Timestamp,OAT,Success,Quote,Observations,Regular_Quote,Difference
1667303483,202570,true,1595645919,28,1589435329,-6210590
1667305283,202569,true,1595805484,28,1589435329,-6370155
1667305475,202570,true,1595645919,28,1589594272,-6051647
1667305823,202570,true,1595645919,28,1589594272,-6051647
1667306123,202570,true,1595645919,28,1589753232,-5892687
1667306159,202570,true,1595645919,28,1589753232,-5892687
1667306375,202570,true,1595645919,28,1589912207,-5733712
1667306819,202570,true,1595645919,28,1590230206,-5415713
1667306903,202570,true,1595645919,28,1590230206,-5415713
1667306963,202569,true,1595805484,28,1590389229,-5416255
1667307059,202570,true,1595645919,28,1590548267,-5097652
1667307143,202570,true,1595645919,28,1590707322,-4938597
1667307611,202570,true,1595645919,28,1591661985,-3983934
1667309339,202569,true,1595805484,28,1593254364,-2551120
1667310071,202569,true,1595805484,28,1593254364,-2551120
1667310083,202569,true,1595805484,28,1593254364,-2551120
1667310119,202569,true,1595805484,28,1593254364,-2551120
1667310131,202568,true,1595965064,28,1593254364,-2710700
1667310143,202569,true,1595805484,28,1593254364,-2551120
1667310155,202569,true,1595805484,28,1593254364,-2551120
1667310215,202569,true,1595805484,28,1593095054,-2710430
1667310239,202569,true,1595805484,28,1592935761,-2869723
1667310311,202569,true,1595805484,28,1592776483,-3029001
1667310347,202570,true,1595645919,28,1592617221,-3028698
1667310359,202570,true,1595645919,28,1592617221,-3028698
1667310371,202570,true,1595645919,28,1592457976,-3187943
1667310395,202571,true,1595486370,28,1592298746,-3187624
1667310419,202571,true,1595486370,28,1592298746,-3187624
1667310491,202572,true,1595326838,28,1591661985,-3664853
1667310503,202572,true,1595326838,28,1591661985,-3664853
1667310683,202573,true,1595167321,28,1590071198,-5096123
1667310695,202574,true,1595007820,28,1589912207,-5095613
1667310731,202575,true,1594848335,28,1589594272,-5254063
1667310791,202575,true,1594848335,28,1588958594,-5889741
1667311235,202576,true,1594688866,28,1584832873,-9855993
1667311271,202578,true,1594369976,28,1584515954,-9854022
1667311283,202578,true,1594369976,28,1584357519,-10012457
1667311511,202579,true,1594210555,28,1582141081,-12069474
1667311619,202581,true,1593891761,28,1580875937,-13015824
1667311655,202582,true,1593732388,28,1580401769,-13330619
1667311691,202583,true,1593573031,28,1580085736,-13487295
1667311799,202585,true,1593254364,28,1578664370,-14589994
1667311919,202588,true,1592776483,28,1577244282,-15532201
1667311991,202590,true,1592457976,28,1576455897,-16002079
1667312015,202591,true,1592298746,28,1576140653,-16158093
1667312219,202593,true,1591980334,28,1574250513,-17729821
1667312243,202596,true,1591502835,28,1574093103,-17409732
1667312315,202598,true,1591184582,28,1573778332,-17406250
1667313263,202598,true,1591184582,28,1571576694,-19607888
1667313275,202599,true,1591025480,28,1571576694,-19448786
1667313299,202602,true,1590548267,28,1571576694,-18971573
1667313311,202603,true,1590389229,28,1571576694,-18812535
1667313467,202603,true,1590389229,28,1571733852,-18655377
1667313887,202604,true,1590230206,28,1572834395,-17395811
1667314175,202607,true,1589753232,28,1573463624,-16289608
1667314703,202608,true,1589594272,28,1574093103,-15501169
1667314715,202608,true,1589594272,28,1574093103,-15501169
1667317151,202610,true,1589276401,28,1572048214,-17228187
1667318387,202613,true,1588799714,28,1572048214,-16751500
1667318771,202614,true,1588640850,28,1572048214,-16592636
1667318783,202614,true,1588640850,28,1572205419,-16435431
1667318795,202616,true,1588323169,28,1572205419,-16117750
1667318807,202619,true,1587846767,28,1572205419,-15641348
1667318819,202620,true,1587687999,28,1572205419,-15482580
1667318831,202619,true,1587846767,28,1572205419,-15641348
1667318855,202621,true,1587529246,28,1572362639,-15166607
1667318867,202624,true,1587053082,28,1572362639,-14690443
1667318903,202624,true,1587053082,28,1572519876,-14533206
1667319467,202624,true,1587053082,28,1574565379,-12487703
1667320175,202626,true,1586735719,28,1577244282,-9491437
1667320187,202628,true,1586418420,28,1577244282,-9174138
1667320223,202629,true,1586259794,28,1577402007,-8857787
1667320283,202629,true,1586259794,28,1577559747,-8700047
1667320295,202631,true,1585942589,28,1577559747,-8382842
1667320319,202634,true,1585466902,28,1577717503,-7749399
1667320331,202635,true,1585308371,28,1577717503,-7590868
1667320475,202636,true,1585149856,28,1577875275,-7274581
1667320487,202638,true,1584832873,28,1577875275,-6957598
1667320583,202641,true,1584357519,28,1578033062,-6324457
1667321663,202642,true,1584199099,28,1574565379,-9633720
1667322455,202643,true,1584040695,28,1572834395,-11206300
1667323211,202645,true,1583723934,28,1572834395,-10889539
1667323355,202648,true,1583248912,28,1572834395,-10414517
1667323895,202649,true,1583090603,28,1572834395,-10256208
1667323907,202650,true,1582932309,28,1572834395,-10097914
1667325227,202652,true,1582615771,28,1572834395,-9781376
1667325563,202655,true,1582141081,28,1572834395,-9306686
1667325599,202656,true,1581982882,28,1572991679,-8991203
1667325623,202656,true,1581982882,28,1572991679,-8991203
1667325635,202658,true,1581666533,28,1572991679,-8674854
1667325647,202661,true,1581192128,28,1572991679,-8200449
1667325659,202662,true,1581034025,28,1572991679,-8042346
1667325731,202662,true,1581034025,28,1572991679,-8042346
1667325815,202663,true,1580875937,28,1573148978,-7726959
1667325851,202666,true,1580401769,28,1573148978,-7252791
1667326151,202666,true,1580401769,28,1573935710,-6466059
1667326235,202666,true,1580401769,28,1574250513,-6151256
1667328275,202667,true,1580243745,28,1578190865,-2052880
1667328983,202669,true,1579927744,28,1578190865,-1736879
1667329019,202668,true,1580085736,28,1578348684,-1737052
1667329175,202668,true,1580085736,28,1578348684,-1737052
1667329187,202669,true,1579927744,28,1578506519,-1421225
1667329535,202670,true,1579769767,28,1578822236,-947531
1667329607,202670,true,1579769767,28,1578822236,-947531
1667329787,202670,true,1579769767,28,1579138017,-631750
1667330531,202671,true,1579611805,28,1580559809,948004
1667330867,202672,true,1579453860,28,1581034025,1580165
1667331095,202672,true,1579453860,28,1581350247,1896387
1667331299,202672,true,1579453860,28,1581508382,2054522
1667332139,202672,true,1579453860,28,1581508382,2054522
1667332247,202674,true,1579138017,28,1581508382,2370365
1667332475,202674,true,1579138017,28,1581508382,2370365
1667332523,202673,true,1579295930,28,1581508382,2212452
1667332883,202674,true,1579138017,28,1581350247,2212230
1667332907,202676,true,1578822236,28,1581350247,2528011
1667333075,202676,true,1578822236,28,1581192128,2369892
1667333207,202676,true,1578822236,28,1581034025,2211789
1667333495,202677,true,1578664370,28,1580717865,2053495
1667333999,202678,true,1578506519,28,1580243745,1737226
1667334011,202678,true,1578506519,28,1580085736,1579217
1667334227,202678,true,1578506519,28,1579927744,1421225
1667334251,202679,true,1578348684,28,1579927744,1579060
1667334443,202681,true,1578033062,28,1579611805,1578743
1667335655,202681,true,1578033062,28,1578664370,631308
1667338691,202681,true,1578033062,28,1578348684,315622
1667338907,202682,true,1577875275,28,1578348684,473409
1667339411,202684,true,1577559747,28,1578348684,788937
1667339927,202685,true,1577402007,28,1578348684,946677
1667339939,202685,true,1577402007,28,1578348684,946677
1667339951,202686,true,1577244282,28,1578348684,1104402
1667339963,202687,true,1577086574,28,1578190865,1104291
1667339975,202688,true,1576928881,28,1578190865,1261984
1667340011,202688,true,1576928881,28,1578190865,1261984
1667340155,202689,true,1576771204,28,1577717503,946299
1667340239,202691,true,1576455897,28,1577559747,1103850
1667341067,202691,true,1576455897,28,1575667905,-787992
1667341151,202691,true,1576455897,28,1575510354,-945543
1667343455,202692,true,1576298267,28,1574093103,-2205164
1667343551,202693,true,1576140653,28,1574093103,-2047550
1667343803,202693,true,1576140653,28,1574250513,-1890140
1667343923,202693,true,1576140653,28,1574407938,-1732715
1667344283,202693,true,1576140653,28,1574565379,-1575274
1667344295,202694,true,1575983054,28,1574565379,-1417675
1667344331,202694,true,1575983054,28,1574722835,-1260219
1667345063,202693,true,1576140653,28,1575825472,-315181
1667345075,202693,true,1576140653,28,1575825472,-315181
1667345435,202694,true,1575983054,28,1576613542,630488
1667345495,202694,true,1575983054,28,1576613542,630488
1667345567,202692,true,1576298267,28,1576771204,472937
1667345951,202693,true,1576140653,28,1577402007,1261354
1667346095,202693,true,1576140653,28,1577559747,1419094
1667346551,202693,true,1576140653,28,1577717503,1576850
1667347211,202692,true,1576298267,28,1577875275,1577008
1667347379,202691,true,1576455897,28,1578348684,1892787
1667347463,202691,true,1576455897,28,1578506519,2050622
1667347523,202691,true,1576455897,28,1578664370,2208473
1667347547,202689,true,1576771204,28,1578664370,1893166
1667347643,202689,true,1576771204,28,1578664370,1893166
1667348351,202689,true,1576771204,28,1578190865,1419661
1667348411,202689,true,1576771204,28,1578190865,1419661
1667348747,202688,true,1576928881,28,1578033062,1104181
1667349431,202688,true,1576928881,28,1577244282,315401
1667349503,202688,true,1576928881,28,1577244282,315401
1667349527,202688,true,1576928881,28,1577244282,315401
1667349587,202687,true,1577086574,28,1577244282,157708
1667349779,202687,true,1577086574,28,1577559747,473173
1667349923,202687,true,1577086574,28,1577875275,788701
1667350031,202687,true,1577086574,28,1578190865,1104291
1667350055,202686,true,1577244282,28,1578190865,946583
1667350079,202685,true,1577402007,28,1578348684,946677
1667350103,202685,true,1577402007,28,1578506519,1104512
1667350367,202684,true,1577559747,28,1579927744,2367997
1667350955,202682,true,1577875275,28,1583248912,5373637
1667351807,202682,true,1577875275,28,1587211787,9336512
1667351903,202681,true,1578033062,28,1587370509,9337447
1667352815,202681,true,1578033062,28,1587370509,9337447
1667353943,202680,true,1578190865,28,1587370509,9179644
1667354315,202679,true,1578348684,28,1587370509,9021825
1667354519,202679,true,1578348684,28,1587370509,9021825
1667354555,202679,true,1578348684,28,1587370509,9021825
1667354711,202678,true,1578506519,28,1587370509,8863990
1667354807,202677,true,1578664370,28,1587370509,8706139
1667354819,202677,true,1578664370,28,1587370509,8706139
1667354843,202677,true,1578664370,28,1587370509,8706139
1667354867,202676,true,1578822236,28,1587370509,8548273
1667354987,202676,true,1578822236,28,1587053082,8230846
1667355227,202676,true,1578822236,28,1586577061,7754825
1667356415,202675,true,1578980119,28,1584040695,5060576
1667357207,202674,true,1579138017,28,1583565577,4427560
1667357291,202674,true,1579138017,28,1583723934,4585917
1667357303,202674,true,1579138017,28,1583723934,4585917
1667357315,202673,true,1579295930,28,1583723934,4428004
1667357327,202672,true,1579453860,28,1583723934,4270074
1667357363,202671,true,1579611805,28,1583723934,4112129
1667357495,202671,true,1579611805,28,1583882306,4270501
1667357543,202670,true,1579769767,28,1584040695,4270928
1667357555,202669,true,1579927744,28,1584040695,4112951
1667357723,202668,true,1580085736,28,1584357519,4271783
1667357783,202667,true,1580243745,28,1584515954,4272209
1667357807,202667,true,1580243745,28,1584515954,4272209
1667358011,202665,true,1580559809,28,1585149856,4590047
1667358047,202664,true,1580717865,28,1585149856,4431991
1667358551,202664,true,1580717865,28,1586418420,5700555
1667359223,202663,true,1580875937,28,1587846767,6970830
1667359643,202662,true,1581034025,28,1588005552,6971527
1667359667,202662,true,1581034025,28,1588005552,6971527
1667359691,202661,true,1581192128,28,1588005552,6813424
1667359703,202661,true,1581192128,28,1588164353,6972225
1667359763,202659,true,1581508382,28,1588164353,6655971
1667360243,202659,true,1581508382,28,1588799714,7291332
1667360699,202658,true,1581666533,28,1589435329,7768796
1667361203,202658,true,1581666533,28,1590071198,8404665
1667361287,202657,true,1581824700,28,1590230206,8405506
1667361359,202656,true,1581982882,28,1590389229,8406347
1667361551,202656,true,1581982882,28,1590548267,8565385
1667361767,202656,true,1581982882,28,1590548267,8565385
1667362295,202654,true,1582299295,28,1590548267,8248972
1667362451,202654,true,1582299295,28,1590548267,8248972
1667362799,202654,true,1582299295,28,1590548267,8248972
1667362955,202654,true,1582299295,28,1590548267,8248972
1667364983,202652,true,1582615771,28,1590548267,7932496
1667365403,202652,true,1582615771,28,1590548267,7932496
1667365415,202652,true,1582615771,28,1590548267,7932496
1667365763,202651,true,1582774032,28,1591502835,8728803
1667365919,202650,true,1582932309,28,1591821152,8888843
1667366375,202649,true,1583090603,28,1592935761,9845158
1667366615,202649,true,1583090603,28,1593413689,10323086
1667366687,202648,true,1583248912,28,1593573031,10324119
1667366747,202647,true,1583407237,28,1593732388,10325151
1667366759,202646,true,1583565577,28,1593732388,10166811
1667367035,202646,true,1583565577,28,1594210555,10644978
1667367167,202645,true,1583723934,28,1594369976,10646042
1667367251,202644,true,1583882306,28,1594369976,10487670
1667367275,202643,true,1584040695,28,1594210555,10169860
1667367311,202643,true,1584040695,28,1594210555,10169860
1667368139,202642,true,1584199099,28,1592617221,8418122
1667368163,202641,true,1584357519,28,1592457976,8100457
1667368343,202640,true,1584515954,28,1592139532,7623578
1667368763,202640,true,1584515954,28,1591343701,6827747
1667368919,202639,true,1584674406,28,1591184582,6510176
1667369015,202638,true,1584832873,28,1591025480,6192607
1667369027,202637,true,1584991357,28,1591025480,6034123
1667369039,202637,true,1584991357,28,1591025480,6034123
1667369111,202636,true,1585149856,28,1590866393,5716537
1667369231,202634,true,1585466902,28,1590707322,5240420
1667369699,202633,true,1585625448,28,1590071198,4445750
1667369711,202634,true,1585466902,28,1590071198,4604296
1667369963,202633,true,1585625448,28,1589435329,3809881
1667370059,202631,true,1585942589,28,1589276401,3333812
1667370491,202630,true,1586101183,28,1588640850,2539667
1667371655,202631,true,1585942589,28,1587687999,1745410
1667372207,202630,true,1586101183,28,1587687999,1586816
1667372987,202628,true,1586418420,28,1587687999,1269579
1667373155,202628,true,1586418420,28,1587687999,1269579
1667373167,202628,true,1586418420,28,1587687999,1269579
1667373191,202627,true,1586577061,28,1587687999,1110938
1667373203,202626,true,1586735719,28,1587687999,952280
1667373335,202626,true,1586735719,28,1587211787,476068
1667373347,202627,true,1586577061,28,1587211787,634726
1667373383,202626,true,1586735719,28,1587053082,317363
1667373395,202625,true,1586894393,28,1587053082,158689
1667373419,202626,true,1586735719,28,1586735719,0
1667373443,202627,true,1586577061,28,1586577061,0
1667373467,202628,true,1586418420,28,1586418420,0
1667373503,202627,true,1586577061,28,1585942589,-634472
1667373563,202629,true,1586259794,28,1585149856,-1109938
1667373575,202630,true,1586101183,28,1584991357,-1109826
1667373743,202631,true,1585942589,28,1582615771,-3326818
1667373767,202631,true,1585942589,28,1582299295,-3643294
1667374427,202633,true,1585625448,28,1571733852,-13891596
1667374715,202634,true,1585466902,28,1567182653,-18284249
1667374727,202635,true,1585308371,28,1567025951,-18282420
1667375039,202635,true,1585308371,28,1562488385,-22819986
1667375051,202637,true,1584991357,28,1562332152,-22659205
1667375099,202638,true,1584832873,28,1561707375,-23125498
1667375303,202639,true,1584674406,28,1560146526,-24527880
1667375387,202639,true,1584674406,28,1559990527,-24683879
1667375399,202641,true,1584357519,28,1559990527,-24366992
1667375459,202642,true,1584199099,28,1559990527,-24208572
1667375531,202643,true,1584040695,28,1559990527,-24050168
1667375663,202643,true,1584040695,28,1560302541,-23738154
1667375951,202646,true,1583565577,28,1560926756,-22638821
1667376227,202647,true,1583407237,28,1561395081,-22012156
1667377559,202649,true,1583090603,28,1562957178,-20133425
1667377643,202649,true,1583090603,28,1563113474,-19977129
1667377655,202651,true,1582774032,28,1563113474,-19660558
1667378051,202652,true,1582615771,28,1563269786,-19345985
1667378063,202654,true,1582299295,28,1563269786,-19029509
1667378591,202654,true,1582299295,28,1563738813,-18560482
1667379023,202656,true,1581982882,28,1564051577,-17931305
1667379059,202657,true,1581824700,28,1564051577,-17773123
1667379083,202659,true,1581508382,28,1564051577,-17456805
1667379119,202659,true,1581508382,28,1564051577,-17456805
1667379383,202661,true,1581192128,28,1564520839,-16671289
1667379479,202662,true,1581034025,28,1564677291,-16356734
1667379491,202664,true,1580717865,28,1564677291,-16040574
1667379635,202663,true,1580875937,28,1564990242,-15885695
1667379647,202665,true,1580559809,28,1565146741,-15413068
1667379683,202665,true,1580559809,28,1565146741,-15413068
1667379719,202667,true,1580243745,28,1565303256,-14940489
1667379755,202666,true,1580401769,28,1565459786,-14941983
1667380391,202667,true,1580243745,28,1568750541,-11493204
1667380811,202668,true,1580085736,28,1570791141,-9294595
1667380883,202669,true,1579927744,28,1571105315,-8822429
1667380895,202669,true,1579927744,28,1571105315,-8822429
1667381135,202670,true,1579769767,28,1572048214,-7721553
1667381183,202671,true,1579611805,28,1572205419,-7406386
1667381267,202672,true,1579453860,28,1572519876,-6933984
1667381375,202672,true,1579453860,28,1572677128,-6776732
1667381447,202674,true,1579138017,28,1572677128,-6460889
1667381495,202675,true,1578980119,28,1572677128,-6302991
1667381507,202676,true,1578822236,28,1572677128,-6145108
1667381543,202676,true,1578822236,28,1572677128,-6145108
1667381567,202678,true,1578506519,28,1572519876,-5986643
1667381615,202679,true,1578348684,28,1572362639,-5986045
1667381627,202681,true,1578033062,28,1572205419,-5827643
1667382839,202681,true,1578033062,28,1565772894,-12260168
1667383211,202684,true,1577559747,28,1563895187,-13664560
1667383223,202685,true,1577402007,28,1563895187,-13506820
1667383247,202687,true,1577086574,28,1563738813,-13347761
1667383271,202687,true,1577086574,28,1563582455,-13504119
1667383283,202690,true,1576613542,28,1563582455,-13031087
1667383403,202692,true,1576298267,28,1563113474,-13184793
1667383415,202694,true,1575983054,28,1562957178,-13025876
1667383427,202695,true,1575825472,28,1562800898,-13024574
1667383559,202699,true,1575195299,28,1561395081,-13800218
1667383931,202702,true,1574722835,28,1557185210,-17537625
1667384327,202704,true,1574407938,28,1552831407,-21576531
1667384339,202706,true,1574093103,28,1552676140,-21416963
1667384627,202710,true,1573463624,28,1549574046,-23889578
1667384711,202713,true,1572991679,28,1548644627,-24347052
1667384735,202715,true,1572677128,28,1548489778,-24187350
1667384747,202716,true,1572519876,28,1548334944,-24184932
1667385299,202720,true,1571891025,28,1544005886,-27885139
1667385683,202723,true,1571419552,28,1544469134,-26950418
1667385959,202726,true,1570948220,28,1544778044,-26170176
1667386163,202727,true,1570791141,28,1545087015,-25704126
1667386919,202731,true,1570162982,28,1545550587,-24612395
1667386931,202735,true,1569535074,28,1545550587,-23984487
1667387039,202737,true,1569221214,28,1545550587,-23670627
1667387075,202738,true,1569064307,28,1545550587,-23513720
1667387111,202742,true,1568436838,28,1545550587,-22886251
1667387615,202745,true,1567966401,28,1546323517,-21642884
1667387627,202747,true,1567652855,28,1546323517,-21329338
1667387783,202748,true,1567496106,28,1546632797,-20863309
1667387987,202753,true,1566712593,28,1546787461,-19925132
1667388395,202755,true,1566399297,28,1547406268,-18993029
1667388407,202757,true,1566086064,28,1547406268,-18679796
1667388419,202758,true,1565929471,28,1547561009,-18368462
1667388431,202762,true,1565303256,28,1547561009,-17742247
1667388479,202765,true,1564833759,28,1547561009,-17272750
1667388527,202766,true,1564677291,28,1547715765,-16961526
1667388551,202767,true,1564520839,28,1547870537,-16650302
1667388719,202771,true,1563895187,28,1548489778,-15405409
1667388791,202773,true,1563582455,28,1548644627,-14937828
1667388815,202775,true,1563269786,28,1548799491,-14470295
1667389031,202776,true,1563113474,28,1549574046,-13539428
1667389151,202779,true,1562644634,28,1549883976,-12760658
1667389343,202782,true,1562175934,28,1550504023,-11671911
1667389919,202783,true,1562019732,28,1552210430,-9809302
1667390315,202783,true,1562019732,28,1553452633,-8567099
1667390399,202787,true,1561395081,28,1553452633,-7942448
1667390687,202789,true,1561082848,28,1553763339,-7319509
1667390795,202790,true,1560926756,28,1553763339,-7163417
1667390939,202791,true,1560770679,28,1553763339,-7007340
1667391299,202795,true,1560146526,28,1553763339,-6383187
1667391311,202797,true,1559834544,28,1553763339,-6071205
1667391419,202798,true,1559678576,28,1553763339,-5915237
1667391467,202799,true,1559522624,28,1553763339,-5759285
1667391575,202802,true,1559054861,28,1553607978,-5446883
1667391587,202804,true,1558743096,28,1553607978,-5135118
1667391599,202805,true,1558587238,28,1553607978,-4979260
1667391803,202805,true,1558587238,28,1553607978,-4979260
1667391863,202807,true,1558275567,28,1553607978,-4667589
1667392043,202809,true,1557963959,28,1553607978,-4355981
1667392163,202809,true,1557963959,28,1553763339,-4200620
1667392211,202809,true,1557963959,28,1553763339,-4200620
1667392295,202810,true,1557808178,28,1553763339,-4044839
1667392907,202812,true,1557496663,28,1553763339,-3733324
1667393003,202811,true,1557652412,28,1553763339,-3889073
1667393207,202811,true,1557652412,28,1553918716,-3733696
1667393327,202812,true,1557496663,28,1553918716,-3577947
1667393903,202813,true,1557340929,28,1553918716,-3422213
1667394035,202812,true,1557496663,28,1553918716,-3577947
1667394803,202812,true,1557496663,28,1553918716,-3577947
1667395535,202813,true,1557340929,28,1553763339,-3577590
1667395811,202814,true,1557185210,28,1553763339,-3421871
1667396879,202814,true,1557185210,28,1553763339,-3421871
1667397383,202814,true,1557185210,28,1553763339,-3421871
1667398415,202815,true,1557029507,28,1553763339,-3266168
1667398427,202816,true,1556873820,28,1553918716,-2955104
1667398439,202816,true,1556873820,28,1553918716,-2955104
1667398475,202816,true,1556873820,28,1554074107,-2799713
1667398523,202815,true,1557029507,28,1554229515,-2799992
1667399579,202817,true,1556718148,28,1558431394,1713246
1667399591,202816,true,1556873820,28,1558431394,1557574
1667400383,202816,true,1556873820,28,1560614617,3740797
1667400791,202816,true,1556873820,28,1560302541,3428721
1667401067,202817,true,1556718148,28,1560302541,3584393
1667401079,202817,true,1556718148,28,1560302541,3584393
1667401439,202817,true,1556718148,28,1559990527,3272379
1667401799,202817,true,1556718148,28,1559990527,3272379
1667402207,202818,true,1556562492,28,1559990527,3428035
1667402495,202818,true,1556562492,28,1559990527,3428035
1667403515,202818,true,1556562492,28,1559990527,3428035
1667403611,202818,true,1556562492,28,1559834544,3272052
1667404259,202820,true,1556251226,28,1559834544,3583318
1667405483,202819,true,1556406851,28,1560146526,3739675
1667406419,202820,true,1556251226,28,1560146526,3895300
1667406443,202820,true,1556251226,28,1560146526,3895300
1667406491,202822,true,1555940022,28,1560146526,4206504
1667406527,202822,true,1555940022,28,1560146526,4206504
1667406743,202823,true,1555784444,28,1559990527,4206083
1667406971,202823,true,1555784444,28,1559834544,4050100
1667406995,202825,true,1555473334,28,1559834544,4361210
1667407079,202825,true,1555473334,28,1559678576,4205242
1667407511,202826,true,1555317802,28,1558743096,3425294
1667407763,202827,true,1555162286,28,1558431394,3269108
1667407775,202829,true,1554851300,28,1558431394,3580094
1667407835,202828,true,1555006785,28,1558431394,3424609
1667407847,202829,true,1554851300,28,1558431394,3580094
1667407871,202830,true,1554695830,28,1558431394,3735564
1667407895,202831,true,1554540376,28,1558431394,3891018
1667407907,202830,true,1554695830,28,1558431394,3735564
1667408159,202831,true,1554540376,28,1559054861,4514485
1667408279,202831,true,1554540376,28,1559366687,4826311
1667408303,202832,true,1554384938,28,1559366687,4981749
1667408315,202831,true,1554540376,28,1559522624,4982248
1667408543,202830,true,1554695830,28,1560926756,6230926
1667408711,202829,true,1554851300,28,1562019732,7168432
1667408723,202830,true,1554695830,28,1562019732,7323902
1667408795,202829,true,1554851300,28,1562488385,7637085
1667408807,202828,true,1555006785,28,1562644634,7637849
1667408879,202827,true,1555162286,28,1562957178,7794892
1667410535,202828,true,1555006785,28,1567025951,12019166
1667410907,202828,true,1555006785,28,1566869264,11862479
1667411315,202826,true,1555317802,28,1566869264,11551462
1667411603,202824,true,1555628881,28,1566869264,11240383
1667411735,202823,true,1555784444,28,1566869264,11084820
1667411747,202822,true,1555940022,28,1566869264,10929242
1667411759,202821,true,1556095616,28,1566869264,10773648
1667411807,202819,true,1556406851,28,1566712593,10305742
1667411819,202819,true,1556406851,28,1566555937,10149086
1667411831,202818,true,1556562492,28,1566555937,9993445
1667411891,202818,true,1556562492,28,1566086064,9523572
1667412011,202816,true,1556873820,28,1565616332,8742512
1667412035,202816,true,1556873820,28,1565146741,8272921
1667412047,202816,true,1556873820,28,1564990242,8116422
1667412071,202816,true,1556873820,28,1564990242,8116422
1667412083,202814,true,1557185210,28,1564990242,7805032
1667412095,202812,true,1557496663,28,1565146741,7650078
1667412107,202810,true,1557808178,28,1565146741,7338563
1667412131,202808,true,1558119755,28,1565459786,7340031
1667412143,202806,true,1558431394,28,1565459786,7028392
1667412155,202804,true,1558743096,28,1565616332,6873236
1667412167,202802,true,1559054861,28,1565772894,6718033
1667412203,202800,true,1559366687,28,1566086064,6719377
1667412215,202798,true,1559678576,28,1566242673,6564097
1667412227,202796,true,1559990527,28,1566242673,6252146
1667412239,202794,true,1560302541,28,1566399297,6096756
1667412275,202791,true,1560770679,28,1566712593,5941914
1667412347,202790,true,1560926756,28,1567496106,6569350
1667412371,202788,true,1561238957,28,1567809620,6570663
1667412383,202786,true,1561551220,28,1567966401,6415181
1667412395,202783,true,1562019732,28,1568123198,6103466
1667412407,202781,true,1562332152,28,1568280010,5947858
1667412419,202778,true,1562800898,28,1568436838,5635940
1667412431,202775,true,1563269786,28,1568750541,5480755
1667412443,202773,true,1563582455,28,1568907417,5324962
1667412479,202770,true,1564051577,28,1569692027,5640450
1667412563,202767,true,1564520839,28,1571419552,6898713
1667412587,202764,true,1564990242,28,1571891025,6900783
1667412623,202762,true,1565303256,28,1572519876,7216620
1667412635,202759,true,1565772894,28,1572677128,6904234
1667412647,202756,true,1566242673,28,1572834395,6591722
1667412839,202755,true,1566399297,28,1575510354,9111057
1667412851,202753,true,1566712593,28,1575825472,9112879
1667412863,202750,true,1567182653,28,1575983054,8800401
1667412875,202748,true,1567496106,28,1576140653,8644547
1667412923,202746,true,1567809620,28,1576928881,9119261
1667412947,202743,true,1568280010,28,1577244282,8964272
1667412959,202740,true,1568750541,28,1577402007,8651466
1667412971,202738,true,1569064307,28,1577717503,8653196
1667412983,202736,true,1569378136,28,1577875275,8497139
1667412995,202733,true,1569848996,28,1578033062,8184066
1667413007,202730,true,1570319998,28,1578348684,8028686
1667413019,202727,true,1570791141,28,1578664370,7873229
1667413043,202724,true,1571262426,28,1579138017,7875591
1667413079,202720,true,1571891025,28,1580085736,8194711
1667413103,202717,true,1572362639,28,1580717865,8355226
1667413283,202714,true,1572834395,28,1584991357,12156962
1667413343,202711,true,1573306293,28,1586418420,13112127
1667413499,202707,true,1573935710,28,1590230206,16294496
1667413631,202704,true,1574407938,28,1593732388,19324450
1667413655,202701,true,1574880307,28,1594529413,19649106
1667413703,202699,true,1575195299,28,1595965064,20769765
1667413919,202694,true,1575983054,28,1602681877,26698823
1667413943,202690,true,1576613542,28,1603002429,26388887
1667413955,202688,true,1576928881,28,1603162730,26233849
1667413979,202685,true,1577402007,28,1603483378,26081371
1667414039,202682,true,1577875275,28,1604285280,26410005
1667414159,202678,true,1578506519,28,1606050877,27544358
1667414207,202675,true,1578980119,28,1606532740,27552621
1667414219,202672,true,1579453860,28,1606532740,27078880
1667414243,202669,true,1579927744,28,1606532740,26604996
1667414255,202667,true,1580243745,28,1606532740,26288995
1667414267,202666,true,1580401769,28,1606532740,26130971
1667414279,202663,true,1580875937,28,1606532740,25656803
1667414291,202661,true,1581192128,28,1606372103,25179975
1667414315,202660,true,1581350247,28,1606211482,24861235
1667414351,202659,true,1581508382,28,1605729715,24221333
1667414435,202658,true,1581666533,28,1605087583,23421050
1667414471,202655,true,1582141081,28,1605087583,22946502
1667414483,202654,true,1582299295,28,1605087583,22788288
1667414531,202653,true,1582457525,28,1604927091,22469566
1667414543,202650,true,1582932309,28,1605087583,22155274
1667414555,202647,true,1583407237,28,1605087583,21680346
1667414579,202646,true,1583565577,28,1605248092,21682515
1667414603,202643,true,1584040695,28,1605408617,21367922
1667414651,202640,true,1584515954,28,1605729715,21213761
1667414663,202637,true,1584991357,28,1605890288,20898931
1667414771,202636,true,1585149856,28,1606372103,21222247
1667414795,202633,true,1585625448,28,1606372103,20746655
1667414819,202630,true,1586101183,28,1606372103,20270920
1667414879,202627,true,1586577061,28,1605890288,19313227
1667414927,202626,true,1586735719,28,1605729715,18993996
1667414975,202624,true,1587053082,28,1605408617,18355535
1667414987,202621,true,1587529246,28,1605248092,17718846
1667415011,202618,true,1588005552,28,1605087583,17082031
1667415023,202617,true,1588164353,28,1605087583,16923230
1667415035,202615,true,1588482001,28,1604927091,16445090
1667415047,202612,true,1588958594,28,1604766614,15808020
1667415059,202610,true,1589276401,28,1604606153,15329752
1667415071,202610,true,1589276401,28,1604445709,15169308
1667415083,202609,true,1589435329,28,1604285280,14849951
1667415095,202608,true,1589594272,28,1604124868,14530596
1667415107,202606,true,1589912207,28,1603804091,13891884
1667415155,202608,true,1589594272,28,1602681877,13087605
1667415167,202607,true,1589753232,28,1602521625,12768393
1667415179,202606,true,1589912207,28,1602201169,12288962
1667415203,202606,true,1589912207,28,1601560448,11648241
1667415215,202609,true,1589435329,28,1601240184,11804855
1667415227,202609,true,1589435329,28,1600919984,11484655
1667415239,202609,true,1589435329,28,1600439804,11004475
1667415275,202610,true,1589276401,28,1599319944,10043543
1667415323,202612,true,1588958594,28,1597881276,8922682
1667415335,202612,true,1588958594,28,1597402007,8443413
1667415347,202612,true,1588958594,28,1597082575,8123981
1667415359,202612,true,1588958594,28,1596763206,7804612
1667415371,202614,true,1588640850,28,1596443901,7803051
1667415515,202614,true,1588640850,28,1592298746,3657896
1667415539,202613,true,1588799714,28,1591502835,2703121
1667415599,202614,true,1588640850,28,1589753232,1112382
1667415659,202615,true,1588482001,28,1588005552,-476449
1667415671,202614,true,1588640850,28,1587687999,-952851
1667415695,202613,true,1588799714,28,1586894393,-1905321
1667415839,202613,true,1588799714,28,1583090603,-5709111
1667415851,202614,true,1588640850,28,1582774032,-5866818
1667415863,202612,true,1588958594,28,1582457525,-6501069
1667415875,202611,true,1589117490,28,1582141081,-6976409
1667415899,202610,true,1589276401,28,1581666533,-7609868
1667415935,202611,true,1589117490,28,1580875937,-8241553
1667415947,202611,true,1589117490,28,1580559809,-8557681
1667415983,202612,true,1588958594,28,1579769767,-9188827
1667416115,202612,true,1588958594,28,1577717503,-11241091
1667416139,202613,true,1588799714,28,1577559747,-11239967
1667416175,202614,true,1588640850,28,1577402007,-11238843
1667416295,202613,true,1588799714,28,1577086574,-11713140
1667416475,202613,true,1588799714,28,1575037795,-13761919
1667416499,202614,true,1588640850,28,1574722835,-13918015
1667416523,202614,true,1588640850,28,1574407938,-14232912
1667416547,202614,true,1588640850,28,1574093103,-14547747
1667416559,202614,true,1588640850,28,1573935710,-14705140
1667416595,202616,true,1588323169,28,1573306293,-15016876
1667416619,202617,true,1588164353,28,1572834395,-15329958
1667416631,202617,true,1588164353,28,1572677128,-15487225
1667416703,202618,true,1588005552,28,1571576694,-16428858
1667416715,202620,true,1587687999,28,1571262426,-16425573
1667416787,202622,true,1587370509,28,1570005981,-17364528
1667416811,202623,true,1587211787,28,1569692027,-17519760
1667416823,202625,true,1586894393,28,1569378136,-17516257
1667416835,202628,true,1586418420,28,1569221214,-17197206
1667416847,202631,true,1585942589,28,1569064307,-16878282
1667416859,202632,true,1585784011,28,1568907417,-16876594
1667416883,202634,true,1585466902,28,1568436838,-17030064
1667416895,202638,true,1584832873,28,1568280010,-16552863
1667416991,202641,true,1584357519,28,1567652855,-16704664
1667417003,202641,true,1584357519,28,1567496106,-16861413
1667417027,202643,true,1584040695,28,1567496106,-16544589
1667417051,202647,true,1583407237,28,1567496106,-15911131
1667417063,202650,true,1582932309,28,1567496106,-15436203
1667417075,202651,true,1582774032,28,1567496106,-15277926
1667417159,202653,true,1582457525,28,1567182653,-15274872
1667417171,202657,true,1581824700,28,1567025951,-14798749
1667417183,202661,true,1581192128,28,1566869264,-14322864
1667417207,202662,true,1581034025,28,1566712593,-14321432
1667417219,202666,true,1580401769,28,1566555937,-13845832
1667417279,202671,true,1579611805,28,1565772894,-13838911
1667417303,202676,true,1578822236,28,1565303256,-13518980
1667417315,202678,true,1578506519,28,1565146741,-13359778
1667417363,202684,true,1577559747,28,1564364403,-13195344
1667417375,202690,true,1576613542,28,1564207982,-12405560
1667417387,202694,true,1575983054,28,1564051577,-11931477
1667417495,202696,true,1575667905,28,1562332152,-13335753
1667417627,202701,true,1574880307,28,1560302541,-14577766
1667417639,202707,true,1573935710,28,1560146526,-13789184
1667417663,202711,true,1573306293,28,1559678576,-13627717
1667417831,202713,true,1572991679,28,1556562492,-16429187
1667417843,202719,true,1572048214,28,1556251226,-15796988
1667417867,202725,true,1571105315,28,1555784444,-15320871
1667418011,202728,true,1570634078,28,1552986691,-17647387
1667418071,202729,true,1570477030,28,1551589701,-18887329
1667418095,202734,true,1569692027,28,1551124317,-18567710
1667418659,202740,true,1568750541,28,1540921115,-27829426
1667418743,202744,true,1568123198,28,1540150885,-27972313
1667418755,202745,true,1567966401,28,1540150885,-27815516
1667418851,202749,true,1567339372,28,1539381041,-27958331
1667419031,202755,true,1566399297,28,1538611581,-27787716
1667419235,202758,true,1565929471,28,1539227118,-26702353
1667419259,202759,true,1565772894,28,1539381041,-26391853
1667419703,202763,true,1565146741,28,1539688932,-25457809
1667419715,202767,true,1564520839,28,1539688932,-24831907
1667419811,202770,true,1564051577,28,1539227118,-24824459
1667419835,202770,true,1564051577,28,1539073211,-24978366
1667419847,202775,true,1563269786,28,1539073211,-24196575
1667419859,202780,true,1562488385,28,1538919319,-23569066
1667419955,202783,true,1562019732,28,1538150090,-23869642
1667419967,202785,true,1561707375,28,1538150090,-23557285
1667420003,202790,true,1560926756,28,1537688737,-23238019
1667420015,202796,true,1559990527,28,1537688737,-22301790
1667420051,202802,true,1559054861,28,1537227523,-21827338
1667420075,202804,true,1558743096,28,1536920123,-21822973
1667420123,202810,true,1557808178,28,1536305509,-21502669
1667420135,202815,true,1557029507,28,1536151894,-20877613
1667420339,202821,true,1556095616,28,1533389445,-22706171
1667420363,202824,true,1555628881,28,1533082813,-22546068
1667420411,202830,true,1554695830,28,1532316502,-22379328
1667420591,202835,true,1553918716,28,1529713907,-24204809
1667420603,202841,true,1552986691,28,1529560951,-23425740
1667420615,202843,true,1552676140,28,1529408010,-23268130
1667420627,202849,true,1551744860,28,1529255084,-22489776
1667420699,202855,true,1550814139,28,1528185034,-22629105
1667420891,202861,true,1549883976,28,1524826890,-25057086
1667420903,202863,true,1549574046,28,1524521970,-25052076
1667421251,202868,true,1548799491,28,1519043832,-29755659
1667421683,202873,true,1548025324,28,1512980095,-35045229
1667421767,202879,true,1547096833,28,1512223832,-34873001
1667422103,202880,true,1546942139,28,1510410343,-36531796
1667422487,202884,true,1546323517,28,1509504413,-36819104
1667422499,202888,true,1545705142,28,1509504413,-36200729
1667422823,202893,true,1544932522,28,1510259317,-34673205
1667422883,202894,true,1544778044,28,1510259317,-34518727
1667423219,202897,true,1544314703,28,1510712440,-33602263
1667423351,202900,true,1543851501,28,1510712440,-33139061
1667423435,202905,true,1543079807,28,1510863511,-32216296
1667423555,202905,true,1543079807,28,1510863511,-32216296
1667423687,202908,true,1542616976,28,1511014597,-31602379
1667423795,202910,true,1542308498,28,1511014597,-31293901
1667424083,202915,true,1541537576,28,1511165699,-30371877
1667424131,202915,true,1541537576,28,1511165699,-30371877
1667424191,202918,true,1541075207,28,1511165699,-29909508
1667424251,202922,true,1540458931,28,1511165699,-29293232
1667424347,202927,true,1539688932,28,1511165699,-28523233
1667424371,202927,true,1539688932,28,1511165699,-28523233
1667424455,202930,true,1539227118,28,1510863511,-28363607
1667424659,202934,true,1538611581,28,1510259317,-28352264
1667424779,202939,true,1537842506,28,1510108306,-27734200
1667424827,202939,true,1537842506,28,1509957310,-27885196
1667424839,202943,true,1537227523,28,1509957310,-27270213
1667424851,202947,true,1536612785,28,1509957310,-26655475
1667424887,202952,true,1535844709,28,1509957310,-25887399
1667425199,202952,true,1535844709,28,1509655364,-26189345
1667425259,202956,true,1535230525,28,1509504413,-25726112
1667425631,202960,true,1534616586,28,1509202558,-25414028
1667425859,202965,true,1533849508,28,1509051653,-24797855
1667426351,202966,true,1533696139,28,1509202558,-24493581
1667426519,202970,true,1533082813,28,1509353478,-23729335
1667426531,202974,true,1532469734,28,1509353478,-23116256
1667426543,202980,true,1531550574,28,1509353478,-22197096
1667426615,202981,true,1531397434,28,1509504413,-21893021
1667428139,202986,true,1530631965,28,1510712440,-19919525
1667428187,202991,true,1529866878,28,1510712440,-19154438
1667429639,202996,true,1529102174,28,1511467947,-17634227
1667429759,202997,true,1528949279,28,1511619094,-17330185
1667430359,203002,true,1528185034,28,1511619094,-16565940
1667430383,203005,true,1527726670,28,1511619094,-16107576
1667430563,203011,true,1526810355,28,1511467947,-15342408
1667430803,203012,true,1526657689,28,1511467947,-15189742
1667430839,203016,true,1526047179,28,1511467947,-14579232
1667431103,203019,true,1525589456,28,1511619094,-13970362
1667431115,203024,true,1524826890,28,1511619094,-13207796
1667431127,203025,true,1524674423,28,1511619094,-13055329
1667431403,203028,true,1524217112,28,1512072625,-12144487
1667431439,203031,true,1523759938,28,1512072625,-11687313
1667431475,203036,true,1522998287,28,1512223832,-10774455
1667431643,203036,true,1522998287,28,1512677545,-10320742
1667431739,203038,true,1522693733,28,1512980095,-9713638
1667432051,203041,true,1522237016,28,1514039499,-8197517
1667432507,203045,true,1521628273,28,1515554220,-6074053
1667433083,203045,true,1521628273,28,1517070457,-4557816
1667433155,203047,true,1521323993,28,1517222164,-4101829
1667433731,203050,true,1520867687,28,1517677376,-3190311
1667434931,203053,true,1520411518,28,1517677376,-2734142
1667434991,203053,true,1520411518,28,1517829143,-2582375
1667435003,203055,true,1520107482,28,1517829143,-2278339
1667435015,203057,true,1519803506,28,1517829143,-1974363
1667435063,203060,true,1519347656,28,1517829143,-1518513
1667435087,203059,true,1519499591,28,1517829143,-1670448
1667435099,203060,true,1519347656,28,1517829143,-1518513
1667435111,203061,true,1519195736,28,1517829143,-1366593
1667435411,203063,true,1518891943,28,1518588210,-303733
1667435447,203062,true,1519043832,28,1518740069,-303763
1667435579,203062,true,1519043832,28,1519043832,0
1667435603,203063,true,1518891943,28,1519195736,303793
1667435759,203065,true,1518588210,28,1519651541,1063331
1667436059,203064,true,1518740069,28,1520715616,1975547
1667436143,203065,true,1518588210,28,1520867687,2279477
1667436191,203066,true,1518436366,28,1521019774,2583408
1667436203,203068,true,1518132724,28,1521171876,3039152
1667436311,203067,true,1518284538,28,1521628273,3343735
1667436323,203067,true,1518284538,28,1521628273,3343735
1667436347,203068,true,1518132724,28,1521780436,3647712
1667436359,203071,true,1517677376,28,1521780436,4103060
1667436371,203070,true,1517829143,28,1521932614,4103471
1667436395,203070,true,1517829143,28,1522084807,4255664
1667436455,203071,true,1517677376,28,1522541479,4864103
1667436467,203073,true,1517373886,28,1522541479,5167593
1667436539,203072,true,1517525623,28,1523150587,5624964
1667437007,203072,true,1517525623,28,1526810355,9284732
1667437283,203073,true,1517373886,28,1528490686,11116800
1667437391,203075,true,1517070457,28,1529102174,12031717
1667437583,203073,true,1517373886,28,1530019865,12645979
1667438135,203074,true,1517222164,28,1532776243,15554079
1667438207,203074,true,1517222164,28,1532929521,15707357
1667438303,203076,true,1516918765,28,1532929521,16010756
1667438435,203074,true,1517222164,28,1532929521,15707357
1667438879,203074,true,1517222164,28,1532776243,15554079
1667438963,203074,true,1517222164,28,1532929521,15707357
1667439047,203075,true,1517070457,28,1532929521,15859064
1667439731,203073,true,1517373886,28,1534156293,16782407
1667439743,203072,true,1517525623,28,1534156293,16630670
1667439755,203071,true,1517677376,28,1534309709,16632333
1667439791,203071,true,1517677376,28,1534309709,16632333
1667439971,203069,true,1517980926,28,1535077017,17096091
1667439995,203067,true,1518284538,28,1535230525,16945987
1667440067,203067,true,1518284538,28,1535384048,17099510
1667440079,203066,true,1518436366,28,1535537587,17101221
1667440403,203063,true,1518891943,28,1537073815,18181872
1667440667,203061,true,1519195736,28,1538611581,19415845
1667441255,203060,true,1519347656,28,1541075207,21727551
1667441279,203060,true,1519347656,28,1541075207,21727551
1667441339,203056,true,1519955486,28,1541383437,21427951
1667441471,203054,true,1520259492,28,1542154283,21894791
1667443211,203053,true,1520411518,28,1545241523,24830005
1667445239,203051,true,1520715616,28,1545241523,24525907
1667445731,203048,true,1521171876,28,1545241523,24069647
1667445743,203046,true,1521476126,28,1545396048,23919922
1667445791,203044,true,1521780436,28,1545396048,23615612
1667445803,203043,true,1521932614,28,1545396048,23463434
1667445815,203039,true,1522541479,28,1545550587,23009108
1667445947,203036,true,1522998287,28,1545859713,22861426
1667446895,203034,true,1523302902,28,1549419104,26116202
1667447795,203033,true,1523455232,28,1552055225,28599993
1667447903,203029,true,1524064705,28,1552055225,27990520
1667448263,203027,true,1524369534,28,1551900035,27530501
1667448515,203025,true,1524674423,28,1551744860,27070437
1667448803,203024,true,1524826890,28,1551744860,26917970
1667448887,203020,true,1525436912,28,1551900035,26463123
1667448899,203017,true,1525894589,28,1551900035,26005446
1667448983,203015,true,1526199783,28,1551900035,25700252
1667449151,203014,true,1526352403,28,1552210430,25858027
1667449727,203010,true,1526963036,28,1552831407,25868371
1667452703,203007,true,1527421171,28,1554074107,26652936
1667453159,203005,true,1527726670,28,1554074107,26347437
1667454707,203003,true,1528032231,28,1553452633,25420402
1667455547,202999,true,1528643535,28,1553297303,24653768
1667455619,202997,true,1528949279,28,1553297303,24348024
1667455631,202995,true,1529255084,28,1553297303,24042219
1667455751,202993,true,1529560951,28,1553297303,23736352
1667455775,202989,true,1530172867,28,1553297303,23124436
1667456771,202987,true,1530478917,28,1552365651,21886734
1667458235,202985,true,1530785028,28,1549574046,18789018
1667459579,202983,true,1531091200,28,1548954371,17863171
1667459591,202979,true,1531703729,28,1549109267,17405538
1667459723,202977,true,1532010085,28,1549109267,17099182
1667460611,202975,true,1532316502,28,1549729003,17412501
1667460647,202974,true,1532469734,28,1549883976,17414242
1667460659,202970,true,1533082813,28,1549883976,16801163
1667460863,202968,true,1533389445,28,1549883976,16494531
1667460923,202966,true,1533696139,28,1549883976,16187837
1667461691,202965,true,1533849508,28,1549419104,15569596
1667461715,202961,true,1534463140,28,1549419104,14955964
1667461835,202959,true,1534770048,28,1549264177,14494129
1667461919,202957,true,1535077017,28,1549109267,14032250
1667462027,202956,true,1535230525,28,1548954371,13723846
1667462579,202952,true,1535844709,28,1548025324,12180615
1667462687,202951,true,1535998294,28,1547870537,11872243
1667462831,202949,true,1536305509,28,1547715765,11410256
1667462927,202948,true,1536459139,28,1547561009,11101870
1667462951,202944,true,1537073815,28,1547561009,10487194
1667464127,202943,true,1537227523,28,1546168900,8941377
1667464403,202941,true,1537534984,28,1546014299,8479315
1667464427,202940,true,1537688737,28,1546014299,8325562
1667464463,202937,true,1538150090,28,1546014299,7864209
1667465411,202935,true,1538457735,28,1545087015,6629280
1667466215,202934,true,1538611581,28,1544469134,5857553
1667466239,202933,true,1538765442,28,1544469134,5703692
1667466515,202930,true,1539227118,28,1544623581,5396463
1667466647,202929,true,1539381041,28,1544778044,5397003
1667467811,202927,true,1539688932,28,1546014299,6325367
1667467919,202926,true,1539842901,28,1546168900,6325999
1667467931,202923,true,1540304900,28,1546168900,5864000
1667467955,202922,true,1540458931,28,1546168900,5709969
1667468015,202920,true,1540767038,28,1546323517,5556479
1667468027,202919,true,1540921115,28,1546323517,5402402
1667468075,202916,true,1541383437,28,1546478149,5094712
1667468111,202915,true,1541537576,28,1546478149,4940573
1667468759,202912,true,1542000083,28,1548489778,6489695
1667469839,202911,true,1542154283,28,1551744860,9590577
1667470151,202908,true,1542616976,28,1551744860,9127884
1667470475,202907,true,1542771237,28,1551744860,8973623
1667470883,202905,true,1543079807,28,1551744860,8665053
1667470931,202905,true,1543079807,28,1551744860,8665053
1667471027,202901,true,1543697131,28,1551744860,8047729
1667471063,202900,true,1543851501,28,1551744860,7893359
1667471111,202898,true,1544160287,28,1551744860,7584573
1667471123,202898,true,1544160287,28,1551744860,7584573
1667471135,202895,true,1544623581,28,1551744860,7121279
1667472299,202894,true,1544778044,28,1549729003,4950959
1667472395,202893,true,1544932522,28,1549574046,4641524
1667472503,202892,true,1545087015,28,1549419104,4332089
1667472515,202889,true,1545550587,28,1549419104,3868517
1667473295,202889,true,1545550587,28,1548180126,2629539
1667473643,202887,true,1545859713,28,1548025324,2165611
1667473895,202887,true,1545859713,28,1547715765,1856052
1667474171,202885,true,1546168900,28,1547251543,1082643
1667474219,202885,true,1546168900,28,1547251543,1082643
1667474255,202883,true,1546478149,28,1547096833,618684
1667474315,202883,true,1546478149,28,1546942139,463990
1667474339,202882,true,1546632797,28,1546942139,309342
1667474363,202882,true,1546632797,28,1546942139,309342
1667474375,202881,true,1546787461,28,1546942139,154678
1667474387,202881,true,1546787461,28,1546787461,0
1667474447,202879,true,1547096833,28,1546632797,-464036
1667474627,202880,true,1546942139,28,1546014299,-927840
1667474663,202879,true,1547096833,28,1545859713,-1237120
1667474675,202879,true,1547096833,28,1545859713,-1237120
1667475479,202878,true,1547251543,28,1542308498,-4943045
1667475551,202878,true,1547251543,28,1542000083,-5251460
1667475575,202877,true,1547406268,28,1542000083,-5406185
1667475587,202877,true,1547406268,28,1541845898,-5560370
1667475611,202877,true,1547406268,28,1541691729,-5714539
1667475635,202878,true,1547251543,28,1541537576,-5713967
1667475695,202877,true,1547406268,28,1541229314,-6176954
1667475707,202877,true,1547406268,28,1541229314,-6176954
1667475731,202878,true,1547251543,28,1541075207,-6176336
1667475851,202879,true,1547096833,28,1540304900,-6791933
1667475863,202878,true,1547251543,28,1540150885,-7100658
1667475959,202879,true,1547096833,28,1539534979,-7561854
1667476007,202879,true,1547096833,28,1539073211,-8023622
1667476019,202881,true,1546787461,28,1539073211,-7714250
1667476031,202881,true,1546787461,28,1538919319,-7868142
1667476055,202881,true,1546787461,28,1538765442,-8022019
1667476079,202882,true,1546632797,28,1538611581,-8021216
1667476115,202884,true,1546323517,28,1538303905,-8019612
1667476127,202884,true,1546323517,28,1538150090,-8173427
1667476139,202885,true,1546168900,28,1538150090,-8018810
1667476415,202886,true,1546014299,28,1535998294,-10016005
1667476439,202888,true,1545705142,28,1535844709,-9860433
1667476499,202888,true,1545705142,28,1535384048,-10321094
1667476703,202889,true,1545550587,28,1534309709,-11240878
1667477099,202891,true,1545241523,28,1532010085,-13231438
1667477147,202893,true,1544932522,28,1531856899,-13075623
1667477171,202893,true,1544932522,28,1531703729,-13228793
1667477219,202894,true,1544778044,28,1531550574,-13227470
1667477915,202895,true,1544623581,28,1531397434,-13226147
1667478023,202897,true,1544314703,28,1531703729,-12610974
1667478119,202897,true,1544314703,28,1532163286,-12151417
1667478143,202898,true,1544160287,28,1532163286,-11997001
1667478203,202899,true,1544005886,28,1532316502,-11689384
1667478215,202901,true,1543697131,28,1532469734,-11227397
1667478275,202902,true,1543542777,28,1532622981,-10919796
1667478431,202903,true,1543388438,28,1532776243,-10612195
1667478779,202904,true,1543234115,28,1533082813,-10151302
1667479019,202906,true,1542925514,28,1533082813,-9842701
1667479103,202907,true,1542771237,28,1532929521,-9841716
1667479139,202908,true,1542616976,28,1532929521,-9687455
1667479787,202909,true,1542462729,28,1531091200,-11371529
1667479811,202912,true,1542000083,28,1531091200,-10908883
1667479835,202913,true,1541845898,28,1530938106,-10907792
1667480555,202914,true,1541691729,28,1528949279,-12742450
1667480567,202915,true,1541537576,28,1528949279,-12588297
1667480675,202918,true,1541075207,28,1528643535,-12431672
1667480963,202918,true,1541075207,28,1528337852,-12737355
1667481035,202919,true,1540921115,28,1528185034,-12736081
1667481047,202920,true,1540767038,28,1528185034,-12582004
1667481203,202922,true,1540458931,28,1528185034,-12273897
1667482043,202922,true,1540458931,28,1529102174,-11356757
1667482439,202923,true,1540304900,28,1529713907,-10590993
1667482451,202925,true,1539996885,28,1529713907,-10282978
1667482475,202927,true,1539688932,28,1529713907,-9975025
1667482679,202927,true,1539688932,28,1530172867,-9516065
1667482847,202927,true,1539688932,28,1530478917,-9210015
1667482883,202929,true,1539381041,28,1530631965,-8749076
1667482895,202931,true,1539073211,28,1530631965,-8441246
1667483531,202930,true,1539227118,28,1532622981,-6604137
1667483543,202930,true,1539227118,28,1532776243,-6450875
1667483711,202932,true,1538919319,28,1532929521,-5989798
1667483759,202933,true,1538765442,28,1533082813,-5682629
1667483771,202933,true,1538765442,28,1533082813,-5682629
1667483783,202933,true,1538765442,28,1533082813,-5682629
1667483807,202935,true,1538457735,28,1533082813,-5374922
1667483951,202937,true,1538150090,28,1533082813,-5067277
1667483999,202937,true,1538150090,28,1533082813,-5067277
1667484275,202937,true,1538150090,28,1532929521,-5220569
1667484287,202939,true,1537842506,28,1532929521,-4912985
1667484407,202940,true,1537688737,28,1532929521,-4759216
1667484851,202940,true,1537688737,28,1532469734,-5219003
1667484863,202940,true,1537688737,28,1532469734,-5219003
1667484875,202941,true,1537534984,28,1532469734,-5065250
1667484887,202943,true,1537227523,28,1532469734,-4757789
1667484899,202942,true,1537381245,28,1532469734,-4911511
1667484911,202942,true,1537381245,28,1532622981,-4758264
1667484935,202943,true,1537227523,28,1532622981,-4604542
1667484971,202945,true,1536920123,28,1532776243,-4143880
1667485235,202943,true,1537227523,28,1533849508,-3378015
1667485307,202943,true,1537227523,28,1534156293,-3071230
1667485403,202945,true,1536920123,28,1534616586,-2303537
1667485523,202946,true,1536766447,28,1535384048,-1382399
1667485559,202945,true,1536920123,28,1535537587,-1382536
1667485583,202945,true,1536920123,28,1535844709,-1075414
1667485631,202946,true,1536766447,28,1536305509,-460938
1667485847,202947,true,1536612785,28,1538303905,1691120
1667486171,202946,true,1536766447,28,1541383437,4616990
1667486231,202946,true,1536766447,28,1541845898,5079451
1667486495,202947,true,1536612785,28,1544160287,7547502
1667486519,202948,true,1536459139,28,1544314703,7855564
1667486675,202947,true,1536612785,28,1545859713,9246928
1667486723,202947,true,1536612785,28,1546168900,9556115
1667486735,202948,true,1536459139,28,1546168900,9709761
1667486783,202948,true,1536459139,28,1546478149,10019010
1667486795,202946,true,1536766447,28,1546478149,9711702
1667486819,202946,true,1536766447,28,1546632797,9866350
1667486855,202947,true,1536612785,28,1546787461,10174676
1667486891,202947,true,1536612785,28,1546942139,10329354
1667486951,202945,true,1536920123,28,1547251543,10331420
1667487587,202945,true,1536920123,28,1549729003,12808880
1667488487,202946,true,1536766447,28,1551900035,15133588
1667488499,202946,true,1536766447,28,1551900035,15133588
1667488595,202944,true,1537073815,28,1551900035,14826220
1667488631,202944,true,1537073815,28,1551900035,14826220
1667488643,202944,true,1537073815,28,1551900035,14826220
1667488703,202945,true,1536920123,28,1551744860,14824737
1667489135,202943,true,1537227523,28,1550969220,13741697
1667489351,202943,true,1537227523,28,1550504023,13276500
1667489363,202943,true,1537227523,28,1550504023,13276500
1667489483,202943,true,1537227523,28,1550193968,12966445
1667489531,202942,true,1537381245,28,1549883976,12502731
1667489555,202942,true,1537381245,28,1549883976,12502731
1667489591,202942,true,1537381245,28,1549729003,12347758
1667489603,202942,true,1537381245,28,1549574046,12192801
1667489687,202941,true,1537534984,28,1549264177,11729193
1667489735,202941,true,1537534984,28,1548954371,11419387
1667489771,202941,true,1537534984,28,1548644627,11109643
1667490383,202941,true,1537534984,28,1544778044,7243060
1667490395,202940,true,1537688737,28,1544623581,6934844
1667491679,202940,true,1537688737,28,1541075207,3386470
1667491859,202940,true,1537688737,28,1541229314,3540577
1667492147,202940,true,1537688737,28,1541537576,3848839
1667492243,202938,true,1537996290,28,1541691729,3695439
1667492279,202938,true,1537996290,28,1541691729,3695439
1667492675,202938,true,1537996290,28,1542000083,4003793
1667493815,202937,true,1538150090,28,1542925514,4775424
1667493971,202936,true,1538303905,28,1542925514,4621609
1667493995,202935,true,1538457735,28,1542925514,4467779
1667494139,202935,true,1538457735,28,1542925514,4467779
1667494331,202935,true,1538457735,28,1542925514,4467779
1667494355,202933,true,1538765442,28,1542925514,4160072
1667494439,202932,true,1538919319,28,1542925514,4006195
1667494571,202932,true,1538919319,28,1543079807,4160488
1667494907,202931,true,1539073211,28,1543388438,4315227
1667497967,202929,true,1539381041,28,1544469134,5088093
1667498123,202929,true,1539381041,28,1544469134,5088093
1667498747,202928,true,1539534979,28,1544469134,4934155
1667499179,202927,true,1539688932,28,1544314703,4625771
1667502287,202926,true,1539842901,28,1542925514,3082613
1667502767,202926,true,1539842901,28,1543079807,3236906
1667503163,202926,true,1539842901,28,1543079807,3236906
1667504423,202925,true,1539996885,28,1543079807,3082922
1667505419,202924,true,1540150885,28,1543079807,2928922
1667505431,202924,true,1540150885,28,1543079807,2928922
1667506787,202924,true,1540150885,28,1543079807,2928922
1667506883,202923,true,1540304900,28,1543079807,2774907
1667507111,202922,true,1540458931,28,1543079807,2620876
1667508119,202921,true,1540612977,28,1543079807,2466830
1667509331,202921,true,1540612977,28,1543079807,2466830
1667509403,202921,true,1540612977,28,1543079807,2466830
1667509487,202919,true,1540921115,28,1543079807,2158692
1667509535,202918,true,1541075207,28,1543079807,2004600
1667509643,202918,true,1541075207,28,1543079807,2004600
1667509871,202918,true,1541075207,28,1543079807,2004600
1667509967,202916,true,1541383437,28,1543079807,1696370
1667510411,202915,true,1541537576,28,1543079807,1542231
1667511455,202915,true,1541537576,28,1542925514,1387938
1667511947,202914,true,1541691729,28,1542925514,1233785
1667513135,202912,true,1542000083,28,1542925514,925431
1667513483,202912,true,1542000083,28,1542925514,925431
1667513591,202911,true,1542154283,28,1542925514,771231
1667513615,202911,true,1542154283,28,1542925514,771231
1667513675,202910,true,1542308498,28,1542771237,462739
1667513699,202909,true,1542462729,28,1542771237,308508
1667513831,202909,true,1542462729,28,1542616976,154247
1667513939,202909,true,1542462729,28,1542000083,-462646
1667513951,202908,true,1542616976,28,1542000083,-616893
1667513963,202908,true,1542616976,28,1541845898,-771078
1667513975,202909,true,1542462729,28,1541845898,-616831
1667514035,202909,true,1542462729,28,1541383437,-1079292
1667514179,202909,true,1542462729,28,1540304900,-2157829
1667514407,202909,true,1542462729,28,1538457735,-4004994
1667514431,202910,true,1542308498,28,1538303905,-4004593
1667514455,202911,true,1542154283,28,1538150090,-4004193
1667514467,202910,true,1542308498,28,1538150090,-4158408
1667514479,202910,true,1542308498,28,1537996290,-4312208
1667514503,202910,true,1542308498,28,1537842506,-4465992
1667515619,202910,true,1542308498,28,1532163286,-10145212
1667515811,202910,true,1542308498,28,1532163286,-10145212
1667516903,202909,true,1542462729,28,1533082813,-9379916
1667517275,202909,true,1542462729,28,1533082813,-9379916
1667517299,202909,true,1542462729,28,1533082813,-9379916
1667517311,202909,true,1542462729,28,1533082813,-9379916
1667517383,202909,true,1542462729,28,1533082813,-9379916
1667517395,202910,true,1542308498,28,1533082813,-9225685
1667517527,202910,true,1542308498,28,1532776243,-9532255
1667517563,202910,true,1542308498,28,1532776243,-9532255
1667517695,202911,true,1542154283,28,1532469734,-9684549
1667517767,202912,true,1542000083,28,1532316502,-9683581
1667518859,202912,true,1542000083,28,1530172867,-11827216
1667518979,202913,true,1541845898,28,1529866878,-11979020
1667519675,202914,true,1541691729,28,1529408010,-12283719
1667521175,202915,true,1541537576,28,1529408010,-12129566
1667521211,202916,true,1541383437,28,1529560951,-11822486
1667521235,202917,true,1541229314,28,1529560951,-11668363
1667521247,202917,true,1541229314,28,1529560951,-11668363
1667521343,202918,true,1541075207,28,1529713907,-11361300
1667521391,202919,true,1540921115,28,1529866878,-11054237
1667521403,202920,true,1540767038,28,1529866878,-10900160
1667521751,202920,true,1540767038,28,1530938106,-9828932
1667521787,202921,true,1540612977,28,1531091200,-9521777
1667522123,202922,true,1540458931,28,1532163286,-8295645
1667522639,202923,true,1540304900,28,1534002893,-6302007
1667523491,202923,true,1540304900,28,1535691140,-4613760
1667523635,202924,true,1540150885,28,1535691140,-4459745
1667523887,202925,true,1539996885,28,1535691140,-4305745
1667523899,202926,true,1539842901,28,1535844709,-3998192
1667523923,202927,true,1539688932,28,1535844709,-3844223
1667523935,202927,true,1539688932,28,1535844709,-3844223
1667523983,202928,true,1539534979,28,1535844709,-3690270
1667524127,202929,true,1539381041,28,1536151894,-3229147
1667524283,202930,true,1539227118,28,1536305509,-2921609
1667524799,202930,true,1539227118,28,1537073815,-2153303
1667527211,202931,true,1539073211,28,1538457735,-615476
1667527871,202932,true,1538919319,28,1538457735,-461584
1667528123,202933,true,1538765442,28,1538457735,-307707
1667528279,202933,true,1538765442,28,1538611581,-153861
1667528543,202934,true,1538611581,28,1538611581,0
1667528687,202935,true,1538457735,28,1538611581,153846
1667528735,202935,true,1538457735,28,1538611581,153846
1667528795,202935,true,1538457735,28,1538611581,153846
1667528963,202936,true,1538303905,28,1538765442,461537
1667529407,202937,true,1538150090,28,1538765442,615352
1667531435,202937,true,1538150090,28,1538765442,615352
1667531483,202937,true,1538150090,28,1538765442,615352
1667532179,202937,true,1538150090,28,1538765442,615352
1667532551,202938,true,1537996290,28,1538765442,769152
1667532671,202937,true,1538150090,28,1538765442,615352
1667532719,202938,true,1537996290,28,1538765442,769152
1667532743,202938,true,1537996290,28,1538919319,923029
1667532863,202938,true,1537996290,28,1538919319,923029
1667532875,202938,true,1537996290,28,1538919319,923029
1667533163,202938,true,1537996290,28,1539381041,1384751
1667533439,202938,true,1537996290,28,1539842901,1846611
1667533487,202938,true,1537996290,28,1539842901,1846611
1667533511,202938,true,1537996290,28,1539996885,2000595
1667533523,202938,true,1537996290,28,1539996885,2000595
1667533607,202938,true,1537996290,28,1540150885,2154595
1667533667,202938,true,1537996290,28,1540304900,2308610
1667533871,202938,true,1537996290,28,1541075207,3078917
1667534099,202937,true,1538150090,28,1541845898,3695808
1667534459,202937,true,1538150090,28,1543079807,4929717
1667534495,202937,true,1538150090,28,1543234115,5084025
1667536343,202937,true,1538150090,28,1545087015,6936925
1667536355,202937,true,1538150090,28,1545241523,7091433
1667536451,202937,true,1538150090,28,1545241523,7091433
1667536547,202937,true,1538150090,28,1545241523,7091433
1667536631,202937,true,1538150090,28,1545396048,7245958
1667536703,202937,true,1538150090,28,1545396048,7245958
1667539343,202937,true,1538150090,28,1546632797,8482707
1667539583,202936,true,1538303905,28,1546787461,8483556
1667539751,202936,true,1538303905,28,1546942139,8638234
1667540663,202936,true,1538303905,28,1547561009,9257104
1667540711,202935,true,1538457735,28,1547561009,9103274
1667540807,202935,true,1538457735,28,1547715765,9258030
1667540939,202935,true,1538457735,28,1547870537,9412802
1667541011,202934,true,1538611581,28,1548025324,9413743
1667541059,202934,true,1538611581,28,1548025324,9413743
1667541071,202934,true,1538611581,28,1548180126,9568545
1667541083,202933,true,1538765442,28,1548180126,9414684
1667541095,202932,true,1538919319,28,1548334944,9415625
1667541131,202931,true,1539073211,28,1548489778,9416567
1667541143,202931,true,1539073211,28,1548489778,9416567
1667541155,202930,true,1539227118,28,1548644627,9417509
1667541215,202928,true,1539534979,28,1549109267,9574288
1667541779,202927,true,1539688932,28,1553141989,13453057
1667541815,202926,true,1539842901,28,1553452633,13609732
1667541851,202925,true,1539996885,28,1553763339,13766454
1667541899,202924,true,1540150885,28,1554074107,13923222
1667542055,202922,true,1540458931,28,1555628881,15169950
1667542091,202922,true,1540458931,28,1555940022,15481091
1667542235,202920,true,1540767038,28,1557340929,16573891
1667542247,202919,true,1540921115,28,1557340929,16419814
1667542271,202917,true,1541229314,28,1557652412,16423098
1667542655,202916,true,1541383437,28,1561395081,20011644
1667542799,202915,true,1541537576,28,1562644634,21107058
1667542811,202913,true,1541845898,28,1562800898,20955000
1667542835,202911,true,1542154283,28,1563113474,20959191
1667542847,202910,true,1542308498,28,1563113474,20804976
1667542919,202908,true,1542616976,28,1563738813,21121837
1667542931,202905,true,1543079807,28,1563738813,20659006
1667542955,202902,true,1543542777,28,1563895187,20352410
1667542979,202900,true,1543851501,28,1564051577,20200076
1667542991,202898,true,1544160287,28,1564207982,20047695
1667543003,202896,true,1544469134,28,1564207982,19738848
1667543015,202892,true,1545087015,28,1564364403,19277388
1667543435,202890,true,1545396048,28,1567496106,22100058
1667543483,202888,true,1545705142,28,1567809620,22104478
1667543531,202886,true,1546014299,28,1568280010,22265711
1667543555,202882,true,1546632797,28,1568436838,21804041
1667543579,202880,true,1546942139,28,1568750541,21808402
1667543603,202878,true,1547251543,28,1568907417,21655874
1667543615,202876,true,1547561009,28,1569064307,21503298
1667543639,202872,true,1548180126,28,1569221214,21041088
1667544599,202869,true,1548644627,28,1578664370,30019743
1667544671,202867,true,1548954371,28,1579295930,30341559
1667544803,202864,true,1549419104,28,1580085736,30666632
1667546111,202860,true,1550038965,28,1582299295,32260330
1667546255,202857,true,1550504023,28,1582141081,31637058
1667546327,202855,true,1550814139,28,1582141081,31326942
1667546399,202852,true,1551279430,28,1581982882,30703452
1667546435,202848,true,1551900035,28,1581982882,30082847
1667546507,202845,true,1552365651,28,1581982882,29617231
1667546711,202843,true,1552676140,28,1581666533,28990393
1667547107,202840,true,1553141989,28,1581192128,28050139
1667547131,202837,true,1553607978,28,1581034025,27426047
1667547623,202834,true,1554074107,28,1580085736,26011629
1667548151,202832,true,1554384938,28,1578980119,24595181
1667548235,202830,true,1554695830,28,1578980119,24284289
1667548283,202826,true,1555317802,28,1578980119,23662317
1667548331,202824,true,1555628881,28,1578980119,23351238
1667548391,202821,true,1556095616,28,1578980119,22884503
1667548487,202819,true,1556406851,28,1579138017,22731166
1667548535,202816,true,1556873820,28,1579138017,22264197
1667548715,202813,true,1557340929,28,1579453860,22112931
1667548835,202811,true,1557652412,28,1579769767,22117355
1667548895,202808,true,1558119755,28,1579769767,21650012
1667549735,202805,true,1558587238,28,1582299295,23712057
1667550803,202802,true,1559054861,28,1584357519,25302658
1667551667,202799,true,1559522624,28,1584674406,25151782
1667552219,202797,true,1559834544,28,1584674406,24839862
1667552243,202794,true,1560302541,28,1584674406,24371865
1667552279,202791,true,1560770679,28,1584674406,23903727
1667552903,202789,true,1561082848,28,1584357519,23274671
1667552915,202787,true,1561395081,28,1584199099,22804018
1667553011,202784,true,1561863546,28,1584199099,22335553
1667553059,202781,true,1562332152,28,1584040695,21708543
1667553803,202780,true,1562488385,28,1581824700,19336315
1667553935,202777,true,1562957178,28,1581350247,18393069
1667554607,202774,true,1563426112,28,1579769767,16343655
1667554907,202772,true,1563738813,28,1579138017,15399204
1667554919,202770,true,1564051577,28,1579295930,15244353
1667554943,202768,true,1564364403,28,1579295930,14931527
1667555843,202765,true,1564833759,28,1579769767,14936008
1667556563,202762,true,1565303256,28,1580085736,14782480
1667557667,202761,true,1565459786,28,1580085736,14625950
1667558903,202759,true,1565772894,28,1580085736,14312842
1667559167,202755,true,1566399297,28,1580085736,13686439
1667559203,202753,true,1566712593,28,1580085736,13373143
1667559431,202751,true,1567025951,28,1580243745,13217794
1667559443,202749,true,1567339372,28,1580243745,12904373
1667559455,202746,true,1567809620,28,1580401769,12592149
1667559467,202743,true,1568280010,28,1580401769,12121759
1667559503,202741,true,1568593682,28,1580559809,11966127
1667559515,202739,true,1568907417,28,1580559809,11652392
1667559791,202734,true,1569692027,28,1582774032,13082005
1667559803,202731,true,1570162982,28,1582774032,12611050
1667560067,202729,true,1570477030,28,1584515954,14038924
1667560079,202727,true,1570791141,28,1584674406,13883265
1667560163,202723,true,1571419552,28,1585149856,13730304
1667560259,202720,true,1571891025,28,1585784011,13892986
1667561267,202719,true,1572048214,28,1591502835,19454621
1667561783,202716,true,1572519876,28,1590866393,18346517
1667561819,202712,true,1573148978,28,1590866393,17717415
1667561855,202710,true,1573463624,28,1590866393,17402769
1667561927,202708,true,1573778332,28,1590707322,16928990
1667561939,202706,true,1574093103,28,1590707322,16614219
1667561963,202702,true,1574722835,28,1590548267,15825432
1667562215,202700,true,1575037795,28,1590071198,15033403
1667562239,202699,true,1575195299,28,1589912207,14716908
1667562371,202697,true,1575510354,28,1589594272,14083918
1667562395,202693,true,1576140653,28,1589594272,13453619
1667562431,202691,true,1576455897,28,1589435329,12979432
1667562491,202690,true,1576613542,28,1589276401,12662859
1667562575,202688,true,1576928881,28,1588958594,12029713
1667562611,202685,true,1577402007,28,1588958594,11556587
1667562647,202683,true,1577717503,28,1588799714,11082211
1667562671,202682,true,1577875275,28,1588640850,10765575
1667562683,202680,true,1578190865,28,1588640850,10449985
1667562719,202677,true,1578664370,28,1588482001,9817631
1667562971,202676,true,1578822236,28,1587211787,8389551
1667563367,202675,true,1578980119,28,1585149856,6169737
1667563487,202674,true,1579138017,28,1584515954,5377937
1667563511,202671,true,1579611805,28,1584357519,4745714
1667563631,202670,true,1579769767,28,1583407237,3637470
1667563655,202670,true,1579769767,28,1583248912,3479145
1667563679,202670,true,1579769767,28,1583090603,3320836
1667564231,202668,true,1580085736,28,1578822236,-1263500
1667564987,202667,true,1580243745,28,1574407938,-5835807
1667565011,202667,true,1580243745,28,1574407938,-5835807
1667565119,202667,true,1580243745,28,1573463624,-6780121
1667565131,202666,true,1580401769,28,1573306293,-7095476
1667565143,202667,true,1580243745,28,1573306293,-6937452
1667565155,202667,true,1580243745,28,1573306293,-6937452
1667565167,202665,true,1580559809,28,1573148978,-7410831
1667565251,202662,true,1581034025,28,1573463624,-7570401
1667565359,202662,true,1581034025,28,1573778332,-7255693
1667565383,202662,true,1581034025,28,1573935710,-7098315
1667565407,202661,true,1581192128,28,1574093103,-7099025
1667565527,202657,true,1581824700,28,1575352819,-6471881
1667565539,202657,true,1581824700,28,1575510354,-6314346
1667565611,202656,true,1581982882,28,1576613542,-5369340
1667565683,202654,true,1582299295,28,1577559747,-4739548
1667565743,202650,true,1582932309,28,1578506519,-4425790
1667565767,202650,true,1582932309,28,1578822236,-4110073
1667565827,202650,true,1582932309,28,1579769767,-3162542
1667565839,202648,true,1583248912,28,1579927744,-3321168
1667565911,202645,true,1583723934,28,1580717865,-3006069
1667566019,202645,true,1583723934,28,1582141081,-1582853
1667566055,202645,true,1583723934,28,1582615771,-1108163
1667566067,202643,true,1584040695,28,1582774032,-1266663
1667566475,202640,true,1584515954,28,1588640850,4124896
1667566703,202640,true,1584515954,28,1591821152,7305198
1667566727,202640,true,1584515954,28,1592139532,7623578
1667566739,202639,true,1584674406,28,1592457976,7783570
1667566763,202635,true,1585308371,28,1592776483,7468112
1667566775,202636,true,1585149856,28,1592935761,7785905
1667566799,202636,true,1585149856,28,1593413689,8263833
1667566823,202634,true,1585466902,28,1593891761,8424859
1667566847,202630,true,1586101183,28,1594369976,8268793
1667566883,202630,true,1586101183,28,1595326838,9225655
1667566919,202630,true,1586101183,28,1596124661,10023478
1667566943,202628,true,1586418420,28,1596763206,10344786
1667566955,202624,true,1587053082,28,1596922883,9869801
1667567231,202623,true,1587211787,28,1601080076,13868289
1667567795,202623,true,1587211787,28,1606211482,18999695
1667567807,202620,true,1587687999,28,1606372103,18684104
1667567855,202616,true,1588323169,28,1606854063,18530894
1667567939,202615,true,1588482001,28,1607657650,19175649
1667568491,202614,true,1588640850,28,1613294028,24653178
1667568527,202612,true,1588958594,28,1613616703,24658109
1667568539,202608,true,1589594272,28,1613778065,24183793
1667568611,202607,true,1589753232,28,1614423673,24670441
1667568839,202605,true,1590071198,28,1615554109,25482911
1667569247,202604,true,1590230206,28,1616523683,26293477
1667569283,202599,true,1591025480,28,1616685336,25659856
1667569295,202599,true,1591025480,28,1616685336,25659856
1667569403,202598,true,1591184582,28,1617008689,25824107
1667569475,202596,true,1591502835,28,1617170390,25667555
1667569499,202592,true,1592139532,28,1617170390,25030858
1667569511,202591,true,1592298746,28,1617170390,24871644
1667569547,202591,true,1592298746,28,1617170390,24871644
1667569727,202589,true,1592617221,28,1617170390,24553169
1667569787,202585,true,1593254364,28,1617008689,23754325
1667569799,202585,true,1593254364,28,1617008689,23754325
1667569871,202584,true,1593413689,28,1616847004,23433315
1667570267,202583,true,1593573031,28,1615715664,22142633
1667570279,202579,true,1594210555,28,1615715664,21505109
1667570363,202579,true,1594210555,28,1615392569,21182014
1667570387,202577,true,1594529413,28,1615231046,20701633
1667570399,202576,true,1594688866,28,1615231046,20542180
1667570411,202572,true,1595326838,28,1615231046,19904208
1667570591,202571,true,1595486370,28,1614585115,19098745
1667570783,202569,true,1595805484,28,1614100837,18295353
1667570795,202568,true,1595965064,28,1613939443,17974379
1667571011,202564,true,1596603546,28,1613455358,16851812
1667571023,202564,true,1596603546,28,1613455358,16851812
1667571035,202562,true,1596922883,28,1613455358,16532475
1667571107,202561,true,1597082575,28,1613294028,16211453
1667571119,202557,true,1597721504,28,1613294028,15572524
1667571167,202556,true,1597881276,28,1613294028,15412752
1667571179,202554,true,1598200868,28,1613294028,15093160
1667571203,202552,true,1598520524,28,1613294028,14773504
1667571215,202548,true,1599160028,28,1613455358,14295330
1667571239,202546,true,1599479876,28,1613616703,14136827
1667571287,202544,true,1599799788,28,1613939443,14139655
1667571299,202543,true,1599959768,28,1614100837,14141069
1667571311,202540,true,1600439804,28,1614262247,13822443
1667571383,202537,true,1600919984,28,1614908049,13988065
1667571407,202535,true,1601240184,28,1615231046,13990862
1667571419,202534,true,1601400308,28,1615392569,13992261
1667571431,202530,true,1602040964,28,1615554109,13513145
1667571515,202527,true,1602521625,28,1616847004,14325379
1667571731,202524,true,1603002429,28,1620569846,17567417
1667571743,202522,true,1603323046,28,1620731903,17408857
1667571767,202519,true,1603804091,28,1621218171,17414080
1667571779,202515,true,1604445709,28,1621380293,16934584
1667571791,202512,true,1604927091,28,1621704585,16777494
1667571803,202510,true,1605248092,28,1621866756,16618664
1667571815,202505,true,1606050877,28,1622191145,16140268
1667571827,202500,true,1606854063,28,1622515600,15661537
1667571839,202496,true,1607496901,28,1622840119,15343218
1667571875,202493,true,1607979198,28,1623976448,15997250
1667571887,202488,true,1608783348,28,1624301260,15517912
1667571899,202482,true,1609748860,28,1624788599,15039739
1667571935,202478,true,1610392856,28,1625926292,15533436
1667571947,202475,true,1610876022,28,1626251493,15375471
1667571959,202470,true,1611681621,28,1626576760,14895139
1667571971,202465,true,1612487623,28,1626902092,14414469
1667571995,202461,true,1613132715,28,1627552950,14420235
1667572019,202457,true,1613778065,28,1628366889,14588824
1667572055,202452,true,1614585115,28,1629344154,14759039
1667572067,202447,true,1615392569,28,1629670039,14277470
1667572079,202443,true,1616038823,28,1629995989,13957166
1667572283,202440,true,1616523683,28,1635383591,18859908
1667572883,202435,true,1617332107,28,1650827899,33495792
1667572895,202429,true,1618302749,28,1651158081,32855332
1667572943,202425,true,1618950167,28,1652314239,33364072
1667573291,202421,true,1619597844,28,1658107181,38509337
1667573339,202415,true,1620569846,28,1658604663,38034817
1667573855,202410,true,1621380293,28,1660762143,39381850
1667574563,202405,true,1622191145,28,1661592690,39401545
1667574587,202401,true,1622840119,28,1661592690,38752571
1667574731,202396,true,1623651701,28,1661426547,37774846
1667574743,202389,true,1624788599,28,1661426547,36637948
1667574827,202385,true,1625438612,28,1661094312,35655700
1667574839,202383,true,1625763716,28,1661094312,35330596
1667574851,202380,true,1626251493,28,1661094312,34842819
1667574911,202374,true,1627227488,28,1660596083,33368595
1667574983,202371,true,1627715705,28,1660098004,32382299
1667575619,202369,true,1628041265,28,1655787571,27746306
1667576351,202366,true,1628529726,28,1650827899,22298173
1667576387,202361,true,1629344154,28,1650497783,21153629
1667576399,202359,true,1629670039,28,1650497783,20827744
1667576423,202357,true,1629995989,28,1650332750,20336761
1667576435,202355,true,1630322005,28,1650332750,20010745
1667576447,202350,true,1631137329,28,1650167733,19030404
1667576495,202349,true,1631300442,28,1649837749,18537307
1667576543,202347,true,1631626719,28,1649507831,17881112
1667576567,202345,true,1631953061,28,1649342897,17389836
1667576579,202340,true,1632769200,28,1649342897,16573697
1667576603,202338,true,1633095770,28,1649013078,15917308
1667576687,202337,true,1633259080,28,1648518473,15259393
1667576807,202336,true,1633422406,28,1647859230,14436824
1667577107,202330,true,1634402704,28,1646212277,11809573
1667577119,202329,true,1634566145,28,1646047672,11481527
1667577143,202328,true,1634729601,28,1646047672,11318071
1667577167,202327,true,1634893074,28,1645718512,10825438
1667577191,202323,true,1635547130,28,1645553957,10006827
1667577203,202321,true,1635874255,28,1645553957,9679702
1667577215,202321,true,1635874255,28,1645389418,9515163
1667577227,202320,true,1636037843,28,1645224895,9187052
1667577347,202317,true,1636528703,28,1644073698,7544995
1667577503,202316,true,1636692356,28,1642594771,5902415
1667577575,202316,true,1636692356,28,1641773720,5081364
1667577587,202315,true,1636856025,28,1641609559,4753534
1667577791,202313,true,1637183413,28,1639476960,2293547
1667577803,202312,true,1637347131,28,1639313029,1965898
1667577815,202312,true,1637347131,28,1639149114,1801983
1667577839,202312,true,1637347131,28,1638821333,1474202
1667577923,202311,true,1637510866,28,1637510866,0
1667577983,202311,true,1637510866,28,1636528703,-982163
1667577995,202311,true,1637510866,28,1636365067,-1145799
1667578007,202311,true,1637510866,28,1636037843,-1473023
1667578067,202311,true,1637510866,28,1635056564,-2454302
1667578127,202312,true,1637347131,28,1633749107,-3598024
1667578151,202312,true,1637347131,28,1633259080,-4088051
1667578175,202312,true,1637347131,28,1632932477,-4414654
1667578187,202312,true,1637347131,28,1632605940,-4741191
1667578199,202313,true,1637183413,28,1632442695,-4740718
1667578211,202312,true,1637347131,28,1632279467,-5067664
1667578427,202311,true,1637510866,28,1629344154,-8166712
1667578535,202311,true,1637510866,28,1628204069,-9306797
1667578607,202312,true,1637347131,28,1627390211,-9956920
1667578643,202311,true,1637510866,28,1627064782,-10446084
1667578655,202310,true,1637674617,28,1626902092,-10772525
1667578667,202309,true,1637838385,28,1626739418,-11098967
1667578679,202310,true,1637674617,28,1626576760,-11097857
1667578739,202308,true,1638002168,28,1626088885,-11913283
1667579075,202307,true,1638165969,28,1623814067,-14351902
1667579111,202307,true,1638165969,28,1623651701,-14514268
1667579123,202307,true,1638165969,28,1623651701,-14514268
1667579135,202305,true,1638493618,28,1623651701,-14841917
1667579699,202304,true,1638657468,28,1621542431,-17115037
1667579987,202304,true,1638657468,28,1622840119,-15817349
1667580071,202305,true,1638493618,28,1623002403,-15491215
1667580419,202303,true,1638821333,28,1623164703,-15656630
1667580575,202302,true,1638985215,28,1623002403,-15982812
1667580611,202303,true,1638821333,28,1622840119,-15981214
1667580767,202303,true,1638821333,28,1622353364,-16467969
1667580863,202302,true,1638985215,28,1622028942,-16956273
1667581343,202301,true,1639149114,28,1621218171,-17930943
1667581571,202302,true,1638985215,28,1620731903,-18253312
1667581583,202302,true,1638985215,28,1620731903,-18253312
1667581763,202302,true,1638985215,28,1620245781,-18739434
1667581775,202302,true,1638985215,28,1620245781,-18739434
1667581787,202303,true,1638821333,28,1620245781,-18575552
1667581799,202304,true,1638657468,28,1620245781,-18411687
1667581907,202304,true,1638657468,28,1619921780,-18735688
1667582363,202304,true,1638657468,28,1619435901,-19221567
1667582975,202306,true,1638329785,28,1619273973,-19055812
1667584127,202307,true,1638165969,28,1619112062,-19053907
1667584139,202307,true,1638165969,28,1619273973,-18891996
1667584175,202307,true,1638165969,28,1619273973,-18891996
1667584331,202310,true,1637674617,28,1619435901,-18238716
1667584403,202312,true,1637347131,28,1619597844,-17749287
1667584427,202312,true,1637347131,28,1619597844,-17749287
1667584511,202312,true,1637347131,28,1619921780,-17425351
1667585219,202315,true,1636856025,28,1621542431,-15313594
1667585267,202316,true,1636692356,28,1621704585,-14987771
1667585351,202317,true,1636528703,28,1621866756,-14661947
1667585459,202318,true,1636365067,28,1622028942,-14336125
1667586239,202321,true,1635874255,28,1622840119,-13034136
1667586383,202324,true,1635383591,28,1623002403,-12381188
1667586395,202326,true,1635056564,28,1623002403,-12054161
1667586407,202327,true,1634893074,28,1623002403,-11890671
1667586431,202331,true,1634239280,28,1623002403,-11236877
1667586455,202333,true,1633912482,28,1623002403,-10910079
1667586467,202335,true,1633585748,28,1623002403,-10583345
1667586491,202336,true,1633422406,28,1623164703,-10257703
1667586503,202339,true,1632932477,28,1623164703,-9767774
1667586515,202341,true,1632605940,28,1623164703,-9441237
1667586527,202343,true,1632279467,28,1623164703,-9114764
1667587115,202343,true,1632279467,28,1626088885,-6190582
1667587151,202346,true,1631789882,28,1626251493,-5538389
1667587211,202348,true,1631463573,28,1626739418,-4724155
1667587331,202349,true,1631300442,28,1627390211,-3910231
1667587367,202348,true,1631463573,28,1627715705,-3747868
1667587403,202352,true,1630811150,28,1627878477,-2932673
1667587415,202353,true,1630648085,28,1628041265,-2606820
1667587451,202354,true,1630485037,28,1628204069,-2280968
1667587475,202354,true,1630485037,28,1628529726,-1955311
1667587487,202357,true,1629995989,28,1628529726,-1466263
1667587595,202358,true,1629833006,28,1629670039,-162967
1667587619,202359,true,1629670039,28,1629833006,162967
1667587643,202359,true,1629670039,28,1629995989,325950
1667587655,202361,true,1629344154,28,1630158989,814835
1667587895,202362,true,1629181236,28,1632932477,3751241
1667588015,202362,true,1629181236,28,1634239280,5058044
1667588099,202362,true,1629181236,28,1635220069,6038833
1667588675,202364,true,1628855448,28,1639149114,10293666
1667588723,202363,true,1629018334,28,1639476960,10458626
1667588867,202364,true,1628855448,28,1640296863,11441415
1667589155,202363,true,1629018334,28,1641773720,12755386
1667589467,202366,true,1628529726,28,1642430528,13900802
1667589755,202365,true,1628692579,28,1642430528,13737949
1667589767,202365,true,1628692579,28,1642430528,13737949
1667589827,202364,true,1628855448,28,1642266302,13410854
1667589923,202367,true,1628366889,28,1642266302,13899413
1667591063,202366,true,1628529726,28,1640953080,12423354
1667591075,202366,true,1628529726,28,1640953080,12423354
1667591207,202365,true,1628692579,28,1640953080,12260501
1667591423,202368,true,1628204069,28,1640789001,12584932
1667591999,202367,true,1628366889,28,1641281287,12914398
1667592023,202366,true,1628529726,28,1641281287,12751561
1667592095,202365,true,1628692579,28,1641445415,12752836
1667592371,202367,true,1628366889,28,1641937898,13571009
1667592431,202366,true,1628529726,28,1642102092,13572366
1667593607,202365,true,1628692579,28,1644566970,15874391
1667595395,202364,true,1628855448,28,1644895899,16040451
1667595479,202365,true,1628692579,28,1644731426,16038847
1667595671,202364,true,1628855448,28,1644731426,15875978
1667595911,202363,true,1629018334,28,1644731426,15713092
1667595971,202361,true,1629344154,28,1644731426,15387272
1667596379,202362,true,1629181236,28,1644731426,15550190
1667596979,202361,true,1629344154,28,1644731426,15387272
1667597963,202360,true,1629507088,28,1644731426,15224338
1667598323,202358,true,1629833006,28,1644731426,14898420
1667598827,202359,true,1629670039,28,1644731426,15061387
1667598887,202358,true,1629833006,28,1644731426,14898420
1667599283,202357,true,1629995989,28,1644895899,14899910
1667599295,202355,true,1630322005,28,1644895899,14573894
1667599307,202354,true,1630485037,28,1644895899,14410862
1667599319,202352,true,1630811150,28,1644895899,14084749
1667599379,202351,true,1630974231,28,1645060389,14086158
1667599439,202349,true,1631300442,28,1645224895,13924453
1667599535,202348,true,1631463573,28,1645389418,13925845
1667599847,202345,true,1631953061,28,1646212277,14259216
1667600171,202343,true,1632279467,28,1646870861,14591394
1667601119,202341,true,1632605940,28,1648848193,16242253
1667601527,202340,true,1632769200,28,1648848193,16078993
1667602379,202338,true,1633095770,28,1648848193,15752423
1667602487,202336,true,1633422406,28,1648848193,15425787
1667603747,202335,true,1633585748,28,1648848193,15262445
1667604839,202334,true,1633749107,28,1648848193,15099086
1667605175,202331,true,1634239280,28,1648848193,14608913
1667605187,202330,true,1634402704,28,1648848193,14445489
1667605199,202329,true,1634566145,28,1648848193,14282048
1667605295,202328,true,1634729601,28,1648848193,14118592
1667605427,202326,true,1635056564,28,1648683325,13626761
1667605451,202325,true,1635220069,28,1648683325,13463256
1667605655,202324,true,1635383591,28,1648518473,13134882
1667605691,202323,true,1635547130,28,1648353637,12806507
1667606135,202321,true,1635874255,28,1647859230,11984975
1667606723,202320,true,1636037843,28,1647200251,11162408
1667606747,202319,true,1636201447,28,1647200251,10998804
1667606759,202318,true,1636365067,28,1647200251,10835184
1667606795,202316,true,1636692356,28,1647035548,10343192
1667606819,202315,true,1636856025,28,1647035548,10179523
1667606951,202314,true,1637019711,28,1646541536,9521825
1667606987,202313,true,1637183413,28,1646541536,9358123
1667607023,202311,true,1637510866,28,1646376898,8866032
1667607035,202310,true,1637674617,28,1646376898,8702281
1667607323,202309,true,1637838385,28,1645224895,7386510
1667607647,202308,true,1638002168,28,1644238106,6235938
1667607779,202306,true,1638329785,28,1643744933,5415148
1667608223,202306,true,1638329785,28,1642266302,3936517
1667608511,202304,true,1638657468,28,1641445415,2787947
1667608535,202304,true,1638657468,28,1641281287,2623819
1667608595,202302,true,1638985215,28,1641117175,2131960
1667608655,202301,true,1639149114,28,1641117175,1968061
1667608667,202299,true,1639476960,28,1641117175,1640215
1667608679,202298,true,1639640908,28,1641117175,1476267
1667608703,202296,true,1639968852,28,1641281287,1312435
1667608715,202295,true,1640132849,28,1641281287,1148438
1667608727,202293,true,1640460892,28,1641281287,820395
1667608739,202292,true,1640624938,28,1641281287,656349
1667608847,202289,true,1641117175,28,1642102092,984917
1667609135,202287,true,1641445415,28,1644895899,3450484
1667609171,202286,true,1641609559,28,1645389418,3779859
1667609915,202284,true,1641937898,28,1653305875,11367977
1667609987,202282,true,1642266302,28,1653967297,11700995
1667610251,202279,true,1642759031,28,1656781292,14022261
1667610275,202278,true,1642923307,28,1657112665,14189358
1667610311,202276,true,1643251908,28,1657444104,14192196
1667610323,202273,true,1643744933,28,1657609848,13864915
1667610335,202271,true,1644073698,28,1657609848,13536150
1667610347,202270,true,1644238106,28,1657775609,13537503
1667610383,202269,true,1644402529,28,1658107181,13704652
1667610395,202267,true,1644731426,28,1658107181,13375755
1667610479,202265,true,1645060389,28,1658770523,13710134
1667611295,202264,true,1645224895,28,1657444104,12219209
1667612507,202263,true,1645389418,28,1654959925,9570507
1667612675,202261,true,1645718512,28,1654959925,9241413
1667615843,202259,true,1646047672,28,1654463537,8415865
1667616347,202259,true,1646047672,28,1654298107,8250435
1667616443,202258,true,1646212277,28,1654298107,8085830
1667616503,202256,true,1646541536,28,1654298107,7756571
1667616539,202254,true,1646870861,28,1654298107,7427246
1667616671,202254,true,1646870861,28,1654132694,7261833
1667616719,202254,true,1646870861,28,1654132694,7261833
1667616851,202252,true,1647200251,28,1653967297,6767046
1667617235,202251,true,1647364971,28,1653471206,6106235
1667617319,202251,true,1647364971,28,1653471206,6106235
1667617571,202250,true,1647529708,28,1653140561,5610853
1667618747,202249,true,1647694461,28,1652149024,4454563
1667618879,202248,true,1647859230,28,1652149024,4289794
1667618891,202248,true,1647859230,28,1652149024,4289794
1667618951,202248,true,1647859230,28,1652149024,4289794
1667618963,202247,true,1648024016,28,1652149024,4125008
1667618975,202246,true,1648188818,28,1652149024,3960206
1667618999,202246,true,1648188818,28,1652149024,3960206
1667619059,202246,true,1648188818,28,1651983826,3795008
1667619911,202245,true,1648353637,28,1650827899,2474262
1667620691,202244,true,1648518473,28,1649342897,824424
1667621687,202245,true,1648353637,28,1649013078,659441
1667621879,202245,true,1648353637,28,1648848193,494556
1667622827,202244,true,1648518473,28,1648848193,329720
1667622875,202243,true,1648683325,28,1648848193,164868
1667623967,202243,true,1648683325,28,1648848193,164868
1667624051,202243,true,1648683325,28,1648848193,164868
1667624783,202242,true,1648848193,28,1648848193,0
1667627003,202241,true,1649013078,28,1648848193,-164885
1667627087,202242,true,1648848193,28,1648848193,0
1667627483,202241,true,1649013078,28,1648848193,-164885
1667628491,202241,true,1649013078,28,1648848193,-164885
1667628515,202240,true,1649177979,28,1648848193,-329786
1667628755,202240,true,1649177979,28,1648848193,-329786
1667629451,202240,true,1649177979,28,1648848193,-329786
1667631479,202239,true,1649342897,28,1653636553,4293656
1667631563,202238,true,1649507831,28,1653636553,4128722
1667632667,202238,true,1649507831,28,1653636553,4128722
1667633003,202238,true,1649507831,28,1653636553,4128722
1667633903,202237,true,1649672782,28,1653801917,4129135
1667633927,202236,true,1649837749,28,1653967297,4129548
1667634023,202236,true,1649837749,28,1653967297,4129548
1667634167,202236,true,1649837749,28,1653967297,4129548
1667634743,202235,true,1650002733,28,1653967297,3964564
1667634899,202234,true,1650167733,28,1653967297,3799564
1667635259,202234,true,1650167733,28,1653967297,3799564
1667635643,202234,true,1650167733,28,1653967297,3799564
1667635703,202233,true,1650332750,28,1653801917,3469167
1667635727,202232,true,1650497783,28,1653801917,3304134
1667635823,202233,true,1650332750,28,1653636553,3303803
1667635919,202233,true,1650332750,28,1653471206,3138456
1667636123,202232,true,1650497783,28,1653140561,2642778
1667636147,202232,true,1650497783,28,1652975264,2477481
1667636159,202232,true,1650497783,28,1652975264,2477481
1667636219,202233,true,1650332750,28,1652809983,2477233
1667636267,202232,true,1650497783,28,1652644718,2146935
1667636279,202232,true,1650497783,28,1652644718,2146935
1667636819,202233,true,1650332750,28,1649507831,-824919
1667637551,202234,true,1650167733,28,1645553957,-4613776
1667637635,202233,true,1650332750,28,1645224895,-5107855
1667637659,202233,true,1650332750,28,1645060389,-5272361
1667637815,202234,true,1650167733,28,1644566970,-5600763
1667637887,202235,true,1650002733,28,1644238106,-5764627
1667638763,202234,true,1650167733,28,1643744933,-6422800
1667639543,202234,true,1650167733,28,1643744933,-6422800
1667640167,202236,true,1649837749,28,1643580575,-6257174
1667640395,202236,true,1649837749,28,1643744933,-6092816
1667640707,202235,true,1650002733,28,1643744933,-6257800
1667640971,202235,true,1650002733,28,1643744933,-6257800
1667641379,202236,true,1649837749,28,1643909307,-5928442
1667641451,202237,true,1649672782,28,1643909307,-5763475
1667641475,202236,true,1649837749,28,1643744933,-6092816
1667641967,202236,true,1649837749,28,1643251908,-6585841
1667642123,202237,true,1649672782,28,1643087599,-6585183
1667642159,202238,true,1649507831,28,1642923307,-6584524
1667642231,202237,true,1649672782,28,1642923307,-6749475
1667642627,202237,true,1649672782,28,1642266302,-7406480
1667642723,202238,true,1649507831,28,1642266302,-7241529
1667643599,202238,true,1649507831,28,1641445415,-8062416
1667644043,202237,true,1649672782,28,1641445415,-8227367
1667644679,202237,true,1649672782,28,1641445415,-8227367
1667644703,202238,true,1649507831,28,1641445415,-8062416
1667644751,202238,true,1649507831,28,1641445415,-8062416
1667644775,202237,true,1649672782,28,1641445415,-8227367
1667644895,202237,true,1649672782,28,1641445415,-8227367
1667644907,202238,true,1649507831,28,1641445415,-8062416
1667645195,202238,true,1649507831,28,1641445415,-8062416
1667645435,202237,true,1649672782,28,1641445415,-8227367
1667645447,202237,true,1649672782,28,1641445415,-8227367
1667646407,202238,true,1649507831,28,1641445415,-8062416
1667646563,202238,true,1649507831,28,1641445415,-8062416
1667646635,202237,true,1649672782,28,1641609559,-8063223
1667647043,202238,true,1649507831,28,1641773720,-7734111
1667647127,202239,true,1649342897,28,1641937898,-7404999
1667647355,202240,true,1649177979,28,1642102092,-7075887
1667647931,202239,true,1649342897,28,1643087599,-6255298
1667647943,202241,true,1649013078,28,1643087599,-5925479
1667648471,202242,true,1648848193,28,1643909307,-4938886
1667648555,202243,true,1648683325,28,1643909307,-4774018
1667648615,202243,true,1648683325,28,1644073698,-4609627
1667648843,202244,true,1648518473,28,1644402529,-4115944
1667649059,202245,true,1648353637,28,1644895899,-3457738
1667650139,202246,true,1648188818,28,1645718512,-2470306
1667650631,202246,true,1648188818,28,1645718512,-2470306
1667650787,202247,true,1648024016,28,1645718512,-2305504
1667650943,202248,true,1647859230,28,1645718512,-2140718
1667651003,202248,true,1647859230,28,1645718512,-2140718
1667651087,202248,true,1647859230,28,1645718512,-2140718
1667651255,202249,true,1647694461,28,1645718512,-1975949
1667651783,202250,true,1647529708,28,1645718512,-1811196
1667652107,202250,true,1647529708,28,1645718512,-1811196
1667652311,202250,true,1647529708,28,1645718512,-1811196
1667652383,202251,true,1647364971,28,1645718512,-1646459
1667652719,202252,true,1647200251,28,1645718512,-1481739
1667653019,202252,true,1647200251,28,1645718512,-1481739
1667653031,202252,true,1647200251,28,1645718512,-1481739
1667653919,202253,true,1647035548,28,1645718512,-1317036
1667654219,202253,true,1647035548,28,1645718512,-1317036
1667654363,202254,true,1646870861,28,1645718512,-1152349
1667654435,202254,true,1646870861,28,1645718512,-1152349
1667654471,202254,true,1646870861,28,1645718512,-1152349
1667654675,202255,true,1646706190,28,1645553957,-1152233
1667654687,202256,true,1646541536,28,1645553957,-987579
1667654807,202255,true,1646706190,28,1645389418,-1316772
1667654855,202256,true,1646541536,28,1645389418,-1152118
1667654867,202257,true,1646376898,28,1645389418,-987480
1667654891,202258,true,1646212277,28,1645224895,-987382
1667654951,202258,true,1646212277,28,1645060389,-1151888
1667654975,202258,true,1646212277,28,1644895899,-1316378
1667654999,202259,true,1646047672,28,1644895899,-1151773
1667655035,202260,true,1645883084,28,1644731426,-1151658
1667655239,202260,true,1645883084,28,1643744933,-2138151
1667655539,202261,true,1645718512,28,1642266302,-3452210
1667656187,202262,true,1645553957,28,1639149114,-6404843
1667656391,202263,true,1645389418,28,1638329785,-7059633
1667657447,202263,true,1645389418,28,1637019711,-8369707
1667657471,202263,true,1645389418,28,1637019711,-8369707
1667657879,202264,true,1645224895,28,1637019711,-8205184
1667658179,202265,true,1645060389,28,1637019711,-8040678
1667658239,202265,true,1645060389,28,1637019711,-8040678
1667658923,202266,true,1644895899,28,1636201447,-8694452
1667659031,202267,true,1644731426,28,1636201447,-8529979
1667659055,202268,true,1644566970,28,1636037843,-8529127
1667659139,202268,true,1644566970,28,1636037843,-8529127
1667659187,202269,true,1644402529,28,1635874255,-8528274
1667659259,202270,true,1644238106,28,1635874255,-8363851
1667659295,202271,true,1644073698,28,1635710684,-8363014
1667659319,202272,true,1643909307,28,1635710684,-8198623
1667659379,202274,true,1643580575,28,1635383591,-8196984
1667659439,202275,true,1643416233,28,1635220069,-8196164
1667659787,202277,true,1643087599,28,1633585748,-9501851
1667659799,202278,true,1642923307,28,1633585748,-9337559
1667660207,202279,true,1642759031,28,1631789882,-10969149
1667660435,202281,true,1642430528,28,1631137329,-11293199
1667660855,202282,true,1642266302,28,1629670039,-12596263
1667661599,202283,true,1642102092,28,1628692579,-13409513
1667661635,202284,true,1641937898,28,1628855448,-13082450
1667661659,202286,true,1641609559,28,1628855448,-12754111
1667661683,202288,true,1641281287,28,1628855448,-12425839
1667661839,202288,true,1641281287,28,1629018334,-12262953
1667661851,202289,true,1641117175,28,1629018334,-12098841
1667661863,202291,true,1640789001,28,1629018334,-11770667
1667661875,202292,true,1640624938,28,1629018334,-11606604
1667662043,202292,true,1640624938,28,1629507088,-11117850
1667662151,202293,true,1640460892,28,1629833006,-10627886
1667662343,202295,true,1640132849,28,1630485037,-9647812
1667662391,202295,true,1640132849,28,1630485037,-9647812
1667662427,202295,true,1640132849,28,1630648085,-9484764
1667662439,202296,true,1639968852,28,1630648085,-9320767
1667662487,202297,true,1639804872,28,1630811150,-8993722
1667662619,202297,true,1639804872,28,1631463573,-8341299
1667662703,202297,true,1639804872,28,1631789882,-8014990
1667663423,202298,true,1639640908,28,1634566145,-5074763
1667663519,202298,true,1639640908,28,1634893074,-4747834
1667663783,202299,true,1639476960,28,1635383591,-4093369
1667663879,202299,true,1639476960,28,1635547130,-3929830
1667664035,202300,true,1639313029,28,1635710684,-3602345
1667664695,202300,true,1639313029,28,1635874255,-3438774
1667665199,202301,true,1639149114,28,1635874255,-3274859
1667665307,202300,true,1639313029,28,1635874255,-3438774
1667665523,202301,true,1639149114,28,1635874255,-3274859
1667665595,202302,true,1638985215,28,1635874255,-3110960
1667665607,202302,true,1638985215,28,1635874255,-3110960
1667665691,202302,true,1638985215,28,1635874255,-3110960
1667665883,202302,true,1638985215,28,1636037843,-2947372
1667665895,202303,true,1638821333,28,1636037843,-2783490
1667665907,202303,true,1638821333,28,1636037843,-2783490
1667666147,202303,true,1638821333,28,1636365067,-2456266
1667666363,202303,true,1638821333,28,1636692356,-2128977
1667666771,202304,true,1638657468,28,1637183413,-1474055
1667668091,202304,true,1638657468,28,1638165969,-491499
1667668451,202304,true,1638657468,28,1638165969,-491499
1667668607,202304,true,1638657468,28,1638165969,-491499
1667669291,202304,true,1638657468,28,1637838385,-819083
1667670995,202305,true,1638493618,28,1637347131,-1146487
1667671079,202304,true,1638657468,28,1637347131,-1310337
1667671223,202305,true,1638493618,28,1637347131,-1146487
1667671475,202305,true,1638493618,28,1637347131,-1146487
1667671499,202306,true,1638329785,28,1637347131,-982654
1667672747,202305,true,1638493618,28,1637347131,-1146487
1667672867,202306,true,1638329785,28,1637347131,-982654
1667672963,202306,true,1638329785,28,1637347131,-982654
1667672987,202307,true,1638165969,28,1637347131,-818838
1667673719,202307,true,1638165969,28,1636528703,-1637266
1667673767,202307,true,1638165969,28,1636528703,-1637266
1667673803,202308,true,1638002168,28,1636365067,-1637101
1667673935,202308,true,1638002168,28,1636037843,-1964325
1667674043,202309,true,1637838385,28,1635874255,-1964130
1667674115,202309,true,1637838385,28,1635710684,-2127701
1667674127,202310,true,1637674617,28,1635547130,-2127487
1667674235,202311,true,1637510866,28,1635220069,-2290797
1667674307,202312,true,1637347131,28,1634893074,-2454057
1667674679,202313,true,1637183413,28,1633422406,-3761007
1667674871,202313,true,1637183413,28,1632769200,-4414213
1667674955,202314,true,1637019711,28,1632605940,-4413771
1667675171,202315,true,1636856025,28,1631953061,-4902964
1667675183,202316,true,1636692356,28,1631953061,-4739295
1667675543,202317,true,1636528703,28,1630974231,-5554472
1667676575,202318,true,1636365067,28,1630322005,-6043062
1667676671,202319,true,1636201447,28,1630158989,-6042458
1667676707,202319,true,1636201447,28,1630158989,-6042458
1667677043,202320,true,1636037843,28,1629181236,-6856607
1667677235,202322,true,1635710684,28,1628692579,-7018105
1667677571,202323,true,1635547130,28,1627878477,-7668653
1667677895,202324,true,1635383591,28,1627227488,-8156103
1667677907,202325,true,1635220069,28,1627227488,-7992581
1667677931,202326,true,1635056564,28,1627064782,-7991782
1667678015,202327,true,1634893074,28,1626902092,-7990982
1667678039,202328,true,1634729601,28,1626902092,-7827509
1667678087,202329,true,1634566145,28,1626902092,-7664053
1667678351,202330,true,1634402704,28,1626576760,-7825944
1667678651,202331,true,1634239280,28,1627064782,-7174498
1667678891,202331,true,1634239280,28,1627552950,-6686330
1667678939,202332,true,1634075873,28,1627552950,-6522923
1667679731,202334,true,1633749107,28,1629018334,-4730773
1667679755,202334,true,1633749107,28,1629018334,-4730773
1667679815,202334,true,1633749107,28,1629181236,-4567871
1667679995,202335,true,1633585748,28,1629181236,-4404512
1667681687,202336,true,1633422406,28,1629507088,-3915318
1667682023,202337,true,1633259080,28,1629507088,-3751992
1667682791,202337,true,1633259080,28,1629507088,-3751992
1667682863,202337,true,1633259080,28,1629507088,-3751992
1667684099,202339,true,1632932477,28,1629507088,-3425389
1667685179,202338,true,1633095770,28,1629507088,-3588682
1667685407,202338,true,1633095770,28,1629507088,-3588682
1667685851,202339,true,1632932477,28,1629507088,-3425389
1667685899,202340,true,1632769200,28,1629507088,-3262112
1667686619,202340,true,1632769200,28,1629507088,-3262112
1667686763,202340,true,1632769200,28,1629507088,-3262112
1667686991,202341,true,1632605940,28,1629670039,-2935901
1667687627,202342,true,1632442695,28,1629670039,-2772656
1667687951,202341,true,1632605940,28,1629833006,-2772934
1667689427,202341,true,1632605940,28,1630322005,-2283935
1667689811,202342,true,1632442695,28,1630322005,-2120690
1667689955,202343,true,1632279467,28,1630322005,-1957462
1667691071,202343,true,1632279467,28,1628204069,-4075398
1667693267,202343,true,1632279467,28,1626902092,-5377375
1667693279,202343,true,1632279467,28,1626902092,-5377375
1667693999,202344,true,1632116256,28,1626902092,-5214164
1667694191,202344,true,1632116256,28,1626902092,-5214164
1667694371,202344,true,1632116256,28,1626902092,-5214164
1667694383,202344,true,1632116256,28,1626902092,-5214164
1667694959,202345,true,1631953061,28,1626902092,-5050969
1667695199,202345,true,1631953061,28,1626902092,-5050969
1667695271,202345,true,1631953061,28,1626902092,-5050969
1667695547,202345,true,1631953061,28,1627227488,-4725573
1667696315,202345,true,1631953061,28,1627878477,-4074584
1667696891,202345,true,1631953061,28,1628529726,-3423335
1667698439,202345,true,1631953061,28,1628529726,-3423335
1667699231,202345,true,1631953061,28,1628529726,-3423335
1667699495,202345,true,1631953061,28,1628529726,-3423335
1667699567,202345,true,1631953061,28,1628529726,-3423335
1667699579,202345,true,1631953061,28,1628529726,-3423335
1667699591,202345,true,1631953061,28,1628529726,-3423335
1667699771,202347,true,1631626719,28,1627878477,-3748242
1667699807,202348,true,1631463573,28,1627715705,-3747868
1667699963,202348,true,1631463573,28,1627064782,-4398791
1667699975,202348,true,1631463573,28,1627064782,-4398791
1667700011,202350,true,1631137329,28,1626902092,-4235237
1667700371,202351,true,1630974231,28,1624788599,-6185632
1667700839,202351,true,1630974231,28,1622353364,-8620867
1667700935,202352,true,1630811150,28,1621704585,-9106565
1667701559,202353,true,1630648085,28,1618788288,-11859797
1667701991,202355,true,1630322005,28,1618140935,-12181070
1667702183,202355,true,1630322005,28,1618140935,-12181070
1667702759,202356,true,1630158989,28,1617817355,-12341634
1667702867,202357,true,1629995989,28,1617817355,-12178634
1667703695,202359,true,1629670039,28,1617817355,-11852684
1667706755,202359,true,1629670039,28,1617817355,-11852684
1667707199,202360,true,1629507088,28,1617817355,-11689733
1667707355,202361,true,1629344154,28,1617817355,-11526799
1667707391,202363,true,1629018334,28,1617817355,-11200979
1667707751,202363,true,1629018334,28,1617817355,-11200979
1667708255,202364,true,1628855448,28,1617817355,-11038093
1667708711,202365,true,1628692579,28,1617817355,-10875224
1667709263,202367,true,1628366889,28,1617817355,-10549534
1667709887,202367,true,1628366889,28,1617817355,-10549534
1667710703,202368,true,1628204069,28,1617817355,-10386714
1667711147,202369,true,1628041265,28,1617817355,-10223910
1667711339,202371,true,1627715705,28,1617817355,-9898350
1667711735,202372,true,1627552950,28,1617817355,-9735595
1667712935,202372,true,1627552950,28,1617817355,-9735595
1667713043,202374,true,1627227488,28,1617817355,-9410133
1667713127,202376,true,1626902092,28,1617817355,-9084737
1667713571,202376,true,1626902092,28,1617817355,-9084737
1667714567,202377,true,1626739418,28,1617817355,-8922063
1667714699,202378,true,1626576760,28,1617817355,-8759405
1667715767,202380,true,1626251493,28,1617817355,-8434138
1667716067,202380,true,1626251493,28,1617817355,-8434138
1667716139,202381,true,1626088885,28,1617817355,-8271530
1667716355,202383,true,1625763716,28,1617817355,-7946361
1667716391,202384,true,1625601155,28,1617817355,-7783800
1667716775,202385,true,1625438612,28,1617817355,-7621257
1667716955,202385,true,1625438612,28,1617817355,-7621257
1667717027,202387,true,1625113573,28,1617817355,-7296218
1667717423,202388,true,1624951078,28,1617817355,-7133723
1667718191,202389,true,1624788599,28,1617817355,-6971244
1667718611,202389,true,1624788599,28,1617817355,-6971244
1667718719,202391,true,1624463690,28,1617817355,-6646335
1667719247,202392,true,1624301260,28,1617817355,-6483905
1667719667,202392,true,1624301260,28,1617817355,-6483905
1667719763,202392,true,1624301260,28,1617817355,-6483905
1667719775,202394,true,1623976448,28,1617817355,-6159093
1667719967,202394,true,1623976448,28,1617817355,-6159093
1667720003,202395,true,1623814067,28,1617817355,-5996712
1667720915,202395,true,1623814067,28,1617817355,-5996712
1667720975,202396,true,1623651701,28,1617979137,-5672564
1667721707,202397,true,1623489353,28,1618302749,-5186604
1667721731,202397,true,1623489353,28,1618464579,-5024774
1667721851,202398,true,1623327020,28,1618464579,-4862441
1667722007,202399,true,1623164703,28,1618626426,-4538277
1667722067,202399,true,1623164703,28,1618626426,-4538277
1667722103,202400,true,1623002403,28,1618626426,-4375977
1667722463,202400,true,1623002403,28,1618788288,-4214115
1667722523,202400,true,1623002403,28,1618950167,-4052236
1667722739,202401,true,1622840119,28,1619112062,-3728057
1667722799,202401,true,1622840119,28,1619112062,-3728057
1667722919,202401,true,1622840119,28,1619112062,-3728057
1667722991,202402,true,1622677851,28,1619112062,-3565789
1667723027,202403,true,1622515600,28,1619112062,-3403538
1667723267,202403,true,1622515600,28,1619273973,-3241627
1667723603,202403,true,1622515600,28,1619273973,-3241627
1667723891,202404,true,1622353364,28,1619435901,-2917463
1667723915,202404,true,1622353364,28,1619435901,-2917463
1667723939,202405,true,1622191145,28,1619435901,-2755244
1667723963,202405,true,1622191145,28,1619435901,-2755244
1667723987,202406,true,1622028942,28,1619597844,-2431098
1667723999,202406,true,1622028942,28,1619597844,-2431098
1667724107,202406,true,1622028942,28,1619921780,-2107162
1667724179,202406,true,1622028942,28,1620083772,-1945170
1667724191,202407,true,1621866756,28,1620083772,-1782984
1667724251,202407,true,1621866756,28,1620245781,-1620975
1667724263,202408,true,1621704585,28,1620407805,-1296780
1667724275,202407,true,1621866756,28,1620407805,-1458951
1667724287,202408,true,1621704585,28,1620407805,-1296780
1667724299,202408,true,1621704585,28,1620569846,-1134739
1667724323,202408,true,1621704585,28,1620569846,-1134739
1667724335,202408,true,1621704585,28,1620731903,-972682
1667724359,202408,true,1621704585,28,1620893976,-810609
1667724395,202408,true,1621704585,28,1621056066,-648519
1667724407,202408,true,1621704585,28,1621218171,-486414
1667724515,202407,true,1621866756,28,1621866756,0
1667724527,202407,true,1621866756,28,1622028942,162186
1667725343,202407,true,1621866756,28,1628366889,6500133
1667725727,202407,true,1621866756,28,1631300442,9433686
1667726231,202406,true,1622028942,28,1633422406,11393464
1667726603,202407,true,1621866756,28,1633422406,11555650
1667726759,202406,true,1622028942,28,1633422406,11393464
1667727551,202406,true,1622028942,28,1633422406,11393464
1667728379,202405,true,1622191145,28,1633422406,11231261
1667728775,202405,true,1622191145,28,1633259080,11067935
1667728967,202405,true,1622191145,28,1633259080,11067935
1667729063,202404,true,1622353364,28,1633259080,10905716
1667729363,202404,true,1622353364,28,1633095770,10742406
1667729459,202404,true,1622353364,28,1633095770,10742406
1667729975,202404,true,1622353364,28,1632769200,10415836
1667730719,202403,true,1622515600,28,1632116256,9600656
1667730995,202403,true,1622515600,28,1631953061,9437461
1667731091,202403,true,1622515600,28,1631789882,9274282
1667731247,202403,true,1622515600,28,1631789882,9274282
1667731547,202403,true,1622515600,28,1631626719,9111119
1667731655,202402,true,1622677851,28,1631463573,8785722
1667731751,202403,true,1622515600,28,1631463573,8947973
1667731871,202402,true,1622677851,28,1631463573,8785722
1667731967,202402,true,1622677851,28,1631463573,8785722
1667731991,202401,true,1622840119,28,1631463573,8623454
1667732111,202401,true,1622840119,28,1631463573,8623454
1667732207,202400,true,1623002403,28,1631463573,8461170
1667732303,202400,true,1623002403,28,1631463573,8461170
1667732399,202399,true,1623164703,28,1631463573,8298870
1667732783,202399,true,1623164703,28,1631300442,8135739
1667732999,202398,true,1623327020,28,1631300442,7973422
1667733419,202397,true,1623489353,28,1631300442,7811089
1667733455,202396,true,1623651701,28,1631300442,7648741
1667733467,202396,true,1623651701,28,1631300442,7648741
1667733491,202395,true,1623814067,28,1631300442,7486375
1667733515,202395,true,1623814067,28,1631300442,7486375
1667733527,202394,true,1623976448,28,1631300442,7323994
1667733719,202394,true,1623976448,28,1630811150,6834702
1667733731,202393,true,1624138846,28,1630811150,6672304
1667733767,202392,true,1624301260,28,1630648085,6346825
1667733815,202392,true,1624301260,28,1630485037,6183777
1667733995,202392,true,1624301260,28,1629995989,5694729
1667734175,202391,true,1624463690,28,1629507088,5043398
1667734235,202391,true,1624463690,28,1629181236,4717546
1667734271,202390,true,1624626136,28,1629181236,4555100
1667734283,202390,true,1624626136,28,1629018334,4392198
1667734295,202390,true,1624626136,28,1629018334,4392198
1667734307,202390,true,1624626136,28,1628855448,4229312
1667734331,202390,true,1624626136,28,1628692579,4066443
1667734367,202390,true,1624626136,28,1628529726,3903590
1667734379,202390,true,1624626136,28,1628366889,3740753
1667734415,202390,true,1624626136,28,1628041265,3415129
1667735339,202390,true,1624626136,28,1619921780,-4704356
1667735351,202391,true,1624463690,28,1619759804,-4703886
1667735819,202390,true,1624626136,28,1617170390,-7455746
1667736323,202390,true,1624626136,28,1615877236,-8748900
1667736431,202390,true,1624626136,28,1615877236,-8748900
1667736443,202391,true,1624463690,28,1615877236,-8586454
1667736503,202390,true,1624626136,28,1616038823,-8587313
1667736599,202390,true,1624626136,28,1616200427,-8425709
1667736731,202390,true,1624626136,28,1616362047,-8264089
1667736851,202391,true,1624463690,28,1616685336,-7778354
1667737067,202390,true,1624626136,28,1617170390,-7455746
1667737079,202390,true,1624626136,28,1617170390,-7455746
1667737091,202390,true,1624626136,28,1617332107,-7294029
1667737919,202390,true,1624626136,28,1618950167,-5675969
1667738579,202390,true,1624626136,28,1620083772,-4542364
1667739023,202390,true,1624626136,28,1620083772,-4542364
1667739323,202390,true,1624626136,28,1620083772,-4542364
1667739467,202390,true,1624626136,28,1620083772,-4542364
1667739539,202389,true,1624788599,28,1620083772,-4704827
1667739611,202389,true,1624788599,28,1620083772,-4704827
1667739647,202389,true,1624788599,28,1620083772,-4704827
1667739671,202389,true,1624788599,28,1620083772,-4704827
1667741411,202389,true,1624788599,28,1619921780,-4866819
1667741495,202389,true,1624788599,28,1619921780,-4866819
1667741783,202389,true,1624788599,28,1619921780,-4866819
1667742011,202389,true,1624788599,28,1619921780,-4866819
1667742023,202388,true,1624951078,28,1619921780,-5029298
1667742251,202388,true,1624951078,28,1619921780,-5029298
1667742383,202388,true,1624951078,28,1619921780,-5029298
1667742791,202389,true,1624788599,28,1619921780,-4866819
1667744015,202388,true,1624951078,28,1619921780,-5029298
1667744423,202388,true,1624951078,28,1619921780,-5029298
1667745311,202388,true,1624951078,28,1619921780,-5029298
1667745335,202388,true,1624951078,28,1620083772,-4867306
1667745659,202388,true,1624951078,28,1620407805,-4543273
1667745719,202388,true,1624951078,28,1620407805,-4543273
1667745803,202388,true,1624951078,28,1620569846,-4381232
1667746055,202388,true,1624951078,28,1621056066,-3895012
1667746091,202387,true,1625113573,28,1621056066,-4057507
1667746115,202387,true,1625113573,28,1621056066,-4057507
1667746415,202386,true,1625276084,28,1622191145,-3084939
1667747039,202386,true,1625276084,28,1624301260,-974824
1667747543,202386,true,1625276084,28,1625601155,325071
1667748515,202385,true,1625438612,28,1627552950,2114338
1667749763,202385,true,1625438612,28,1628529726,3091114
1667749931,202385,true,1625438612,28,1628692579,3253967
1667750171,202384,true,1625601155,28,1628692579,3091424
1667750375,202384,true,1625601155,28,1628692579,3091424
1667750459,202384,true,1625601155,28,1628692579,3091424
1667750483,202384,true,1625601155,28,1628692579,3091424
1667750495,202383,true,1625763716,28,1628692579,2928863
1667750507,202383,true,1625763716,28,1628692579,2928863
1667750519,202383,true,1625763716,28,1628529726,2766010
1667750531,202384,true,1625601155,28,1628529726,2928571
1667750543,202384,true,1625601155,28,1628529726,2928571
1667750555,202384,true,1625601155,28,1628529726,2928571
1667750567,202385,true,1625438612,28,1628366889,2928277
1667750579,202385,true,1625438612,28,1628366889,2928277
1667750675,202386,true,1625276084,28,1627715705,2439621
1667750759,202387,true,1625113573,28,1627227488,2113915
1667750783,202388,true,1624951078,28,1627064782,2113704
1667750855,202389,true,1624788599,28,1626414119,1625520
1667750879,202390,true,1624626136,28,1626251493,1625357
1667750915,202391,true,1624463690,28,1625926292,1462602
1667750927,202392,true,1624301260,28,1625926292,1625032
1667750951,202393,true,1624138846,28,1625763716,1624870
1667750963,202394,true,1623976448,28,1625601155,1624707
1667750975,202395,true,1623814067,28,1625601155,1787088
1667751059,202395,true,1623814067,28,1625113573,1299506
1667751167,202396,true,1623651701,28,1624788599,1136898
1667751647,202397,true,1623489353,28,1622677851,-811502
1667752475,202398,true,1623327020,28,1619597844,-3729176
1667752691,202398,true,1623327020,28,1620083772,-3243248
1667752787,202398,true,1623327020,28,1620245781,-3081239
1667752979,202400,true,1623002403,28,1620245781,-2756622
1667754923,202400,true,1623002403,28,1621056066,-1946337
1667755775,202400,true,1623002403,28,1621056066,-1946337
1667755967,202401,true,1622840119,28,1621056066,-1784053
1667756159,202402,true,1622677851,28,1621056066,-1621785
1667756663,202402,true,1622677851,28,1621056066,-1621785
1667756675,202403,true,1622515600,28,1621056066,-1459534
1667756687,202403,true,1622515600,28,1621056066,-1459534
1667756747,202404,true,1622353364,28,1621056066,-1297298
1667756771,202405,true,1622191145,28,1621056066,-1135079
1667756795,202405,true,1622191145,28,1621056066,-1135079
1667757455,202406,true,1622028942,28,1620083772,-1945170
1667757479,202407,true,1621866756,28,1620083772,-1782984
1667757851,202408,true,1621704585,28,1619435901,-2268684
1667757947,202408,true,1621704585,28,1619273973,-2430612
1667758319,202409,true,1621542431,28,1618302749,-3239682
1667758487,202410,true,1621380293,28,1617979137,-3401156
1667758511,202411,true,1621218171,28,1617817355,-3400816
1667758583,202411,true,1621218171,28,1617655590,-3562581
1667758607,202412,true,1621056066,28,1617655590,-3400476
1667758679,202413,true,1620893976,28,1617493840,-3400136
1667758691,202414,true,1620731903,28,1617493840,-3238063
1667758739,202415,true,1620569846,28,1617332107,-3237739
1667759111,202416,true,1620407805,28,1615715664,-4692141
1667759195,202417,true,1620245781,28,1615231046,-5014735
1667759351,202418,true,1620083772,28,1614262247,-5821525
1667759759,202418,true,1620083772,28,1612165174,-7918598
1667759783,202420,true,1619759804,28,1612003974,-7755830
1667759807,202421,true,1619597844,28,1611842789,-7755055
1667759855,202422,true,1619435901,28,1611681621,-7754280
1667759903,202422,true,1619435901,28,1611359333,-8076568
1667759975,202424,true,1619112062,28,1611037110,-8074952
1667760011,202425,true,1618950167,28,1610876022,-8074145
1667760119,202425,true,1618950167,28,1610392856,-8557311
1667760203,202425,true,1618950167,28,1609909835,-9040332
1667761163,202426,true,1618788288,28,1608139996,-10648292
1667761427,202427,true,1618626426,28,1608139996,-10486430
1667761931,202427,true,1618626426,28,1608139996,-10486430
1667762423,202427,true,1618626426,28,1608139996,-10486430
1667762831,202428,true,1618464579,28,1608139996,-10324583
1667762903,202429,true,1618302749,28,1608139996,-10162753
1667765591,202429,true,1618302749,28,1608139996,-10162753
1667765795,202429,true,1618302749,28,1608139996,-10162753
1667766119,202429,true,1618302749,28,1608139996,-10162753
1667767883,202430,true,1618140935,28,1608139996,-10000939
1667768363,202431,true,1617979137,28,1608139996,-9839141
1667769071,202431,true,1617979137,28,1608139996,-9839141
1667769095,202432,true,1617817355,28,1608139996,-9677359
1667769923,202433,true,1617655590,28,1608139996,-9515594
1667770127,202433,true,1617655590,28,1608139996,-9515594
1667770847,202433,true,1617655590,28,1608139996,-9515594
1667770979,202434,true,1617493840,28,1608139996,-9353844
1667771975,202435,true,1617332107,28,1608139996,-9192111
1667772407,202436,true,1617170390,28,1608139996,-9030394
1667772503,202436,true,1617170390,28,1608139996,-9030394
1667772779,202437,true,1617008689,28,1607818416,-9190273
1667772851,202438,true,1616847004,28,1607657650,-9189354
1667772887,202439,true,1616685336,28,1607657650,-9027686
1667772899,202439,true,1616685336,28,1607496901,-9188435
1667772971,202441,true,1616362047,28,1607175450,-9186597
1667772995,202442,true,1616200427,28,1607175450,-9024977
1667773055,202443,true,1616038823,28,1606854063,-9184760
1667773067,202443,true,1616038823,28,1606854063,-9184760
1667773103,202445,true,1615715664,28,1606532740,-9182924
1667773127,202447,true,1615392569,28,1606372103,-9020466
1667773163,202448,true,1615231046,28,1606211482,-9019564
1667773187,202448,true,1615231046,28,1606050877,-9180169
1667773199,202450,true,1614908049,28,1606050877,-8857172
1667773775,202452,true,1614585115,28,1602040964,-12544151
1667773787,202454,true,1614262247,28,1601880776,-12381471
1667773799,202454,true,1614262247,28,1601880776,-12381471
1667773823,202456,true,1613939443,28,1601720604,-12218839
1667774207,202458,true,1613616703,28,1599479876,-14136827
1667774675,202459,true,1613455358,28,1597082575,-16372783
1667774915,202459,true,1613455358,28,1596763206,-16692152
1667774999,202461,true,1613132715,28,1596922883,-16209832
1667775083,202463,true,1612810137,28,1597082575,-15727562
1667775167,202464,true,1612648872,28,1597242283,-15406589
1667775467,202465,true,1612487623,28,1598041064,-14446559
1667775731,202467,true,1612165174,28,1598680376,-13484798
1667775935,202469,true,1611842789,28,1599160028,-12682761
1667775971,202470,true,1611681621,28,1599160028,-12521593
1667775983,202471,true,1611520469,28,1599160028,-12360441
1667776019,202473,true,1611198213,28,1599160028,-12038185
1667776043,202475,true,1610876022,28,1599160028,-11715994
1667776055,202477,true,1610553895,28,1599319944,-11233951
1667776067,202478,true,1610392856,28,1599160028,-11232828
1667776079,202480,true,1610070826,28,1599160028,-10910798
1667776127,202483,true,1609587901,28,1599160028,-10427873
1667776139,202484,true,1609426958,28,1599160028,-10266930
1667776151,202485,true,1609266032,28,1599000128,-10265904
1667776235,202488,true,1608783348,28,1598840244,-9943104
1667776247,202490,true,1608461640,28,1598840244,-9621396
1667776343,202492,true,1608139996,28,1598360688,-9779308
1667776367,202492,true,1608139996,28,1598200868,-9939128
1667776379,202495,true,1607657650,28,1598200868,-9456782
1667776391,202497,true,1607336167,28,1598041064,-9295103
1667776415,202498,true,1607175450,28,1598041064,-9134386
1667776427,202499,true,1607014748,28,1597881276,-9133472
1667776439,202501,true,1606693393,28,1597881276,-8812117
1667776463,202504,true,1606211482,28,1597561748,-8649734
1667776643,202506,true,1605890288,28,1595645919,-10244369
1667776739,202507,true,1605729715,28,1594688866,-11040849
1667776775,202509,true,1605408617,28,1594210555,-11198062
1667776835,202512,true,1604927091,28,1593573031,-11354060
1667777171,202515,true,1604445709,28,1589594272,-14851437
1667777699,202516,true,1604285280,28,1583407237,-20878043
1667777771,202519,true,1603804091,28,1582615771,-21188320
1667777939,202521,true,1603483378,28,1580875937,-22607441
1667777951,202524,true,1603002429,28,1580875937,-22126492
1667777987,202525,true,1602842145,28,1580559809,-22282336
1667777999,202528,true,1602361389,28,1580401769,-21959620
1667778011,202531,true,1601880776,28,1580243745,-21637031
1667778071,202535,true,1601240184,28,1579611805,-21628379
1667778131,202536,true,1601080076,28,1578822236,-22257840
1667778227,202540,true,1600439804,28,1577875275,-22564529
1667778239,202543,true,1599959768,28,1577717503,-22242265
1667778287,202546,true,1599479876,28,1577559747,-21920129
1667778467,202548,true,1599160028,28,1576771204,-22388824
1667778527,202551,true,1598680376,28,1576455897,-22224479
1667779055,202554,true,1598200868,28,1574407938,-23792930
1667779103,202557,true,1597721504,28,1574093103,-23628401
1667779199,202559,true,1597402007,28,1573778332,-23623675
1667779223,202561,true,1597082575,28,1573620970,-23461605
1667779307,202564,true,1596603546,28,1573306293,-23297253
1667779775,202568,true,1595965064,28,1571262426,-24702638
1667780243,202569,true,1595805484,28,1571576694,-24228790
1667780255,202572,true,1595326838,28,1571576694,-23750144
1667780279,202575,true,1594848335,28,1571576694,-23271641
1667780291,202578,true,1594369976,28,1571576694,-22793282
1667780831,202578,true,1594369976,28,1572677128,-21692848
1667781587,202581,true,1593891761,28,1574722835,-19168926
1667781791,202584,true,1593413689,28,1575352819,-18060870
1667781935,202587,true,1592935761,28,1575667905,-17267856
1667781959,202587,true,1592935761,28,1575825472,-17110289
1667782187,202589,true,1592617221,28,1575983054,-16634167
1667782199,202591,true,1592298746,28,1575983054,-16315692
1667782211,202594,true,1591821152,28,1575983054,-15838098
1667782235,202594,true,1591821152,28,1575983054,-15838098
1667782247,202596,true,1591502835,28,1575983054,-15519781
1667782259,202599,true,1591025480,28,1575983054,-15042426
1667782295,202602,true,1590548267,28,1575825472,-14722795
1667782307,202602,true,1590548267,28,1575825472,-14722795
1667782535,202605,true,1590071198,28,1575037795,-15033403
1667782559,202607,true,1589753232,28,1574880307,-14872925
1667782571,202611,true,1589117490,28,1574880307,-14237183
1667782595,202611,true,1589117490,28,1574880307,-14237183
1667782679,202613,true,1588799714,28,1574565379,-14234335
1667783171,202616,true,1588323169,28,1573306293,-15016876
1667783207,202619,true,1587846767,28,1573306293,-14540474
1667783519,202619,true,1587846767,28,1572519876,-15326891
1667783627,202621,true,1587529246,28,1572205419,-15323827
1667783687,202624,true,1587053082,28,1572048214,-15004868
1667784479,202627,true,1586577061,28,1571105315,-15471746
1667784539,202628,true,1586418420,28,1570948220,-15470200
1667784599,202630,true,1586101183,28,1570948220,-15152963
1667784611,202632,true,1585784011,28,1570948220,-14835791
1667784671,202636,true,1585149856,28,1570948220,-14201636
1667784683,202636,true,1585149856,28,1570948220,-14201636
1667784779,202638,true,1584832873,28,1570948220,-13884653
1667784815,202641,true,1584357519,28,1570948220,-13409299
1667784839,202644,true,1583882306,28,1570948220,-12934086
1667784923,202644,true,1583882306,28,1570948220,-12934086
1667785031,202646,true,1583565577,28,1571105315,-12460262
1667785043,202649,true,1583090603,28,1571105315,-11985288
1667785079,202652,true,1582615771,28,1571105315,-11510456
1667785091,202652,true,1582615771,28,1571105315,-11510456
1667785163,202654,true,1582299295,28,1571262426,-11036869
1667785331,202656,true,1581982882,28,1571576694,-10406188
1667785355,202659,true,1581508382,28,1571576694,-9931688
1667785367,202659,true,1581508382,28,1571576694,-9931688
1667785391,202660,true,1581350247,28,1571733852,-9616395
1667785415,202662,true,1581034025,28,1571733852,-9300173
1667785427,202664,true,1580717865,28,1571891025,-8826840
1667785463,202664,true,1580717865,28,1572048214,-8669651
1667785787,202665,true,1580559809,28,1573620970,-6938839
1667786039,202666,true,1580401769,28,1575037795,-5363974
1667786135,202668,true,1580085736,28,1575510354,-4575382
1667786243,202668,true,1580085736,28,1575983054,-4102682
1667786303,202668,true,1580085736,28,1576298267,-3787469
1667786747,202669,true,1579927744,28,1578506519,-1421225
1667786879,202672,true,1579453860,28,1579138017,-315843
1667786939,202671,true,1579611805,28,1579295930,-315875
1667787011,202672,true,1579453860,28,1579611805,157945
1667787023,202673,true,1579295930,28,1579611805,315875
1667787035,202676,true,1578822236,28,1579611805,789569
1667787059,202675,true,1578980119,28,1579769767,789648
1667787095,202675,true,1578980119,28,1579927744,947625
1667787119,202676,true,1578822236,28,1580085736,1263500
1667787167,202679,true,1578348684,28,1580401769,2053085
1667787179,202678,true,1578506519,28,1580401769,1895250
1667787323,202678,true,1578506519,28,1581034025,2527506
1667787827,202679,true,1578348684,28,1583407237,5058553
1667788007,202682,true,1577875275,28,1584199099,6323824
1667788067,202681,true,1578033062,28,1584357519,6324457
1667788391,202681,true,1578033062,28,1585784011,7750949
1667788583,202682,true,1577875275,28,1586577061,8701786
1667788595,202684,true,1577559747,28,1586735719,9175972
1667788631,202683,true,1577717503,28,1586894393,9176890
1667788655,202683,true,1577717503,28,1586894393,9176890
1667788715,202683,true,1577717503,28,1587211787,9494284
1667788727,202685,true,1577402007,28,1587211787,9809780
1667788739,202684,true,1577559747,28,1587370509,9810762
1667788907,202684,true,1577559747,28,1588005552,10445805
1667790755,202683,true,1577717503,28,1590230206,12512703
1667790887,202685,true,1577402007,28,1590230206,12828199
1667791019,202684,true,1577559747,28,1590230206,12670459
1667791163,202683,true,1577717503,28,1590230206,12512703
1667791355,202683,true,1577717503,28,1590230206,12512703
1667791367,202685,true,1577402007,28,1590230206,12828199
1667791499,202684,true,1577559747,28,1590230206,12670459
1667791691,202683,true,1577717503,28,1590071198,12353695
1667792351,202682,true,1577875275,28,1589753232,11877957
1667792651,202682,true,1577875275,28,1589594272,11718997
1667793251,202681,true,1578033062,28,1589117490,11084428
1667793323,202680,true,1578190865,28,1589117490,10926625
1667793431,202680,true,1578190865,28,1589117490,10926625
1667793647,202680,true,1578190865,28,1589117490,10926625
1667793731,202679,true,1578348684,28,1589117490,10768806
1667793935,202678,true,1578506519,28,1589117490,10610971
1667793947,202677,true,1578664370,28,1589117490,10453120
1667793995,202678,true,1578506519,28,1589117490,10610971
1667794031,202677,true,1578664370,28,1588958594,10294224
1667794199,202676,true,1578822236,28,1588799714,9977478
1667794451,202675,true,1578980119,28,1588323169,9343050
1667794475,202675,true,1578980119,28,1588323169,9343050
1667794643,202673,true,1579295930,28,1588005552,8709622
1667794667,202672,true,1579453860,28,1588005552,8551692
1667794835,202671,true,1579611805,28,1587687999,8076194
1667794859,202671,true,1579611805,28,1587529246,7917441
1667794871,202670,true,1579769767,28,1587529246,7759479
1667794895,202669,true,1579927744,28,1587529246,7601502
1667794907,202668,true,1580085736,28,1587370509,7284773
1667794991,202669,true,1579927744,28,1587053082,7125338
1667795459,202668,true,1580085736,28,1584991357,4905621
1667795711,202667,true,1580243745,28,1583882306,3638561
1667795975,202666,true,1580401769,28,1583090603,2688834
1667796071,202666,true,1580401769,28,1582774032,2372263
1667796467,202665,true,1580559809,28,1581824700,1264891
1667796707,202665,true,1580559809,28,1581192128,632319
1667796755,202664,true,1580717865,28,1581350247,632382
1667796983,202664,true,1580717865,28,1581350247,632382
1667797115,202664,true,1580717865,28,1581508382,790517
1667797199,202663,true,1580875937,28,1581508382,632445
1667797283,202662,true,1581034025,28,1581666533,632508
1667797307,202663,true,1580875937,28,1581666533,790596
1667797463,202662,true,1581034025,28,1581982882,948857
1667797475,202661,true,1581192128,28,1581982882,790754
1667797499,202660,true,1581350247,28,1581982882,632635
1667797511,202661,true,1581192128,28,1581982882,790754
1667797523,202660,true,1581350247,28,1582141081,790834
1667798267,202658,true,1581666533,28,1584515954,2849421
1667798375,202658,true,1581666533,28,1584991357,3324824
1667799095,202657,true,1581824700,28,1587053082,5228382
1667799155,202657,true,1581824700,28,1587053082,5228382
1667799179,202655,true,1582141081,28,1587211787,5070706
1667799575,202653,true,1582457525,28,1587687999,5230474
1667799611,202653,true,1582457525,28,1587687999,5230474
1667799623,202652,true,1582615771,28,1587687999,5072228
1667801039,202650,true,1582932309,28,1589753232,6820923
1667801507,202649,true,1583090603,28,1589912207,6821604
1667801519,202649,true,1583090603,28,1589912207,6821604
1667801555,202648,true,1583248912,28,1589912207,6663295
1667801567,202646,true,1583565577,28,1589912207,6346630
1667801579,202646,true,1583565577,28,1589912207,6346630
1667801591,202645,true,1583723934,28,1589912207,6188273
1667801783,202644,true,1583882306,28,1589435329,5553023
1667801831,202643,true,1584040695,28,1589435329,5394634
1667801843,202642,true,1584199099,28,1589276401,5077302
1667802347,202642,true,1584199099,28,1587846767,3647668
1667802767,202641,true,1584357519,28,1586577061,2219542
1667802815,202640,true,1584515954,28,1586418420,1902466
1667803223,202639,true,1584674406,28,1584991357,316951
1667803295,202639,true,1584674406,28,1584674406,0
1667803571,202639,true,1584674406,28,1584199099,-475307
1667803787,202637,true,1584991357,28,1584040695,-950662
1667803811,202637,true,1584991357,28,1584040695,-950662
1667804051,202636,true,1585149856,28,1583882306,-1267550
1667804183,202636,true,1585149856,28,1583723934,-1425922
1667804195,202635,true,1585308371,28,1583723934,-1584437
1667804291,202635,true,1585308371,28,1583565577,-1742794
1667804303,202635,true,1585308371,28,1583565577,-1742794
1667804339,202635,true,1585308371,28,1583565577,-1742794
1667804435,202634,true,1585466902,28,1583248912,-2217990
1667804495,202634,true,1585466902,28,1583090603,-2376299
1667804627,202634,true,1585466902,28,1582457525,-3009377
1667804639,202635,true,1585308371,28,1582299295,-3009076
1667804663,202634,true,1585466902,28,1582299295,-3167607
1667804879,202635,true,1585308371,28,1581034025,-4274346
1667804927,202636,true,1585149856,28,1580717865,-4431991
1667804951,202636,true,1585149856,28,1580559809,-4590047
1667804987,202636,true,1585149856,28,1580243745,-4906111
1667806115,202637,true,1584991357,28,1572362639,-12628718
1667806343,202638,true,1584832873,28,1571419552,-13413321
1667806427,202638,true,1584832873,28,1571105315,-13727558
1667806619,202638,true,1584832873,28,1570948220,-13884653
1667806979,202639,true,1584674406,28,1570948220,-13726186
1667807075,202640,true,1584515954,28,1570948220,-13567734
1667807087,202641,true,1584357519,28,1570948220,-13409299
1667807099,202641,true,1584357519,28,1570948220,-13409299
1667807183,202643,true,1584040695,28,1570791141,-13249554
1667807195,202644,true,1583882306,28,1570791141,-13091165
1667807207,202645,true,1583723934,28,1570791141,-12932793
1667807291,202645,true,1583723934,28,1570477030,-13246904
1667807339,202647,true,1583407237,28,1570477030,-12930207
1667807351,202649,true,1583090603,28,1570319998,-12770605
1667807411,202650,true,1582932309,28,1570162982,-12769327
1667807471,202651,true,1582774032,28,1569848996,-12925036
1667807543,202653,true,1582457525,28,1569535074,-12922451
1667807555,202655,true,1582141081,28,1569535074,-12606007
1667807567,202656,true,1581982882,28,1569378136,-12604746
1667807627,202657,true,1581824700,28,1568907417,-12917283
1667807639,202660,true,1581350247,28,1568907417,-12442830
1667807675,202662,true,1581034025,28,1568436838,-12597187
1667807771,202664,true,1580717865,28,1567496106,-13221759
1667807783,202665,true,1580559809,28,1567339372,-13220437
1667808071,202669,true,1579927744,28,1564364403,-15563341
1667808479,202671,true,1579611805,28,1559990527,-19621278
1667808527,202672,true,1579453860,28,1559366687,-20087173
1667808539,202674,true,1579138017,28,1559366687,-19771330
1667808551,202678,true,1578506519,28,1559210766,-19295753
1667808599,202679,true,1578348684,28,1558743096,-19605588
1667808635,202681,true,1578033062,28,1558431394,-19601668
1667808659,202682,true,1577875275,28,1558119755,-19755520
1667808683,202686,true,1577244282,28,1557963959,-19280323
1667808695,202687,true,1577086574,28,1557808178,-19278396
1667808707,202688,true,1576928881,28,1557652412,-19276469
1667808959,202690,true,1576613542,28,1555784444,-20829098
1667808971,202693,true,1576140653,28,1555784444,-20356209
1667808983,202695,true,1575825472,28,1555628881,-20196591
1667808995,202696,true,1575667905,28,1555628881,-20039024
1667809007,202697,true,1575510354,28,1555473334,-20037020
1667809931,202700,true,1575037795,28,1556873820,-18163975
1667809979,202701,true,1574880307,28,1557185210,-17695097
1667809991,202702,true,1574722835,28,1557185210,-17537625
1667810279,202703,true,1574565379,28,1559054861,-15510518
1667810327,202705,true,1574250513,28,1559366687,-14883826
1667810831,202707,true,1573935710,28,1561551220,-12384490
1667810915,202707,true,1573935710,28,1561707375,-12228335
1667810951,202708,true,1573778332,28,1561863546,-11914786
1667810987,202710,true,1573463624,28,1561863546,-11600078
1667811011,202711,true,1573306293,28,1562019732,-11286561
1667811071,202712,true,1573148978,28,1562175934,-10973044
1667811191,202713,true,1572991679,28,1562488385,-10503294
1667811527,202714,true,1572834395,28,1563269786,-9564609
1667811671,202715,true,1572677128,28,1563582455,-9094673
1667811767,202716,true,1572519876,28,1563895187,-8624689
1667811779,202716,true,1572519876,28,1563895187,-8624689
1667811803,202718,true,1572205419,28,1563895187,-8310232
1667811827,202719,true,1572048214,28,1564051577,-7996637
1667811839,202720,true,1571891025,28,1564051577,-7839448
1667811935,202720,true,1571891025,28,1564364403,-7526622
1667812031,202721,true,1571733852,28,1564677291,-7056561
1667812055,202722,true,1571576694,28,1564677291,-6899403
1667812079,202723,true,1571419552,28,1564833759,-6585793
1667812127,202723,true,1571419552,28,1564990242,-6429310
1667812235,202724,true,1571262426,28,1565303256,-5959170
1667812331,202725,true,1571105315,28,1565772894,-5332421
1667813387,202726,true,1570948220,28,1569535074,-1413146
1667813423,202726,true,1570948220,28,1569535074,-1413146
1667813447,202727,true,1570791141,28,1569692027,-1099114
1667813807,202728,true,1570634078,28,1570477030,-157048
1667814371,202729,true,1570477030,28,1570477030,0
1667814983,202729,true,1570477030,28,1570477030,0
1667815007,202731,true,1570162982,28,1570477030,314048
1667815187,202732,true,1570005981,28,1570477030,471049
1667815199,202733,true,1569848996,28,1570477030,628034
1667815295,202733,true,1569848996,28,1570319998,471002
1667815355,202735,true,1569535074,28,1570319998,784924
1667815631,202736,true,1569378136,28,1570005981,627845
1667815655,202737,true,1569221214,28,1570005981,784767
1667815679,202738,true,1569064307,28,1570005981,941674
1667815739,202740,true,1568750541,28,1570005981,1255440
1667816099,202741,true,1568593682,28,1570005981,1412299
1667816255,202742,true,1568436838,28,1570005981,1569143
1667816267,202743,true,1568280010,28,1570005981,1725971
1667816279,202744,true,1568123198,28,1570005981,1882783
1667816315,202745,true,1567966401,28,1570162982,2196581
1667816327,202745,true,1567966401,28,1570162982,2196581
1667816423,202745,true,1567966401,28,1570477030,2510629
1667816459,202746,true,1567809620,28,1570634078,2824458
1667817167,202746,true,1567809620,28,1574565379,6755759
1667817323,202746,true,1567809620,28,1575510354,7700734
1667818139,202746,true,1567809620,28,1579611805,11802185
1667818151,202747,true,1567652855,28,1579611805,11958950
1667818679,202747,true,1567652855,28,1579611805,11958950
1667818739,202747,true,1567652855,28,1579611805,11958950
1667818991,202747,true,1567652855,28,1579611805,11958950
1667819123,202748,true,1567496106,28,1579611805,12115699
1667819327,202748,true,1567496106,28,1579611805,12115699
1667819459,202747,true,1567652855,28,1579611805,11958950
1667819519,202747,true,1567652855,28,1579611805,11958950
1667819615,202749,true,1567339372,28,1579611805,12272433
1667819735,202748,true,1567496106,28,1579611805,12115699
1667819891,202748,true,1567496106,28,1579611805,12115699
1667819999,202748,true,1567496106,28,1579611805,12115699
1667820059,202749,true,1567339372,28,1579611805,12272433
1667820227,202748,true,1567496106,28,1579611805,12115699
1667820287,202747,true,1567652855,28,1579611805,11958950
1667820395,202747,true,1567652855,28,1579611805,11958950
1667820959,202747,true,1567652855,28,1579611805,11958950
1667821991,202747,true,1567652855,28,1579611805,11958950
1667822207,202746,true,1567809620,28,1579611805,11802185
1667823995,202745,true,1567966401,28,1579611805,11645404
1667824295,202745,true,1567966401,28,1579611805,11645404
1667825963,202745,true,1567966401,28,1579611805,11645404
1667826011,202744,true,1568123198,28,1579769767,11646569
1667826287,202743,true,1568280010,28,1580085736,11805726
1667826299,202743,true,1568280010,28,1580085736,11805726
1667826359,202742,true,1568436838,28,1580243745,11806907
1667827271,202741,true,1568593682,28,1582932309,14338627
1667827295,202740,true,1568750541,28,1582932309,14181768
1667827307,202740,true,1568750541,28,1583090603,14340062
1667827331,202738,true,1569064307,28,1583090603,14026296
1667827343,202737,true,1569221214,28,1583090603,13869389
1667827631,202737,true,1569221214,28,1583248912,14027698
1667827907,202737,true,1569221214,28,1583248912,14027698
1667829695,202735,true,1569535074,28,1580875937,11340863
1667831639,202734,true,1569692027,28,1580875937,11183910
1667831651,202733,true,1569848996,28,1580875937,11026941
1667831675,202732,true,1570005981,28,1580875937,10869956
1667831783,202731,true,1570162982,28,1580559809,10396827
1667831807,202731,true,1570162982,28,1580559809,10396827
1667832455,202730,true,1570319998,28,1578190865,7870867
1667832479,202729,true,1570477030,28,1578033062,7556032
1667832587,202727,true,1570791141,28,1577717503,6926362
1667832743,202726,true,1570948220,28,1577086574,6138354
1667832755,202725,true,1571105315,28,1577086574,5981259
1667833295,202724,true,1571262426,28,1574565379,3302953
1667833343,202722,true,1571576694,28,1574407938,2831244
1667833379,202721,true,1571733852,28,1574250513,2516661
1667833439,202720,true,1571891025,28,1574093103,2202078
1667833547,202718,true,1572205419,28,1573935710,1730291
1667834183,202716,true,1572519876,28,1574565379,2045503
1667834195,202716,true,1572519876,28,1574565379,2045503
1667834219,202715,true,1572677128,28,1574565379,1888251
1667834243,202713,true,1572991679,28,1574722835,1731156
1667834255,202711,true,1573306293,28,1574722835,1416542
1667834807,202710,true,1573463624,28,1576771204,3307580
1667836067,202710,true,1573463624,28,1579927744,6464120
1667836247,202708,true,1573778332,28,1580243745,6465413
1667836259,202705,true,1574250513,28,1580243745,5993232
1667836295,202705,true,1574250513,28,1580243745,5993232
1667836343,202704,true,1574407938,28,1580401769,5993831
1667836355,202702,true,1574722835,28,1580559809,5836974
1667836439,202700,true,1575037795,28,1580875937,5838142
1667836811,202699,true,1575195299,28,1582615771,7420472
1667836919,202698,true,1575352819,28,1583090603,7737784
1667836931,202696,true,1575667905,28,1583090603,7422698
1667836943,202694,true,1575983054,28,1583248912,7265858
1667837291,202692,true,1576298267,28,1585784011,9485744
1667837675,202691,true,1576455897,28,1588482001,12026104
1667837903,202690,true,1576613542,28,1589912207,13298665
1667837987,202687,true,1577086574,28,1590389229,13302655
1667838011,202686,true,1577244282,28,1590389229,13144947
1667839259,202685,true,1577402007,28,1590866393,13464386
1667839295,202684,true,1577559747,28,1590707322,13147575
1667839307,202682,true,1577875275,28,1590707322,12832047
1667839403,202680,true,1578190865,28,1590548267,12357402
1667839427,202680,true,1578190865,28,1590389229,12198364
1667839499,202679,true,1578348684,28,1590230206,11881522
1667839559,202677,true,1578664370,28,1589912207,11247837
1667840195,202676,true,1578822236,28,1588005552,9183316
1667840255,202676,true,1578822236,28,1587846767,9024531
1667840267,202675,true,1578980119,28,1587846767,8866648
1667840507,202673,true,1579295930,28,1586894393,7598463
1667840615,202672,true,1579453860,28,1586418420,6964560
1667840867,202673,true,1579295930,28,1585149856,5853926
1667842487,202672,true,1579453860,28,1581982882,2529022
1667842883,202670,true,1579769767,28,1581982882,2213115
1667843015,202670,true,1579769767,28,1581982882,2213115
1667843027,202670,true,1579769767,28,1581982882,2213115
1667843219,202670,true,1579769767,28,1581982882,2213115
1667843423,202668,true,1580085736,28,1581982882,1897146
1667844107,202667,true,1580243745,28,1581982882,1739137
1667844227,202667,true,1580243745,28,1582141081,1897336
1667844263,202667,true,1580243745,28,1582141081,1897336
1667844743,202665,true,1580559809,28,1582457525,1897716
1667845259,202664,true,1580717865,28,1582932309,2214444
1667845283,202664,true,1580717865,28,1582932309,2214444
1667845379,202664,true,1580717865,28,1583248912,2531047
1667845391,202661,true,1581192128,28,1583248912,2056784
1667845415,202660,true,1581350247,28,1583248912,1898665
1667845439,202660,true,1581350247,28,1583407237,2056990
1667845463,202660,true,1581350247,28,1583407237,2056990
1667845583,202658,true,1581666533,28,1583882306,2215773
1667845799,202656,true,1581982882,28,1584515954,2533072
1667845811,202656,true,1581982882,28,1584515954,2533072
1667846123,202655,true,1582141081,28,1585784011,3642930
1667847119,202653,true,1582457525,28,1589117490,6659965
1667847503,202653,true,1582457525,28,1589753232,7295707
1667847635,202653,true,1582457525,28,1589753232,7295707
1667847743,202653,true,1582457525,28,1589753232,7295707
1667848355,202651,true,1582774032,28,1589753232,6979200
1667848811,202651,true,1582774032,28,1589753232,6979200
1667848823,202651,true,1582774032,28,1589912207,7138175
1667848835,202650,true,1582932309,28,1589912207,6979898
1667848847,202649,true,1583090603,28,1589912207,6821604
1667848979,202648,true,1583248912,28,1589912207,6663295
1667849531,202649,true,1583090603,28,1590230206,7139603
1667849567,202648,true,1583248912,28,1590230206,6981294
1667849579,202646,true,1583565577,28,1590230206,6664629
1667849687,202645,true,1583723934,28,1590548267,6824333
1667849699,202645,true,1583723934,28,1590707322,6983388
1667849759,202644,true,1583882306,28,1590866393,6984087
1667849771,202642,true,1584199099,28,1591025480,6826381
1667849795,202641,true,1584357519,28,1591184582,6827063
1667849831,202641,true,1584357519,28,1591343701,6986182
1667849855,202639,true,1584674406,28,1591502835,6828429
1667849867,202637,true,1584991357,28,1591661985,6670628
1667851931,202636,true,1585149856,28,1603483378,18333522
1667852399,202635,true,1585308371,28,1603483378,18175007
1667852663,202634,true,1585466902,28,1603483378,18016476
1667853083,202632,true,1585784011,28,1603483378,17699367
1667853179,202630,true,1586101183,28,1603483378,17382195
1667855567,202630,true,1586101183,28,1603323046,17221863
1667855699,202629,true,1586259794,28,1603323046,17063252
1667855771,202627,true,1586577061,28,1603323046,16745985
1667855783,202625,true,1586894393,28,1603323046,16428653
1667855855,202625,true,1586894393,28,1603323046,16428653
1667855903,202623,true,1587211787,28,1603323046,16111259
1667856023,202622,true,1587370509,28,1603162730,15792221
1667856611,202621,true,1587529246,28,1602521625,14992379
1667856683,202621,true,1587529246,28,1602361389,14832143
1667856695,202620,true,1587687999,28,1602361389,14673390
1667856743,202619,true,1587846767,28,1602201169,14354402
1667856767,202618,true,1588005552,28,1602040964,14035412
1667856791,202617,true,1588164353,28,1602040964,13876611
1667856839,202616,true,1588323169,28,1601720604,13397435
1667856863,202615,true,1588482001,28,1601720604,13238603
1667856911,202615,true,1588482001,28,1601400308,12918307
1667856947,202614,true,1588640850,28,1601240184,12599334
1667856959,202613,true,1588799714,28,1601080076,12280362
1667856983,202613,true,1588799714,28,1600919984,12120270
1667857007,202611,true,1589117490,28,1600759908,11642418
1667857127,202611,true,1589117490,28,1599959768,10842278
1667857139,202610,true,1589276401,28,1599799788,10523387
1667857187,202609,true,1589435329,28,1599319944,9884615
1667857211,202608,true,1589594272,28,1599160028,9565756
1667857223,202608,true,1589594272,28,1599000128,9405856
1667857235,202607,true,1589753232,28,1598840244,9087012
1667857247,202607,true,1589753232,28,1598680376,8927144
1667857823,202606,true,1589912207,28,1591661985,1749778
1667858459,202607,true,1589753232,28,1583723934,-6029298
1667858471,202606,true,1589912207,28,1583565577,-6346630
1667858483,202606,true,1589912207,28,1583407237,-6504970
1667858519,202605,true,1590071198,28,1583090603,-6980595
1667858543,202606,true,1589912207,28,1582774032,-7138175
1667858603,202606,true,1589912207,28,1581982882,-7929325
1667858627,202606,true,1589912207,28,1581824700,-8087507
1667858675,202606,true,1589912207,28,1581192128,-8720079
1667858687,202607,true,1589753232,28,1581034025,-8719207
1667859227,202608,true,1589594272,28,1576928881,-12665391
1667859491,202608,true,1589594272,28,1575667905,-13926367
1667859599,202608,true,1589594272,28,1575195299,-14398973
1667859611,202610,true,1589276401,28,1575037795,-14238606
1667859635,202611,true,1589117490,28,1574880307,-14237183
1667859671,202612,true,1588958594,28,1574722835,-14235759
1667859707,202612,true,1588958594,28,1574565379,-14393215
1667859743,202614,true,1588640850,28,1574250513,-14390337
1667859803,202615,true,1588482001,28,1573935710,-14546291
1667859815,202616,true,1588323169,28,1573935710,-14387459
1667859827,202618,true,1588005552,28,1573778332,-14227220
1667859851,202620,true,1587687999,28,1573620970,-14067029
1667859863,202621,true,1587529246,28,1573463624,-14065622
1667859875,202623,true,1587211787,28,1573463624,-13748163
1667859911,202624,true,1587053082,28,1573148978,-13904104
1667859923,202626,true,1586735719,28,1572991679,-13744040
1667859935,202628,true,1586418420,28,1572834395,-13584025
1667859947,202629,true,1586259794,28,1572677128,-13582666
1667859971,202632,true,1585784011,28,1572362639,-13421372
1667859983,202633,true,1585625448,28,1572205419,-13420029
1667860055,202635,true,1585308371,28,1571262426,-14045945
1667860079,202636,true,1585149856,28,1570948220,-14201636
1667860091,202639,true,1584674406,28,1570791141,-13883265
1667860415,202641,true,1584357519,28,1566086064,-18271455
1667860859,202642,true,1584199099,28,1561238957,-22960142
1667861171,202644,true,1583882306,28,1557808178,-26074128
1667861399,202646,true,1583565577,28,1555473334,-28092243
1667861471,202648,true,1583248912,28,1554851300,-28397612
1667861483,202649,true,1583090603,28,1554695830,-28394773
1667861663,202650,true,1582932309,28,1553452633,-29479676
1667861675,202652,true,1582615771,28,1553452633,-29163138
1667861699,202654,true,1582299295,28,1553297303,-29001992
1667861711,202655,true,1582141081,28,1553297303,-28843778
1667861723,202656,true,1581982882,28,1553297303,-28685579
1667861987,202657,true,1581824700,28,1553918716,-27905984
1667862539,202659,true,1581508382,28,1556095616,-25412766
1667862599,202660,true,1581350247,28,1556406851,-24943396
1667862827,202661,true,1581192128,28,1557340929,-23851199
1667862899,202663,true,1580875937,28,1557652412,-23223525
1667862971,202664,true,1580717865,28,1557963959,-22753906
1667862995,202666,true,1580401769,28,1558119755,-22282014
1667863019,202667,true,1580243745,28,1558119755,-22123990
1667863031,202668,true,1580085736,28,1558275567,-21810169
1667863151,202670,true,1579769767,28,1558898971,-20870796
1667863691,202671,true,1579611805,28,1561395081,-18216724
1667863727,202672,true,1579453860,28,1561551220,-17902640
1667863979,202673,true,1579295930,28,1562332152,-16963778
1667864051,202675,true,1578980119,28,1562644634,-16335485
1667864987,202676,true,1578822236,28,1564990242,-13831994
1667865191,202677,true,1578664370,28,1564990242,-13674128
1667865587,202679,true,1578348684,28,1565146741,-13201943
1667865815,202680,true,1578190865,28,1565146741,-13044124
1667865827,202682,true,1577875275,28,1565303256,-12572019
1667865839,202683,true,1577717503,28,1565303256,-12414247
1667865863,202684,true,1577559747,28,1565303256,-12256491
1667865899,202686,true,1577244282,28,1565303256,-11941026
1667866043,202687,true,1577086574,28,1565616332,-11470242
1667866127,202688,true,1576928881,28,1565772894,-11155987
1667866379,202689,true,1576771204,28,1566399297,-10371907
1667866511,202690,true,1576613542,28,1566712593,-9900949
1667867351,202691,true,1576455897,28,1568907417,-7548480
1667867531,202692,true,1576298267,28,1569378136,-6920131
1667868083,202694,true,1575983054,28,1569848996,-6134058
1667868275,202696,true,1575667905,28,1569848996,-5818909
1667868311,202697,true,1575510354,28,1569848996,-5661358
1667868467,202699,true,1575195299,28,1569848996,-5346303
1667868491,202701,true,1574880307,28,1569848996,-5031311
1667868683,202703,true,1574565379,28,1569848996,-4716383
1667868707,202704,true,1574407938,28,1569848996,-4558942
1667868755,202706,true,1574093103,28,1569848996,-4244107
1667868779,202708,true,1573778332,28,1569692027,-4086305
1667868815,202711,true,1573306293,28,1569692027,-3614266
1667868827,202713,true,1572991679,28,1569692027,-3299652
1667868839,202714,true,1572834395,28,1569692027,-3142368
1667870111,202717,true,1572362639,28,1565303256,-7059383
1667870207,202720,true,1571891025,28,1564990242,-6900783
1667870219,202722,true,1571576694,28,1564990242,-6586452
1667870231,202723,true,1571419552,28,1564990242,-6429310
1667870243,202726,true,1570948220,28,1564990242,-5957978
1667870267,202728,true,1570634078,28,1564833759,-5800319
1667870291,202730,true,1570319998,28,1564833759,-5486239
1667870315,202731,true,1570162982,28,1564833759,-5329223
1667870363,202734,true,1569692027,28,1564833759,-4858268
1667870375,202736,true,1569378136,28,1564833759,-4544377
1667870387,202737,true,1569221214,28,1564833759,-4387455
1667870411,202738,true,1569064307,28,1564833759,-4230548
1667870483,202740,true,1568750541,28,1564990242,-3760299
1667870615,202741,true,1568593682,28,1565303256,-3290426
1667871167,202743,true,1568280010,28,1567809620,-470390
1667871575,202743,true,1568280010,28,1569692027,1412017
1667871659,202745,true,1567966401,28,1570162982,2196581
1667872691,202746,true,1567809620,28,1572205419,4395799
1667872907,202748,true,1567496106,28,1572205419,4709313
1667873855,202748,true,1567496106,28,1572205419,4709313
1667873915,202750,true,1567182653,28,1572205419,5022766
1667874251,202751,true,1567025951,28,1572205419,5179468
1667875451,202752,true,1566869264,28,1572205419,5336155
1667875643,202752,true,1566869264,28,1572362639,5493375
1667875811,202753,true,1566712593,28,1572362639,5650046
1667875835,202754,true,1566555937,28,1572362639,5806702
1667875847,202755,true,1566399297,28,1572362639,5963342
1667875859,202755,true,1566399297,28,1572205419,5806122
1667875883,202756,true,1566242673,28,1572205419,5962746
1667875907,202757,true,1566086064,28,1572048214,5962150
1667875931,202758,true,1565929471,28,1572048214,6118743
1667875943,202758,true,1565929471,28,1571891025,5961554
1667875955,202759,true,1565772894,28,1571891025,6118131
1667875967,202760,true,1565616332,28,1571733852,6117520
1667876087,202763,true,1565146741,28,1570477030,5330289
1667876315,202764,true,1564990242,28,1567339372,2349130
1667876351,202765,true,1564833759,28,1566869264,2035505
1667876375,202766,true,1564677291,28,1566399297,1722006
1667876411,202768,true,1564364403,28,1565929471,1565068
1667876435,202770,true,1564051577,28,1565616332,1564755
1667876459,202772,true,1563738813,28,1565146741,1407928
1667876471,202773,true,1563582455,28,1564990242,1407787
1667876483,202775,true,1563269786,28,1564677291,1407505
1667876495,202777,true,1562957178,28,1564520839,1563661
1667876507,202779,true,1562644634,28,1564207982,1563348
1667876543,202780,true,1562488385,28,1563426112,937727
1667876687,202783,true,1562019732,28,1560458571,-1561161
1667876723,202785,true,1561707375,28,1559678576,-2028799
1667876735,202787,true,1561395081,28,1559522624,-1872457
1667876867,202788,true,1561238957,28,1556873820,-4365137
1667876879,202790,true,1560926756,28,1556718148,-4208608
1667876987,202791,true,1560770679,28,1554695830,-6074849
1667876999,202792,true,1560614617,28,1554540376,-6074241
1667877107,202793,true,1560458571,28,1552520888,-7937683
1667877191,202795,true,1560146526,28,1551124317,-9022209
1667877215,202796,true,1559990527,28,1550659073,-9331454
1667877371,202796,true,1559990527,28,1548025324,-11965203
1667877479,202797,true,1559834544,28,1546014299,-13820245
1667877503,202798,true,1559678576,28,1545705142,-13973434
1667877515,202799,true,1559522624,28,1545396048,-14126576
1667877527,202800,true,1559366687,28,1545087015,-14279672
1667877539,202800,true,1559366687,28,1544932522,-14434165
1667877551,202802,true,1559054861,28,1544623581,-14431280
1667877623,202804,true,1558743096,28,1542925514,-15817582
1667877635,202805,true,1558587238,28,1542616976,-15970262
1667877647,202806,true,1558431394,28,1542462729,-15968665
1667877755,202808,true,1558119755,28,1540150885,-17968870
1667877815,202810,true,1557808178,28,1539073211,-18734967
1667877827,202812,true,1557496663,28,1538919319,-18577344
1667877839,202812,true,1557496663,28,1538765442,-18731221
1667878187,202814,true,1557185210,28,1535844709,-21340501
1667878715,202816,true,1556873820,28,1533849508,-23024312
1667878811,202818,true,1556562492,28,1533389445,-23173047
1667878871,202819,true,1556406851,28,1533082813,-23324038
1667878895,202820,true,1556251226,28,1532929521,-23321705
1667878907,202823,true,1555784444,28,1532929521,-22854923
1667878967,202825,true,1555473334,28,1532622981,-22850353
1667878979,202825,true,1555473334,28,1532469734,-23003600
1667879051,202827,true,1555162286,28,1532010085,-23152201
1667879111,202830,true,1554695830,28,1531397434,-23298396
1667879123,202832,true,1554384938,28,1531397434,-22987504
1667879135,202834,true,1554074107,28,1531244309,-22829798
1667879711,202837,true,1553607978,28,1528337852,-25270126
1667879723,202840,true,1553141989,28,1528185034,-24956955
1667879759,202842,true,1552831407,28,1528032231,-24799176
1667879795,202843,true,1552676140,28,1527726670,-24949470
1667879807,202847,true,1552055225,28,1527573913,-24481312
1667879819,202850,true,1551589701,28,1527573913,-24015788
1667879843,202853,true,1551124317,28,1527268444,-23855873
1667879939,202855,true,1550814139,28,1526199783,-24614356
1667879951,202859,true,1550193968,28,1526047179,-24146789
1667879963,202863,true,1549574046,28,1525894589,-23679457
1667880047,202866,true,1549109267,28,1524826890,-24282377
1667880059,202869,true,1548644627,28,1524674423,-23970204
1667880143,202874,true,1547870537,28,1523455232,-24415305
1667880179,202877,true,1547406268,28,1522846002,-24560266
1667880191,202881,true,1546787461,28,1522693733,-24093728
1667880203,202884,true,1546323517,28,1522541479,-23782038
1667880215,202889,true,1545550587,28,1522389240,-23161347
1667880419,202891,true,1545241523,28,1520107482,-25134041
1667880455,202895,true,1544623581,28,1519651541,-24972040
1667880467,202898,true,1544160287,28,1519499591,-24660696
1667880479,202903,true,1543388438,28,1519347656,-24040782
1667880491,202906,true,1542925514,28,1519195736,-23729778
1667880515,202909,true,1542462729,28,1518740069,-23722660
1667880527,202913,true,1541845898,28,1518588210,-23257688
1667880539,202918,true,1541075207,28,1518436366,-22638841
1667880599,202922,true,1540458931,28,1517222164,-23236767
1667880635,202927,true,1539688932,28,1516463780,-23225152
1667880695,202930,true,1539227118,28,1515099645,-24127473
1667880707,202936,true,1538303905,28,1514796670,-23507235
1667880719,202940,true,1537688737,28,1514342322,-23346415
1667880755,202946,true,1536766447,28,1513131393,-23635054
1667880791,202952,true,1535844709,28,1512072625,-23772084
1667880803,202957,true,1535077017,28,1511619094,-23457923
1667880815,202962,true,1534309709,28,1511316815,-22992894
1667880827,202968,true,1533389445,28,1510863511,-22525934
1667880851,202975,true,1532316502,28,1509957310,-22359192
1667880911,202981,true,1531397434,28,1507995739,-23401695
1667880983,202986,true,1530631965,28,1505735554,-24896411
1667880995,202991,true,1529866878,28,1505283924,-24582954
1667881007,202999,true,1528643535,28,1504982912,-23660623
1667881019,203005,true,1527726670,28,1504681960,-23044710
1667881031,203009,true,1527115732,28,1504230646,-22885086
1667881115,203015,true,1526199783,28,1501976104,-24223679
1667881127,203022,true,1525131871,28,1501525601,-23606270
1667881151,203028,true,1524217112,28,1500925141,-23291971
1667881343,203033,true,1523455232,28,1495232733,-28222499
1667881379,203038,true,1522693733,28,1494186488,-28507245
1667881403,203046,true,1521476126,28,1493588963,-27887163
1667881415,203052,true,1520563559,28,1493290290,-27273269
1667881427,203056,true,1519955486,28,1492842393,-27113093
1667881463,203061,true,1519195736,28,1491947001,-27248735
1667881487,203068,true,1518132724,28,1491350371,-26782353
1667881595,203074,true,1517222164,28,1488817356,-28404808
1667881691,203078,true,1516615426,28,1486883247,-29732179
1667881715,203083,true,1515857346,28,1486437272,-29420074
1667881727,203090,true,1514796670,28,1486140029,-28656641
1667881739,203096,true,1513888110,28,1485991430,-27896680
1667882207,203099,true,1513434035,28,1479171907,-34262128
1667882231,203104,true,1512677545,28,1478728244,-33949301
1667882303,203110,true,1511770256,28,1477693548,-34076708
1667882315,203116,true,1510863511,28,1477545794,-33317717
1667882339,203119,true,1510410343,28,1477250329,-33160014
1667882351,203124,true,1509655364,28,1477102619,-32552745
1667882399,203130,true,1508749888,28,1476659576,-32090312
1667882591,203134,true,1508146538,28,1476216667,-31929871
1667882699,203137,true,1507694185,28,1476807242,-30886943
1667882711,203141,true,1507091258,28,1476807242,-30284016
1667882735,203147,true,1506187320,28,1476954923,-29232397
1667882747,203151,true,1505584995,28,1477102619,-28482376
1667882759,203153,true,1505283924,28,1477102619,-28181305
1667882771,203157,true,1504681960,28,1477102619,-27579341
1667882795,203163,true,1503779467,28,1477250329,-26529138
1667882843,203167,true,1503178106,28,1477250329,-25927777
1667882855,203169,true,1502877515,28,1477250329,-25627186
1667882927,203172,true,1502426742,28,1477250329,-25176413
1667882939,203178,true,1501525601,28,1477250329,-24275272
1667882951,203182,true,1500925141,28,1477250329,-23674812
1667882963,203184,true,1500625001,28,1477250329,-23374672
1667883035,203188,true,1500024901,28,1477250329,-22774572
1667883047,203194,true,1499125201,28,1477250329,-21874872
1667883071,203197,true,1498675554,28,1477250329,-21425225
1667883095,203200,true,1498226041,28,1477250329,-20975712
1667883311,203203,true,1497776663,28,1477102619,-20674044
1667883335,203210,true,1496728639,28,1476954923,-19773716
1667883359,203214,true,1496130097,28,1476807242,-19322855
1667883371,203216,true,1495830916,28,1476807242,-19023674
1667883383,203220,true,1495232733,28,1476659576,-18573157
1667883467,203227,true,1494186488,28,1476216667,-17969821
1667883767,203231,true,1493588963,28,1473856727,-19732236
1667883779,203234,true,1493140976,28,1473709356,-19431620
1667883827,203238,true,1492543869,28,1473414658,-19129211
1667883839,203244,true,1491648656,28,1473267332,-18381324
1667883851,203247,true,1491201251,28,1473267332,-17933919
1667883887,203248,true,1491052146,28,1472972722,-18079424
1667884103,203252,true,1490455874,28,1471942054,-18513820
1667884211,203258,true,1489561913,28,1471500559,-18061354
1667884223,203260,true,1489264046,28,1471500559,-17763487
1667884247,203261,true,1489115134,28,1471353424,-17761710
1667884259,203265,true,1488519637,28,1471353424,-17166213
1667884271,203272,true,1487478090,28,1471206303,-16271787
1667884283,203275,true,1487031936,28,1471206303,-15825633
1667884295,203277,true,1486734574,28,1471059197,-15675377
1667884307,203280,true,1486288643,28,1471059197,-15229446
1667884415,203289,true,1484951652,28,1469735906,-15215746
1667884439,203292,true,1484506255,28,1469588947,-14917308
1667884583,203295,true,1484060992,28,1467533065,-16527927
1667884595,203299,true,1483467516,28,1467386326,-16081190
1667884607,203307,true,1482281276,28,1467386326,-14894950
1667884643,203311,true,1481688512,28,1466946198,-14742314
1667884655,203312,true,1481540358,28,1466799518,-14740840
1667884847,203315,true,1481095985,28,1465333525,-15762460
1667884859,203324,true,1479763664,28,1465333525,-14430139
1667884895,203327,true,1479319824,28,1464894013,-14425811
1667885015,203329,true,1479024005,28,1463722625,-15301380
1667885039,203332,true,1478580386,28,1463429924,-15150462
1667885051,203341,true,1477250329,28,1463137282,-14113047
1667885063,203343,true,1476954923,28,1462990983,-13963940
1667885171,203346,true,1476511925,28,1461528797,-14983128
1667885195,203350,true,1475921468,28,1461236535,-14684933
1667885279,203358,true,1474741262,28,1459776101,-14965161
1667885327,203360,true,1474446358,28,1459046432,-15399926
1667885339,203364,true,1473856727,28,1458900542,-14956185
1667885351,203367,true,1473414658,28,1458754667,-14659991
1667885363,203375,true,1472236457,28,1458608806,-13627651
1667885387,203376,true,1472089248,28,1458317128,-13772120
1667885435,203379,true,1471647709,28,1457733947,-13913762
1667885507,203381,true,1471353424,28,1457005298,-14348126
1667885531,203389,true,1470176871,28,1456713941,-13462930
1667885555,203390,true,1470029868,28,1456422642,-13607226
1667885579,203393,true,1469588947,28,1456277014,-13311933
1667885591,203396,true,1469148159,28,1456131401,-13016758
1667885615,203403,true,1468120166,28,1455840219,-12279947
1667885723,203404,true,1467973369,28,1454676070,-13297299
1667885795,203407,true,1467533065,28,1453948950,-13584115
1667885807,203409,true,1467239602,28,1453803570,-13436032
1667885831,203416,true,1466212945,28,1453512853,-12700092
1667885843,203416,true,1466212945,28,1453512853,-12700092
1667885855,203418,true,1465919747,28,1453367516,-12552231
1667885879,203418,true,1465919747,28,1453222194,-12697553
1667885939,203424,true,1465040502,28,1452786315,-12254187
1667885987,203424,true,1465040502,28,1452495801,-12544701
1667886143,203424,true,1465040502,28,1452205345,-12835157
1667886167,203423,true,1465187006,28,1452205345,-12981661
1667886203,203427,true,1464601078,28,1452350566,-12250512
1667886215,203427,true,1464601078,28,1452350566,-12250512
1667886239,203427,true,1464601078,28,1452495801,-12105277
1667886347,203426,true,1464747538,28,1453222194,-11525344
1667886455,203428,true,1464454633,28,1453948950,-10505683
1667886839,203427,true,1464601078,28,1456131401,-8469677
1667886935,203427,true,1464601078,28,1457150999,-7450079
1667886983,203426,true,1464747538,28,1457879720,-6867818
1667886995,203428,true,1464454633,28,1458025508,-6429125
1667887115,203427,true,1464601078,28,1460214078,-4387000
1667887427,203427,true,1464601078,28,1464308202,-292876
1667888099,203426,true,1464747538,28,1468707502,3959964
1667888255,203429,true,1464308202,28,1469148159,4839957
1667888375,203427,true,1464601078,28,1469442003,4840925
1667888387,203427,true,1464601078,28,1469442003,4840925
1667888399,203426,true,1464747538,28,1469442003,4694465
1667888723,203429,true,1464308202,28,1470470921,6162719
1667888819,203427,true,1464601078,28,1470617968,6016890
1667888879,203427,true,1464601078,28,1470617968,6016890
1667888903,203427,true,1464601078,28,1470765030,6163952
1667888939,203430,true,1464161786,28,1470765030,6603244
1667889059,203429,true,1464308202,28,1470912106,6603904
1667889083,203429,true,1464308202,28,1470912106,6603904
1667889095,203428,true,1464454633,28,1470912106,6457473
1667889107,203431,true,1464015384,28,1470912106,6896722
1667889131,203430,true,1464161786,28,1470912106,6750320
1667889155,203430,true,1464161786,28,1471059197,6897411
1667889167,203430,true,1464161786,28,1471059197,6897411
1667889227,203432,true,1463868997,28,1471353424,7484427
1667889263,203430,true,1464161786,28,1471500559,7338773
1667889275,203430,true,1464161786,28,1471647709,7485923
1667889431,203430,true,1464161786,28,1472530919,8369133
1667889731,203431,true,1464015384,28,1474298928,10283544
1667889875,203430,true,1464161786,28,1475036225,10874439
1667889887,203430,true,1464161786,28,1475183729,11021943
1667890031,203429,true,1464308202,28,1476069060,11760858
1667890055,203430,true,1464161786,28,1476216667,12054881
1667890079,203428,true,1464454633,28,1476364289,11909656
1667890331,203428,true,1464454633,28,1478136901,13682268
1667890415,203427,true,1464601078,28,1478580386,13979308
1667890427,203428,true,1464454633,28,1478728244,14273611
1667890463,203426,true,1464747538,28,1479024005,14276467
1667890535,203425,true,1464894013,28,1479615703,14721690
1667890547,203424,true,1465040502,28,1479615703,14575201
1667890607,203425,true,1464894013,28,1480207638,15313625
1667890631,203422,true,1465333525,28,1480355659,15022134
1667890931,203421,true,1465480059,28,1483022565,17542506
1667890967,203420,true,1465626607,28,1483170867,17544260
1667891243,203421,true,1465480059,28,1484357819,18877760
1667891255,203418,true,1465919747,28,1484357819,18438072
1667891423,203418,true,1465919747,28,1484951652,19031905
1667891447,203416,true,1466212945,28,1485100147,18887202
1667891459,203417,true,1466066338,28,1485100147,19033809
1667891603,203415,true,1466359566,28,1485545721,19186155
1667891699,203414,true,1466506202,28,1485842845,19336643
1667891711,203412,true,1466799518,28,1485842845,19043327
1667891723,203413,true,1466652853,28,1485842845,19189992
1667891747,203410,true,1467092893,28,1485842845,18749952
1667891759,203410,true,1467092893,28,1485842845,18749952
1667891771,203408,true,1467386326,28,1485842845,18456519
1667891807,203409,true,1467239602,28,1485991430,18751828
1667891903,203407,true,1467533065,28,1485991430,18458365
1667891939,203406,true,1467679818,28,1485991430,18311612
1667892779,203405,true,1467826586,28,1484357819,16531233
1667893091,203406,true,1467679818,28,1483467516,15787698
1667893103,203404,true,1467973369,28,1483467516,15494147
1667893115,203404,true,1467973369,28,1483467516,15494147
1667893127,203402,true,1468266978,28,1483467516,15200538
1667893139,203402,true,1468266978,28,1483467516,15200538
1667893151,203400,true,1468560646,28,1483467516,14906870
1667893187,203399,true,1468707502,28,1483467516,14760014
1667893211,203397,true,1469001258,28,1483467516,14466258
1667893523,203395,true,1469295073,28,1484357819,15062746
1667893535,203392,true,1469735906,28,1484357819,14621913
1667893559,203390,true,1470029868,28,1484357819,14327951
1667894315,203388,true,1470323888,28,1488519637,18195749
1667894363,203385,true,1470765030,28,1488817356,18052326
1667894663,203382,true,1471206303,28,1490753980,19547677
1667894675,203381,true,1471353424,28,1490753980,19400556
1667894699,203379,true,1471647709,28,1490903055,19255346
1667894819,203376,true,1472089248,28,1491648656,19559408
1667894843,203374,true,1472383680,28,1491648656,19264976
1667894867,203372,true,1472678172,28,1491797821,19119649
1667894915,203369,true,1473120020,28,1492096195,18976175
1667895023,203367,true,1473414658,28,1492096195,18681537
1667895035,203364,true,1473856727,28,1492096195,18239468
1667895131,203361,true,1474298928,28,1492096195,17797267
1667895143,203358,true,1474741262,28,1492096195,17354933
1667895179,203355,true,1475183729,28,1492096195,16912466
1667895215,203353,true,1475478780,28,1492096195,16617415
1667895227,203349,true,1476069060,28,1492096195,16027135
1667895407,203346,true,1476511925,28,1491648656,15136731
1667895419,203344,true,1476807242,28,1491648656,14841414
1667895443,203341,true,1477250329,28,1491499506,14249177
1667895455,203339,true,1477545794,28,1491499506,13953712
1667895503,203336,true,1477989102,28,1491350371,13361269
1667895515,203334,true,1478284714,28,1491350371,13065657
1667895611,203332,true,1478580386,28,1491052146,12471760
1667895923,203329,true,1479024005,28,1489859841,10835836
1667896115,203328,true,1479171907,28,1489115134,9943227
1667896463,203325,true,1479615703,28,1487626838,8011135
1667896523,203324,true,1479763664,28,1487329357,7565693
1667896607,203321,true,1480207638,28,1487180639,6973001
1667896703,203319,true,1480503694,28,1486883247,6379553
1667896715,203317,true,1480799810,28,1486883247,6083437
1667896727,203315,true,1481095985,28,1486883247,5787262
1667896787,203313,true,1481392219,28,1486734574,5342355
1667896883,203312,true,1481540358,28,1486585915,5045557
1667896967,203310,true,1481836681,28,1486585915,4749234
1667897015,203308,true,1482133063,28,1486585915,4452852
1667897195,203306,true,1482429504,28,1486734574,4305070
1667897411,203305,true,1482577747,28,1487180639,4602892
1667897423,203303,true,1482874278,28,1487180639,4306361
1667897459,203301,true,1483170867,28,1487180639,4009772
1667897531,203300,true,1483319184,28,1487478090,4158906
1667897699,203298,true,1483615863,28,1487775600,4159737
1667898011,203297,true,1483764225,28,1488519637,4755412
1667898143,203296,true,1483912601,28,1488817356,4904755
1667898155,203294,true,1484209398,28,1488966238,4756840
1667898239,203293,true,1484357819,28,1489115134,4757315
1667898359,203291,true,1484654706,28,1489264046,4609340
1667898551,203291,true,1484654706,28,1489561913,4907207
1667899067,203289,true,1484951652,28,1489412972,4461320
1667899079,203288,true,1485100147,28,1489412972,4312825
1667899115,203287,true,1485248657,28,1489412972,4164315
1667899127,203286,true,1485397182,28,1489412972,4015790
1667899139,203286,true,1485397182,28,1489264046,3866864
1667899295,203285,true,1485545721,28,1488817356,3271635
1667899595,203283,true,1485842845,28,1487924378,2081533
1667899631,203283,true,1485842845,28,1487924378,2081533
1667899643,203282,true,1485991430,28,1487775600,1784170
1667899655,203281,true,1486140029,28,1487775600,1635571
1667899703,203280,true,1486288643,28,1487775600,1486957
1667899943,203279,true,1486437272,28,1487626838,1189566
1667900063,203278,true,1486585915,28,1487478090,892175
1667900075,203278,true,1486585915,28,1487478090,892175
1667900099,203276,true,1486883247,28,1487478090,594843
1667900147,203275,true,1487031936,28,1487626838,594902
1667900255,203275,true,1487031936,28,1487626838,594902
1667900675,203274,true,1487180639,28,1488073170,892531
1667900699,203273,true,1487329357,28,1488221978,892621
1667900807,203272,true,1487478090,28,1488370800,892710
1667900879,203272,true,1487478090,28,1488668489,1190399
1667900891,203271,true,1487626838,28,1488668489,1041651
1667900903,203270,true,1487775600,28,1488668489,892889
1667900927,203269,true,1487924378,28,1488817356,892978
1667900939,203268,true,1488073170,28,1488966238,893068
1667900963,203268,true,1488073170,28,1488966238,893068
1667901035,203267,true,1488221978,28,1489412972,1190994
1667901227,203266,true,1488370800,28,1490306843,1936043
1667901323,203266,true,1488370800,28,1490753980,2383180
1667901347,203265,true,1488519637,28,1490903055,2383418
1667901383,203264,true,1488668489,28,1491052146,2383657
1667901779,203264,true,1488668489,28,1492096195,3427706
1667901791,203264,true,1488668489,28,1492096195,3427706
1667901851,203263,true,1488817356,28,1492245405,3428049
1667901887,203263,true,1488817356,28,1492245405,3428049
1667901911,203263,true,1488817356,28,1492245405,3428049
1667902139,203263,true,1488817356,28,1492245405,3428049
1667902343,203263,true,1488817356,28,1491947001,3129645
1667902463,203262,true,1488966238,28,1491947001,2980763
1667902823,203262,true,1488966238,28,1491052146,2085908
1667902835,203263,true,1488817356,28,1491052146,2234790
1667902895,203263,true,1488817356,28,1490903055,2085699
1667902919,203262,true,1488966238,28,1490753980,1787742
1667902931,203262,true,1488966238,28,1490753980,1787742
1667902943,203262,true,1488966238,28,1490753980,1787742
1667902991,203262,true,1488966238,28,1490604920,1638682
1667903003,203261,true,1489115134,28,1490455874,1340740
1667903027,203262,true,1488966238,28,1490455874,1489636
1667903111,203262,true,1488966238,28,1490008827,1042589
1667903903,203262,true,1488966238,28,1487180639,-1785599
1667903915,203261,true,1489115134,28,1487031936,-2083198
1667904251,203261,true,1489115134,28,1486288643,-2826491
1667904263,203261,true,1489115134,28,1486288643,-2826491
1667904575,203261,true,1489115134,28,1485545721,-3569413
1667904911,203261,true,1489115134,28,1484951652,-4163482
1667904959,203261,true,1489115134,28,1484951652,-4163482
1667905007,203261,true,1489115134,28,1484951652,-4163482
1667905019,203261,true,1489115134,28,1484951652,-4163482
1667905079,203261,true,1489115134,28,1484803171,-4311963
1667905151,203261,true,1489115134,28,1484654706,-4460428
1667905271,203262,true,1488966238,28,1484357819,-4608419
1667905439,203263,true,1488817356,28,1484060992,-4756364
1667905451,203263,true,1488817356,28,1484060992,-4756364
1667905535,203264,true,1488668489,28,1483467516,-5200973
1667905559,203265,true,1488519637,28,1483319184,-5200453
1667905571,203267,true,1488221978,28,1483319184,-4902794
1667905595,203267,true,1488221978,28,1483170867,-5051111
1667905643,203268,true,1488073170,28,1483022565,-5050605
1667905763,203269,true,1487924378,28,1482577747,-5346631
1667905835,203270,true,1487775600,28,1482429504,-5346096
1667905859,203270,true,1487775600,28,1482281276,-5494324
1667905919,203271,true,1487626838,28,1482133063,-5493775
1667906111,203271,true,1487626838,28,1481688512,-5938326
1667906123,203273,true,1487329357,28,1481688512,-5640845
1667906303,203273,true,1487329357,28,1481244094,-6085263
1667906375,203273,true,1487329357,28,1481095985,-6233372
1667906567,203274,true,1487180639,28,1480799810,-6380829
1667906807,203275,true,1487031936,28,1480355659,-6676277
1667906831,203275,true,1487031936,28,1480355659,-6676277
1667907011,203275,true,1487031936,28,1480503694,-6528242
1667907959,203275,true,1487031936,28,1481836681,-5195255
1667908151,203277,true,1486734574,28,1481836681,-4897893
1667908391,203276,true,1486883247,28,1481984864,-4898383
1667908439,203276,true,1486883247,28,1481984864,-4898383
1667908451,203277,true,1486734574,28,1481984864,-4749710
1667908559,203278,true,1486585915,28,1481984864,-4601051
1667908883,203278,true,1486585915,28,1481540358,-5045557
1667909027,203278,true,1486585915,28,1481392219,-5193696
1667909435,203278,true,1486585915,28,1480799810,-5786105
1667909615,203279,true,1486437272,28,1480651745,-5785527
1667909639,203279,true,1486437272,28,1480651745,-5785527
1667909651,203279,true,1486437272,28,1480651745,-5785527
1667909675,203279,true,1486437272,28,1480651745,-5785527
1667910323,203280,true,1486288643,28,1480947890,-5340753
1667911007,203280,true,1486288643,28,1481984864,-4303779
1667911115,203280,true,1486288643,28,1482133063,-4155580
1667911139,203281,true,1486140029,28,1482133063,-4006966
1667911151,203282,true,1485991430,28,1482133063,-3858367
1667911163,203282,true,1485991430,28,1482133063,-3858367
1667911175,203282,true,1485991430,28,1482133063,-3858367
1667911187,203283,true,1485842845,28,1482133063,-3709782
1667911199,203284,true,1485694276,28,1482133063,-3561213
1667911331,203285,true,1485545721,28,1481984864,-3560857
1667911367,203285,true,1485545721,28,1481984864,-3560857
1667911511,203286,true,1485397182,28,1481688512,-3708670
1667911751,203287,true,1485248657,28,1480947890,-4300767
1667911823,203288,true,1485100147,28,1480651745,-4448402
1667912111,203288,true,1485100147,28,1479763664,-5336483
1667912519,203289,true,1484951652,28,1478580386,-6371266
1667913659,203290,true,1484803171,28,1477102619,-7700552
1667913887,203291,true,1484654706,28,1476954923,-7699783
1667914139,203291,true,1484654706,28,1476807242,-7847464
1667914163,203292,true,1484506255,28,1476807242,-7699013
1667914223,203293,true,1484357819,28,1476807242,-7550577
1667914307,203294,true,1484209398,28,1476659576,-7549822
1667914355,203294,true,1484209398,28,1476511925,-7697473
1667915003,203295,true,1484060992,28,1475626328,-8434664
1667915651,203296,true,1483912601,28,1474741262,-9171339
1667915663,203296,true,1483912601,28,1474741262,-9171339
1667915699,203297,true,1483764225,28,1474593803,-9170422
1667915723,203297,true,1483764225,28,1474593803,-9170422
1667915771,203299,true,1483467516,28,1474446358,-9021158
1667915807,203300,true,1483319184,28,1474298928,-9020256
1667915831,203301,true,1483170867,28,1474151513,-9019354
1667915843,203302,true,1483022565,28,1474151513,-8871052
1667915855,203304,true,1482726005,28,1474004113,-8721892
1667915867,203306,true,1482429504,28,1474004113,-8425391
1667916143,203307,true,1482281276,28,1472383680,-9897596
1667916191,203308,true,1482133063,28,1472089248,-10043815
1667916203,203310,true,1481836681,28,1471942054,-9894627
1667916227,203312,true,1481540358,28,1471794874,-9745484
1667916239,203314,true,1481244094,28,1471794874,-9449220
1667916299,203315,true,1481095985,28,1471353424,-9742561
1667916323,203317,true,1480799810,28,1471353424,-9446386
1667916335,203319,true,1480503694,28,1471206303,-9297391
1667916347,203321,true,1480207638,28,1471206303,-9001335
1667916359,203321,true,1480207638,28,1471206303,-9001335
1667916371,203324,true,1479763664,28,1471059197,-8704467
1667916647,203325,true,1479615703,28,1470470921,-9144782
1667916659,203327,true,1479319824,28,1470323888,-8995936
1667917067,203328,true,1479171907,28,1468707502,-10464405
1667917079,203330,true,1478876117,28,1468560646,-10315471
1667917199,203331,true,1478728244,28,1467826586,-10901658
1667917211,203333,true,1478432543,28,1467679818,-10752725
1667917319,203335,true,1478136901,28,1466799518,-11337383
1667917403,203337,true,1477841318,28,1466212945,-11628373
1667917415,203339,true,1477545794,28,1466066338,-11479456
1667917427,203341,true,1477250329,28,1465919747,-11330582
1667917439,203343,true,1476954923,28,1465773169,-11181754
1667917607,203345,true,1476659576,28,1464601078,-12058498
1667917619,203347,true,1476364289,28,1464454633,-11909656
1667917667,203349,true,1476069060,28,1464308202,-11760858
1667917943,203350,true,1475921468,28,1463868997,-12052471
1667918039,203352,true,1475626328,28,1463722625,-11903703
1667918123,203354,true,1475331247,28,1463576267,-11754980
1667918135,203355,true,1475183729,28,1463429924,-11753805
1667918183,203357,true,1474888736,28,1463283596,-11605140
1667918315,203360,true,1474446358,28,1462113496,-12332862
1667918327,203362,true,1474151513,28,1461967299,-12184214
1667918339,203363,true,1474004113,28,1461967299,-12036814
1667918411,203365,true,1473709356,28,1461090426,-12618930
1667918435,203368,true,1473267332,28,1460652186,-12615146
1667918447,203371,true,1472825440,28,1460506135,-12319305
1667918459,203372,true,1472678172,28,1460360099,-12318073
1667918495,203375,true,1472236457,28,1459922079,-12314378
1667918519,203378,true,1471794874,28,1459630138,-12164736
1667918615,203381,true,1471353424,28,1458317128,-13036296
1667918687,203383,true,1471059197,28,1457296714,-13762483
1667918783,203385,true,1470765030,28,1455694649,-15070381
1667918915,203389,true,1470176871,28,1453803570,-16373301
1667918951,203392,true,1469735906,28,1453222194,-16513712
1667918975,203394,true,1469442003,28,1452786315,-16655688
1667919071,203396,true,1469148159,28,1451334327,-17813832
1667919083,203401,true,1468413805,28,1451189208,-17224597
1667919143,203403,true,1468120166,28,1450608877,-17511289
1667919155,203404,true,1467973369,28,1450463831,-17509538
1667919191,203406,true,1467679818,28,1450173782,-17506036
1667919227,203409,true,1467239602,28,1449883791,-17355811
1667919263,203410,true,1467092893,28,1449593857,-17499036
1667919275,203412,true,1466799518,28,1449593857,-17205661
1667919287,203413,true,1466652853,28,1449593857,-17058996
1667919311,203416,true,1466212945,28,1449448912,-16764033
1667919359,203418,true,1465919747,28,1449159066,-16760681
1667919479,203419,true,1465773169,28,1448579547,-17193622
1667919599,203421,true,1465480059,28,1447710704,-17769355
1667919623,203424,true,1465040502,28,1447565947,-17474555
1667919659,203425,true,1464894013,28,1447276477,-17617536
1667919863,203427,true,1464601078,28,1445829997,-18771081
1667919899,203429,true,1464308202,28,1445540874,-18767328
1667919911,203432,true,1463868997,28,1445396334,-18472663
1667919923,203434,true,1463576267,28,1445396334,-18179933
1667919935,203436,true,1463283596,28,1445251809,-18031787
1667920019,203438,true,1462990983,28,1444818320,-18172663
1667920319,203441,true,1462552174,28,1444240537,-18311637
1667920331,203443,true,1462259707,28,1444240537,-18019170
1667920391,203445,true,1461967299,28,1444384961,-17582338
1667920511,203446,true,1461821117,28,1444962802,-16858315
1667920679,203449,true,1461382658,28,1445829997,-15552661
1667920727,203450,true,1461236535,28,1445974580,-15261955
1667920811,203452,true,1460944331,28,1446697711,-14246620
1667920847,203454,true,1460652186,28,1446987065,-13665121
1667920859,203457,true,1460214078,28,1446987065,-13227013
1667920967,203459,true,1459922079,28,1447276477,-12645602
1667921003,203461,true,1459630138,28,1447276477,-12353661
1667921015,203463,true,1459338256,28,1447276477,-12061779
1667921027,203467,true,1458754667,28,1447276477,-11478190
1667921075,203469,true,1458462960,28,1446987065,-11475895
1667921111,203471,true,1458171311,28,1446842381,-11328930
1667921135,203474,true,1457733947,28,1446697711,-11036236
1667921159,203477,true,1457296714,28,1446697711,-10599003
1667921207,203479,true,1457005298,28,1446263789,-10741509
1667921219,203482,true,1456568284,28,1446263789,-10304495
1667921243,203484,true,1456277014,28,1446119177,-10157837
1667921315,203487,true,1455840219,28,1445540874,-10299345
1667921375,203490,true,1455403554,28,1445107298,-10296256
1667921387,203492,true,1455112517,28,1444962802,-10149715
1667921399,203494,true,1454821538,28,1444818320,-10003218
1667921495,203498,true,1454239755,28,1443951733,-10288022
1667921543,203501,true,1453803570,28,1443518634,-10284936
1667921759,203503,true,1453512853,28,1441787537,-11725316
1667921771,203505,true,1453222194,28,1441643372,-11578822
1667921783,203509,true,1452641050,28,1441643372,-10997678
1667921891,203511,true,1452350566,28,1440922767,-11427799
1667921903,203513,true,1452060139,28,1440922767,-11137372
1667922239,203515,true,1451769771,28,1439338703,-12431068
1667922407,203519,true,1451189208,28,1438475401,-12713807
1667922455,203520,true,1451044104,28,1438331568,-12712536
1667922479,203522,true,1450753938,28,1438187750,-12566188
1667922491,203523,true,1450608877,28,1438187750,-12421127
1667922503,203527,true,1450028779,28,1438187750,-11841029
1667922515,203529,true,1449738817,28,1438043945,-11694872
1667922527,203530,true,1449593857,28,1438043945,-11549912
1667922563,203531,true,1449448912,28,1438043945,-11404967
1667922623,203533,true,1449159066,28,1437900155,-11258911
1667922647,203535,true,1448869278,28,1437900155,-10969123
1667922671,203536,true,1448724405,28,1437900155,-10824250
1667922767,203537,true,1448579547,28,1438043945,-10535602
1667922779,203539,true,1448289875,28,1438187750,-10102125
1667922803,203540,true,1448145060,28,1438187750,-9957310
1667922839,203540,true,1448145060,28,1438331568,-9813492
1667922935,203540,true,1448145060,28,1438906987,-9238073
1667922959,203542,true,1447855475,28,1439050878,-8804597
1667923031,203543,true,1447710704,28,1439482636,-8228068
1667923043,203543,true,1447710704,28,1439626585,-8084119
1667923055,203544,true,1447565947,28,1439626585,-7939362
1667923103,203546,true,1447276477,28,1440058516,-7217961
1667923151,203546,true,1447276477,28,1440490577,-6785900
1667923175,203547,true,1447131764,28,1440778689,-6353075
1667923187,203547,true,1447131764,28,1440922767,-6208997
1667923199,203549,true,1446842381,28,1441066859,-5775522
1667923223,203550,true,1446697711,28,1441499223,-5198488
1667923235,203550,true,1446697711,28,1441643372,-5054339
1667923247,203550,true,1446697711,28,1441787537,-4910174
1667923259,203551,true,1446553056,28,1441931716,-4621340
1667923343,203551,true,1446553056,28,1443374296,-3178760
1667923403,203551,true,1446553056,28,1444240537,-2312519
1667923415,203550,true,1446697711,28,1444529400,-2168311
1667923439,203551,true,1446553056,28,1444818320,-1734736
1667923451,203551,true,1446553056,28,1445107298,-1445758
1667923463,203550,true,1446697711,28,1445251809,-1445902
1667923475,203548,true,1446987065,28,1445540874,-1446191
1667923487,203548,true,1446987065,28,1445829997,-1157068
1667923499,203547,true,1447131764,28,1446119177,-1012587
1667923535,203544,true,1447565947,28,1447276477,-289470
1667923547,203543,true,1447710704,28,1447565947,-144757
1667923571,203542,true,1447855475,28,1448434704,579229
1667923583,203540,true,1448145060,28,1448869278,724218
1667923607,203536,true,1448724405,28,1449593857,869452
1667923619,203534,true,1449014165,28,1450028779,1014614
1667923631,203532,true,1449303982,28,1450463831,1159849
1667923643,203529,true,1449738817,28,1450899014,1160197
1667923655,203525,true,1450318799,28,1451334327,1015528
1667923667,203522,true,1450753938,28,1451769771,1015833
1667923679,203519,true,1451189208,28,1452205345,1016137
1667923703,203515,true,1451769771,28,1453222194,1452423
1667923715,203511,true,1452350566,28,1453658204,1307638
1667923727,203506,true,1453076886,28,1454094345,1017459
1667923739,203503,true,1453512853,28,1454676070,1163217
1667923751,203499,true,1454094345,28,1455112517,1018172
1667923763,203494,true,1454821538,28,1455549094,727556
1667923775,203489,true,1455549094,28,1456131401,582307
1667923787,203485,true,1456131401,28,1456713941,582540
1667923847,203478,true,1457150999,28,1459630138,2479139
1667923871,203472,true,1458025508,28,1460944331,2918823
1667923895,203467,true,1458754667,28,1461967299,3212632
1667923907,203462,true,1459484190,28,1462552174,3067984
1667923919,203456,true,1460360099,28,1463137282,2777183
1667923931,203450,true,1461236535,28,1463868997,2632462
1667923955,203445,true,1461967299,28,1465040502,3073203
1667923967,203440,true,1462698429,28,1465773169,3074740
1667923991,203434,true,1463576267,28,1467092893,3516626
1667924003,203428,true,1464454633,28,1467679818,3225185
1667924027,203422,true,1465333525,28,1469148159,3814634
1667924051,203417,true,1466066338,28,1470470921,4404583
1667924075,203411,true,1466946198,28,1471942054,4995856
1667924123,203405,true,1467826586,28,1474741262,6914676
1667924135,203400,true,1468560646,28,1475331247,6770601
1667924171,203395,true,1469295073,28,1477398054,8102981
1667924207,203389,true,1470176871,28,1479467756,9290885
1667924243,203383,true,1471059197,28,1481392219,10333022
1667924267,203377,true,1471942054,28,1482726005,10783951
1667924363,203373,true,1472530919,28,1487775600,15244681
1667924387,203367,true,1473414658,28,1489115134,15700476
1667924411,203361,true,1474298928,28,1490306843,16007915
1667924459,203356,true,1475036225,28,1492543869,17507644
1667924495,203352,true,1475626328,28,1494335907,18709579
1667924567,203347,true,1476364289,28,1497477153,21112864
1667924591,203341,true,1477250329,28,1498675554,21425225
1667924603,203336,true,1477989102,28,1499275114,21286012
1667924651,203332,true,1478580386,28,1501525601,22945215
1667924663,203326,true,1479467756,28,1502126302,22658546
1667924843,203319,true,1480503694,28,1511165699,30662005
1667924867,203314,true,1481244094,28,1512375055,31130961
1667924903,203310,true,1481836681,28,1514190903,32354222
1667925083,203303,true,1482874278,28,1522693733,39819455
1667925095,203296,true,1483912601,28,1523302902,39390301
1667925107,203291,true,1484654706,28,1523912314,39257608
1667925119,203286,true,1485397182,28,1524369534,38972352
1667925131,203278,true,1486585915,28,1524979373,38393458
1667925143,203271,true,1487626838,28,1525589456,37962618
1667925155,203265,true,1488519637,28,1526199783,37680146
1667925167,203259,true,1489412972,28,1526963036,37550064
1667925215,203250,true,1490753980,28,1529713907,38959927
1667925227,203242,true,1491947001,28,1530325884,38378883
1667925251,203235,true,1492991677,28,1531703729,38712052
1667925263,203230,true,1493738322,28,1532316502,38578180
1667925275,203220,true,1495232733,28,1532929521,37696788
1667925299,203211,true,1496578981,28,1534156293,37577312
1667925323,203204,true,1497626900,28,1535384048,37757148
1667925407,203197,true,1498675554,28,1538765442,40089888
1667925575,203187,true,1500174904,28,1544160287,43985383
1667925587,203179,true,1501375464,28,1544469134,43093670
1667925755,203172,true,1502426742,28,1547561009,45134267
1667925767,203166,true,1503328424,28,1547870537,44542113
1667925959,203156,true,1504832429,28,1550038965,45206536
1667926031,203148,true,1506036716,28,1550969220,44932504
1667926055,203142,true,1506940564,28,1551279430,44338866
1667926067,203136,true,1507844954,28,1551434558,43589604
1667926523,203127,true,1509202558,28,1557963959,48761401
1667926535,203119,true,1510410343,28,1558119755,47709412
1667926547,203113,true,1511316815,28,1558275567,46958752
1667926607,203107,true,1512223832,28,1558898971,46675139
1667926619,203099,true,1513434035,28,1559054861,45620826
1667926643,203092,true,1514493756,28,1559210766,44717010
1667926667,203086,true,1515402680,28,1559366687,43964007
1667926679,203081,true,1516160533,28,1559522624,43362091
1667926727,203074,true,1517222164,28,1559678576,42456412
1667926739,203066,true,1518436366,28,1559834544,41398178
1667926751,203061,true,1519195736,28,1559834544,40638808
1667926763,203057,true,1519803506,28,1559834544,40031038
1667926847,203050,true,1520867687,28,1560146526,39278839
1667926871,203043,true,1521932614,28,1560302541,38369927
1667926967,203037,true,1522846002,28,1560458571,37612569
1667926991,203033,true,1523455232,28,1560302541,36847309
1667927027,203026,true,1524521970,28,1559990527,35468557
1667927039,203019,true,1525589456,28,1559834544,34245088
1667927147,203015,true,1526199783,28,1558275567,32075784
1667927183,203011,true,1526810355,28,1557652412,30842057
1667927219,203005,true,1527726670,28,1557185210,29458540
1667927291,202998,true,1528796400,28,1556095616,27299216
1667927327,202994,true,1529408010,28,1555628881,26220871
1667927339,202991,true,1529866878,28,1555473334,25606456
1667927675,202985,true,1530785028,28,1550814139,20029111
1667927687,202979,true,1531703729,28,1550659073,18955344
1667927699,202975,true,1532316502,28,1550504023,18187521
1667927867,202972,true,1532776243,28,1547715765,14939522
1667928023,202967,true,1533542784,28,1545396048,11853264
1667928035,202961,true,1534463140,28,1545241523,10778383
1667928059,202957,true,1535077017,28,1544932522,9855505
1667928071,202954,true,1535537587,28,1544623581,9085994
1667928095,202950,true,1536151894,28,1544314703,8162809
1667928119,202945,true,1536920123,28,1543851501,6931378
1667928131,202942,true,1537381245,28,1543697131,6315886
1667928167,202941,true,1537534984,28,1542925514,5390530
1667928215,202938,true,1537996290,28,1542000083,4003793
1667928275,202934,true,1538611581,28,1540767038,2155457
1667928287,202933,true,1538765442,28,1540458931,1693489
1667928311,202932,true,1538919319,28,1539996885,1077566
1667928407,202931,true,1539073211,28,1537688737,-1384474
1667928419,202929,true,1539381041,28,1537381245,-1999796
1667928431,202928,true,1539534979,28,1537073815,-2461164
1667928443,202928,true,1539534979,28,1536766447,-2768532
1667928455,202927,true,1539688932,28,1536612785,-3076147
1667928467,202926,true,1539842901,28,1536305509,-3537392
1667928479,202926,true,1539842901,28,1535844709,-3998192
1667928503,202928,true,1539534979,28,1535230525,-4304454
1667928563,202928,true,1539534979,28,1533696139,-5838840
1667928611,202928,true,1539534979,28,1532622981,-6911998
1667928803,202927,true,1539688932,28,1527879443,-11809489
1667928815,202929,true,1539381041,28,1527573913,-11807128
1667928875,202929,true,1539381041,28,1526505039,-12876002
1667928887,202929,true,1539381041,28,1526352403,-13028638
1667928899,202928,true,1539534979,28,1526199783,-13335196
1667929031,202930,true,1539227118,28,1524217112,-15010006
1667929043,202932,true,1538919319,28,1524064705,-14854614
1667929115,202932,true,1538919319,28,1522998287,-15921032
1667929187,202931,true,1539073211,28,1521932614,-17140597
1667929343,202933,true,1538765442,28,1519499591,-19265851
1667929415,202935,true,1538457735,28,1518436366,-20021369
1667929463,202936,true,1538303905,28,1517525623,-20778282
1667929487,202936,true,1538303905,28,1517222164,-21081741
1667929655,202940,true,1537688737,28,1514342322,-23346415
1667929667,202943,true,1537227523,28,1514190903,-23036620
1667929679,202944,true,1537073815,28,1513888110,-23185705
1667929835,202946,true,1536766447,28,1510410343,-26356104
1667929883,202951,true,1535998294,28,1509353478,-26644816
1667929895,202954,true,1535537587,28,1509202558,-26335029
1667929919,202956,true,1535230525,28,1508599028,-26631497
1667929931,202958,true,1534923525,28,1508448183,-26475342
1667929943,202964,true,1534002893,28,1508146538,-25856355
1667929955,202967,true,1533542784,28,1507844954,-25697830
1667929967,202969,true,1533236122,28,1507543431,-25692691
1667929979,202971,true,1532929521,28,1507241967,-25687554
1667930003,202978,true,1531856899,28,1506639221,-25217678
1667930027,202982,true,1531244309,28,1506036716,-25207593
1667930039,202984,true,1530938106,28,1505584995,-25353111
1667930051,202986,true,1530631965,28,1505283924,-25348041
1667930075,202993,true,1529560951,28,1504531507,-25029444
1667930087,202997,true,1528949279,28,1504080238,-24869041
1667930123,203000,true,1528490686,28,1502877515,-25613171
1667930135,203003,true,1528032231,28,1502576985,-25455246
1667930207,203010,true,1526963036,28,1500324921,-26638115
1667930387,203015,true,1526199783,28,1495531794,-30667989
1667930399,203019,true,1525589456,28,1495232733,-30356723
1667930411,203022,true,1525131871,28,1494933731,-30198140
1667930447,203029,true,1524064705,28,1493738322,-30326383
1667930471,203036,true,1522998287,28,1493140976,-29857311
1667930483,203039,true,1522541479,28,1492842393,-29699086
1667930543,203041,true,1522237016,28,1491350371,-30886645
1667930555,203049,true,1521019774,28,1491052146,-29967628
1667930603,203056,true,1519955486,28,1490008827,-29946659
1667930615,203059,true,1519499591,28,1489561913,-29937678
1667930627,203062,true,1519043832,28,1489264046,-29779786
1667930651,203070,true,1517829143,28,1488519637,-29309506
1667930675,203079,true,1516463780,28,1487775600,-28688180
1667930687,203084,true,1515705776,28,1487478090,-28227686
1667930699,203087,true,1515251155,28,1487031936,-28219219
1667930723,203096,true,1513888110,28,1486140029,-27748081
1667930735,203106,true,1512375055,28,1485694276,-26680779
1667930747,203112,true,1511467947,28,1485248657,-26219290
1667930759,203117,true,1510712440,28,1484654706,-26057734
1667930771,203128,true,1509051653,28,1484060992,-24990661
1667930783,203139,true,1507392691,28,1483467516,-23925175
1667930795,203146,true,1506337938,28,1482874278,-23463660
1667930807,203151,true,1505584995,28,1482133063,-23451932
1667930819,203162,true,1503929845,28,1481540358,-22389487
1667930831,203173,true,1502276514,28,1480947890,-21328624
1667930843,203182,true,1500925141,28,1480059632,-20865509
1667930855,203189,true,1499874914,28,1479319824,-20555090
1667930867,203200,true,1498226041,28,1478728244,-19497797
1667930879,203211,true,1496578981,28,1477989102,-18589879
1667930891,203218,true,1495531794,28,1477250329,-18281465
1667930903,203224,true,1494634789,28,1476659576,-17975213
1667930915,203235,true,1492991677,28,1476069060,-16922617
1667930939,203244,true,1491648656,28,1474888736,-16759920
1667930963,203251,true,1490604920,28,1473709356,-16895564
1667930987,203257,true,1489710870,28,1472383680,-17327190
1667931047,203268,true,1488073170,28,1468854373,-19218797
1667931059,203278,true,1486585915,28,1468266978,-18318937
1667931071,203285,true,1485545721,28,1467533065,-18012656
1667931083,203291,true,1484654706,28,1466946198,-17708508
1667931095,203301,true,1483170867,28,1466212945,-16957922
1667931119,203310,true,1481836681,28,1464894013,-16942668
1667931131,203317,true,1480799810,28,1464308202,-16491608
1667931143,203322,true,1480059632,28,1463722625,-16337007
1667931179,203333,true,1478432543,28,1461821117,-16611426
1667931191,203341,true,1477250329,28,1461236535,-16013794
1667931215,203349,true,1476069060,28,1459922079,-16146981
1667931227,203353,true,1475478780,28,1459338256,-16140524
1667931251,203364,true,1473856727,28,1458025508,-15831219
1667931311,203372,true,1472678172,28,1455112517,-17565655
1667931335,203378,true,1471794874,28,1453948950,-17845924
1667931347,203383,true,1471059197,28,1453367516,-17691681
1667931359,203394,true,1469442003,28,1452786315,-16655688
1667931371,203402,true,1468266978,28,1452205345,-16061633
1667931383,203409,true,1467239602,28,1451479460,-15760142
1667931407,203415,true,1466359566,28,1450173782,-16185784
1667931431,203426,true,1464747538,28,1448724405,-16023133
1667931467,203435,true,1463429924,28,1446553056,-16876868
1667931491,203443,true,1462259707,28,1445251809,-17007898
1667931515,203449,true,1461382658,28,1443807352,-17575306
1667931527,203460,true,1459776101,28,1443229973,-16546128
1667931539,203469,true,1458462960,28,1442508575,-15954385
1667931563,203478,true,1457150999,28,1440922767,-16228232
1667931575,203484,true,1456277014,28,1440202522,-16074492
1667931587,203495,true,1454676070,28,1439482636,-15193434
1667931611,203505,true,1453222194,28,1438043945,-15178249
1667931623,203513,true,1452060139,28,1437181421,-14878718
1667931635,203520,true,1451044104,28,1436463045,-14581059
1667931647,203531,true,1449448912,28,1435745029,-13703883
1667931659,203539,true,1448289875,28,1434883884,-13405991
1667931671,203548,true,1446987065,28,1434166657,-12820408
1667931683,203555,true,1445974580,28,1433306458,-12668122
1667931695,203566,true,1444384961,28,1432446775,-11938186
1667931719,203575,true,1443085665,28,1430872029,-12213636
1667931731,203583,true,1441931716,28,1430013806,-11917910
1667931743,203589,true,1441066859,28,1429299013,-11767846
1667931755,203599,true,1439626585,28,1428584578,-11042007
1667931767,203606,true,1438619249,28,1428013287,-10605962
1667931779,203612,true,1437756379,28,1427442225,-10314154
1667931791,203617,true,1437037717,28,1426871391,-10166326
1667931803,203627,true,1435601469,28,1426158169,-9443300
1667931827,203635,true,1434453505,28,1425017756,-9435749
1667931851,203644,true,1433163142,28,1423593521,-9569621
1667931863,203651,true,1432160329,28,1423024226,-9136103
1667931875,203662,true,1430585897,28,1422312927,-8272970
1667931887,203671,true,1429299013,28,1421744145,-7554868
1667931959,203678,true,1428298904,28,1418478054,-9820850
1667931983,203685,true,1427299495,28,1417343782,-9955713
1667932007,203695,true,1425872980,28,1416210417,-9662563
1667932019,203704,true,1424590336,28,1415644074,-8946262
1667932043,203711,true,1423593521,28,1414653520,-8940001
1667932055,203718,true,1422597404,28,1414087800,-8509604
1667932067,203727,true,1421317707,28,1413522306,-7795401
1667932079,203736,true,1420039160,28,1412957038,-7082122
1667932127,203743,true,1419045530,28,1410698228,-8347302
1667932271,203749,true,1418194401,28,1404083833,-14110568
1667932331,203758,true,1416918664,28,1401138497,-15780167
1667932355,203766,true,1415785639,28,1400018091,-15767548
1667932367,203773,true,1414794985,28,1399458224,-15336761
1667932379,203779,true,1413946405,28,1398898580,-15047825
1667932403,203786,true,1412957038,28,1397779965,-15177073
1667932427,203793,true,1411968364,28,1396801910,-15166454
1667932487,203798,true,1411262591,28,1394568926,-16693665
1667932511,203803,true,1410557172,28,1393732477,-16824695
1667932523,203810,true,1409570177,28,1393314441,-16255736
1667932595,203816,true,1408724730,28,1391504399,-17220331
1667932607,203821,true,1408020579,28,1391226140,-16794439
1667932619,203825,true,1407457512,28,1391087032,-16370480
1667932631,203830,true,1406753994,28,1390808856,-15945138
1667932763,203837,true,1405769660,28,1388446607,-17323053
1667932787,203841,true,1405207493,28,1387891368,-17316125
1667932823,203845,true,1404645550,28,1387475083,-17170467
1667932847,203850,true,1403943438,28,1387058924,-16884514
1667932859,203856,true,1403101367,28,1386920232,-16181135
1667932871,203860,true,1402540267,28,1386642890,-15897377
1667932883,203865,true,1401839207,28,1386504239,-15334968
1667932895,203869,true,1401278611,28,1386226980,-15051631
1667932931,203874,true,1400578182,28,1385534074,-15044108
1667932943,203879,true,1399878103,28,1385257009,-14621094
1667932955,203885,true,1399038470,28,1384979999,-14058471
1667932967,203890,true,1398339161,28,1384564588,-13774573
1667932991,203897,true,1397360715,28,1384010901,-13349814
1667933003,203902,true,1396662244,28,1383734140,-12928104
1667933039,203908,true,1395824540,28,1382904190,-12920350
1667933075,203913,true,1395126837,28,1381936544,-13190293
1667933147,203919,true,1394290054,28,1380141284,-14148770
1667933231,203924,true,1393593118,28,1378624039,-14969079
1667933243,203929,true,1392896530,28,1378486190,-14410340
1667933267,203933,true,1392339511,28,1378210534,-14128977
1667933279,203939,true,1391504399,28,1378072727,-13431672
1667933291,203942,true,1391087032,28,1377934934,-13152098
1667933303,203946,true,1390530736,28,1377934934,-12595802
1667933327,203948,true,1390252671,28,1377659388,-12593283
1667933399,203952,true,1389696709,28,1377521636,-12175073
1667933471,203954,true,1389418812,28,1377521636,-11897176
1667933483,203957,true,1389002069,28,1377521636,-11480433
1667933507,203959,true,1388724311,28,1377659388,-11064923
1667933555,203963,true,1388168960,28,1377659388,-10509572
1667933567,203964,true,1388030157,28,1377521636,-10508521
1667933579,203966,true,1387752592,28,1377383898,-10368694
1667933615,203969,true,1387336350,28,1376970765,-10365585
1667933639,203973,true,1386781554,28,1376833082,-9948472
1667933675,203975,true,1386504239,28,1376695412,-9808827
1667933759,203979,true,1385949776,28,1376144872,-9804904
1667933771,203982,true,1385534074,28,1376007271,-9526803
1667933783,203987,true,1384841515,28,1375869684,-8971831
1667933795,203990,true,1384426146,28,1375732111,-8694035
1667933819,203994,true,1383872514,28,1375457006,-8415508
1667933843,203996,true,1383595781,28,1375319474,-8276307
1667933867,204002,true,1382765914,28,1375044451,-7721463
1667933891,204005,true,1382351167,28,1374632020,-7719147
1667933903,204009,true,1381798365,28,1374494571,-7303794
1667933999,204011,true,1381522046,28,1373395470,-8126576
1667934011,204017,true,1380693423,28,1373258144,-7435279
1667934023,204021,true,1380141284,28,1373120832,-7020452
1667934035,204025,true,1379589365,28,1372983533,-6605832
1667934047,204029,true,1379037668,28,1372846249,-6191419
1667934059,204035,true,1378210534,28,1372708978,-5501556
1667934071,204038,true,1377797154,28,1372571721,-5225433
1667934095,204042,true,1377246173,28,1372297248,-4948925
1667934131,204045,true,1376833082,28,1371748466,-5084616
1667934143,204052,true,1375869684,28,1371611305,-4258379
1667934179,204055,true,1375457006,28,1371062797,-4394209
1667934239,204059,true,1374906960,28,1369966441,-4940519
1667934251,204063,true,1374357135,28,1369692488,-4664647
1667934263,204069,true,1373532809,28,1369418591,-4114218
1667934275,204072,true,1373120832,28,1369144748,-3976084
1667934287,204075,true,1372708978,28,1368870960,-3838018
1667934299,204077,true,1372434477,28,1368597227,-3837250
1667934323,204082,true,1371748466,28,1368186730,-3561736
1667934347,204084,true,1371474157,28,1367639592,-3834565
1667934359,204087,true,1371062797,28,1367366105,-3696692
1667934455,204088,true,1370925705,28,1365589773,-5335932
1667934491,204092,true,1370377472,28,1365043674,-5333798
1667934527,204094,true,1370103437,28,1364497793,-5605644
1667934575,204096,true,1369829458,28,1363679381,-6150077
1667934647,204097,true,1369692488,28,1362452683,-7239805
1667934659,204101,true,1369144748,28,1362180233,-6964515
1667934671,204102,true,1369007847,28,1361907838,-7100009
1667934683,204104,true,1368734087,28,1361635497,-7098590
1667934695,204106,true,1368460381,28,1361363211,-7097170
1667934767,204110,true,1367913134,28,1360002596,-7910538
1667934779,204111,true,1367776356,28,1359866609,-7909747
1667934791,204113,true,1367502842,28,1359594677,-7908165
1667934887,204116,true,1367092673,28,1357692671,-9400002
1667934911,204120,true,1366545973,28,1357149730,-9396243
1667934959,204121,true,1366409332,28,1356064498,-10344834
1667934971,204123,true,1366136091,28,1355793326,-10342765
1667935055,204125,true,1365862905,28,1354302848,-11560057
1667935091,204131,true,1365043674,28,1353625900,-11417774
1667935127,204133,true,1364770706,28,1352814008,-11956698
1667935175,204136,true,1364361357,28,1351732244,-12629113
1667935271,204139,true,1363952130,28,1349841237,-14110893
1667935295,204143,true,1363406686,28,1349301436,-14105250
1667935319,204143,true,1363406686,28,1348896726,-14509960
1667935355,204145,true,1363134045,28,1348087671,-15046374
1667935367,204148,true,1362725187,28,1347818094,-14907093
1667935379,204153,true,1362044028,28,1347548571,-14495457
1667935415,204155,true,1361771661,28,1346605664,-15165997
1667935427,204159,true,1361227088,28,1346336384,-14890704
1667935439,204163,true,1360682733,28,1346067157,-14615576
1667935451,204168,true,1360002596,28,1345663417,-14339179
1667935475,204172,true,1359458731,28,1344990787,-14467944
1667935487,204176,true,1358915083,28,1344587371,-14327712
1667935499,204180,true,1358371653,28,1344184075,-14187578
1667935511,204185,true,1357692671,28,1343915279,-13777392
1667935535,204189,true,1357149730,28,1343109212,-14040518
1667935559,204194,true,1356471358,28,1342303628,-14167730
1667935595,204198,true,1355928905,28,1341230268,-14698637
1667935619,204203,true,1355251144,28,1340425812,-14825332
1667935631,204208,true,1354573722,28,1340157767,-14415955
1667935655,204212,true,1354032028,28,1339353954,-14678074
1667935691,204218,true,1353219893,28,1338416781,-14803112
1667935703,204225,true,1352273018,28,1338015336,-14257682
1667935715,204230,true,1351597084,28,1337614012,-13983072
1667935727,204235,true,1350921488,28,1337212808,-13708680
1667935739,204242,true,1349976221,28,1336811724,-13164497
1667935763,204249,true,1349031616,28,1336009918,-13021698
1667935775,204255,true,1348222480,28,1335609195,-12613285
1667935787,204260,true,1347548571,28,1335208592,-12339979
1667935799,204267,true,1346605664,28,1334674642,-11931022
1667935835,204274,true,1345663417,28,1333474035,-12189382
1667935847,204280,true,1344856302,28,1333074073,-11782229
1667935871,204286,true,1344049670,28,1332141295,-11908375
1667935883,204293,true,1343109212,28,1331608571,-11500641
1667935895,204302,true,1341901018,28,1331076061,-10824957
1667935907,204308,true,1341096159,28,1330410722,-10685437
1667935919,204316,true,1340023764,28,1329878691,-10145073
1667935979,204324,true,1338952228,28,1327221725,-11730503
1667936003,204332,true,1337881548,28,1326160425,-11721123
1667936015,204339,true,1336945405,28,1325497543,-11447862
1667936027,204346,true,1336009918,28,1324967477,-11042441
1667936039,204354,true,1334941590,28,1324305192,-10636398
1667936051,204362,true,1333874118,28,1323643238,-10230880
1667936075,204369,true,1332940779,28,1322452554,-10488225
1667936099,204376,true,1332008094,28,1321395068,-10613026
1667936111,204383,true,1331076061,28,1320998729,-10077332
1667936123,204389,true,1330277695,28,1320734569,-9543126
1667936135,204392,true,1329878691,28,1320338428,-9540263
1667936159,204396,true,1329346873,28,1319678457,-9668416
1667936171,204403,true,1328416702,28,1319150717,-9265985
1667936183,204411,true,1327354447,28,1318755051,-8599396
1667936195,204415,true,1326823638,28,1318359504,-8464134
1667936207,204419,true,1326293041,28,1317964075,-8328966
1667936219,204426,true,1325365007,28,1317568765,-7796242
1667936231,204432,true,1324570066,28,1317305290,-7264776
1667936279,204437,true,1323907980,28,1315725551,-8182429
1667936291,204442,true,1323246224,28,1315330912,-7915312
1667936303,204449,true,1322320322,28,1314936392,-7383930
1667936327,204454,true,1321659361,28,1314279121,-7380240
1667936339,204458,true,1321130829,28,1313884916,-7245913
1667936351,204461,true,1320734569,28,1313622179,-7112390
1667936363,204467,true,1319942405,28,1313228171,-6714234
1667936375,204471,true,1319414560,28,1312965565,-6448995
1667936387,204474,true,1319018815,28,1312703011,-6315804
1667936399,204476,true,1318755051,28,1312440510,-6314541
1667936411,204482,true,1317964075,28,1312178061,-5786014
1667936423,204486,true,1317437021,28,1311915665,-5521356
1667936447,204488,true,1317173573,28,1311391029,-5782544
1667936495,204490,true,1316910178,28,1310473423,-6436755
1667936507,204494,true,1316383546,28,1310342389,-6041157
1667936555,204497,true,1315988709,28,1309687414,-6301295
1667936579,204499,true,1315725551,28,1309425516,-6300035
1667936591,204499,true,1315725551,28,1309294586,-6430965
1667936615,204503,true,1315199392,28,1309163670,-6035722
1667936639,204506,true,1314804912,28,1309032767,-5772145
1667936651,204507,true,1314673444,28,1308901876,-5771568
1667936687,204508,true,1314541990,28,1308640135,-5901855
1667936699,204512,true,1314016305,28,1308509284,-5507021
1667936711,204514,true,1313753541,28,1308509284,-5244257
1667936723,204515,true,1313622179,28,1308378447,-5243732
1667936771,204515,true,1313622179,28,1308247622,-5374557
1667936783,204519,true,1313096861,28,1308116810,-4980051
1667936795,204521,true,1312834281,28,1307986011,-4848270
1667936831,204521,true,1312834281,28,1307986011,-4848270
1667936843,204520,true,1312965565,28,1307855226,-5110339
1667936855,204522,true,1312703011,28,1307986011,-4717000
1667936891,204523,true,1312571754,28,1307986011,-4585743
1667936963,204522,true,1312703011,28,1308116810,-4586201
1667936975,204520,true,1312965565,28,1308116810,-4848755
1667936999,204523,true,1312571754,28,1308247622,-4324132
1667937023,204524,true,1312440510,28,1308378447,-4062063
1667937035,204523,true,1312571754,28,1308378447,-4193307
1667937047,204521,true,1312834281,28,1308378447,-4455834
1667937059,204524,true,1312440510,28,1308378447,-4062063
1667937071,204526,true,1312178061,28,1308378447,-3799614
1667937107,204525,true,1312309279,28,1308509284,-3799995
1667937155,204524,true,1312440510,28,1308509284,-3931226
1667937167,204528,true,1311915665,28,1308640135,-3275530
1667937179,204529,true,1311784486,28,1308640135,-3144351
1667937203,204529,true,1311784486,28,1308770999,-3013487
1667937239,204528,true,1311915665,28,1309032767,-2882898
1667937251,204530,true,1311653321,28,1309163670,-2489651
1667937263,204532,true,1311391029,28,1309294586,-2096443
1667937275,204532,true,1311391029,28,1309294586,-2096443
1667937299,204534,true,1311128791,28,1309425516,-1703275
1667937371,204535,true,1310997691,28,1309818383,-1179308
1667937383,204536,true,1310866604,28,1309949364,-917240
1667937407,204536,true,1310866604,28,1310211367,-655237
1667937431,204536,true,1310866604,28,1310604470,-262134
1667937467,204537,true,1310735531,28,1311128791,393260
1667937503,204539,true,1310473423,28,1311653321,1179898
1667937515,204539,true,1310473423,28,1311915665,1442242
1667937551,204540,true,1310342389,28,1312440510,2098121
1667937611,204542,true,1310080359,28,1313490830,3410471
1667937683,204544,true,1309818383,28,1314936392,5118009
1667937695,204544,true,1309818383,28,1315199392,5381009
1667937707,204545,true,1309687414,28,1315593992,5906578
1667937719,204546,true,1309556458,28,1315988709,6432251
1667937743,204547,true,1309425516,28,1316778500,7352984
1667937767,204545,true,1309687414,28,1317568765,7881351
1667937791,204545,true,1309687414,28,1318359504,8672090
1667937803,204545,true,1309687414,28,1318755051,9067637
1667937923,204544,true,1309818383,28,1322849330,13030947
1667937983,204542,true,1310080359,28,1324040371,13960012
1667938019,204541,true,1310211367,28,1324702523,14491156
1667938031,204540,true,1310342389,28,1324834993,14492604
1667938055,204540,true,1310342389,28,1325232484,14890095
1667938091,204538,true,1310604470,28,1325762656,15158186
1667938103,204537,true,1310735531,28,1325895232,15159701
1667938115,204537,true,1310735531,28,1326027822,15292291
1667938139,204537,true,1310735531,28,1326160425,15424894
1667938151,204536,true,1310866604,28,1326293041,15426437
1667938163,204535,true,1310997691,28,1326293041,15295350
1667938175,204535,true,1310997691,28,1326160425,15162734
1667938187,204537,true,1310735531,28,1326160425,15424894
1667938211,204535,true,1310997691,28,1326027822,15030131
1667938247,204534,true,1311128791,28,1325895232,14766441
1667938259,204534,true,1311128791,28,1325762656,14633865
1667938271,204535,true,1310997691,28,1325630093,14632402
1667938283,204533,true,1311259903,28,1325630093,14370190
1667938295,204533,true,1311259903,28,1325497543,14237640
1667938307,204533,true,1311259903,28,1325232484,13972581
1667938355,204534,true,1311128791,28,1324570066,13441275
1667938367,204532,true,1311391029,28,1324437622,13046593
1667938403,204531,true,1311522169,28,1323907980,12385811
1667938415,204530,true,1311653321,28,1323643238,11989917
1667938427,204529,true,1311784486,28,1323510887,11726401
1667938439,204526,true,1312178061,28,1323378549,11200488
1667938463,204522,true,1312703011,28,1323246224,10543213
1667938475,204520,true,1312965565,28,1323246224,10280659
1667938487,204518,true,1313228171,28,1323246224,10018053
1667938511,204515,true,1313622179,28,1323113913,9491734
1667938595,204511,true,1314147706,28,1322055898,7908192
1667938619,204508,true,1314541990,28,1321659361,7117371
1667938631,204505,true,1314936392,28,1321527208,6590816
1667938655,204501,true,1315462446,28,1320998729,5536283
1667938667,204499,true,1315725551,28,1320866642,5141091
1667938751,204497,true,1315988709,28,1319150717,3162008
1667938823,204496,true,1316120308,28,1317700522,1580214
1667938835,204495,true,1316251920,28,1317437021,1185101
1667938847,204496,true,1316120308,28,1317173573,1053265
1667939003,204494,true,1316383546,28,1314016305,-2367241
1667939039,204493,true,1316515184,28,1313359494,-3155690
1667939075,204492,true,1316646835,28,1312965565,-3681270
1667939087,204492,true,1316646835,28,1312834281,-3812554
1667939099,204492,true,1316646835,28,1312703011,-3943824
1667939111,204491,true,1316778500,28,1312571754,-4206746
1667939147,204492,true,1316646835,28,1312046856,-4599979
1667939171,204492,true,1316646835,28,1311653321,-4993514
1667939183,204492,true,1316646835,28,1311522169,-5124666
1667939267,204493,true,1316515184,28,1309687414,-6827770
1667939363,204494,true,1316383546,28,1307724454,-8659092
1667939411,204495,true,1316251920,28,1306940093,-9311827
1667939459,204495,true,1316251920,28,1306286819,-9965101
1667939483,204496,true,1316120308,28,1306025601,-10094707
1667939507,204497,true,1315988709,28,1305764435,-10224274
1667939519,204498,true,1315857124,28,1305633872,-10223252
1667939531,204497,true,1315988709,28,1305503321,-10485388
1667939543,204498,true,1315857124,28,1305372784,-10484340
1667939567,204499,true,1315725551,28,1305111749,-10613802
1667939579,204500,true,1315593992,28,1304850766,-10743226
1667939675,204499,true,1315725551,28,1303807355,-11918196
1667939723,204500,true,1315593992,28,1303155646,-12438346
1667939735,204501,true,1315462446,28,1303155646,-12306800
1667939831,204502,true,1315330912,28,1302374027,-12956885
1667939843,204501,true,1315462446,28,1302243802,-13218644
1667939855,204503,true,1315199392,28,1302243802,-12955590
1667940143,204503,true,1315199392,28,1304068129,-11131263
1667940167,204504,true,1315067886,28,1304459389,-10608497
1667940179,204502,true,1315330912,28,1304589835,-10741077
1667940215,204504,true,1315067886,28,1304981251,-10086635
1667940239,204504,true,1315067886,28,1305242260,-9825626
1667940359,204505,true,1314936392,28,1305895012,-9041380
1667940371,204504,true,1315067886,28,1306025601,-9042285
1667940383,204505,true,1314936392,28,1306156204,-8780188
1667940395,204506,true,1314804912,28,1306286819,-8518093
1667940407,204508,true,1314541990,28,1306417448,-8124542
1667940455,204507,true,1314673444,28,1306809412,-7864032
1667940479,204509,true,1314410549,28,1307070787,-7339762
1667940503,204511,true,1314147706,28,1307332215,-6815491
1667940599,204512,true,1314016305,28,1308640135,-5376170
1667940623,204511,true,1314147706,28,1308901876,-5245830
1667940635,204513,true,1313884916,28,1309163670,-4721246
1667940659,204515,true,1313622179,28,1309425516,-4196663
1667940671,204516,true,1313490830,28,1309556458,-3934372
1667940683,204515,true,1313622179,28,1309818383,-3803796
1667940707,204517,true,1313359494,28,1310080359,-3279135
1667940719,204519,true,1313096861,28,1310211367,-2885494
1667940731,204521,true,1312834281,28,1310342389,-2491892
1667940935,204521,true,1312834281,28,1312440510,-393771
1667941151,204523,true,1312571754,28,1315988709,3416955
1667941175,204524,true,1312440510,28,1316383546,3943036
1667941211,204525,true,1312309279,28,1316778500,4469221
1667941223,204525,true,1312309279,28,1316910178,4600899
1667941523,204528,true,1311915665,28,1318491340,6575675
1667941583,204528,true,1311915665,28,1318623189,6707524
1667941595,204527,true,1312046856,28,1318623189,6576333
1667941643,204526,true,1312178061,28,1318755051,6576990
1667941727,204528,true,1311915665,28,1318755051,6839386
1667941739,204529,true,1311784486,28,1318755051,6970565
1667941751,204529,true,1311784486,28,1318755051,6970565
1667941763,204529,true,1311784486,28,1318755051,6970565
1667941775,204532,true,1311391029,28,1318755051,7364022
1667941787,204533,true,1311259903,28,1318755051,7495148
1667941799,204532,true,1311391029,28,1318755051,7364022
1667941847,204531,true,1311522169,28,1318886927,7364758
1667941859,204533,true,1311259903,28,1318886927,7627024
1667941883,204533,true,1311259903,28,1318886927,7627024
1667941967,204532,true,1311391029,28,1319018815,7627786
1667941979,204531,true,1311522169,28,1319018815,7496646
1667942003,204534,true,1311128791,28,1319150717,8021926
1667942015,204535,true,1310997691,28,1319150717,8153026
1667942099,204533,true,1311259903,28,1319282632,8022729
1667942111,204533,true,1311259903,28,1319282632,8022729
1667942123,204536,true,1310866604,28,1319282632,8416028
1667942183,204537,true,1310735531,28,1319282632,8547101
1667942195,204536,true,1310866604,28,1319282632,8416028
1667942231,204535,true,1310997691,28,1319150717,8153026
1667942291,204538,true,1310604470,28,1318755051,8150581
1667942303,204539,true,1310473423,28,1318623189,8149766
1667942315,204538,true,1310604470,28,1318491340,7886870
1667942327,204537,true,1310735531,28,1318359504,7623973
1667942399,204540,true,1310342389,28,1317305290,6962901
1667942411,204540,true,1310342389,28,1317173573,6831184
1667942579,204539,true,1310473423,28,1315462446,4989023
1667942603,204538,true,1310604470,28,1315330912,4726442
1667942627,204540,true,1310342389,28,1315067886,4725497
1667942639,204539,true,1310473423,28,1315067886,4594463
1667942687,204537,true,1310735531,28,1314673444,3937913
1667942699,204536,true,1310866604,28,1314673444,3806840
1667942711,204538,true,1310604470,28,1314541990,3937520
1667942723,204537,true,1310735531,28,1314541990,3806459
1667942735,204533,true,1311259903,28,1314541990,3282087
1667942759,204531,true,1311522169,28,1314410549,2888380
1667942831,204532,true,1311391029,28,1314279121,2888092
1667942867,204531,true,1311522169,28,1314147706,2625537
1667943311,204527,true,1312046856,28,1314410549,2363693
1667943335,204525,true,1312309279,28,1314541990,2232711
1667943431,204526,true,1312178061,28,1314936392,2758331
1667943479,204525,true,1312309279,28,1315067886,2758607
1667943587,204522,true,1312703011,28,1315462446,2759435
1667943599,204521,true,1312834281,28,1315593992,2759711
1667943623,204522,true,1312703011,28,1315593992,2890981
1667943647,204522,true,1312703011,28,1315725551,3022540
1667943683,204517,true,1313359494,28,1315857124,2497630
1667943695,204515,true,1313622179,28,1315857124,2234945
1667943719,204517,true,1313359494,28,1315988709,2629215
1667943731,204516,true,1313490830,28,1316120308,2629478
1667943791,204511,true,1314147706,28,1316515184,2367478
1667943815,204509,true,1314410549,28,1316515184,2104635
1667943875,204510,true,1314279121,28,1316910178,2631057
1667943887,204509,true,1314410549,28,1316910178,2499629
1667943911,204505,true,1314936392,28,1317041869,2105477
1667943923,204502,true,1315330912,28,1317173573,1842661
1667944139,204502,true,1315330912,28,1319414560,4083648
1667944151,204501,true,1315462446,28,1319546502,4084056
1667944199,204496,true,1316120308,28,1320074400,3954092
1667944211,204494,true,1316383546,28,1320338428,3954882
1667944223,204494,true,1316383546,28,1320470462,4086916
1667944271,204491,true,1316778500,28,1321130829,4352329
1667944307,204486,true,1317437021,28,1321659361,4222340
1667944571,204482,true,1317964075,28,1325630093,7666018
1667944583,204482,true,1317964075,28,1325762656,7798581
1667944607,204479,true,1318359504,28,1326027822,7668318
1667944727,204474,true,1319018815,28,1327089016,8070201
1667944823,204471,true,1319414560,28,1328018257,8603697
1667945111,204471,true,1319414560,28,1330809886,11395326
1667945135,204469,true,1319678457,28,1331076061,11397604
1667945159,204464,true,1320338428,28,1331076061,10737633
1667945183,204462,true,1320602509,28,1331209168,10606659
1667945207,204463,true,1320470462,28,1331342289,10871827
1667945363,204462,true,1320602509,28,1331608571,11006062
1667945903,204458,true,1321130829,28,1329878691,8747862
1667945939,204457,true,1321262942,28,1329745717,8482775
1667945951,204458,true,1321130829,28,1329612755,8481926
1667945975,204458,true,1321130829,28,1329612755,8481926
1667945987,204453,true,1321791526,28,1329612755,7821229
1667946131,204451,true,1322055898,28,1329745717,7689819
1667946167,204453,true,1321791526,28,1329612755,7821229
1667946239,204453,true,1321791526,28,1329612755,7821229
1667946383,204448,true,1322452554,28,1329479807,7027253
1667946479,204446,true,1322717058,28,1329479807,6762749
1667946563,204448,true,1322452554,28,1329612755,7160201
1667946575,204448,true,1322452554,28,1329612755,7160201
1667946587,204444,true,1322981615,28,1329612755,6631140
1667946731,204444,true,1322981615,28,1328948148,5966533
1667946779,204446,true,1322717058,28,1328815267,6098209
1667946803,204446,true,1322717058,28,1328682399,5965341
1667947127,204443,true,1323113913,28,1328018257,4904344
1667947139,204443,true,1323113913,28,1328018257,4904344
1667947151,204445,true,1322849330,28,1328018257,5168927
1667947163,204446,true,1322717058,28,1328018257,5301199
1667947187,204444,true,1322981615,28,1328018257,5036642
1667947199,204444,true,1322981615,28,1328018257,5036642
1667947223,204447,true,1322584800,28,1328018257,5433457
1667947559,204449,true,1322320322,28,1327619931,5299609
1667947763,204446,true,1322717058,28,1327221725,4504667
1667947775,204446,true,1322717058,28,1327089016,4371958
1667947787,204449,true,1322320322,28,1327089016,4768694
1667947799,204450,true,1322188104,28,1326956320,4768216
1667947883,204448,true,1322452554,28,1326160425,3707871
1667947955,204447,true,1322584800,28,1325497543,2912743
1667948015,204450,true,1322188104,28,1324834993,2646889
1667948027,204451,true,1322055898,28,1324702523,2646625
1667948063,204449,true,1322320322,28,1324437622,2117300
1667948159,204447,true,1322584800,28,1323907980,1323180
1667948255,204447,true,1322584800,28,1323378549,793749
1667948339,204448,true,1322452554,28,1322981615,529061
1667948387,204446,true,1322717058,28,1322717058,0
1667948483,204444,true,1322981615,28,1322452554,-529061
1667948507,204445,true,1322849330,28,1322320322,-529008
1667948591,204447,true,1322584800,28,1321923706,-661094
1667948615,204445,true,1322849330,28,1321923706,-925624
1667948663,204444,true,1322981615,28,1321791526,-1190089
1667948675,204444,true,1322981615,28,1321659361,-1322254
1667948699,204446,true,1322717058,28,1321659361,-1057697
1667948723,204444,true,1322981615,28,1321659361,-1322254
1667948759,204442,true,1323246224,28,1321527208,-1719016
1667948783,204443,true,1323113913,28,1321527208,-1586705
1667948795,204444,true,1322981615,28,1321527208,-1454407
1667949023,204442,true,1323246224,28,1321527208,-1719016
1667949059,204440,true,1323510887,28,1321659361,-1851526
1667949095,204441,true,1323378549,28,1321791526,-1587023
1667949251,204442,true,1323246224,28,1322452554,-793670
1667949287,204440,true,1323510887,28,1322584800,-926087
1667949299,204438,true,1323775602,28,1322584800,-1190802
1667949323,204439,true,1323643238,28,1322717058,-926180
1667949383,204440,true,1323510887,28,1322981615,-529272
1667949575,204437,true,1323907980,28,1323907980,0
1667949647,204435,true,1324172775,28,1324437622,264847
1667949695,204436,true,1324040371,28,1324702523,662152
1667949731,204436,true,1324040371,28,1324834993,794622
1667949911,204434,true,1324305192,28,1325630093,1324901
1667950223,204431,true,1324702523,28,1326160425,1457902
1667950463,204431,true,1324702523,28,1327089016,2386493
1667950475,204431,true,1324702523,28,1327089016,2386493
1667950499,204428,true,1325099974,28,1327221725,2121751
1667950559,204426,true,1325365007,28,1327354447,1989440
1667950571,204425,true,1325497543,28,1327487182,1989639
1667950619,204425,true,1325497543,28,1327619931,2122388
1667950643,204422,true,1325895232,28,1327752693,1857461
1667950691,204419,true,1326293041,28,1327885468,1592427
1667950799,204418,true,1326425670,28,1328549544,2123874
1667950859,204417,true,1326558313,28,1328815267,2256954
1667950871,204415,true,1326823638,28,1328948148,2124510
1667951063,204413,true,1327089016,28,1329745717,2656701
1667951087,204412,true,1327221725,28,1329878691,2656966
1667951099,204411,true,1327354447,28,1329878691,2524244
1667951147,204409,true,1327619931,28,1330144680,2524749
1667951195,204406,true,1328018257,28,1330410722,2392465
1667951207,204406,true,1328018257,28,1330543764,2525507
1667951255,204406,true,1328018257,28,1330676818,2658561
1667951267,204405,true,1328151058,28,1330809886,2658828
1667951303,204403,true,1328416702,28,1330809886,2393184
1667951351,204402,true,1328549544,28,1331076061,2526517
1667951543,204402,true,1328549544,28,1331874906,3325362
1667951567,204402,true,1328549544,28,1332008094,3458550
1667951579,204400,true,1328815267,28,1332008094,3192827
1667951591,204399,true,1328948148,28,1332141295,3193147
1667951603,204400,true,1328815267,28,1332141295,3326028
1667951687,204400,true,1328815267,28,1332540977,3725710
1667951711,204399,true,1328948148,28,1332540977,3592829
1667951879,204398,true,1329081043,28,1333340701,4259658
1667952119,204399,true,1328948148,28,1334274320,5326172
1667952131,204400,true,1328815267,28,1334274320,5459053
1667952143,204398,true,1329081043,28,1334407747,5326704
1667952179,204398,true,1329081043,28,1334407747,5326704
1667952191,204400,true,1328815267,28,1334407747,5592480
1667952227,204401,true,1328682399,28,1334541188,5858789
1667952299,204399,true,1328948148,28,1334541188,5593040
1667952395,204399,true,1328948148,28,1334407747,5459599
1667952431,204401,true,1328682399,28,1334274320,5591921
1667952443,204402,true,1328549544,28,1334274320,5724776
1667952551,204402,true,1328549544,28,1333474035,4924491
1667952575,204402,true,1328549544,28,1333207381,4657837
1667952611,204404,true,1328283874,28,1332940779,4656905
1667952947,204405,true,1328151058,28,1329878691,1727633
1667952971,204405,true,1328151058,28,1329612755,1461697
1667952995,204406,true,1328018257,28,1329346873,1328616
1667953019,204407,true,1327885468,28,1329213951,1328483
1667953031,204408,true,1327752693,28,1329081043,1328350
1667953067,204408,true,1327752693,28,1328815267,1062574
1667953079,204408,true,1327752693,28,1328815267,1062574
1667953103,204408,true,1327752693,28,1328549544,796851
1667953115,204408,true,1327752693,28,1328549544,796851
1667953127,204408,true,1327752693,28,1328416702,664009
1667953211,204407,true,1327885468,28,1328018257,132789
1667953223,204408,true,1327752693,28,1328018257,265564
1667953259,204409,true,1327619931,28,1327752693,132762
1667953283,204409,true,1327619931,28,1327752693,132762
1667953343,204409,true,1327619931,28,1327487182,-132749
1667953355,204409,true,1327619931,28,1327354447,-265484
1667953367,204410,true,1327487182,28,1327354447,-132735
1667953379,204410,true,1327487182,28,1327354447,-132735
1667953403,204410,true,1327487182,28,1327221725,-265457
1667953439,204411,true,1327354447,28,1327089016,-265431
1667953451,204411,true,1327354447,28,1327089016,-265431
1667953499,204410,true,1327487182,28,1327089016,-398166
1667953523,204409,true,1327619931,28,1326956320,-663611
1667953571,204409,true,1327619931,28,1326956320,-663611
1667953895,204410,true,1327487182,28,1326293041,-1194141
1667953907,204409,true,1327619931,28,1326293041,-1326890
1667953955,204408,true,1327752693,28,1326293041,-1459652
1667953979,204408,true,1327752693,28,1326293041,-1459652
1667953991,204408,true,1327752693,28,1326293041,-1459652
1667954183,204407,true,1327885468,28,1326956320,-929148
1667954219,204405,true,1328151058,28,1327089016,-1062042
1667954231,204405,true,1328151058,28,1327221725,-929333
1667954291,204405,true,1328151058,28,1327487182,-663876
1667954303,204404,true,1328283874,28,1327487182,-796692
1667954375,204403,true,1328416702,28,1327885468,-531234
1667954423,204403,true,1328416702,28,1328018257,-398445
1667954483,204402,true,1328549544,28,1328283874,-265670
1667954639,204400,true,1328815267,28,1329081043,265776
1667954687,204399,true,1328948148,28,1329213951,265803
1667954795,204399,true,1328948148,28,1329745717,797569
1667954831,204398,true,1329081043,28,1329745717,664674
1667954843,204398,true,1329081043,28,1329745717,664674
1667954855,204398,true,1329081043,28,1329745717,664674
1667954891,204399,true,1328948148,28,1329745717,797569
1667954903,204398,true,1329081043,28,1329745717,664674
1667954915,204398,true,1329081043,28,1329745717,664674
1667954939,204397,true,1329213951,28,1329745717,531766
1667954975,204398,true,1329081043,28,1329612755,531712
1667954987,204397,true,1329213951,28,1329612755,398804
1667955179,204397,true,1329213951,28,1328815267,-398684
1667955395,204397,true,1329213951,28,1327619931,-1594020
1667955455,204398,true,1329081043,28,1327354447,-1726596
1667955539,204398,true,1329081043,28,1326823638,-2257405
1667955671,204398,true,1329081043,28,1326027822,-3053221
1667955779,204398,true,1329081043,28,1325232484,-3848559
1667955815,204399,true,1328948148,28,1324967477,-3980671
1667955971,204399,true,1328948148,28,1323643238,-5304910
1667955983,204400,true,1328815267,28,1323510887,-5304380
1667956019,204400,true,1328815267,28,1323246224,-5569043
1667956031,204401,true,1328682399,28,1323246224,-5436175
1667956043,204401,true,1328682399,28,1323113913,-5568486
1667956103,204402,true,1328549544,28,1322849330,-5700214
1667956163,204402,true,1328549544,28,1322717058,-5832486
1667956211,204403,true,1328416702,28,1322452554,-5964148
1667956223,204403,true,1328416702,28,1322452554,-5964148
1667956235,204404,true,1328283874,28,1322452554,-5831320
1667956355,204403,true,1328416702,28,1322188104,-6228598
1667956463,204405,true,1328151058,28,1321923706,-6227352
1667956511,204404,true,1328283874,28,1321791526,-6492348
1667956775,204404,true,1328283874,28,1321395068,-6888806
1667956835,204404,true,1328283874,28,1321395068,-6888806
1667957135,204405,true,1328151058,28,1322320322,-5830736
1667957231,204405,true,1328151058,28,1322584800,-5566258
1667957243,204405,true,1328151058,28,1322584800,-5566258
1667957255,204405,true,1328151058,28,1322584800,-5566258
1667957363,204407,true,1327885468,28,1322849330,-5036138
1667957399,204407,true,1327885468,28,1322849330,-5036138
1667957507,204407,true,1327885468,28,1322981615,-4903853
1667957519,204408,true,1327752693,28,1322981615,-4771078
1667957531,204410,true,1327487182,28,1323113913,-4373269
1667957543,204410,true,1327487182,28,1323113913,-4373269
1667957555,204411,true,1327354447,28,1323113913,-4240534
1667958011,204411,true,1327354447,28,1324437622,-2916825
1667958023,204413,true,1327089016,28,1324437622,-2651394
1667958035,204413,true,1327089016,28,1324437622,-2651394
1667958455,204415,true,1326823638,28,1324834993,-1988645
1667958563,204415,true,1326823638,28,1325099974,-1723664
1667958683,204417,true,1326558313,28,1325232484,-1325829
1667958887,204417,true,1326558313,28,1325365007,-1193306
1667958899,204418,true,1326425670,28,1325365007,-1060663
1667958935,204417,true,1326558313,28,1325365007,-1193306
1667958947,204419,true,1326293041,28,1325232484,-1060557
1667958995,204420,true,1326160425,28,1325232484,-927941
1667959055,204421,true,1326027822,28,1325099974,-927848
1667959067,204421,true,1326027822,28,1325099974,-927848
1667959115,204423,true,1325762656,28,1324967477,-795179
1667959151,204424,true,1325630093,28,1324834993,-795100
1667959259,204425,true,1325497543,28,1324702523,-795020
1667959271,204425,true,1325497543,28,1324702523,-795020
1667959439,204427,true,1325232484,28,1324305192,-927292
1667959595,204428,true,1325099974,28,1323775602,-1324372
1667959823,204428,true,1325099974,28,1323510887,-1589087
1667959907,204428,true,1325099974,28,1323378549,-1721425
1667959991,204429,true,1324967477,28,1323113913,-1853564
1667960339,204430,true,1324834993,28,1322320322,-2514671
1667960363,204430,true,1324834993,28,1322320322,-2514671
1667960387,204430,true,1324834993,28,1322320322,-2514671
1667960555,204431,true,1324702523,28,1322055898,-2646625
1667961083,204431,true,1324702523,28,1322584800,-2117723
1667961095,204430,true,1324834993,28,1322717058,-2117935
1667961107,204429,true,1324967477,28,1322717058,-2250419
1667961119,204430,true,1324834993,28,1322717058,-2117935
1667961131,204431,true,1324702523,28,1322717058,-1985465
1667961155,204430,true,1324834993,28,1322717058,-2117935
1667961179,204429,true,1324967477,28,1322717058,-2250419
1667961311,204430,true,1324834993,28,1322717058,-2117935
1667961335,204431,true,1324702523,28,1322717058,-1985465
1667961347,204431,true,1324702523,28,1322584800,-2117723
1667961371,204431,true,1324702523,28,1322584800,-2117723
1667961635,204432,true,1324570066,28,1321659361,-2910705
1667961683,204434,true,1324305192,28,1321395068,-2910124
1667961755,204434,true,1324305192,28,1321130829,-3174363
1667961767,204434,true,1324305192,28,1320998729,-3306463
1667961887,204436,true,1324040371,28,1320338428,-3701943
1667961899,204438,true,1323775602,28,1320206407,-3569195
1667961911,204438,true,1323775602,28,1320074400,-3701202
1667961923,204438,true,1323775602,28,1320074400,-3701202
1667962007,204442,true,1323246224,28,1319282632,-3963592
1667962163,204443,true,1323113913,28,1317964075,-5149838
1667962211,204444,true,1322981615,28,1317568765,-5412850
1667962235,204444,true,1322981615,28,1317437021,-5544594
1667962271,204448,true,1322452554,28,1317041869,-5410685
1667962391,204449,true,1322320322,28,1316120308,-6200014
1667962403,204450,true,1322188104,28,1315988709,-6199395
1667962415,204450,true,1322188104,28,1315857124,-6330980
1667962487,204454,true,1321659361,28,1315199392,-6459969
1667962499,204455,true,1321527208,28,1315067886,-6459322
1667962511,204456,true,1321395068,28,1314936392,-6458676
1667962535,204456,true,1321395068,28,1314673444,-6721624
1667962547,204460,true,1320866642,28,1314541990,-6324652
1667962559,204463,true,1320470462,28,1314410549,-6059913
1667962571,204464,true,1320338428,28,1314279121,-6059307
1667962583,204465,true,1320206407,28,1314147706,-6058701
1667962643,204469,true,1319678457,28,1313359494,-6318963
1667962667,204471,true,1319414560,28,1312965565,-6448995
1667962691,204473,true,1319150717,28,1312571754,-6578963
1667962727,204473,true,1319150717,28,1312046856,-7103861
1667962739,204478,true,1318491340,28,1311915665,-6575675
1667962751,204480,true,1318227681,28,1311784486,-6443195
1667962787,204481,true,1318095871,28,1311128791,-6967080
1667962847,204482,true,1317964075,28,1310211367,-7752708
1667962883,204487,true,1317305290,28,1309556458,-7748832
1667962967,204489,true,1317041869,28,1308378447,-8663422
1667963231,204490,true,1316910178,28,1304850766,-12059412
1667963255,204491,true,1316778500,28,1304589835,-12188665
1667963291,204495,true,1316251920,28,1304198536,-12053384
1667963447,204497,true,1315988709,28,1302504264,-13484445
1667963519,204498,true,1315857124,28,1301853207,-14003917
1667963531,204498,true,1315857124,28,1301723035,-14134089
1667963567,204502,true,1315330912,28,1301332596,-13998316
1667963579,204504,true,1315067886,28,1301202476,-13865410
1667963591,204505,true,1314936392,28,1301072369,-13864023
1667963615,204506,true,1314804912,28,1300812193,-13992719
1667963627,204510,true,1314279121,28,1300682125,-13596996
1667963663,204512,true,1314016305,28,1300291998,-13724307
1667963855,204514,true,1313753541,28,1298213298,-15540243
1667963879,204515,true,1313622179,28,1297953695,-15668484
1667963915,204519,true,1313096861,28,1297564387,-15532474
1667963927,204521,true,1312834281,28,1297434643,-15399638
1667963939,204522,true,1312703011,28,1297304913,-15398098
1667963951,204522,true,1312703011,28,1297304913,-15398098
1667963963,204526,true,1312178061,28,1297175195,-15002866
1667964047,204527,true,1312046856,28,1296786120,-15260736
1667964059,204529,true,1311784486,28,1296656455,-15128031
1667964095,204529,true,1311784486,28,1296526802,-15257684
1667964251,204532,true,1311391029,28,1295878733,-15512296
1667964263,204533,true,1311259903,28,1295878733,-15381170
1667964407,204535,true,1310997691,28,1295360511,-15637180
1667964443,204535,true,1310997691,28,1295360511,-15637180
1667964731,204538,true,1310604470,28,1296137922,-14466548
1667964755,204540,true,1310342389,28,1296137922,-14204467
1667964779,204541,true,1310211367,28,1296267536,-13943831
1667964863,204542,true,1310080359,28,1296267536,-13812823
1667964935,204546,true,1309556458,28,1296267536,-13288922
1667965043,204548,true,1309294586,28,1296137922,-13156664
1667965067,204550,true,1309032767,28,1296137922,-12894845
1667965139,204551,true,1308901876,28,1296008321,-12893555
1667965379,204555,true,1308378447,28,1295490047,-12888400
1667965391,204557,true,1308116810,28,1295490047,-12626763
1667965403,204558,true,1307986011,28,1295490047,-12495964
1667965427,204559,true,1307855226,28,1295619596,-12235630
1667965439,204563,true,1307332215,28,1295619596,-11712619
1667965463,204564,true,1307201494,28,1295619596,-11581898
1667965487,204565,true,1307070787,28,1295749158,-11321629
1667965499,204567,true,1306809412,28,1295878733,-10930679
1667965511,204571,true,1306286819,28,1295878733,-10408086
1667965523,204572,true,1306156204,28,1296008321,-10147883
1667965535,204573,true,1306025601,28,1296008321,-10017280
1667965547,204574,true,1305895012,28,1296137922,-9757090
1667965571,204578,true,1305372784,28,1296267536,-9105248
1667965583,204579,true,1305242260,28,1296397162,-8845098
1667965691,204580,true,1305111749,28,1297045491,-8066258
1667965763,204581,true,1304981251,28,1297434643,-7546608
1667965775,204585,true,1304459389,28,1297434643,-7024746
1667965787,204585,true,1304459389,28,1297434643,-7024746
1667965943,204585,true,1304459389,28,1297953695,-6505694
1667965991,204586,true,1304328956,28,1298083490,-6245466
1667966003,204589,true,1303937735,28,1298083490,-5854245
1667966015,204589,true,1303937735,28,1298213298,-5724437
1667966219,204588,true,1304068129,28,1299382158,-4685971
1667966243,204589,true,1303937735,28,1299642047,-4295688
1667966651,204592,true,1303546632,28,1302113591,-1433041
1667966675,204592,true,1303546632,28,1302374027,-1172605
1667966687,204591,true,1303676987,28,1302374027,-1302960
1667966723,204592,true,1303546632,28,1302764778,-781854
1667966771,204595,true,1303155646,28,1303155646,0
1667966831,204595,true,1303155646,28,1303546632,390986
1667966891,204595,true,1303155646,28,1304068129,912483
1667966939,204595,true,1303155646,28,1304459389,1303743
1667966951,204599,true,1302634514,28,1304589835,1955321
1667967155,204600,true,1302504264,28,1306156204,3651940
1667967359,204600,true,1302504264,28,1307332215,4827951
1667967515,204600,true,1302504264,28,1307724454,5220190
1667967683,204604,true,1301983393,28,1307986011,6002618
1667967695,204604,true,1301983393,28,1307986011,6002618
1667967743,204604,true,1301983393,28,1308116810,6133417
1667968043,204604,true,1301983393,28,1307724454,5741061
1667968055,204607,true,1301592876,28,1307724454,6131578
1667968091,204608,true,1301462729,28,1307593694,6130965
1667968103,204607,true,1301592876,28,1307593694,6000818
1667968127,204606,true,1301723035,28,1307593694,5870659
1667968163,204609,true,1301332596,28,1307593694,6261098
1667968187,204609,true,1301332596,28,1307593694,6261098
1667968403,204608,true,1301462729,28,1307593694,6130965
1667968607,204608,true,1301462729,28,1307593694,6130965
1667968799,204610,true,1301202476,28,1308116810,6914334
1667968823,204609,true,1301332596,28,1308247622,6915026
1667968859,204608,true,1301462729,28,1308247622,6784893
1667968943,204608,true,1301462729,28,1308509284,7046555
1667969039,204609,true,1301332596,28,1308640135,7307539
1667969075,204609,true,1301332596,28,1308770999,7438403
1667969135,204607,true,1301592876,28,1308770999,7178123
1667969147,204607,true,1301592876,28,1308770999,7178123
1667969159,204609,true,1301332596,28,1308901876,7569280
1667969183,204609,true,1301332596,28,1308901876,7569280
1667969459,204608,true,1301462729,28,1309032767,7570038
1667969759,204608,true,1301462729,28,1308770999,7308270
1667969783,204609,true,1301332596,28,1308770999,7438403
1667969867,204609,true,1301332596,28,1308640135,7307539
1667969915,204608,true,1301462729,28,1308509284,7046555
1667969963,204608,true,1301462729,28,1308378447,6915718
1667969975,204610,true,1301202476,28,1308378447,7175971
1667970059,204609,true,1301332596,28,1308116810,6784214
1667970071,204609,true,1301332596,28,1307986011,6653415
1667970083,204608,true,1301462729,28,1307986011,6523282
1667970311,204609,true,1301332596,28,1306940093,5607497
1667970359,204609,true,1301332596,28,1306678745,5346149
1667970407,204608,true,1301462729,28,1306417448,4954719
1667970443,204607,true,1301592876,28,1306156204,4563328
1667970467,204609,true,1301332596,28,1305895012,4562416
1667970479,204609,true,1301332596,28,1305895012,4562416
1667970503,204608,true,1301462729,28,1305633872,4171143
1667970527,204607,true,1301592876,28,1305372784,3779908
1667970599,204609,true,1301332596,28,1304589835,3257239
1667970623,204609,true,1301332596,28,1304328956,2996360
1667970671,204609,true,1301332596,28,1303807355,2474759
1667970935,204609,true,1301332596,28,1300812193,-520403
1667970995,204611,true,1301072369,28,1300291998,-780371
1667971091,204611,true,1301072369,28,1299512096,-1560273
1667971127,204611,true,1301072369,28,1299252233,-1820136
1667971475,204610,true,1301202476,28,1296526802,-4675674
1667971571,204612,true,1300942274,28,1295749158,-5193116
1667971595,204612,true,1300942274,28,1295619596,-5322678
1667971619,204611,true,1301072369,28,1295490047,-5582322
1667971631,204610,true,1301202476,28,1295360511,-5841965
1667971643,204611,true,1301072369,28,1295360511,-5711858
1667971667,204610,true,1301202476,28,1295230988,-5971488
1667971691,204608,true,1301462729,28,1295230988,-6231741
1667971727,204607,true,1301592876,28,1295101478,-6491398
1667971763,204608,true,1301462729,28,1295101478,-6361251
1667971943,204606,true,1301723035,28,1295101478,-6621557
1667972027,204605,true,1301853207,28,1295101478,-6751729
1667972591,204604,true,1301983393,28,1297434643,-4548750
1667972603,204605,true,1301853207,28,1297564387,-4288820
1667972627,204605,true,1301853207,28,1297694143,-4159064
1667972639,204603,true,1302113591,28,1297823912,-4289679
1667972651,204602,true,1302243802,28,1297953695,-4290107
1667972747,204604,true,1301983393,28,1298732662,-3250731
1667972783,204603,true,1302113591,28,1299122320,-2991271
1667972795,204602,true,1302243802,28,1299252233,-2991569
1667972855,204600,true,1302504264,28,1299901989,-2602275
1667972867,204601,true,1302374027,28,1300031979,-2342048
1667972963,204600,true,1302504264,28,1300942274,-1561990
1667973059,204599,true,1302634514,28,1301983393,-651121
1667973131,204597,true,1302895054,28,1302764778,-130276
1667973143,204597,true,1302895054,28,1302895054,0
1667973179,204596,true,1303025344,28,1303155646,130302
1667973203,204594,true,1303285962,28,1303416291,130329
1667973227,204593,true,1303416291,28,1303676987,260696
1667973251,204593,true,1303416291,28,1303807355,391064
1667973263,204592,true,1303546632,28,1303937735,391103
1667973311,204590,true,1303807355,28,1304328956,521601
1667973323,204589,true,1303937735,28,1304459389,521654
1667973503,204589,true,1303937735,28,1305503321,1565586
1667973623,204589,true,1303937735,28,1305764435,1826700
1667973671,204587,true,1304198536,28,1305764435,1565899
1667973707,204586,true,1304328956,28,1305764435,1435479
1667973923,204587,true,1304198536,28,1305633872,1435336
1667973971,204587,true,1304198536,28,1305633872,1435336
1667974055,204586,true,1304328956,28,1305633872,1304916
1667974079,204585,true,1304459389,28,1305633872,1174483
1667974103,204586,true,1304328956,28,1305633872,1304916
1667974115,204586,true,1304328956,28,1305633872,1304916
1667974139,204585,true,1304459389,28,1305633872,1174483
1667974583,204584,true,1304589835,28,1305372784,782949
1667974691,204586,true,1304328956,28,1305111749,782793
1667974799,204585,true,1304459389,28,1304589835,130446
1667974811,204585,true,1304459389,28,1304589835,130446
1667974883,204585,true,1304459389,28,1304198536,-260853
1667974907,204586,true,1304328956,28,1304068129,-260827
1667974955,204586,true,1304328956,28,1303937735,-391221
1667975087,204587,true,1304198536,28,1303416291,-782245
1667975471,204587,true,1304198536,28,1302504264,-1694272
1667975651,204589,true,1303937735,28,1302374027,-1563708
1667975843,204589,true,1303937735,28,1302243802,-1693933
1667975939,204590,true,1303807355,28,1302113591,-1693764
1667976251,204590,true,1303807355,28,1301723035,-2084320
1667976299,204591,true,1303676987,28,1301592876,-2084111
1667976455,204591,true,1303676987,28,1301332596,-2344391
1667976623,204592,true,1303546632,28,1301072369,-2474263
1667976647,204592,true,1303546632,28,1301072369,-2474263
1667976803,204593,true,1303416291,28,1301072369,-2343922
1667977139,204593,true,1303416291,28,1300682125,-2734166
1667977175,204594,true,1303285962,28,1300682125,-2603837
1667977211,204593,true,1303416291,28,1300552070,-2864221
1667977319,204595,true,1303155646,28,1300291998,-2863648
1667977787,204595,true,1303155646,28,1299252233,-3903413
1667978135,204596,true,1303025344,28,1298472954,-4552390
1667978147,204596,true,1303025344,28,1298472954,-4552390
1667978171,204598,true,1302764778,28,1298343120,-4421658
1667978195,204598,true,1302764778,28,1298343120,-4421658
1667978219,204600,true,1302504264,28,1298213298,-4290966
1667978231,204600,true,1302504264,28,1298213298,-4290966
1667978255,204602,true,1302243802,28,1298083490,-4160312
1667978639,204603,true,1302113591,28,1296008321,-6105270
1667978699,204605,true,1301853207,28,1295749158,-6104049
1667978759,204606,true,1301723035,28,1295490047,-6232988
1667978771,204608,true,1301462729,28,1295490047,-5972682
1667978855,204608,true,1301462729,28,1295101478,-6361251
1667979383,204610,true,1301202476,28,1293419024,-7783452
1667979395,204611,true,1301072369,28,1293419024,-7653345
1667979407,204613,true,1300812193,28,1293419024,-7393169
1667979443,204614,true,1300682125,28,1293031076,-7651049
1667979587,204618,true,1300161982,28,1291480447,-8681535
1667979611,204619,true,1300031979,28,1291222189,-8809790
1667979623,204621,true,1299772012,28,1291093080,-8678932
1667979647,204622,true,1299642047,28,1290963984,-8678063
1667979779,204626,true,1299122320,28,1289673729,-9448591
1667979923,204626,true,1299122320,28,1288384765,-10737555
1667979935,204628,true,1298862535,28,1288255939,-10606596
1667979971,204629,true,1298732662,28,1287869539,-10863123
1667979983,204633,true,1298213298,28,1287740765,-10472533
1667980043,204634,true,1298083490,28,1287225798,-10857692
1667980103,204636,true,1297823912,28,1286711036,-11112876
1667980115,204637,true,1297694143,28,1286582378,-11111765
1667980151,204641,true,1297175195,28,1286196480,-10978715
1667980163,204642,true,1297045491,28,1286067874,-10977617
1667980175,204644,true,1296786120,28,1285939280,-10846840
1667980283,204645,true,1296656455,28,1284654047,-12002408
1667980295,204650,true,1296008321,28,1284525595,-11482726
1667980319,204651,true,1295878733,28,1284268728,-11610005
1667980355,204652,true,1295749158,28,1283883525,-11865633
1667980367,204653,true,1295619596,28,1283883525,-11736071
1667980439,204656,true,1295230988,28,1283241775,-11989213
1667980487,204656,true,1295230988,28,1282856880,-12374108
1667980691,204657,true,1295101478,28,1281062227,-14039251
1667980703,204657,true,1295101478,28,1280934133,-14167345
1667980715,204660,true,1294713025,28,1280806053,-13906972
1667980739,204660,true,1294713025,28,1280549930,-14163095
1667980943,204661,true,1294583567,28,1278630641,-15952926
1667980979,204662,true,1294454121,28,1278247128,-16206993
1667981651,204666,true,1293936469,28,1273144607,-20791862
1667981663,204666,true,1293936469,28,1273144607,-20791862
1667981819,204667,true,1293807088,28,1271999349,-21807739
1667982059,204668,true,1293677721,28,1271490677,-22187044
1667982179,204672,true,1293160379,28,1271109306,-22051073
1667982191,204673,true,1293031076,28,1271109306,-21921770
1667982215,204674,true,1292901786,28,1270982207,-21919579
1667982371,204677,true,1292513993,28,1269711924,-22802069
1667982395,204682,true,1291867929,28,1269458020,-22409909
1667982407,204683,true,1291738756,28,1269458020,-22280736
1667982431,204685,true,1291480447,28,1269204166,-22276281
1667982443,204688,true,1291093080,28,1269077258,-22015822
1667982503,204695,true,1290189676,28,1268442910,-21746766
1667982527,204696,true,1290060670,28,1268189260,-21871410
1667982539,204698,true,1289802697,28,1268189260,-21613437
1667982551,204701,true,1289415833,28,1268062453,-21353380
1667982563,204706,true,1288771319,28,1267935660,-20835659
1667982635,204707,true,1288642454,28,1267428612,-21213842
1667982683,204709,true,1288384765,28,1267175165,-21209600
1667982695,204713,true,1287869539,28,1267048460,-20821079
1667982707,204719,true,1287097088,28,1267048460,-20048628
1667982743,204720,true,1286968391,28,1266668421,-20299970
1667982755,204723,true,1286582378,28,1266541767,-20040611
1667982767,204727,true,1286067874,28,1266415126,-19652748
1667982779,204734,true,1285167986,28,1266288497,-18879489
1667982911,204736,true,1284910991,28,1265149407,-19761584
1667982935,204739,true,1284525595,28,1265022904,-19502691
1667982995,204743,true,1284011913,28,1264517022,-19494891
1667983067,204749,true,1283241775,28,1263884953,-19356822
1667983211,204751,true,1282985166,28,1262621763,-20363403
1667983223,204754,true,1282600347,28,1262495513,-20104834
1667983259,204758,true,1282087435,28,1262243052,-19844383
1667983271,204764,true,1281318452,28,1262116840,-19201612
1667983283,204766,true,1281062227,28,1261990641,-19071586
1667983295,204769,true,1280677985,28,1261990641,-18687344
1667983331,204772,true,1280293858,28,1261738281,-18555577
1667983343,204777,true,1279653903,28,1261738281,-17915622
1667983391,204778,true,1279525951,28,1261485971,-18039980
1667983427,204780,true,1279270084,28,1261485971,-17784113
1667983439,204782,true,1279014268,28,1261485971,-17528297
1667983487,204787,true,1278374953,28,1261485971,-16888982
1667983523,204788,true,1278247128,28,1261485971,-16761157
1667983643,204790,true,1277991517,28,1261485971,-16505546
1667983679,204792,true,1277735957,28,1261359835,-16376122
1667983691,204797,true,1277097281,28,1261359835,-15737446
1667983727,204798,true,1276969584,28,1261233712,-15735872
1667983739,204800,true,1276714228,28,1261233712,-15480516
1667983991,204803,true,1276331291,28,1260351201,-15980090
1667984003,204808,true,1275693316,28,1260351201,-15342115
1667984039,204809,true,1275565760,28,1260351201,-15214559
1667984051,204812,true,1275183166,28,1260351201,-14831965
1667984063,204815,true,1274800688,28,1260351201,-14449487
1667984147,204820,true,1274163479,28,1260225179,-13938300
1667984183,204821,true,1274036075,28,1260099169,-13936906
1667984207,204823,true,1273781306,28,1260099169,-13682137
1667984219,204827,true,1273271921,28,1259973171,-13298750
1667984231,204833,true,1272508225,28,1259973171,-12535054
1667984243,204834,true,1272380987,28,1259973171,-12407816
1667984303,204835,true,1272253762,28,1260225179,-12028583
1667984555,204837,true,1271999349,28,1260351201,-11648148
1667984579,204843,true,1271236417,28,1260477236,-10759181
1667984723,204844,true,1271109306,28,1260981503,-10127803
1667984747,204846,true,1270855122,28,1261107601,-9747521
1667984759,204848,true,1270600989,28,1261107601,-9493388
1667984783,204854,true,1269838895,28,1261107601,-8731294
1667984819,204856,true,1269584966,28,1261233712,-8351254
1667984831,204857,true,1269458020,28,1261233712,-8224308
1667984867,204860,true,1269077258,28,1261233712,-7843546
1667984903,204866,true,1268316079,28,1261107601,-7208478
1667984927,204868,true,1268062453,28,1261107601,-6954852
1667984939,204870,true,1267808879,28,1261107601,-6701278
1667984951,204872,true,1267555355,28,1261107601,-6447754
1667984963,204878,true,1266795088,28,1261107601,-5687487
1667985035,204881,true,1266415126,28,1260855417,-5559709
1667985107,204882,true,1266288497,28,1260351201,-5937296
1667985143,204885,true,1265908686,28,1260099169,-5809517
1667985215,204891,true,1265149407,28,1259343374,-5806033
1667985287,204894,true,1264769938,28,1258336352,-6433586
1667985299,204896,true,1264517022,28,1258084723,-6432299
1667985347,204899,true,1264137742,28,1257330136,-6807606
1667985359,204906,true,1263253200,28,1257204416,-6048784
1667985407,204910,true,1262748025,28,1256324724,-6423301
1667985431,204912,true,1262495513,28,1255822320,-6673193
1667985443,204915,true,1262116840,28,1255571193,-6545647
1667985503,204919,true,1261612120,28,1254441744,-7170376
1667985515,204923,true,1261107601,28,1254190893,-6916708
1667985539,204925,true,1260855417,28,1253814711,-7040706
1667985575,204929,true,1260351201,28,1253062686,-7288515
1667985623,204934,true,1259721215,28,1252185893,-7535322
1667985635,204938,true,1259217452,28,1251935493,-7281959
1667985659,204940,true,1258965646,28,1251434844,-7530802
1667985683,204943,true,1258588032,28,1251059489,-7528543
1667985707,204947,true,1258084723,28,1250684246,-7400477
1667985719,204951,true,1257581615,28,1250434147,-7147468
1667985731,204952,true,1257455869,28,1250309116,-7146753
1667985743,204955,true,1257078708,28,1250184097,-6894611
1667985755,204958,true,1256701660,28,1250059091,-6642569
1667985815,204960,true,1256450357,28,1249434249,-7016108
1667985839,204961,true,1256324724,28,1249184400,-7140324
1667985851,204962,true,1256199105,28,1249059494,-7139611
1667985863,204965,true,1255822320,28,1249059494,-6762826
1667985887,204967,true,1255571193,28,1248809719,-6761474
1667985983,204967,true,1255571193,28,1248435151,-7136042
1667985995,204969,true,1255320117,28,1248310320,-7009797
1667986007,204972,true,1254943596,28,1248310320,-6633276
1667986019,204974,true,1254692645,28,1248310320,-6382325
1667986079,204975,true,1254567188,28,1247811121,-6756067
1667986103,204977,true,1254316313,28,1247561596,-6754717
1667986151,204980,true,1253940093,28,1247187403,-6752690
1667986163,204983,true,1253563986,28,1247062696,-6501290
1667986247,204983,true,1253563986,28,1246314721,-7249265
1667986259,204985,true,1253313311,28,1246190102,-7123209
1667986271,204988,true,1252937392,28,1246065495,-6871897
1667986283,204990,true,1252686842,28,1245816319,-6870523
1667986295,204991,true,1252561586,28,1245691750,-6869836
1667986319,204994,true,1252185893,28,1245318117,-6867776
1667986439,204997,true,1251810312,28,1243575979,-8234333
1667986535,205000,true,1251434844,28,1241960461,-9474383
1667986571,205001,true,1251309713,28,1241339667,-9970046
1667986583,205003,true,1251059489,28,1241215546,-9843943
1667986715,205006,true,1250684246,28,1239603094,-11081152
1667986727,205009,true,1250309116,28,1239479146,-10829970
1667986751,205010,true,1250184097,28,1239231288,-10952809
1667986787,205012,true,1249934098,28,1238735719,-11198379
1667986811,205015,true,1249559193,28,1238488009,-11071184
1667986931,205019,true,1249059494,28,1236755426,-12304068
1667986955,205020,true,1248934600,28,1236384473,-12550127
1667986967,205022,true,1248684851,28,1236260847,-12424004
1667986991,205026,true,1248185502,28,1235890043,-12295459
1667987003,205031,true,1247561596,28,1235766466,-11795130
1667987027,205033,true,1247312121,28,1235395811,-11916310
1667987063,205036,true,1246938003,28,1234901776,-12036227
1667987075,205040,true,1246439352,28,1234654833,-11784519
1667987099,205044,true,1245940901,28,1234407939,-11532962
1667987111,205046,true,1245691750,28,1234161094,-11530656
1667987147,205048,true,1245442649,28,1233667553,-11775096
1667987159,205052,true,1244944597,28,1233544199,-11400398
1667987171,205055,true,1244571188,28,1233420856,-11150332
1667987207,205056,true,1244446743,28,1233174209,-11272534
1667987219,205059,true,1244073484,28,1233050904,-11022580
1667987255,205063,true,1243575979,28,1232681063,-10894916
1667987291,205067,true,1243078673,28,1232311333,-10767340
1667987315,205068,true,1242954377,28,1232064907,-10889470
1667987327,205070,true,1242705824,28,1231941713,-10764111
1667987339,205075,true,1242084657,28,1231818531,-10266126
1667987351,205079,true,1241587948,28,1231695362,-9892586
1667987363,205081,true,1241339667,28,1231572204,-9767463
1667987375,205085,true,1240843255,28,1231325927,-9517328
1667987399,205090,true,1240223020,28,1231079699,-9143321
1667987423,205096,true,1239479146,28,1230710449,-8768697
1667987435,205098,true,1239231288,28,1230587390,-8643898
1667987459,205102,true,1238735719,28,1230341309,-8394410
1667987495,205107,true,1238116537,28,1229849296,-8267241
1667987507,205112,true,1237497664,28,1229726323,-7771341
1667987519,205115,true,1237126489,28,1229480415,-7646074
1667987531,205119,true,1236631763,28,1229234556,-7397207
1667987567,205124,true,1236013632,28,1228620123,-7393509
1667987579,205129,true,1235395811,28,1228374435,-7021376
1667987615,205132,true,1235025266,28,1227637669,-7387597
1667987627,205135,true,1234654833,28,1227392178,-7262655
1667987675,205140,true,1234037690,28,1226288077,-7749613
1667987687,205146,true,1233297527,28,1225920264,-7377263
1667987723,205149,true,1232927611,28,1225062463,-7865148
1667987759,205152,true,1232557807,28,1224082854,-8474953
1667987795,205157,true,1231941713,28,1223226339,-8715374
1667987879,205161,true,1231449060,28,1221270839,-10178221
1667987927,205164,true,1231079699,28,1220050240,-11029459
1667987963,205167,true,1230710449,28,1219196546,-11513903
1667987975,205172,true,1230095278,28,1218952743,-11142535
1667988011,205176,true,1229603363,28,1218343450,-11259913
1667988023,205179,true,1229234556,28,1218099818,-11134738
1667988035,205182,true,1228865859,28,1217856234,-11009625
1667988047,205186,true,1228374435,28,1217734461,-10639974
1667988071,205189,true,1228005997,28,1217369214,-10636783
1667988119,205191,true,1227760432,28,1217004076,-10756356
1667988167,205193,true,1227514917,28,1216639048,-10875869
1667988179,205197,true,1227024034,28,1216517396,-10506638
1667988215,205200,true,1226656000,28,1216152514,-10503486
1667988227,205202,true,1226410706,28,1216030911,-10379795
1667988263,205204,true,1226165461,28,1215666174,-10499287
1667988287,205208,true,1225675117,28,1215544620,-10130497
1667988299,205212,true,1225184970,28,1215301547,-9883423
1667988323,205214,true,1224939969,28,1215058523,-9881446
1667988443,205217,true,1224572561,28,1213480053,-11092508
1667988551,205222,true,1223960458,28,1211782454,-12178004
1667988611,205224,true,1223715703,28,1211055639,-12660064
1667988635,205227,true,1223348661,28,1210813464,-12535197
1667988659,205230,true,1222981730,28,1210450293,-12531437
1667988671,205235,true,1222370423,28,1210208239,-12162184
1667988683,205238,true,1222003785,28,1210087230,-11916555
1667988695,205241,true,1221637257,28,1209845249,-11792008
1667988743,205245,true,1221148724,28,1208998696,-12150028
1667988767,205250,true,1220538333,28,1208636069,-11902264
1667988803,205252,true,1220294262,28,1207911141,-12383121
1667988815,205255,true,1219928247,28,1207790362,-12137885
1667988827,205259,true,1219440398,28,1207548840,-11891558
1667988851,205264,true,1218830860,28,1207065941,-11764919
1667988875,205267,true,1218465284,28,1206583236,-11882048
1667988887,205270,true,1218099818,28,1206341955,-11757863
1667988899,205275,true,1217490951,28,1205980125,-11510826
1667988923,205281,true,1216760712,28,1205377316,-11383396
1667988935,205285,true,1216274129,28,1205015775,-11258354
1667988947,205289,true,1215787741,28,1204654342,-11133399
1667988971,205294,true,1215180029,28,1203931803,-11248226
1667989031,205301,true,1214329743,28,1202127349,-12202394
1667989055,205306,true,1213722761,28,1201406325,-12316436
1667989067,205310,true,1213237393,28,1201045975,-12191418
1667989079,205316,true,1212509705,28,1200685733,-11823972
1667989103,205324,true,1211540134,28,1199965574,-11574560
1667989127,205330,true,1210813464,28,1199245847,-11567617
1667989139,205335,true,1210208239,28,1198886145,-11322094
1667989151,205341,true,1209482368,28,1198526551,-10955817
1667989163,205350,true,1208394378,28,1198167065,-10227313
1667989175,205357,true,1207548840,28,1197807687,-9741153
1667989187,205364,true,1206703894,28,1197448416,-9255478
1667989223,205371,true,1205859539,28,1196251626,-9607913
1667989235,205380,true,1204774808,28,1195892822,-8881986
1667989259,205388,true,1203811422,28,1195056032,-8755390
1667989271,205394,true,1203089388,28,1194578129,-8511259
1667989283,205401,true,1202247562,28,1194219827,-8027735
1667989295,205410,true,1201166080,28,1193861633,-7304447
1667989331,205416,true,1200445632,28,1192787695,-7657937
1667989343,205421,true,1199845589,28,1192429930,-7415659
1667989367,205427,true,1199125934,28,1191833894,-7292040
1667989379,205435,true,1198167065,28,1191595563,-6571502
1667989391,205440,true,1197568161,28,1191238156,-6330005
1667989403,205444,true,1197089253,28,1190999944,-6089309
1667989427,205448,true,1196610537,28,1190642715,-5967822
1667989439,205454,true,1195892822,28,1190404622,-5488200
1667989463,205458,true,1195414585,28,1189928579,-5486006
1667989475,205462,true,1194936538,28,1189690629,-5245909
1667989511,205466,true,1194458683,28,1189095962,-5362721
1667989535,205473,true,1193622897,28,1188620443,-5002454
1667989547,205477,true,1193145567,28,1188382755,-4762812
1667989571,205480,true,1192787695,28,1187907520,-4880175
1667989607,205485,true,1192191480,28,1187076318,-5115162
1667989643,205491,true,1191476415,28,1186245696,-5230719
1667989655,205494,true,1191119044,28,1185889894,-5229150
1667989679,205498,true,1190642715,28,1185415656,-5227059
1667989703,205503,true,1190047572,28,1184823126,-5224446
1667989715,205508,true,1189452727,28,1184586197,-4866530
1667989739,205512,true,1188977065,28,1183994082,-4982983
1667989799,205515,true,1188620443,28,1182455966,-6164477
1667989823,205519,true,1188145114,28,1181864916,-6280198
1667989835,205524,true,1187551219,28,1181628578,-5922641
1667989847,205527,true,1187195025,28,1181274161,-5920864
1667989895,205527,true,1187195025,28,1180211545,-6983480
1667989907,205530,true,1186838938,28,1179857553,-6981385
1667989919,205535,true,1186245696,28,1179621616,-6624080
1667989931,205538,true,1185889894,28,1179267801,-6622093
1667990027,205541,true,1185534198,28,1176676393,-8857805
1667990039,205544,true,1185178609,28,1176441093,-8737516
1667990075,205550,true,1184467751,28,1175382825,-9084926
1667990087,205552,true,1184230893,28,1175030281,-9200612
1667990111,205555,true,1183875694,28,1174560386,-9315308
1667990147,205558,true,1183520603,28,1173855896,-9664707
1667990159,205563,true,1182929020,28,1173503810,-9425210
1667990171,205565,true,1182692469,28,1173386471,-9305998
1667990243,205565,true,1182692469,28,1172213730,-10478739
1667990255,205567,true,1182455966,28,1172096520,-10359446
1667990267,205571,true,1181983102,28,1171979322,-10003780
1667990279,205572,true,1181864916,28,1171862136,-10002780
1667990291,205572,true,1181864916,28,1171744962,-10119954
1667990303,205573,true,1181746741,28,1171627799,-10118942
1667990315,205576,true,1181392288,28,1171627799,-9764489
1667990339,205576,true,1181392288,28,1171627799,-9764489
1667990387,205574,true,1181628578,28,1171627799,-10000779
1667990411,205575,true,1181510427,28,1171510648,-9999779
1667990423,205578,true,1181156045,28,1171510648,-9645397
1667990435,205578,true,1181156045,28,1171510648,-9645397
1667990447,205577,true,1181274161,28,1171510648,-9763513
1667990471,205578,true,1181156045,28,1171510648,-9645397
1667990567,205581,true,1180801769,28,1171744962,-9056807
1667990735,205581,true,1180801769,28,1172917234,-7884535
1667990747,205580,true,1180919849,28,1173151829,-7768020
1667990759,205581,true,1180801769,28,1173386471,-7415298
1667990867,205584,true,1180447599,28,1175617913,-4829686
1667990915,205583,true,1180565644,28,1176441093,-4124551
1667990939,205582,true,1180683701,28,1177029431,-3654270
1667991119,205584,true,1180447599,28,1181746741,1299142
1667991131,205586,true,1180211545,28,1181983102,1771557
1667991227,205586,true,1180211545,28,1183520603,3309058
1667991323,205585,true,1180329566,28,1184941609,4612043
1667991371,205588,true,1179975538,28,1185771317,5795779
1667991443,205591,true,1179621616,28,1187195025,7573409
1667991467,205592,true,1179503666,28,1187669974,8166308
1667991551,205592,true,1179503666,28,1189452727,9949061
1667991635,205595,true,1179149886,28,1190880856,11730970
1667991671,205598,true,1178796211,28,1191238156,12441945
1667991791,205599,true,1178678344,28,1192668428,13990084
1667991815,205599,true,1178678344,28,1192906973,14228629
1667991899,205602,true,1178324811,28,1193981019,15656208
1667991983,205606,true,1177853599,28,1194697587,16843988
1667991995,205606,true,1177853599,28,1194817057,16963458
1667992007,205606,true,1177853599,28,1194817057,16963458
1667992019,205608,true,1177618063,28,1194817057,17198994
1667992043,205613,true,1177029431,28,1194817057,17787626
1667992055,205613,true,1177029431,28,1194817057,17787626
1667992067,205613,true,1177029431,28,1194817057,17787626
1667992211,205615,true,1176794060,28,1193384208,16590148
1667992223,205619,true,1176323460,28,1193264881,16941421
1667992235,205618,true,1176441093,28,1193145567,16704474
1667992247,205617,true,1176558737,28,1193145567,16586830
1667992259,205617,true,1176558737,28,1193026264,16467527
1667992319,205620,true,1176205840,28,1192787695,16581855
1667992379,205619,true,1176323460,28,1192668428,16344968
1667992403,205617,true,1176558737,28,1192668428,16109691
1667992415,205617,true,1176558737,28,1192668428,16109691
1667992439,205618,true,1176441093,28,1192668428,16227335
1667992487,205615,true,1176794060,28,1192787695,15993635
1667992523,205612,true,1177147134,28,1192906973,15759839
1667992547,205611,true,1177264849,28,1192906973,15642124
1667992559,205611,true,1177264849,28,1192906973,15642124
1667992583,205606,true,1177853599,28,1192906973,15053374
1667992775,205602,true,1178324811,28,1193384208,15059397
1667992823,205600,true,1178560488,28,1193503546,14943058
1667992835,205599,true,1178678344,28,1193622897,14944553
1667992859,205594,true,1179267801,28,1193742259,14474458
1667992883,205589,true,1179857553,28,1193981019,14123466
1667992919,205586,true,1180211545,28,1194219827,14008282
1667992943,205584,true,1180447599,28,1194458683,14011084
1667992979,205579,true,1181037941,28,1194817057,13779116
1667993015,205573,true,1181746741,28,1195175538,13428797
1667993171,205569,true,1182219511,28,1196490888,14271377
1667993183,205567,true,1182455966,28,1196610537,14154571
1667993195,205561,true,1183165617,28,1196610537,13444920
1667993243,205555,true,1183875694,28,1196969556,13093862
1667993255,205551,true,1184349316,28,1196969556,12620240
1667993423,205549,true,1184586197,28,1197927467,13341270
1667993687,205543,true,1185297127,28,1199965574,14668447
1667993699,205536,true,1186127084,28,1200085571,13958487
1667993711,205533,true,1186482957,28,1200325600,13842643
1667993807,205531,true,1186720266,28,1201526466,14806200
1667993819,205525,true,1187432476,28,1201766783,14334307
1667993831,205520,true,1188026311,28,1201886960,13860649
1667993843,205517,true,1188382755,28,1202127349,13744594
1667993867,205516,true,1188501593,28,1202488023,13986430
1667993903,205512,true,1188977065,28,1202969091,13992026
1667993951,205507,true,1189571672,28,1203811422,14239750
1667993987,205506,true,1189690629,28,1204293018,14602389
1667993999,205505,true,1189809598,28,1204533889,14724291
1667994035,205501,true,1190285594,28,1205015775,14730181
1667994095,205496,true,1190880856,28,1205618403,14737547
1667994227,205495,true,1190999944,28,1206703894,15703950
1667994251,205495,true,1190999944,28,1206824564,15824620
1667994263,205491,true,1191476415,28,1206945247,15468832
1667994395,205486,true,1192072272,28,1207186648,15114376
1667994431,205484,true,1192310699,28,1207307367,14996668
1667994527,205484,true,1192310699,28,1207307367,14996668
1667994659,205479,true,1192906973,28,1207186648,14279675
1667994791,205474,true,1193503546,28,1206462589,12959043
1667994815,205472,true,1193742259,28,1206341955,12599696
1667994839,205472,true,1193742259,28,1206221333,12479074
1667994851,205467,true,1194339249,28,1206221333,11882084
1667994863,205461,true,1195056032,28,1206221333,11165301
1667994875,205459,true,1195295055,28,1206100723,10805668
1667994899,205458,true,1195414585,28,1206100723,10686138
1667994911,205454,true,1195892822,28,1206100723,10207901
1667994947,205451,true,1196251626,28,1205980125,9728499
1667994959,205449,true,1196490888,28,1205980125,9489237
1667994971,205448,true,1196610537,28,1205980125,9369588
1667995031,205443,true,1197208962,28,1206100723,8891761
1667995079,205438,true,1197807687,28,1206221333,8413646
1667995127,205437,true,1197927467,28,1206462589,8535122
1667995139,205435,true,1198167065,28,1206462589,8295524
1667995151,205429,true,1198886145,28,1206583236,7697091
1667995223,205423,true,1199605656,28,1206945247,7339591
1667995355,205421,true,1199845589,28,1207790362,7944773
1667995367,205420,true,1199965574,28,1207790362,7824788
1667995379,205415,true,1200565677,28,1207911141,7345464
1667995391,205411,true,1201045975,28,1208031932,6985957
1667995403,205409,true,1201286196,28,1208152735,6866539
1667995415,205407,true,1201526466,28,1208273551,6747085
1667995427,205402,true,1202127349,28,1208394378,6267029
1667995463,205397,true,1202728533,28,1208877808,6149275
1667995475,205395,true,1202969091,28,1208998696,6029605
1667995499,205395,true,1202969091,28,1209361432,6392341
1667995607,205391,true,1203450350,28,1210813464,7363114
1667995619,205387,true,1203931803,28,1211055639,7123836
1667995631,205386,true,1204052196,28,1211176744,7124548
1667995655,205385,true,1204172601,28,1211418992,7246391
1667995667,205382,true,1204533889,28,1211540134,7006245
1667995787,205379,true,1204895285,28,1212873495,7978210
1667995823,205377,true,1205136276,28,1213237393,8101117
1667995835,205375,true,1205377316,28,1213358717,7981401
1667995847,205372,true,1205738965,28,1213601401,7862436
1667995883,205368,true,1206221333,28,1214086914,7865581
1667995955,205366,true,1206462589,28,1215180029,8717440
1667996003,205365,true,1206583236,28,1215909320,9326084
1667996015,205362,true,1206945247,28,1216152514,9207267
1667996039,205358,true,1207428097,28,1216517396,9089299
1667996063,205355,true,1207790362,28,1217004076,9213714
1667996075,205353,true,1208031932,28,1217247489,9215557
1667996087,205350,true,1208394378,28,1217490951,9096573
1667996171,205345,true,1208998696,28,1219196546,10197850
1667996195,205342,true,1209361432,28,1219684298,10322866
1667996207,205341,true,1209482368,28,1219928247,10445879
1667996219,205338,true,1209845249,28,1220172245,10326996
1667996231,205334,true,1210329260,28,1220294262,9965002
1667996267,205332,true,1210571338,28,1220904531,10333193
1667996279,205331,true,1210692395,28,1221148724,10456329
1667996315,205328,true,1211055639,28,1221637257,10581618
1667996327,205323,true,1211661288,28,1221881597,10220309
1667996447,205321,true,1211903632,28,1223715703,11812071
1667996471,205319,true,1212146025,28,1224082854,11936829
1667996483,205315,true,1212630956,28,1224205262,11574306
1667996495,205311,true,1213116081,28,1224450116,11334035
1667996507,205308,true,1213480053,28,1224572561,11092508
1667996579,205305,true,1213844133,28,1225675117,11830984
1667996627,205302,true,1214208323,28,1226288077,12079754
1667996675,205297,true,1214815548,28,1226778666,11963118
1667996687,205294,true,1215180029,28,1226901344,11721315
1667996699,205291,true,1215544620,28,1227024034,11479414
1667996723,205288,true,1215909320,28,1227269451,11360131
1667996831,205284,true,1216395756,28,1227883209,11487453
1667996915,205282,true,1216639048,28,1228374435,11735387
1667996939,205280,true,1216882388,28,1228497273,11614885
1667997083,205278,true,1217125776,28,1228742985,11617209
1667997131,205274,true,1217612700,28,1228865859,11253159
1667997143,205273,true,1217734461,28,1228865859,11131398
1667997311,205271,true,1217978020,28,1228497273,10519253
1667997383,205269,true,1218221628,28,1228128797,9907169
1667997503,205266,true,1218587131,28,1227760432,9173301
1667997515,205264,true,1218830860,28,1227760432,8929572
1667997551,205262,true,1219074639,28,1227883209,8808570
1667997575,205261,true,1219196546,28,1227883209,8686663
1667997659,205257,true,1219684298,28,1228005997,8321699
1667997683,205256,true,1219806266,28,1228005997,8199731
1667997983,205253,true,1220172245,28,1227637669,7465424
1667998019,205252,true,1220294262,28,1227514917,7220655
1667998043,205249,true,1220660387,28,1227514917,6854530
1667998055,205249,true,1220660387,28,1227637669,6977282
1667998091,205246,true,1221026622,28,1227637669,6611047
1667998103,205245,true,1221148724,28,1227760432,6611708
1667998115,205242,true,1221515106,28,1227760432,6245326
1667998139,205242,true,1221515106,28,1227883209,6368103
1667998151,205238,true,1222003785,28,1228005997,6002212
1667998163,205237,true,1222125985,28,1228005997,5880012
1667998199,205234,true,1222492660,28,1228251610,5758950
1667998223,205233,true,1222614909,28,1228251610,5636701
1667998367,205231,true,1222859444,28,1228374435,5514991
1667998379,205230,true,1222981730,28,1228374435,5392705
1667998391,205227,true,1223348661,28,1228374435,5025774
1667998415,205227,true,1223348661,28,1228497273,5148612
1667998427,205225,true,1223593343,28,1228497273,4903930
1667998439,205224,true,1223715703,28,1228497273,4781570
1667998487,205223,true,1223838074,28,1228374435,4536361
1667998499,205222,true,1223960458,28,1228374435,4413977
1667998607,205220,true,1224205262,28,1228497273,4292011
1667998619,205220,true,1224205262,28,1228497273,4292011
1667998775,205219,true,1224327683,28,1228005997,3678314
1667998787,205219,true,1224327683,28,1228005997,3678314
1667998799,205217,true,1224572561,28,1228005997,3433436
1667998823,205216,true,1224695018,28,1228005997,3310979
1667998847,205214,true,1224939969,28,1228005997,3066028
1667998859,205213,true,1225062463,28,1228005997,2943534
1667998883,205212,true,1225184970,28,1228128797,2943827
1667998955,205210,true,1225430019,28,1228251610,2821591
1667998991,205208,true,1225675117,28,1228374435,2699318
1667999003,205206,true,1225920264,28,1228374435,2454171
1667999111,205204,true,1226165461,28,1228620123,2454662
1667999183,205203,true,1226288077,28,1228742985,2454908
1667999207,205200,true,1226656000,28,1228742985,2086985
1667999243,205199,true,1226778666,28,1228620123,1841457
1667999291,205198,true,1226901344,28,1228497273,1595929
1667999303,205198,true,1226901344,28,1228374435,1473091
1667999351,205196,true,1227146736,28,1228128797,982061
1667999363,205196,true,1227146736,28,1228005997,859261
1667999387,205196,true,1227146736,28,1227760432,613696
1667999399,205196,true,1227146736,28,1227637669,490933
1667999435,205196,true,1227146736,28,1227146736,0
1667999447,205197,true,1227024034,28,1226901344,-122690
1667999459,205198,true,1226901344,28,1226778666,-122678
1667999531,205200,true,1226656000,28,1225307488,-1348512
1667999543,205200,true,1226656000,28,1225062463,-1593537
1667999567,205201,true,1226533347,28,1224695018,-1838329
1667999603,205202,true,1226410706,28,1224082854,-2327852
1667999663,205203,true,1226288077,28,1223104028,-3184049
1667999687,205203,true,1226288077,28,1222859444,-3428633
1667999699,205204,true,1226165461,28,1222737171,-3428290
1667999747,205204,true,1226165461,28,1222248198,-3917263
1667999759,205203,true,1226288077,28,1222125985,-4162092
1667999783,205205,true,1226042856,28,1221881597,-4161259
1667999795,205206,true,1225920264,28,1221759421,-4160843
1667999843,205207,true,1225797685,28,1221148724,-4648961
1667999867,205207,true,1225797685,28,1220782453,-5015232
1667999927,205210,true,1225430019,28,1219806266,-5623753
1667999951,205212,true,1225184970,28,1219318466,-5866504
1667999963,205214,true,1224939969,28,1219074639,-5865330
1667999975,205215,true,1224817488,28,1218952743,-5864745
1668000023,205218,true,1224450116,28,1218099818,-6350298
1668000035,205220,true,1224205262,28,1217978020,-6227242
1668000047,205222,true,1223960458,28,1217856234,-6104224
1668000059,205222,true,1223960458,28,1217612700,-6347758
1668000095,205223,true,1223838074,28,1217247489,-6590585
1668000167,205224,true,1223715703,28,1216639048,-7076655
1668000179,205226,true,1223470996,28,1216517396,-6953600
1668000431,205226,true,1223470996,28,1214572622,-8898374
1668000443,205228,true,1223226339,28,1214572622,-8653717
1668000455,205230,true,1222981730,28,1214572622,-8409108
1668000467,205232,true,1222737171,28,1214451176,-8285995
1668000635,205233,true,1222614909,28,1213722761,-8892148
1668000707,205235,true,1222370423,28,1213116081,-9254342
1668000731,205237,true,1222125985,28,1212873495,-9252490
1668000743,205239,true,1221881597,28,1212752219,-9129378
1668000791,205240,true,1221759421,28,1212509705,-9249716
1668000851,205242,true,1221515106,28,1212024823,-9490283
1668000887,205244,true,1221270839,28,1211782454,-9488385
1668000899,205246,true,1221026622,28,1211661288,-9365334
1668000911,205247,true,1220904531,28,1211540134,-9364397
1668000959,205249,true,1220660387,28,1211176744,-9483643
1668001031,205251,true,1220416292,28,1210571338,-9844954
1668001055,205253,true,1220172245,28,1210450293,-9721952
1668001163,205253,true,1220172245,28,1209845249,-10326996
1668001343,205256,true,1219806266,28,1210208239,-9598027
1668001355,205258,true,1219562342,28,1210208239,-9354103
1668001367,205260,true,1219318466,28,1210329260,-8989206
1668001391,205260,true,1219318466,28,1210450293,-8868173
1668001403,205261,true,1219196546,28,1210571338,-8625208
1668001415,205262,true,1219074639,28,1210571338,-8503301
1668001535,205262,true,1219074639,28,1211176744,-7897895
1668001619,205262,true,1219074639,28,1211661288,-7413351
1668001667,205263,true,1218952743,28,1212024823,-6927920
1668001859,205264,true,1218830860,28,1213480053,-5350807
1668001871,205264,true,1218830860,28,1213480053,-5350807
1668001883,205263,true,1218952743,28,1213601401,-5351342
1668001895,205264,true,1218830860,28,1213601401,-5229459
1668001907,205265,true,1218708989,28,1213601401,-5107588
1668001931,205265,true,1218708989,28,1213601401,-5107588
1668001967,205265,true,1218708989,28,1213722761,-4986228
1668001991,205265,true,1218708989,28,1213722761,-4986228
1668002063,205267,true,1218465284,28,1213844133,-4621151
1668002291,205268,true,1218343450,28,1214329743,-4013707
1668002339,205267,true,1218465284,28,1214451176,-4014108
1668002351,205268,true,1218343450,28,1214451176,-3892274
1668002363,205269,true,1218221628,28,1214572622,-3649006
1668002459,205271,true,1217978020,28,1214694079,-3283941
1668002495,205271,true,1217978020,28,1214815548,-3162472
1668002519,205273,true,1217734461,28,1214815548,-2918913
1668002603,205274,true,1217612700,28,1214815548,-2797152
1668002639,205277,true,1217247489,28,1214694079,-2553410
1668002651,205277,true,1217247489,28,1214694079,-2553410
1668002687,205279,true,1217004076,28,1214572622,-2431454
1668002699,205281,true,1216760712,28,1214572622,-2188090
1668002723,205284,true,1216395756,28,1214572622,-1823134
1668002927,205285,true,1216274129,28,1214572622,-1701507
1668002963,205287,true,1216030911,28,1214572622,-1458289
1668002999,205289,true,1215787741,28,1214572622,-1215119
1668003047,205293,true,1215301547,28,1214694079,-607468
1668003083,205294,true,1215180029,28,1214815548,-364481
1668003107,205296,true,1214937030,28,1214815548,-121482
1668003143,205297,true,1214815548,28,1214937030,121482
1668003155,205299,true,1214572622,28,1214937030,364408
1668003179,205300,true,1214451176,28,1214937030,485854
1668003383,205301,true,1214329743,28,1214086914,-242829
1668003407,205302,true,1214208323,28,1213965517,-242806
1668003491,205304,true,1213965517,28,1213480053,-485464
1668003635,205305,true,1213844133,28,1212509705,-1334428
1668003671,205306,true,1213722761,28,1212267240,-1455521
1668003719,205307,true,1213601401,28,1212024823,-1576578
1668003827,205309,true,1213358717,28,1211540134,-1818583
1668003995,205310,true,1213237393,28,1210934545,-2302848
1668004043,205310,true,1213237393,28,1210692395,-2544998
1668004055,205311,true,1213116081,28,1210692395,-2423686
1668004067,205312,true,1212994782,28,1210571338,-2423444
1668004079,205314,true,1212752219,28,1210450293,-2301926
1668004127,205316,true,1212509705,28,1210087230,-2422475
1668004139,205317,true,1212388466,28,1209966234,-2422232
1668004151,205319,true,1212146025,28,1209845249,-2300776
1668004163,205322,true,1211782454,28,1209724277,-2058177
1668004283,205324,true,1211540134,28,1208756933,-2783201
1668004319,205326,true,1211297862,28,1208273551,-3024311
1668004355,205328,true,1211055639,28,1207911141,-3144498
1668004523,205331,true,1210692395,28,1206100723,-4591672
1668004535,205334,true,1210329260,28,1205980125,-4349135
1668004559,205336,true,1210087230,28,1205738965,-4348265
1668004571,205337,true,1209966234,28,1205738965,-4227269
1668004739,205338,true,1209845249,28,1204774808,-5070441
1668004859,205341,true,1209482368,28,1203931803,-5550565
1668004871,205342,true,1209361432,28,1203931803,-5429629
1668004883,205342,true,1209361432,28,1203811422,-5550010
1668004943,205343,true,1209240508,28,1203570695,-5669813
1668004967,205342,true,1209361432,28,1203450350,-5911082
1668005015,205343,true,1209240508,28,1203330017,-5910491
1668005051,205342,true,1209361432,28,1203330017,-6031415
1668005063,205340,true,1209603316,28,1203330017,-6273299
1668005075,205339,true,1209724277,28,1203330017,-6394260
1668005087,205339,true,1209724277,28,1203330017,-6394260
1668005099,205338,true,1209845249,28,1203330017,-6515232
1668005123,205336,true,1210087230,28,1203450350,-6636880
1668005135,205335,true,1210208239,28,1203570695,-6637544
1668005147,205335,true,1210208239,28,1203570695,-6637544
1668005159,205334,true,1210329260,28,1203691053,-6638207
1668005171,205333,true,1210450293,28,1203811422,-6638871
1668005195,205330,true,1210813464,28,1204172601,-6640863
1668005207,205329,true,1210934545,28,1204413448,-6521097
1668005243,205327,true,1211176744,28,1204895285,-6281459
1668005267,205325,true,1211418992,28,1205256790,-6162202
1668005315,205323,true,1211661288,28,1205859539,-5801749
1668005363,205321,true,1211903632,28,1206583236,-5320396
1668005399,205319,true,1212146025,28,1207065941,-5080084
1668005411,205317,true,1212388466,28,1207307367,-5081099
1668005423,205314,true,1212752219,28,1207428097,-5324122
1668005435,205313,true,1212873495,28,1207548840,-5324655
1668005471,205312,true,1212994782,28,1207911141,-5083641
1668005483,205310,true,1213237393,28,1208152735,-5084658
1668005495,205308,true,1213480053,28,1208273551,-5206502
1668005519,205308,true,1213480053,28,1208515217,-4964836
1668005531,205307,true,1213601401,28,1208636069,-4965332
1668005675,205306,true,1213722761,28,1209845249,-3877512
1668005687,205305,true,1213844133,28,1209966234,-3877899
1668005699,205304,true,1213965517,28,1210087230,-3878287
1668005807,205303,true,1214086914,28,1211176744,-2910170
1668005831,205302,true,1214208323,28,1211540134,-2668189
1668005843,205300,true,1214451176,28,1211661288,-2789888
1668005903,205300,true,1214451176,28,1212388466,-2062710
1668005951,205299,true,1214572622,28,1213116081,-1456541
1668006035,205297,true,1214815548,28,1214572622,-242926
1668006167,205296,true,1214937030,28,1216760712,1823682
1668006179,205296,true,1214937030,28,1217004076,2067046
1668006191,205295,true,1215058523,28,1217247489,2188966
1668006227,205294,true,1215180029,28,1217978020,2797991
1668006239,205291,true,1215544620,28,1218221628,2677008
1668006311,205290,true,1215666174,28,1219928247,4262073
1668006323,205289,true,1215787741,28,1220172245,4384504
1668006395,205287,true,1216030911,28,1221759421,5728510
1668006455,205284,true,1216395756,28,1222981730,6585974
1668006503,205282,true,1216639048,28,1223960458,7321410
1668006539,205281,true,1216760712,28,1224572561,7811849
1668006779,205280,true,1216882388,28,1228620123,11737735
1668006983,205278,true,1217125776,28,1229849296,12723520
1668007007,205277,true,1217247489,28,1229726323,12478834
1668007055,205278,true,1217125776,28,1229603363,12477587
1668007067,205277,true,1217247489,28,1229603363,12355874
1668007091,205275,true,1217490951,28,1229603363,12112412
1668007139,205275,true,1217490951,28,1229357479,11866528
1668007151,205275,true,1217490951,28,1229357479,11866528
1668007163,205275,true,1217490951,28,1229357479,11866528
1668007175,205273,true,1217734461,28,1229234556,11500095
1668007355,205272,true,1217856234,28,1228988746,11132512
1668007379,205273,true,1217734461,28,1228988746,11254285
1668007427,205272,true,1217856234,28,1229234556,11378322
1668007463,205270,true,1218099818,28,1229234556,11134738
1668007619,205268,true,1218343450,28,1229603363,11259913
1668007655,205268,true,1218343450,28,1229603363,11259913
1668007703,205267,true,1218465284,28,1229726323,11261039
1668007799,205266,true,1218587131,28,1229603363,11016232
1668007811,205265,true,1218708989,28,1229603363,10894374
1668007835,205265,true,1218708989,28,1229480415,10771426
1668007907,205264,true,1218830860,28,1229480415,10649555
1668007967,205263,true,1218952743,28,1229357479,10404736
1668007979,205262,true,1219074639,28,1229357479,10282840
1668008003,205262,true,1219074639,28,1229234556,10159917
1668008015,205262,true,1219074639,28,1229111644,10037005
1668008027,205262,true,1219074639,28,1228988746,9914107
1668008051,205262,true,1219074639,28,1228620123,9545484
1668008087,205263,true,1218952743,28,1228128797,9176054
1668008159,205263,true,1218952743,28,1226901344,7948601
1668008171,205263,true,1218952743,28,1226656000,7703257
1668008183,205263,true,1218952743,28,1226410706,7457963
1668008207,205266,true,1218587131,28,1225797685,7210554
1668008231,205269,true,1218221628,28,1225062463,6840835
1668008243,205271,true,1217978020,28,1224572561,6594541
1668008279,205274,true,1217612700,28,1223226339,5613639
1668008291,205278,true,1217125776,28,1222737171,5611395
1668008315,205282,true,1216639048,28,1221881597,5242549
1668008327,205284,true,1216395756,28,1221515106,5119350
1668008339,205285,true,1216274129,28,1221148724,4874595
1668008363,205288,true,1215909320,28,1220538333,4629013
1668008387,205290,true,1215666174,28,1220050240,4384066
1668008411,205291,true,1215544620,28,1219440398,3895778
1668008423,205292,true,1215423077,28,1219074639,3651562
1668008435,205295,true,1215058523,28,1218830860,3772337
1668008459,205297,true,1214815548,28,1218221628,3406080
1668008483,205299,true,1214572622,28,1217490951,2918329
1668008495,205301,true,1214329743,28,1217125776,2796033
1668008519,205303,true,1214086914,28,1216395756,2308842
1668008531,205306,true,1213722761,28,1215909320,2186559
1668008543,205307,true,1213601401,28,1215544620,1943219
1668008555,205308,true,1213480053,28,1215180029,1699976
1668008579,205311,true,1213116081,28,1214451176,1335095
1668008591,205314,true,1212752219,28,1214086914,1334695
1668008603,205315,true,1212630956,28,1213601401,970445
1668008615,205317,true,1212388466,28,1213116081,727615
1668008627,205321,true,1211903632,28,1212752219,848587
1668008639,205323,true,1211661288,28,1212267240,605952
1668008651,205325,true,1211418992,28,1211782454,363462
1668008663,205328,true,1211055639,28,1211297862,242223
1668008675,205332,true,1210571338,28,1210692395,121057
1668008699,205335,true,1210208239,28,1209845249,-362990
1668008723,205336,true,1210087230,28,1208998696,-1088534
1668008759,205337,true,1209966234,28,1207911141,-2055093
1668008795,205341,true,1209482368,28,1206462589,-3019779
1668008831,205346,true,1208877808,28,1205015775,-3862033
1668008843,205348,true,1208636069,28,1204533889,-4102180
1668008855,205350,true,1208394378,28,1204052196,-4342182
1668008879,205355,true,1207790362,28,1203209696,-4580666
1668008891,205359,true,1207307367,28,1202728533,-4578834
1668008915,205361,true,1207065941,28,1202007148,-5058793
1668008939,205364,true,1206703894,28,1201166080,-5537814
1668008951,205369,true,1206100723,28,1200805802,-5294921
1668008963,205373,true,1205618403,28,1200445632,-5172771
1668008999,205375,true,1205377316,28,1199245847,-6131469
1668009119,205378,true,1205015775,28,1195653680,-9362095
1668009203,205384,true,1204293018,28,1193145567,-11147451
1668009239,205390,true,1203570695,28,1191953077,-11617618
1668009287,205393,true,1203209696,28,1190404622,-12805074
1668009323,205397,true,1202728533,28,1189214872,-13513661
1668009335,205403,true,1202007148,28,1188739305,-13267843
1668009347,205410,true,1201166080,28,1188382755,-12783325
1668009359,205413,true,1200805802,28,1187907520,-12898282
1668009371,205418,true,1200205579,28,1187432476,-12773103
1668009383,205424,true,1199485708,28,1187076318,-12409390
1668009407,205431,true,1198646404,28,1186127084,-12519320
1668009419,205435,true,1198167065,28,1185652751,-12514314
1668009431,205439,true,1197687918,28,1185297127,-12390791
1668009443,205445,true,1196969556,28,1184823126,-12146430
1668009467,205452,true,1196132013,28,1183994082,-12137931
1668009479,205455,true,1195773245,28,1183520603,-12252642
1668009503,205460,true,1195175538,28,1182574212,-12601326
1668009515,205466,true,1194458683,28,1182101301,-12357382
1668009527,205472,true,1193742259,28,1181746741,-11995518
1668009539,205476,true,1193264881,28,1181274161,-11990720
1668009551,205480,true,1192787695,28,1180801769,-11985926
1668009563,205486,true,1192072272,28,1180447599,-11624673
1668009647,205492,true,1191357279,28,1177500313,-13856966
1668009671,205495,true,1190999944,28,1176676393,-14323551
1668009683,205499,true,1190523663,28,1176205840,-14317823
1668009731,205504,true,1189928579,28,1174912789,-15015790
1668009779,205508,true,1189452727,28,1173621160,-15831567
1668009803,205511,true,1189095962,28,1173034526,-16061436
1668009827,205514,true,1188739305,28,1172682686,-16056619
1668009887,205518,true,1188263928,28,1171862136,-16401792
1668009995,205522,true,1187788741,28,1170690918,-17097823
1668010007,205525,true,1187432476,28,1170690918,-16741558
1668010031,205529,true,1186957622,28,1170690918,-16266704
1668010043,205533,true,1186482957,28,1170690918,-15792039
1668010079,205537,true,1186008483,28,1171042161,-14966322
1668010103,205541,true,1185534198,28,1171276381,-14257817
1668010115,205545,true,1185060103,28,1171276381,-13783722
1668010127,205549,true,1184586197,28,1171276381,-13309816
1668010139,205553,true,1184112481,28,1171159265,-12953216
1668010175,205557,true,1183638955,28,1171042161,-12596794
1668010187,205560,true,1183283934,28,1170925068,-12358866
1668010235,205564,true,1182810739,28,1170807987,-12002752
1668010283,205568,true,1182337733,28,1170925068,-11412665
1668010463,205572,true,1181864916,28,1171862136,-10002780
1668010583,205576,true,1181392288,28,1172682686,-8709602
1668010655,205579,true,1181037941,28,1173503810,-7534131
1668010667,205583,true,1180565644,28,1173621160,-6944484
1668010679,205587,true,1180093536,28,1173621160,-6472376
1668010715,205591,true,1179621616,28,1173738522,-5883094
1668010727,205596,true,1179031983,28,1173738522,-5293461
1668010751,205600,true,1178560488,28,1173621160,-4939328
1668010787,205604,true,1178089181,28,1173621160,-4468021
1668010823,205609,true,1177500313,28,1173503810,-3996503
1668010847,205614,true,1176911740,28,1173386471,-3525269
1668010979,205618,true,1176441093,28,1173034526,-3406567
1668010991,205623,true,1175853049,28,1173034526,-2818523
1668011003,205627,true,1175382825,28,1172917234,-2465591
1668011015,205632,true,1174795310,28,1172917234,-1878076
1668011027,205636,true,1174325509,28,1172799954,-1525555
1668011039,205641,true,1173738522,28,1172799954,-938568
1668011051,205645,true,1173269144,28,1172682686,-586458
1668011063,205650,true,1172682686,28,1172682686,0
1668011135,205654,true,1172213730,28,1172213730,0
1668011147,205658,true,1171744962,28,1172213730,468768
1668011159,205661,true,1171393508,28,1172096520,703012
1668011219,205664,true,1171042161,28,1172213730,1171569
1668011243,205667,true,1170690918,28,1172330951,1640033
1668011255,205669,true,1170456815,28,1172330951,1874136
1668011279,205673,true,1169988750,28,1172330951,2342201
1668011291,205675,true,1169754787,28,1172330951,2576164
1668011303,205675,true,1169754787,28,1172330951,2576164
1668011315,205677,true,1169520871,28,1172330951,2810080
1668011327,205678,true,1169403931,28,1172330951,2927020
1668011339,205679,true,1169287002,28,1172330951,3043949
1668011363,205679,true,1169287002,28,1172213730,2926728
1668011387,205681,true,1169053180,28,1172213730,3160550
1668011411,205683,true,1168819404,28,1172213730,3394326
1668011483,205685,true,1168585675,28,1172213730,3628055
1668011495,205687,true,1168351993,28,1172096520,3744527
1668011567,205688,true,1168235170,28,1171627799,3392629
1668011579,205691,true,1167884769,28,1171510648,3625879
1668011603,205692,true,1167767992,28,1171393508,3625516
1668011699,205692,true,1167767992,28,1170690918,2922926
1668011723,205693,true,1167651227,28,1170456815,2805588
1668011735,205695,true,1167417732,28,1170339781,2922049
1668011759,205696,true,1167301002,28,1170222759,2921757
1668011783,205695,true,1167417732,28,1169988750,2571018
1668011795,205696,true,1167301002,28,1169871762,2570760
1668011831,205698,true,1167067577,28,1169520871,2453294
1668011843,205699,true,1166950882,28,1169403931,2453049
1668011915,205699,true,1166950882,28,1168585675,1634793
1668011939,205698,true,1167067577,28,1168468828,1401251
1668011951,205700,true,1166834198,28,1168351993,1517795
1668011963,205700,true,1166834198,28,1168235170,1400972
1668011999,205698,true,1167067577,28,1168001558,933981
1668012011,205697,true,1167184283,28,1167884769,700486
1668012023,205698,true,1167067577,28,1167767992,700415
1668012047,205697,true,1167184283,28,1167534474,350191
1668012059,205695,true,1167417732,28,1167417732,0
1668012071,205695,true,1167417732,28,1167417732,0
1668012083,205697,true,1167184283,28,1167301002,116719
1668012107,205695,true,1167417732,28,1167301002,-116730
1668012143,205693,true,1167651227,28,1167184283,-466944
1668012191,205692,true,1167767992,28,1167184283,-583709
1668012215,205692,true,1167767992,28,1167184283,-583709
1668012227,205690,true,1168001558,28,1167184283,-817275
1668012239,205688,true,1168235170,28,1167301002,-934168
1668012251,205686,true,1168468828,28,1167417732,-1051096
1668012431,205686,true,1168468828,28,1168585675,116847
1668012515,205684,true,1168702534,28,1169170085,467551
1668012527,205682,true,1168936286,28,1169287002,350716
1668012539,205681,true,1169053180,28,1169403931,350751
1668012575,205681,true,1169053180,28,1169754787,701607
1668012587,205679,true,1169287002,28,1169871762,584760
1668012599,205678,true,1169403931,28,1169988750,584819
1668012647,205677,true,1169520871,28,1170456815,935944
1668012671,205677,true,1169520871,28,1170690918,1170047
1668012683,205675,true,1169754787,28,1170807987,1053200
1668012731,205674,true,1169871762,28,1171276381,1404619
1668012755,205672,true,1170105748,28,1171510648,1404900
1668012767,205672,true,1170105748,28,1171627799,1522051
1668012779,205670,true,1170339781,28,1171627799,1288018
1668012995,205668,true,1170573861,28,1173973282,3399421
1668013007,205667,true,1170690918,28,1174090679,3399761
1668013019,205666,true,1170807987,28,1174208088,3400101
1668013067,205664,true,1171042161,28,1174560386,3518225
1668013079,205663,true,1171159265,28,1174677842,3518577
1668013103,205661,true,1171393508,28,1174912789,3519281
1668013115,205661,true,1171393508,28,1175030281,3636773
1668013163,205659,true,1171627799,28,1175500363,3872564
1668013187,205658,true,1171744962,28,1175735475,3990513
1668013199,205657,true,1171862136,28,1175853049,3990913
1668013211,205656,true,1171979322,28,1175853049,3873727
1668013307,205655,true,1172096520,28,1176441093,4344573
1668013367,205654,true,1172213730,28,1176794060,4580330
1668013379,205653,true,1172330951,28,1176911740,4580789
1668013403,205653,true,1172330951,28,1176911740,4580789
1668013487,205653,true,1172330951,28,1177029431,4698480
1668013547,205654,true,1172213730,28,1177147134,4933404
1668013559,205654,true,1172213730,28,1177147134,4933404
1668013571,205654,true,1172213730,28,1177264849,5051119
1668013583,205655,true,1172096520,28,1177264849,5168329
1668013727,205656,true,1171979322,28,1178442643,6463321
1668013751,205656,true,1171979322,28,1178560488,6581166
1668013787,205656,true,1171979322,28,1178678344,6699022
1668013811,205657,true,1171862136,28,1178796211,6934075
1668014027,205658,true,1171744962,28,1178678344,6933382
1668014051,205658,true,1171744962,28,1178560488,6815526
1668014063,205658,true,1171744962,28,1178442643,6697681
1668014075,205659,true,1171627799,28,1178324811,6697012
1668014087,205659,true,1171627799,28,1178206990,6579191
1668014099,205658,true,1171744962,28,1178206990,6462028
1668014147,205658,true,1171744962,28,1177853599,6108637
1668014291,205659,true,1171627799,28,1177147134,5519335
1668014399,205660,true,1171510648,28,1176676393,5165745
1668014423,205658,true,1171744962,28,1176558737,4813775
1668014471,205658,true,1171744962,28,1176441093,4696131
1668014519,205659,true,1171627799,28,1176323460,4695661
1668014555,205660,true,1171510648,28,1176205840,4695192
1668014567,205659,true,1171627799,28,1176088231,4460432
1668014579,205658,true,1171744962,28,1176088231,4343269
1668014591,205658,true,1171744962,28,1175970634,4225672
1668014603,205659,true,1171627799,28,1175970634,4342835
1668014615,205658,true,1171744962,28,1175853049,4108087
1668014627,205658,true,1171744962,28,1175735475,3990513
1668014651,205659,true,1171627799,28,1175500363,3872564
1668014843,205660,true,1171510648,28,1173621160,2110512
1668014903,205659,true,1171627799,28,1173151829,1524030
1668014915,205659,true,1171627799,28,1173034526,1406727
1668014939,205660,true,1171510648,28,1172799954,1289306
1668014951,205661,true,1171393508,28,1172799954,1406446
1668014975,205660,true,1171510648,28,1172565429,1054781
1668015023,205660,true,1171510648,28,1172213730,703082
1668015071,205661,true,1171393508,28,1171862136,468628
1668015131,205662,true,1171276381,28,1171393508,117127
1668015143,205661,true,1171393508,28,1171276381,-117127
1668015155,205660,true,1171510648,28,1171276381,-234267
1668015203,205661,true,1171393508,28,1171042161,-351347
1668015287,205662,true,1171276381,28,1170807987,-468394
1668015299,205661,true,1171393508,28,1170807987,-585521
1668015323,205660,true,1171510648,28,1170690918,-819730
1668015371,205660,true,1171510648,28,1170690918,-819730
1668015395,205660,true,1171510648,28,1170573861,-936787
1668015407,205658,true,1171744962,28,1170456815,-1288147
1668015443,205657,true,1171862136,28,1170222759,-1639377
1668015455,205658,true,1171744962,28,1170105748,-1639214
1668015467,205658,true,1171744962,28,1169988750,-1756212
1668015479,205657,true,1171862136,28,1169988750,-1873386
1668015491,205656,true,1171979322,28,1169871762,-2107560
1668015503,205656,true,1171979322,28,1169871762,-2107560
1668015539,205656,true,1171979322,28,1169754787,-2224535
1668015551,205654,true,1172213730,28,1169637823,-2575907
1668015575,205653,true,1172330951,28,1169637823,-2693128
1668015587,205654,true,1172213730,28,1169637823,-2575907
1668015599,205655,true,1172096520,28,1169520871,-2575649
1668015635,205654,true,1172213730,28,1169403931,-2809799
1668015683,205653,true,1172330951,28,1169287002,-3043949
1668015731,205654,true,1172213730,28,1169170085,-3043645
1668015803,205654,true,1172213730,28,1168936286,-3277444
1668016055,205653,true,1172330951,28,1167767992,-4562959
1668016175,205652,true,1172448184,28,1166950882,-5497302
1668016187,205652,true,1172448184,28,1166950882,-5497302
1668016199,205652,true,1172448184,28,1166834198,-5613986
1668016271,205651,true,1172565429,28,1166600866,-5964563
1668016283,205649,true,1172799954,28,1166484218,-6315736
1668016307,205650,true,1172682686,28,1166484218,-6198468
1668016583,205649,true,1172799954,28,1167184283,-5615671
1668016751,205648,true,1172917234,28,1168351993,-4565241
1668016763,205647,true,1173034526,28,1168468828,-4565698
1668016811,205648,true,1172917234,28,1168819404,-4097830
1668016823,205647,true,1173034526,28,1168819404,-4215122
1668016967,205648,true,1172917234,28,1169403931,-3513303
1668016979,205647,true,1173034526,28,1169403931,-3630595
1668017015,205649,true,1172799954,28,1169520871,-3279083
1668017027,205649,true,1172799954,28,1169520871,-3279083
1668017087,205650,true,1172682686,28,1169754787,-2927899
1668017099,205649,true,1172799954,28,1169754787,-3045167
1668017243,205652,true,1172448184,28,1169637823,-2810361
1668017339,205653,true,1172330951,28,1169754787,-2576164
1668017375,205655,true,1172096520,28,1169754787,-2341733
1668017387,205656,true,1171979322,28,1169754787,-2224535
1668017447,205659,true,1171627799,28,1169637823,-1989976
1668017459,205660,true,1171510648,28,1169637823,-1872825
1668017471,205663,true,1171159265,28,1169520871,-1638394
1668017483,205664,true,1171042161,28,1169520871,-1521290
1668017495,205667,true,1170690918,28,1169403931,-1286987
1668017543,205668,true,1170573861,28,1169287002,-1286859
1668017603,205670,true,1170339781,28,1169053180,-1286601
1668017699,205671,true,1170222759,28,1168468828,-1753931
1668017723,205674,true,1169871762,28,1168351993,-1519769
1668017735,205675,true,1169754787,28,1168235170,-1519617
1668017759,205678,true,1169403931,28,1168118358,-1285573
1668017807,205680,true,1169170085,28,1167651227,-1518858
1668017819,205683,true,1168819404,28,1167534474,-1284930
1668017867,205684,true,1168702534,28,1167184283,-1518251
1668017891,205686,true,1168468828,28,1166834198,-1634630
1668017903,205689,true,1168118358,28,1166717526,-1400832
1668017915,205692,true,1167767992,28,1166600866,-1167126
1668017939,205693,true,1167651227,28,1166367581,-1283646
1668017975,205695,true,1167417732,28,1166017741,-1399991
1668017987,205697,true,1167184283,28,1165901151,-1283132
1668017999,205699,true,1166950882,28,1165784572,-1166310
1668018011,205699,true,1166950882,28,1165784572,-1166310
1668018035,205700,true,1166834198,28,1165668005,-1166193
1668018095,205701,true,1166717526,28,1165318375,-1399151
1668018191,205703,true,1166484218,28,1164735891,-1748327
1668018215,205703,true,1166484218,28,1164502978,-1981240
1668018239,205703,true,1166484218,28,1164386540,-2097678
1668018335,205705,true,1166250956,28,1163455449,-2795507
1668018359,205707,true,1166017741,28,1163222793,-2794948
1668018383,205707,true,1166017741,28,1163106483,-2911258
1668018539,205707,true,1166017741,28,1161944016,-4073725
1668018563,205708,true,1165901151,28,1161711662,-4189489
1668018575,205710,true,1165668005,28,1161711662,-3956343
1668018587,205711,true,1165551450,28,1161595502,-3955948
1668018623,205711,true,1165551450,28,1161363218,-4188232
1668018647,205713,true,1165318375,28,1161247093,-4071282
1668018671,205716,true,1164968849,28,1161014879,-3953970
1668018683,205716,true,1164968849,28,1161014879,-3953970
1668018731,205716,true,1164968849,28,1160782710,-4186139
1668018815,205718,true,1164735891,28,1160318513,-4417378
1668018851,205720,true,1164502978,28,1160086484,-4416494
1668019067,205721,true,1164386540,28,1158811155,-5575385
1668019091,205723,true,1164153697,28,1158695285,-5458412
1668019103,205725,true,1163920901,28,1158579427,-5341474
1668019127,205728,true,1163571795,28,1158347746,-5224049
1668019187,205730,true,1163339116,28,1157884523,-5454593
1668019271,205731,true,1163222793,28,1157305754,-5917039
1668019295,205733,true,1162990184,28,1157190035,-5800149
1668019307,205736,true,1162641356,28,1157074328,-5567028
1668019319,205738,true,1162408863,28,1157074328,-5334535
1668019331,205740,true,1162176416,28,1156958632,-5217784
1668019343,205741,true,1162060210,28,1156842948,-5217262
1668019391,205744,true,1161711662,28,1156611614,-5100048
1668019415,205745,true,1161595502,28,1156495964,-5099538
1668019427,205746,true,1161479354,28,1156380326,-5099028
1668019451,205747,true,1161363218,28,1156264700,-5098518
1668019511,205749,true,1161130980,28,1155917890,-5213090
1668019523,205749,true,1161130980,28,1155917890,-5213090
1668019547,205750,true,1161014879,28,1155802309,-5212570
1668019583,205751,true,1160898789,28,1155802309,-5096480
1668019595,205752,true,1160782710,28,1155802309,-4980401
1668019679,205752,true,1160782710,28,1155686741,-5095969
1668019691,205753,true,1160666644,28,1155686741,-4979903
1668019715,205753,true,1160666644,28,1155802309,-4864335
1668019775,205753,true,1160666644,28,1156149085,-4517559
1668019787,205752,true,1160782710,28,1156149085,-4633625
1668019799,205752,true,1160782710,28,1156264700,-4518010
1668019895,205751,true,1160898789,28,1156727275,-4171514
1668019919,205751,true,1160898789,28,1156842948,-4055841
1668020015,205751,true,1160898789,28,1157190035,-3708754
1668020087,205750,true,1161014879,28,1157884523,-3130356
1668020099,205749,true,1161130980,28,1158000311,-3130669
1668020123,205750,true,1161014879,28,1158116111,-2898768
1668020135,205749,true,1161130980,28,1158231923,-2899057
1668020159,205750,true,1161014879,28,1158347746,-2667133
1668020183,205749,true,1161130980,28,1158463581,-2667399
1668020195,205748,true,1161247093,28,1158463581,-2783512
1668020555,205748,true,1161247093,28,1159622566,-1624527
1668020567,205749,true,1161130980,28,1159738528,-1392452
1668020591,205748,true,1161247093,28,1159738528,-1508565
1668020603,205748,true,1161247093,28,1159854502,-1392591
1668020615,205748,true,1161247093,28,1159970487,-1276606
1668020651,205748,true,1161247093,28,1160202493,-1044600
1668020663,205747,true,1161363218,28,1160318513,-1044705
1668020675,205747,true,1161363218,28,1160434545,-928673
1668020699,205746,true,1161479354,28,1160782710,-696644
1668020711,205745,true,1161595502,28,1161014879,-580623
1668020807,205742,true,1161944016,28,1162641356,697340
1668020819,205742,true,1161944016,28,1162757620,813604
1668020843,205741,true,1162060210,28,1163222793,1162583
1668020999,205740,true,1162176416,28,1165901151,3724735
1668021011,205737,true,1162525104,28,1166134343,3609239
1668021023,205737,true,1162525104,28,1166250956,3725852
1668021035,205736,true,1162641356,28,1166484218,3842862
1668021059,205736,true,1162641356,28,1166834198,4192842
1668021071,205734,true,1162873896,28,1166950882,4076986
1668021143,205734,true,1162873896,28,1168235170,5361274
1668021443,205734,true,1162873896,28,1172917234,10043338
1668021467,205734,true,1162873896,28,1173386471,10512575
1668021479,205732,true,1163106483,28,1173621160,10514677
1668021503,205732,true,1163106483,28,1173973282,10866799
1668021539,205731,true,1163222793,28,1174560386,11337593
1668021647,205729,true,1163455449,28,1175970634,12515185
1668021671,205726,true,1163804521,28,1176205840,12401319
1668021695,205726,true,1163804521,28,1176441093,12636572
1668021839,205725,true,1163920901,28,1177853599,13932698
1668021851,205723,true,1164153697,28,1177971384,13817687
1668021875,205721,true,1164386540,28,1178206990,13820450
1668021923,205719,true,1164619429,28,1178914091,14294662
1668021947,205716,true,1164968849,28,1179267801,14298952
1668021959,205714,true,1165201855,28,1179503666,14301811
1668022271,205712,true,1165434907,28,1184467751,19032844
1668022343,205711,true,1165551450,28,1185534198,19982748
1668022415,205708,true,1165901151,28,1186482957,20581806
1668022547,205706,true,1166134343,28,1187313745,21179402
1668022775,205704,true,1166367581,28,1187788741,21421160
1668022799,205702,true,1166600866,28,1187907520,21306654
1668022871,205699,true,1166950882,28,1188263928,21313046
1668022883,205697,true,1167184283,28,1188382755,21198472
1668022967,205694,true,1167534474,28,1189095962,21561488
1668023027,205692,true,1167767992,28,1189690629,21922637
1668023051,205688,true,1168235170,28,1189928579,21693409
1668023063,205686,true,1168468828,28,1190047572,21578744
1668023123,205681,true,1169053180,28,1190761779,21708599
1668023135,205678,true,1169403931,28,1190880856,21476925
1668023147,205674,true,1169871762,28,1190999944,21128182
1668023231,205672,true,1170105748,28,1191833894,21728146
1668023327,205668,true,1170573861,28,1192429930,21856069
1668023339,205664,true,1171042161,28,1192549173,21507012
1668023351,205660,true,1171510648,28,1192549173,21038525
1668023471,205659,true,1171627799,28,1192906973,21279174
1668023483,205655,true,1172096520,28,1192906973,20810453
1668023507,205652,true,1172448184,28,1193026264,20578080
1668023543,205648,true,1172917234,28,1193026264,20109030
1668023627,205649,true,1172799954,28,1193264881,20464927
1668023639,205646,true,1173151829,28,1193264881,20113052
1668023651,205643,true,1173503810,28,1193264881,19761071
1668023891,205640,true,1173855896,28,1192429930,18574034
1668023903,205640,true,1173855896,28,1192429930,18574034
1668024047,205636,true,1174325509,28,1192191480,17865971
1668024143,205633,true,1174677842,28,1192191480,17513638
1668024155,205629,true,1175147784,28,1192191480,17043696
1668024167,205630,true,1175030281,28,1192191480,17161199
1668024491,205627,true,1175382825,28,1191953077,16570252
1668024587,205625,true,1175617913,28,1191833894,16215981
1668024815,205621,true,1176088231,28,1190999944,14911713
1668025103,205621,true,1176088231,28,1189333794,13245563
1668025139,205619,true,1176323460,28,1189214872,12891412
1668025175,205615,true,1176794060,28,1189095962,12301902
1668025259,205611,true,1177264849,28,1188977065,11712216
1668025295,205612,true,1177147134,28,1188858179,11711045
1668025331,205609,true,1177500313,28,1188858179,11357866
1668025355,205606,true,1177853599,28,1188858179,11004580
1668025391,205601,true,1178442643,28,1188858179,10415536
1668025451,205602,true,1178324811,28,1188739305,10414494
1668025463,205599,true,1178678344,28,1188739305,10060961
1668025499,205596,true,1179031983,28,1188739305,9707322
1668025511,205591,true,1179621616,28,1188620443,8998827
1668025535,205592,true,1179503666,28,1188620443,9116777
1668025607,205589,true,1179857553,28,1188382755,8525202
1668025619,205586,true,1180211545,28,1188382755,8171210
1668025643,205581,true,1180801769,28,1188263928,7462159
1668025679,205581,true,1180801769,28,1188145114,7343345
1668025739,205579,true,1181037941,28,1187907520,6869579
1668025751,205576,true,1181392288,28,1187788741,6396453
1668025775,205571,true,1181983102,28,1187669974,5686872
1668025799,205572,true,1181864916,28,1187551219,5686303
1668025847,205569,true,1182219511,28,1187313745,5094234
1668026039,205565,true,1182692469,28,1186838938,4146469
1668026051,205560,true,1183283934,28,1186838938,3555004
1668026063,205561,true,1183165617,28,1186838938,3673321
1668026099,205558,true,1183520603,28,1186838938,3318335
1668026111,205554,true,1183994082,28,1186957622,2963540
1668026123,205548,true,1184704656,28,1186957622,2252966
1668026147,205548,true,1184704656,28,1187076318,2371662
1668026207,205545,true,1185060103,28,1187195025,2134922
1668026279,205542,true,1185415656,28,1187551219,2135563
1668026291,205537,true,1186008483,28,1187551219,1542736
1668026303,205538,true,1185889894,28,1187551219,1661325
1668026351,205537,true,1186008483,28,1187788741,1780258
1668026411,205534,true,1186364321,28,1188026311,1661990
1668026423,205530,true,1186838938,28,1188026311,1187373
1668026435,205531,true,1186720266,28,1188026311,1306045
1668026447,205530,true,1186838938,28,1188026311,1187373
1668026459,205529,true,1186957622,28,1188026311,1068689
1668026495,205526,true,1187313745,28,1187907520,593775
1668026519,205527,true,1187195025,28,1187788741,593716
1668026531,205527,true,1187195025,28,1187669974,474949
1668026555,205526,true,1187313745,28,1187432476,118731
1668026579,205524,true,1187551219,28,1187313745,-237474
1668026591,205525,true,1187432476,28,1187195025,-237451
1668026603,205525,true,1187432476,28,1187076318,-356158
1668026615,205525,true,1187432476,28,1186957622,-474854
1668026639,205524,true,1187551219,28,1186601606,-949613
1668026675,205527,true,1187195025,28,1186127084,-1067941
1668026699,205528,true,1187076318,28,1185771317,-1305001
1668026747,205529,true,1186957622,28,1184941609,-2016013
1668026759,205528,true,1187076318,28,1184823126,-2253192
1668026771,205533,true,1186482957,28,1184586197,-1896760
1668026807,205534,true,1186364321,28,1184230893,-2133428
1668026855,205535,true,1186245696,28,1183638955,-2606741
1668026879,205534,true,1186364321,28,1183402262,-2962059
1668026891,205538,true,1185889894,28,1183283934,-2605960
1668026903,205540,true,1185652751,28,1183165617,-2487134
1668026927,205540,true,1185652751,28,1182810739,-2842012
1668026987,205541,true,1185534198,28,1181864916,-3669282
1668026999,205544,true,1185178609,28,1181628578,-3550031
1668027011,205546,true,1184941609,28,1181392288,-3549321
1668027023,205547,true,1184823126,28,1181156045,-3667081
1668027059,205549,true,1184586197,28,1180447599,-4138598
1668027071,205552,true,1184230893,28,1180211545,-4019348
1668027083,205554,true,1183994082,28,1179857553,-4136529
1668027095,205555,true,1183875694,28,1179621616,-4254078
1668027131,205558,true,1183520603,28,1178914091,-4606512
1668027155,205562,true,1183047313,28,1178442643,-4604670
1668027167,205564,true,1182810739,28,1178206990,-4603749
1668027203,205565,true,1182692469,28,1177618063,-5074406
1668027251,205568,true,1182337733,28,1176794060,-5543673
1668027263,205572,true,1181864916,28,1176676393,-5188523
1668027299,205573,true,1181746741,28,1176088231,-5658510
1668027311,205575,true,1181510427,28,1175853049,-5657378
1668027503,205578,true,1181156045,28,1173386471,-7769574
1668027539,205582,true,1180683701,28,1173151829,-7531872
1668027575,205583,true,1180565644,28,1172799954,-7765690
1668027599,205584,true,1180447599,28,1172565429,-7882170
1668027635,205586,true,1180211545,28,1172213730,-7997815
1668027647,205590,true,1179739579,28,1172096520,-7643059
1668027659,205590,true,1179739579,28,1171979322,-7760257
1668027671,205592,true,1179503666,28,1171862136,-7641530
1668027695,205594,true,1179267801,28,1171510648,-7757153
1668027707,205598,true,1178796211,28,1171393508,-7402703
1668027731,205600,true,1178560488,28,1171042161,-7518327
1668027743,205602,true,1178324811,28,1170807987,-7516824
1668027755,205606,true,1177853599,28,1170573861,-7279738
1668027779,205611,true,1177264849,28,1169988750,-7276099
1668027791,205615,true,1176794060,28,1169871762,-6922298
1668027803,205617,true,1176558737,28,1169637823,-6920914
1668027839,205621,true,1176088231,28,1168936286,-7151945
1668027863,205625,true,1175617913,28,1168468828,-7149085
1668027899,205628,true,1175265298,28,1167651227,-7614071
1668027911,205631,true,1174912789,28,1167417732,-7495057
1668027923,205635,true,1174442942,28,1167067577,-7375365
1668027947,205639,true,1173973282,28,1166484218,-7489064
1668027959,205642,true,1173621160,28,1166134343,-7486817
1668027983,205645,true,1173269144,28,1165434907,-7834237
1668028019,205649,true,1172799954,28,1164502978,-8296976
1668028091,205652,true,1172448184,28,1162757620,-9690564
1668028127,205655,true,1172096520,28,1161827833,-10268687
1668028163,205658,true,1171744962,28,1160898789,-10846173
1668028199,205661,true,1171393508,28,1159970487,-11423021
1668028235,205664,true,1171042161,28,1159158833,-11883328
1668028271,205667,true,1170690918,28,1158579427,-12111491
1668028295,205670,true,1170339781,28,1158116111,-12223670
1668028307,205674,true,1169871762,28,1157884523,-11987239
1668028355,205677,true,1169520871,28,1157190035,-12330836
1668028367,205680,true,1169170085,28,1157074328,-12095757
1668028379,205682,true,1168936286,28,1156958632,-11977654
1668028391,205686,true,1168468828,28,1156727275,-11741553
1668028403,205690,true,1168001558,28,1156611614,-11389944
1668028427,205692,true,1167767992,28,1156380326,-11387666
1668028439,205694,true,1167534474,28,1156264700,-11269774
1668028571,205698,true,1167067577,28,1155455638,-11611939
1668028583,205702,true,1166600866,28,1155340104,-11260762
1668028607,205704,true,1166367581,28,1155109071,-11258510
1668028631,205707,true,1166017741,28,1154762607,-11255134
1668028643,205712,true,1165434907,28,1154531689,-10903218
1668028655,205716,true,1164968849,28,1154416248,-10552601
1668028715,205719,true,1164619429,28,1153493130,-11126299
1668028739,205722,true,1164270113,28,1153147151,-11122962
1668028763,205727,true,1163688152,28,1152801276,-10886876
1668028775,205731,true,1163222793,28,1152686008,-10536785
1668028787,205734,true,1162873896,28,1152455505,-10418391
1668028799,205737,true,1162525104,28,1152340271,-10184833
1668028871,205742,true,1161944016,28,1151649109,-10294907
1668028907,205746,true,1161479354,28,1151303683,-10175671
1668028919,205749,true,1161130980,28,1151188564,-9942416
1668028931,205752,true,1160782710,28,1150958361,-9824349
1668028943,205757,true,1160202493,28,1150843277,-9359216
1668028967,205761,true,1159738528,28,1150613143,-9125385
1668028979,205764,true,1159390676,28,1150383055,-9007621
1668028991,205768,true,1158927036,28,1150268028,-8659008
1668029099,205774,true,1158231923,28,1148429162,-9802761
1668029111,205779,true,1157652981,28,1148199511,-9453470
1668029135,205783,true,1157190035,28,1147740346,-9449689
1668029183,205788,true,1156611614,28,1146822567,-9789047
1668029207,205794,true,1155917890,28,1146249327,-9668563
1668029219,205799,true,1155340104,28,1146020112,-9319992
1668029231,205805,true,1154647142,28,1145790942,-8856200
1668029243,205811,true,1153954597,28,1145447274,-8507323
1668029255,205818,true,1153147151,28,1145103708,-8043443
1668029267,205824,true,1152455505,28,1144874722,-7580783
1668029279,205829,true,1151879450,28,1144531328,-7348122
1668029327,205836,true,1151073457,28,1143158783,-7914674
1668029351,205843,true,1150268028,28,1142473128,-7794900
1668029363,205849,true,1149578109,28,1142016253,-7561856
1668029375,205854,true,1149003492,28,1141673716,-7329776
1668029399,205860,true,1148314331,28,1140760788,-7553543
1668029411,205867,true,1147510832,28,1140418628,-7092204
1668029423,205872,true,1146937249,28,1140076571,-6860678
1668029471,205875,true,1146593237,28,1138823239,-7769998
1668029483,205879,true,1146134714,28,1138595509,-7539205
1668029495,205885,true,1145447274,28,1138253998,-7193276
1668029543,205889,true,1144989209,28,1137230082,-7759127
1668029555,205891,true,1144760246,28,1137002670,-7757576
1668029591,205895,true,1144302456,28,1136434339,-7868117
1668029627,205899,true,1143844850,28,1135866292,-7978558
1668029639,205902,true,1143501765,28,1135639153,-7862612
1668029651,205904,true,1143273099,28,1135412059,-7861040
1668029663,205907,true,1142930185,28,1135185011,-7745174
1668029675,205911,true,1142473128,28,1135071504,-7401624
1668029687,205914,true,1142130454,28,1134844524,-7285930
1668029699,205916,true,1141902062,28,1134731050,-7171012
1668029771,205918,true,1141673716,28,1134163855,-7509861
1668029783,205922,true,1141217161,28,1134050450,-7166711
1668029807,205924,true,1140988952,28,1133823674,-7165278
1668029819,205926,true,1140760788,28,1133823674,-6937114
1668029831,205928,true,1140532670,28,1133596943,-6935727
1668029903,205931,true,1140190579,28,1132917023,-7273556
1668029939,205934,true,1139848590,28,1132577216,-7271374
1668029951,205935,true,1139734617,28,1132463969,-7270648
1668029963,205937,true,1139506704,28,1132237511,-7269193
1668029987,205939,true,1139278837,28,1132011097,-7267740
1668030035,205942,true,1138937121,28,1131445261,-7491860
1668030095,205943,true,1138823239,28,1130653566,-8169673
1668030107,205945,true,1138595509,28,1130540512,-8054997
1668030119,205948,true,1138253998,28,1130314438,-7939560
1668030131,205951,true,1137912590,28,1130201418,-7711172
1668030143,205954,true,1137571285,28,1129975412,-7595873
1668030191,205958,true,1137116370,28,1128846057,-8270313
1668030215,205962,true,1136661637,28,1128394632,-8267005
1668030323,205966,true,1136207086,28,1125915016,-10292070
1668030335,205970,true,1135752717,28,1125577309,-10175408
1668030371,205974,true,1135298529,28,1124789720,-10508809
1668030383,205978,true,1134844524,28,1124564796,-10279728
1668030419,205982,true,1134390699,28,1123890293,-10500406
1668030431,205986,true,1133937056,28,1123665549,-10271507
1668030443,205990,true,1133483595,28,1123553194,-9930401
1668030479,205996,true,1132803743,28,1122879298,-9924445
1668030491,206000,true,1132350734,28,1122767021,-9583713
1668030515,206003,true,1132011097,28,1122318026,-9693071
1668030551,206007,true,1131558406,28,1121981398,-9577008
1668030563,206012,true,1130992796,28,1121869211,-9123585
1668030611,206015,true,1130653566,28,1121420576,-9232990
1668030671,206017,true,1130427470,28,1120747959,-9679511
1668030707,206020,true,1130088409,28,1120411802,-9676607
1668030719,206024,true,1129636487,28,1120299772,-9336715
1668030731,206026,true,1129410593,28,1120187753,-9222840
1668030743,206028,true,1129184745,28,1120075745,-9109000
1668030755,206031,true,1128846057,28,1119851764,-8994293
1668030779,206036,true,1128281804,28,1119627827,-8653977
1668030791,206039,true,1127943387,28,1119515875,-8427512
1668030839,206041,true,1127717832,28,1118956285,-8761547
1668030863,206045,true,1127266858,28,1118508815,-8758043
1668030923,206051,true,1126590734,28,1117726172,-8864562
1668031031,206053,true,1126365450,28,1116609060,-9756390
1668031043,206056,true,1126027608,28,1116609060,-9418548
1668031127,206058,true,1125802436,28,1116385772,-9416664
1668031139,206064,true,1125127191,28,1116274144,-8853047
1668031283,206066,true,1124902199,28,1115939329,-8962870
1668031295,206068,true,1124677252,28,1115827746,-8849506
1668031307,206072,true,1124227494,28,1115716175,-8511319
1668031319,206077,true,1123665549,28,1115604614,-8060935
1668031331,206080,true,1123328517,28,1115493065,-7835452
1668031355,206082,true,1123103885,28,1115381527,-7722358
1668031403,206085,true,1122767021,28,1115046979,-7720042
1668031427,206090,true,1122205806,28,1114935486,-7270320
1668031523,206092,true,1121981398,28,1114043938,-7937460
1668031547,206094,true,1121757036,28,1113709792,-8047244
1668031571,206097,true,1121420576,28,1113375746,-8044830
1668031583,206102,true,1120860034,28,1113264420,-7595614
1668031595,206104,true,1120635895,28,1113041800,-7594095
1668031607,206106,true,1120411802,28,1112930507,-7481295
1668031631,206110,true,1119963749,28,1112596695,-7367054
1668031643,206116,true,1119292006,28,1112374209,-6917797
1668031667,206118,true,1119068181,28,1112040563,-7027618
1668031679,206121,true,1118732528,28,1111818188,-6914340
1668031739,206124,true,1118396975,28,1110929134,-7467841
1668031871,206129,true,1117837944,28,1109153157,-8684787
1668031883,206131,true,1117614410,28,1108931360,-8683050
1668031907,206132,true,1117502660,28,1108598747,-8903913
1668031919,206136,true,1117055771,28,1108487898,-8567873
1668031931,206140,true,1116609060,28,1108377061,-8231999
1668031943,206142,true,1116385772,28,1108266234,-8119538
1668031955,206143,true,1116274144,28,1108266234,-8007910
1668031991,206145,true,1116050923,28,1108377061,-7673862
1668032051,206148,true,1115716175,28,1108709607,-7006568
1668032063,206149,true,1115604614,28,1108709607,-6895007
1668032075,206149,true,1115604614,28,1108709607,-6895007
1668032111,206151,true,1115381527,28,1108820478,-6561049
1668032135,206154,true,1115046979,28,1108931360,-6115619
1668032231,206155,true,1114935486,28,1109042253,-5893233
1668032387,206155,true,1114935486,28,1109264073,-5671413
1668032447,206156,true,1114824003,28,1109042253,-5781750
1668032495,206159,true,1114489623,28,1109042253,-5447370
1668032519,206160,true,1114378185,28,1108931360,-5446825
1668032579,206159,true,1114489623,28,1109153157,-5336466
1668032591,206160,true,1114378185,28,1109264073,-5114112
1668032615,206161,true,1114266758,28,1109485936,-4780822
1668032783,206161,true,1114266758,28,1111151331,-3115427
1668032795,206159,true,1114489623,28,1111262446,-3227177
1668032819,206159,true,1114489623,28,1111595858,-2893765
1668032831,206159,true,1114489623,28,1111707018,-2782605
1668032891,206158,true,1114601072,28,1112262982,-2338090
1668033023,206156,true,1114824003,28,1113487084,-1336919
1668033095,206155,true,1114935486,28,1114155343,-780143
1668033107,206156,true,1114824003,28,1114266758,-557245
1668033119,206154,true,1115046979,28,1114489623,-557356
1668033215,206153,true,1115158484,28,1114935486,-222998
1668033431,206152,true,1115270000,28,1116162528,892528
1668033443,206152,true,1115270000,28,1116274144,1004144
1668033659,206150,true,1115493065,28,1118620666,3127601
1668033683,206151,true,1115381527,28,1118956285,3574758
1668033695,206150,true,1115493065,28,1119068181,3575116
1668033731,206150,true,1115493065,28,1119403935,3910870
1668033755,206149,true,1115604614,28,1119627827,4023213
1668033791,206150,true,1115493065,28,1119851764,4358699
1668033839,206149,true,1115604614,28,1119963749,4359135
1668033983,206149,true,1115604614,28,1120747959,5143345
1668034067,206147,true,1115827746,28,1121308445,5480699
1668034079,206148,true,1115716175,28,1121420576,5704401
1668034091,206148,true,1115716175,28,1121420576,5704401
1668034151,206149,true,1115604614,28,1121644871,6040257
1668034163,206148,true,1115716175,28,1121644871,5928696
1668034175,206150,true,1115493065,28,1121644871,6151806
1668034235,206152,true,1115270000,28,1121757036,6487036
1668034307,206154,true,1115046979,28,1121869211,6822232
1668034391,206154,true,1115046979,28,1121757036,6710057
1668034403,206155,true,1114935486,28,1121757036,6821550
1668034535,206156,true,1114824003,28,1121644871,6820868
1668034595,206157,true,1114712532,28,1121532718,6820186
1668034739,206157,true,1114712532,28,1121196325,6483793
1668034763,206158,true,1114601072,28,1121084217,6483145
1668034811,206159,true,1114489623,28,1120972120,6482497
1668034823,206160,true,1114378185,28,1120860034,6481849
1668034835,206159,true,1114489623,28,1120860034,6370411
1668034847,206161,true,1114266758,28,1120860034,6593276
1668034859,206163,true,1114043938,28,1120747959,6704021
1668034871,206163,true,1114043938,28,1120747959,6704021
1668034883,206162,true,1114155343,28,1120635895,6480552
1668034895,206163,true,1114043938,28,1120635895,6591957
1668034919,206162,true,1114155343,28,1120523843,6368500
1668034931,206162,true,1114155343,28,1120523843,6368500
1668034943,206161,true,1114266758,28,1120411802,6145044
1668034967,206161,true,1114266758,28,1120299772,6033014
1668035039,206161,true,1114266758,28,1120075745,5808987
1668035075,206161,true,1114266758,28,1119851764,5585006
1668035087,206161,true,1114266758,28,1119739790,5473032
1668035111,206162,true,1114155343,28,1119515875,5360532
1668035123,206163,true,1114043938,28,1119403935,5359997
1668035135,206164,true,1113932545,28,1119292006,5359461
1668035159,206163,true,1114043938,28,1119068181,5024243
1668035171,206164,true,1113932545,28,1118956285,5023740
1668035219,206166,true,1113709792,28,1118396975,4687183
1668035231,206168,true,1113487084,28,1118285147,4798063
1668035243,206169,true,1113375746,28,1118061523,4685777
1668035267,206171,true,1113153104,28,1117614410,4461306
1668035291,206175,true,1112707954,28,1117167476,4459522
1668035303,206177,true,1112485446,28,1117055771,4570325
1668035327,206177,true,1112485446,28,1116609060,4123614
1668035339,206179,true,1112262982,28,1116497410,4234428
1668035363,206181,true,1112040563,28,1116162528,4121965
1668035375,206181,true,1112040563,28,1116050923,4010360
1668035387,206181,true,1112040563,28,1115827746,3787183
1668035399,206181,true,1112040563,28,1115827746,3787183
1668035459,206179,true,1112262982,28,1115493065,3230083
1668035495,206179,true,1112262982,28,1115381527,3118545
1668035507,206178,true,1112374209,28,1115270000,2895791
1668035519,206178,true,1112374209,28,1115270000,2895791
1668035543,206177,true,1112485446,28,1115158484,2673038
1668035555,206177,true,1112485446,28,1115046979,2561533
1668035567,206176,true,1112596695,28,1115046979,2450284
1668035603,206177,true,1112485446,28,1114712532,2227086
1668035615,206176,true,1112596695,28,1114601072,2004377
1668035627,206177,true,1112485446,28,1114489623,2004177
1668035651,206176,true,1112596695,28,1114266758,1670063
1668035723,206177,true,1112485446,28,1113598432,1112986
1668035771,206177,true,1112485446,28,1113153104,667658
1668035795,206177,true,1112485446,28,1112930507,445061
1668035843,206176,true,1112596695,28,1112485446,-111249
1668035891,206177,true,1112485446,28,1112040563,-444883
1668035903,206177,true,1112485446,28,1111929370,-556076
1668035927,206178,true,1112374209,28,1111707018,-667191
1668035939,206177,true,1112485446,28,1111595858,-889588
1668035951,206179,true,1112262982,28,1111484710,-778272
1668036071,206179,true,1112262982,28,1110262810,-2000172
1668036095,206180,true,1112151767,28,1110040790,-2110977
1668036107,206179,true,1112262982,28,1109929797,-2333185
1668036119,206181,true,1112040563,28,1109707845,-2332718
1668036143,206182,true,1111929370,28,1109485936,-2443434
1668036155,206183,true,1111818188,28,1109264073,-2554115
1668036191,206183,true,1111818188,28,1108709607,-3108581
1668036239,206185,true,1111595858,28,1107933821,-3662037
1668036251,206186,true,1111484710,28,1107712267,-3772443
1668036263,206187,true,1111373572,28,1107490758,-3882814
1668036299,206188,true,1111262446,28,1106715824,-4546622
1668036311,206191,true,1110929134,28,1106383876,-4545258
1668036335,206194,true,1110595922,28,1105941433,-4654489
1668036371,206197,true,1110262810,28,1105167584,-5095226
1668036395,206197,true,1110262810,28,1104725627,-5537183
1668036407,206201,true,1109818816,28,1104504715,-5314101
1668036419,206204,true,1109485936,28,1104283847,-5202089
1668036491,206206,true,1109264073,28,1102739009,-6525064
1668036563,206208,true,1109042253,28,1101196331,-7845922
1668036575,206212,true,1108598747,28,1100866038,-7732709
1668036587,206214,true,1108377061,28,1100645898,-7731163
1668036599,206217,true,1108044614,28,1100425802,-7618812
1668036623,206218,true,1107933821,28,1099985742,-7948079
1668036695,206222,true,1107490758,28,1098666617,-8824141
1668036707,206224,true,1107269293,28,1098556761,-8712532
1668036743,206227,true,1106937178,28,1098007647,-8929531
1668036923,206230,true,1106605164,28,1095594806,-11010358
1668036935,206234,true,1106162632,28,1095485258,-10677374
1668036959,206237,true,1105830850,28,1095266193,-10564657
1668036971,206240,true,1105499167,28,1095156678,-10342489
1668036983,206243,true,1105167584,28,1095047173,-10120411
1668036995,206247,true,1104725627,28,1094937679,-9787948
1668037019,206251,true,1104283847,28,1094718725,-9565122
1668037043,206254,true,1103952628,28,1094499814,-9452814
1668037079,206258,true,1103511158,28,1094171529,-9339629
1668037103,206261,true,1103180170,28,1093952728,-9227442
1668037115,206264,true,1102849283,28,1093843344,-9005939
1668037127,206268,true,1102408253,28,1093733970,-8674283
1668037151,206272,true,1101967400,28,1093515256,-8452144
1668037271,206274,true,1101747040,28,1091767118,-9979922
1668037283,206277,true,1101416582,28,1091548797,-9867785
1668037295,206281,true,1100976125,28,1091439653,-9536472
1668037379,206283,true,1100755963,28,1090457849,-10298114
1668037391,206284,true,1100645898,28,1090348814,-10297084
1668037427,206288,true,1100205750,28,1090021775,-10183975
1668037451,206291,true,1099875754,28,1089803803,-10071951
1668037475,206294,true,1099545857,28,1089585875,-9959982
1668037547,206295,true,1099435914,28,1088932352,-10503562
1668037571,206298,true,1099106149,28,1088714598,-10391551
1668037583,206301,true,1098776483,28,1088605738,-10170745
1668037607,206303,true,1098556761,28,1088496888,-10059873
1668037727,206302,true,1098666617,28,1087952803,-10713814
1668037739,206305,true,1098337082,28,1087952803,-10384279
1668037751,206307,true,1098117448,28,1087952803,-10164645
1668037763,206309,true,1097897857,28,1087952803,-9945054
1668037835,206309,true,1097897857,28,1087844018,-10053839
1668037919,206311,true,1097678311,28,1087952803,-9725508
1668037967,206314,true,1097349073,28,1088170404,-9178669
1668038027,206316,true,1097129636,28,1088388049,-8741587
1668038063,206316,true,1097129636,28,1088496888,-8632748
1668038099,206319,true,1096800563,28,1088823470,-7977093
1668038183,206322,true,1096471589,28,1089259064,-7212525
1668038195,206323,true,1096361953,28,1089367990,-6993963
1668038207,206323,true,1096361953,28,1089367990,-6993963
1668038219,206326,true,1096033110,28,1089476927,-6556183
1668038231,206328,true,1095813936,28,1089585875,-6228061
1668038267,206329,true,1095704366,28,1089912783,-5791583
1668038315,206329,true,1095704366,28,1090457849,-5246517
1668038327,206331,true,1095485258,28,1090566894,-4918364
1668038351,206333,true,1095266193,28,1090894097,-4372096
1668038375,206333,true,1095266193,28,1091112287,-4153906
1668038387,206332,true,1095375720,28,1091221398,-4154322
1668038483,206335,true,1095047173,28,1091985482,-3061691
1668038543,206337,true,1094828196,28,1092422342,-2405854
1668038567,206337,true,1094828196,28,1092531584,-2296612
1668038579,206336,true,1094937679,28,1092640837,-2296842
1668038615,206338,true,1094718725,28,1092750102,-1968623
1668038627,206340,true,1094499814,28,1092750102,-1749712
1668038651,206341,true,1094390375,28,1092859377,-1530998
1668038675,206339,true,1094609264,28,1092968663,-1640601
1668038723,206341,true,1094390375,28,1093077959,-1312416
1668038735,206342,true,1094280947,28,1093187267,-1093680
1668038747,206343,true,1094171529,28,1093296586,-874943
1668038795,206340,true,1094499814,28,1093515256,-984558
1668038831,206340,true,1094499814,28,1093843344,-656470
1668038843,206341,true,1094390375,28,1093952728,-437647
1668038867,206341,true,1094390375,28,1094280947,-109428
1668038903,206339,true,1094609264,28,1094609264,0
1668038915,206340,true,1094499814,28,1094828196,328382
1668039035,206342,true,1094280947,28,1095813936,1532989
1668039119,206342,true,1094280947,28,1096471589,2190642
1668039131,206340,true,1094499814,28,1096581236,2081422
1668039143,206343,true,1094171529,28,1096690894,2519365
1668039155,206345,true,1093952728,28,1096800563,2847835
1668039167,206345,true,1093952728,28,1096910243,2957515
1668039179,206343,true,1094171529,28,1097019934,2848405
1668039203,206344,true,1094062123,28,1097349073,3286950
1668039215,206345,true,1093952728,28,1097568554,3615826
1668039227,206344,true,1094062123,28,1097678311,3616188
1668039239,206340,true,1094499814,28,1097897857,3398043
1668039299,206341,true,1094390375,28,1098886361,4495986
1668039311,206341,true,1094390375,28,1098996249,4605874
1668039323,206340,true,1094499814,28,1099216060,4716246
1668039347,206336,true,1094937679,28,1099545857,4608178
1668039359,206337,true,1094828196,28,1099765778,4937582
1668039371,206338,true,1094718725,28,1099875754,5157029
1668039395,206337,true,1094828196,28,1100095740,5267544
1668039443,206334,true,1095156678,28,1100535845,5379167
1668039479,206335,true,1095047173,28,1100866038,5818865
1668039491,206335,true,1095047173,28,1100976125,5928952
1668039551,206334,true,1095156678,28,1101526723,6370045
1668039611,206330,true,1095594806,28,1102077597,6482791
1668039647,206330,true,1095594806,28,1102408253,6813447
1668039659,206330,true,1095594806,28,1102518494,6923688
1668039671,206329,true,1095704366,28,1102628746,6924380
1668039731,206324,true,1096252327,28,1103180170,6927843
1668039863,206323,true,1096361953,28,1104725627,8363674
1668039875,206323,true,1096361953,28,1104836100,8474147
1668039887,206321,true,1096581236,28,1105057078,8475842
1668039995,206315,true,1097239349,28,1106715824,9476475
1668040031,206312,true,1097568554,28,1107380020,9811466
1668040055,206311,true,1097678311,28,1107712267,10033956
1668040079,206308,true,1098007647,28,1108044614,10036967
1668040091,206301,true,1098776483,28,1108155418,9378935
1668040151,206298,true,1099106149,28,1108931360,9825211
1668040163,206297,true,1099216060,28,1109153157,9937097
1668040175,206295,true,1099435914,28,1109374999,9939085
1668040223,206287,true,1100315771,28,1110262810,9947039
1668040247,206283,true,1100755963,28,1110818052,10062089
1668040271,206281,true,1100976125,28,1111262446,10286321
1668040283,206278,true,1101306451,28,1111484710,10178259
1668040343,206271,true,1102077597,28,1112485446,10407849
1668040367,206267,true,1102518494,28,1112930507,10412013
1668040511,206267,true,1102518494,28,1115716175,13197681
1668040523,206264,true,1102849283,28,1115939329,13090046
1668040547,206257,true,1103621509,28,1116385772,12764263
1668040559,206254,true,1103952628,28,1116609060,12656432
1668040631,206253,true,1104063024,28,1117949728,13886704
1668040643,206250,true,1104394276,28,1118173329,13779053
1668040655,206243,true,1105167584,28,1118396975,13229391
1668040691,206240,true,1105499167,28,1119068181,13569014
1668040703,206238,true,1105720278,28,1119292006,13571728
1668040919,206235,true,1106052027,28,1122991585,16939558
1668040979,206228,true,1106826496,28,1123777915,16951419
1668041015,206224,true,1107269293,28,1124002682,16733389
1668041303,206223,true,1107380020,28,1125577309,18197289
1668041339,206220,true,1107712267,28,1125915016,18202749
1668041351,206213,true,1108487898,28,1126027608,17539710
1668041423,206208,true,1109042253,28,1126703393,17661140
1668041483,206205,true,1109374999,28,1127154142,17779143
1668041603,206202,true,1109707845,28,1128168987,18461142
1668041675,206196,true,1110373836,28,1128846057,18472221
1668041699,206192,true,1110818052,28,1128958942,18140890
1668041759,206189,true,1111151331,28,1129410593,18259262
1668041771,206186,true,1111484710,28,1129523534,18038824
1668041975,206181,true,1112040563,28,1130879708,18839145
1668042011,206176,true,1112596695,28,1130992796,18396101
1668042047,206174,true,1112819225,28,1131105896,18286671
1668042059,206171,true,1113153104,28,1131219006,18065902
1668042071,206165,true,1113821163,28,1131219006,17397843
1668042083,206160,true,1114378185,28,1131332128,16953943
1668042107,206157,true,1114712532,28,1131558406,16845874
1668042119,206154,true,1115046979,28,1131671562,16624583
1668042179,206149,true,1115604614,28,1132463969,16859355
1668042191,206144,true,1116162528,28,1132577216,16414688
1668042287,206140,true,1116609060,28,1134163855,17554795
1668042311,206136,true,1117055771,28,1134617589,17561818
1668042359,206130,true,1117726172,28,1135412059,17685887
1668042371,206126,true,1118173329,28,1135525600,17352271
1668042407,206121,true,1118732528,28,1136093477,17360949
1668042431,206118,true,1119068181,28,1136434339,17366158
1668042479,206112,true,1119739790,28,1137116370,17376580
1668042515,206108,true,1120187753,28,1137571285,17383532
1668042527,206103,true,1120747959,28,1137685042,16937083
1668042599,206100,true,1121084217,28,1138481660,17397443
1668042695,206094,true,1121757036,28,1139620655,17863619
1668042839,206090,true,1122205806,28,1141331283,19125477
1668042971,206086,true,1122654755,28,1143158783,20504028
1668042995,206083,true,1122991585,28,1143387426,20395841
1668043007,206078,true,1123553194,28,1143616115,20062921
1668043019,206074,true,1124002682,28,1143730477,19727795
1668043043,206070,true,1124452351,28,1144073630,19621279
1668043055,206068,true,1124677252,28,1144188037,19510785
1668043067,206063,true,1125239704,28,1144302456,19062752
1668043127,206059,true,1125689867,28,1144874722,19184855
1668043295,206056,true,1126027608,28,1146020112,19992504
1668043331,206054,true,1126252825,28,1146249327,19996502
1668043355,206049,true,1126816064,28,1146363952,19547888
1668043643,206044,true,1127379584,28,1147510832,20131248
1668043655,206040,true,1127830604,28,1147510832,19680228
1668043691,206037,true,1128168987,28,1147625583,19456596
1668043763,206033,true,1128620322,28,1147740346,19120024
1668043919,206029,true,1129071838,28,1147396093,18324255
1668043931,206025,true,1129523534,28,1147281365,17757831
1668043955,206022,true,1129862425,28,1147166648,17304223
1668043991,206018,true,1130314438,28,1147051943,16737505
1668044027,206013,true,1130879708,28,1146707896,15828188
1668044051,206010,true,1131219006,28,1146593237,15374231
1668044123,206008,true,1131445261,28,1145905521,14460260
1668044147,206003,true,1132011097,28,1145676375,13665278
1668044159,205999,true,1132463969,28,1145561819,13097850
1668044267,205996,true,1132803743,28,1144760246,11956503
1668044279,205994,true,1133030315,28,1144645781,11615466
1668044351,205990,true,1133483595,28,1144416887,10933292
1668044399,205986,true,1133937056,28,1144188037,10250981
1668044411,205983,true,1134277271,28,1144188037,9910766
1668044435,205982,true,1134390699,28,1144073630,9682931
1668044447,205978,true,1134844524,28,1143959234,9114710
1668044459,205976,true,1135071504,28,1143844850,8773346
1668044543,205975,true,1135185011,28,1143158783,7973772
1668044579,205975,true,1135185011,28,1142930185,7745174
1668044591,205972,true,1135525600,28,1142815904,7290304
1668044615,205971,true,1135639153,28,1142701634,7062481
1668044651,205969,true,1135866292,28,1142473128,6606836
1668044699,205969,true,1135866292,28,1142130454,6264162
1668044735,205966,true,1136207086,28,1141902062,5694976
1668044759,205964,true,1136434339,28,1141787884,5353545
1668044795,205962,true,1136661637,28,1141559560,4897923
1668044915,205962,true,1136661637,28,1141103051,4441414
1668044999,205959,true,1137002670,28,1140874864,3872194
1668045011,205957,true,1137230082,28,1140874864,3644782
1668045035,205955,true,1137457539,28,1140760788,3303249
1668045047,205954,true,1137571285,28,1140760788,3189503
1668045071,205951,true,1137912590,28,1140646724,2734134
1668045083,205949,true,1138140184,28,1140646724,2506540
1668045323,205948,true,1138253998,28,1139392765,1138767
1668045371,205948,true,1138253998,28,1139164920,910922
1668045599,205945,true,1138595509,28,1138253998,-341511
1668045611,205944,true,1138709368,28,1138253998,-455370
1668045707,205943,true,1138823239,28,1138026382,-796857
1668045827,205943,true,1138823239,28,1137457539,-1365700
1668045839,205941,true,1139051015,28,1137457539,-1593476
1668045851,205941,true,1139051015,28,1137343805,-1707210
1668045863,205940,true,1139164920,28,1137343805,-1821115
1668045875,205940,true,1139164920,28,1137230082,-1934838
1668045959,205939,true,1139278837,28,1136888981,-2389856
1668046031,205939,true,1139278837,28,1136320707,-2958130
1668046163,205939,true,1139278837,28,1135298529,-3980308
1668046355,205940,true,1139164920,28,1134277271,-4887649
1668046379,205939,true,1139278837,28,1134163855,-5114982
1668046595,205940,true,1139164920,28,1133370258,-5794662
1668046607,205940,true,1139164920,28,1133256932,-5907988
1668046703,205940,true,1139164920,28,1132917023,-6247897
1668046739,205939,true,1139278837,28,1132803743,-6475094
1668046751,205940,true,1139164920,28,1132803743,-6361177
1668046763,205938,true,1139392765,28,1132690474,-6702291
1668046775,205938,true,1139392765,28,1132690474,-6702291
1668047003,205936,true,1139620655,28,1132690474,-6930181
1668047027,205937,true,1139506704,28,1132690474,-6816230
1668047039,205936,true,1139620655,28,1132803743,-6816912
1668047243,205935,true,1139734617,28,1133143618,-6590999
1668047255,205933,true,1139962575,28,1133143618,-6818957
1668047387,205934,true,1139848590,28,1133370258,-6478332
1668047423,205933,true,1139962575,28,1133483595,-6478980
1668047627,205933,true,1139962575,28,1133823674,-6138901
1668047639,205931,true,1140190579,28,1133823674,-6366905
1668047795,205931,true,1140190579,28,1134504138,-5686441
1668047807,205930,true,1140304598,28,1134617589,-5687009
1668048047,205929,true,1140418628,28,1135866292,-4552336
1668048095,205927,true,1140646724,28,1136093477,-4553247
1668048107,205928,true,1140532670,28,1136207086,-4325584
1668048131,205928,true,1140532670,28,1136320707,-4211963
1668048179,205927,true,1140646724,28,1136661637,-3985087
1668048287,205925,true,1140874864,28,1137116370,-3758494
1668048347,205925,true,1140874864,28,1137457539,-3417325
1668048539,205926,true,1140760788,28,1138253998,-2506790
1668048551,205925,true,1140874864,28,1138253998,-2620866
1668048563,205924,true,1140988952,28,1138367824,-2621128
1668048587,205925,true,1140874864,28,1138367824,-2507040
1668048623,205926,true,1140760788,28,1138367824,-2392964
1668048671,205925,true,1140874864,28,1138481660,-2393204
1668048707,205925,true,1140874864,28,1138481660,-2393204
1668048779,205926,true,1140760788,28,1138595509,-2165279
1668048887,205927,true,1140646724,28,1138709368,-1937356
1668048947,205928,true,1140532670,28,1138709368,-1823302
1668049079,205929,true,1140418628,28,1138709368,-1709260
1668049139,205930,true,1140304598,28,1138709368,-1595230
1668049151,205932,true,1140076571,28,1138823239,-1253332
1668049175,205933,true,1139962575,28,1138823239,-1139336
1668049199,205934,true,1139848590,28,1138823239,-1025351
1668049211,205935,true,1139734617,28,1138937121,-797496
1668049223,205937,true,1139506704,28,1138937121,-569583
1668049331,205937,true,1139506704,28,1139392765,-113939
1668049343,205937,true,1139506704,28,1139506704,0
1668049355,205937,true,1139506704,28,1139506704,0
1668049367,205939,true,1139278837,28,1139620655,341818
1668049379,205937,true,1139506704,28,1139734617,227913
1668049391,205937,true,1139506704,28,1139848590,341886
1668049679,205936,true,1139620655,28,1142473128,2852473
1668049691,205938,true,1139392765,28,1142587375,3194610
1668049715,205936,true,1139620655,28,1142815904,3195249
1668049727,205936,true,1139620655,28,1142930185,3309530
1668049739,205933,true,1139962575,28,1143158783,3196208
1668049751,205935,true,1139734617,28,1143273099,3538482
1668049787,205931,true,1140190579,28,1143844850,3654271
1668049799,205929,true,1140418628,28,1144073630,3655002
1668049811,205926,true,1140760788,28,1144302456,3541668
1668049847,205926,true,1140760788,28,1144989209,4228421
1668049859,205922,true,1141217161,28,1145218219,4001058
1668049871,205921,true,1141331283,28,1145332741,4001458
1668049895,205918,true,1141673716,28,1145790942,4117226
1668049907,205919,true,1141559560,28,1145905521,4345961
1668049943,205916,true,1141902062,28,1146249327,4347265
1668050099,205915,true,1142016253,28,1147969906,5953653
1668050123,205912,true,1142358892,28,1148199511,5840619
1668050147,205913,true,1142244667,28,1148429162,6184495
1668050183,205910,true,1142587375,28,1148888603,6301228
1668050195,205909,true,1142701634,28,1149003492,6301858
1668050267,205905,true,1143158783,28,1149923016,6764233
1668050291,205906,true,1143044478,28,1150383055,7338577
1668050315,205902,true,1143501765,28,1150728204,7226439
1668050351,205901,true,1143616115,28,1151303683,7687568
1668050375,205897,true,1144073630,28,1151649109,7575479
1668050447,205898,true,1143959234,28,1152801276,8842042
1668050471,205894,true,1144416887,28,1153147151,8730264
1668050483,205894,true,1144416887,28,1153377792,8960905
1668050495,205889,true,1144989209,28,1153493130,8503921
1668050507,205891,true,1144760246,28,1153723840,8963594
1668050519,205886,true,1145332741,28,1153954597,8621856
1668050555,205885,true,1145447274,28,1154647142,9199868
1668050675,205880,true,1146020112,28,1156842948,10822836
1668050747,205880,true,1146020112,28,1158231923,12211811
1668050963,205875,true,1146593237,28,1162176416,15583179
1668050999,205874,true,1146707896,28,1162757620,16049724
1668051011,205869,true,1147281365,28,1162873896,15592531
1668051035,205870,true,1147166648,28,1163222793,16056145
1668051047,205866,true,1147625583,28,1163455449,15829866
1668051563,205866,true,1147625583,28,1166950882,19325299
1668051623,205861,true,1148199511,28,1166717526,18518015
1668051647,205862,true,1148084703,28,1166717526,18632823
1668051659,205858,true,1148544005,28,1166717526,18173521
1668051719,205857,true,1148658860,28,1166834198,18175338
1668051755,205852,true,1149233304,28,1167184283,17950979
1668051791,205852,true,1149233304,28,1167417732,18184428
1668051803,205848,true,1149693066,28,1167534474,17841408
1668051899,205845,true,1150038009,28,1168351993,18313984
1668051923,205840,true,1150613143,28,1168585675,17972532
1668052127,205839,true,1150728204,28,1169988750,19260546
1668052139,205835,true,1151188564,28,1169988750,18800186
1668052151,205832,true,1151533956,28,1170105748,18571792
1668052163,205827,true,1152109838,28,1170105748,17995910
1668052175,205825,true,1152340271,28,1170222759,17882488
1668052187,205821,true,1152801276,28,1170339781,17538505
1668052199,205819,true,1153031848,28,1170339781,17307933
1668052211,205813,true,1153723840,28,1170456815,16732975
1668052247,205812,true,1153839213,28,1170690918,16851705
1668052259,205808,true,1154300818,28,1170690918,16390100
1668052295,205806,true,1154531689,28,1170807987,16276298
1668052439,205800,true,1155224581,28,1171042161,15817580
1668052463,205798,true,1155455638,28,1171042161,15586523
1668052523,205794,true,1155917890,28,1171042161,15124271
1668052571,205792,true,1156149085,28,1171042161,14893076
1668052595,205787,true,1156727275,28,1171042161,14314886
1668052739,205786,true,1156842948,28,1170925068,14082120
1668052751,205782,true,1157305754,28,1170925068,13619314
1668052763,205780,true,1157537227,28,1170925068,13387841
1668052787,205776,true,1158000311,28,1170925068,12924757
1668052871,205775,true,1158116111,28,1170807987,12691876
1668052907,205772,true,1158463581,28,1170807987,12344406
1668052943,205770,true,1158695285,28,1170925068,12229783
1668053027,205766,true,1159158833,28,1171042161,11883328
1668053063,205765,true,1159274749,28,1171042161,11767412
1668053783,205763,true,1159506615,28,1169871762,10365147
1668053807,205761,true,1159738528,28,1169754787,10016259
1668053843,205757,true,1160202493,28,1169637823,9435330
1668053855,205756,true,1160318513,28,1169637823,9319310
1668053867,205753,true,1160666644,28,1169520871,8854227
1668053891,205751,true,1160898789,28,1169520871,8622082
1668053903,205746,true,1161479354,28,1169403931,7924577
1668053927,205746,true,1161479354,28,1169403931,7924577
1668053939,205743,true,1161827833,28,1169287002,7459169
1668054059,205741,true,1162060210,28,1169053180,6992970
1668054299,205736,true,1162641356,28,1169170085,6528729
1668054455,205735,true,1162757620,28,1169520871,6763251
1668054467,205732,true,1163106483,28,1169637823,6531340
1668054479,205730,true,1163339116,28,1169637823,6298707
1668054491,205725,true,1163920901,28,1169637823,5716922
1668054503,205725,true,1163920901,28,1169637823,5716922
1668054515,205723,true,1164153697,28,1169637823,5484126
1668054539,205721,true,1164386540,28,1169637823,5251283
1668054551,205716,true,1164968849,28,1169637823,4668974
1668054563,205716,true,1164968849,28,1169637823,4668974
1668054587,205714,true,1165201855,28,1169520871,4319016
1668054683,205713,true,1165318375,28,1169403931,4085556
1668054719,205708,true,1165901151,28,1169403931,3502780
1668054731,205708,true,1165901151,28,1169287002,3385851
1668054743,205706,true,1166134343,28,1169287002,3152659
1668054755,205705,true,1166250956,28,1169170085,2919129
1668054779,205701,true,1166717526,28,1169053180,2335654
1668054839,205701,true,1166717526,28,1168819404,2101878
1668054947,205699,true,1166950882,28,1168468828,1517946
1668054983,205698,true,1167067577,28,1168351993,1284416
1668055007,205694,true,1167534474,28,1168235170,700696
1668055103,205695,true,1167417732,28,1168118358,700626
1668055199,205693,true,1167651227,28,1167884769,233542
1668055319,205693,true,1167651227,28,1167534474,-116753
1668055343,205689,true,1168118358,28,1167534474,-583884
1668055439,205689,true,1168118358,28,1167301002,-817356
1668055463,205689,true,1168118358,28,1167301002,-817356
1668055583,205689,true,1168118358,28,1166950882,-1167476
1668055667,205687,true,1168351993,28,1166717526,-1634467
1668055847,205687,true,1168351993,28,1165901151,-2450842
1668055871,205686,true,1168468828,28,1165784572,-2684256
1668055919,205686,true,1168468828,28,1165551450,-2917378
1668056063,205685,true,1168585675,28,1164852364,-3733311
1668056087,205685,true,1168585675,28,1164735891,-3849784
1668056219,205686,true,1168468828,28,1164270113,-4198715
1668056231,205687,true,1168351993,28,1164153697,-4198296
1668056267,205686,true,1168468828,28,1164037294,-4431534
1668056279,205686,true,1168468828,28,1164037294,-4431534
1668056459,205687,true,1168351993,28,1164270113,-4081880
1668056471,205687,true,1168351993,28,1164270113,-4081880
1668056483,205685,true,1168585675,28,1164386540,-4199135
1668056495,205685,true,1168585675,28,1164386540,-4199135
1668056543,205683,true,1168819404,28,1164735891,-4083513
1668056555,205683,true,1168819404,28,1164852364,-3967040
1668056567,205680,true,1169170085,28,1164968849,-4201236
1668056603,205679,true,1169287002,28,1165551450,-3735552
1668056723,205676,true,1169637823,28,1167301002,-2336821
1668056771,205675,true,1169754787,28,1168001558,-1753229
1668056795,205673,true,1169988750,28,1168351993,-1636757
1668056903,205672,true,1170105748,28,1169988750,-116998
1668056915,205668,true,1170573861,28,1170105748,-468113
1668056927,205668,true,1170573861,28,1170339781,-234080
1668057047,205667,true,1170690918,28,1171979322,1288404
1668057107,205665,true,1170925068,28,1172799954,1874886
1668057167,205662,true,1171276381,28,1173621160,2344779
1668057335,205661,true,1171393508,28,1175970634,4577126
1668057359,205660,true,1171510648,28,1176323460,4812812
1668057395,205659,true,1171627799,28,1176794060,5166261
1668057455,205656,true,1171979322,28,1177618063,5638741
1668057467,205656,true,1171979322,28,1177735825,5756503
1668057479,205655,true,1172096520,28,1177853599,5757079
1668057491,205655,true,1172096520,28,1178089181,5992661
1668057527,205652,true,1172448184,28,1178442643,5994459
1668057539,205652,true,1172448184,28,1178560488,6112304
1668057551,205651,true,1172565429,28,1178678344,6112915
1668057563,205651,true,1172565429,28,1178796211,6230782
1668057623,205648,true,1172917234,28,1179385727,6468493
1668057683,205647,true,1173034526,28,1179975538,6941012
1668057755,205647,true,1173034526,28,1180565644,7531118
1668057803,205646,true,1173151829,28,1180919849,7768020
1668057815,205644,true,1173386471,28,1181037941,7651470
1668057923,205644,true,1173386471,28,1181746741,8360270
1668057947,205644,true,1173386471,28,1181864916,8478445
1668058019,205644,true,1173386471,28,1182219511,8833040
1668058055,205642,true,1173621160,28,1182455966,8834806
1668058091,205643,true,1173503810,28,1182574212,9070402
1668058103,205644,true,1173386471,28,1182574212,9187741
1668058115,205644,true,1173386471,28,1182692469,9305998
1668058163,205642,true,1173621160,28,1182929020,9307860
1668058175,205643,true,1173503810,28,1182929020,9425210
1668058187,205643,true,1173503810,28,1183047313,9543503
1668058259,205644,true,1173386471,28,1183520603,10134132
1668058367,205642,true,1173621160,28,1183757319,10136159
1668058403,205642,true,1173621160,28,1183638955,10017795
1668058427,205643,true,1173503810,28,1183520603,10016793
1668058451,205643,true,1173503810,28,1183402262,9898452
1668058463,205640,true,1173855896,28,1183402262,9546366
1668058559,205640,true,1173855896,28,1183165617,9309721
1668058655,205640,true,1173855896,28,1182692469,8836573
1668058667,205640,true,1173855896,28,1182692469,8836573
1668058679,205637,true,1174208088,28,1182574212,8366124
1668058715,205638,true,1174090679,28,1182337733,8247054
1668058727,205638,true,1174090679,28,1182337733,8247054
1668058787,205637,true,1174208088,28,1182101301,7893213
1668058907,205634,true,1174560386,28,1181628578,7068192
1668059075,205634,true,1174560386,28,1181156045,6595659
1668059111,205634,true,1174560386,28,1180919849,6359463
1668059123,205633,true,1174677842,28,1180919849,6242007
1668059183,205630,true,1175030281,28,1180683701,5653420
1668059243,205630,true,1175030281,28,1180447599,5417318
1668059303,205630,true,1175030281,28,1180211545,5181264
1668059351,205630,true,1175030281,28,1180093536,5063255
1668059387,205626,true,1175500363,28,1179975538,4475175
1668059411,205627,true,1175382825,28,1179857553,4474728
1668059423,205627,true,1175382825,28,1179857553,4474728
1668059435,205627,true,1175382825,28,1179739579,4356754
1668059495,205623,true,1175853049,28,1179739579,3886530
1668059543,205624,true,1175735475,28,1179739579,4004104
1668059579,205625,true,1175617913,28,1179739579,4121666
1668059603,205624,true,1175735475,28,1179739579,4004104
1668059627,205621,true,1176088231,28,1179739579,3651348
1668059747,205622,true,1175970634,28,1179857553,3886919
1668059783,205623,true,1175853049,28,1179975538,4122489
1668059807,205623,true,1175853049,28,1179975538,4122489
1668059819,205619,true,1176323460,28,1180093536,3770076
1668059867,205620,true,1176205840,28,1180211545,4005705
1668059951,205621,true,1176088231,28,1180329566,4241335
1668059963,205620,true,1176205840,28,1180447599,4241759
1668060239,205616,true,1176676393,28,1180565644,3889251
1668060263,205616,true,1176676393,28,1180565644,3889251
1668060275,205617,true,1176558737,28,1180447599,3888862
1668060299,205616,true,1176676393,28,1180565644,3889251
1668060383,205611,true,1177264849,28,1180683701,3418852
1668060431,205610,true,1177382575,28,1180801769,3419194
1668060443,205611,true,1177264849,28,1180919849,3655000
1668060647,205610,true,1177382575,28,1181274161,3891586
1668060659,205604,true,1178089181,28,1181274161,3184980
1668060719,205604,true,1178089181,28,1181392288,3303107
1668060803,205604,true,1178089181,28,1181392288,3303107
1668060863,205603,true,1178206990,28,1181392288,3185298
1668060887,205598,true,1178796211,28,1181392288,2596077
1668060911,205597,true,1178914091,28,1181392288,2478197
1668060959,205598,true,1178796211,28,1181392288,2596077
1668060971,205597,true,1178914091,28,1181392288,2478197
1668061043,205593,true,1179385727,28,1181392288,2006561
1668061355,205593,true,1179385727,28,1181037941,1652214
1668061379,205593,true,1179385727,28,1181037941,1652214
1668061463,205593,true,1179385727,28,1180683701,1297974
1668061547,205589,true,1179857553,28,1180329566,472013
1668061559,205590,true,1179739579,28,1180211545,471966
1668061571,205590,true,1179739579,28,1180211545,471966
1668061607,205590,true,1179739579,28,1180093536,353957
1668061619,205585,true,1180329566,28,1180093536,-236030
1668061655,205586,true,1180211545,28,1179975538,-236007
1668061667,205586,true,1180211545,28,1179975538,-236007
1668061679,205586,true,1180211545,28,1179975538,-236007
1668061763,205581,true,1180801769,28,1179975538,-826231
1668061895,205582,true,1180683701,28,1179975538,-708163
1668061919,205583,true,1180565644,28,1179857553,-708091
1668062015,205583,true,1180565644,28,1179857553,-708091
1668062051,205578,true,1181156045,28,1179739579,-1416466
1668062075,205579,true,1181037941,28,1179739579,-1298362
1668062231,205580,true,1180919849,28,1178678344,-2241505
1668062279,205581,true,1180801769,28,1178442643,-2359126
1668062291,205578,true,1181156045,28,1178442643,-2713402
1668062303,205579,true,1181037941,28,1178324811,-2713130
1668062315,205581,true,1180801769,28,1178324811,-2476958
1668062327,205582,true,1180683701,28,1178324811,-2358890
1668062363,205580,true,1180919849,28,1178206990,-2712859
1668062375,205581,true,1180801769,28,1178089181,-2712588
1668062423,205583,true,1180565644,28,1177971384,-2594260
1668062447,205584,true,1180447599,28,1177971384,-2476215
1668062459,205583,true,1180565644,28,1177971384,-2594260
1668062483,205584,true,1180447599,28,1177853599,-2594000
1668062543,205585,true,1180329566,28,1177971384,-2358182
1668062555,205586,true,1180211545,28,1177971384,-2240161
1668062579,205584,true,1180447599,28,1177971384,-2476215
1668062603,205586,true,1180211545,28,1177971384,-2240161
1668062759,205587,true,1180093536,28,1177971384,-2122152
1668062879,205588,true,1179975538,28,1178089181,-1886357
1668062987,205587,true,1180093536,28,1178089181,-2004355
1668063323,205589,true,1179857553,28,1178089181,-1768372
1668063335,205590,true,1179739579,28,1178089181,-1650398
1668063359,205592,true,1179503666,28,1178089181,-1414485
1668063371,205590,true,1179739579,28,1178089181,-1650398
1668063587,205592,true,1179503666,28,1177382575,-2121091
1668063611,205594,true,1179267801,28,1177264849,-2002952
1668063647,205595,true,1179149886,28,1177029431,-2120455
1668063779,205593,true,1179385727,28,1176323460,-3062267
1668063791,205596,true,1179031983,28,1176323460,-2708523
1668063803,205597,true,1178914091,28,1176205840,-2708251
1668063863,205598,true,1178796211,28,1176088231,-2707980
1668063875,205595,true,1179149886,28,1176088231,-3061655
1668063923,205598,true,1178796211,28,1175970634,-2825577
1668063947,205599,true,1178678344,28,1175970634,-2707710
1668063971,205599,true,1178678344,28,1175970634,-2707710
1668063995,205597,true,1178914091,28,1175970634,-2943457
1668064079,205598,true,1178796211,28,1175970634,-2825577
1668064187,205599,true,1178678344,28,1175735475,-2942869
1668064235,205600,true,1178560488,28,1175617913,-2942575
1668064247,205597,true,1178914091,28,1175500363,-3413728
1668064295,205599,true,1178678344,28,1175265298,-3413046
1668064499,205601,true,1178442643,28,1174208088,-4234555
1668064535,205602,true,1178324811,28,1174090679,-4234132
1668064571,205600,true,1178560488,28,1173973282,-4587206
1668064679,205601,true,1178442643,28,1173621160,-4821483
1668064775,205602,true,1178324811,28,1173503810,-4821001
1668064883,205603,true,1178206990,28,1173621160,-4585830
1668064967,205601,true,1178442643,28,1173738522,-4704121
1668064979,205603,true,1178206990,28,1173738522,-4468468
1668064991,205604,true,1178089181,28,1173738522,-4350659
1668065003,205604,true,1178089181,28,1173738522,-4350659
1668065171,205603,true,1178206990,28,1173973282,-4233708
1668065183,205604,true,1178089181,28,1173973282,-4115899
1668065195,205605,true,1177971384,28,1174090679,-3880705
1668065219,205606,true,1177853599,28,1174090679,-3762920
1668065315,205604,true,1178089181,28,1174325509,-3763672
1668065483,205605,true,1177971384,28,1174912789,-3058595
1668065519,205606,true,1177853599,28,1175030281,-2823318
1668065531,205607,true,1177735825,28,1175147784,-2588041
1668065543,205605,true,1177971384,28,1175147784,-2823600
1668065579,205605,true,1177971384,28,1175382825,-2588559
1668065603,205606,true,1177853599,28,1175617913,-2235686
1668065615,205606,true,1177853599,28,1175617913,-2235686
1668065711,205602,true,1178324811,28,1176676393,-1648418
1668065735,205601,true,1178442643,28,1177029431,-1413212
1668065747,205601,true,1178442643,28,1177147134,-1295509
1668065783,205600,true,1178560488,28,1177618063,-942425
1668065807,205596,true,1179031983,28,1177853599,-1178384
1668065819,205596,true,1179031983,28,1178089181,-942802
1668065891,205596,true,1179031983,28,1178914091,-117892
1668066059,205595,true,1179149886,28,1180801769,1651883
1668066107,205591,true,1179621616,28,1181392288,1770672
1668066131,205592,true,1179503666,28,1181628578,2124912
1668066167,205592,true,1179503666,28,1181983102,2479436
1668066179,205592,true,1179503666,28,1182101301,2597635
1668066191,205589,true,1179857553,28,1182219511,2361958
1668066743,205590,true,1179739579,28,1186008483,6268904
1668066947,205590,true,1179739579,28,1187195025,7455446
1668066995,205590,true,1179739579,28,1187432476,7692897
1668067007,205587,true,1180093536,28,1187432476,7338940
1668067019,205588,true,1179975538,28,1187551219,7575681
1668067031,205589,true,1179857553,28,1187551219,7693666
1668067043,205590,true,1179739579,28,1187551219,7811640
1668067139,205587,true,1180093536,28,1187788741,7695205
1668067151,205589,true,1179857553,28,1187907520,8049967
1668067163,205590,true,1179739579,28,1187907520,8167941
1668067499,205590,true,1179739579,28,1188263928,8524349
1668067607,205588,true,1179975538,28,1187551219,7575681
1668067631,205589,true,1179857553,28,1187313745,7456192
1668067763,205590,true,1179739579,28,1186364321,6624742
1668067775,205590,true,1179739579,28,1186245696,6506117
1668068015,205588,true,1179975538,28,1184823126,4847588
1668068087,205589,true,1179857553,28,1184586197,4728644
1668068099,205590,true,1179739579,28,1184467751,4728172
1668068399,205590,true,1179739579,28,1183283934,3544355
1668068423,205588,true,1179975538,28,1183165617,3190079
1668068435,205588,true,1179975538,28,1183165617,3190079
1668068447,205589,true,1179857553,28,1183047313,3189760
1668068507,205589,true,1179857553,28,1182692469,2834916
1668068687,205587,true,1180093536,28,1181746741,1653205
1668068723,205587,true,1180093536,28,1181510427,1416891
1668068879,205588,true,1179975538,28,1180801769,826231
1668068927,205588,true,1179975538,28,1180683701,708163
1668069011,205587,true,1180093536,28,1180329566,236030
1668069047,205587,true,1180093536,28,1180211545,118009
1668069371,205588,true,1179975538,28,1179031983,-943555
1668069395,205588,true,1179975538,28,1178914091,-1061447
1668069431,205587,true,1180093536,28,1178914091,-1179445
1668069443,205588,true,1179975538,28,1178914091,-1061447
1668069455,205587,true,1180093536,28,1178914091,-1179445
1668069467,205588,true,1179975538,28,1178914091,-1061447
1668069491,205586,true,1180211545,28,1178914091,-1297454
1668069515,205586,true,1180211545,28,1179031983,-1179562
1668069563,205584,true,1180447599,28,1179149886,-1297713
1668069575,205584,true,1180447599,28,1179149886,-1297713
1668069599,205582,true,1180683701,28,1179267801,-1415900
1668069635,205581,true,1180801769,28,1179503666,-1298103
1668069647,205580,true,1180919849,28,1179621616,-1298233
1668069659,205580,true,1180919849,28,1179621616,-1298233
1668069767,205577,true,1181274161,28,1180447599,-826562
1668069911,205577,true,1181274161,28,1181392288,118127
1668069923,205576,true,1181392288,28,1181392288,0
1668069935,205576,true,1181392288,28,1181510427,118139
1668069959,205574,true,1181628578,28,1181628578,0
1668070115,205574,true,1181628578,28,1182574212,945634
1668070163,205573,true,1181746741,28,1182929020,1182279
1668070223,205574,true,1181628578,28,1183283934,1655356
1668070235,205571,true,1181983102,28,1183402262,1419160
1668070247,205571,true,1181983102,28,1183520603,1537501
1668070271,205569,true,1182219511,28,1183875694,1656183
1668070295,205568,true,1182337733,28,1184230893,1893160
1668070403,205565,true,1182692469,28,1185771317,3078848
1668070439,205563,true,1182929020,28,1186245696,3316676
1668070535,205560,true,1183283934,28,1188026311,4742377
1668070655,205558,true,1183520603,28,1190404622,6884019
1668070727,205554,true,1183994082,28,1191714722,7720640
1668070895,205552,true,1184230893,28,1194817057,10586164
1668070907,205549,true,1184586197,28,1195056032,10469835
1668070943,205547,true,1184823126,28,1195653680,10830554
1668070967,205542,true,1185415656,28,1196132013,10716357
1668070979,205540,true,1185652751,28,1196371251,10718500
1668071003,205537,true,1186008483,28,1196730198,10721715
1668071027,205536,true,1186127084,28,1197089253,10962169
1668071147,205532,true,1186601606,28,1199006033,12404427
1668071207,205530,true,1186838938,28,1199965574,13126636
1668071219,205527,true,1187195025,28,1200205579,13010554
1668071255,205525,true,1187432476,28,1200685733,13253257
1668071327,205521,true,1187907520,28,1201646618,13739098
1668071627,205520,true,1188026311,28,1204654342,16628031
1668071723,205517,true,1188382755,28,1205618403,17235648
1668071759,205515,true,1188620443,28,1205980125,17359682
1668072035,205511,true,1189095962,28,1208756933,19660971
1668072047,205509,true,1189333794,28,1208756933,19423139
1668072059,205506,true,1189690629,28,1208877808,19187179
1668072083,205504,true,1189928579,28,1208998696,19070117
1668072119,205501,true,1190285594,28,1208998696,18713102
1668072131,205499,true,1190523663,28,1208998696,18475033
1668072143,205496,true,1190880856,28,1208998696,18117840
1668072227,205495,true,1190999944,28,1208998696,17998752
1668072239,205492,true,1191357279,28,1208998696,17641417
1668072275,205491,true,1191476415,28,1208877808,17401393
1668072287,205489,true,1191714722,28,1208756933,17042211
1668072299,205488,true,1191833894,28,1208756933,16923039
1668072407,205485,true,1192191480,28,1208031932,15840452
1668072491,205484,true,1192310699,28,1207548840,15238141
1668072623,205482,true,1192549173,28,1206703894,14154721
1668072647,205481,true,1192668428,28,1206583236,13914808
1668072659,205479,true,1192906973,28,1206462589,13555616
1668072671,205478,true,1193026264,28,1206341955,13315691
1668072695,205476,true,1193264881,28,1206100723,12835842
1668072707,205476,true,1193264881,28,1205980125,12715244
1668072719,205474,true,1193503546,28,1205859539,12355993
1668072743,205474,true,1193503546,28,1205618403,12114857
1668072755,205473,true,1193622897,28,1205497854,11874957
1668072779,205474,true,1193503546,28,1205256790,11753244
1668072791,205474,true,1193503546,28,1205136276,11632730
1668072923,205475,true,1193384208,28,1203570695,10186487
1668073079,205475,true,1193384208,28,1201646618,8262410
1668073091,205476,true,1193264881,28,1201406325,8141444
1668073127,205477,true,1193145567,28,1200925883,7780316
1668073247,205479,true,1192906973,28,1199365771,6458798
1668073259,205478,true,1193026264,28,1199245847,6219583
1668073283,205479,true,1192906973,28,1199006033,6099060
1668073295,205479,true,1192906973,28,1198886145,5979172
1668073355,205480,true,1192787695,28,1198167065,5379370
1668073415,205479,true,1192906973,28,1197448416,4541443
1668073499,205480,true,1192787695,28,1196490888,3703193
1668073511,205479,true,1192906973,28,1196371251,3464278
1668073523,205480,true,1192787695,28,1196251626,3463931
1668073547,205479,true,1192906973,28,1196012412,3105439
1668073571,205478,true,1193026264,28,1195773245,2746981
1668073583,205478,true,1193026264,28,1195773245,2746981
1668073631,205478,true,1193026264,28,1195295055,2268791
1668073991,205476,true,1193264881,28,1192668428,-596453
1668074087,205475,true,1193384208,28,1192191480,-1192728
1668074111,205474,true,1193503546,28,1192191480,-1312066
1668074411,205474,true,1193503546,28,1191714722,-1788824
1668074423,205472,true,1193742259,28,1191595563,-2146696
1668074471,205471,true,1193861633,28,1191595563,-2266070
1668074507,205471,true,1193861633,28,1191595563,-2266070
1668074519,205471,true,1193861633,28,1191595563,-2266070
1668074591,205468,true,1194219827,28,1191953077,-2266750
1668074603,205467,true,1194339249,28,1191953077,-2386172
1668075035,205466,true,1194458683,28,1195175538,716855
1668075047,205465,true,1194578129,28,1195175538,597409
1668075095,205463,true,1194817057,28,1195295055,477998
1668075119,205462,true,1194936538,28,1195414585,478047
1668075131,205462,true,1194936538,28,1195414585,478047
1668075167,205462,true,1194936538,28,1195295055,358517
1668075287,205460,true,1195175538,28,1195175538,0
1668075299,205459,true,1195295055,28,1195175538,-119517
1668075467,205460,true,1195175538,28,1194219827,-955711
1668075611,205460,true,1195175538,28,1193264881,-1910657
1668075911,205458,true,1195414585,28,1191476415,-3938170
1668075935,205457,true,1195534126,28,1191357279,-4176847
1668075947,205458,true,1195414585,28,1191238156,-4176429
1668076091,205458,true,1195414585,28,1190285594,-5128991
1668076403,205456,true,1195653680,28,1188382755,-7270925
1668076451,205455,true,1195773245,28,1187907520,-7865725
1668076523,205456,true,1195653680,28,1187313745,-8339935
1668076535,205456,true,1195653680,28,1187195025,-8458655
1668076547,205456,true,1195653680,28,1187076318,-8577362
1668076559,205455,true,1195773245,28,1186957622,-8815623
1668076571,205457,true,1195534126,28,1186720266,-8813860
1668076751,205459,true,1195295055,28,1184349316,-10945739
1668076775,205459,true,1195295055,28,1184112481,-11182574
1668076799,205459,true,1195295055,28,1183757319,-11537736
1668076811,205461,true,1195056032,28,1183638955,-11417077
1668076847,205463,true,1194817057,28,1183165617,-11651440
1668077303,205463,true,1194817057,28,1181037941,-13779116
1668077339,205463,true,1194817057,28,1180919849,-13897208
1668077375,205466,true,1194458683,28,1180801769,-13656914
1668077411,205467,true,1194339249,28,1180683701,-13655548
1668077615,205468,true,1194219827,28,1179739579,-14480248
1668077903,205468,true,1194219827,28,1178324811,-15895016
1668077915,205471,true,1193861633,28,1178206990,-15654643
1668077939,205472,true,1193742259,28,1178089181,-15653078
1668077951,205473,true,1193622897,28,1177971384,-15651513
1668078347,205474,true,1193503546,28,1175382825,-18120721
1668078395,205477,true,1193145567,28,1175382825,-17762742
1668078539,205478,true,1193026264,28,1175265298,-17760966
1668079031,205479,true,1192906973,28,1174912789,-17994184
1668079055,205481,true,1192668428,28,1174795310,-17873118
1668079223,205485,true,1192191480,28,1174442942,-17748538
1668079451,205487,true,1191953077,28,1173855896,-18097181
1668079655,205489,true,1191714722,28,1173269144,-18445578
1668079727,205492,true,1191357279,28,1173151829,-18205450
1668079739,205496,true,1190880856,28,1173151829,-17729027
1668079751,205499,true,1190523663,28,1173151829,-17371834
1668079763,205501,true,1190285594,28,1173151829,-17133765
1668079775,205503,true,1190047572,28,1173151829,-16895743
1668079787,205508,true,1189452727,28,1173151829,-16300898
1668079799,205510,true,1189214872,28,1173151829,-16063043
1668079835,205512,true,1188977065,28,1173269144,-15707921
1668079967,205513,true,1188858179,28,1173386471,-15471708
1668079991,205517,true,1188382755,28,1173503810,-14878945
1668080003,205519,true,1188145114,28,1173503810,-14641304
1668080015,205521,true,1187907520,28,1173503810,-14403710
1668080027,205522,true,1187788741,28,1173621160,-14167581
1668080075,205526,true,1187313745,28,1173738522,-13575223
1668080147,205528,true,1187076318,28,1174090679,-12985639
1668080291,205530,true,1186838938,28,1174560386,-12278552
1668080315,205531,true,1186720266,28,1174677842,-12042424
1668080339,205535,true,1186245696,28,1174795310,-11450386
1668080387,205537,true,1186008483,28,1174912789,-11095694
1668080543,205538,true,1185889894,28,1175500363,-10389531
1668081191,205539,true,1185771317,28,1178914091,-6857226
1668081371,205542,true,1185415656,28,1180093536,-5322120
1668081383,205544,true,1185178609,28,1180211545,-4967064
1668081479,205545,true,1185060103,28,1180801769,-4258334
1668081491,205545,true,1185060103,28,1180919849,-4140254
1668081503,205548,true,1184704656,28,1181037941,-3666715
1668081515,205550,true,1184467751,28,1181037941,-3429810
1668081539,205552,true,1184230893,28,1181156045,-3074848
1668081563,205552,true,1184230893,28,1181274161,-2956732
1668081611,205555,true,1183875694,28,1181274161,-2601533
1668081791,205557,true,1183638955,28,1181274161,-2364794
1668081803,205559,true,1183402262,28,1181274161,-2128101
1668081827,205559,true,1183402262,28,1181392288,-2009974
1668081839,205562,true,1183047313,28,1181392288,-1655025
1668081851,205562,true,1183047313,28,1181510427,-1536886
1668081887,205562,true,1183047313,28,1181628578,-1418735
1668081983,205561,true,1183165617,28,1182219511,-946106
1668081995,205563,true,1182929020,28,1182337733,-591287
1668082031,205562,true,1183047313,28,1182455966,-591347
1668082043,205562,true,1183047313,28,1182574212,-473101
1668082079,205562,true,1183047313,28,1182574212,-473101
1668082091,205564,true,1182810739,28,1182692469,-118270
1668082103,205563,true,1182929020,28,1182692469,-236551
1668082139,205563,true,1182929020,28,1182692469,-236551
1668082235,205563,true,1182929020,28,1182574212,-354808
1668082295,205565,true,1182692469,28,1182574212,-118257
1668082355,205564,true,1182810739,28,1182574212,-236527
1668082463,205564,true,1182810739,28,1182455966,-354773
1668082475,205564,true,1182810739,28,1182455966,-354773
1668082487,205567,true,1182455966,28,1182455966,0
1668082511,205566,true,1182574212,28,1182455966,-118246
1668082523,205566,true,1182574212,28,1182455966,-118246
1668082535,205566,true,1182574212,28,1182455966,-118246
1668082559,205568,true,1182337733,28,1182574212,236479
1668082583,205565,true,1182692469,28,1182810739,118270
1668082631,205564,true,1182810739,28,1183283934,473195
1668082703,205563,true,1182929020,28,1183994082,1065062
1668082763,205565,true,1182692469,28,1184467751,1775282
1668082823,205563,true,1182929020,28,1185060103,2131083
1668082835,205562,true,1183047313,28,1185060103,2012790
1668082847,205562,true,1183047313,28,1185178609,2131296
1668082859,205564,true,1182810739,28,1185297127,2486388
1668082871,205564,true,1182810739,28,1185297127,2486388
1668082895,205564,true,1182810739,28,1185297127,2486388
1668082907,205565,true,1182692469,28,1185297127,2604658
1668082931,205568,true,1182337733,28,1185297127,2959394
1668082943,205568,true,1182337733,28,1185297127,2959394
1668082955,205568,true,1182337733,28,1185297127,2959394
1668082991,205569,true,1182219511,28,1185178609,2959098
1668083111,205573,true,1181746741,28,1185297127,3550386
1668083123,205572,true,1181864916,28,1185297127,3432211
1668083135,205573,true,1181746741,28,1185297127,3550386
1668083183,205573,true,1181746741,28,1185534198,3787457
1668083195,205573,true,1181746741,28,1185534198,3787457
1668083231,205572,true,1181864916,28,1185771317,3906401
1668083375,205571,true,1181983102,28,1186957622,4974520
1668083531,205571,true,1181983102,28,1188382755,6399653
1668083579,205571,true,1181983102,28,1188858179,6875077
1668083603,205570,true,1182101301,28,1188977065,6875764
1668083639,205568,true,1182337733,28,1189214872,6877139
1668083651,205569,true,1182219511,28,1189214872,6995361
1668083663,205568,true,1182337733,28,1189214872,6877139
1668083783,205565,true,1182692469,28,1189928579,7236110
1668083819,205564,true,1182810739,28,1190047572,7236833
1668083843,205564,true,1182810739,28,1190285594,7474855
1668083855,205564,true,1182810739,28,1190285594,7474855
1668083867,205561,true,1183165617,28,1190404622,7239005
1668083879,205560,true,1183283934,28,1190404622,7120688
1668084443,205561,true,1183165617,28,1192668428,9502811
1668084755,205559,true,1183402262,28,1192549173,9146911
1668084767,205556,true,1183757319,28,1192668428,8911109
1668084779,205555,true,1183875694,28,1192668428,8792734
1668084971,205555,true,1183875694,28,1193861633,9985939
1668084995,205553,true,1184112481,28,1193861633,9749152
1668085007,205550,true,1184467751,28,1193981019,9513268
1668085067,205549,true,1184586197,28,1194100417,9514220
1668085103,205549,true,1184586197,28,1194219827,9633630
1668085151,205546,true,1184941609,28,1194458683,9517074
1668085163,205544,true,1185178609,28,1194458683,9280074
1668085175,205542,true,1185415656,28,1194458683,9043027
1668085199,205541,true,1185534198,28,1194578129,9043931
1668085211,205539,true,1185771317,28,1194697587,8926270
1668085355,205537,true,1186008483,28,1195056032,9047549
1668085367,205535,true,1186245696,28,1195175538,8929842
1668085427,205533,true,1186482957,28,1195414585,8931628
1668085499,205531,true,1186720266,28,1195534126,8813860
1668085595,205528,true,1187076318,28,1195653680,8577362
1668085607,205527,true,1187195025,28,1195653680,8458655
1668085643,205526,true,1187313745,28,1195653680,8339935
1668085679,205523,true,1187669974,28,1195773245,8103271
1668085799,205520,true,1188026311,28,1196371251,8344940
1668085907,205518,true,1188263928,28,1196849871,8585943
1668085919,205517,true,1188382755,28,1196969556,8586801
1668085991,205514,true,1188739305,28,1197328683,8589378
1668086039,205511,true,1189095962,28,1197568161,8472199
1668086123,205508,true,1189452727,28,1198167065,8714338
1668086399,205507,true,1189571672,28,1199965574,10393902
1668086411,205505,true,1189809598,28,1199965574,10155976
1668086495,205502,true,1190166577,28,1200445632,10279055
1668086591,205499,true,1190523663,28,1200805802,10282139
1668086795,205500,true,1190404622,28,1201286196,10881574
1668086807,205497,true,1190761779,28,1201286196,10524417
1668086819,205494,true,1191119044,28,1201286196,10167152
1668086831,205492,true,1191357279,28,1201286196,9928917
1668086867,205494,true,1191119044,28,1201286196,10167152
1668086879,205492,true,1191357279,28,1201166080,9808801
1668086903,205490,true,1191595563,28,1201045975,9450412
1668086927,205488,true,1191833894,28,1200925883,9091989
1668086951,205490,true,1191595563,28,1200685733,9090170
1668087011,205489,true,1191714722,28,1200445632,8730910
1668087023,205487,true,1191953077,28,1200445632,8492555
1668087059,205483,true,1192429930,28,1201045975,8616045
1668087071,205483,true,1192429930,28,1201286196,8856266
1668087083,205477,true,1193145567,28,1201526466,8380899
1668087107,205472,true,1193742259,28,1202127349,8385090
1668087119,205466,true,1194458683,28,1202367786,7909103
1668087131,205466,true,1194458683,28,1202608272,8149589
1668087143,205459,true,1195295055,28,1202969091,7674036
1668087179,205455,true,1195773245,28,1203691053,7917808
1668087191,205449,true,1196490888,28,1203931803,7440915
1668087203,205448,true,1196610537,28,1204293018,7682481
1668087215,205441,true,1197448416,28,1204533889,7085473
1668087227,205434,true,1198286882,28,1204895285,6608403
1668087239,205426,true,1199245847,28,1205377316,6131469
1668087251,205424,true,1199485708,28,1205738965,6253257
1668087263,205415,true,1200565677,28,1206221333,5655656
1668087275,205410,true,1201166080,28,1206583236,5417156
1668087287,205402,true,1202127349,28,1207065941,4938592
1668087299,205401,true,1202247562,28,1207548840,5301278
1668087311,205391,true,1203450350,28,1208031932,4581582
1668087323,205386,true,1204052196,28,1208515217,4463021
1668087335,205378,true,1205015775,28,1208998696,3982921
1668087359,205375,true,1205377316,28,1209966234,4588918
1668087371,205365,true,1206583236,28,1210450293,3867057
1668087383,205359,true,1207307367,28,1210934545,3627178
1668087455,205352,true,1208152735,28,1213722761,5570026
1668087479,205349,true,1208515217,28,1214572622,6057405
1668087491,205340,true,1209603316,28,1214937030,5333714
1668087527,205333,true,1210450293,28,1216395756,5945463
1668087611,205326,true,1211297862,28,1219562342,8264480
1668087623,205323,true,1211661288,28,1220050240,8388952
1668087647,205314,true,1212752219,28,1220904531,8152312
1668087671,205308,true,1213480053,28,1221759421,8279368
1668087707,205302,true,1214208323,28,1223104028,8895705
1668087719,205299,true,1214572622,28,1223593343,9020721
1668087755,205290,true,1215666174,28,1224939969,9273795
1668087767,205286,true,1216152514,28,1225307488,9154974
1668087779,205281,true,1216760712,28,1225797685,9036973
1668087791,205279,true,1217004076,28,1226288077,9284001
1668087815,205269,true,1218221628,28,1227269451,9047823
1668087899,205264,true,1218830860,28,1230587390,11756530
1668087947,205258,true,1219562342,28,1232557807,12995465
1668087959,205256,true,1219806266,28,1233050904,13244638
1668087983,205246,true,1221026622,28,1233914299,12887677
1668087995,205240,true,1221759421,28,1234407939,12648518
1668088007,205233,true,1222614909,28,1235025266,12410357
1668088019,205229,true,1223104028,28,1235519350,12415322
1668088031,205218,true,1224450116,28,1236013632,11563516
1668088079,205212,true,1225184970,28,1237992738,12807768
1668088115,205205,true,1226042856,28,1239479146,13436290
1668088127,205201,true,1226533347,28,1239851027,13317680
1668088163,205190,true,1227883209,28,1241463801,13580592
1668088175,205184,true,1228620123,28,1241960461,13340338
1668088199,205176,true,1229603363,28,1242954377,13351014
1668088223,205173,true,1229972281,28,1244073484,14101203
1668088247,205164,true,1231079699,28,1245069091,13989392
1668088307,205157,true,1231941713,28,1247811121,15869408
1668088319,205150,true,1232804331,28,1248435151,15630820
1668088331,205147,true,1233174209,28,1248934600,15760391
1668088343,205137,true,1234407939,28,1249559193,15151254
1668088367,205130,true,1235272283,28,1250684246,15411963
1668088403,205123,true,1236137233,28,1252561586,16424353
1668088427,205119,true,1236631763,28,1253689342,17057579
1668088439,205109,true,1237868951,28,1254316313,16447362
1668088451,205104,true,1238488009,28,1254943596,16455587
1668088463,205096,true,1239479146,28,1255571193,16092047
1668088475,205092,true,1239975012,28,1256199105,16224093
1668088487,205082,true,1241215546,28,1256953012,15737466
1668088523,205074,true,1242208866,28,1259091543,16882677
1668088583,205066,true,1243202981,28,1262369276,19166295
1668088595,205061,true,1243824706,28,1263126887,19302181
1668088643,205051,true,1245069091,28,1265782108,20713017
1668088751,205044,true,1245940901,28,1272126549,26185648
1668088763,205037,true,1246813321,28,1272762740,25949419
1668088775,205032,true,1247436853,28,1273526588,26089735
1668088823,205023,true,1248559995,28,1276203670,27643675
1668088835,205016,true,1249434249,28,1276714228,27279979
1668088859,205009,true,1250309116,28,1277608196,27299080
1668088871,205005,true,1250809314,28,1277991517,27182203
1668088883,204997,true,1251810312,28,1278247128,26436816
1668088895,204991,true,1252561586,28,1278630641,26069055
1668089027,204985,true,1253313311,28,1281702886,28389575
1668089039,204981,true,1253814711,28,1281831056,28016345
1668089051,204972,true,1254943596,28,1281959239,27015643
1668089075,204966,true,1255696751,28,1282215644,26518893
1668089087,204960,true,1256450357,28,1282343865,25893508
1668089099,204957,true,1256827330,28,1282343865,25516535
1668089123,204948,true,1257958927,28,1282343865,24384938
1668089159,204943,true,1258588032,28,1282472100,23884068
1668089243,204938,true,1259217452,28,1282600347,23382895
1668089303,204935,true,1259595255,28,1282985166,23389911
1668089351,204926,true,1260729344,28,1283113464,22384120
1668089363,204921,true,1261359835,28,1283241775,21881940
1668089399,204916,true,1261990641,28,1283370100,21379459
1668089435,204913,true,1262369276,28,1283498437,21129161
1668089495,204904,true,1263505863,28,1283883525,20377662
1668089531,204899,true,1264137742,28,1284140314,20002572
1668089543,204894,true,1264769938,28,1284268728,19498790
1668089567,204891,true,1265149407,28,1284397155,19247748
1668089735,204882,true,1266288497,28,1285039482,18750985
1668089903,204876,true,1267048460,28,1285682130,18633670
1668090011,204871,true,1267682111,28,1285810699,18128588
1668090035,204867,true,1268189260,28,1285810699,17621439
1668090047,204858,true,1269331087,28,1285810699,16479612
1668090095,204852,true,1270092876,28,1285682130,15589254
1668090131,204847,true,1270728049,28,1285553575,14825526
1668090215,204842,true,1271363540,28,1285296503,13932963
1668090227,204833,true,1272508225,28,1285296503,12788278
1668090251,204826,true,1273399248,28,1285167986,11768738
1668090371,204821,true,1274036075,28,1284268728,10232653
1668090383,204815,true,1274800688,28,1284140314,9339626
1668090407,204805,true,1276076063,28,1284011913,7935850
1668090419,204799,true,1276841900,28,1284011913,7170013
1668090467,204795,true,1277352713,28,1283883525,6530812
1668090515,204790,true,1277991517,28,1283883525,5892008
1668090539,204786,true,1278502790,28,1283883525,5380735
1668090563,204782,true,1279014268,28,1283883525,4869257
1668090623,204779,true,1279398011,28,1284011913,4613902
1668090695,204775,true,1279909847,28,1284140314,4230467
1668090707,204770,true,1280549930,28,1284268728,3718798
1668090731,204766,true,1281062227,28,1284397155,3334928
1668090767,204763,true,1281446584,28,1284525595,3079011
1668090791,204759,true,1281959239,28,1284654047,2694808
1668090803,204755,true,1282472100,28,1284782513,2310413
1668090839,204754,true,1282600347,28,1284782513,2182166
1668091067,204754,true,1282600347,28,1286067874,3467527
1668091103,204751,true,1282985166,28,1286196480,3211314
1668091115,204749,true,1283241775,28,1286325100,3083325
1668091139,204747,true,1283498437,28,1286325100,2826663
1668091343,204749,true,1283241775,28,1286968391,3726616
1668091451,204747,true,1283498437,28,1286968391,3469954
1668091523,204745,true,1283755149,28,1286968391,3213242
1668091619,204745,true,1283755149,28,1286968391,3213242
1668091631,204746,true,1283626787,28,1286968391,3341604
1668091655,204745,true,1283755149,28,1286968391,3213242
1668091679,204742,true,1284140314,28,1287097088,2956774
1668091691,204742,true,1284140314,28,1287097088,2956774
1668091715,204742,true,1284140314,28,1287097088,2956774
1668091727,204740,true,1284397155,28,1287097088,2699933
1668091751,204737,true,1284782513,28,1287225798,2443285
1668091775,204736,true,1284910991,28,1287354520,2443529
1668091799,204737,true,1284782513,28,1287483256,2700743
1668091847,204734,true,1285167986,28,1287612004,2444018
1668091883,204732,true,1285425033,28,1287869539,2444506
1668091931,204730,true,1285682130,28,1288127126,2444996
1668092015,204730,true,1285682130,28,1288513603,2831473
1668092039,204728,true,1285939280,28,1288642454,2703174
1668092135,204725,true,1286325100,28,1289286905,2961805
1668092147,204723,true,1286582378,28,1289286905,2704527
1668092159,204723,true,1286582378,28,1289415833,2833455
1668092171,204721,true,1286839707,28,1289544775,2705068
1668092183,204717,true,1287354520,28,1289673729,2319209
1668092195,204715,true,1287612004,28,1289802697,2190693
1668092219,204714,true,1287740765,28,1290060670,2319905
1668092411,204710,true,1288255939,28,1292384754,4128815
1668092483,204706,true,1288771319,28,1293289695,4518376
1668092495,204705,true,1288900196,28,1293419024,4518828
1668092519,204703,true,1289157989,28,1293807088,4649099
1668092543,204699,true,1289673729,28,1294195269,4521540
1668092591,204694,true,1290318695,28,1295101478,4782783
1668092603,204692,true,1290576772,28,1295360511,4783739
1668092723,204689,true,1290963984,28,1298213298,7249314
1668092759,204685,true,1291480447,28,1298992421,7511974
1668092879,204680,true,1292126316,28,1301592876,9466560
1668092903,204678,true,1292384754,28,1302243802,9859048
1668092927,204676,true,1292643244,28,1302764778,10121534
1668092975,204671,true,1293289695,28,1304068129,10778434
1668092987,204667,true,1293807088,28,1304328956,10521868
1668092999,204664,true,1294195269,28,1304720294,10525025
1668093023,204663,true,1294324689,28,1305372784,11048095
1668093095,204657,true,1295101478,28,1307593694,12492216
1668093107,204652,true,1295749158,28,1307986011,12236853
1668093131,204651,true,1295878733,28,1308640135,12761402
1668093143,204649,true,1296137922,28,1308901876,12763954
1668093155,204644,true,1296786120,28,1309294586,12508466
1668093203,204640,true,1297304913,28,1310604470,13299557
1668093275,204639,true,1297434643,28,1312571754,15137111
1668093299,204638,true,1297564387,28,1313096861,15532474
1668093311,204634,true,1298083490,28,1313490830,15407340
1668093347,204631,true,1298472954,28,1314279121,15806167
1668093371,204632,true,1298343120,28,1314804912,16461792
1668093383,204631,true,1298472954,28,1315067886,16594932
1668093467,204627,true,1298992421,28,1317173573,18181152
1668093563,204623,true,1299512096,28,1319282632,19770536
1668093575,204624,true,1299382158,28,1319546502,20164344
1668093647,204622,true,1299642047,28,1321130829,21488782
1668093683,204618,true,1300161982,28,1321923706,21761724
1668093719,204614,true,1300682125,28,1322717058,22034933
1668093779,204614,true,1300682125,28,1323907980,23225855
1668093791,204613,true,1300812193,28,1324172775,23360582
1668093803,204608,true,1301462729,28,1324305192,22842463
1668093827,204604,true,1301983393,28,1324834993,22851600
1668094043,204603,true,1302113591,28,1328018257,25904666
1668094067,204601,true,1302374027,28,1328151058,25777031
1668094091,204597,true,1302895054,28,1328151058,25256004
1668094115,204592,true,1303546632,28,1328283874,24737242
1668094127,204593,true,1303416291,28,1328283874,24867583
1668094199,204591,true,1303676987,28,1328549544,24872557
1668094247,204586,true,1304328956,28,1328682399,24353443
1668094271,204581,true,1304981251,28,1328815267,23834016
1668094307,204581,true,1304981251,28,1328815267,23834016
1668094331,204578,true,1305372784,28,1328682399,23309615
1668094343,204574,true,1305895012,28,1328682399,22787387
1668094355,204569,true,1306548090,28,1328549544,22001454
1668094367,204570,true,1306417448,28,1328549544,22132096
1668094379,204568,true,1306678745,28,1328416702,21737957
1668094391,204563,true,1307332215,28,1328283874,20951659
1668094403,204559,true,1307855226,28,1328151058,20295832
1668094607,204561,true,1307593694,28,1326027822,18434128
1668094679,204559,true,1307855226,28,1325232484,17377258
1668094715,204555,true,1308378447,28,1324834993,16456546
1668094859,204552,true,1308770999,28,1322584800,13813801
1668094871,204554,true,1308509284,28,1322320322,13811038
1668094943,204553,true,1308640135,28,1321262942,12622807
1668094955,204549,true,1309163670,28,1321130829,11967159
1668095243,204545,true,1309687414,28,1318095871,8408457
1668095327,204547,true,1309425516,28,1317305290,7879774
1668095375,204544,true,1309818383,28,1316910178,7091795
1668095399,204541,true,1310211367,28,1316646835,6435468
1668095543,204537,true,1310735531,28,1314936392,4200861
1668095579,204539,true,1310473423,28,1314673444,4200021
1668095687,204537,true,1310735531,28,1313622179,2886648
1668095831,204534,true,1311128791,28,1312309279,1180488
1668095903,204530,true,1311653321,28,1311784486,131165
1668095915,204533,true,1311259903,28,1311653321,393418
1668095927,204532,true,1311391029,28,1311653321,262292
1668096143,204528,true,1311915665,28,1310866604,-1049061
1668096155,204524,true,1312440510,28,1310866604,-1573906
1668096167,204527,true,1312046856,28,1310866604,-1180252
1668096275,204527,true,1312046856,28,1310735531,-1311325
1668096299,204524,true,1312440510,28,1310735531,-1704979
1668096311,204520,true,1312965565,28,1310735531,-2230034
1668096395,204522,true,1312703011,28,1311128791,-1574220
1668096407,204521,true,1312834281,28,1311128791,-1705490
1668096419,204517,true,1313359494,28,1311259903,-2099591
1668096443,204513,true,1313884916,28,1311391029,-2493887
1668096539,204514,true,1313753541,28,1312309279,-1444262
1668096551,204511,true,1314147706,28,1312440510,-1707196
1668096611,204507,true,1314673444,28,1312965565,-1707879
1668096659,204503,true,1315199392,28,1313490830,-1708562
1668096671,204503,true,1315199392,28,1313622179,-1577213
1668096695,204500,true,1315593992,28,1313884916,-1709076
1668096767,204495,true,1316251920,28,1314673444,-1578476
1668096815,204491,true,1316778500,28,1315199392,-1579108
1668096851,204491,true,1316778500,28,1315462446,-1316054
1668096935,204488,true,1317173573,28,1316251920,-921653
1668097007,204484,true,1317700522,28,1316910178,-790344
1668097019,204479,true,1318359504,28,1317041869,-1317635
1668097031,204479,true,1318359504,28,1317305290,-1054214
1668097067,204475,true,1318886927,28,1317700522,-1186405
1668097139,204469,true,1319678457,28,1319018815,-659642
1668097151,204465,true,1320206407,28,1319282632,-923775
1668097187,204465,true,1320206407,28,1319810424,-395983
1668097259,204462,true,1320602509,28,1320602509,0
1668097343,204457,true,1321262942,28,1321659361,396419
1668097367,204454,true,1321659361,28,1322055898,396537
1668097379,204454,true,1321659361,28,1322188104,528743
1668097463,204451,true,1322055898,28,1323246224,1190326
1668097475,204446,true,1322717058,28,1323378549,661491
1668097499,204443,true,1323113913,28,1323775602,661689
1668097643,204443,true,1323113913,28,1325497543,2383630
1668097655,204441,true,1323378549,28,1325762656,2384107
1668097667,204436,true,1324040371,28,1325895232,1854861
1668097715,204433,true,1324437622,28,1326558313,2120691
1668097727,204435,true,1324172775,28,1326690969,2518194
1668097739,204433,true,1324437622,28,1326823638,2386016
1668097751,204430,true,1324834993,28,1327089016,2254023
1668097763,204427,true,1325232484,28,1327221725,1989241
1668097775,204428,true,1325099974,28,1327354447,2254473
1668097787,204427,true,1325232484,28,1327619931,2387447
1668097823,204424,true,1325630093,28,1328151058,2520965
1668097847,204423,true,1325762656,28,1328416702,2654046
1668097859,204424,true,1325630093,28,1328682399,3052306
1668097871,204423,true,1325762656,28,1328815267,3052611
1668097979,204421,true,1326027822,28,1330410722,4382900
1668098003,204420,true,1326160425,28,1330809886,4649461
1668098075,204421,true,1326027822,28,1331874906,5847084
1668098087,204420,true,1326160425,28,1332008094,5847669
1668098159,204419,true,1326293041,28,1332807498,6514457
1668098171,204419,true,1326293041,28,1332807498,6514457
1668098267,204421,true,1326027822,28,1333474035,7446213
1668098279,204420,true,1326160425,28,1333607383,7446958
1668098363,204420,true,1326160425,28,1334007505,7847080
1668098471,204420,true,1326160425,28,1334274320,8113895
1668098495,204422,true,1325895232,28,1334274320,8379088
1668098639,204422,true,1325895232,28,1334541188,8645956
1668098735,204421,true,1326027822,28,1334941590,8913768
1668098759,204421,true,1326027822,28,1334941590,8913768
1668098783,204423,true,1325762656,28,1334941590,9178934
1668098903,204422,true,1325895232,28,1334541188,8645956
1668098951,204422,true,1325895232,28,1334274320,8379088
1668098975,204420,true,1326160425,28,1334140906,7980481
1668098987,204422,true,1325895232,28,1334007505,8112273
1668099191,204421,true,1326027822,28,1333607383,7579561
1668099263,204421,true,1326027822,28,1333340701,7312879
1668099359,204420,true,1326160425,28,1332940779,6780354
1668099407,204422,true,1325895232,28,1332674231,6778999
1668099431,204422,true,1325895232,28,1332674231,6778999
1668099443,204422,true,1325895232,28,1332540977,6645745
1668099515,204422,true,1325895232,28,1331874906,5979674
1668099659,204424,true,1325630093,28,1330277695,4647602
1668099683,204424,true,1325630093,28,1329878691,4248598
1668099959,204424,true,1325630093,28,1326956320,1326227
1668099983,204424,true,1325630093,28,1326823638,1193545
1668100079,204427,true,1325232484,28,1325762656,530172
1668100091,204427,true,1325232484,28,1325630093,397609
1668100211,204428,true,1325099974,28,1324437622,-662352
1668100235,204428,true,1325099974,28,1324305192,-794782
1668100631,204429,true,1324967477,28,1320206407,-4761070
1668100643,204429,true,1324967477,28,1320074400,-4893077
1668100691,204430,true,1324834993,28,1319546502,-5288491
1668100739,204430,true,1324834993,28,1319018815,-5816178
1668100907,204432,true,1324570066,28,1317437021,-7133045
1668100943,204432,true,1324570066,28,1317173573,-7396493
1668100979,204433,true,1324437622,28,1316910178,-7527444
1668101255,204432,true,1324570066,28,1314936392,-9633674
1668101267,204433,true,1324437622,28,1314936392,-9501230
1668101387,204433,true,1324437622,28,1314410549,-10027073
1668101471,204433,true,1324437622,28,1314016305,-10421317
1668101495,204433,true,1324437622,28,1313884916,-10552706
1668101519,204433,true,1324437622,28,1313884916,-10552706
1668101555,204433,true,1324437622,28,1313622179,-10815443
1668101567,204434,true,1324305192,28,1313490830,-10814362
1668101591,204433,true,1324437622,28,1313359494,-11078128
1668101603,204433,true,1324437622,28,1313228171,-11209451
1668101615,204433,true,1324437622,28,1313228171,-11209451
1668101627,204435,true,1324172775,28,1313096861,-11075914
1668101639,204435,true,1324172775,28,1312965565,-11207210
1668101651,204436,true,1324040371,28,1312834281,-11206090
1668101663,204436,true,1324040371,28,1312703011,-11337360
1668101675,204438,true,1323775602,28,1312571754,-11203848
1668101699,204439,true,1323643238,28,1312178061,-11465177
1668101711,204440,true,1323510887,28,1312046856,-11464031
1668101759,204441,true,1323378549,28,1311391029,-11987520
1668101783,204443,true,1323113913,28,1311128791,-11985122
1668101807,204444,true,1322981615,28,1310735531,-12246084
1668101819,204445,true,1322849330,28,1310604470,-12244860
1668101831,204446,true,1322717058,28,1310473423,-12243635
1668101843,204449,true,1322320322,28,1310211367,-12108955
1668101855,204452,true,1321923706,28,1309949364,-11974342
1668101867,204453,true,1321791526,28,1309818383,-11973143
1668101879,204455,true,1321527208,28,1309556458,-11970750
1668101903,204458,true,1321130829,28,1309032767,-12098062
1668101915,204461,true,1320734569,28,1308770999,-11963570
1668101927,204464,true,1320338428,28,1308378447,-11959981
1668101951,204468,true,1319810424,28,1307724454,-12085970
1668101963,204472,true,1319282632,28,1307462948,-11819684
1668101975,204477,true,1318623189,28,1307070787,-11552402
1668102011,204482,true,1317964075,28,1305764435,-12199640
1668102059,204486,true,1317437021,28,1304328956,-13108065
1668102071,204491,true,1316778500,28,1303937735,-12840765
1668102095,204495,true,1316251920,28,1303155646,-13096274
1668102131,204501,true,1315462446,28,1302113591,-13348855
1668102143,204505,true,1314936392,28,1301723035,-13213357
1668102167,204511,true,1314147706,28,1300812193,-13335513
1668102179,204515,true,1313622179,28,1300422028,-13200151
1668102203,204521,true,1312834281,28,1299772012,-13062269
1668102251,204524,true,1312440510,28,1298213298,-14227212
1668102287,204530,true,1311653321,28,1297175195,-14478126
1668102335,204535,true,1310997691,28,1295619596,-15378095
1668102383,204540,true,1310342389,28,1294065863,-16276526
1668102443,204546,true,1309556458,28,1292126316,-17430142
1668102491,204553,true,1308640135,28,1290447727,-18192408
1668102515,204559,true,1307855226,28,1289673729,-18181497
1668102539,204565,true,1307070787,28,1288900196,-18170591
1668102611,204569,true,1306548090,28,1286582378,-19965712
1668102623,204575,true,1305764435,28,1286196480,-19567955
1668102635,204580,true,1305111749,28,1285939280,-19172469
1668102647,204586,true,1304328956,28,1285553575,-18775381
1668102659,204589,true,1303937735,28,1285167986,-18769749
1668102683,204596,true,1303025344,28,1284525595,-18499749
1668103007,204601,true,1302374027,28,1274800688,-27573339
1668103247,204606,true,1301723035,28,1267555355,-34167680
1668103355,204610,true,1301202476,28,1264390583,-36811893
1668103367,204617,true,1300291998,28,1264137742,-36154256
1668103379,204622,true,1299642047,28,1263758577,-35883470
1668103391,204628,true,1298862535,28,1263505863,-35356672
1668103403,204631,true,1298472954,28,1263253200,-35219754
1668103415,204638,true,1297564387,28,1263000587,-34563800
1668103427,204643,true,1296915799,28,1262748025,-34167774
1668103475,204648,true,1296267536,28,1261990641,-34276895
1668103715,204651,true,1295878733,28,1259469308,-36409425
1668103883,204658,true,1294971981,28,1260351201,-34620780
1668103895,204663,true,1294324689,28,1260477236,-33847453
1668104075,204668,true,1293677721,28,1262495513,-31182208
1668104087,204670,true,1293419024,28,1262621763,-30797261
1668104363,204676,true,1292643244,28,1266035277,-26607967
1668104483,204681,true,1291997116,28,1267175165,-24821951
1668104603,204685,true,1291480447,28,1268189260,-23291187
1668104615,204688,true,1291093080,28,1268189260,-22903820
1668104627,204693,true,1290447727,28,1268316079,-22131648
1668104639,204698,true,1289802697,28,1268316079,-21486618
1668104687,204703,true,1289157989,28,1268442910,-20715079
1668104735,204706,true,1288771319,28,1268696611,-20074708
1668104963,204711,true,1288127126,28,1269711924,-18415202
1668104987,204716,true,1287483256,28,1269711924,-17771332
1668104999,204722,true,1286711036,28,1269711924,-16999112
1668105227,204726,true,1286196480,28,1269204166,-16992314
1668105263,204732,true,1285425033,28,1268950363,-16474670
1668105359,204737,true,1284782513,28,1268189260,-16593253
1668105431,204743,true,1284011913,28,1267682111,-16329802
1668105659,204747,true,1283498437,28,1266035277,-17463160
1668105707,204753,true,1282728607,28,1265782108,-16946499
1668105731,204758,true,1282087435,28,1265528989,-16558446
1668105743,204763,true,1281446584,28,1265402449,-16044135
1668105851,204765,true,1281190333,28,1264643473,-16546860
1668105983,204770,true,1280549930,28,1263884953,-16664977
1668106103,204775,true,1279909847,28,1263000587,-16909260
1668106151,204780,true,1279270084,28,1262748025,-16522059
1668106211,204782,true,1279014268,28,1262495513,-16518755
1668106655,204787,true,1278374953,28,1261485971,-16888982
1668106667,204791,true,1277863731,28,1261485971,-16377760
1668106691,204795,true,1277352713,28,1261612120,-15740593
1668106919,204797,true,1277097281,28,1262748025,-14349256
1668106955,204801,true,1276586570,28,1263000587,-13585983
1668107015,204805,true,1276076063,28,1263505863,-12570200
1668107027,204809,true,1275565760,28,1263632214,-11933546
1668107615,204809,true,1275565760,28,1268442910,-7122850
1668107699,204812,true,1275183166,28,1268823481,-6359685
1668107831,204816,true,1274673221,28,1269458020,-5215201
1668107927,204820,true,1274163479,28,1269965879,-4197600
1668107951,204820,true,1274163479,28,1269965879,-4197600
1668107963,204823,true,1273781306,28,1270092876,-3688430
1668107987,204827,true,1273271921,28,1270092876,-3179045
1668107999,204831,true,1272762740,28,1270092876,-2669864
1668108167,204832,true,1272635476,28,1270346907,-2288569
1668108347,204835,true,1272253762,28,1270600989,-1652773
1668108359,204840,true,1271617826,28,1270600989,-1016837
1668108395,204844,true,1271109306,28,1270728049,-381257
1668108455,204844,true,1271109306,28,1270855122,-254184
1668108467,204847,true,1270728049,28,1270855122,127073
1668108479,204851,true,1270219885,28,1270855122,635237
1668108755,204855,true,1269711924,28,1271744987,2033063
1668109151,204855,true,1269711924,28,1272380987,2669063
1668109271,204857,true,1269458020,28,1272635476,3177456
1668109283,204861,true,1268950363,28,1272635476,3685113
1668109427,204863,true,1268696611,28,1272762740,4066129
1668109463,204863,true,1268696611,28,1272890016,4193405
1668109475,204865,true,1268442910,28,1272890016,4447106
1668109487,204868,true,1268062453,28,1272890016,4827563
1668109559,204871,true,1267682111,28,1272762740,5080629
1668109739,204871,true,1267682111,28,1272635476,4953365
1668109751,204872,true,1267555355,28,1272635476,5080121
1668109763,204875,true,1267175165,28,1272635476,5460311
1668109787,204877,true,1266921768,28,1272890016,5968248
1668109811,204874,true,1267301882,28,1273144607,5842725
1668109943,204874,true,1267301882,28,1274545766,7243884
1668110339,204876,true,1267048460,28,1278502790,11454330
1668110351,204878,true,1266795088,28,1278630641,11835553
1668110375,204875,true,1267175165,28,1278758504,11583339
1668110411,204874,true,1267301882,28,1279014268,11712386
1668110423,204877,true,1266921768,28,1279142170,12220402
1668110447,204878,true,1266795088,28,1279270084,12474996
1668110459,204874,true,1267301882,28,1279398011,12096129
1668110471,204873,true,1267428612,28,1279398011,11969399
1668110483,204874,true,1267301882,28,1279525951,12224069
1668110519,204875,true,1267175165,28,1279781869,12606704
1668110627,204869,true,1267935660,28,1280677985,12742325
1668110855,204868,true,1268062453,28,1281446584,13384131
1668110999,204868,true,1268062453,28,1281959239,13896786
1668111239,204868,true,1268062453,28,1282856880,14794427
1668111275,204862,true,1268823481,28,1283113464,14289983
1668111287,204861,true,1268950363,28,1283113464,14163101
1668111299,204861,true,1268950363,28,1283241775,14291412
1668111635,204860,true,1269077258,28,1284910991,15833733
1668111647,204854,true,1269838895,28,1284910991,15072096
1668111719,204853,true,1269965879,28,1284910991,14945112
1668111731,204853,true,1269965879,28,1284910991,14945112
1668111743,204852,true,1270092876,28,1284910991,14818115
1668111755,204846,true,1270855122,28,1284910991,14055869
1668111779,204844,true,1271109306,28,1284910991,13801685
1668111803,204843,true,1271236417,28,1285039482,13803065
1668111995,204841,true,1271490677,28,1285810699,14320022
1668112127,204835,true,1272253762,28,1286325100,14071338
1668112271,204832,true,1272635476,28,1286968391,14332915
1668112307,204832,true,1272635476,28,1287225798,14590322
1668112355,204829,true,1273017305,28,1287483256,14465951
1668112523,204823,true,1273781306,28,1288642454,14861148
1668112679,204820,true,1274163479,28,1289931677,15768198
1668112823,204820,true,1274163479,28,1291222189,17058710
1668112835,204818,true,1274418324,28,1291351311,16932987
1668112859,204812,true,1275183166,28,1291480447,16297281
1668112871,204810,true,1275438216,28,1291609595,16171379
1668112895,204810,true,1275438216,28,1291738756,16300540
1668112907,204807,true,1275820886,28,1291867929,16047043
1668113003,204802,true,1276458924,28,1292513993,16055069
1668113051,204800,true,1276714228,28,1292901786,16187558
1668113423,204800,true,1276714228,28,1294842496,18128268
1668113579,204797,true,1277097281,28,1295490047,18392766
1668113591,204792,true,1277735957,28,1295490047,17754090
1668113603,204791,true,1277863731,28,1295490047,17626316
1668113615,204791,true,1277863731,28,1295490047,17626316
1668113639,204789,true,1278119316,28,1295490047,17370731
1668113651,204784,true,1278758504,28,1295619596,16861092
1668113675,204781,true,1279142170,28,1295878733,16736563
1668113687,204780,true,1279270084,28,1296008321,16738237
1668113699,204777,true,1279653903,28,1296137922,16484019
1668113735,204771,true,1280421888,28,1296656455,16234567
1668113747,204769,true,1280677985,28,1296915799,16237814
1668113795,204767,true,1280934133,28,1297564387,16630254
1668113831,204764,true,1281318452,28,1298213298,16894846
1668113843,204758,true,1282087435,28,1298343120,16255685
1668113855,204755,true,1282472100,28,1298602801,16130701
1668113879,204752,true,1282856880,28,1299122320,16265440
1668113975,204748,true,1283370100,28,1300682125,17312025
1668113987,204741,true,1284268728,28,1300942274,16673546
1668114023,204738,true,1284654047,28,1301592876,16938829
1668114059,204735,true,1285039482,28,1302374027,17334545
1668114071,204730,true,1285682130,28,1302634514,16952384
1668114083,204722,true,1286711036,28,1302764778,16053742
1668114299,204718,true,1287225798,28,1306286819,19061021
1668114311,204715,true,1287612004,28,1306548090,18936086
1668114323,204710,true,1288255939,28,1306678745,18422806
1668114371,204702,true,1289286905,28,1307593694,18306789
1668114383,204698,true,1289802697,28,1307724454,17921757
1668114395,204696,true,1290060670,28,1307986011,17925341
1668114419,204690,true,1290834900,28,1308509284,17674384
1668114515,204682,true,1291867929,28,1310604470,18736541
1668114551,204678,true,1292384754,28,1311391029,19006275
1668114563,204676,true,1292643244,28,1311522169,18878925
1668114575,204670,true,1293419024,28,1311784486,18365462
1668114635,204664,true,1294195269,28,1312965565,18770296
1668114659,204661,true,1294583567,28,1313359494,18775927
1668114887,204659,true,1294842496,28,1317832292,22989796
1668114899,204653,true,1295619596,28,1317964075,22344479
1668114911,204647,true,1296397162,28,1318227681,21830519
1668115079,204644,true,1296786120,28,1321130829,24344709
1668115103,204643,true,1296915799,28,1321527208,24611409
1668115139,204637,true,1297694143,28,1322188104,24493961
1668115163,204632,true,1298343120,28,1322584800,24241680
1668115403,204630,true,1298602801,28,1326558313,27955512
1668115439,204629,true,1298732662,28,1327089016,28356354
1668115463,204623,true,1299512096,28,1327354447,27842351
1668115475,204618,true,1300161982,28,1327354447,27192465
1668115487,204616,true,1300422028,28,1327487182,27065154
1668115499,204614,true,1300682125,28,1327487182,26805057
1668115511,204608,true,1301462729,28,1327487182,26024453
1668115571,204602,true,1302243802,28,1327619931,25376129
1668115967,204600,true,1302504264,28,1327487182,24982918
1668116267,204598,true,1302764778,28,1327089016,24324238
1668116531,204592,true,1303546632,28,1326558313,23011681
1668116555,204586,true,1304328956,28,1326558313,22229357
1668116843,204584,true,1304589835,28,1326690969,22101134
1668116999,204583,true,1304720294,28,1326823638,22103344
1668117011,204577,true,1305503321,28,1326823638,21320317
1668117023,204572,true,1306156204,28,1326823638,20667434
1668117035,204570,true,1306417448,28,1326823638,20406190
1668117143,204570,true,1306417448,28,1326425670,20008222
1668117311,204565,true,1307070787,28,1325762656,18691869
1668117551,204560,true,1307724454,28,1324570066,16845612
1668117659,204558,true,1307986011,28,1324040371,16054360
1668117815,204558,true,1307986011,28,1323378549,15392538
1668118067,204552,true,1308770999,28,1322188104,13417105
1668118079,204547,true,1309425516,28,1322188104,12762588
1668118151,204545,true,1309687414,28,1321527208,11839794
1668118343,204546,true,1309556458,28,1319942405,10385947
1668118355,204541,true,1310211367,28,1319810424,9599057
1668118403,204539,true,1310473423,28,1319414560,8941137
1668118883,204539,true,1310473423,28,1314936392,4462969
1668119159,204540,true,1310342389,28,1313622179,3279790
1668119207,204536,true,1310866604,28,1313490830,2624226
1668119219,204533,true,1311259903,28,1313490830,2230927
1668119255,204533,true,1311259903,28,1313359494,2099591
1668119603,204533,true,1311259903,28,1312046856,786953
1668119675,204528,true,1311915665,28,1311784486,-131179
1668119711,204525,true,1312309279,28,1311653321,-655958
1668119807,204525,true,1312309279,28,1311391029,-918250
1668119843,204526,true,1312178061,28,1311259903,-918158
1668119867,204521,true,1312834281,28,1311259903,-1574378
1668119879,204519,true,1313096861,28,1311259903,-1836958
1668119891,204517,true,1313359494,28,1311259903,-2099591
1668120035,204516,true,1313490830,28,1311653321,-1837509
1668120071,204511,true,1314147706,28,1311784486,-2363220
1668120095,204508,true,1314541990,28,1311784486,-2757504
1668120383,204507,true,1314673444,28,1313490830,-1182614
1668120587,204506,true,1314804912,28,1314673444,-131468
1668120779,204501,true,1315462446,28,1316120308,657862
1668121343,204498,true,1315857124,28,1319678457,3821333
1668121379,204496,true,1316120308,28,1319942405,3822097
1668121403,204496,true,1316120308,28,1319942405,3822097
1668121511,204492,true,1316646835,28,1320470462,3823627
1668121715,204489,true,1317041869,28,1320998729,3956860
1668121883,204488,true,1317173573,28,1321130829,3957256
1668122063,204488,true,1317173573,28,1321130829,3957256
1668122087,204485,true,1317568765,28,1321130829,3562064
1668122099,204482,true,1317964075,28,1321130829,3166754
1668122123,204481,true,1318095871,28,1321130829,3034958
1668122147,204482,true,1317964075,28,1321130829,3166754
1668122159,204479,true,1318359504,28,1321130829,2771325
1668122171,204477,true,1318623189,28,1320998729,2375540
1668122183,204477,true,1318623189,28,1320998729,2375540
1668122195,204478,true,1318491340,28,1320866642,2375302
1668122207,204475,true,1318886927,28,1320734569,1847642
1668122243,204475,true,1318886927,28,1320470462,1583535
1668122267,204475,true,1318886927,28,1320074400,1187473
1668122291,204476,true,1318755051,28,1319810424,1055373
1668122327,204474,true,1319018815,28,1319414560,395745
1668122375,204474,true,1319018815,28,1318755051,-263764
1668122483,204474,true,1319018815,28,1317041869,-1976946
1668122495,204476,true,1318755051,28,1316910178,-1844873
1668122555,204475,true,1318886927,28,1315725551,-3161376
1668122807,204475,true,1318886927,28,1310997691,-7889236
1668122831,204476,true,1318755051,28,1310604470,-8150581
1668123035,204477,true,1318623189,28,1306940093,-11683096
1668123047,204476,true,1318755051,28,1306678745,-12076306
1668123059,204477,true,1318623189,28,1306548090,-12075099
1668123071,204479,true,1318359504,28,1306417448,-11942056
1668123083,204481,true,1318095871,28,1306156204,-11939667
1668123119,204481,true,1318095871,28,1305764435,-12331436
1668123203,204483,true,1317832292,28,1304589835,-13242457
1668123239,204486,true,1317437021,28,1304198536,-13238485
1668123719,204487,true,1317305290,28,1298862535,-18442755
1668123743,204488,true,1317173573,28,1298602801,-18570772
1668123755,204490,true,1316910178,28,1298472954,-18437224
1668123779,204493,true,1316515184,28,1298083490,-18431694
1668123863,204495,true,1316251920,28,1297045491,-19206429
1668123875,204496,true,1316120308,28,1296786120,-19334188
1668123887,204498,true,1315857124,28,1296656455,-19200669
1668123899,204501,true,1315462446,28,1296526802,-18935644
1668124091,204504,true,1315067886,28,1295101478,-19966408
1668124523,204506,true,1314804912,28,1295749158,-19055754
1668124535,204508,true,1314541990,28,1295878733,-18663257
1668125123,204510,true,1314279121,28,1296656455,-17622666
1668125147,204513,true,1313884916,28,1296656455,-17228461
1668125231,204514,true,1313753541,28,1296526802,-17226739
1668125483,204516,true,1313490830,28,1296397162,-17093668
1668125507,204518,true,1313228171,28,1296267536,-16960635
1668125519,204521,true,1312834281,28,1296267536,-16566745
1668125531,204523,true,1312571754,28,1296267536,-16304218
1668125603,204528,true,1311915665,28,1295878733,-16036932
1668125615,204530,true,1311653321,28,1295878733,-15774588
1668125627,204533,true,1311259903,28,1295878733,-15381170
1668125639,204535,true,1310997691,28,1295878733,-15118958
1668125903,204538,true,1310604470,28,1295878733,-14725737
1668125939,204540,true,1310342389,28,1295878733,-14463656
1668125951,204542,true,1310080359,28,1295878733,-14201626
1668125975,204544,true,1309818383,28,1295878733,-13939650
1668125987,204547,true,1309425516,28,1295878733,-13546783
1668125999,204549,true,1309163670,28,1295878733,-13284937
1668126023,204552,true,1308770999,28,1295749158,-13021841
1668126035,204554,true,1308509284,28,1295749158,-12760126
1668126095,204557,true,1308116810,28,1295490047,-12626763
1668126227,204559,true,1307855226,28,1294971981,-12883245
1668126239,204562,true,1307462948,28,1294842496,-12620452
1668126539,204564,true,1307201494,28,1293160379,-14041115
1668126743,204568,true,1306678745,28,1291997116,-14681629
1668126767,204570,true,1306417448,28,1291867929,-14549519
1668126923,204573,true,1306025601,28,1290963984,-15061617
1668127079,204575,true,1305764435,28,1289931677,-15832758
1668127343,204579,true,1305242260,28,1288513603,-16728657
1668127403,204581,true,1304981251,28,1288384765,-16596486
1668127415,204583,true,1304720294,28,1288384765,-16335529
1668127751,204586,true,1304328956,28,1286453733,-17875223
1668127763,204590,true,1303807355,28,1286453733,-17353622
1668127775,204592,true,1303546632,28,1286325100,-17221532
1668127787,204595,true,1303155646,28,1286325100,-16830546
1668127799,204597,true,1302895054,28,1286325100,-16569954
1668127823,204601,true,1302374027,28,1286325100,-16048927
1668127835,204603,true,1302113591,28,1286325100,-15788491
1668127907,204603,true,1302113591,28,1286325100,-15788491
1668128231,204606,true,1301723035,28,1286711036,-15011999
1668128255,204609,true,1301332596,28,1286839707,-14492889
1668128291,204611,true,1301072369,28,1286839707,-14232662
1668128495,204611,true,1301072369,28,1287612004,-13460365
1668128531,204613,true,1300812193,28,1287740765,-13071428
1668128567,204617,true,1300291998,28,1287740765,-12551233
1668128579,204618,true,1300161982,28,1287869539,-12292443
1668128591,204618,true,1300161982,28,1287869539,-12292443
1668128603,204619,true,1300031979,28,1287869539,-12162440
1668128639,204622,true,1299642047,28,1288127126,-11514921
1668128699,204623,true,1299512096,28,1288255939,-11256157
1668128711,204622,true,1299642047,28,1288384765,-11257282
1668128843,204623,true,1299512096,28,1289029086,-10483010
1668128927,204626,true,1299122320,28,1289415833,-9706487
1668128975,204626,true,1299122320,28,1289673729,-9448591
1668128987,204626,true,1299122320,28,1289802697,-9319623
1668129035,204627,true,1298992421,28,1290189676,-8802745
1668129107,204629,true,1298732662,28,1290705829,-8026833
1668129191,204630,true,1298602801,28,1291351311,-7251490
1668129203,204630,true,1298602801,28,1291480447,-7122354
1668129551,204631,true,1298472954,28,1294065863,-4407091
1668129755,204633,true,1298213298,28,1295360511,-2852787
1668129839,204634,true,1298083490,28,1295878733,-2204757
1668129875,204635,true,1297953695,28,1296137922,-1815773
1668129899,204636,true,1297823912,28,1296267536,-1556376
1668129911,204639,true,1297434643,28,1296267536,-1167107
1668129923,204640,true,1297304913,28,1296397162,-907751
1668129935,204641,true,1297175195,28,1296397162,-778033
1668129947,204642,true,1297045491,28,1296397162,-648329
1668130007,204646,true,1296526802,28,1296656455,129653
1668130031,204647,true,1296397162,28,1296786120,388958
1668130199,204649,true,1296137922,28,1296786120,648198
1668130223,204650,true,1296008321,28,1296915799,907478
1668130247,204653,true,1295619596,28,1296915799,1296203
1668130295,204655,true,1295360511,28,1296915799,1555288
1668130319,204657,true,1295101478,28,1296915799,1814321
1668130331,204658,true,1294971981,28,1296915799,1943818
1668130343,204661,true,1294583567,28,1296786120,2202553
1668130355,204663,true,1294324689,28,1296786120,2461431
1668130367,204666,true,1293936469,28,1296656455,2719986
1668130379,204667,true,1293807088,28,1296656455,2849367
1668130403,204671,true,1293289695,28,1296397162,3107467
1668130415,204673,true,1293031076,28,1296397162,3366086
1668130439,204675,true,1292772508,28,1296137922,3365414
1668130463,204677,true,1292513993,28,1295749158,3235165
1668130535,204681,true,1291997116,28,1294583567,2586451
1668130823,204683,true,1291738756,28,1289544775,-2193981
1668130835,204685,true,1291480447,28,1289286905,-2193542
1668130847,204686,true,1291351311,28,1289029086,-2322225
1668130859,204690,true,1290834900,28,1288771319,-2063581
1668130907,204692,true,1290576772,28,1287869539,-2707233
1668130931,204693,true,1290447727,28,1287483256,-2964471
1668131855,204693,true,1290447727,28,1271363540,-19084187
1668131879,204696,true,1290060670,28,1270982207,-19078463
1668131903,204698,true,1289802697,28,1270600989,-19201708
1668131915,204700,true,1289544775,28,1270473942,-19070833
1668131951,204700,true,1289544775,28,1269838895,-19705880
1668131975,204704,true,1289029086,28,1269331087,-19697999
1668131999,204706,true,1288771319,28,1268823481,-19947838
1668132023,204710,true,1288255939,28,1268442910,-19813029
1668132059,204711,true,1288127126,28,1267682111,-20445015
1668132119,204716,true,1287483256,28,1266541767,-20941489
1668132131,204718,true,1287225798,28,1266288497,-20937301
1668132143,204721,true,1286839707,28,1266161881,-20677826
1668132155,204723,true,1286582378,28,1265908686,-20673692
1668132239,204727,true,1286067874,28,1265022904,-21044970
1668132251,204729,true,1285810699,28,1265022904,-20787795
1668132263,204732,true,1285425033,28,1264896415,-20528618
1668132287,204734,true,1285167986,28,1264896415,-20271571
1668132359,204737,true,1284782513,28,1264769938,-20012575
1668132467,204739,true,1284525595,28,1264643473,-19882122
1668132503,204741,true,1284268728,28,1264643473,-19625255
1668132623,204743,true,1284011913,28,1264517022,-19494891
1668132707,204746,true,1283626787,28,1264390583,-19236204
1668132731,204748,true,1283370100,28,1264264156,-19105944
1668132755,204750,true,1283113464,28,1264264156,-18849308
1668132779,204752,true,1282856880,28,1264137742,-18719138
1668132803,204756,true,1282343865,28,1264011341,-18332524
1668132815,204758,true,1282087435,28,1264011341,-18076094
1668132827,204761,true,1281702886,28,1263884953,-17817933
1668132851,204763,true,1281446584,28,1263758577,-17688007
1668132863,204765,true,1281190333,28,1263632214,-17558119
1668132875,204768,true,1280806053,28,1263505863,-17300190
1668132887,204772,true,1280293858,28,1263505863,-16787995
1668132911,204775,true,1279909847,28,1263253200,-16656647
1668132959,204778,true,1279525951,28,1262748025,-16777926
1668133043,204782,true,1279014268,28,1261738281,-17275987
1668133139,204785,true,1278630641,28,1260603284,-18027357
1668133451,204788,true,1278247128,28,1257204416,-21042712
1668133583,204792,true,1277735957,28,1255822320,-21913637
1668133595,204795,true,1277352713,28,1255696751,-21655962
1668133859,204797,true,1277097281,28,1254190893,-22906388
1668133871,204799,true,1276841900,28,1254190893,-22651007
1668133883,204802,true,1276458924,28,1254065487,-22393437
1668134051,204805,true,1276076063,28,1253563986,-22512077
1668134183,204807,true,1275820886,28,1252812111,-23008775
1668134243,204809,true,1275565760,28,1252561586,-23004174
1668134255,204811,true,1275310685,28,1252436342,-22874343
1668134339,204814,true,1274928168,28,1252060687,-22867481
1668134351,204816,true,1274673221,28,1251935493,-22737728
1668134399,204818,true,1274418324,28,1251685143,-22733181
1668134507,204821,true,1274036075,28,1250934395,-23101680
1668134591,204824,true,1273653941,28,1250559190,-23094751
1668134831,204826,true,1273399248,28,1250559190,-22840058
1668135047,204828,true,1273144607,28,1251059489,-22085118
1668135167,204831,true,1272762740,28,1251184595,-21578145
1668135179,204833,true,1272508225,28,1251184595,-21323630
1668135443,204836,true,1272126549,28,1251184595,-20941954
1668135455,204839,true,1271744987,28,1251059489,-20685498
1668135515,204842,true,1271363540,28,1250934395,-20429145
1668135527,204845,true,1270982207,28,1250934395,-20047812
1668135587,204847,true,1270728049,28,1250809314,-19918735
1668135947,204850,true,1270346907,28,1250059091,-20287816
1668135959,204853,true,1269965879,28,1249934098,-20031781
1668135971,204856,true,1269584966,28,1249934098,-19650868
1668135983,204859,true,1269204166,28,1249934098,-19270068
1668136007,204863,true,1268696611,28,1249809117,-18887494
1668136067,204867,true,1268189260,28,1249309318,-18879942
1668136079,204870,true,1267808879,28,1249184400,-18624479
1668136091,204874,true,1267301882,28,1249059494,-18242388
1668136247,204879,true,1266668421,28,1247312121,-19356300
1668136283,204884,true,1266035277,28,1246938003,-19097274
1668136295,204887,true,1265655542,28,1246813321,-18842221
1668136307,204891,true,1265149407,28,1246688652,-18460755
1668136331,204896,true,1264517022,28,1246563996,-17953026
1668136439,204900,true,1264011341,28,1245567193,-18444148
1668136463,204904,true,1263505863,28,1245442649,-18063214
1668136475,204908,true,1263000587,28,1245318117,-17682470
1668136535,204914,true,1262243052,28,1244820115,-17422937
1668136559,204919,true,1261612120,28,1244571188,-17040932
1668136835,204923,true,1261107601,28,1242208866,-18898735
1668136847,204926,true,1260729344,28,1242084657,-18644687
1668136871,204932,true,1259973171,28,1241836278,-18136893
1668136895,204937,true,1259343374,28,1241587948,-17755426
1668136907,204941,true,1258839762,28,1241463801,-17375961
1668136919,204945,true,1258336352,28,1241339667,-16996685
1668136955,204952,true,1257455869,28,1240843255,-16612614
1668137051,204957,true,1256827330,28,1239727055,-17100275
1668137315,204963,true,1256073497,28,1235766466,-20307031
1668137327,204967,true,1255571193,28,1235642902,-19928291
1668137351,204973,true,1254818114,28,1235272283,-19545831
1668137459,204978,true,1254190893,28,1233667553,-20523340
1668137615,204983,true,1253563986,28,1231572204,-21991782
1668137843,204987,true,1253062686,28,1228620123,-24442563
1668137855,204993,true,1252311111,28,1228497273,-23813838
1668137903,204998,true,1251685143,28,1228251610,-23433533
1668137915,205003,true,1251059489,28,1228128797,-22930692
1668137951,205006,true,1250684246,28,1228005997,-22678249
1668137963,205012,true,1249934098,28,1228005997,-21928101
1668138011,205016,true,1249434249,28,1227883209,-21551040
1668138035,205020,true,1248934600,28,1227883209,-21051391
1668138047,205021,true,1248809719,28,1227883209,-20926510
1668138059,205026,true,1248185502,28,1228005997,-20179505
1668138083,205029,true,1247811121,28,1228005997,-19805124
1668138107,205032,true,1247436853,28,1228005997,-19430856
1668138119,205033,true,1247312121,28,1228005997,-19306124
1668138203,205037,true,1246813321,28,1228128797,-18684524
1668138275,205038,true,1246688652,28,1228128797,-18559855
1668139055,205041,true,1246314721,28,1230710449,-15604272
1668139283,205041,true,1246314721,28,1232434564,-13880157
1668139367,205046,true,1245691750,28,1232927611,-12764139
1668139415,205047,true,1245567193,28,1233174209,-12392984
1668139439,205050,true,1245193598,28,1233297527,-11896071
1668139619,205051,true,1245069091,28,1234161094,-10907997
1668139631,205055,true,1244571188,28,1234284510,-10286678
1668139643,205057,true,1244322311,28,1234284510,-10037801
1668139703,205060,true,1243949089,28,1234654833,-9294256
1668140003,205060,true,1243949089,28,1235148769,-8800320
1668140039,205064,true,1243451634,28,1235148769,-8302865
1668140075,205064,true,1243451634,28,1235148769,-8302865
1668140087,205066,true,1243202981,28,1235148769,-8054212
1668140111,205066,true,1243202981,28,1235272283,-7930698
1668140219,205069,true,1242830094,28,1235519350,-7310744
1668140615,205070,true,1242705824,28,1236260847,-6444977
1668141215,205072,true,1242457320,28,1237497664,-4959656
1668141239,205071,true,1242581566,28,1237497664,-5083902
1668141383,205074,true,1242208866,28,1237992738,-4216128
1668141419,205075,true,1242084657,28,1238116537,-3968120
1668141671,205078,true,1241712106,28,1238364173,-3347933
1668141683,205077,true,1241836278,28,1238364173,-3472105
1668141707,205080,true,1241463801,28,1238364173,-3099628
1668141767,205082,true,1241215546,28,1238364173,-2851373
1668141971,205086,true,1240719184,28,1237992738,-2726446
1668141983,205085,true,1240843255,28,1237868951,-2974304
1668142103,205089,true,1240347042,28,1237373927,-2973115
1668142319,205092,true,1239975012,28,1236137233,-3837779
1668142451,205095,true,1239603094,28,1235395811,-4207283
1668142535,205095,true,1239603094,28,1234901776,-4701318
1668142919,205099,true,1239107377,28,1232557807,-6549570
1668143003,205101,true,1238859593,28,1232064907,-6794686
1668143015,205105,true,1238364173,28,1232064907,-6299266
1668143027,205104,true,1238488009,28,1231941713,-6546296
1668143039,205107,true,1238116537,28,1231941713,-6174824
1668143051,205108,true,1237992738,28,1231941713,-6051025
1668143063,205111,true,1237621414,28,1231941713,-5679701
1668143075,205110,true,1237745176,28,1231818531,-5926645
1668143135,205112,true,1237497664,28,1231818531,-5679133
1668143147,205113,true,1237373927,28,1231695362,-5678565
1668143243,205115,true,1237126489,28,1231695362,-5431127
1668143327,205113,true,1237373927,28,1231572204,-5801723
1668143339,205115,true,1237126489,28,1231572204,-5554285
1668143555,205116,true,1237002789,28,1231818531,-5184258
1668143663,205117,true,1236879101,28,1231941713,-4937388
1668143939,205116,true,1237002789,28,1232927611,-4075178
1668144035,205118,true,1236755426,28,1233544199,-3211227
1668144083,205119,true,1236631763,28,1233790920,-2840843
1668144107,205121,true,1236384473,28,1233914299,-2470174
1668144215,205120,true,1236508112,28,1234654833,-1853279
1668144347,205122,true,1236260847,28,1235519350,-741497
1668144383,205123,true,1236137233,28,1235642902,-494331
1668144443,205125,true,1235890043,28,1236137233,247190
1668144647,205123,true,1236137233,28,1237621414,1484181
1668144695,205125,true,1235890043,28,1238116537,2226494
1668144827,205126,true,1235766466,28,1239231288,3464822
1668144899,205127,true,1235642902,28,1239727055,4084153
1668145031,205125,true,1235890043,28,1240595124,4705081
1668145043,205127,true,1235642902,28,1240719184,5076282
1668145079,205127,true,1235642902,28,1240967340,5324438
1668145115,205128,true,1235519350,28,1241215546,5696196
1668145127,205125,true,1235890043,28,1241339667,5449624
1668145451,205127,true,1235642902,28,1243202981,7560079
1668145511,205127,true,1235642902,28,1243451634,7808732
1668145631,205128,true,1235519350,28,1244197891,8678541
1668145643,205125,true,1235890043,28,1244322311,8432268
1668145667,205126,true,1235766466,28,1244571188,8804722
1668145691,205125,true,1235890043,28,1244944597,9054554
1668145715,205125,true,1235890043,28,1245193598,9303555
1668145883,205120,true,1236508112,28,1247561596,11053484
1668145919,205121,true,1236384473,28,1248060696,11676223
1668145991,205119,true,1236631763,28,1249059494,12427731
1668146411,205118,true,1236755426,28,1254943596,18188170
1668146423,205113,true,1237373927,28,1255069090,17695163
1668146495,205112,true,1237497664,28,1255947902,18450238
1668146615,205110,true,1237745176,28,1257330136,19584960
1668146663,205108,true,1237992738,28,1257958927,19966189
1668146699,205103,true,1238611858,28,1258336352,19724494
1668146711,205103,true,1238611858,28,1258462186,19850328
1668146819,205101,true,1238859593,28,1259721215,20861622
1668147047,205099,true,1239107377,28,1262116840,23009463
1668147131,205095,true,1239603094,28,1263000587,23397493
1668147383,205094,true,1239727055,28,1265655542,25928487
1668147395,205091,true,1240099010,28,1265782108,25683098
1668147407,205090,true,1240223020,28,1265782108,25559088
1668147419,205085,true,1240843255,28,1265908686,25065431
1668147467,205085,true,1240843255,28,1266161881,25318626
1668147479,205083,true,1241091436,28,1266161881,25070445
1668147491,205082,true,1241215546,28,1266161881,24946335
1668147683,205077,true,1241836278,28,1265402449,23566171
1668147695,205077,true,1241836278,28,1265402449,23566171
1668147707,205074,true,1242208866,28,1265275922,23067056
1668147779,205072,true,1242457320,28,1264896415,22439095
1668148007,205069,true,1242830094,28,1263000587,20170493
1668148319,205069,true,1242830094,28,1260351201,17521107
1668148415,205066,true,1243202981,28,1259595255,16392274
1668148427,205064,true,1243451634,28,1259469308,16017674
1668148463,205061,true,1243824706,28,1259091543,15266837
1668148499,205061,true,1243824706,28,1258839762,15015056
1668148511,205058,true,1244197891,28,1258713891,14516000
1668148547,205056,true,1244446743,28,1258462186,14015443
1668148583,205053,true,1244820115,28,1258210531,13390416
1668148631,205052,true,1244944597,28,1257833144,12888547
1668148643,205050,true,1245193598,28,1257833144,12639546
1668148655,205048,true,1245442649,28,1257833144,12390495
1668148835,205044,true,1245940901,28,1257330136,11389235
1668148967,205044,true,1245940901,28,1256953012,11012111
1668149111,205042,true,1246190102,28,1256576002,10385900
1668149219,205040,true,1246439352,28,1256324724,9885372
1668149255,205037,true,1246813321,28,1256324724,9511403
1668149279,205036,true,1246938003,28,1256324724,9386721
1668149819,205035,true,1247062696,28,1258713891,11651195
1668150047,205033,true,1247312121,28,1260225179,12913058
1668150059,205029,true,1247811121,28,1260351201,12540080
1668150119,205029,true,1247811121,28,1260729344,12918223
1668150131,205027,true,1248060696,28,1260729344,12668648
1668150143,205025,true,1248310320,28,1260855417,12545097
1668150275,205022,true,1248684851,28,1261107601,12422750
1668150347,205022,true,1248684851,28,1261233712,12548861
1668150359,205020,true,1248934600,28,1261233712,12299112
1668150395,205019,true,1249059494,28,1261233712,12174218
1668150419,205017,true,1249309318,28,1261233712,11924394
1668150719,205016,true,1249434249,28,1260351201,10916952
1668150755,205014,true,1249684149,28,1260225179,10541030
1668150767,205013,true,1249809117,28,1260225179,10416062
1668150803,205011,true,1250059091,28,1260099169,10040078
1668150815,205011,true,1250059091,28,1260099169,10040078
1668150827,205009,true,1250309116,28,1260099169,9790053
1668150839,205007,true,1250559190,28,1260099169,9539979
1668150863,205005,true,1250809314,28,1260099169,9289855
1668150875,205005,true,1250809314,28,1260099169,9289855
1668150887,205003,true,1251059489,28,1260099169,9039680
1668150935,205000,true,1251434844,28,1260099169,8664325
1668150947,204998,true,1251685143,28,1260099169,8414026
1668150959,204997,true,1251810312,28,1260099169,8288857
1668150971,204995,true,1252060687,28,1260099169,8038482
1668150983,204992,true,1252436342,28,1260099169,7662827
1668150995,204989,true,1252812111,28,1260225179,7413068
1668151007,204987,true,1253062686,28,1260225179,7162493
1668151175,204982,true,1253689342,28,1261738281,8048939
1668151319,204979,true,1254065487,28,1262874300,8808813
1668151331,204976,true,1254441744,28,1263000587,8558843
1668152003,204974,true,1254692645,28,1267935660,13243015
1668152483,204969,true,1255320117,28,1273017305,17697188
1668152495,204965,true,1255822320,28,1273144607,17322287
1668152519,204962,true,1256199105,28,1273399248,17200143
1668152543,204961,true,1256324724,28,1273653941,17329217
1668152555,204956,true,1256953012,28,1273781306,16828294
1668153023,204952,true,1257455869,28,1275693316,18237447
1668153119,204950,true,1257707373,28,1275693316,17985943
1668153431,204948,true,1257958927,28,1276331291,18372364
1668153563,204944,true,1258462186,28,1276586570,18124384
1668153587,204940,true,1258965646,28,1276586570,17620924
1668153623,204937,true,1259343374,28,1276586570,17243196
1668153671,204936,true,1259469308,28,1276714228,17244920
1668153683,204932,true,1259973171,28,1276714228,16741057
1668153707,204929,true,1260351201,28,1276714228,16363027
1668153731,204926,true,1260729344,28,1276714228,15984884
1668153887,204926,true,1260729344,28,1276586570,15857226
1668153923,204922,true,1261233712,28,1276586570,15352858
1668154043,204919,true,1261612120,28,1276586570,14974450
1668154163,204917,true,1261864455,28,1276586570,14722115
1668154199,204916,true,1261990641,28,1276458924,14468283
1668154295,204912,true,1262495513,28,1276458924,13963411
1668154307,204909,true,1262874300,28,1276458924,13584624
1668154331,204907,true,1263126887,28,1276331291,13204404
1668154415,204908,true,1263000587,28,1276076063,13075476
1668154427,204904,true,1263505863,28,1276076063,12570200
1668154439,204901,true,1263884953,28,1276076063,12191110
1668154835,204900,true,1264011341,28,1274673221,10661880
1668154919,204901,true,1263884953,28,1274418324,10533371
1668155423,204897,true,1264390583,28,1272253762,7863179
1668155495,204895,true,1264643473,28,1271872162,7228689
1668155831,204895,true,1264643473,28,1270855122,6211649
1668155843,204894,true,1264769938,28,1271109306,6339368
1668155855,204891,true,1265149407,28,1271109306,5959899
1668156215,204887,true,1265655542,28,1272253762,6598220
1668156227,204886,true,1265782108,28,1272253762,6471654
1668156575,204886,true,1265782108,28,1273781306,7999198
1668156647,204884,true,1266035277,28,1274163479,8128202
1668156923,204882,true,1266288497,28,1275693316,9404819
1668157055,204881,true,1266415126,28,1276714228,10299102
1668157139,204881,true,1266415126,28,1277352713,10937587
1668157163,204879,true,1266668421,28,1277608196,10939775
1668157199,204876,true,1267048460,28,1277863731,10815271
1668157211,204876,true,1267048460,28,1277991517,10943057
1668157235,204876,true,1267048460,28,1278119316,11070856
1668157247,204874,true,1267301882,28,1278247128,10945246
1668157259,204872,true,1267555355,28,1278247128,10691773
1668157343,204872,true,1267555355,28,1278630641,11075286
1668157355,204873,true,1267428612,28,1278758504,11329892
1668157379,204871,true,1267682111,28,1278886380,11204269
1668157391,204869,true,1267935660,28,1278886380,10950720
1668157499,204869,true,1267935660,28,1279398011,11462351
1668157739,204870,true,1267808879,28,1279525951,11717072
1668157751,204868,true,1268062453,28,1279398011,11335558
1668157763,204866,true,1268316079,28,1279398011,11081932
1668157775,204867,true,1268189260,28,1279270084,11080824
1668157811,204869,true,1267935660,28,1279142170,11206510
1668157883,204866,true,1268316079,28,1278886380,10570301
1668157895,204864,true,1268569754,28,1278886380,10316626
1668157943,204864,true,1268569754,28,1278630641,10060887
1668158027,204865,true,1268442910,28,1278247128,9804218
1668158171,204863,true,1268696611,28,1277480448,8783837
1668158591,204860,true,1269077258,28,1275183166,6105908
1668158603,204859,true,1269204166,28,1275183166,5979000
1668158651,204860,true,1269077258,28,1274928168,5850910
1668158759,204858,true,1269331087,28,1274163479,4832392
1668159059,204855,true,1269711924,28,1271999349,2287425
1668159107,204853,true,1269965879,28,1271744987,1779108
1668159227,204854,true,1269838895,28,1271363540,1524645
1668159275,204852,true,1270092876,28,1271236417,1143541
1668159287,204849,true,1270473942,28,1271236417,762475
1668159299,204848,true,1270600989,28,1271236417,635428
1668159323,204849,true,1270473942,28,1271109306,635364
1668159335,204846,true,1270855122,28,1271109306,254184
1668159359,204844,true,1271109306,28,1271109306,0
1668159371,204843,true,1271236417,28,1271236417,0
1668159683,204844,true,1271109306,28,1272380987,1271681
1668159863,204842,true,1271363540,28,1273144607,1781067
1668159923,204839,true,1271744987,28,1273399248,1654261
1668159959,204839,true,1271744987,28,1273526588,1781601
1668159971,204840,true,1271617826,28,1273526588,1908762
1668160007,204838,true,1271872162,28,1273653941,1781779
1668160031,204835,true,1272253762,28,1273653941,1400179
1668160187,204835,true,1272253762,28,1274163479,1909717
1668160619,204836,true,1272126549,28,1275310685,3184136
1668160739,204834,true,1272380987,28,1275565760,3184773
1668160931,204831,true,1272762740,28,1275948468,3185728
1668160943,204830,true,1272890016,28,1275948468,3058452
1668161015,204831,true,1272762740,28,1276203670,3440930
1668161099,204829,true,1273017305,28,1276331291,3313986
1668161327,204825,true,1273526588,28,1275948468,2421880
1668161351,204824,true,1273653941,28,1275948468,2294527
1668161447,204825,true,1273526588,28,1275565760,2039172
1668161579,204823,true,1273781306,28,1275438216,1656910
1668161591,204820,true,1274163479,28,1275310685,1147206
1668161603,204819,true,1274290895,28,1275310685,1019790
1668161615,204821,true,1274036075,28,1275310685,1274610
1668161663,204819,true,1274290895,28,1275183166,892271
1668161675,204816,true,1274673221,28,1275183166,509945
1668161783,204816,true,1274673221,28,1274928168,254947
1668161795,204817,true,1274545766,28,1274800688,254922
1668161903,204816,true,1274673221,28,1274545766,-127455
1668161915,204814,true,1274928168,28,1274545766,-382402
1668161939,204814,true,1274928168,28,1274418324,-509844
1668162335,204816,true,1274673221,28,1272762740,-1910481
1668162443,204815,true,1274800688,28,1272380987,-2419701
1668162527,204813,true,1275055661,28,1271999349,-3056312
1668162647,204813,true,1275055661,28,1271490677,-3564984
1668162695,204816,true,1274673221,28,1271236417,-3436804
1668163319,204817,true,1274545766,28,1268569754,-5976012
1668163331,204815,true,1274800688,28,1268442910,-6357778
1668163343,204816,true,1274673221,28,1268442910,-6230311
1668163355,204819,true,1274290895,28,1268442910,-5847985
1668163367,204819,true,1274290895,28,1268316079,-5974816
1668163379,204817,true,1274545766,28,1268316079,-6229687
1668163523,204818,true,1274418324,28,1268189260,-6229064
1668163535,204820,true,1274163479,28,1268189260,-5974219
1668163547,204821,true,1274036075,28,1268189260,-5846815
1668163619,204818,true,1274418324,28,1268316079,-6102245
1668163811,204818,true,1274418324,28,1268823481,-5594843
1668163835,204821,true,1274036075,28,1268823481,-5212594
1668163931,204822,true,1273908684,28,1269077258,-4831426
1668164759,204820,true,1274163479,28,1271363540,-2799939
1668164855,204820,true,1274163479,28,1271617826,-2545653
1668164867,204822,true,1273908684,28,1271744987,-2163697
1668164879,204823,true,1273781306,28,1271744987,-2036319
1668165047,204821,true,1274036075,28,1272508225,-1527850
1668165059,204820,true,1274163479,28,1272635476,-1528003
1668165083,204822,true,1273908684,28,1272762740,-1145944
1668165107,204822,true,1273908684,28,1273017305,-891379
1668165299,204819,true,1274290895,28,1274290895,0
1668165347,204818,true,1274418324,28,1274673221,254897
1668165431,204820,true,1274163479,28,1275055661,892182
1668165575,204820,true,1274163479,28,1275820886,1657407
1668166043,204816,true,1274673221,28,1278630641,3957420
1668166079,204815,true,1274800688,28,1278758504,3957816
1668166115,204817,true,1274545766,28,1279014268,4468502
1668166139,204817,true,1274545766,28,1279014268,4468502
1668166415,204814,true,1274928168,28,1279781869,4853701
1668166427,204813,true,1275055661,28,1279781869,4726208
1668166439,204815,true,1274800688,28,1279781869,4981181
1668166487,204815,true,1274800688,28,1280037838,5237150
1668166523,204812,true,1275183166,28,1280165842,4982676
1668166535,204811,true,1275310685,28,1280165842,4855157
1668166547,204813,true,1275055661,28,1280165842,5110181
1668166559,204813,true,1275055661,28,1280293858,5238197
1668166583,204810,true,1275438216,28,1280421888,4983672
1668166595,204810,true,1275438216,28,1280549930,5111714
1668166631,204811,true,1275310685,28,1280677985,5367300
1668166715,204811,true,1275310685,28,1281190333,5879648
1668166727,204809,true,1275565760,28,1281190333,5624573
1668166739,204809,true,1275565760,28,1281318452,5752692
1668166763,204811,true,1275310685,28,1281318452,6007767
1668166775,204811,true,1275310685,28,1281318452,6007767
1668166787,204810,true,1275438216,28,1281446584,6008368
1668166823,204811,true,1275310685,28,1281446584,6135899
1668166955,204813,true,1275055661,28,1281062227,6006566
1668167183,204813,true,1275055661,28,1280037838,4982177
1668167279,204812,true,1275183166,28,1279653903,4470737
1668167291,204812,true,1275183166,28,1279525951,4342785
1668167339,204814,true,1274928168,28,1279270084,4341916
1668167375,204815,true,1274800688,28,1279014268,4213580
1668167531,204814,true,1274928168,28,1277991517,3063349
1668167579,204814,true,1274928168,28,1277735957,2807789
1668167939,204816,true,1274673221,28,1275438216,764995
1668168227,204816,true,1274673221,28,1274418324,-254897
1668168263,204815,true,1274800688,28,1274290895,-509793
1668168275,204815,true,1274800688,28,1274290895,-509793
1668168911,204815,true,1274800688,28,1272126549,-2674139
1668168995,204816,true,1274673221,28,1271999349,-2673872
1668169007,204815,true,1274800688,28,1271999349,-2801339
1668169427,204814,true,1274928168,28,1271744987,-3183181
1668169439,204814,true,1274928168,28,1271744987,-3183181
1668169547,204815,true,1274800688,28,1271744987,-3055701
1668169787,204814,true,1274928168,28,1271363540,-3564628
1668169883,204815,true,1274800688,28,1271236417,-3564271
1668169907,204815,true,1274800688,28,1271236417,-3564271
1668170159,204816,true,1274673221,28,1270982207,-3691014
1668170231,204815,true,1274800688,28,1270855122,-3945566
1668170255,204815,true,1274800688,28,1270855122,-3945566
1668170495,204815,true,1274800688,28,1270600989,-4199699
1668170711,204816,true,1274673221,28,1270473942,-4199279
1668170939,204815,true,1274800688,28,1270600989,-4199699
1668170963,204815,true,1274800688,28,1270600989,-4199699
1668171011,204815,true,1274800688,28,1270728049,-4072639
1668171023,204816,true,1274673221,28,1270728049,-3945172
1668171047,204815,true,1274800688,28,1270728049,-4072639
1668171071,204816,true,1274673221,28,1270728049,-3945172
1668171179,204816,true,1274673221,28,1271363540,-3309681
1668171251,204816,true,1274673221,28,1271872162,-2801059
1668171275,204815,true,1274800688,28,1271999349,-2801339
1668171335,204815,true,1274800688,28,1272508225,-2292463
1668171407,204814,true,1274928168,28,1273144607,-1783561
1668171659,204813,true,1275055661,28,1275565760,510099
1668171671,204812,true,1275183166,28,1275693316,510150
1668171695,204811,true,1275310685,28,1276076063,765378
1668171707,204810,true,1275438216,28,1276203670,765454
1668171911,204808,true,1275693316,28,1279142170,3448854
1668171935,204806,true,1275948468,28,1279398011,3449543
1668172031,204805,true,1276076063,28,1280934133,4858070
1668172103,204804,true,1276203670,28,1281959239,5755569
1668172139,204802,true,1276458924,28,1282472100,6013176
1668172151,204801,true,1276586570,28,1282600347,6013777
1668172175,204800,true,1276714228,28,1282856880,6142652
1668172343,204800,true,1276714228,28,1284525595,7811367
1668172367,204798,true,1276969584,28,1284782513,7812929
1668172379,204797,true,1277097281,28,1284910991,7813710
1668172583,204796,true,1277224990,28,1286839707,9614717
1668172595,204796,true,1277224990,28,1286968391,9743401
1668172631,204793,true,1277608196,28,1287483256,9875060
1668172727,204791,true,1277863731,28,1288771319,10907588
1668173003,204789,true,1278119316,28,1291738756,13619440
1668173267,204789,true,1278119316,28,1294324689,16205373
1668173423,204785,true,1278630641,28,1295619596,16988955
1668173435,204783,true,1278886380,28,1295619596,16733216
1668173567,204781,true,1279142170,28,1295878733,16736563
1668173795,204781,true,1279142170,28,1295749158,16606988
1668173903,204777,true,1279653903,28,1295619596,15965693
1668174023,204775,true,1279909847,28,1295878733,15968886
1668174191,204773,true,1280165842,28,1295878733,15712891
1668174275,204774,true,1280037838,28,1295878733,15840895
1668174539,204771,true,1280421888,28,1295360511,14938623
1668174599,204769,true,1280677985,28,1295101478,14423493
1668175043,204768,true,1280806053,28,1292384754,11578701
1668175055,204768,true,1280806053,28,1292255529,11449476
1668175067,204765,true,1281190333,28,1292126316,10935983
1668175079,204764,true,1281318452,28,1292126316,10807864
1668175163,204764,true,1281318452,28,1291222189,9903737
1668175175,204764,true,1281318452,28,1291093080,9774628
1668175235,204762,true,1281574728,28,1290447727,8872999
1668175247,204761,true,1281702886,28,1290447727,8744841
1668175295,204762,true,1281574728,28,1289931677,8356949
1668175307,204762,true,1281574728,28,1289931677,8356949
1668175319,204760,true,1281831056,28,1289802697,7971641
1668175343,204759,true,1281959239,28,1289415833,7456594
1668175355,204761,true,1281702886,28,1289286905,7584019
1668175367,204762,true,1281574728,28,1289157989,7583261
1668175391,204761,true,1281702886,28,1288642454,6939568
1668175703,204764,true,1281318452,28,1282472100,1153648
1668175715,204766,true,1281062227,28,1282215644,1153417
1668175739,204767,true,1280934133,28,1281831056,896923
1668175751,204766,true,1281062227,28,1281574728,512501
1668175763,204769,true,1280677985,28,1281318452,640467
1668175943,204770,true,1280549930,28,1278886380,-1663550
1668176051,204772,true,1280293858,28,1277224990,-3068868
1668176099,204772,true,1280293858,28,1276331291,-3962567
1668176135,204775,true,1279909847,28,1275693316,-4216531
1668176147,204777,true,1279653903,28,1275438216,-4215687
1668176159,204779,true,1279398011,28,1275183166,-4214845
1668176171,204780,true,1279270084,28,1274800688,-4469396
1668176183,204783,true,1278886380,28,1274545766,-4340614
1668176195,204785,true,1278630641,28,1274290895,-4339746
1668176219,204788,true,1278247128,28,1273653941,-4593187
1668176279,204790,true,1277991517,28,1272126549,-5864968
1668176315,204793,true,1277608196,28,1270982207,-6625989
1668176339,204796,true,1277224990,28,1270346907,-6878083
1668176351,204799,true,1276841900,28,1269965879,-6876021
1668176363,204801,true,1276586570,28,1269711924,-6874646
1668176375,204806,true,1275948468,28,1269331087,-6617381
1668176435,204810,true,1275438216,28,1267301882,-8136334
1668176447,204814,true,1274928168,28,1266921768,-8006400
1668176495,204817,true,1274545766,28,1265275922,-9269844
1668176507,204821,true,1274036075,28,1264896415,-9139660
1668176519,204826,true,1273399248,28,1264517022,-8882226
1668176531,204829,true,1273017305,28,1264137742,-8879563
1668176555,204831,true,1272762740,28,1263379525,-9383215
1668176567,204836,true,1272126549,28,1263000587,-9125962
1668176579,204840,true,1271617826,28,1262621763,-8996063
1668176591,204844,true,1271109306,28,1262116840,-8992466
1668176615,204847,true,1270728049,28,1261107601,-9620448
1668176639,204852,true,1270092876,28,1260225179,-9867697
1668176663,204857,true,1269458020,28,1259217452,-10240568
1668176675,204861,true,1268950363,28,1258588032,-10362331
1668176699,204865,true,1268442910,28,1257455869,-10987041
1668176711,204870,true,1267808879,28,1256953012,-10855867
1668176723,204875,true,1267175165,28,1256450357,-10724808
1668176735,204879,true,1266668421,28,1255947902,-10720519
1668176747,204883,true,1266161881,28,1255445649,-10716232
1668176759,204887,true,1265655542,28,1254943596,-10711946
1668176771,204892,true,1265022904,28,1254441744,-10581160
1668176783,204896,true,1264517022,28,1253940093,-10576929
1668176795,204900,true,1264011341,28,1253438642,-10572699
1668176819,204904,true,1263505863,28,1252311111,-11194752
1668176831,204910,true,1262748025,28,1251810312,-10937713
1668176843,204914,true,1262243052,28,1251309713,-10933339
1668176879,204917,true,1261864455,28,1249809117,-12055338
1668176891,204922,true,1261233712,28,1249309318,-11924394
1668176915,204927,true,1260603284,28,1248310320,-12292964
1668176999,204930,true,1260225179,28,1245069091,-15156088
1668177023,204934,true,1259721215,28,1244073484,-15647731
1668177035,204939,true,1259091543,28,1243575979,-15515564
1668177059,204944,true,1258462186,28,1242581566,-15880620
1668177119,204948,true,1257958927,28,1240223020,-17735907
1668177215,204952,true,1257455869,28,1237250202,-20205667
1668177227,204957,true,1256827330,28,1236879101,-19948229
1668177299,204961,true,1256324724,28,1235025266,-21299458
1668177311,204966,true,1255696751,28,1234778298,-20918453
1668177371,204968,true,1255445649,28,1233297527,-22148122
1668177407,204973,true,1254818114,28,1232434564,-22383550
1668177479,204978,true,1254190893,28,1230710449,-23480444
1668177515,204983,true,1253563986,28,1229849296,-23714690
1668177575,204987,true,1253062686,28,1228251610,-24811076
1668177731,204992,true,1252436342,28,1223838074,-28598268
1668177743,204997,true,1251810312,28,1223593343,-28216969
1668177911,205003,true,1251059489,28,1219562342,-31497147
1668177923,205007,true,1250559190,28,1219318466,-31240724
1668177935,205012,true,1249934098,28,1219074639,-30859459
1668177959,205016,true,1249434249,28,1218830860,-30603389
1668177995,205019,true,1249059494,28,1218587131,-30472363
1668178019,205024,true,1248435151,28,1218465284,-29969867
1668178031,205029,true,1247811121,28,1218465284,-29345837
1668178043,205033,true,1247312121,28,1218465284,-28846837
1668178055,205034,true,1247187403,28,1218587131,-28600272
1668178067,205038,true,1246688652,28,1218587131,-28101521
1668178079,205039,true,1246563996,28,1218952743,-27611253
1668178091,205040,true,1246439352,28,1219196546,-27242806
1668178103,205038,true,1246688652,28,1219440398,-27248254
1668178115,205040,true,1246439352,28,1219684298,-26755054
1668178127,205042,true,1246190102,28,1219928247,-26261855
1668178139,205045,true,1245816319,28,1220172245,-25644074
1668178151,205044,true,1245940901,28,1220294262,-25646639
1668178187,205045,true,1245816319,28,1221148724,-24667595
1668178223,205048,true,1245442649,28,1222003785,-23438864
1668178247,205051,true,1245069091,28,1222492660,-22576431
1668178295,205050,true,1245193598,28,1223838074,-21355524
1668178319,205052,true,1244944597,28,1224327683,-20616914
1668178355,205055,true,1244571188,28,1225184970,-19386218
1668178367,205058,true,1244197891,28,1225430019,-18767872
1668178391,205057,true,1244322311,28,1226042856,-18279455
1668178403,205059,true,1244073484,28,1226288077,-17785407
1668178487,205064,true,1243451634,28,1228497273,-14954361
1668178499,205067,true,1243078673,28,1228865859,-14212814
1668178511,205066,true,1243202981,28,1229234556,-13968425
1668178523,205068,true,1242954377,28,1229480415,-13473962
1668178619,205075,true,1242084657,28,1231449060,-10635597
1668178655,205078,true,1241712106,28,1232311333,-9400773
1668178667,205077,true,1241836278,28,1232557807,-9278471
1668178691,205079,true,1241587948,28,1233174209,-8413739
1668178715,205085,true,1240843255,28,1233790920,-7052335
1668178727,205086,true,1240719184,28,1234037690,-6681494
1668178739,205085,true,1240843255,28,1234407939,-6435316
1668178751,205086,true,1240719184,28,1234654833,-6064351
1668178787,205091,true,1240099010,28,1235766466,-4332544
1668178811,205092,true,1239975012,28,1236384473,-3590539
1668178823,205090,true,1240223020,28,1236755426,-3467594
1668178859,205090,true,1240223020,28,1237868951,-2354069
1668178871,205095,true,1239603094,28,1238240349,-1362745
1668178931,205094,true,1239727055,28,1240223020,495965
1668178943,205092,true,1239975012,28,1240595124,620112
1668179003,205091,true,1240099010,28,1242457320,2358310
1668179051,205094,true,1239727055,28,1243824706,4097651
1668179087,205093,true,1239851027,28,1244695645,4844618
1668179099,205091,true,1240099010,28,1245069091,4970081
1668179111,205091,true,1240099010,28,1245318117,5219107
1668179351,205095,true,1239603094,28,1250809314,11206220
1668179363,205096,true,1239479146,28,1251059489,11580343
1668179387,205094,true,1239727055,28,1251559987,11832932
1668179399,205093,true,1239851027,28,1251810312,11959285
1668179423,205099,true,1239107377,28,1252185893,13078516
1668179519,205100,true,1238983479,28,1253814711,14831232
1668179531,205097,true,1239355211,28,1253940093,14584882
1668179579,205095,true,1239603094,28,1254818114,15215020
1668179591,205100,true,1238983479,28,1255069090,16085611
1668179663,205100,true,1238983479,28,1256450357,17466878
1668179783,205095,true,1239603094,28,1258713891,19110797
1668179831,205092,true,1239975012,28,1259343374,19368362
1668179843,205096,true,1239479146,28,1259343374,19864228
1668180011,205095,true,1239603094,28,1258084723,18481629
1668180023,205090,true,1240223020,28,1257958927,17735907
1668180035,205086,true,1240719184,28,1257833144,17113960
1668180047,205090,true,1240223020,28,1257833144,17610124
1668180107,205086,true,1240719184,28,1257455869,16736685
1668180155,205080,true,1241463801,28,1257330136,15866335
1668180323,205075,true,1242084657,28,1257707373,15622716
1668180359,205079,true,1241587948,28,1258084723,16496775
1668180371,205075,true,1242084657,28,1258210531,16125874
1668180383,205070,true,1242705824,28,1258336352,15630528
1668180407,205065,true,1243327301,28,1258588032,15260731
1668180431,205068,true,1242954377,28,1258965646,16011269
1668180479,205063,true,1243575979,28,1259469308,15893329
1668180503,205056,true,1244446743,28,1259721215,15274472
1668180635,205050,true,1245193598,28,1260603284,15409686
1668180647,205052,true,1244944597,28,1260729344,15784747
1668180671,205046,true,1245691750,28,1260729344,15037594
1668180695,205040,true,1246439352,28,1260855417,14416065
1668180707,205033,true,1247312121,28,1260855417,13543296
1668180719,205034,true,1247187403,28,1260855417,13668014
1668180743,205029,true,1247811121,28,1260855417,13044296
1668180779,205022,true,1248684851,28,1260981503,12296652
1668180791,205016,true,1249434249,28,1260981503,11547254
1668180839,205018,true,1249184400,28,1261107601,11923201
1668180947,205013,true,1249809117,28,1261359835,11550718
1668180959,205007,true,1250559190,28,1261485971,10926781
1668180971,205001,true,1251309713,28,1261485971,10176258
1668180983,205003,true,1251059489,28,1261485971,10426482
1668180995,204998,true,1251685143,28,1261485971,9800828
1668181031,204992,true,1252436342,28,1261612120,9175778
1668181043,204986,true,1253187992,28,1261612120,8424128
1668181055,204989,true,1252812111,28,1261612120,8800009
1668181091,204984,true,1253438642,28,1261612120,8173478
1668181247,204979,true,1254065487,28,1262116840,8051353
1668181571,204973,true,1254818114,28,1263126887,8308773
1668181583,204976,true,1254441744,28,1263126887,8685143
1668181595,204971,true,1255069090,28,1263126887,8057797
1668181607,204965,true,1255822320,28,1263000587,7178267
1668181619,204960,true,1256450357,28,1263000587,6550230
1668181679,204962,true,1256199105,28,1262874300,6675195
1668181691,204958,true,1256701660,28,1262874300,6172640
1668181715,204953,true,1257330136,28,1262874300,5544164
1668181811,204948,true,1257958927,28,1262874300,4915373
1668181823,204950,true,1257707373,28,1262874300,5166927
1668181979,204946,true,1258210531,28,1262369276,4158745
1668182063,204940,true,1258965646,28,1262116840,3151194
1668182159,204935,true,1259595255,28,1261612120,2016865
1668182171,204938,true,1259217452,28,1261612120,2394668
1668182195,204934,true,1259721215,28,1261359835,1638620
1668182207,204928,true,1260477236,28,1261233712,756476
1668182231,204924,true,1260981503,28,1261107601,126098
1668182279,204926,true,1260729344,28,1260603284,-126060
1668182459,204923,true,1261107601,28,1258839762,-2267839
1668182531,204921,true,1261359835,28,1258336352,-3023483
1668182555,204917,true,1261864455,28,1258084723,-3779732
1668182615,204921,true,1261359835,28,1257581615,-3778220
1668182639,204918,true,1261738281,28,1257455869,-4282412
1668182651,204917,true,1261864455,28,1257455869,-4408586
1668182771,204915,true,1262116840,28,1256953012,-5163828
1668182783,204922,true,1261233712,28,1256827330,-4406382
1668182819,204922,true,1261233712,28,1256827330,-4406382
1668182855,204923,true,1261107601,28,1256701660,-4405941
1668182867,204922,true,1261233712,28,1256701660,-4532052
1668182903,204928,true,1260477236,28,1256576002,-3901234
1668182975,204927,true,1260603284,28,1256450357,-4152927
1668182987,204928,true,1260477236,28,1256324724,-4152512
1668182999,204928,true,1260477236,28,1256324724,-4152512
1668183023,204934,true,1259721215,28,1256199105,-3522110
1668183059,204934,true,1259721215,28,1256073497,-3647718
1668183095,204935,true,1259595255,28,1255947902,-3647353
1668183107,204935,true,1259595255,28,1255947902,-3647353
1668183167,204941,true,1258839762,28,1255696751,-3143011
1668183179,204941,true,1258839762,28,1255696751,-3143011
1668183191,204941,true,1258839762,28,1255571193,-3268569
1668183203,204941,true,1258839762,28,1255445649,-3394113
1668183215,204946,true,1258210531,28,1255445649,-2764882
1668183299,204946,true,1258210531,28,1254818114,-3392417
1668183347,204946,true,1258210531,28,1254441744,-3768787
1668183371,204946,true,1258210531,28,1254190893,-4019638
1668183503,204949,true,1257833144,28,1253062686,-4770458
1668183515,204949,true,1257833144,28,1253062686,-4770458
1668183527,204949,true,1257833144,28,1252937392,-4895752
1668183587,204949,true,1257833144,28,1252311111,-5522033
1668183623,204952,true,1257455869,28,1252060687,-5395182
1668183635,204952,true,1257455869,28,1251935493,-5520376
1668183731,204953,true,1257330136,28,1251059489,-6270647
1668183815,204953,true,1257330136,28,1250309116,-7021020
1668184043,204958,true,1256701660,28,1248060696,-8640964
1668184067,204958,true,1256701660,28,1247935902,-8765758
1668184163,204959,true,1256576002,28,1247062696,-9513306
1668184187,204959,true,1256576002,28,1246813321,-9762681
1668184199,204964,true,1255947902,28,1246688652,-9259250
1668184283,204966,true,1255696751,28,1245691750,-10005001
1668184307,204968,true,1255445649,28,1245442649,-10003000
1668184343,204968,true,1255445649,28,1245069091,-10376558
1668184463,204973,true,1254818114,28,1243824706,-10993408
1668184631,204974,true,1254692645,28,1242084657,-12607988
1668184679,204975,true,1254567188,28,1241712106,-12855082
1668184691,204975,true,1254567188,28,1241587948,-12979240
1668184799,204978,true,1254190893,28,1240967340,-13223553
1668185387,204978,true,1254190893,28,1239975012,-14215881
1668185399,204979,true,1254065487,28,1240099010,-13966477
1668185411,204979,true,1254065487,28,1240099010,-13966477
1668185459,204980,true,1253940093,28,1240223020,-13717073
1668185507,204978,true,1254190893,28,1240347042,-13843851
1668185699,204978,true,1254190893,28,1241091436,-13099457
1668186107,204978,true,1254190893,28,1243327301,-10863592
1668186155,204980,true,1253940093,28,1243700336,-10239757
1668186263,204978,true,1254190893,28,1244322311,-9868582
1668186299,204980,true,1253940093,28,1244571188,-9368905
1668186491,204980,true,1253940093,28,1245816319,-8123774
1668186575,204981,true,1253814711,28,1246190102,-7624609
1668186611,204980,true,1253940093,28,1246314721,-7625372
1668186623,204982,true,1253689342,28,1246314721,-7374621
1668186635,204983,true,1253563986,28,1246439352,-7124634
1668186647,204984,true,1253438642,28,1246439352,-6999290
1668186659,204984,true,1253438642,28,1246563996,-6874646
1668186719,204985,true,1253313311,28,1247062696,-6250615
1668186791,204986,true,1253187992,28,1247686352,-5501640
1668186803,204987,true,1253062686,28,1247811121,-5251565
1668186851,204987,true,1253062686,28,1248060696,-5001990
1668186887,204988,true,1252937392,28,1248435151,-4502241
1668186911,204990,true,1252686842,28,1248559995,-4126847
1668186923,204992,true,1252436342,28,1248684851,-3751491
1668186971,204992,true,1252436342,28,1249059494,-3376848
1668186995,204993,true,1252311111,28,1249184400,-3126711
1668187115,204994,true,1252185893,28,1250184097,-2001796
1668187139,204997,true,1251810312,28,1250434147,-1376165
1668187499,204997,true,1251810312,28,1252185893,375581
1668187775,204998,true,1251685143,28,1253313311,1628168
1668187907,204998,true,1251685143,28,1253814711,2129568
1668188051,205000,true,1251434844,28,1254441744,3006900
1668188303,205000,true,1251434844,28,1255445649,4010805
1668188867,205001,true,1251309713,28,1256073497,4763784
1668188879,205002,true,1251184595,28,1256073497,4888902
1668188963,205004,true,1250934395,28,1256199105,5264710
1668188975,205003,true,1251059489,28,1256199105,5139616
1668188987,205003,true,1251059489,28,1256199105,5139616
1668189011,205004,true,1250934395,28,1256324724,5390329
1668189095,205004,true,1250934395,28,1256701660,5767265
1668189179,205003,true,1251059489,28,1257078708,6019219
1668189191,205002,true,1251184595,28,1257078708,5894113
1668189203,205002,true,1251184595,28,1257204416,6019821
1668189215,205002,true,1251184595,28,1257204416,6019821
1668189239,205001,true,1251309713,28,1257330136,6020423
1668189275,205000,true,1251434844,28,1257581615,6146771
1668189287,205000,true,1251434844,28,1257707373,6272529
1668189311,205000,true,1251434844,28,1257833144,6398300
1668189323,204998,true,1251685143,28,1257958927,6273784
1668189335,204996,true,1251935493,28,1257958927,6023434
1668189359,204996,true,1251935493,28,1258210531,6275038
1668189383,204995,true,1252060687,28,1258336352,6275665
1668189407,204993,true,1252311111,28,1258588032,6276921
1668189479,204992,true,1252436342,28,1259217452,6781110
1668189503,204991,true,1252561586,28,1259469308,6907722
1668189527,204991,true,1252561586,28,1259721215,7159629
1668189551,204989,true,1252812111,28,1259847187,7035076
1668189671,204988,true,1252937392,28,1260981503,8044111
1668189683,204988,true,1252937392,28,1261107601,8170209
1668189707,204987,true,1253062686,28,1261359835,8297149
1668189827,204985,true,1253313311,28,1262748025,9434714
1668190187,204982,true,1253689342,28,1267428612,13739270
1668190415,204981,true,1253814711,28,1270346907,16532196
1668190475,204981,true,1253814711,28,1271109306,17294595
1668190487,204978,true,1254190893,28,1271236417,17045524
1668190511,204976,true,1254441744,28,1271617826,17176082
1668190523,204975,true,1254567188,28,1271744987,17177799
1668190535,204974,true,1254692645,28,1271872162,17179517
1668190811,204972,true,1254943596,28,1274928168,19984572
1668190883,204969,true,1255320117,28,1275438216,20118099
1668190895,204969,true,1255320117,28,1275438216,20118099
1668190967,204968,true,1255445649,28,1275820886,20375237
1668191063,204966,true,1255696751,28,1276203670,20506919
1668191603,204964,true,1255947902,28,1276841900,20893998
1668191987,204963,true,1256073497,28,1275948468,19874971
1668192131,204962,true,1256199105,28,1275565760,19366655
1668192155,204960,true,1256450357,28,1275565760,19115403
1668192167,204958,true,1256701660,28,1275438216,18736556
1668192179,204957,true,1256827330,28,1275310685,18483355
1668192191,204958,true,1256701660,28,1275310685,18609025
1668192407,204956,true,1256953012,28,1273653941,16700929
1668192419,204953,true,1257330136,28,1273526588,16196452
1668192443,204953,true,1257330136,28,1273399248,16069112
1668192899,204953,true,1257330136,28,1270346907,13016771
1668192911,204952,true,1257455869,28,1270219885,12764016
1668193271,204949,true,1257833144,28,1268062453,10229309
1668193283,204948,true,1257958927,28,1267935660,9976733
1668193295,204948,true,1257958927,28,1267808879,9849952
1668193343,204947,true,1258084723,28,1267301882,9217159
1668193367,204946,true,1258210531,28,1266921768,8711237
1668193667,204946,true,1258210531,28,1263000587,4790056
1668193715,204945,true,1258336352,28,1262369276,4032924
1668193823,204943,true,1258588032,28,1261233712,2645680
1668193835,204942,true,1258713891,28,1261107601,2393710
1668193847,204942,true,1258713891,28,1261107601,2393710
1668193859,204941,true,1258839762,28,1260981503,2141741
1668193871,204938,true,1259217452,28,1260855417,1637965
1668193883,204937,true,1259343374,28,1260855417,1512043
1668193991,204935,true,1259595255,28,1260603284,1008029
1668194015,204934,true,1259721215,28,1260603284,882069
1668194087,204931,true,1260099169,28,1260603284,504115
1668194819,204930,true,1260225179,28,1261233712,1008533
1668195095,204928,true,1260477236,28,1261612120,1134884
1668195443,204926,true,1260729344,28,1264264156,3534812
1668195491,204923,true,1261107601,28,1264517022,3409421
1668195599,204921,true,1261359835,28,1265022904,3663069
1668195659,204920,true,1261485971,28,1265149407,3663436
1668196367,204919,true,1261612120,28,1263758577,2146457
1668196415,204916,true,1261990641,28,1263758577,1767936
1668196547,204914,true,1262243052,28,1263505863,1262811
1668196619,204912,true,1262495513,28,1263505863,1010350
1668196655,204912,true,1262495513,28,1263632214,1136701
1668196763,204909,true,1262874300,28,1264011341,1137041
1668196943,204906,true,1263253200,28,1264643473,1390273
1668196955,204904,true,1263505863,28,1264769938,1264075
1668197423,204903,true,1263632214,28,1266288497,2656283
1668197483,204902,true,1263758577,28,1266541767,2783190
1668197495,204900,true,1264011341,28,1266541767,2530426
1668197531,204898,true,1264264156,28,1266668421,2404265
1668197555,204898,true,1264264156,28,1266668421,2404265
1668197627,204897,true,1264390583,28,1266795088,2404505
1668197723,204895,true,1264643473,28,1266795088,2151615
1668197735,204893,true,1264896415,28,1266795088,1898673
1668197759,204894,true,1264769938,28,1266795088,2025150
1668197843,204894,true,1264769938,28,1266668421,1898483
1668198107,204893,true,1264896415,28,1266035277,1138862
1668198323,204891,true,1265149407,28,1265528989,379582
1668198803,204891,true,1265149407,28,1262116840,-3032567
1668198815,204892,true,1265022904,28,1261990641,-3032263
1668199127,204892,true,1265022904,28,1259469308,-5553596
1668199151,204890,true,1265275922,28,1259217452,-6058470
1668199163,204892,true,1265022904,28,1259091543,-5931361
1668199175,204892,true,1265022904,28,1258965646,-6057258
1668199187,204893,true,1264896415,28,1258713891,-6182524
1668199199,204893,true,1264896415,28,1258588032,-6308383
1668199247,204895,true,1264643473,28,1257833144,-6810329
1668199283,204896,true,1264517022,28,1257330136,-7186886
1668199379,204897,true,1264390583,28,1256073497,-8317086
1668199595,204897,true,1264390583,28,1253814711,-10575872
1668199607,204898,true,1264264156,28,1253689342,-10574814
1668199703,204899,true,1264137742,28,1252937392,-11200350
1668199751,204900,true,1264011341,28,1252686842,-11324499
1668199811,204900,true,1264011341,28,1252185893,-11825448
1668199943,204901,true,1263884953,28,1251309713,-12575240
1668200087,204902,true,1263758577,28,1250434147,-13324430
1668200135,204903,true,1263632214,28,1250059091,-13573123
1668200207,204903,true,1263632214,28,1249559193,-14073021
1668200219,204904,true,1263505863,28,1249434249,-14071614
1668200591,204905,true,1263379525,28,1247062696,-16316829
1668200627,204907,true,1263126887,28,1246813321,-16313566
1668200651,204907,true,1263126887,28,1246813321,-16313566
1668200915,204909,true,1262874300,28,1245816319,-17057981
1668201191,204909,true,1262874300,28,1246688652,-16185648
1668201227,204911,true,1262621763,28,1246813321,-15808442
1668201347,204911,true,1262621763,28,1247561596,-15060167
1668201491,204913,true,1262369276,28,1248310320,-14058956
1668201611,204913,true,1262369276,28,1248809719,-13559557
1668201659,204915,true,1262116840,28,1249059494,-13057346
1668201671,204914,true,1262243052,28,1249184400,-13058652
1668201707,204916,true,1261990641,28,1249434249,-12556392
1668201719,204916,true,1261990641,28,1249559193,-12431448
1668201731,204917,true,1261864455,28,1249559193,-12305262
1668201755,204917,true,1261864455,28,1249809117,-12055338
1668201767,204918,true,1261738281,28,1249934098,-11804183
1668201779,204918,true,1261738281,28,1250184097,-11554184
1668201971,204918,true,1261738281,28,1252686842,-9051439
1668202067,204917,true,1261864455,28,1253940093,-7924362
1668202187,204919,true,1261612120,28,1255445649,-6166471
1668202283,204919,true,1261612120,28,1256576002,-5036118
1668202295,204919,true,1261612120,28,1256701660,-4910460
1668202391,204919,true,1261612120,28,1257958927,-3653193
1668202415,204920,true,1261485971,28,1258210531,-3275440
1668202511,204921,true,1261359835,28,1259091543,-2268292
1668202571,204922,true,1261233712,28,1259721215,-1512497
1668202607,204922,true,1261233712,28,1260099169,-1134543
1668202715,204924,true,1260981503,28,1261107601,126098
1668202907,204924,true,1260981503,28,1263000587,2019084
1668202955,204926,true,1260729344,28,1263505863,2776519
1668203147,204925,true,1260855417,28,1265149407,4293990
1668203219,204927,true,1260603284,28,1265782108,5178824
1668203459,204927,true,1260603284,28,1267682111,7078827
1668203483,204928,true,1260477236,28,1267808879,7331643
1668203831,204928,true,1260477236,28,1267935660,7458424
1668204599,204929,true,1260351201,28,1268062453,7711252
1668205235,204928,true,1260477236,28,1268062453,7585217
1668205319,204930,true,1260225179,28,1268062453,7837274
1668205439,204929,true,1260351201,28,1268062453,7711252
1668205451,204931,true,1260099169,28,1268062453,7963284
1668205463,204930,true,1260225179,28,1268062453,7837274
1668205487,204932,true,1259973171,28,1268189260,8216089
1668205547,204930,true,1260225179,28,1268189260,7964081
1668205775,204931,true,1260099169,28,1268442910,8343741
1668205943,204929,true,1260351201,28,1268696611,8345410
1668205955,204930,true,1260225179,28,1268823481,8598302
1668206123,204929,true,1260351201,28,1269204166,8852965
1668206255,204928,true,1260477236,28,1269584966,9107730
1668206495,204926,true,1260729344,28,1270346907,9617563
1668206627,204927,true,1260603284,28,1270728049,10124765
1668206687,204926,true,1260729344,28,1270855122,10125778
1668206723,204925,true,1260855417,28,1270982207,10126790
1668206735,204923,true,1261107601,28,1270982207,9874606
1668206975,204923,true,1261107601,28,1271236417,10128816
1668207251,204921,true,1261359835,28,1271617826,10257991
1668207263,204920,true,1261485971,28,1271617826,10131855
1668207347,204918,true,1261738281,28,1271744987,10006706
1668207371,204918,true,1261738281,28,1271744987,10006706
1668207407,204916,true,1261990641,28,1271872162,9881521
1668207431,204915,true,1262116840,28,1271872162,9755322
1668207671,204913,true,1262369276,28,1272890016,10520740
1668207779,204913,true,1262369276,28,1273271921,10902645
1668208379,204912,true,1262495513,28,1275055661,12560148
1668208403,204912,true,1262495513,28,1275183166,12687653
1668208463,204909,true,1262874300,28,1275310685,12436385
1668208475,204910,true,1262748025,28,1275310685,12562660
1668208511,204909,true,1262874300,28,1275438216,12563916
1668208523,204909,true,1262874300,28,1275438216,12563916
1668208607,204906,true,1263253200,28,1275693316,12440116
1668208631,204906,true,1263253200,28,1275820886,12567686
1668208643,204906,true,1263253200,28,1275820886,12567686
1668209831,204906,true,1263253200,28,1274545766,11292566
1668209855,204903,true,1263632214,28,1274545766,10913552
1668209891,204903,true,1263632214,28,1274418324,10786110
1668209903,204903,true,1263632214,28,1274418324,10786110
1668209939,204903,true,1263632214,28,1274418324,10786110
1668209951,204901,true,1263884953,28,1274418324,10533371
1668209975,204901,true,1263884953,28,1274418324,10533371
1668210011,204900,true,1264011341,28,1274418324,10406983
1668210035,204900,true,1264011341,28,1274545766,10534425
1668210047,204898,true,1264264156,28,1274545766,10281610
1668210059,204898,true,1264264156,28,1274545766,10281610
1668210071,204897,true,1264390583,28,1274673221,10282638
1668210143,204895,true,1264643473,28,1274928168,10284695
1668210155,204892,true,1265022904,28,1274928168,9905264
1668210167,204892,true,1265022904,28,1274928168,9905264
1668210539,204891,true,1265149407,28,1276203670,11054263
1668210551,204889,true,1265402449,28,1276203670,10801221
1668210563,204886,true,1265782108,28,1276331291,10549183
1668210611,204885,true,1265908686,28,1276586570,10677884
1668210647,204884,true,1266035277,28,1276841900,10806623
1668210791,204882,true,1266288497,28,1277735957,11447460
1668210803,204879,true,1266668421,28,1277735957,11067536
1668211055,204877,true,1266921768,28,1279909847,12988079
1668211247,204876,true,1267048460,28,1281446584,14398124
1668211427,204873,true,1267428612,28,1282985166,15556554
1668211571,204870,true,1267808879,28,1284140314,16331435
1668211595,204867,true,1268189260,28,1284268728,16079468
1668211727,204864,true,1268569754,28,1285039482,16469728
1668211751,204861,true,1268950363,28,1285167986,16217623
1668211775,204858,true,1269331087,28,1285167986,15836899
1668211835,204855,true,1269711924,28,1285296503,15584579
1668212135,204853,true,1269965879,28,1285296503,15330624
1668212159,204850,true,1270346907,28,1285296503,14949596
1668212195,204847,true,1270728049,28,1285167986,14439937
1668212219,204844,true,1271109306,28,1285167986,14058680
1668212339,204843,true,1271236417,28,1285039482,13803065
1668212351,204840,true,1271617826,28,1284910991,13293165
1668212423,204837,true,1271999349,28,1284782513,12783164
1668212447,204835,true,1272253762,28,1284654047,12400285
1668212531,204834,true,1272380987,28,1284397155,12016168
1668212543,204831,true,1272762740,28,1284397155,11634415
1668212555,204828,true,1273144607,28,1284397155,11252548
1668212759,204826,true,1273399248,28,1283113464,9714216
1668212807,204825,true,1273526588,28,1282728607,9202019
1668212831,204823,true,1273781306,28,1282600347,8819041
1668213203,204821,true,1274036075,28,1280165842,6129767
1668213227,204819,true,1274290895,28,1280037838,5746943
1668213251,204818,true,1274418324,28,1279909847,5491523
1668213419,204816,true,1274673221,28,1278758504,4085283
1668213743,204814,true,1274928168,28,1277097281,2169113
1668213767,204813,true,1275055661,28,1276969584,1913923
1668213911,204812,true,1275183166,28,1276076063,892897
1668213923,204811,true,1275310685,28,1276076063,765378
1668213935,204810,true,1275438216,28,1275948468,510252
1668214259,204809,true,1275565760,28,1274418324,-1147436
1668214283,204810,true,1275438216,28,1274290895,-1147321
1668214847,204809,true,1275565760,28,1272380987,-3184773
1668215183,204808,true,1275693316,28,1271490677,-4202639
1668215507,204809,true,1275565760,28,1270600989,-4964771
1668215723,204809,true,1275565760,28,1270219885,-5345875
1668216011,204808,true,1275693316,28,1270219885,-5473431
1668216023,204808,true,1275693316,28,1270346907,-5346409
1668216047,204808,true,1275693316,28,1270346907,-5346409
1668216107,204809,true,1275565760,28,1270346907,-5218853
1668216311,204807,true,1275820886,28,1270346907,-5473979
1668216839,204807,true,1275820886,28,1270473942,-5346944
1668216983,204807,true,1275820886,28,1270600989,-5219897
1668217007,204808,true,1275693316,28,1270600989,-5092327
1668217067,204806,true,1275948468,28,1270600989,-5347479
1668217223,204806,true,1275948468,28,1270346907,-5601561
1668217487,204807,true,1275820886,28,1269965879,-5855007
1668217607,204808,true,1275693316,28,1269838895,-5854421
1668217631,204806,true,1275948468,28,1269838895,-6109573
1668217643,204806,true,1275948468,28,1269838895,-6109573
1668217655,204807,true,1275820886,28,1269838895,-5981991
1668217679,204807,true,1275820886,28,1269965879,-5855007
1668217919,204805,true,1276076063,28,1270219885,-5856178
1668218015,204805,true,1276076063,28,1270346907,-5729156
1668218483,204805,true,1276076063,28,1270855122,-5220941
1668218519,204806,true,1275948468,28,1270982207,-4966261
1668218627,204804,true,1276203670,28,1270982207,-5221463
1668219467,204804,true,1276203670,28,1272126549,-4077121
1668219503,204805,true,1276076063,28,1272126549,-3949514
1668219515,204805,true,1276076063,28,1272126549,-3949514
1668219551,204803,true,1276331291,28,1272126549,-4204742
1668219563,204803,true,1276331291,28,1272126549,-4204742
1668219647,204804,true,1276203670,28,1272126549,-4077121
1668219659,204804,true,1276203670,28,1272126549,-4077121
1668219683,204803,true,1276331291,28,1272253762,-4077529
1668219695,204803,true,1276331291,28,1272253762,-4077529
1668219707,204803,true,1276331291,28,1272253762,-4077529
1668219719,204804,true,1276203670,28,1272253762,-3949908
1668219755,204802,true,1276458924,28,1272380987,-4077937
1668219827,204802,true,1276458924,28,1272635476,-3823448
1668220007,204801,true,1276586570,28,1273144607,-3441963
1668220031,204801,true,1276586570,28,1273271921,-3314649
1668220271,204799,true,1276841900,28,1274418324,-2423576
1668220823,204799,true,1276841900,28,1277991517,1149617
1668220991,204798,true,1276969584,28,1279014268,2044684
1668221339,204798,true,1276969584,28,1281190333,4220749
1668221567,204796,true,1277224990,28,1282087435,4862445
1668221639,204797,true,1277097281,28,1282343865,5246584
1668221675,204796,true,1277224990,28,1282343865,5118875
1668221723,204797,true,1277097281,28,1282343865,5246584
1668221939,204796,true,1277224990,28,1282087435,4862445
1668221999,204797,true,1277097281,28,1281959239,4861958
1668222095,204796,true,1277224990,28,1281702886,4477896
1668222359,204798,true,1276969584,28,1280806053,3836469
1668222443,204797,true,1277097281,28,1280549930,3452649
1668222575,204797,true,1277097281,28,1279781869,2684588
1668222611,204797,true,1277097281,28,1279653903,2556622
1668222623,204798,true,1276969584,28,1279525951,2556367
1668222635,204796,true,1277224990,28,1279525951,2300961
1668222659,204797,true,1277097281,28,1279398011,2300730
1668222671,204797,true,1277097281,28,1279270084,2172803
1668222683,204798,true,1276969584,28,1279142170,2172586
1668222995,204798,true,1276969584,28,1276586570,-383014
1668223403,204799,true,1276841900,28,1273399248,-3442652
1668223427,204800,true,1276714228,28,1273144607,-3569621
1668223439,204802,true,1276458924,28,1272890016,-3568908
1668223451,204802,true,1276458924,28,1272762740,-3696184
1668223463,204805,true,1276076063,28,1272635476,-3440587
1668223583,204807,true,1275820886,28,1271109306,-4711580
1668223607,204810,true,1275438216,28,1270728049,-4710167
1668223763,204810,true,1275438216,28,1268950363,-6487853
1668223799,204814,true,1274928168,28,1268569754,-6358414
1668223835,204815,true,1274800688,28,1268189260,-6611428
1668224303,204816,true,1274673221,28,1263758577,-10914644
1668224315,204817,true,1274545766,28,1263758577,-10787189
1668224927,204820,true,1274163479,28,1261107601,-13055878
1668224939,204821,true,1274036075,28,1260981503,-13054572
1668224951,204822,true,1273908684,28,1260981503,-12927181
1668224963,204823,true,1273781306,28,1260981503,-12799803
1668224999,204826,true,1273399248,28,1260729344,-12669904
1668225011,204828,true,1273144607,28,1260729344,-12415263
1668225023,204830,true,1272890016,28,1260603284,-12286732
1668225035,204831,true,1272762740,28,1260603284,-12159456
1668225119,204834,true,1272380987,28,1260225179,-12155808
1668225407,204836,true,1272126549,28,1260099169,-12027380
1668225443,204837,true,1271999349,28,1260099169,-11900180
1668225455,204838,true,1271872162,28,1260099169,-11772993
1668225491,204841,true,1271490677,28,1260225179,-11265498
1668225659,204843,true,1271236417,28,1260351201,-10885216
1668225683,204844,true,1271109306,28,1260351201,-10758105
1668225839,204845,true,1270982207,28,1260351201,-10631006
1668226103,204848,true,1270600989,28,1260351201,-10249788
1668226367,204849,true,1270473942,28,1259973171,-10500771
1668226511,204850,true,1270346907,28,1259847187,-10499720
1668226643,204850,true,1270346907,28,1259595255,-10751652
1668226667,204853,true,1269965879,28,1259595255,-10370624
1668226679,204855,true,1269711924,28,1259595255,-10116669
1668226691,204855,true,1269711924,28,1259469308,-10242616
1668226787,204856,true,1269584966,28,1259343374,-10241592
1668226799,204859,true,1269204166,28,1259343374,-9860792
1668226859,204860,true,1269077258,28,1259343374,-9733884
1668226871,204860,true,1269077258,28,1259217452,-9859806
1668226883,204861,true,1268950363,28,1259217452,-9732911
1668227159,204865,true,1268442910,28,1258210531,-10232379
1668227195,204866,true,1268316079,28,1258210531,-10105548
1668227423,204866,true,1268316079,28,1258336352,-9979727
1668227447,204866,true,1268316079,28,1258336352,-9979727
1668227651,204870,true,1267808879,28,1258336352,-9472527
1668227735,204871,true,1267682111,28,1258210531,-9471580
1668227747,204870,true,1267808879,28,1258210531,-9598348
1668227759,204871,true,1267682111,28,1258210531,-9471580
1668228131,204873,true,1267428612,28,1258839762,-8588850
1668228299,204873,true,1267428612,28,1259091543,-8337069
1668228347,204872,true,1267555355,28,1259091543,-8463812
1668228611,204873,true,1267428612,28,1259721215,-7707397
1668228683,204875,true,1267175165,28,1259847187,-7327978
1668228719,204875,true,1267175165,28,1259973171,-7201994
1668228743,204875,true,1267175165,28,1260099169,-7075996
1668228839,204875,true,1267175165,28,1260477236,-6697929
1668229163,204878,true,1266795088,28,1261107601,-5687487
1668229175,204878,true,1266795088,28,1261107601,-5687487
1668229199,204878,true,1266795088,28,1260981503,-5813585
1668229211,204878,true,1266795088,28,1260981503,-5813585
1668229235,204881,true,1266415126,28,1260981503,-5433623
1668229259,204882,true,1266288497,28,1260981503,-5306994
1668229295,204882,true,1266288497,28,1260855417,-5433080
1668229319,204883,true,1266161881,28,1260855417,-5306464
1668229331,204885,true,1265908686,28,1260855417,-5053269
1668229343,204886,true,1265782108,28,1260729344,-5052764
1668229355,204886,true,1265782108,28,1260729344,-5052764
1668229367,204887,true,1265655542,28,1260729344,-4926198
1668229379,204890,true,1265275922,28,1260603284,-4672638
1668229415,204891,true,1265149407,28,1260351201,-4798206
1668229727,204892,true,1265022904,28,1258462186,-6560718
1668229763,204893,true,1264896415,28,1258210531,-6685884
1668229787,204896,true,1264517022,28,1257958927,-6558095
1668229835,204898,true,1264264156,28,1257581615,-6682541
1668229847,204899,true,1264137742,28,1257455869,-6681873
1668229871,204901,true,1263884953,28,1257204416,-6680537
1668229883,204904,true,1263505863,28,1257078708,-6427155
1668229895,204905,true,1263379525,28,1256953012,-6426513
1668229931,204907,true,1263126887,28,1256450357,-6676530
1668230015,204910,true,1262748025,28,1255320117,-7427908
1668230063,204913,true,1262369276,28,1254818114,-7551162
1668230075,204915,true,1262116840,28,1254567188,-7549652
1668230291,204917,true,1261864455,28,1251935493,-9928962
1668230363,204919,true,1261612120,28,1251184595,-10427525
1668230699,204922,true,1261233712,28,1248435151,-12798561
1668230723,204924,true,1260981503,28,1248185502,-12796001
1668230759,204926,true,1260729344,28,1247935902,-12793442
1668230771,204928,true,1260477236,28,1247811121,-12666115
1668230915,204931,true,1260099169,28,1246688652,-13410517
1668230987,204933,true,1259847187,28,1246190102,-13657085
1668231083,204935,true,1259595255,28,1245567193,-14028062
1668231095,204938,true,1259217452,28,1245567193,-13650259
1668231383,204941,true,1258839762,28,1244820115,-14019647
1668231431,204944,true,1258462186,28,1244695645,-13766541
1668231515,204945,true,1258336352,28,1244571188,-13765164
1668231791,204948,true,1257958927,28,1245193598,-12765329
1668231995,204951,true,1257581615,28,1246065495,-11516120
1668232043,204953,true,1257330136,28,1246314721,-11015415
1668232079,204955,true,1257078708,28,1246439352,-10639356
1668232091,204957,true,1256827330,28,1246563996,-10263334
1668232151,204960,true,1256450357,28,1246439352,-10011005
1668232163,204963,true,1256073497,28,1246439352,-9634145
1668232175,204964,true,1255947902,28,1246439352,-9508550
1668232847,204967,true,1255571193,28,1244446743,-11124450
1668233039,204970,true,1255194597,28,1243949089,-11245508
1668233051,204973,true,1254818114,28,1243949089,-10869025
1668233075,204974,true,1254692645,28,1243949089,-10743556
1668233087,204976,true,1254441744,28,1243824706,-10617038
1668233111,204979,true,1254065487,28,1243824706,-10240781
1668233147,204981,true,1253814711,28,1243824706,-9990005
1668233375,204981,true,1253814711,28,1243824706,-9990005
1668233387,204983,true,1253563986,28,1243824706,-9739280
1668233615,204985,true,1253313311,28,1243700336,-9612975
1668233651,204987,true,1253062686,28,1243700336,-9362350
1668233711,204987,true,1253062686,28,1243575979,-9486707
1668233831,204989,true,1252812111,28,1243327301,-9484810
1668233855,204989,true,1252812111,28,1243327301,-9484810
1668233867,204990,true,1252686842,28,1243327301,-9359541
1668233879,204990,true,1252686842,28,1243327301,-9359541
1668233915,204992,true,1252436342,28,1243327301,-9109041
1668233927,204992,true,1252436342,28,1243327301,-9109041
1668234119,204993,true,1252311111,28,1243824706,-8486405
1668234131,204994,true,1252185893,28,1243824706,-8361187
1668234239,204996,true,1251935493,28,1244322311,-7613182
1668234407,204996,true,1251935493,28,1245442649,-6492844
1668234419,204996,true,1251935493,28,1245567193,-6368300
1668234455,204997,true,1251810312,28,1245816319,-5993993
1668234479,204998,true,1251685143,28,1245940901,-5744242
1668234527,204999,true,1251559987,28,1246065495,-5494492
1668234599,204999,true,1251559987,28,1246439352,-5120635
1668234659,205000,true,1251434844,28,1246688652,-4746192
1668234803,205001,true,1251309713,28,1247561596,-3748117
1668234815,205001,true,1251309713,28,1247686352,-3623361
1668234839,205002,true,1251184595,28,1247811121,-3373474
1668234863,205002,true,1251184595,28,1248060696,-3123899
1668234923,205001,true,1251309713,28,1248559995,-2749718
1668235187,205001,true,1251309713,28,1250559190,-750523
1668235247,205002,true,1251184595,28,1250934395,-250200
1668235331,205002,true,1251184595,28,1251559987,375392
1668235475,205001,true,1251309713,28,1252561586,1251873
1668235631,205001,true,1251309713,28,1253689342,2379629
1668235655,205002,true,1251184595,28,1253814711,2630116
1668235667,205002,true,1251184595,28,1253940093,2755498
1668235691,205002,true,1251184595,28,1254065487,2880892
1668236099,205002,true,1251184595,28,1256324724,5140129
1668236111,205002,true,1251184595,28,1256324724,5140129
1668236123,205003,true,1251059489,28,1256324724,5265235
1668236171,205002,true,1251184595,28,1256576002,5391407
1668236231,205001,true,1251309713,28,1256701660,5391947
1668236579,205002,true,1251184595,28,1258839762,7655167
1668237023,205002,true,1251184595,28,1259343374,8158779
1668237347,205001,true,1251309713,28,1259721215,8411502
1668237359,204999,true,1251559987,28,1259721215,8161228
1668237371,205000,true,1251434844,28,1259721215,8286371
1668237383,205001,true,1251309713,28,1259721215,8411502
1668237551,204999,true,1251559987,28,1260351201,8791214
1668237563,204998,true,1251685143,28,1260351201,8666058
1668237767,204998,true,1251685143,28,1261612120,9926977
1668237815,204999,true,1251559987,28,1261864455,10304468
1668237851,204997,true,1251810312,28,1262116840,10306528
1668237899,204996,true,1251935493,28,1262369276,10433783
1668238031,204996,true,1251935493,28,1263126887,11191394
1668238103,204997,true,1251810312,28,1263632214,11821902
1668238187,204995,true,1252060687,28,1264011341,11950654
1668238247,204994,true,1252185893,28,1264390583,12204690
1668238319,204993,true,1252311111,28,1264769938,12458827
1668238331,204994,true,1252185893,28,1264769938,12584045
1668238379,204992,true,1252436342,28,1265022904,12586562
1668238403,204991,true,1252561586,28,1265149407,12587821
1668238439,204991,true,1252561586,28,1265275922,12714336
1668238463,204992,true,1252436342,28,1265275922,12839580
1668238847,204990,true,1252686842,28,1266541767,13854925
1668239099,204989,true,1252812111,28,1267428612,14616501
1668239459,204989,true,1252812111,28,1267808879,14996768
1668239903,204989,true,1252812111,28,1267048460,14236349
1668239915,204988,true,1252937392,28,1266921768,13984376
1668240191,204986,true,1253187992,28,1266288497,13100505
1668240323,204986,true,1253187992,28,1266161881,12973889
1668240347,204986,true,1253187992,28,1266035277,12847285
1668240383,204984,true,1253438642,28,1266035277,12596635
1668240407,204983,true,1253563986,28,1266035277,12471291
1668240431,204982,true,1253689342,28,1265908686,12219344
1668240443,204982,true,1253689342,28,1265908686,12219344
1668240611,204981,true,1253814711,28,1265402449,11587738
1668240623,204979,true,1254065487,28,1265275922,11210435
1668240755,204979,true,1254065487,28,1264896415,10830928
1668240875,204978,true,1254190893,28,1264517022,10326129
1668241031,204977,true,1254316313,28,1264011341,9695028
1668241283,204975,true,1254567188,28,1263253200,8686012
1668241427,204974,true,1254692645,28,1262748025,8055380
1668241451,204973,true,1254818114,28,1262621763,7803649
1668241487,204971,true,1255069090,28,1262495513,7426423
1668241559,204970,true,1255194597,28,1262116840,6922243
1668241583,204969,true,1255320117,28,1261990641,6670524
1668241631,204968,true,1255445649,28,1261738281,6292632
1668241643,204966,true,1255696751,28,1261612120,5915369
1668241667,204966,true,1255696751,28,1261485971,5789220
1668241727,204966,true,1255696751,28,1261107601,5410850
1668241787,204966,true,1255696751,28,1260729344,5032593
1668241871,204964,true,1255947902,28,1260225179,4277277
1668241919,204964,true,1255947902,28,1259847187,3899285
1668241931,204964,true,1255947902,28,1259721215,3773313
1668241943,204964,true,1255947902,28,1259721215,3773313
1668242123,204963,true,1256073497,28,1258336352,2262855
1668242159,204962,true,1256199105,28,1257958927,1759822
1668242255,204962,true,1256199105,28,1257330136,1131031
1668242267,204962,true,1256199105,28,1257330136,1131031
1668242279,204961,true,1256324724,28,1257330136,1005412
1668242291,204961,true,1256324724,28,1257204416,879692
1668242315,204960,true,1256450357,28,1257204416,754059
1668242327,204960,true,1256450357,28,1257204416,754059
1668242423,204958,true,1256701660,28,1257078708,377048
1668242495,204957,true,1256827330,28,1257078708,251378
1668242507,204956,true,1256953012,28,1257078708,125696
1668242519,204955,true,1257078708,28,1257078708,0
1668242543,204953,true,1257330136,28,1257078708,-251428
1668242795,204951,true,1257581615,28,1257455869,-125746
1668242843,204949,true,1257833144,28,1257581615,-251529
1668243107,204949,true,1257833144,28,1257707373,-125771
1668243275,204946,true,1258210531,28,1257958927,-251604
1668243287,204945,true,1258336352,28,1258084723,-251629
1668243383,204944,true,1258462186,28,1258336352,-125834
1668243431,204944,true,1258462186,28,1258462186,0
1668243683,204942,true,1258713891,28,1259595255,881364
1668243707,204941,true,1258839762,28,1259721215,881453
1668243731,204940,true,1258965646,28,1259847187,881541
1668243743,204940,true,1258965646,28,1259847187,881541
1668243767,204938,true,1259217452,28,1259973171,755719
1668243779,204937,true,1259343374,28,1259973171,629797
1668243851,204936,true,1259469308,28,1260225179,755871
1668243947,204936,true,1259469308,28,1260603284,1133976
1668244703,204934,true,1259721215,28,1259343374,-377841
1668244727,204934,true,1259721215,28,1259217452,-503763
1668244775,204933,true,1259847187,28,1259091543,-755644
1668244859,204933,true,1259847187,28,1258965646,-881541
1668244871,204931,true,1260099169,28,1258839762,-1259407
1668245315,204931,true,1260099169,28,1258084723,-2014446
1668246491,204931,true,1260099169,28,1258713891,-1385278
1668246647,204931,true,1260099169,28,1258965646,-1133523
1668246659,204930,true,1260225179,28,1259091543,-1133636
1668246731,204929,true,1260351201,28,1258965646,-1385555
1668246863,204928,true,1260477236,28,1258965646,-1511590
1668246971,204928,true,1260477236,28,1258839762,-1637474
1668247007,204927,true,1260603284,28,1258839762,-1763522
1668247271,204926,true,1260729344,28,1258839762,-1889582
1668247451,204926,true,1260729344,28,1258713891,-2015453
1668247475,204927,true,1260603284,28,1258713891,-1889393
1668247703,204927,true,1260603284,28,1258713891,-1889393
1668247775,204926,true,1260729344,28,1258713891,-2015453
1668248111,204926,true,1260729344,28,1258462186,-2267158
1668248195,204928,true,1260477236,28,1258462186,-2015050
1668248207,204928,true,1260477236,28,1258462186,-2015050
1668248231,204927,true,1260603284,28,1258462186,-2141098
1668248243,204926,true,1260729344,28,1258588032,-2141312
1668248255,204926,true,1260729344,28,1258588032,-2141312
1668248399,204925,true,1260855417,28,1259091543,-1763874
1668248411,204924,true,1260981503,28,1259091543,-1889960
1668248519,204924,true,1260981503,28,1259469308,-1512195
1668248543,204924,true,1260981503,28,1259595255,-1386248
1668248747,204923,true,1261107601,28,1260477236,-630365
1668248771,204923,true,1261107601,28,1260477236,-630365
1668248819,204923,true,1261107601,28,1260603284,-504317
1668248951,204923,true,1261107601,28,1261107601,0
1668249011,204922,true,1261233712,28,1261233712,0
1668249311,204922,true,1261233712,28,1262243052,1009340
1668249575,204922,true,1261233712,28,1263253200,2019488
1668249623,204922,true,1261233712,28,1263379525,2145813
1668249863,204922,true,1261233712,28,1264390583,3156871
1668249911,204921,true,1261359835,28,1264517022,3157187
1668250055,204922,true,1261233712,28,1264769938,3536226
1668250115,204922,true,1261233712,28,1264643473,3409761
1668250175,204923,true,1261107601,28,1264517022,3409421
1668250271,204923,true,1261107601,28,1264264156,3156555
1668250391,204924,true,1260981503,28,1264011341,3029838
1668250655,204925,true,1260855417,28,1263632214,2776797
1668250667,204926,true,1260729344,28,1263632214,2902870
1668250727,204926,true,1260729344,28,1263505863,2776519
1668250763,204927,true,1260603284,28,1263379525,2776241
1668251555,204928,true,1260477236,28,1260729344,252108
1668251591,204929,true,1260351201,28,1260603284,252083
1668251603,204929,true,1260351201,28,1260603284,252083
1668251627,204930,true,1260225179,28,1260477236,252057
1668253127,204932,true,1259973171,28,1255069090,-4904081
1668253139,204932,true,1259973171,28,1255069090,-4904081
1668253163,204932,true,1259973171,28,1255069090,-4904081
1668253307,204933,true,1259847187,28,1254818114,-5029073
1668253367,204935,true,1259595255,28,1254692645,-4902610
1668253523,204935,true,1259595255,28,1254818114,-4777141
1668253715,204935,true,1259595255,28,1254943596,-4651659
1668253991,204936,true,1259469308,28,1255069090,-4400218
1668254159,204937,true,1259343374,28,1255194597,-4148777
1668254243,204938,true,1259217452,28,1255320117,-3897335
1668254363,204938,true,1259217452,28,1255320117,-3897335
1668254375,204938,true,1259217452,28,1255320117,-3897335
1668254459,204940,true,1258965646,28,1255445649,-3519997
1668254483,204939,true,1259091543,28,1255445649,-3645894
1668254507,204939,true,1259091543,28,1255445649,-3645894
1668254531,204940,true,1258965646,28,1255445649,-3519997
1668254543,204941,true,1258839762,28,1255445649,-3394113
1668254579,204940,true,1258965646,28,1255571193,-3394453
1668254651,204940,true,1258965646,28,1255696751,-3268895
1668254687,204940,true,1258965646,28,1255822320,-3143326
1668255095,204942,true,1258713891,28,1256450357,-2263534
1668255203,204941,true,1258839762,28,1256701660,-2138102
1668255839,204940,true,1258965646,28,1257455869,-1509777
1668256127,204940,true,1258965646,28,1257707373,-1258273
1668256235,204941,true,1258839762,28,1257833144,-1006618
1668256259,204941,true,1258839762,28,1257833144,-1006618
1668256439,204940,true,1258965646,28,1257833144,-1132502
1668256475,204940,true,1258965646,28,1257833144,-1132502
1668256535,204941,true,1258839762,28,1257707373,-1132389
1668256559,204940,true,1258965646,28,1257707373,-1258273
1668256715,204939,true,1259091543,28,1257455869,-1635674
1668256727,204939,true,1259091543,28,1257330136,-1761407
1668256967,204940,true,1258965646,28,1257204416,-1761230
1668257099,204938,true,1259217452,28,1257330136,-1887316
1668257123,204937,true,1259343374,28,1257330136,-2013238
1668257159,204937,true,1259343374,28,1257455869,-1887505
1668257267,204937,true,1259343374,28,1257707373,-1636001
1668257375,204935,true,1259595255,28,1257958927,-1636328
1668257699,204934,true,1259721215,28,1258839762,-881453
1668257771,204935,true,1259595255,28,1259217452,-377803
1668257783,204935,true,1259595255,28,1259217452,-377803
1668257795,204934,true,1259721215,28,1259343374,-377841
1668257855,204932,true,1259973171,28,1259721215,-251956
1668257867,204932,true,1259973171,28,1259721215,-251956
1668258239,204933,true,1259847187,28,1261864455,2017268
1668258479,204932,true,1259973171,28,1263379525,3406354
1668258503,204931,true,1260099169,28,1263632214,3533045
1668258527,204931,true,1260099169,28,1263758577,3659408
1668258563,204932,true,1259973171,28,1263884953,3911782
1668258575,204931,true,1260099169,28,1263884953,3785784
1668258587,204930,true,1260225179,28,1263884953,3659774
1668258599,204931,true,1260099169,28,1264011341,3912172
1668258611,204932,true,1259973171,28,1264011341,4038170
1668258959,204931,true,1260099169,28,1264769938,4670769
1668259031,204930,true,1260225179,28,1264769938,4544759
1668259211,204931,true,1260099169,28,1264643473,4544304
1668259415,204931,true,1260099169,28,1264517022,4417853
1668259847,204931,true,1260099169,28,1263632214,3533045
1668259931,204930,true,1260225179,28,1263379525,3154346
1668259943,204929,true,1260351201,28,1263379525,3028324
1668259955,204930,true,1260225179,28,1263253200,3028021
1668260579,204930,true,1260225179,28,1261485971,1260792
1668260951,204929,true,1260351201,28,1260981503,630302
1668261323,204929,true,1260351201,28,1260477236,126035
1668261395,204929,true,1260351201,28,1260351201,0
1668261455,204929,true,1260351201,28,1260351201,0
1668261527,204928,true,1260477236,28,1260225179,-252057
1668261671,204928,true,1260477236,28,1260099169,-378067
1668262379,204929,true,1260351201,28,1260477236,126035
1668262607,204929,true,1260351201,28,1260603284,252083
1668262619,204928,true,1260477236,28,1260603284,126048
1668262871,204928,true,1260477236,28,1260729344,252108
1668262883,204928,true,1260477236,28,1260729344,252108
1668263579,204928,true,1260477236,28,1261359835,882599
1668263603,204927,true,1260603284,28,1261485971,882687
1668263639,204926,true,1260729344,28,1261485971,756627
1668263711,204927,true,1260603284,28,1261612120,1008836
1668263903,204926,true,1260729344,28,1262116840,1387496
1668263927,204925,true,1260855417,28,1262243052,1387635
1668264107,204924,true,1260981503,28,1262621763,1640260
1668264179,204925,true,1260855417,28,1262748025,1892608
1668264227,204924,true,1260981503,28,1262874300,1892797
1668264275,204923,true,1261107601,28,1263000587,1892986
1668264383,204923,true,1261107601,28,1263379525,2271924
1668264455,204923,true,1261107601,28,1263632214,2524613
1668264479,204923,true,1261107601,28,1263758577,2650976
1668264491,204923,true,1261107601,28,1263758577,2650976
1668264515,204922,true,1261233712,28,1263884953,2651241
1668264527,204922,true,1261233712,28,1264011341,2777629
1668264647,204920,true,1261485971,28,1265275922,3789951
1668264659,204919,true,1261612120,28,1265275922,3663802
1668264707,204918,true,1261738281,28,1265782108,4043827
1668264731,204918,true,1261738281,28,1265908686,4170405
1668264743,204917,true,1261864455,28,1266035277,4170822
1668265115,204916,true,1261990641,28,1268823481,6832840
1668265295,204915,true,1262116840,28,1270219885,8103045
1668265379,204915,true,1262116840,28,1270855122,8738282
1668265439,204913,true,1262369276,28,1271109306,8740030
1668265679,204913,true,1262369276,28,1272380987,10011711
1668265691,204912,true,1262495513,28,1272508225,10012712
1668265907,204912,true,1262495513,28,1273781306,11285793
1668266255,204910,true,1262748025,28,1275693316,12945291
1668266279,204909,true,1262874300,28,1275820886,12946586
1668266579,204908,true,1263000587,28,1275693316,12692729
1668266867,204908,true,1263000587,28,1275820886,12820299
1668266939,204906,true,1263253200,28,1275820886,12567686
1668266975,204905,true,1263379525,28,1275820886,12441361
1668267299,204904,true,1263505863,28,1275948468,12442605
1668267359,204903,true,1263632214,28,1275948468,12316254
1668267383,204901,true,1263884953,28,1275948468,12063515
1668267395,204900,true,1264011341,28,1275948468,11937127
1668267851,204900,true,1264011341,28,1275310685,11299344
1668268379,204898,true,1264264156,28,1274545766,10281610
1668268511,204896,true,1264517022,28,1274290895,9773873
1668268655,204895,true,1264643473,28,1274036075,9392602
1668269027,204894,true,1264769938,28,1273526588,8756650
1668269195,204893,true,1264896415,28,1273144607,8248192
1668269219,204891,true,1265149407,28,1273017305,7867898
1668269495,204890,true,1265275922,28,1272762740,7486818
1668269555,204890,true,1265275922,28,1272635476,7359554
1668269675,204889,true,1265402449,28,1272508225,7105776
1668269723,204887,true,1265655542,28,1272508225,6852683
1668269759,204886,true,1265782108,28,1272380987,6598879
1668269795,204886,true,1265782108,28,1272380987,6598879
1668269819,204884,true,1266035277,28,1272380987,6345710
1668270023,204882,true,1266288497,28,1272253762,5965265
1668270095,204881,true,1266415126,28,1272126549,5711423
1668270179,204881,true,1266415126,28,1272126549,5711423
1668270503,204880,true,1266541767,28,1271617826,5076059
1668270791,204878,true,1266795088,28,1271236417,4441329
1668270815,204878,true,1266795088,28,1271236417,4441329
1668270875,204878,true,1266795088,28,1271109306,4314218
1668271199,204877,true,1266921768,28,1270728049,3806281
1668273503,204875,true,1267175165,28,1269077258,1902093
1668273587,204875,true,1267175165,28,1269331087,2155922
1668273671,204874,true,1267301882,28,1269458020,2156138
1668273971,204873,true,1267428612,28,1270092876,2664264
1668274043,204871,true,1267682111,28,1270219885,2537774
1668274211,204870,true,1267808879,28,1270473942,2665063
1668274259,204870,true,1267808879,28,1270600989,2792110
1668274271,204869,true,1267935660,28,1270600989,2665329
1668274835,204866,true,1268316079,28,1271363540,3047461
1668275075,204866,true,1268316079,28,1271744987,3428908
1668275231,204865,true,1268442910,28,1271999349,3556439
1668275327,204864,true,1268569754,28,1272508225,3938471
1668275339,204862,true,1268823481,28,1272508225,3684744
1668275363,204861,true,1268950363,28,1272508225,3557862
1668275399,204860,true,1269077258,28,1272635476,3558218
1668275471,204860,true,1269077258,28,1272762740,3685482
1668275507,204858,true,1269331087,28,1272762740,3431653
1668275747,204857,true,1269458020,28,1273144607,3686587
1668275843,204857,true,1269458020,28,1273271921,3813901
1668275903,204857,true,1269458020,28,1273271921,3813901
1668276131,204855,true,1269711924,28,1273526588,3814664
1668276467,204855,true,1269711924,28,1273908684,4196760
1668276491,204855,true,1269711924,28,1273908684,4196760
1668276635,204855,true,1269711924,28,1274036075,4324151
1668276647,204853,true,1269965879,28,1274036075,4070196
1668276659,204854,true,1269838895,28,1274036075,4197180
1668276683,204853,true,1269965879,28,1274036075,4070196
1668276695,204854,true,1269838895,28,1274036075,4197180
1668276707,204851,true,1270219885,28,1274036075,3816190
1668276719,204852,true,1270092876,28,1274036075,3943199
1668276743,204852,true,1270092876,28,1273908684,3815808
1668276767,204852,true,1270092876,28,1273908684,3815808
1668277067,204850,true,1270346907,28,1272762740,2415833
1668281135,204851,true,1270219885,28,1265908686,-4311199
1668281603,204851,true,1270219885,28,1265908686,-4311199
1668282935,204851,true,1270219885,28,1265908686,-4311199
1668283883,204849,true,1270473942,28,1265908686,-4565256
1668285227,204850,true,1270346907,28,1263632214,-6714693
1668286127,204850,true,1270346907,28,1262748025,-7598882
1668287027,204851,true,1270219885,28,1262748025,-7471860
1668287099,204848,true,1270600989,28,1262748025,-7852964
1668287315,204849,true,1270473942,28,1262748025,-7725917
1668287543,204849,true,1270473942,28,1262748025,-7725917
1668287867,204850,true,1270346907,28,1262621763,-7725144
1668287963,204848,true,1270600989,28,1262495513,-8105476
1668287999,204849,true,1270473942,28,1262495513,-7978429
1668288179,204849,true,1270473942,28,1262369276,-8104666
1668288203,204850,true,1270346907,28,1262243052,-8103855
1668288263,204848,true,1270600989,28,1262243052,-8357937
1668288275,204849,true,1270473942,28,1262243052,-8230890
1668288323,204850,true,1270346907,28,1261990641,-8356266
1668288419,204851,true,1270219885,28,1261612120,-8607765
1668288707,204850,true,1270346907,28,1260225179,-10121728
1668289031,204851,true,1270219885,28,1258713891,-11505994
1668290315,204852,true,1270092876,28,1253814711,-16278165
1668290507,204853,true,1269965879,28,1253689342,-16276537
1668290783,204853,true,1269965879,28,1253563986,-16401893
1668290975,204854,true,1269838895,28,1253689342,-16149553
1668291527,204855,true,1269711924,28,1254065487,-15646437
1668291899,204856,true,1269584966,28,1254316313,-15268653
1668291923,204856,true,1269584966,28,1254316313,-15268653
1668292931,204857,true,1269458020,28,1254943596,-14514424
1668292943,204858,true,1269331087,28,1254943596,-14387491
1668293447,204859,true,1269204166,28,1255822320,-13381846
1668293579,204859,true,1269204166,28,1255947902,-13256264
1668293819,204860,true,1269077258,28,1256324724,-12752534
1668294167,204861,true,1268950363,28,1256701660,-12248703
1668294347,204863,true,1268696611,28,1257078708,-11617903
1668294431,204864,true,1268569754,28,1257204416,-11365338
1668294611,204865,true,1268442910,28,1257581615,-10861295
1668294695,204867,true,1268189260,28,1257707373,-10481887
1668294827,204869,true,1267935660,28,1257833144,-10102516
1668294839,204869,true,1267935660,28,1257833144,-10102516
1668294887,204870,true,1267808879,28,1257833144,-9975735
1668294899,204872,true,1267555355,28,1257833144,-9722211
1668295007,204874,true,1267301882,28,1257833144,-9468738
1668295667,204875,true,1267175165,28,1257455869,-9719296
1668295703,204876,true,1267048460,28,1257455869,-9592591
1668295715,204877,true,1266921768,28,1257455869,-9465899
1668295727,204879,true,1266668421,28,1257330136,-9338285
1668295823,204881,true,1266415126,28,1257078708,-9336418
1668295835,204882,true,1266288497,28,1257078708,-9209789
1668295847,204884,true,1266035277,28,1256953012,-9082265
1668296279,204886,true,1265782108,28,1255069090,-10713018
1668296303,204888,true,1265528989,28,1254943596,-10585393
1668296375,204890,true,1265275922,28,1254692645,-10583277
1668297311,204891,true,1265149407,28,1251184595,-13964812
1668297527,204893,true,1264896415,28,1250684246,-14212169
1668297851,204895,true,1264643473,28,1250809314,-13834159
1668298175,204897,true,1264390583,28,1250934395,-13456188
1668298211,204897,true,1264390583,28,1251059489,-13331094
1668298631,204899,true,1264137742,28,1251434844,-12702898
1668298643,204902,true,1263758577,28,1251434844,-12323733
1668298667,204902,true,1263758577,28,1251434844,-12323733
1668298715,204903,true,1263632214,28,1251559987,-12072227
1668298883,204905,true,1263379525,28,1251935493,-11444032
1668298895,204907,true,1263126887,28,1251935493,-11191394
1668299003,204907,true,1263126887,28,1252185893,-10940994
1668299051,204908,true,1263000587,28,1252311111,-10689476
1668299063,204909,true,1262874300,28,1252436342,-10437958
1668299087,204911,true,1262621763,28,1252436342,-10185421
1668299099,204911,true,1262621763,28,1252561586,-10060177
1668299123,204912,true,1262495513,28,1252561586,-9933927
1668299507,204913,true,1262369276,28,1253940093,-8429183
1668300071,204915,true,1262116840,28,1256953012,-5163828
1668300251,204915,true,1262116840,28,1257707373,-4409467
1668301187,204915,true,1262116840,28,1260729344,-1387496
1668301847,204916,true,1261990641,28,1260855417,-1135224
1668302327,204917,true,1261864455,28,1260981503,-882952
1668302399,204918,true,1261738281,28,1260981503,-756778
1668303851,204918,true,1261738281,28,1261233712,-504569
1668303887,204918,true,1261738281,28,1261233712,-504569
1668303935,204920,true,1261485971,28,1261233712,-252259
1668303947,204920,true,1261485971,28,1261359835,-126136
1668303959,204920,true,1261485971,28,1261359835,-126136
1668304139,204920,true,1261485971,28,1261485971,0
1668304343,204922,true,1261233712,28,1261738281,504569
1668304931,204923,true,1261107601,28,1262369276,1261675
1668305663,204922,true,1261233712,28,1263126887,1893175
1668306011,204923,true,1261107601,28,1263253200,2145599
1668306239,204925,true,1260855417,28,1263253200,2397783
1668307847,204925,true,1260855417,28,1263253200,2397783
1668307979,204925,true,1260855417,28,1263253200,2397783
1668308111,204925,true,1260855417,28,1263253200,2397783
1668308495,204928,true,1260477236,28,1263253200,2775964
1668308531,204928,true,1260477236,28,1263379525,2902289
1668308543,204929,true,1260351201,28,1263379525,3028324
1668309191,204929,true,1260351201,28,1264517022,4165821
1668309623,204930,true,1260225179,28,1265275922,5050743
1668309935,204931,true,1260099169,28,1265782108,5682939
1668310055,204931,true,1260099169,28,1266035277,5936108
1668310427,204931,true,1260099169,28,1266415126,6315957
1668311663,204933,true,1259847187,28,1266288497,6441310
1668311843,204933,true,1259847187,28,1266288497,6441310
1668311879,204933,true,1259847187,28,1266288497,6441310
1668312083,204933,true,1259847187,28,1266415126,6567939
1668312191,204934,true,1259721215,28,1266541767,6820552
1668312407,204934,true,1259721215,28,1266795088,7073873
1668312503,204935,true,1259595255,28,1266921768,7326513
1668312551,204934,true,1259721215,28,1266921768,7200553
1668312839,204935,true,1259595255,28,1267301882,7706627
1668313571,204935,true,1259595255,28,1268062453,8467198
1668314423,204935,true,1259595255,28,1268189260,8594005
1668314435,204934,true,1259721215,28,1268189260,8468045
1668315119,204935,true,1259595255,28,1267808879,8213624
1668315131,204935,true,1259595255,28,1267808879,8213624
1668315431,204935,true,1259595255,28,1267555355,7960100
1668315551,204934,true,1259721215,28,1267428612,7707397
1668315851,204935,true,1259595255,28,1267175165,7579910
1668316295,204934,true,1259721215,28,1266795088,7073873
1668316919,204934,true,1259721215,28,1266541767,6820552
1668317279,204933,true,1259847187,28,1266415126,6567939
1668318215,204934,true,1259721215,28,1266415126,6693911
1668319127,204933,true,1259847187,28,1266415126,6567939
1668319211,204933,true,1259847187,28,1266415126,6567939
1668319259,204932,true,1259973171,28,1266415126,6441955
1668319271,204933,true,1259847187,28,1266415126,6567939
1668319283,204932,true,1259973171,28,1266415126,6441955
1668319295,204932,true,1259973171,28,1266415126,6441955
1668319319,204931,true,1260099169,28,1266415126,6315957
1668319343,204931,true,1260099169,28,1266415126,6315957
1668319403,204931,true,1260099169,28,1266288497,6189328
1668319415,204930,true,1260225179,28,1266288497,6063318
1668319463,204929,true,1260351201,28,1266161881,5810680
1668319619,204929,true,1260351201,28,1265782108,5430907
1668319931,204929,true,1260351201,28,1265022904,4671703
1668320927,204928,true,1260477236,28,1262621763,2144527
1668320939,204927,true,1260603284,28,1262495513,1892229
1668321071,204927,true,1260603284,28,1262116840,1513556
1668321179,204926,true,1260729344,28,1261738281,1008937
1668321191,204927,true,1260603284,28,1261738281,1134997
1668321203,204925,true,1260855417,28,1261612120,756703
1668321227,204926,true,1260729344,28,1261612120,882776
1668321287,204926,true,1260729344,28,1261359835,630491
1668321299,204926,true,1260729344,28,1261359835,630491
1668322055,204926,true,1260729344,28,1258210531,-2518813
1668322067,204926,true,1260729344,28,1258210531,-2518813
1668322307,204927,true,1260603284,28,1257078708,-3524576
1668322559,204927,true,1260603284,28,1255822320,-4780964
1668322691,204927,true,1260603284,28,1255069090,-5534194
1668322763,204928,true,1260477236,28,1254692645,-5784591
1668322775,204928,true,1260477236,28,1254692645,-5784591
1668322787,204929,true,1260351201,28,1254567188,-5784013
1668322799,204929,true,1260351201,28,1254567188,-5784013
1668322811,204930,true,1260225179,28,1254441744,-5783435
1668322823,204931,true,1260099169,28,1254441744,-5657425
1668322835,204932,true,1259973171,28,1254316313,-5656858
1668322859,204932,true,1259973171,28,1254065487,-5907684
1668322871,204933,true,1259847187,28,1253940093,-5907094
1668322883,204934,true,1259721215,28,1253814711,-5906504
1668322895,204935,true,1259595255,28,1253689342,-5905913
1668322943,204937,true,1259343374,28,1253062686,-6280688
1668322979,204938,true,1259217452,28,1252561586,-6655866
1668323015,204939,true,1259091543,28,1252060687,-7030856
1668323039,204940,true,1258965646,28,1251810312,-7155334
1668323063,204942,true,1258713891,28,1251559987,-7153904
1668323135,204942,true,1258713891,28,1250809314,-7904577
1668323147,204943,true,1258588032,28,1250684246,-7903786
1668323171,204944,true,1258462186,28,1250434147,-8028039
1668323195,204946,true,1258210531,28,1250184097,-8026434
1668323207,204946,true,1258210531,28,1250059091,-8151440
1668323231,204947,true,1258084723,28,1249934098,-8150625
1668323267,204947,true,1258084723,28,1249684149,-8400574
1668323315,204948,true,1257958927,28,1249434249,-8524678
1668323327,204948,true,1257958927,28,1249309318,-8649609
1668323339,204949,true,1257833144,28,1249309318,-8523826
1668323351,204950,true,1257707373,28,1249184400,-8522973
1668323423,204951,true,1257581615,28,1248809719,-8771896
1668323603,204951,true,1257581615,28,1247935902,-9645713
1668323639,204952,true,1257455869,28,1247811121,-9644748
1668323651,204952,true,1257455869,28,1247686352,-9769517
1668323771,204954,true,1257204416,28,1247312121,-9892295
1668324179,204953,true,1257330136,28,1245940901,-11389235
1668324191,204954,true,1257204416,28,1245816319,-11388097
1668324227,204955,true,1257078708,28,1245691750,-11386958
1668324251,204956,true,1256953012,28,1245691750,-11261262
1668324383,204957,true,1256827330,28,1245193598,-11633732
1668324935,204958,true,1256701660,28,1245816319,-10885341
1668324947,204959,true,1256576002,28,1245940901,-10635101
1668325439,204961,true,1256324724,28,1245442649,-10882075
1668325763,204962,true,1256199105,28,1244571188,-11627917
1668325811,204963,true,1256073497,28,1244446743,-11626754
1668325967,204965,true,1255822320,28,1243949089,-11873231
1668326063,204966,true,1255696751,28,1243824706,-11872045
1668326087,204967,true,1255571193,28,1243824706,-11746487
1668326099,204969,true,1255320117,28,1243824706,-11495411
1668326579,204969,true,1255320117,28,1244197891,-11122226
1668327359,204971,true,1255069090,28,1246065495,-9003595
1668327383,204971,true,1255069090,28,1246190102,-8878988
1668327407,204973,true,1254818114,28,1246190102,-8628012
1668327419,204973,true,1254818114,28,1246190102,-8628012
1668327803,204976,true,1254441744,28,1246938003,-7503741
1668327815,204976,true,1254441744,28,1246938003,-7503741
1668327851,204978,true,1254190893,28,1246938003,-7252890
1668328163,204978,true,1254190893,28,1246688652,-7502241
1668328271,204981,true,1253814711,28,1246439352,-7375359
1668328943,204982,true,1253689342,28,1245567193,-8122149
1668329543,204983,true,1253563986,28,1244944597,-8619389
1668329555,204984,true,1253438642,28,1244944597,-8494045
1668329663,204987,true,1253062686,28,1244820115,-8242571
1668329687,204988,true,1252937392,28,1244820115,-8117277
1668329723,204990,true,1252686842,28,1244695645,-7991197
1668329807,204990,true,1252686842,28,1244571188,-8115654
1668329843,204994,true,1252185893,28,1244446743,-7739150
1668329855,204995,true,1252060687,28,1244322311,-7738376
1668330275,204999,true,1251559987,28,1240967340,-10592647
1668330287,205000,true,1251434844,28,1240967340,-10467504
1668330359,205004,true,1250934395,28,1240223020,-10711375
1668330371,205006,true,1250684246,28,1240099010,-10585236
1668330383,205011,true,1250059091,28,1239975012,-10084079
1668330419,205013,true,1249809117,28,1239479146,-10329971
1668330647,205018,true,1249184400,28,1236137233,-13047167
1668330671,205020,true,1248934600,28,1235766466,-13168134
1668330707,205025,true,1248310320,28,1235272283,-13038037
1668330959,205027,true,1248060696,28,1231325927,-16734769
1668331043,205033,true,1247312121,28,1230095278,-17216843
1668331067,205034,true,1247187403,28,1229726323,-17461080
1668331091,205040,true,1246439352,28,1229357479,-17081873
1668331199,205041,true,1246314721,28,1228005997,-18308724
1668331355,205046,true,1245691750,28,1226042856,-19648894
1668331631,205047,true,1245567193,28,1222981730,-22585463
1668331727,205052,true,1244944597,28,1222370423,-22574174
1668331835,205053,true,1244820115,28,1221881597,-22938518
1668331883,205059,true,1244073484,28,1221637257,-22436227
1668331931,205060,true,1243949089,28,1221392966,-22556123
1668331943,205065,true,1243327301,28,1221270839,-22056462
1668332063,205066,true,1243202981,28,1220782453,-22420528
1668332471,205071,true,1242581566,28,1221026622,-21554944
1668332555,205073,true,1242333087,28,1221392966,-20940121
1668332567,205078,true,1241712106,28,1221392966,-20319140
1668332579,205079,true,1241587948,28,1221392966,-20194982
1668332687,205083,true,1241091436,28,1221881597,-19209839
1668332951,205084,true,1240967340,28,1222981730,-17985610
1668333479,205089,true,1240347042,28,1224205262,-16141780
1668333635,205090,true,1240223020,28,1224572561,-15650459
1668333851,205094,true,1239727055,28,1225062463,-14664592
1668334163,205094,true,1239727055,28,1225552562,-14174493
1668334175,205099,true,1239107377,28,1225552562,-13554815
1668334199,205100,true,1238983479,28,1225675117,-13308362
1668334223,205104,true,1238488009,28,1225675117,-12812892
1668334247,205105,true,1238364173,28,1225675117,-12689056
1668334271,205110,true,1237745176,28,1225675117,-12070059
1668334343,205110,true,1237745176,28,1225797685,-11947491
1668334355,205114,true,1237250202,28,1225797685,-11452517
1668334511,205115,true,1237126489,28,1225797685,-11328804
1668335111,205119,true,1236631763,28,1225062463,-11569300
1668335195,205119,true,1236631763,28,1224939969,-11691794
1668335207,205123,true,1236137233,28,1224939969,-11197264
1668335219,205123,true,1236137233,28,1224939969,-11197264
1668335243,205127,true,1235642902,28,1224939969,-10702933
1668335255,205127,true,1235642902,28,1224939969,-10702933
1668335303,205130,true,1235272283,28,1225062463,-10209820
1668335339,205131,true,1235148769,28,1225062463,-10086306
1668335699,205134,true,1234778298,28,1225920264,-8858034
1668335915,205134,true,1234778298,28,1226410706,-8367592
1668336587,205137,true,1234407939,28,1228128797,-6279142
1668337235,205137,true,1234407939,28,1229357479,-5050460
1668337487,205140,true,1234037690,28,1229234556,-4803134
1668337511,205139,true,1234161094,28,1229234556,-4926538
1668338627,205142,true,1233790920,28,1228497273,-5293647
1668338687,205142,true,1233790920,28,1228497273,-5293647
1668338735,205145,true,1233420856,28,1228497273,-4923583
1668338759,205144,true,1233544199,28,1228497273,-5046926
1668338771,205145,true,1233420856,28,1228497273,-4923583
1668338783,205144,true,1233544199,28,1228497273,-5046926
1668338807,205146,true,1233297527,28,1228497273,-4800254
1668338951,205144,true,1233544199,28,1228742985,-4801214
1668338963,205145,true,1233420856,28,1228865859,-4554997
1668338975,205145,true,1233420856,28,1228865859,-4554997
1668338987,205147,true,1233174209,28,1228865859,-4308350
1668339299,205145,true,1233420856,28,1230095278,-3325578
1668340007,205145,true,1233420856,28,1233790920,370064
1668340019,205145,true,1233420856,28,1233790920,370064
1668340283,205148,true,1233050904,28,1235642902,2591998
1668340307,205145,true,1233420856,28,1235766466,2345610
1668340367,205146,true,1233297527,28,1236260847,2963320
1668341423,205146,true,1233297527,28,1239975012,6677485
1668341447,205148,true,1233050904,28,1239975012,6924108
1668341711,205146,true,1233297527,28,1240347042,7049515
1668341759,205147,true,1233174209,28,1240347042,7172833
1668342455,205148,true,1233050904,28,1239975012,6924108
1668342479,205150,true,1232804331,28,1239975012,7170681
1668342935,205149,true,1232927611,28,1238983479,6055868
1668344291,205150,true,1232804331,28,1236879101,4074770
1668344375,205151,true,1232681063,28,1236879101,4198038
1668344567,205153,true,1232434564,28,1236879101,4444537
1668344615,205152,true,1232557807,28,1236879101,4321294
1668344627,205153,true,1232434564,28,1236879101,4444537
1668344663,205153,true,1232434564,28,1236879101,4444537
1668344675,205156,true,1232064907,28,1236879101,4814194
1668344699,205154,true,1232311333,28,1236879101,4567768
1668344711,205155,true,1232188114,28,1236879101,4690987
1668344723,205156,true,1232064907,28,1236879101,4814194
1668345383,205158,true,1231818531,28,1236137233,4318702
1668346103,205157,true,1231941713,28,1235395811,3454098
1668346367,205158,true,1231818531,28,1235148769,3330238
1668346715,205158,true,1231818531,28,1235025266,3206735
1668346799,205160,true,1231572204,28,1235148769,3576565
1668346811,205160,true,1231572204,28,1235148769,3576565
1668346823,205161,true,1231449060,28,1235148769,3699709
1668346835,205161,true,1231449060,28,1235148769,3699709
1668346847,205163,true,1231202807,28,1235272283,4069476
1668346907,205162,true,1231325927,28,1235519350,4193423
1668347075,205162,true,1231325927,28,1236137233,4811306
1668347111,205162,true,1231325927,28,1236260847,4934920
1668347387,205164,true,1231079699,28,1237373927,6294228
1668347411,205163,true,1231202807,28,1237497664,6294857
1668347423,205163,true,1231202807,28,1237497664,6294857
1668347447,205163,true,1231202807,28,1237621414,6418607
1668347459,205165,true,1230956603,28,1237621414,6664811
1668347483,205164,true,1231079699,28,1237745176,6665477
1668347591,205164,true,1231079699,28,1237992738,6913039
1668347747,205164,true,1231079699,28,1238488009,7408310
1668348011,205166,true,1230833520,28,1239355211,8521691
1668348587,205164,true,1231079699,28,1241091436,10011737
1668348611,205164,true,1231079699,28,1241091436,10011737
1668349247,205164,true,1231079699,28,1240719184,9639485
1668349271,205164,true,1231079699,28,1240595124,9515425
1668349319,205162,true,1231325927,28,1240595124,9269197
1668349499,205161,true,1231449060,28,1240595124,9146064
1668349763,205161,true,1231449060,28,1240595124,9146064
1668349871,205160,true,1231572204,28,1240471077,8898873
1668349883,205157,true,1231941713,28,1240471077,8529364
1668349907,205156,true,1232064907,28,1240471077,8406170
1668349967,205155,true,1232188114,28,1240471077,8282963
1668350063,205154,true,1232311333,28,1240347042,8035709
1668350519,205151,true,1232681063,28,1239851027,7169964
1668350639,205149,true,1232927611,28,1239727055,6799444
1668350771,205149,true,1232927611,28,1239603094,6675483
1668351635,205148,true,1233050904,28,1238983479,5932575
1668352043,205146,true,1233297527,28,1238983479,5685952
1668352319,205144,true,1233544199,28,1238983479,5439280
1668352403,205144,true,1233544199,28,1238859593,5315394
1668352511,205143,true,1233667553,28,1238735719,5068166
1668352595,205141,true,1233914299,28,1238611858,4697559
1668352703,205140,true,1234037690,28,1238488009,4450319
1668352727,205140,true,1234037690,28,1238488009,4450319
1668352739,205138,true,1234284510,28,1238488009,4203499
1668352787,205137,true,1234407939,28,1238364173,3956234
1668352835,205136,true,1234531379,28,1238240349,3708970
1668352919,205136,true,1234531379,28,1237992738,3461359
1668352943,205135,true,1234654833,28,1237868951,3214118
1668352955,205134,true,1234778298,28,1237745176,2966878
1668352979,205134,true,1234778298,28,1237621414,2843116
1668353363,205136,true,1234531379,28,1235025266,493887
1668353483,205135,true,1234654833,28,1234161094,-493739
1668353531,205134,true,1234778298,28,1233790920,-987378
1668353963,205134,true,1234778298,28,1230833520,-3944778
1668353975,205136,true,1234531379,28,1230833520,-3697859
1668354179,205135,true,1234654833,28,1229726323,-4928510
1668354323,205133,true,1234901776,28,1229111644,-5790132
1668354335,205133,true,1234901776,28,1229111644,-5790132
1668354395,205135,true,1234654833,28,1228865859,-5788974
1668355019,205133,true,1234901776,28,1228742985,-6158791
1668355595,205131,true,1235148769,28,1230218288,-4930481
1668355655,205131,true,1235148769,28,1230341309,-4807460
1668355823,205133,true,1234901776,28,1230710449,-4191327
1668355859,205131,true,1235148769,28,1230710449,-4438320
1668356087,205129,true,1235395811,28,1230956603,-4439208
1668356111,205129,true,1235395811,28,1230956603,-4439208
1668356231,205131,true,1235148769,28,1230956603,-4192166
1668356591,205129,true,1235395811,28,1230710449,-4685362
1668356699,205128,true,1235519350,28,1230710449,-4808901
1668356723,205128,true,1235519350,28,1230587390,-4931960
1668356987,205130,true,1235272283,28,1230341309,-4930974
1668356999,205130,true,1235272283,28,1230341309,-4930974
1668357035,205128,true,1235519350,28,1230218288,-5301062
1668357983,205128,true,1235519350,28,1229234556,-6284794
1668358103,205130,true,1235272283,28,1229111644,-6160639
1668358127,205130,true,1235272283,28,1229111644,-6160639
1668358235,205128,true,1235519350,28,1229111644,-6407706
1668358247,205128,true,1235519350,28,1229111644,-6407706
1668358271,205130,true,1235272283,28,1229111644,-6160639
1668358331,205129,true,1235395811,28,1229111644,-6284167
1668358703,205128,true,1235519350,28,1229603363,-5915987
1668359111,205127,true,1235642902,28,1230095278,-5547624
1668359183,205129,true,1235395811,28,1230218288,-5177523
1668359543,205129,true,1235395811,28,1230710449,-4685362
1668359567,205128,true,1235519350,28,1230710449,-4808901
1668359627,205128,true,1235519350,28,1230833520,-4685830
1668359663,205129,true,1235395811,28,1230833520,-4562291
1668359699,205129,true,1235395811,28,1230833520,-4562291
1668359735,205130,true,1235272283,28,1230833520,-4438763
1668359747,205130,true,1235272283,28,1230833520,-4438763
1668359759,205132,true,1235025266,28,1230710449,-4314817
1668359951,205134,true,1234778298,28,1230095278,-4683020
1668360179,205134,true,1234778298,28,1229111644,-5666654
1668360203,205135,true,1234654833,28,1228988746,-5666087
1668360311,205138,true,1234284510,28,1228374435,-5910075
1668360563,205139,true,1234161094,28,1227146736,-7014358
1668361127,205139,true,1234161094,28,1224450116,-9710978
1668361271,205140,true,1234037690,28,1223715703,-10321987
1668361331,205142,true,1233790920,28,1223470996,-10319924
1668361355,205144,true,1233544199,28,1223348661,-10195538
1668361559,205144,true,1233544199,28,1222737171,-10807028
1668361787,205144,true,1233544199,28,1222859444,-10684755
1668361835,205146,true,1233297527,28,1222981730,-10315797
1668362087,205148,true,1233050904,28,1223104028,-9946876
1668362183,205147,true,1233174209,28,1223226339,-9947870
1668362747,205148,true,1233050904,28,1223715703,-9335201
1668362771,205150,true,1232804331,28,1223715703,-9088628
1668362783,205151,true,1232681063,28,1223715703,-8965360
1668363011,205151,true,1232681063,28,1224082854,-8598209
1668363143,205151,true,1232681063,28,1224327683,-8353380
1668363587,205153,true,1232434564,28,1224817488,-7617076
1668363599,205154,true,1232311333,28,1224817488,-7493845
1668364007,205154,true,1232311333,28,1224817488,-7493845
1668364091,205154,true,1232311333,28,1224817488,-7493845
1668364103,205156,true,1232064907,28,1224817488,-7247419
1668364115,205157,true,1231941713,28,1224817488,-7124225
1668364127,205157,true,1231941713,28,1224695018,-7246695
1668364175,205158,true,1231818531,28,1224695018,-7123513
1668364223,205160,true,1231572204,28,1224695018,-6877186
1668364343,205162,true,1231325927,28,1224572561,-6753366
1668364367,205163,true,1231202807,28,1224450116,-6752691
1668364619,205164,true,1231079699,28,1223715703,-7363996
1668365039,205167,true,1230710449,28,1222003785,-8706664
1668365219,205169,true,1230464343,28,1221148724,-9315619
1668365447,205170,true,1230341309,28,1220416292,-9925017
1668365831,205171,true,1230218288,28,1219440398,-10777890
1668365939,205174,true,1229849296,28,1219196546,-10652750
1668365951,205175,true,1229726323,28,1219196546,-10529777
1668365963,205176,true,1229603363,28,1219196546,-10406817
1668365975,205177,true,1229480415,28,1219196546,-10283869
1668366083,205179,true,1229234556,28,1219074639,-10159917
1668366095,205181,true,1228988746,28,1219074639,-9914107
1668366131,205182,true,1228865859,28,1219074639,-9791220
1668366503,205183,true,1228742985,28,1219684298,-9058687
1668366683,205185,true,1228497273,28,1220050240,-8447033
1668366743,205186,true,1228374435,28,1220172245,-8202190
1668367139,205187,true,1228251610,28,1221026622,-7224988
1668367307,205188,true,1228128797,28,1221270839,-6857958
1668367319,205190,true,1227883209,28,1221270839,-6612370
1668367475,205192,true,1227637669,28,1221637257,-6000412
1668367499,205192,true,1227637669,28,1221637257,-6000412
1668367511,205193,true,1227514917,28,1221759421,-5755496
1668367595,205195,true,1227269451,28,1222003785,-5265666
1668367907,205195,true,1227269451,28,1223104028,-4165423
1668367991,205196,true,1227146736,28,1223226339,-3920397
1668369047,205196,true,1227146736,28,1225797685,-1349051
1668369239,205198,true,1226901344,28,1226288077,-613267
1668370655,205199,true,1226778666,28,1226410706,-367960
1668371399,205200,true,1226656000,28,1226410706,-245294
1668371411,205200,true,1226656000,28,1226410706,-245294
1668371435,205202,true,1226410706,28,1226410706,0
1668371471,205203,true,1226288077,28,1226410706,122629
1668371507,205203,true,1226288077,28,1226410706,122629
1668371663,205203,true,1226288077,28,1226410706,122629
1668371687,205205,true,1226042856,28,1226288077,245221
1668372419,205206,true,1225920264,28,1226165461,245197
1668372731,205206,true,1225920264,28,1226042856,122592
1668372815,205206,true,1225920264,28,1226042856,122592
1668372887,205208,true,1225675117,28,1225920264,245147
1668372911,205208,true,1225675117,28,1225920264,245147
1668372923,205208,true,1225675117,28,1225920264,245147
1668372983,205208,true,1225675117,28,1225797685,122568
1668373043,205209,true,1225552562,28,1225675117,122555
1668373067,205209,true,1225552562,28,1225552562,0
1668373079,205210,true,1225430019,28,1225552562,122543
1668373271,205210,true,1225430019,28,1224939969,-490050
1668373343,205211,true,1225307488,28,1224695018,-612470
1668373355,205211,true,1225307488,28,1224695018,-612470
1668373367,205212,true,1225184970,28,1224695018,-489952
1668373403,205213,true,1225062463,28,1224327683,-734780
1668373427,205216,true,1224695018,28,1224082854,-612164
1668373583,205218,true,1224450116,28,1222370423,-2079693
1668373595,205219,true,1224327683,28,1222248198,-2079485
1668373715,205220,true,1224205262,28,1221026622,-3178640
1668373739,205223,true,1223838074,28,1220782453,-3055621
1668373823,205225,true,1223593343,28,1219928247,-3665096
1668373835,205226,true,1223470996,28,1219806266,-3664730
1668373859,205227,true,1223348661,28,1219562342,-3786319
1668374207,205229,true,1223104028,28,1216395756,-6708272
1668374231,205231,true,1222859444,28,1216152514,-6706930
1668374351,205232,true,1222737171,28,1214937030,-7800141
1668374615,205233,true,1222614909,28,1212388466,-10226443
1668374651,205235,true,1222370423,28,1212024823,-10345600
1668374663,205237,true,1222125985,28,1212024823,-10101162
1668375131,205237,true,1222125985,28,1209240508,-12885477
1668375407,205238,true,1222003785,28,1209724277,-12279508
1668375419,205240,true,1221759421,28,1209724277,-12035144
1668375443,205242,true,1221515106,28,1209845249,-11669857
1668375455,205242,true,1221515106,28,1209845249,-11669857
1668375479,205243,true,1221392966,28,1209966234,-11426732
1668375515,205244,true,1221270839,28,1210208239,-11062600
1668375527,205246,true,1221026622,28,1210329260,-10697362
1668375551,205246,true,1221026622,28,1210450293,-10576329
1668375563,205245,true,1221148724,28,1210571338,-10577386
1668375839,205245,true,1221148724,28,1213601401,-7547323
1668375875,205247,true,1220904531,28,1213965517,-6939014
1668375887,205246,true,1221026622,28,1214086914,-6939708
1668376127,205247,true,1220904531,28,1216274129,-4630402
1668376139,205247,true,1220904531,28,1216395756,-4508775
1668376151,205248,true,1220782453,28,1216517396,-4265057
1668376163,205248,true,1220782453,28,1216639048,-4143405
1668376199,205248,true,1220782453,28,1216882388,-3900065
1668376259,205248,true,1220782453,28,1217369214,-3413239
1668376271,205248,true,1220782453,28,1217490951,-3291502
1668376547,205248,true,1220782453,28,1219318466,-1463987
1668376679,205248,true,1220782453,28,1220050240,-732213
1668376751,205249,true,1220660387,28,1220416292,-244095
1668376763,205249,true,1220660387,28,1220416292,-244095
1668376787,205249,true,1220660387,28,1220538333,-122054
1668376799,205249,true,1220660387,28,1220660387,0
1668376823,205249,true,1220660387,28,1220782453,122066
1668376835,205250,true,1220538333,28,1220782453,244120
1668376871,205250,true,1220538333,28,1220904531,366198
1668376895,205251,true,1220416292,28,1221026622,610330
1668376979,205251,true,1220416292,28,1221270839,854547
1668377471,205251,true,1220416292,28,1221392966,976674
1668377783,205252,true,1220294262,28,1219806266,-487996
1668377915,205252,true,1220294262,28,1219196546,-1097716
1668378443,205253,true,1220172245,28,1218099818,-2072427
1668378467,205253,true,1220172245,28,1218099818,-2072427
1668378479,205254,true,1220050240,28,1218099818,-1950422
1668378899,205254,true,1220050240,28,1218221628,-1828612
1668378983,205255,true,1219928247,28,1218465284,-1462963
1668379307,205255,true,1219928247,28,1219196546,-731701
1668379667,205255,true,1219928247,28,1220172245,243998
1668379955,205255,true,1219928247,28,1221026622,1098375
1668379991,205255,true,1219928247,28,1221148724,1220477
1668380075,205255,true,1219928247,28,1221392966,1464719
1668380447,205254,true,1220050240,28,1222614909,2564669
1668380507,205255,true,1219928247,28,1222859444,2931197
1668380567,205254,true,1220050240,28,1222981730,2931490
1668380579,205254,true,1220050240,28,1222981730,2931490
1668380603,205254,true,1220050240,28,1223104028,3053788
1668380735,205253,true,1220172245,28,1223348661,3176416
1668381239,205253,true,1220172245,28,1223715703,3543458
1668381275,205253,true,1220172245,28,1223838074,3665829
1668381359,205252,true,1220294262,28,1223838074,3543812
1668381563,205252,true,1220294262,28,1223470996,3176734
1668381707,205252,true,1220294262,28,1223226339,2932077
1668382163,205252,true,1220294262,28,1222370423,2076161
1668382523,205252,true,1220294262,28,1221759421,1465159
1668382595,205252,true,1220294262,28,1221637257,1342995
1668382619,205252,true,1220294262,28,1221515106,1220844
1668383099,205252,true,1220294262,28,1220782453,488191
1668383447,205252,true,1220294262,28,1220660387,366125
1668383663,205252,true,1220294262,28,1220538333,244071
1668383807,205253,true,1220172245,28,1220416292,244047
1668384203,205253,true,1220172245,28,1220294262,122017
1668384215,205253,true,1220172245,28,1220294262,122017
1668384239,205253,true,1220172245,28,1220294262,122017
1668384251,205253,true,1220172245,28,1220294262,122017
1668384287,205253,true,1220172245,28,1220416292,244047
1668384467,205252,true,1220294262,28,1220660387,366125
1668384575,205253,true,1220172245,28,1220904531,732286
1668384815,205253,true,1220172245,28,1221270839,1098594
1668384851,205253,true,1220172245,28,1221392966,1220721
1668384995,205253,true,1220172245,28,1221637257,1465012
1668385031,205254,true,1220050240,28,1221759421,1709181
1668385115,205254,true,1220050240,28,1221881597,1831357
1668385367,205254,true,1220050240,28,1222370423,2320183
1668385379,205254,true,1220050240,28,1222492660,2442420
1668385415,205254,true,1220050240,28,1222492660,2442420
1668385475,205255,true,1219928247,28,1222492660,2564413
1668385487,205256,true,1219806266,28,1222370423,2564157
1668385499,205256,true,1219806266,28,1222370423,2564157
1668385523,205258,true,1219562342,28,1222003785,2441443
1668385547,205262,true,1219074639,28,1221759421,2684782
1668385571,205264,true,1218830860,28,1221392966,2562106
1668385583,205264,true,1218830860,28,1221270839,2439979
1668385715,205265,true,1218708989,28,1220050240,1341251
1668385991,205269,true,1218221628,28,1217490951,-730677
1668386183,205270,true,1218099818,28,1215423077,-2676741
1668386195,205270,true,1218099818,28,1215301547,-2798271
1668386255,205271,true,1217978020,28,1214572622,-3405398
1668386519,205274,true,1217612700,28,1212024823,-5587877
1668386567,205275,true,1217490951,28,1211540134,-5950817
1668386579,205275,true,1217490951,28,1211418992,-6071959
1668386603,205276,true,1217369214,28,1211297862,-6071352
1668386915,205278,true,1217125776,28,1208636069,-8489707
1668387023,205279,true,1217004076,28,1207790362,-9213714
1668387047,205279,true,1217004076,28,1207548840,-9455236
1668387155,205278,true,1217125776,28,1206583236,-10542540
1668387695,205279,true,1217004076,28,1206583236,-10420840
1668387887,205279,true,1217004076,28,1206945247,-10058829
1668388211,205279,true,1217004076,28,1207065941,-9938135
1668388355,205279,true,1217004076,28,1206945247,-10058829
1668388475,205280,true,1216882388,28,1206583236,-10299152
1668388487,205280,true,1216882388,28,1206583236,-10299152
1668388499,205280,true,1216882388,28,1206583236,-10299152
1668388523,205280,true,1216882388,28,1206462589,-10419799
1668388667,205281,true,1216760712,28,1206100723,-10659989
1668388715,205281,true,1216760712,28,1205980125,-10780587
1668388727,205281,true,1216760712,28,1205859539,-10901173
1668388763,205281,true,1216760712,28,1205738965,-11021747
1668388787,205283,true,1216517396,28,1205618403,-10898993
1668388799,205284,true,1216395756,28,1205618403,-10777353
1668388859,205284,true,1216395756,28,1205256790,-11138966
1668388979,205285,true,1216274129,28,1204774808,-11499321
1668389027,205287,true,1216030911,28,1204533889,-11497022
1668389171,205287,true,1216030911,28,1203931803,-12099108
1668389327,205288,true,1215909320,28,1203209696,-12699624
1668389363,205290,true,1215666174,28,1202969091,-12697083
1668389375,205292,true,1215423077,28,1202969091,-12453986
1668389399,205293,true,1215301547,28,1202848806,-12452741
1668389459,205295,true,1215058523,28,1202608272,-12450251
1668389519,205297,true,1214815548,28,1202247562,-12567986
1668389711,205302,true,1214208323,28,1201045975,-13162348
1668389807,205303,true,1214086914,28,1200445632,-13641282
1668389843,205305,true,1213844133,28,1200085571,-13758562
1668389879,205307,true,1213601401,28,1199725617,-13875784
1668389927,205312,true,1212994782,28,1199365771,-13629011
1668389987,205313,true,1212873495,28,1198766268,-14107227
1668390059,205315,true,1212630956,28,1198167065,-14463891
1668390215,205317,true,1212388466,28,1196730198,-15658268
1668390227,205322,true,1211782454,28,1196730198,-15052256
1668390251,205323,true,1211661288,28,1196490888,-15170400
1668390275,205325,true,1211418992,28,1196132013,-15286979
1668390503,205328,true,1211055639,28,1193742259,-17313380
1668390671,205333,true,1210450293,28,1192310699,-18139594
1668390683,205334,true,1210329260,28,1192191480,-18137780
1668391091,205336,true,1210087230,28,1189452727,-20634503
1668391271,205338,true,1209845249,28,1188263928,-21581321
1668391391,205342,true,1209361432,28,1187669974,-21691458
1668391427,205344,true,1209119596,28,1187551219,-21568377
1668391439,205345,true,1208998696,28,1187432476,-21566220
1668391487,205347,true,1208756933,28,1187195025,-21561908
1668391583,205352,true,1208152735,28,1186601606,-21551129
1668391619,205354,true,1207911141,28,1186482957,-21428184
1668391679,205355,true,1207790362,28,1186245696,-21544666
1668391739,205357,true,1207548840,28,1186008483,-21540357
1668391751,205362,true,1206945247,28,1186008483,-20936764
1668391799,205364,true,1206703894,28,1185771317,-20932577
1668391811,205366,true,1206462589,28,1185771317,-20691272
1668391823,205368,true,1206221333,28,1185652751,-20568582
1668391835,205374,true,1205497854,28,1185652751,-19845103
1668391919,205376,true,1205256790,28,1185297127,-19959663
1668391943,205378,true,1205015775,28,1185060103,-19955672
1668392039,205382,true,1204533889,28,1184349316,-20184573
1668392219,205387,true,1203931803,28,1183520603,-20411200
1668392255,205390,true,1203570695,28,1183283934,-20286761
1668392279,205392,true,1203330017,28,1183165617,-20164400
1668392339,205396,true,1202848806,28,1182929020,-19919786
1668392387,205402,true,1202127349,28,1182810739,-19316610
1668392447,205404,true,1201886960,28,1182574212,-19312748
1668392459,205406,true,1201646618,28,1182574212,-19072406
1668392483,205410,true,1201166080,28,1182455966,-18710114
1668392567,205415,true,1200565677,28,1182219511,-18346166
1668392687,205417,true,1200325600,28,1181983102,-18342498
1668393071,205418,true,1200205579,28,1181156045,-19049534
1668393263,205422,true,1199725617,28,1180919849,-18805768
1668393323,205426,true,1199245847,28,1180801769,-18444078
1668393767,205428,true,1199006033,28,1181392288,-17613745
1668393803,205429,true,1198886145,28,1181628578,-17257567
1668394007,205432,true,1198526551,28,1182574212,-15952339
1668394283,205437,true,1197927467,28,1183402262,-14525205
1668394307,205439,true,1197687918,28,1183402262,-14285656
1668394331,205440,true,1197568161,28,1183520603,-14047558
1668394391,205443,true,1197208962,28,1183638955,-13570007
1668394415,205447,true,1196730198,28,1183757319,-12972879
1668394427,205449,true,1196490888,28,1183757319,-12733569
1668394535,205450,true,1196371251,28,1183875694,-12495557
1668394679,205454,true,1195892822,28,1183994082,-11898740
1668394763,205458,true,1195414585,28,1184112481,-11302104
1668394775,205460,true,1195175538,28,1184230893,-10944645
1668394919,205461,true,1195056032,28,1184704656,-10351376
1668394931,205464,true,1194697587,28,1184823126,-9874461
1668395087,205468,true,1194219827,28,1185415656,-8804171
1668395183,205470,true,1193981019,28,1185771317,-8209702
1668395195,205471,true,1193861633,28,1185889894,-7971739
1668395243,205474,true,1193503546,28,1186008483,-7495063
1668395411,205477,true,1193145567,28,1186601606,-6543961
1668395963,205480,true,1192787695,28,1188739305,-4048390
1668396419,205481,true,1192668428,28,1189928579,-2739849
1668396443,205484,true,1192310699,28,1189928579,-2382120
1668396467,205487,true,1191953077,28,1190047572,-1905505
1668396719,205489,true,1191714722,28,1190285594,-1429128
1668396791,205489,true,1191714722,28,1190285594,-1429128
1668396803,205490,true,1191595563,28,1190285594,-1309969
1668397763,205490,true,1191595563,28,1190761779,-833784
1668397799,205491,true,1191476415,28,1190761779,-714636
1668398495,205491,true,1191476415,28,1192191480,715065
1668398843,205493,true,1191238156,28,1192549173,1311017
1668399023,205493,true,1191238156,28,1192668428,1430272
1668399059,205494,true,1191119044,28,1192668428,1549384
1668399323,205494,true,1191119044,28,1192787695,1668651
1668399407,205496,true,1190880856,28,1192787695,1906839
1668399419,205497,true,1190761779,28,1192668428,1906649
1668399443,205498,true,1190642715,28,1192668428,2025713
1668399455,205499,true,1190523663,28,1192668428,2144765
1668399479,205501,true,1190285594,28,1192668428,2382834
1668399503,205502,true,1190166577,28,1192668428,2501851
1668399515,205504,true,1189928579,28,1192668428,2739849
1668399539,205505,true,1189809598,28,1192549173,2739575
1668399551,205507,true,1189571672,28,1192549173,2977501
1668399875,205510,true,1189214872,28,1190285594,1070722
1668400367,205512,true,1188977065,28,1186957622,-2019443
1668400535,205512,true,1188977065,28,1185889894,-3087171
1668400655,205515,true,1188620443,28,1185178609,-3441834
1668400715,205517,true,1188382755,28,1184704656,-3678099
1668400871,205519,true,1188145114,28,1183875694,-4269420
1668400919,205519,true,1188145114,28,1183520603,-4624511
1668400943,205522,true,1187788741,28,1183402262,-4386479
1668401003,205524,true,1187551219,28,1182929020,-4622199
1668401123,205526,true,1187313745,28,1182101301,-5212444
1668401723,205526,true,1187313745,28,1180211545,-7102200
1668401747,205529,true,1186957622,28,1180211545,-6746077
1668401891,205531,true,1186720266,28,1179975538,-6744728
1668401927,205533,true,1186482957,28,1179975538,-6507419
1668402167,205532,true,1186601606,28,1179975538,-6626068
1668402227,205535,true,1186245696,28,1179975538,-6270158
1668402335,205536,true,1186127084,28,1179975538,-6151546
1668402539,205538,true,1185889894,28,1179975538,-5914356
1668403163,205537,true,1186008483,28,1180801769,-5206714
1668403175,205540,true,1185652751,28,1180919849,-4732902
1668403247,205541,true,1185534198,28,1181037941,-4496257
1668403511,205543,true,1185297127,28,1181864916,-3432211
1668404147,205542,true,1185415656,28,1183047313,-2368343
1668404507,205544,true,1185178609,28,1182929020,-2249589
1668404531,205545,true,1185060103,28,1182929020,-2131083
1668404543,205546,true,1184941609,28,1182929020,-2012589
1668404795,205546,true,1184941609,28,1182455966,-2485643
1668404807,205549,true,1184586197,28,1182455966,-2130231
1668404951,205549,true,1184586197,28,1182101301,-2484896
1668405191,205550,true,1184467751,28,1181274161,-3193590
1668405311,205550,true,1184467751,28,1180919849,-3547902
1668405935,205552,true,1184230893,28,1179267801,-4963092
1668405947,205552,true,1184230893,28,1179267801,-4963092
1668406343,205553,true,1184112481,28,1178796211,-5316270
1668406571,205552,true,1184230893,28,1178914091,-5316802
1668407435,205553,true,1184112481,28,1179385727,-4726754
1668407483,205554,true,1183994082,28,1179385727,-4608355
1668407495,205554,true,1183994082,28,1179385727,-4608355
1668407615,205554,true,1183994082,28,1179503666,-4490416
1668407639,205555,true,1183875694,28,1179503666,-4372028
1668407663,205556,true,1183757319,28,1179503666,-4253653
1668407675,205556,true,1183757319,28,1179503666,-4253653
1668407687,205556,true,1183757319,28,1179503666,-4253653
1668407699,205557,true,1183638955,28,1179503666,-4135289
1668407711,205557,true,1183638955,28,1179503666,-4135289
1668407735,205557,true,1183638955,28,1179503666,-4135289
1668407795,205557,true,1183638955,28,1179621616,-4017339
1668407915,205558,true,1183520603,28,1179739579,-3781024
1668407939,205558,true,1183520603,28,1179857553,-3663050
1668407951,205558,true,1183520603,28,1179857553,-3663050
1668408023,205557,true,1183638955,28,1179975538,-3663417
1668408035,205558,true,1183520603,28,1179975538,-3545065
1668408047,205557,true,1183638955,28,1180093536,-3545419
1668408059,205557,true,1183638955,28,1180093536,-3545419
1668408071,205556,true,1183757319,28,1180093536,-3663783
1668408083,205555,true,1183875694,28,1180211545,-3664149
1668408095,205554,true,1183994082,28,1180211545,-3782537
1668408107,205553,true,1184112481,28,1180329566,-3782915
1668408131,205550,true,1184467751,28,1180565644,-3902107
1668408143,205549,true,1184586197,28,1180801769,-3784428
1668408179,205547,true,1184823126,28,1181274161,-3548965
1668408215,205545,true,1185060103,28,1181746741,-3313362
1668408227,205542,true,1185415656,28,1181983102,-3432554
1668408239,205540,true,1185652751,28,1182337733,-3315018
1668408251,205537,true,1186008483,28,1182574212,-3434271
1668408263,205534,true,1186364321,28,1182810739,-3553582
1668408275,205530,true,1186838938,28,1183047313,-3791625
1668408287,205529,true,1186957622,28,1183283934,-3673688
1668408335,205527,true,1187195025,28,1184349316,-2845709
1668408347,205524,true,1187551219,28,1184586197,-2965022
1668408359,205521,true,1187907520,28,1184823126,-3084394
1668408383,205520,true,1188026311,28,1185297127,-2729184
1668408407,205518,true,1188263928,28,1185652751,-2611177
1668408431,205515,true,1188620443,28,1186127084,-2493359
1668408551,205512,true,1188977065,28,1188145114,-831951
1668408563,205512,true,1188977065,28,1188263928,-713137
1668408575,205511,true,1189095962,28,1188501593,-594369
1668408587,205508,true,1189452727,28,1188739305,-713422
1668408635,205503,true,1190047572,28,1189809598,-237974
1668408683,205502,true,1190166577,28,1190761779,595202
1668408695,205501,true,1190285594,28,1191119044,833450
1668408707,205498,true,1190642715,28,1191357279,714564
1668408731,205494,true,1191119044,28,1191833894,714850
1668408743,205492,true,1191357279,28,1192191480,834201
1668408755,205491,true,1191476415,28,1192549173,1072758
1668408899,205487,true,1191953077,28,1196490888,4537811
1668408947,205483,true,1192429930,28,1197807687,5377757
1668409067,205481,true,1192668428,28,1201045975,8377547
1668409127,205480,true,1192787695,28,1202728533,9940838
1668409151,205476,true,1193264881,28,1203450350,10185469
1668409163,205471,true,1193861633,28,1203811422,9949789
1668409175,205469,true,1194100417,28,1204172601,10072184
1668409199,205467,true,1194339249,28,1204895285,10556036
1668409223,205462,true,1194936538,28,1205618403,10681865
1668409235,205458,true,1195414585,28,1205980125,10565540
1668409247,205456,true,1195653680,28,1206341955,10688275
1668409295,205454,true,1195892822,28,1207790362,11897540
1668409319,205450,true,1196371251,28,1208515217,12143966
1668409583,205446,true,1196849871,28,1216030911,19181040
1668409619,205444,true,1197089253,28,1217125776,20036523
1668409715,205443,true,1197208962,28,1219684298,22475336
1668409727,205438,true,1197807687,28,1220050240,22242553
1668409787,205435,true,1198167065,28,1221637257,23470192
1668410231,205433,true,1198406710,28,1227883209,29476499
1668410243,205432,true,1198526551,28,1228005997,29479446
1668410351,205427,true,1199125934,28,1229234556,30108622
1668410375,205423,true,1199605656,28,1229357479,29751823
1668410519,205422,true,1199725617,28,1230218288,30492671
1668410663,205420,true,1199965574,28,1230095278,30129704
1668410675,205416,true,1200445632,28,1230095278,29649646
1668410687,205412,true,1200925883,28,1230095278,29169395
1668410699,205410,true,1201166080,28,1230095278,28929198
1668410711,205406,true,1201646618,28,1230095278,28448660
1668410759,205401,true,1202247562,28,1230218288,27970726
1668410783,205397,true,1202728533,28,1230341309,27612776
1668410795,205394,true,1203089388,28,1230341309,27251921
1668410879,205389,true,1203691053,28,1230956603,27265550
1668410951,205383,true,1204413448,28,1231572204,27158756
1668410963,205379,true,1204895285,28,1231572204,26676919
1668410975,205376,true,1205256790,28,1231695362,26438572
1668410987,205371,true,1205859539,28,1231695362,25835823
1668411023,205363,true,1206824564,28,1232064907,25240343
1668411071,205358,true,1207428097,28,1232311333,24883236
1668411083,205356,true,1207669595,28,1232434564,24764969
1668411227,205350,true,1208394378,28,1233914299,25519921
1668411431,205342,true,1209361432,28,1236013632,26652200
1668411551,205337,true,1209966234,28,1237621414,27655180
1668411683,205335,true,1210208239,28,1239231288,29023049
1668411695,205329,true,1210934545,28,1239355211,28420666
1668411707,205321,true,1211903632,28,1239479146,27575514
1668411743,205317,true,1212388466,28,1239975012,27586546
1668411899,205314,true,1212752219,28,1241836278,29084059
1668411947,205309,true,1213358717,28,1242457320,29098603
1668412019,205301,true,1214329743,28,1243451634,29121891
1668412031,205297,true,1214815548,28,1243700336,28884788
1668412055,205293,true,1215301547,28,1243949089,28647542
1668412295,205288,true,1215909320,28,1247062696,31153376
1668412331,205281,true,1216760712,28,1247561596,30800884
1668412343,205276,true,1217369214,28,1247811121,30441907
1668412355,205272,true,1217856234,28,1247935902,30079668
1668412391,205266,true,1218587131,28,1248435151,29848020
1668412655,205258,true,1219562342,28,1251685143,32122801
1668412811,205253,true,1220172245,28,1252561586,32389341
1668412823,205250,true,1220538333,28,1252561586,32023253
1668412871,205244,true,1221270839,28,1252812111,31541272
1668412991,205235,true,1222370423,28,1253563986,31193563
1668413015,205230,true,1222981730,28,1253689342,30707612
1668413051,205226,true,1223470996,28,1253940093,30469097
1668413075,205220,true,1224205262,28,1254065487,29860225
1668413135,205211,true,1225307488,28,1254567188,29259700
1668413183,205205,true,1226042856,28,1254943596,28900740
1668413579,205201,true,1226533347,28,1257707373,31174026
1668413591,205195,true,1227269451,28,1257833144,30563693
1668413675,205186,true,1228374435,28,1258713891,30339456
1668413783,205179,true,1229234556,28,1259721215,30486659
1668413807,205175,true,1229726323,28,1259847187,30120864
1668413819,205169,true,1230464343,28,1259973171,29508828
1668413867,205160,true,1231572204,28,1260351201,28778997
1668413891,205154,true,1232311333,28,1260603284,28291951
1668413939,205150,true,1232804331,28,1260981503,28177172
1668413987,205144,true,1233544199,28,1261485971,27941772
1668414023,205135,true,1234654833,28,1261738281,27083448
1668414155,205130,true,1235272283,28,1262748025,27475742
1668414275,205126,true,1235766466,28,1263379525,27613059
1668414467,205120,true,1236508112,28,1264517022,28008910
1668414647,205111,true,1237621414,28,1265402449,27781035
1668414671,205106,true,1238240349,28,1265402449,27162100
1668414935,205103,true,1238611858,28,1265782108,27170250
1668415019,205097,true,1239355211,28,1265782108,26426897
1668415031,205089,true,1240347042,28,1265782108,25435066
1668415055,205086,true,1240719184,28,1265655542,24936358
1668415091,205083,true,1241091436,28,1265655542,24564106
1668415127,205080,true,1241463801,28,1265528989,24065188
1668415199,205073,true,1242333087,28,1265402449,23069362
1668416111,205070,true,1242705824,28,1261612120,18906296
1668416303,205068,true,1242954377,28,1260981503,18027126
1668416555,205066,true,1243202981,28,1260351201,17148220
1668416807,205061,true,1243824706,28,1259343374,15518668
1668416831,205059,true,1244073484,28,1259343374,15269890
1668416879,205057,true,1244322311,28,1259217452,14895141
1668416939,205055,true,1244571188,28,1258965646,14394458
1668417023,205050,true,1245193598,28,1258839762,13646164
1668417251,205048,true,1245442649,28,1258462186,13019537
1668417515,205046,true,1245691750,28,1257958927,12267177
1668417659,205042,true,1246190102,28,1257581615,11391513
1668417683,205037,true,1246813321,28,1257455869,10642548
1668417695,205035,true,1247062696,28,1257455869,10393173
1668417743,205033,true,1247312121,28,1257330136,10018015
1668417839,205030,true,1247686352,28,1257078708,9392356
1668417863,205025,true,1248310320,28,1256953012,8642692
1668417971,205024,true,1248435151,28,1256701660,8266509
1668417995,205022,true,1248684851,28,1256576002,7891151
1668418295,205019,true,1249059494,28,1255947902,6888408
1668418427,205014,true,1249684149,28,1255696751,6012602
1668418631,205013,true,1249809117,28,1255445649,5636532
1668418679,205012,true,1249934098,28,1255445649,5511551
1668418691,205009,true,1250309116,28,1255445649,5136533
1668418739,205006,true,1250684246,28,1255571193,4886947
1668419111,205005,true,1250809314,28,1255947902,5138588
1668419207,205004,true,1250934395,28,1255947902,5013507
1668419519,205001,true,1251309713,28,1256576002,5266289
1668420095,204997,true,1251810312,28,1257707373,5897061
1668420107,204997,true,1251810312,28,1257707373,5897061
1668420119,204996,true,1251935493,28,1257707373,5771880
1668420155,204994,true,1252185893,28,1257707373,5521480
1668420587,204992,true,1252436342,28,1257581615,5145273
1668420911,204991,true,1252561586,28,1257078708,4517122
1668421415,204990,true,1252686842,28,1256324724,3637882
1668421451,204988,true,1252937392,28,1256199105,3261713
1668421547,204985,true,1253313311,28,1256073497,2760186
1668421775,204984,true,1253438642,28,1255571193,2132551
1668421931,204984,true,1253438642,28,1255194597,1755955
1668422027,204982,true,1253689342,28,1255194597,1505255
1668422039,204979,true,1254065487,28,1255194597,1129110
1668422063,204978,true,1254190893,28,1255194597,1003704
1668422087,204977,true,1254316313,28,1255194597,878284
1668422207,204974,true,1254692645,28,1255194597,501952
1668422267,204971,true,1255069090,28,1255194597,125507
1668422291,204970,true,1255194597,28,1255194597,0
1668422843,204968,true,1255445649,28,1256073497,627848
1668422855,204966,true,1255696751,28,1256073497,376746
1668423107,204963,true,1256073497,28,1256576002,502505
1668423179,204961,true,1256324724,28,1256701660,376936
1668423551,204960,true,1256450357,28,1257455869,1005512
1668423611,204957,true,1256827330,28,1257581615,754285
1668424607,204955,true,1257078708,28,1258588032,1509324
1668424679,204954,true,1257204416,28,1258588032,1383616
1668424763,204952,true,1257455869,28,1258839762,1383893
1668424775,204951,true,1257581615,28,1258839762,1258147
1668424811,204949,true,1257833144,28,1258965646,1132502
1668424823,204948,true,1257958927,28,1258965646,1006719
1668424859,204947,true,1258084723,28,1258965646,880923
1668424895,204946,true,1258210531,28,1259091543,881012
1668425075,204945,true,1258336352,28,1259217452,881100
1668425111,204944,true,1258462186,28,1259217452,755266
1668425123,204944,true,1258462186,28,1259217452,755266
1668425159,204943,true,1258588032,28,1259217452,629420
1668425231,204943,true,1258588032,28,1259217452,629420
1668425279,204942,true,1258713891,28,1259217452,503561
1668425291,204942,true,1258713891,28,1259217452,503561
1668425303,204942,true,1258713891,28,1259217452,503561
1668425351,204941,true,1258839762,28,1259217452,377690
1668425519,204941,true,1258839762,28,1259091543,251781
1668425591,204940,true,1258965646,28,1259091543,125897
1668425615,204940,true,1258965646,28,1258965646,0
1668425639,204940,true,1258965646,28,1258965646,0
1668425663,204940,true,1258965646,28,1258965646,0
1668426107,204940,true,1258965646,28,1258084723,-880923
1668426251,204939,true,1259091543,28,1257833144,-1258399
1668426491,204939,true,1259091543,28,1257330136,-1761407
1668426587,204939,true,1259091543,28,1256953012,-2138531
1668427151,204939,true,1259091543,28,1255571193,-3520350
1668427211,204939,true,1259091543,28,1255571193,-3520350
1668427343,204939,true,1259091543,28,1255320117,-3771426
1668427367,204939,true,1259091543,28,1255320117,-3771426
1668427391,204939,true,1259091543,28,1255194597,-3896946
1668427403,204939,true,1259091543,28,1255194597,-3896946
1668427415,204940,true,1258965646,28,1255194597,-3771049
1668427427,204941,true,1258839762,28,1255194597,-3645165
1668427499,204942,true,1258713891,28,1254943596,-3770295
1668427511,204942,true,1258713891,28,1254818114,-3895777
1668427523,204944,true,1258462186,28,1254818114,-3644072
1668427583,204945,true,1258336352,28,1254441744,-3894608
1668427679,204947,true,1258084723,28,1253940093,-4144630
1668427859,204948,true,1257958927,28,1253062686,-4896241
1668427907,204950,true,1257707373,28,1252812111,-4895262
1668427955,204951,true,1257581615,28,1252561586,-5020029
1668427967,204954,true,1257204416,28,1252436342,-4768074
1668427991,204955,true,1257078708,28,1252311111,-4767597
1668428003,204956,true,1256953012,28,1252311111,-4641901
1668428099,204957,true,1256827330,28,1251935493,-4891837
1668428147,204959,true,1256576002,28,1251810312,-4765690
1668428591,204960,true,1256450357,28,1250434147,-6016210
1668428615,204961,true,1256324724,28,1250309116,-6015608
1668428651,204962,true,1256199105,28,1250184097,-6015008
1668428735,204964,true,1255947902,28,1249934098,-6013804
1668428771,204964,true,1255947902,28,1249934098,-6013804
1668428783,204965,true,1255822320,28,1249934098,-5888222
1668428843,204965,true,1255822320,28,1249809117,-6013203
1668428867,204967,true,1255571193,28,1249809117,-5762076
1668428879,204967,true,1255571193,28,1249809117,-5762076
1668428903,204968,true,1255445649,28,1249809117,-5636532
1668429155,204968,true,1255445649,28,1250059091,-5386558
1668429167,204969,true,1255320117,28,1250184097,-5136020
1668429179,204968,true,1255445649,28,1250184097,-5261552
1668429287,204969,true,1255320117,28,1250684246,-4635871
1668429323,204968,true,1255445649,28,1250934395,-4511254
1668429347,204969,true,1255320117,28,1251184595,-4135522
1668429371,204968,true,1255445649,28,1251309713,-4135936
1668429635,204969,true,1255320117,28,1253438642,-1881475
1668430799,204967,true,1255571193,28,1259973171,4401978
1668430883,204968,true,1255445649,28,1260099169,4653520
1668431099,204967,true,1255571193,28,1260351201,4780008
1668431159,204968,true,1255445649,28,1260351201,4905552
1668431195,204966,true,1255696751,28,1260351201,4654450
1668431207,204967,true,1255571193,28,1260477236,4906043
1668431243,204965,true,1255822320,28,1260603284,4780964
1668431267,204965,true,1255822320,28,1260729344,4907024
1668431303,204962,true,1256199105,28,1260855417,4656312
1668431339,204963,true,1256073497,28,1260981503,4908006
1668431363,204962,true,1256199105,28,1261107601,4908496
1668431375,204961,true,1256324724,28,1261107601,4782877
1668431411,204960,true,1256450357,28,1261107601,4657244
1668431423,204960,true,1256450357,28,1261107601,4657244
1668431471,204960,true,1256450357,28,1261233712,4783355
1668431531,204959,true,1256576002,28,1261233712,4657710
1668431543,204958,true,1256701660,28,1261233712,4532052
1668431567,204959,true,1256576002,28,1261233712,4657710
1668431579,204958,true,1256701660,28,1261233712,4532052
1668431591,204958,true,1256701660,28,1261233712,4532052
1668431603,204956,true,1256953012,28,1261233712,4280700
1668431639,204956,true,1256953012,28,1261485971,4532959
1668431675,204954,true,1257204416,28,1261738281,4533865
1668431867,204953,true,1257330136,28,1263505863,6175727
1668431879,204951,true,1257581615,28,1263632214,6050599
1668431891,204951,true,1257581615,28,1263758577,6176962
1668432083,204949,true,1257833144,28,1265655542,7822398
1668432203,204947,true,1258084723,28,1266795088,8710365
1668432215,204945,true,1258336352,28,1266921768,8585416
1668432239,204945,true,1258336352,28,1267175165,8838813
1668432263,204943,true,1258588032,28,1267428612,8840580
1668432275,204940,true,1258965646,28,1267555355,8589709
1668432455,204938,true,1259217452,28,1269584966,10367514
1668432467,204937,true,1259343374,28,1269711924,10368550
1668432491,204935,true,1259595255,28,1270092876,10497621
1668432503,204932,true,1259973171,28,1270219885,10246714
1668432539,204930,true,1260225179,28,1270600989,10375810
1668432647,204928,true,1260477236,28,1272380987,11903751
1668432659,204926,true,1260729344,28,1272508225,11778881
1668432683,204923,true,1261107601,28,1272890016,11782415
1668432755,204921,true,1261359835,28,1273908684,12548849
1668432767,204921,true,1261359835,28,1274036075,12676240
1668433067,204919,true,1261612120,28,1277480448,15868328
1668433391,204916,true,1261990641,28,1281062227,19071586
1668433403,204914,true,1262243052,28,1281190333,18947281
1668433451,204914,true,1262243052,28,1281446584,19203532
1668433751,204912,true,1262495513,28,1282087435,19591922
1668433763,204910,true,1262748025,28,1282087435,19339410
1668433775,204908,true,1263000587,28,1282087435,19086848
1668433787,204908,true,1263000587,28,1282087435,19086848
1668433799,204907,true,1263126887,28,1282087435,18960548
1668433811,204906,true,1263253200,28,1282087435,18834235
1668433823,204905,true,1263379525,28,1281959239,18579714
1668433835,204905,true,1263379525,28,1281959239,18579714
1668433859,204905,true,1263379525,28,1281831056,18451531
1668433871,204904,true,1263505863,28,1281702886,18197023
1668433883,204904,true,1263505863,28,1281446584,17940721
1668433895,204905,true,1263379525,28,1281318452,17938927
1668433931,204907,true,1263126887,28,1280806053,17679166
1668433955,204906,true,1263253200,28,1280421888,17168688
1668434219,204906,true,1263253200,28,1276203670,12950470
1668434243,204907,true,1263126887,28,1275948468,12821581
1668434267,204908,true,1263000587,28,1275693316,12692729
1668434459,204907,true,1263126887,28,1273017305,9890418
1668434471,204905,true,1263379525,28,1272762740,9383215
1668434507,204906,true,1263253200,28,1272253762,9000562
1668434639,204907,true,1263126887,28,1270346907,7220020
1668434663,204906,true,1263253200,28,1269965879,6712679
1668434771,204905,true,1263379525,28,1268569754,5190229
1668435095,204905,true,1263379525,28,1264011341,631816
1668435287,204907,true,1263126887,28,1261485971,-1640916
1668435299,204906,true,1263253200,28,1261359835,-1893365
1668435419,204904,true,1263505863,28,1259847187,-3658676
1668435431,204904,true,1263505863,28,1259721215,-3784648
1668435443,204906,true,1263253200,28,1259469308,-3783892
1668435479,204905,true,1263379525,28,1259091543,-4287982
1668435539,204904,true,1263505863,28,1258210531,-5295332
1668435587,204904,true,1263505863,28,1257581615,-5924248
1668435599,204906,true,1263253200,28,1257455869,-5797331
1668435623,204904,true,1263505863,28,1257204416,-6301447
1668435959,204903,true,1263632214,28,1256953012,-6679202
1668435995,204903,true,1263632214,28,1256953012,-6679202
1668436031,204905,true,1263379525,28,1256953012,-6426513
1668436043,204903,true,1263632214,28,1256827330,-6804884
1668436067,204902,true,1263758577,28,1256701660,-7056917
1668436079,204902,true,1263758577,28,1256576002,-7182575
1668436115,204904,true,1263505863,28,1256450357,-7055506
1668436139,204902,true,1263758577,28,1256199105,-7559472
1668436283,204902,true,1263758577,28,1255320117,-8438460
1668436295,204901,true,1263884953,28,1255194597,-8690356
1668436415,204903,true,1263632214,28,1254567188,-9065026
1668436427,204901,true,1263884953,28,1254567188,-9317765
1668436547,204902,true,1263758577,28,1253814711,-9943866
1668436583,204901,true,1263884953,28,1253563986,-10320967
1668436595,204904,true,1263505863,28,1253438642,-10067221
1668436631,204902,true,1263758577,28,1253187992,-10570585
1668436643,204903,true,1263632214,28,1253062686,-10569528
1668436775,204904,true,1263505863,28,1251810312,-11695551
1668436811,204906,true,1263253200,28,1251434844,-11818356
1668436943,204905,true,1263379525,28,1250309116,-13070409
1668437135,204906,true,1263253200,28,1248684851,-14568349
1668437207,204907,true,1263126887,28,1248060696,-15066191
1668437219,204909,true,1262874300,28,1248060696,-14813604
1668437351,204909,true,1262874300,28,1246938003,-15936297
1668437363,204910,true,1262748025,28,1246938003,-15810022
1668437375,204911,true,1262621763,28,1246813321,-15808442
1668437435,204913,true,1262369276,28,1246563996,-15805280
1668437447,204912,true,1262495513,28,1246439352,-16056161
1668437699,204914,true,1262243052,28,1245442649,-16800403
1668437711,204915,true,1262116840,28,1245442649,-16674191
1668437735,204917,true,1261864455,28,1245318117,-16546338
1668438059,204916,true,1261990641,28,1245069091,-16921550
1668438095,204917,true,1261864455,28,1245069091,-16795364
1668438119,204918,true,1261738281,28,1245069091,-16669190
1668438287,204921,true,1261359835,28,1245193598,-16166237
1668439259,204919,true,1261612120,28,1248684851,-12927269
1668439271,204920,true,1261485971,28,1248684851,-12801120
1668439331,204922,true,1261233712,28,1248934600,-12299112
1668439343,204925,true,1260855417,28,1248934600,-11920817
1668439367,204924,true,1260981503,28,1248934600,-12046903
1668439619,204926,true,1260729344,28,1249059494,-11669850
1668439631,204927,true,1260603284,28,1249059494,-11543790
1668439679,204930,true,1260225179,28,1248934600,-11290579
1668439691,204930,true,1260225179,28,1248934600,-11290579
1668439727,204932,true,1259973171,28,1248809719,-11163452
1668439871,204934,true,1259721215,28,1248185502,-11535713
1668439895,204937,true,1259343374,28,1248060696,-11282678
1668440339,204936,true,1259469308,28,1245442649,-14026659
1668440375,204938,true,1259217452,28,1245193598,-14023854
1668440675,204940,true,1258965646,28,1243575979,-15389667
1668440771,204943,true,1258588032,28,1243078673,-15509359
1668441131,204942,true,1258713891,28,1241463801,-17250090
1668441167,204945,true,1258336352,28,1241339667,-16996685
1668441179,204947,true,1258084723,28,1241215546,-16869177
1668441191,204951,true,1257581615,28,1241215546,-16366069
1668441455,204952,true,1257455869,28,1240471077,-16984792
1668441743,204954,true,1257204416,28,1240595124,-16609292
1668441899,204957,true,1256827330,28,1240967340,-15859990
1668441911,204961,true,1256324724,28,1240967340,-15357384
1668441923,204962,true,1256199105,28,1240967340,-15231765
1668442319,204964,true,1255947902,28,1241960461,-13987441
1668442367,204967,true,1255571193,28,1241960461,-13610732
1668442547,204972,true,1254943596,28,1241836278,-13107318
1668442571,204973,true,1254818114,28,1241712106,-13106008
1668442595,204976,true,1254441744,28,1241712106,-12729638
1668442607,204979,true,1254065487,28,1241587948,-12477539
1668442691,204985,true,1253313311,28,1241215546,-12097765
1668442703,204986,true,1253187992,28,1241091436,-12096556
1668442739,204990,true,1252686842,28,1240967340,-11719502
1668442811,204995,true,1252060687,28,1240595124,-11465563
1668442823,205001,true,1251309713,28,1240471077,-10838636
1668443051,205003,true,1251059489,28,1238859593,-12199896
1668443495,205007,true,1250559190,28,1235766466,-14792724
1668443687,205011,true,1250059091,28,1234531379,-15527712
1668443699,205016,true,1249434249,28,1234407939,-15026310
1668443711,205018,true,1249184400,28,1234284510,-14899890
1668443735,205022,true,1248684851,28,1234161094,-14523757
1668443759,205025,true,1248310320,28,1234037690,-14272630
1668444215,205030,true,1247686352,28,1231572204,-16114148
1668444479,205031,true,1247561596,28,1231202807,-16358789
1668444659,205035,true,1247062696,28,1231449060,-15613636
1668444887,205039,true,1246563996,28,1232064907,-14499089
1668444959,205043,true,1246065495,28,1232188114,-13877381
1668445007,205044,true,1245940901,28,1232188114,-13752787
1668445091,205047,true,1245567193,28,1232311333,-13255860
1668445103,205050,true,1245193598,28,1232311333,-12882265
1668445211,205053,true,1244820115,28,1232434564,-12385551
1668445535,205053,true,1244820115,28,1232804331,-12015784
1668445739,205056,true,1244446743,28,1232557807,-11888936
1668445811,205058,true,1244197891,28,1232434564,-11763327
1668445931,205060,true,1243949089,28,1232311333,-11637756
1668445955,205060,true,1243949089,28,1232311333,-11637756
1668446099,205062,true,1243700336,28,1232064907,-11635429
1668446207,205064,true,1243451634,28,1231941713,-11509921
1668447179,205066,true,1243202981,28,1231941713,-11261268
1668447203,205067,true,1243078673,28,1231941713,-11136960
1668447215,205070,true,1242705824,28,1231941713,-10764111
1668447251,205072,true,1242457320,28,1232064907,-10392413
1668447443,205073,true,1242333087,28,1232681063,-9652024
1668447671,205073,true,1242333087,28,1233420856,-8912231
1668447899,205076,true,1241960461,28,1234037690,-7922771
1668448031,205078,true,1241712106,28,1234531379,-7180727
1668448091,205079,true,1241587948,28,1234654833,-6933115
1668448127,205079,true,1241587948,28,1234778298,-6809650
1668448511,205082,true,1241215546,28,1235766466,-5449080
1668449327,205084,true,1240967340,28,1237373927,-3593413
1668449711,205085,true,1240843255,28,1237497664,-3345591
1668450527,205085,true,1240843255,28,1237497664,-3345591
1668450647,205087,true,1240595124,28,1237745176,-2849948
1668451067,205089,true,1240347042,28,1238364173,-1982869
1668451247,205089,true,1240347042,28,1238735719,-1611323
1668451583,205089,true,1240347042,28,1239231288,-1115754
1668452171,205091,true,1240099010,28,1240347042,248032
1668452279,205092,true,1239975012,28,1240471077,496065
1668452723,205093,true,1239851027,28,1240719184,868157
1668453143,205092,true,1239975012,28,1240843255,868243
1668453251,205094,true,1239727055,28,1240719184,992129
1668453263,205095,true,1239603094,28,1240719184,1116090
1668453287,205095,true,1239603094,28,1240595124,992030
1668453335,205095,true,1239603094,28,1240595124,992030
1668453347,205097,true,1239355211,28,1240595124,1239913
1668453359,205099,true,1239107377,28,1240471077,1363700
1668453383,205099,true,1239107377,28,1240471077,1363700
1668453407,205099,true,1239107377,28,1240347042,1239665
1668453431,205101,true,1238859593,28,1240223020,1363427
1668453707,205103,true,1238611858,28,1238983479,371621
1668453827,205103,true,1238611858,28,1238364173,-247685
1668455039,205103,true,1238611858,28,1232064907,-6546951
1668455075,205105,true,1238364173,28,1231818531,-6545642
1668455111,205106,true,1238240349,28,1231695362,-6544987
1668455123,205106,true,1238240349,28,1231572204,-6668145
1668455135,205108,true,1237992738,28,1231449060,-6543678
1668455147,205110,true,1237745176,28,1231325927,-6419249
1668455159,205112,true,1237497664,28,1231202807,-6294857
1668455171,205112,true,1237497664,28,1231202807,-6294857
1668455183,205114,true,1237250202,28,1231079699,-6170503
1668455195,205116,true,1237002789,28,1230956603,-6046186
1668455219,205118,true,1236755426,28,1230710449,-6044977
1668455267,205119,true,1236631763,28,1230341309,-6290454
1668455279,205122,true,1236260847,28,1230218288,-6042559
1668455291,205124,true,1236013632,28,1230218288,-5795344
1668455315,205126,true,1235766466,28,1229972281,-5794185
1668455423,205128,true,1235519350,28,1228988746,-6530604
1668455435,205130,true,1235272283,28,1228865859,-6406424
1668455459,205134,true,1234778298,28,1228620123,-6158175
1668455471,205136,true,1234531379,28,1228620123,-5911256
1668455483,205137,true,1234407939,28,1228497273,-5910666
1668455543,205140,true,1234037690,28,1228005997,-6031693
1668455567,205143,true,1233667553,28,1227883209,-5784344
1668455639,205145,true,1233420856,28,1227392178,-6028678
1668455687,205146,true,1233297527,28,1227024034,-6273493
1668455699,205149,true,1232927611,28,1226901344,-6026267
1668455723,205151,true,1232681063,28,1226656000,-6025063
1668455735,205153,true,1232434564,28,1226533347,-5901217
1668455759,205155,true,1232188114,28,1226288077,-5900037
1668455819,205158,true,1231818531,28,1225675117,-6143414
1668456071,205160,true,1231572204,28,1223226339,-8345865
1668456095,205162,true,1231325927,28,1222981730,-8344197
1668456155,205163,true,1231202807,28,1222370423,-8832384
1668456215,205166,true,1230833520,28,1221759421,-9074099
1668456251,205168,true,1230587390,28,1221515106,-9072284
1668456323,205169,true,1230464343,28,1220904531,-9559812
1668456383,205170,true,1230341309,28,1220416292,-9925017
1668456395,205172,true,1230095278,28,1220294262,-9801016
1668456407,205174,true,1229849296,28,1220294262,-9555034
1668456431,205176,true,1229603363,28,1220050240,-9553123
1668456491,205178,true,1229357479,28,1219440398,-9917081
1668456587,205180,true,1229111644,28,1218587131,-10524513
1668456599,205182,true,1228865859,28,1218465284,-10400575
1668456683,205184,true,1228620123,28,1217612700,-11007423
1668456851,205186,true,1228374435,28,1215909320,-12465115
1668457103,205189,true,1228005997,28,1214694079,-13311918
1668457343,205191,true,1227760432,28,1214451176,-13309256
1668457379,205193,true,1227514917,28,1214329743,-13185174
1668457775,205194,true,1227392178,28,1214937030,-12455148
1668457883,205196,true,1227146736,28,1215180029,-11966707
1668458015,205197,true,1227024034,28,1215423077,-11600957
1668458483,205199,true,1226778666,28,1215909320,-10869346
1668458555,205199,true,1226778666,28,1216030911,-10747755
1668458567,205201,true,1226533347,28,1216030911,-10502436
1668458879,205202,true,1226410706,28,1216760712,-9649994
1668458927,205203,true,1226288077,28,1216760712,-9527365
1668458939,205203,true,1226288077,28,1216760712,-9527365
1668458963,205205,true,1226042856,28,1216760712,-9282144
1668458987,205206,true,1225920264,28,1216760712,-9159552
1668459203,205207,true,1225797685,28,1216760712,-9036973
1668459371,205207,true,1225797685,28,1216517396,-9280289
1668459491,205209,true,1225552562,28,1216395756,-9156806
1668459551,205210,true,1225430019,28,1216274129,-9155890
1668459659,205212,true,1225184970,28,1216152514,-9032456
1668459815,205212,true,1225184970,28,1215909320,-9275650
1668460607,205214,true,1224939969,28,1215180029,-9759940
1668460619,205215,true,1224817488,28,1215180029,-9637459
1668460643,205217,true,1224572561,28,1215180029,-9392532
1668460751,205218,true,1224450116,28,1215301547,-9148569
1668461135,205219,true,1224327683,28,1215909320,-8418363
1668461351,205220,true,1224205262,28,1216639048,-7566214
1668461471,205221,true,1224082854,28,1217125776,-6957078
1668461531,205221,true,1224082854,28,1217247489,-6835365
1668461711,205222,true,1223960458,28,1217978020,-5982438
1668462191,205222,true,1223960458,28,1219684298,-4276160
1668462875,205224,true,1223715703,28,1221392966,-2322737
1668462959,205224,true,1223715703,28,1221515106,-2200597
1668463007,205224,true,1223715703,28,1221515106,-2200597
1668463127,205225,true,1223593343,28,1221759421,-1833922
1668463163,205226,true,1223470996,28,1221759421,-1711575
1668463379,205226,true,1223470996,28,1222003785,-1467211
1668463511,205227,true,1223348661,28,1222125985,-1222676
1668463523,205228,true,1223226339,28,1222125985,-1100354
1668464399,205229,true,1223104028,28,1223226339,122311
1668465143,205230,true,1222981730,28,1223593343,611613
1668465167,205231,true,1222859444,28,1223593343,733899
1668465215,205231,true,1222859444,28,1223470996,611552
1668465515,205233,true,1222614909,28,1222492660,-122249
1668465623,205236,true,1222248198,28,1222125985,-122213
1668465719,205236,true,1222248198,28,1221759421,-488777
1668465971,205237,true,1222125985,28,1220904531,-1221454
1668465983,205239,true,1221881597,28,1220904531,-977066
1668466115,205241,true,1221637257,28,1220538333,-1098924
1668466175,205242,true,1221515106,28,1220294262,-1220844
1668466247,205243,true,1221392966,28,1220172245,-1220721
1668466523,205245,true,1221148724,28,1219440398,-1708326
1668466691,205247,true,1220904531,28,1219074639,-1829892
1668466739,205248,true,1220782453,28,1218952743,-1829710
1668466871,205249,true,1220660387,28,1218587131,-2073256
1668466883,205251,true,1220416292,28,1218587131,-1829161
1668466919,205253,true,1220172245,28,1218465284,-1706961
1668467027,205254,true,1220050240,28,1218587131,-1463109
1668467099,205255,true,1219928247,28,1218830860,-1097387
1668467183,205256,true,1219806266,28,1219074639,-731627
1668467195,205258,true,1219562342,28,1219074639,-487703
1668467207,205259,true,1219440398,28,1219074639,-365759
1668467219,205259,true,1219440398,28,1219196546,-243852
1668467303,205259,true,1219440398,28,1219806266,365868
1668467339,205261,true,1219196546,28,1220050240,853694
1668467531,205260,true,1219318466,28,1221392966,2074500
1668467759,205260,true,1219318466,28,1223104028,3785562
1668467891,205259,true,1219440398,28,1224327683,4887285
1668467903,205261,true,1219196546,28,1224450116,5253570
1668467927,205260,true,1219318466,28,1224695018,5376552
1668468143,205258,true,1219562342,28,1227269451,7707109
1668468491,205257,true,1219684298,28,1231449060,11764762
1668468515,205258,true,1219562342,28,1231695362,12133020
1668468779,205256,true,1219806266,28,1234654833,14848567
1668468851,205253,true,1220172245,28,1235272283,15100038
1668468947,205252,true,1220294262,28,1236260847,15966585
1668469379,205252,true,1220294262,28,1239355211,19060949
1668470039,205250,true,1220538333,28,1242084657,21546324
1668470051,205247,true,1220904531,28,1242084657,21180126
1668470171,205245,true,1221148724,28,1242333087,21184363
1668470207,205245,true,1221148724,28,1242333087,21184363
1668470675,205243,true,1221392966,28,1243078673,21685707
1668470891,205240,true,1221759421,28,1243202981,21443560
1668471047,205237,true,1222125985,28,1243202981,21076996
1668471203,205237,true,1222125985,28,1243202981,21076996
1668471215,205235,true,1222370423,28,1243202981,20832558
1668471359,205232,true,1222737171,28,1243202981,20465810
1668471455,205230,true,1222981730,28,1243078673,20096943
1668471527,205230,true,1222981730,28,1243078673,20096943
1668471563,205228,true,1223226339,28,1243078673,19852334
1668472211,205225,true,1223593343,28,1242457320,18863977
1668472223,205223,true,1223838074,28,1242457320,18619246
1668472235,205223,true,1223838074,28,1242457320,18619246
1668472247,205221,true,1224082854,28,1242581566,18498712
1668472283,205217,true,1224572561,28,1242581566,18009005
1668472307,205215,true,1224817488,28,1242581566,17764078
1668472391,205214,true,1224939969,28,1242830094,17890125
1668472403,205211,true,1225307488,28,1242830094,17522606
1668472715,205208,true,1225675117,28,1243451634,17776517
1668473063,205205,true,1226042856,28,1244073484,18030628
1668473231,205204,true,1226165461,28,1244322311,18156850
1668473327,205202,true,1226410706,28,1244571188,18160482
1668473651,205199,true,1226778666,28,1245069091,18290425
1668473675,205196,true,1227146736,28,1245069091,17922355
1668473723,205196,true,1227146736,28,1245193598,18046862
1668473843,205194,true,1227392178,28,1245193598,17801420
1668473951,205191,true,1227760432,28,1245318117,17557685
1668474035,205188,true,1228128797,28,1245318117,17189320
1668474143,205188,true,1228128797,28,1244944597,16815800
1668474155,205186,true,1228374435,28,1244944597,16570162
1668475139,205183,true,1228742985,28,1241587948,12844963
1668475283,205181,true,1228988746,28,1241091436,12102690
1668475487,205180,true,1229111644,28,1240595124,11483480
1668475511,205178,true,1229357479,28,1240471077,11113598
1668475535,205176,true,1229603363,28,1240471077,10867714
1668475631,205173,true,1229972281,28,1240347042,10374761
1668475667,205173,true,1229972281,28,1240347042,10374761
1668475751,205171,true,1230218288,28,1240223020,10004732
1668475763,205169,true,1230464343,28,1240223020,9758677
1668475799,205166,true,1230833520,28,1240223020,9389500
1668475871,205166,true,1230833520,28,1240223020,9389500
1668475991,205164,true,1231079699,28,1240223020,9143321
1668476027,205162,true,1231325927,28,1240223020,8897093
1668476363,205159,true,1231695362,28,1240719184,9023822
1668476387,205158,true,1231818531,28,1240719184,8900653
1668476459,205156,true,1232064907,28,1240843255,8778348
1668476483,205154,true,1232311333,28,1240967340,8656007
1668476663,205151,true,1232681063,28,1241339667,8658604
1668476675,205150,true,1232804331,28,1241339667,8535336
1668476795,205147,true,1233174209,28,1241960461,8786252
1668476879,205145,true,1233420856,28,1242333087,8912231
1668476891,205141,true,1233914299,28,1242457320,8543021
1668476939,205140,true,1234037690,28,1242830094,8792404
1668476951,205137,true,1234407939,28,1242954377,8546438
1668476999,205133,true,1234901776,28,1243327301,8425525
1668477227,205129,true,1235395811,28,1245193598,9797787
1668477299,205129,true,1235395811,28,1245816319,10420508
1668477575,205126,true,1235766466,28,1248185502,12419036
1668477683,205123,true,1236137233,28,1249059494,12922261
1668477707,205119,true,1236631763,28,1249184400,12552637
1668477863,205118,true,1236755426,28,1250559190,13803764
1668477995,205116,true,1237002789,28,1251559987,14557198
1668478007,205113,true,1237373927,28,1251685143,14311216
1668478151,205109,true,1237868951,28,1252812111,14943160
1668478175,205108,true,1237992738,28,1252937392,14944654
1668478187,205106,true,1238240349,28,1253062686,14822337
1668478235,205103,true,1238611858,28,1253438642,14826784
1668478343,205099,true,1239107377,28,1254316313,15208936
1668478451,205098,true,1239231288,28,1255194597,15963309
1668478499,205096,true,1239479146,28,1255571193,16092047
1668478607,205093,true,1239851027,28,1256199105,16348078
1668478967,205088,true,1240471077,28,1257455869,16984792
1668479363,205088,true,1240471077,28,1258210531,17739454
1668480023,205086,true,1240719184,28,1259469308,18750124
1668480827,205082,true,1241215546,28,1259721215,18505669
1668482279,205077,true,1241836278,28,1259847187,18010909
1668482471,205076,true,1241960461,28,1259847187,17886726
1668483575,205073,true,1242333087,28,1259847187,17514100
1668484055,205070,true,1242705824,28,1259847187,17141363
1668484067,205065,true,1243327301,28,1259847187,16519886
1668484091,205064,true,1243451634,28,1259847187,16395553
1668484187,205061,true,1243824706,28,1259847187,16022481
1668484199,205058,true,1244197891,28,1259847187,15649296
1668484343,205054,true,1244695645,28,1259721215,15025570
1668484367,205052,true,1244944597,28,1259595255,14650658
1668484379,205050,true,1245193598,28,1259595255,14401657
1668484451,205047,true,1245567193,28,1259469308,13902115
1668484463,205043,true,1246065495,28,1259469308,13403813
1668484643,205042,true,1246190102,28,1259217452,13027350
1668484883,205040,true,1246439352,28,1258713891,12274539
1668484907,205037,true,1246813321,28,1258713891,11900570
1668485207,205033,true,1247312121,28,1258084723,10772602
1668485303,205032,true,1247436853,28,1257958927,10522074
1668485411,205030,true,1247686352,28,1257707373,10021021
1668485507,205028,true,1247935902,28,1257581615,9645713
1668485639,205025,true,1248310320,28,1257330136,9019816
1668485759,205024,true,1248435151,28,1257078708,8643557
1668485879,205023,true,1248559995,28,1256953012,8393017
1668485963,205020,true,1248934600,28,1256827330,7892730
1668486095,205018,true,1249184400,28,1256701660,7517260
1668486203,205017,true,1249309318,28,1256576002,7266684
1668486263,205016,true,1249434249,28,1256576002,7141753
1668486323,205015,true,1249559193,28,1256576002,7016809
1668486539,205013,true,1249809117,28,1256199105,6389988
1668486635,205013,true,1249809117,28,1256073497,6264380
1668487235,205012,true,1249934098,28,1255194597,5260499
1668487331,205011,true,1250059091,28,1255069090,5009999
1668487475,205010,true,1250184097,28,1254818114,4634017
1668487571,205009,true,1250309116,28,1254692645,4383529
1668487631,205009,true,1250309116,28,1254692645,4383529
1668487727,205008,true,1250434147,28,1254441744,4007597
1668487739,205007,true,1250559190,28,1254441744,3882554
1668487811,205006,true,1250684246,28,1254316313,3632067
1668487859,205006,true,1250684246,28,1254316313,3632067
1668487955,205005,true,1250809314,28,1254190893,3381579
1668488075,205003,true,1251059489,28,1253940093,2880604
1668488171,205003,true,1251059489,28,1253940093,2880604
1668488279,205002,true,1251184595,28,1253940093,2755498
1668488303,205002,true,1251184595,28,1253940093,2755498
1668488363,205000,true,1251434844,28,1254065487,2630643
1668488711,204999,true,1251559987,28,1254567188,3007201
1668489371,204998,true,1251685143,28,1255696751,4011608
1668489659,204997,true,1251810312,28,1256324724,4514412
1668489671,204996,true,1251935493,28,1256324724,4389231
1668490331,204995,true,1252060687,28,1257455869,5395182
1668490439,204994,true,1252185893,28,1257455869,5269976
1668490571,204994,true,1252185893,28,1257330136,5144243
1668490871,204993,true,1252311111,28,1257078708,4767597
1668490895,204992,true,1252436342,28,1257078708,4642366
1668490907,204991,true,1252561586,28,1256953012,4391426
1668490943,204991,true,1252561586,28,1256953012,4391426
1668491075,204991,true,1252561586,28,1256450357,3888771
1668491147,204991,true,1252561586,28,1256199105,3637519
1668491891,204990,true,1252686842,28,1253313311,626469
1668491963,204990,true,1252686842,28,1252937392,250550
1668492167,204989,true,1252812111,28,1252060687,-751424
1668492275,204989,true,1252812111,28,1251685143,-1126968
1668492371,204988,true,1252937392,28,1251309713,-1627679
1668492527,204988,true,1252937392,28,1250934395,-2002997
1668492623,204988,true,1252937392,28,1250559190,-2378202
1668492755,204987,true,1253062686,28,1250309116,-2753570
1668492827,204986,true,1253187992,28,1250184097,-3003895
1668492851,204985,true,1253313311,28,1250184097,-3129214
1668492899,204985,true,1253313311,28,1250184097,-3129214
1668492935,204984,true,1253438642,28,1250184097,-3254545
1668493019,204983,true,1253563986,28,1250059091,-3504895
1668493127,204983,true,1253563986,28,1250059091,-3504895
1668493187,204982,true,1253689342,28,1250059091,-3630251
1668493211,204982,true,1253689342,28,1250059091,-3630251
1668493319,204981,true,1253814711,28,1249934098,-3880613
1668493931,204980,true,1253940093,28,1249684149,-4255944
1668494495,204980,true,1253940093,28,1250309116,-3630977
1668495071,204979,true,1254065487,28,1250809314,-3256173
1668495527,204978,true,1254190893,28,1251184595,-3006298
1668495647,204977,true,1254316313,28,1251309713,-3006600
1668495671,204977,true,1254316313,28,1251309713,-3006600
1668496331,204976,true,1254441744,28,1252185893,-2255851
1668496355,204975,true,1254567188,28,1252185893,-2381295
1668496367,204974,true,1254692645,28,1252311111,-2381534
1668496463,204974,true,1254692645,28,1252561586,-2131059
1668496487,204972,true,1254943596,28,1252561586,-2382010
1668496499,204972,true,1254943596,28,1252686842,-2256754
1668496511,204971,true,1255069090,28,1252686842,-2382248
1668496535,204971,true,1255069090,28,1252812111,-2256979
1668496559,204970,true,1255194597,28,1252937392,-2257205
1668496583,204970,true,1255194597,28,1252937392,-2257205
1668496595,204970,true,1255194597,28,1253062686,-2131911
1668496631,204970,true,1255194597,28,1253187992,-2006605
1668496679,204969,true,1255320117,28,1253438642,-1881475
1668496691,204968,true,1255445649,28,1253563986,-1881663
1668496703,204968,true,1255445649,28,1253689342,-1756307
1668496715,204968,true,1255445649,28,1253689342,-1756307
1668496763,204966,true,1255696751,28,1254065487,-1631264
1668496799,204966,true,1255696751,28,1254441744,-1255007
1668496931,204965,true,1255822320,28,1255445649,-376671
1668496943,204965,true,1255822320,28,1255571193,-251127
1668496979,204963,true,1256073497,28,1255947902,-125595
1668497015,204963,true,1256073497,28,1256324724,251227
1668497027,204962,true,1256199105,28,1256450357,251252
1668497159,204962,true,1256199105,28,1257958927,1759822
1668497171,204959,true,1256576002,28,1258084723,1508721
1668497195,204959,true,1256576002,28,1258336352,1760350
1668497231,204958,true,1256701660,28,1258839762,2138102
1668497279,204958,true,1256701660,28,1259343374,2641714
1668497327,204956,true,1256953012,28,1259847187,2894175
1668497339,204956,true,1256953012,28,1259847187,2894175
1668497363,204955,true,1257078708,28,1260099169,3020461
1668497459,204956,true,1256953012,28,1260981503,4028491
1668497495,204954,true,1257204416,28,1261233712,4029296
1668497531,204954,true,1257204416,28,1261485971,4281555
1668497543,204953,true,1257330136,28,1261612120,4281984
1668497651,204954,true,1257204416,28,1262369276,5164860
1668498299,204952,true,1257455869,28,1266668421,9212552
1668498311,204952,true,1257455869,28,1266795088,9339219
1668498407,204951,true,1257581615,28,1267428612,9846997
1668498419,204952,true,1257455869,28,1267428612,9972743
1668498467,204949,true,1257833144,28,1267808879,9975735
1668498731,204948,true,1257958927,28,1268569754,10610827
1668498743,204947,true,1258084723,28,1268569754,10485031
1668498899,204948,true,1257958927,28,1268316079,10357152
1668499415,204945,true,1258336352,28,1268316079,9979727
1668499463,204945,true,1258336352,28,1268316079,9979727
1668499475,204944,true,1258462186,28,1268316079,9853893
1668499679,204945,true,1258336352,28,1268442910,10106558
1668499691,204942,true,1258713891,28,1268442910,9729019
1668499703,204942,true,1258713891,28,1268442910,9729019
1668500279,204941,true,1258839762,28,1267808879,8969117
1668500471,204942,true,1258713891,28,1267301882,8587991
1668500591,204939,true,1259091543,28,1267301882,8210339
1668500615,204939,true,1259091543,28,1267428612,8337069
1668500627,204938,true,1259217452,28,1267555355,8337903
1668500651,204937,true,1259343374,28,1267682111,8338737
1668500663,204933,true,1259847187,28,1267682111,7834924
1668500699,204933,true,1259847187,28,1267808879,7961692
1668500711,204932,true,1259973171,28,1267935660,7962489
1668500735,204931,true,1260099169,28,1268062453,7963284
1668500747,204927,true,1260603284,28,1268062453,7459169
1668500771,204926,true,1260729344,28,1268189260,7459916
1668500783,204925,true,1260855417,28,1268189260,7333843
1668500831,204925,true,1260855417,28,1268442910,7587493
1668500843,204921,true,1261359835,28,1268442910,7083075
1668500855,204920,true,1261485971,28,1268569754,7083783
1668500867,204919,true,1261612120,28,1268696611,7084491
1668500879,204917,true,1261864455,28,1268696611,6832156
1668500891,204913,true,1262369276,28,1268823481,6454205
1668500903,204913,true,1262369276,28,1268823481,6454205
1668500915,204912,true,1262495513,28,1268950363,6454850
1668500951,204910,true,1262748025,28,1269077258,6329233
1668500999,204906,true,1263253200,28,1269458020,6204820
1668501023,204906,true,1263253200,28,1269584966,6331766
1668501047,204905,true,1263379525,28,1269711924,6332399
1668501071,204904,true,1263505863,28,1269838895,6333032
1668501083,204900,true,1264011341,28,1269838895,5827554
1668501119,204900,true,1264011341,28,1269965879,5954538
1668501191,204899,true,1264137742,28,1270346907,6209165
1668501215,204898,true,1264264156,28,1270473942,6209786
1668501227,204894,true,1264769938,28,1270473942,5704004
1668501239,204895,true,1264643473,28,1270600989,5957516
1668501263,204894,true,1264769938,28,1270728049,5958111
1668501467,204893,true,1264896415,28,1271490677,6594262
1668501731,204889,true,1265402449,28,1272890016,7487567
1668501839,204889,true,1265402449,28,1273399248,7996799
1668502403,204888,true,1265528989,28,1275948468,10419479
1668502415,204887,true,1265655542,28,1275820886,10165344
1668502559,204882,true,1266288497,28,1275565760,9277263
1668503699,204882,true,1266288497,28,1274290895,8002398
1668503951,204882,true,1266288497,28,1274290895,8002398
1668504119,204880,true,1266541767,28,1274163479,7621712
1668504239,204876,true,1267048460,28,1274163479,7115019
1668504251,204876,true,1267048460,28,1274163479,7115019
1668504263,204875,true,1267175165,28,1274163479,6988314
1668504275,204873,true,1267428612,28,1274036075,6607463
1668504515,204870,true,1267808879,28,1273526588,5717709
1668504707,204870,true,1267808879,28,1273017305,5208426
1668504719,204869,true,1267935660,28,1273017305,5081645
1668504743,204867,true,1268189260,28,1272890016,4700756
1668504767,204864,true,1268569754,28,1272890016,4320262
1668504827,204865,true,1268442910,28,1272508225,4065315
1668504851,204864,true,1268569754,28,1272380987,3811233
1668504911,204863,true,1268696611,28,1272126549,3429938
1668504947,204860,true,1269077258,28,1271872162,2794904
1668505175,204861,true,1268950363,28,1270728049,1777686
1668505187,204860,true,1269077258,28,1270600989,1523731
1668505403,204859,true,1269204166,28,1269204166,0
1668505619,204857,true,1269458020,28,1267555355,-1902665
1668505775,204858,true,1269331087,28,1266415126,-2915961
1668505919,204858,true,1269331087,28,1265149407,-4181680
1668506195,204857,true,1269458020,28,1263253200,-6204820
1668506267,204855,true,1269711924,28,1262874300,-6837624
1668506495,204856,true,1269584966,28,1261485971,-8098995
1668506711,204856,true,1269584966,28,1260729344,-8855622
1668506747,204855,true,1269711924,28,1260603284,-9108640
1668507299,204854,true,1269838895,28,1259721215,-10117680
1668507755,204855,true,1269711924,28,1259721215,-9990709
1668508259,204855,true,1269711924,28,1259847187,-9864737
1668508391,204855,true,1269711924,28,1259847187,-9864737
1668508415,204853,true,1269965879,28,1259847187,-10118692
1668508643,204855,true,1269711924,28,1259595255,-10116669
1668508727,204855,true,1269711924,28,1259469308,-10242616
1668509063,204855,true,1269711924,28,1259217452,-10494472
1668509123,204854,true,1269838895,28,1259217452,-10621443
1668509195,204856,true,1269584966,28,1259217452,-10367514
1668509939,204856,true,1269584966,28,1259469308,-10115658
1668510107,204855,true,1269711924,28,1259595255,-10116669
1668510131,204855,true,1269711924,28,1259721215,-9990709
1668510143,204857,true,1269458020,28,1259721215,-9736805
1668510191,204857,true,1269458020,28,1259721215,-9736805
1668510263,204856,true,1269584966,28,1260099169,-9485797
1668510287,204855,true,1269711924,28,1260225179,-9486745
1668510311,204858,true,1269331087,28,1260351201,-8979886
1668510359,204858,true,1269331087,28,1260603284,-8727803
1668510551,204857,true,1269458020,28,1261612120,-7845900
1668510635,204857,true,1269458020,28,1261990641,-7467379
1668510791,204859,true,1269204166,28,1262748025,-6456141
1668510959,204859,true,1269204166,28,1263505863,-5698303
1668510983,204858,true,1269331087,28,1263632214,-5698873
1668511067,204858,true,1269331087,28,1263884953,-5446134
1668511079,204860,true,1269077258,28,1263884953,-5192305
1668511091,204860,true,1269077258,28,1263884953,-5192305
1668511127,204860,true,1269077258,28,1263884953,-5192305
1668511823,204860,true,1269077258,28,1263000587,-6076671
1668512627,204863,true,1268696611,28,1259721215,-8975396
1668513875,204863,true,1268696611,28,1258588032,-10108579
1668514115,204862,true,1268823481,28,1258588032,-10235449
1668514451,204862,true,1268823481,28,1258588032,-10235449
1668514487,204865,true,1268442910,28,1258713891,-9729019
1668514691,204865,true,1268442910,28,1258965646,-9477264
1668514703,204864,true,1268569754,28,1258965646,-9604108
1668514847,204865,true,1268442910,28,1259091543,-9351367
1668514931,204868,true,1268062453,28,1259217452,-8845001
1668515003,204868,true,1268062453,28,1259343374,-8719079
1668515147,204867,true,1268189260,28,1259469308,-8719952
1668515159,204868,true,1268062453,28,1259469308,-8593145
1668515339,204870,true,1267808879,28,1259721215,-8087664
1668515351,204870,true,1267808879,28,1259721215,-8087664
1668516023,204868,true,1268062453,28,1261359835,-6702618
1668516515,204869,true,1267935660,28,1262116840,-5818820
1668516887,204871,true,1267682111,28,1262621763,-5060348
1668517223,204871,true,1267682111,28,1262874300,-4807811
1668517283,204869,true,1267935660,28,1262874300,-5061360
1668517295,204870,true,1267808879,28,1262874300,-4934579
1668517307,204872,true,1267555355,28,1262874300,-4681055
1668517367,204872,true,1267555355,28,1263000587,-4554768
1668517727,204871,true,1267682111,28,1263632214,-4049897
1668517751,204873,true,1267428612,28,1263758577,-3670035
1668517763,204875,true,1267175165,28,1263758577,-3416588
1668517775,204875,true,1267175165,28,1263758577,-3416588
1668517823,204874,true,1267301882,28,1263884953,-3416929
1668518471,204876,true,1267048460,28,1265908686,-1139774
1668518483,204877,true,1266921768,28,1266035277,-886491
1668518531,204877,true,1266921768,28,1266161881,-759887
1668518603,204876,true,1267048460,28,1266415126,-633334
1668518759,204878,true,1266795088,28,1266795088,0
1668518819,204880,true,1266541767,28,1267048460,506693
1668518999,204880,true,1266541767,28,1267555355,1013588
1668519011,204879,true,1266668421,28,1267682111,1013690
1668519035,204881,true,1266415126,28,1267808879,1393753
1668519047,204882,true,1266288497,28,1267935660,1647163
1668519059,204880,true,1266541767,28,1268062453,1520686
1668519071,204879,true,1266668421,28,1268189260,1520839
1668519167,204880,true,1266541767,28,1269204166,2662399
1668519179,204881,true,1266415126,28,1269331087,2915961
1668519227,204879,true,1266668421,28,1269838895,3170474
1668519323,204877,true,1266921768,28,1270728049,3806281
1668519503,204880,true,1266541767,28,1271617826,5076059
1668519971,204881,true,1266415126,28,1273653941,7238815
1668520031,204879,true,1266668421,28,1273781306,7112885
1668520043,204877,true,1266921768,28,1273908684,6986916
1668520067,204880,true,1266541767,28,1273908684,7366917
1668520223,204882,true,1266288497,28,1274163479,7874982
1668520247,204880,true,1266541767,28,1274163479,7621712
1668520259,204879,true,1266668421,28,1274163479,7495058
1668520799,204881,true,1266415126,28,1275310685,8895559
1668520811,204883,true,1266161881,28,1275310685,9148804
1668520847,204881,true,1266415126,28,1275183166,8768040
1668521123,204879,true,1266668421,28,1274036075,7367654
1668521219,204880,true,1266541767,28,1274163479,7621712
1668521507,204883,true,1266161881,28,1274163479,8001598
1668521639,204880,true,1266541767,28,1274163479,7621712
1668521687,204878,true,1266795088,28,1274163479,7368391
1668521711,204880,true,1266541767,28,1274163479,7621712
1668521723,204883,true,1266161881,28,1274036075,7874194
1668521735,204880,true,1266541767,28,1274036075,7494308
1668521807,204879,true,1266668421,28,1273908684,7240263
1668521831,204880,true,1266541767,28,1273781306,7239539
1668521855,204882,true,1266288497,28,1273781306,7492809
1668521867,204880,true,1266541767,28,1273781306,7239539
1668521879,204879,true,1266668421,28,1273781306,7112885
1668521891,204880,true,1266541767,28,1273781306,7239539
1668521915,204882,true,1266288497,28,1273781306,7492809
1668522023,204879,true,1266668421,28,1273526588,6858167
1668522179,204878,true,1266795088,28,1273271921,6476833
1668522611,204879,true,1266668421,28,1272380987,5712566
1668522719,204880,true,1266541767,28,1271999349,5457582
1668522743,204878,true,1266795088,28,1271872162,5077074
1668522815,204876,true,1267048460,28,1271617826,4569366
1668522875,204877,true,1266921768,28,1271363540,4441772
1668522887,204878,true,1266795088,28,1271363540,4568452
1668523019,204876,true,1267048460,28,1270982207,3933747
1668523235,204873,true,1267428612,28,1270346907,2918295
1668523247,204874,true,1267301882,28,1270219885,2918003
1668523271,204875,true,1267175165,28,1270219885,3044720
1668523283,204873,true,1267428612,28,1270092876,2664264
1668523307,204871,true,1267682111,28,1269965879,2283768
1668523655,204872,true,1267555355,28,1268316079,760724
1668523679,204873,true,1267428612,28,1268316079,887467
1668523739,204871,true,1267682111,28,1268062453,380342
1668523763,204870,true,1267808879,28,1268062453,253574
1668524195,204871,true,1267682111,28,1266415126,-1266985
1668524255,204873,true,1267428612,28,1266161881,-1266731
1668524291,204870,true,1267808879,28,1266035277,-1773602
1668524327,204869,true,1267935660,28,1265908686,-2026974
1668524447,204870,true,1267808879,28,1265528989,-2279890
1668524507,204871,true,1267682111,28,1265402449,-2279662
1668525371,204869,true,1267935660,28,1263126887,-4808773
1668525515,204868,true,1268062453,28,1263000587,-5061866
1668525971,204869,true,1267935660,28,1263505863,-4429797
1668526307,204871,true,1267682111,28,1263632214,-4049897
1668526403,204869,true,1267935660,28,1263758577,-4177083
1668526451,204868,true,1268062453,28,1263758577,-4303876
1668526535,204869,true,1267935660,28,1263758577,-4177083
1668526607,204871,true,1267682111,28,1263884953,-3797158
1668526631,204869,true,1267935660,28,1263884953,-4050707
1668526643,204868,true,1268062453,28,1263884953,-4177500
1668526655,204870,true,1267808879,28,1264011341,-3797538
1668526727,204870,true,1267808879,28,1264137742,-3671137
1668526979,204868,true,1268062453,28,1264896415,-3166038
1668527087,204868,true,1268062453,28,1265275922,-2786531
1668527111,204869,true,1267935660,28,1265402449,-2533211
1668527135,204870,true,1267808879,28,1265528989,-2279890
1668527435,204867,true,1268189260,28,1266541767,-1647493
1668527459,204866,true,1268316079,28,1266541767,-1774312
1668527543,204866,true,1268316079,28,1266668421,-1647658
1668527555,204867,true,1268189260,28,1266795088,-1394172
1668527675,204865,true,1268442910,28,1266795088,-1647822
1668527891,204864,true,1268569754,28,1266921768,-1647986
1668527975,204865,true,1268442910,28,1266921768,-1521142
1668528167,204865,true,1268442910,28,1266795088,-1647822
1668528503,204864,true,1268569754,28,1266288497,-2281257
1668528851,204863,true,1268696611,28,1264896415,-3800196
1668529247,204864,true,1268569754,28,1263505863,-5063891
1668529463,204865,true,1268442910,28,1263253200,-5189710
1668530171,204863,true,1268696611,28,1264011341,-4685270
1668530615,204862,true,1268823481,28,1264643473,-4180008
1668530627,204863,true,1268696611,28,1264769938,-3926673
1668530639,204863,true,1268696611,28,1264769938,-3926673
1668530651,204862,true,1268823481,28,1264769938,-4053543
1668531047,204862,true,1268823481,28,1264517022,-4306459
1668531251,204863,true,1268696611,28,1264390583,-4306028
1668531611,204863,true,1268696611,28,1263884953,-4811658
1668531755,204862,true,1268823481,28,1263758577,-5064904
1668532163,204862,true,1268823481,28,1263253200,-5570281
1668532211,204863,true,1268696611,28,1263253200,-5443411
1668533267,204863,true,1268696611,28,1264137742,-4558869
1668533519,204862,true,1268823481,28,1264517022,-4306459
1668533543,204862,true,1268823481,28,1264517022,-4306459
1668533555,204863,true,1268696611,28,1264517022,-4179589
1668533567,204863,true,1268696611,28,1264517022,-4179589
1668533627,204861,true,1268950363,28,1264769938,-4180425
1668534959,204862,true,1268823481,28,1268189260,-634221
1668535127,204863,true,1268696611,28,1268569754,-126857
1668535343,204863,true,1268696611,28,1268950363,253752
1668535415,204861,true,1268950363,28,1268823481,-126882
1668535451,204862,true,1268823481,28,1268823481,0
1668535463,204863,true,1268696611,28,1268823481,126870
1668535619,204864,true,1268569754,28,1268696611,126857
1668535631,204862,true,1268823481,28,1268569754,-253727
1668535955,204863,true,1268696611,28,1267935660,-760951
1668536027,204864,true,1268569754,28,1267808879,-760875
1668536303,204865,true,1268442910,28,1267175165,-1267745
1668536363,204865,true,1268442910,28,1267048460,-1394450
1668536375,204867,true,1268189260,28,1266921768,-1267492
1668536387,204869,true,1267935660,28,1266921768,-1013892
1668536399,204870,true,1267808879,28,1266921768,-887111
1668536411,204871,true,1267682111,28,1266795088,-887023
1668536579,204873,true,1267428612,28,1266161881,-1266731
1668536591,204874,true,1267301882,28,1266161881,-1140001
1668536651,204875,true,1267175165,28,1265782108,-1393057
1668536687,204875,true,1267175165,28,1265655542,-1519623
1668536711,204878,true,1266795088,28,1265528989,-1266099
1668536831,204879,true,1266668421,28,1264769938,-1898483
1668536843,204879,true,1266668421,28,1264643473,-2024948
1668536867,204879,true,1266668421,28,1264517022,-2151399
1668536915,204882,true,1266288497,28,1264137742,-2150755
1668536927,204883,true,1266161881,28,1264011341,-2150540
1668536987,204884,true,1266035277,28,1263632214,-2403063
1668537107,204884,true,1266035277,28,1262621763,-3413514
1668537119,204887,true,1265655542,28,1262495513,-3160029
1668537131,204890,true,1265275922,28,1262369276,-2906646
1668537143,204890,true,1265275922,28,1262243052,-3032870
1668537155,204892,true,1265022904,28,1261990641,-3032263
1668537407,204896,true,1264517022,28,1258839762,-5677260
1668537443,204899,true,1264137742,28,1258462186,-5675556
1668537527,204899,true,1264137742,28,1257330136,-6807606
1668537539,204901,true,1263884953,28,1257204416,-6680537
1668537551,204905,true,1263379525,28,1257078708,-6300817
1668537575,204907,true,1263126887,28,1256701660,-6425227
1668537647,204908,true,1263000587,28,1255696751,-7303836
1668537659,204910,true,1262748025,28,1255445649,-7302376
1668537695,204913,true,1262369276,28,1254943596,-7425680
1668537707,204916,true,1261990641,28,1254692645,-7297996
1668537803,204917,true,1261864455,28,1253187992,-8676463
1668537863,204919,true,1261612120,28,1252185893,-9426227
1668537875,204923,true,1261107601,28,1251935493,-9172108
1668537911,204925,true,1260855417,28,1251434844,-9420573
1668538031,204926,true,1260729344,28,1249684149,-11045195
1668538043,204928,true,1260477236,28,1249434249,-11042987
1668538067,204931,true,1260099169,28,1249184400,-10914769
1668538127,204934,true,1259721215,28,1248310320,-11410895
1668538655,204935,true,1259595255,28,1242208866,-17386389
1668538739,204936,true,1259469308,28,1241587948,-17881360
1668538991,204940,true,1258965646,28,1239975012,-18990634
1668539039,204942,true,1258713891,28,1239851027,-18862864
1668539063,204943,true,1258588032,28,1239851027,-18737005
1668539135,204945,true,1258336352,28,1239603094,-18733258
1668539207,204948,true,1257958927,28,1239355211,-18603716
1668539483,204950,true,1257707373,28,1238859593,-18847780
1668539543,204951,true,1257581615,28,1238983479,-18598136
1668539555,204953,true,1257330136,28,1239107377,-18222759
1668539615,204956,true,1256953012,28,1239231288,-17721724
1668540011,204956,true,1256953012,28,1240099010,-16854002
1668540047,204957,true,1256827330,28,1240223020,-16604310
1668540095,204958,true,1256701660,28,1240347042,-16354618
1668540107,204961,true,1256324724,28,1240347042,-15977682
1668540347,204961,true,1256324724,28,1241215546,-15109178
1668540395,204961,true,1256324724,28,1241463801,-14860923
1668541163,204963,true,1256073497,28,1244322311,-11751186
1668541367,204966,true,1255696751,28,1245069091,-10627660
1668541379,204966,true,1255696751,28,1245193598,-10503153
1668542195,204966,true,1255696751,28,1247187403,-8509348
1668542207,204967,true,1255571193,28,1247187403,-8383790
1668542231,204970,true,1255194597,28,1247312121,-7882476
1668542279,204970,true,1255194597,28,1247436853,-7757744
1668542291,204970,true,1255194597,28,1247436853,-7757744
1668542303,204971,true,1255069090,28,1247436853,-7632237
1668542435,204974,true,1254692645,28,1248060696,-6631949
1668542447,204973,true,1254818114,28,1248060696,-6757418
1668542459,204974,true,1254692645,28,1248185502,-6507143
1668542471,204975,true,1254567188,28,1248310320,-6256868
1668542951,204977,true,1254316313,28,1251935493,-2380820
1668543095,204976,true,1254441744,28,1252937392,-1504352
1668543107,204977,true,1254316313,28,1253062686,-1253627
1668543119,204978,true,1254190893,28,1253062686,-1128207
1668543191,204980,true,1253940093,28,1253563986,-376107
1668543263,204979,true,1254065487,28,1253940093,-125394
1668543335,204980,true,1253940093,28,1254316313,376220
1668543803,204981,true,1253814711,28,1255947902,2133191
1668543815,204982,true,1253689342,28,1256073497,2384155
1668543899,204982,true,1253689342,28,1256324724,2635382
1668544307,204982,true,1253689342,28,1256827330,3137988
1668544343,204984,true,1253438642,28,1256701660,3263018
1668544391,204985,true,1253313311,28,1256576002,3262691
1668544403,204984,true,1253438642,28,1256450357,3011715
1668544427,204985,true,1253313311,28,1256450357,3137046
1668544451,204987,true,1253062686,28,1256324724,3262038
1668544463,204988,true,1252937392,28,1256199105,3261713
1668545195,204988,true,1252937392,28,1253187992,250600
1668546107,204989,true,1252812111,28,1251184595,-1627516
1668546755,204991,true,1252561586,28,1250934395,-1627191
1668546767,204992,true,1252436342,28,1250934395,-1501947
1668547943,204992,true,1252436342,28,1250059091,-2377251
1668548003,204993,true,1252311111,28,1249934098,-2377013
1668548123,204995,true,1252060687,28,1249559193,-2501494
1668548507,204996,true,1251935493,28,1248185502,-3749991
1668549947,204997,true,1251810312,28,1244446743,-7363569
1668550475,204998,true,1251685143,28,1244446743,-7238400
1668550487,205000,true,1251434844,28,1244571188,-6863656
1668550847,205002,true,1251184595,28,1244571188,-6613407
1668551015,205003,true,1251059489,28,1244571188,-6488301
1668551291,205004,true,1250934395,28,1244571188,-6363207
1668551987,205007,true,1250559190,28,1244571188,-5988002
1668552371,205009,true,1250309116,28,1244571188,-5737928
1668553115,205010,true,1250184097,28,1244571188,-5612909
1668553739,205011,true,1250059091,28,1244571188,-5487903
1668553955,205014,true,1249684149,28,1244571188,-5112961
1668553991,205015,true,1249559193,28,1244571188,-4988005
1668554039,205016,true,1249434249,28,1244571188,-4863061
1668554051,205018,true,1249184400,28,1244571188,-4613212
1668554123,205020,true,1248934600,28,1244571188,-4363412
1668554279,205021,true,1248809719,28,1244695645,-4114074
1668554291,205022,true,1248684851,28,1244695645,-3989206
1668554315,205023,true,1248559995,28,1244695645,-3864350
1668554627,205025,true,1248310320,28,1245069091,-3241229
1668555335,205026,true,1248185502,28,1245940901,-2244601
1668555479,205027,true,1248060696,28,1246190102,-1870594
1668555551,205028,true,1247935902,28,1246314721,-1621181
1668555719,205030,true,1247686352,28,1246439352,-1247000
1668555887,205031,true,1247561596,28,1246688652,-872944
1668555911,205032,true,1247436853,28,1246688652,-748201
1668556007,205032,true,1247436853,28,1246813321,-623532
1668556019,205034,true,1247187403,28,1246813321,-374082
1668556151,205034,true,1247187403,28,1247062696,-124707
1668556175,205035,true,1247062696,28,1247062696,0
1668556187,205035,true,1247062696,28,1247062696,0
1668556955,205037,true,1246813321,28,1247686352,873031
1668557231,205036,true,1246938003,28,1247935902,997899
1668557435,205037,true,1246813321,28,1248185502,1372181
1668557963,205037,true,1246813321,28,1248684851,1871530
1668558143,205038,true,1246688652,28,1248809719,2121067
1668558179,205038,true,1246688652,28,1248809719,2121067
1668558491,205038,true,1246688652,28,1249059494,2370842
1668558863,205038,true,1246688652,28,1249184400,2495748
1668558923,205038,true,1246688652,28,1249309318,2620666
1668559607,205036,true,1246938003,28,1249434249,2496246
1668559703,205037,true,1246813321,28,1249434249,2620928
1668559739,205036,true,1246938003,28,1249434249,2496246
1668559751,205036,true,1246938003,28,1249559193,2621190
1668559799,205034,true,1247187403,28,1249559193,2371790
1668560315,205034,true,1247187403,28,1250059091,2871688
1668560327,205033,true,1247312121,28,1250059091,2746970
1668560831,205033,true,1247312121,28,1250684246,3372125
1668560855,205031,true,1247561596,28,1250684246,3122650
1668560903,205030,true,1247686352,28,1250809314,3122962
1668560927,205028,true,1247935902,28,1250809314,2873412
1668560963,205028,true,1247935902,28,1250934395,2998493
1668561011,205026,true,1248185502,28,1250934395,2748893
1668562031,205025,true,1248310320,28,1252812111,4501791
1668562511,205024,true,1248435151,28,1253563986,5128835
1668562571,205023,true,1248559995,28,1253689342,5129347
1668562595,205021,true,1248809719,28,1253814711,5004992
1668563819,205021,true,1248809719,28,1254818114,6008395
1668563975,205019,true,1249059494,28,1254818114,5758620
1668564011,205019,true,1249059494,28,1254943596,5884102
1668564047,205017,true,1249309318,28,1254943596,5634278
1668564059,205016,true,1249434249,28,1254943596,5509347
1668564743,205014,true,1249684149,28,1255947902,6263753
1668565079,205014,true,1249684149,28,1256324724,6640575
1668565199,205012,true,1249934098,28,1256450357,6516259
1668565355,205011,true,1250059091,28,1256701660,6642569
1668565367,205009,true,1250309116,28,1256701660,6392544
1668565403,205008,true,1250434147,28,1256827330,6393183
1668565427,205006,true,1250684246,28,1256827330,6143084
1668565499,205006,true,1250684246,28,1256953012,6268766
1668565523,205005,true,1250809314,28,1256953012,6143698
1668565775,205004,true,1250934395,28,1257455869,6521474
1668565787,205002,true,1251184595,28,1257455869,6271274
1668565943,205002,true,1251184595,28,1257707373,6522778
1668565955,205001,true,1251309713,28,1257707373,6397660
1668566531,204999,true,1251559987,28,1259469308,7909321
1668567071,204997,true,1251810312,28,1261107601,9297289
1668567659,204998,true,1251685143,28,1262369276,10684133
1668568343,204997,true,1251810312,28,1262243052,10432740
1668568595,204995,true,1252060687,28,1262243052,10182365
1668568955,204993,true,1252311111,28,1262243052,9931941
1668569183,204994,true,1252185893,28,1262243052,10057159
1668570275,204994,true,1252185893,28,1262116840,9930947
1668570299,204992,true,1252436342,28,1262116840,9680498
1668570347,204991,true,1252561586,28,1262116840,9555254
1668570407,204992,true,1252436342,28,1262116840,9680498
1668570419,204991,true,1252561586,28,1262116840,9555254
1668570551,204990,true,1252686842,28,1262116840,9429998
1668570611,204990,true,1252686842,28,1262116840,9429998
1668571415,204991,true,1252561586,28,1262116840,9555254
1668571499,204991,true,1252561586,28,1262116840,9555254
1668571607,204990,true,1252686842,28,1262116840,9429998
1668571763,204989,true,1252812111,28,1262116840,9304729
1668572555,204990,true,1252686842,28,1262116840,9429998
1668572627,204989,true,1252812111,28,1262116840,9304729
1668572651,204988,true,1252937392,28,1262116840,9179448
1668572951,204987,true,1253062686,28,1261738281,8675595
1668573071,204988,true,1252937392,28,1261612120,8674728
1668573107,204988,true,1252937392,28,1261612120,8674728
1668573395,204986,true,1253187992,28,1261233712,8045720
1668573623,204986,true,1253187992,28,1260981503,7793511
1668573659,204987,true,1253062686,28,1260855417,7792731
1668573755,204986,true,1253187992,28,1260729344,7541352
1668573803,204984,true,1253438642,28,1260729344,7290702
1668573995,204984,true,1253438642,28,1260477236,7038594
1668574223,204984,true,1253438642,28,1260099169,6660527
1668574367,204984,true,1253438642,28,1259973171,6534529
1668574463,204982,true,1253689342,28,1259847187,6157845
1668574595,204981,true,1253814711,28,1259847187,6032476
1668575003,204982,true,1253689342,28,1259721215,6031873
1668575135,204981,true,1253814711,28,1259595255,5780544
1668575219,204979,true,1254065487,28,1259469308,5403821
1668575471,204978,true,1254190893,28,1259091543,4900650
1668575591,204978,true,1254190893,28,1258965646,4774753
1668575615,204977,true,1254316313,28,1258839762,4523449
1668575627,204976,true,1254441744,28,1258839762,4398018
1668576263,204975,true,1254567188,28,1257833144,3265956
1668576503,204975,true,1254567188,28,1257455869,2888681
1668576539,204974,true,1254692645,28,1257455869,2763224
1668576599,204972,true,1254943596,28,1257330136,2386540
1668577415,204971,true,1255069090,28,1256953012,1883922
1668577679,204971,true,1255069090,28,1256953012,1883922
1668577919,204970,true,1255194597,28,1257078708,1884111
1668578219,204968,true,1255445649,28,1257078708,1633059
1668578711,204968,true,1255445649,28,1257078708,1633059
1668579203,204967,true,1255571193,28,1256953012,1381819
1668579287,204967,true,1255571193,28,1256953012,1381819
1668579299,204965,true,1255822320,28,1256953012,1130692
1668579323,204965,true,1255822320,28,1256827330,1005010
1668579683,204965,true,1255822320,28,1255822320,0
1668579695,204965,true,1255822320,28,1255822320,0
1668579719,204963,true,1256073497,28,1255696751,-376746
1668580019,204963,true,1256073497,28,1254441744,-1631753
1668580115,204964,true,1255947902,28,1254065487,-1882415
1668580151,204964,true,1255947902,28,1253814711,-2133191
1668580595,204963,true,1256073497,28,1251685143,-4388354
1668580607,204963,true,1256073497,28,1251559987,-4513510
1668580619,204964,true,1255947902,28,1251559987,-4387915
1668580991,204964,true,1255947902,28,1249434249,-6513653
1668581003,204963,true,1256073497,28,1249309318,-6764179
1668581735,204964,true,1255947902,28,1246938003,-9009899
1668582059,204965,true,1255822320,28,1246439352,-9382968
1668582143,204965,true,1255822320,28,1246439352,-9382968
1668582347,204964,true,1255947902,28,1246190102,-9757800
1668582359,204964,true,1255947902,28,1246190102,-9757800
1668582707,204965,true,1255822320,28,1246813321,-9008999
1668583115,204965,true,1255822320,28,1247187403,-8634917
1668583199,204964,true,1255947902,28,1247312121,-8635781
1668583631,204964,true,1255947902,28,1247686352,-8261550
1668584243,204965,true,1255822320,28,1248060696,-7761624
1668584639,204965,true,1255822320,28,1247686352,-8135968
1668585119,204964,true,1255947902,28,1247686352,-8261550
1668585575,204965,true,1255822320,28,1247686352,-8135968
1668585611,204966,true,1255696751,28,1247686352,-8010399
1668585635,204966,true,1255696751,28,1247686352,-8010399
1668585647,204965,true,1255822320,28,1247686352,-8135968
1668585659,204966,true,1255696751,28,1247686352,-8010399
1668585671,204967,true,1255571193,28,1247686352,-7884841
1668585707,204968,true,1255445649,28,1247561596,-7884053
1668585731,204967,true,1255571193,28,1247561596,-8009597
1668585875,204968,true,1255445649,28,1247062696,-8382953
1668586031,204969,true,1255320117,28,1246688652,-8631465
1668586163,204970,true,1255194597,28,1246563996,-8630601
1668586175,204970,true,1255194597,28,1246439352,-8755245
1668586187,204971,true,1255069090,28,1246439352,-8629738
1668586211,204972,true,1254943596,28,1246563996,-8379600
1668586295,204972,true,1254943596,28,1246563996,-8379600
1668586415,204971,true,1255069090,28,1246688652,-8380438
1668586463,204972,true,1254943596,28,1246688652,-8254944
1668586475,204973,true,1254818114,28,1246688652,-8129462
1668586487,204973,true,1254818114,28,1246688652,-8129462
1668586547,204973,true,1254818114,28,1246563996,-8254118
1668586559,204975,true,1254567188,28,1246563996,-8003192
1668586943,204977,true,1254316313,28,1245816319,-8499994
1668587087,204977,true,1254316313,28,1245567193,-8749120
1668587303,204977,true,1254316313,28,1245193598,-9122715
1668587399,204978,true,1254190893,28,1244944597,-9246296
1668587483,204980,true,1253940093,28,1244820115,-9119978
1668587579,204981,true,1253814711,28,1244944597,-8870114
1668587603,204981,true,1253814711,28,1244944597,-8870114
1668587615,204982,true,1253689342,28,1244944597,-8744745
1668587639,204984,true,1253438642,28,1244944597,-8494045
1668587651,204985,true,1253313311,28,1244944597,-8368714
1668587675,204986,true,1253187992,28,1244944597,-8243395
1668587723,204988,true,1252937392,28,1244820115,-8117277
1668587735,204990,true,1252686842,28,1244820115,-7866727
1668587747,204991,true,1252561586,28,1244695645,-7865941
1668587771,204993,true,1252311111,28,1244695645,-7615466
1668587795,204995,true,1252060687,28,1244571188,-7489499
1668588767,204998,true,1251685143,28,1238735719,-12949424
1668589355,204999,true,1251559987,28,1235890043,-15669944
1668590159,205000,true,1251434844,28,1235148769,-16286075
1668590507,205003,true,1251059489,28,1235148769,-15910720
1668590783,205005,true,1250809314,28,1235519350,-15289964
1668590807,205006,true,1250684246,28,1235519350,-15164896
1668590831,205008,true,1250434147,28,1235519350,-14914797
1668590843,205010,true,1250184097,28,1235519350,-14664747
1668590855,205013,true,1249809117,28,1235519350,-14289767
1668590891,205014,true,1249684149,28,1235519350,-14164799
1668590963,205016,true,1249434249,28,1235519350,-13914899
1668590975,205018,true,1249184400,28,1235519350,-13665050
1668590987,205021,true,1248809719,28,1235519350,-13290369
1668590999,205022,true,1248684851,28,1235395811,-13289040
1668591035,205024,true,1248435151,28,1235395811,-13039340
1668592055,205027,true,1248060696,28,1231449060,-16611636
1668592283,205030,true,1247686352,28,1230710449,-16975903
1668592859,205032,true,1247436853,28,1228374435,-19062418
1668593075,205034,true,1247187403,28,1228374435,-18812968
1668593087,205037,true,1246813321,28,1228497273,-18316048
1668593243,205039,true,1246563996,28,1228497273,-18066723
1668593339,205041,true,1246314721,28,1228620123,-17694598
1668593399,205043,true,1246065495,28,1228742985,-17322510
1668593459,205045,true,1245816319,28,1228742985,-17073334
1668594023,205048,true,1245442649,28,1229357479,-16085170
1668594227,205049,true,1245318117,28,1229480415,-15837702
1668594599,205051,true,1245069091,28,1229972281,-15096810
1668594743,205054,true,1244695645,28,1230095278,-14600367
1668595043,205056,true,1244446743,28,1230341309,-14105434
1668595139,205057,true,1244322311,28,1230341309,-13981002
1668595175,205059,true,1244073484,28,1230341309,-13732175
1668595703,205062,true,1243700336,28,1230095278,-13605058
1668596111,205065,true,1243327301,28,1229849296,-13478005
1668596267,205066,true,1243202981,28,1229726323,-13476658
1668596519,205068,true,1242954377,28,1229603363,-13351014
1668596843,205071,true,1242581566,28,1229234556,-13347010
1668596891,205073,true,1242333087,28,1229234556,-13098531
1668597035,205074,true,1242208866,28,1229111644,-13097222
1668597155,205076,true,1241960461,28,1229111644,-12848817
1668597431,205079,true,1241587948,28,1229111644,-12476304
1668597479,205081,true,1241339667,28,1229111644,-12228023
1668597791,205082,true,1241215546,28,1229111644,-12103902
1668598715,205084,true,1240967340,28,1229111644,-11855696
1668599207,205087,true,1240595124,28,1229111644,-11483480
1668599435,205089,true,1240347042,28,1229111644,-11235398
1668599447,205090,true,1240223020,28,1229111644,-11111376
1668599495,205092,true,1239975012,28,1228988746,-10986266
1668599531,205095,true,1239603094,28,1228865859,-10737235
1668599819,205099,true,1239107377,28,1227760432,-11346945
1668599939,205100,true,1238983479,28,1227392178,-11591301
1668600299,205102,true,1238735719,28,1226042856,-12692863
1668600383,205105,true,1238364173,28,1225675117,-12689056
1668600515,205108,true,1237992738,28,1225062463,-12930275
1668600563,205109,true,1237868951,28,1224817488,-13051463
1668600719,205111,true,1237621414,28,1223838074,-13783340
1668601655,205115,true,1237126489,28,1219684298,-17442191
1668601835,205117,true,1236879101,28,1219074639,-17804462
1668601931,205118,true,1236755426,28,1218830860,-17924566
1668602291,205120,true,1236508112,28,1217856234,-18651878
1668602327,205124,true,1236013632,28,1217856234,-18157398
1668602639,205126,true,1235766466,28,1217734461,-18032005
1668602687,205126,true,1235766466,28,1217856234,-17910232
1668603035,205128,true,1235519350,28,1218221628,-17297722
1668603059,205131,true,1235148769,28,1218221628,-16927141
1668603623,205133,true,1234901776,28,1219196546,-15705230
1668603695,205134,true,1234778298,28,1219318466,-15459832
1668603719,205136,true,1234531379,28,1219440398,-15090981
1668603779,205139,true,1234161094,28,1219440398,-14720696
1668603815,205141,true,1233914299,28,1219440398,-14473901
1668603887,205142,true,1233790920,28,1219440398,-14350522
1668603899,205144,true,1233544199,28,1219440398,-14103801
1668603911,205148,true,1233050904,28,1219440398,-13610506
1668603935,205151,true,1232681063,28,1219440398,-13240665
1668604019,205152,true,1232557807,28,1219318466,-13239341
1668604079,205154,true,1232311333,28,1219196546,-13114787
1668604547,205158,true,1231818531,28,1218099818,-13718713
1668604799,205160,true,1231572204,28,1217125776,-14446428
1668604955,205162,true,1231325927,28,1216639048,-14686879
1668605195,205164,true,1231079699,28,1216030911,-15048788
1668605363,205167,true,1230710449,28,1215666174,-15044275
1668605375,205169,true,1230464343,28,1215666174,-14798169
1668605387,205170,true,1230341309,28,1215544620,-14796689
1668605435,205171,true,1230218288,28,1215544620,-14673668
1668605543,205174,true,1229849296,28,1215301547,-14547749
1668605579,205176,true,1229603363,28,1215423077,-14180286
1668605591,205177,true,1229480415,28,1215544620,-13935795
1668605615,205178,true,1229357479,28,1215666174,-13691305
1668605699,205180,true,1229111644,28,1216030911,-13080733
1668605723,205182,true,1228865859,28,1216152514,-12713345
1668605735,205184,true,1228620123,28,1216152514,-12467609
1668605831,205185,true,1228497273,28,1216639048,-11858225
1668605843,205187,true,1228251610,28,1216639048,-11612562
1668605879,205190,true,1227883209,28,1216760712,-11122497
1668605891,205191,true,1227760432,28,1216760712,-10999720
1668605915,205194,true,1227392178,28,1216882388,-10509790
1668606095,205195,true,1227269451,28,1217247489,-10021962
1668606395,205198,true,1226901344,28,1217978020,-8923324
1668606539,205199,true,1226778666,28,1218465284,-8313382
1668606551,205201,true,1226533347,28,1218465284,-8068063
1668606623,205203,true,1226288077,28,1218708989,-7579088
1668606647,205205,true,1226042856,28,1218708989,-7333867
1668606659,205206,true,1225920264,28,1218708989,-7211275
1668606671,205208,true,1225675117,28,1218830860,-6844257
1668606695,205210,true,1225430019,28,1218830860,-6599159
1668606779,205212,true,1225184970,28,1218830860,-6354110
1668606851,205213,true,1225062463,28,1218952743,-6109720
1668606875,205215,true,1224817488,28,1218952743,-5864745
1668606887,205217,true,1224572561,28,1218952743,-5619818
1668606911,205219,true,1224327683,28,1218830860,-5496823
1668606959,205220,true,1224205262,28,1218830860,-5374402
1668607019,205222,true,1223960458,28,1218830860,-5129598
1668607043,205223,true,1223838074,28,1218708989,-5129085
1668607127,205226,true,1223470996,28,1218465284,-5005712
1668607139,205227,true,1223348661,28,1218343450,-5005211
1668607151,205229,true,1223104028,28,1218343450,-4760578
1668607235,205231,true,1222859444,28,1217978020,-4881424
1668607271,205233,true,1222614909,28,1217734461,-4880448
1668607295,205235,true,1222370423,28,1217734461,-4635962
1668607319,205237,true,1222125985,28,1217612700,-4513285
1668607427,205238,true,1222003785,28,1216882388,-5121397
1668607439,205240,true,1221759421,28,1216760712,-4998709
1668607463,205242,true,1221515106,28,1216517396,-4997710
1668607571,205245,true,1221148724,28,1215301547,-5847177
1668607763,205247,true,1220904531,28,1213722761,-7181770
1668607823,205249,true,1220660387,28,1213237393,-7422994
1668608063,205251,true,1220416292,28,1211297862,-9118430
1668608075,205253,true,1220172245,28,1211176744,-8995501
1668608087,205254,true,1220050240,28,1211055639,-8994601
1668608255,205256,true,1219806266,28,1209724277,-10081989
1668608303,205258,true,1219562342,28,1209240508,-10321834
1668608327,205260,true,1219318466,28,1208998696,-10319770
1668608351,205262,true,1219074639,28,1208877808,-10196831
1668608399,205264,true,1218830860,28,1208515217,-10315643
1668608411,205265,true,1218708989,28,1208394378,-10314611
1668608423,205267,true,1218465284,28,1208273551,-10191733
1668608507,205269,true,1218221628,28,1207790362,-10431266
1668608687,205270,true,1218099818,28,1206703894,-11395924
1668608711,205272,true,1217856234,28,1206583236,-11272998
1668608771,205274,true,1217612700,28,1206341955,-11270745
1668608867,205275,true,1217490951,28,1206100723,-11390228
1668609191,205277,true,1217247489,28,1205497854,-11749635
1668609215,205279,true,1217004076,28,1205497854,-11506222
1668609275,205281,true,1216760712,28,1205377316,-11383396
1668609287,205282,true,1216639048,28,1205497854,-11141194
1668609299,205284,true,1216395756,28,1205497854,-10897902
1668609383,205285,true,1216274129,28,1205738965,-10535164
1668609419,205287,true,1216030911,28,1205738965,-10291946
1668609455,205288,true,1215909320,28,1205859539,-10049781
1668609527,205289,true,1215787741,28,1206100723,-9687018
1668609599,205290,true,1215666174,28,1206462589,-9203585
1668609647,205292,true,1215423077,28,1206703894,-8719183
1668609695,205293,true,1215301547,28,1206945247,-8356300
1668609707,205294,true,1215180029,28,1207065941,-8114088
1668609719,205295,true,1215058523,28,1207186648,-7871875
1668609791,205297,true,1214815548,28,1207428097,-7387451
1668609827,205298,true,1214694079,28,1207669595,-7024484
1668610151,205299,true,1214572622,28,1208877808,-5694814
1668610163,205300,true,1214451176,28,1208998696,-5452480
1668610175,205302,true,1214208323,28,1208998696,-5209627
1668610187,205303,true,1214086914,28,1208998696,-5088218
1668610223,205303,true,1214086914,28,1209119596,-4967318
1668610259,205304,true,1213965517,28,1209119596,-4845921
1668610271,205306,true,1213722761,28,1209119596,-4603165
1668610475,205308,true,1213480053,28,1208877808,-4602245
1668610583,205308,true,1213480053,28,1208756933,-4723120
1668610967,205309,true,1213358717,28,1208031932,-5326785
1668611063,205311,true,1213116081,28,1207911141,-5204940
1668611075,205312,true,1212994782,28,1207790362,-5204420
1668611159,205312,true,1212994782,28,1207548840,-5445942
1668611195,205313,true,1212873495,28,1207548840,-5324655
1668611255,205315,true,1212630956,28,1207428097,-5202859
1668611363,205315,true,1212630956,28,1207065941,-5565015
1668611387,205316,true,1212509705,28,1206945247,-5564458
1668611531,205317,true,1212388466,28,1206341955,-6046511
1668611543,205319,true,1212146025,28,1206221333,-5924692
1668611591,205319,true,1212146025,28,1206100723,-6045302
1668611603,205320,true,1212024823,28,1206100723,-5924100
1668611615,205321,true,1211903632,28,1206100723,-5802909
1668612191,205323,true,1211661288,28,1205980125,-5681163
1668612203,205323,true,1211661288,28,1205980125,-5681163
1668612587,205324,true,1211540134,28,1206583236,-4956898
1668612599,205324,true,1211540134,28,1206583236,-4956898
1668613499,205326,true,1211297862,28,1207428097,-3869765
1668613511,205326,true,1211297862,28,1207428097,-3869765
1668613535,205327,true,1211176744,28,1207307367,-3869377
1668613619,205326,true,1211297862,28,1207186648,-4111214
1668613643,205329,true,1210934545,28,1207065941,-3868604
1668613667,205329,true,1210934545,28,1207065941,-3868604
1668613679,205329,true,1210934545,28,1207065941,-3868604
1668613703,205330,true,1210813464,28,1206824564,-3988900
1668613727,205333,true,1210450293,28,1206703894,-3746399
1668613739,205334,true,1210329260,28,1206583236,-3746024
1668613895,205337,true,1209966234,28,1205015775,-4950459
1668613955,205338,true,1209845249,28,1204413448,-5431801
1668614087,205341,true,1209482368,28,1203209696,-6272672
1668614435,205342,true,1209361432,28,1200085571,-9275861
1668614555,205345,true,1208998696,28,1199006033,-9992663
1668614567,205346,true,1208877808,28,1198886145,-9991663
1668614579,205350,true,1208394378,28,1198886145,-9508233
1668614675,205353,true,1208031932,28,1197927467,-10104465
1668614699,205355,true,1207790362,28,1197687918,-10102444
1668614951,205356,true,1207669595,28,1195653680,-12015915
1668615023,205359,true,1207307367,28,1195056032,-12251335
1668615239,205362,true,1206945247,28,1193503546,-13441701
1668615299,205364,true,1206703894,28,1193026264,-13677630
1668615359,205364,true,1206703894,28,1192787695,-13916199
1668615431,205366,true,1206462589,28,1192668428,-13794161
1668615563,205367,true,1206341955,28,1192787695,-13554260
1668615791,205369,true,1206100723,28,1193861633,-12239090
1668616403,205369,true,1206100723,28,1196730198,-9370525
1668616439,205372,true,1205738965,28,1196969556,-8769409
1668616487,205373,true,1205618403,28,1197208962,-8409441
1668616523,205375,true,1205377316,28,1197328683,-8048633
1668616835,205375,true,1205377316,28,1198766268,-6611048
1668616859,205377,true,1205136276,28,1198886145,-6250131
1668616883,205378,true,1205015775,28,1199006033,-6009742
1668617147,205380,true,1204774808,28,1200805802,-3969006
1668617315,205378,true,1205015775,28,1201526466,-3489309
1668617327,205380,true,1204774808,28,1201526466,-3248342
1668617663,205381,true,1204654342,28,1203570695,-1083647
1668618215,205382,true,1204533889,28,1206824564,2290675
1668618359,205380,true,1204774808,28,1207669595,2894787
1668618407,205382,true,1204533889,28,1207911141,3377252
1668618971,205382,true,1204533889,28,1209240508,4706619
1668619151,205383,true,1204413448,28,1209361432,4947984
1668619619,205381,true,1204654342,28,1209119596,4465254
1668620231,205382,true,1204533889,28,1208877808,4343919
1668620375,205382,true,1204533889,28,1209482368,4948479
1668620387,205383,true,1204413448,28,1209482368,5068920
1668620411,205381,true,1204654342,28,1209603316,4948974
1668620747,205381,true,1204654342,28,1210571338,5916996
1668620807,205381,true,1204654342,28,1210813464,6159122
1668620819,205382,true,1204533889,28,1210813464,6279575
1668621923,205379,true,1204895285,28,1214329743,9434458
1668622463,205379,true,1204895285,28,1214694079,9798794
1668622511,205379,true,1204895285,28,1214694079,9798794
1668622631,205379,true,1204895285,28,1214815548,9920263
1668622703,205376,true,1205256790,28,1214937030,9680240
1668623171,205375,true,1205377316,28,1215180029,9802713
1668623639,205375,true,1205377316,28,1215544620,10167304
1668623687,205375,true,1205377316,28,1215544620,10167304
1668623723,205373,true,1205618403,28,1215544620,9926217
1668623735,205372,true,1205738965,28,1215544620,9805655
1668623747,205371,true,1205859539,28,1215544620,9685081
1668623843,205372,true,1205738965,28,1215544620,9805655
1668623855,205370,true,1205980125,28,1215544620,9564495
1668623903,205369,true,1206100723,28,1215544620,9443897
1668623927,205369,true,1206100723,28,1215544620,9443897
1668624179,205370,true,1205980125,28,1215180029,9199904
1668624743,205368,true,1206221333,28,1214208323,7986990
1668625187,205367,true,1206341955,28,1213358717,7016762
1668625391,205367,true,1206341955,28,1212873495,6531540
1668625523,205368,true,1206221333,28,1212630956,6409623
1668625535,205366,true,1206462589,28,1212630956,6168367
1668625547,205366,true,1206462589,28,1212630956,6168367
1668625559,205366,true,1206462589,28,1212509705,6047116
1668625595,205368,true,1206221333,28,1212388466,6167133
1668625871,205367,true,1206341955,28,1211297862,4955907
1668625883,205367,true,1206341955,28,1211297862,4955907
1668625943,205367,true,1206341955,28,1210934545,4592590
1668625955,205369,true,1206100723,28,1210934545,4833822
1668626387,205369,true,1206100723,28,1208394378,2293655
1668626507,205369,true,1206100723,28,1207790362,1689639
1668627251,205370,true,1205980125,28,1203570695,-2409430
1668627443,205373,true,1205618403,28,1202848806,-2769597
1668627467,205373,true,1205618403,28,1202728533,-2889870
1668627539,205373,true,1205618403,28,1202608272,-3010131
1668627671,205373,true,1205618403,28,1202367786,-3250617
1668627755,205375,true,1205377316,28,1202367786,-3009530
1668627791,205375,true,1205377316,28,1202367786,-3009530
1668627983,205375,true,1205377316,28,1202608272,-2769044
1668628067,205375,true,1205377316,28,1202728533,-2648783
1668628091,205376,true,1205256790,28,1202728533,-2528257
1668628307,205376,true,1205256790,28,1202969091,-2287699
1668628343,205376,true,1205256790,28,1202969091,-2287699
1668628367,205375,true,1205377316,28,1203089388,-2287928
1668628403,205376,true,1205256790,28,1203089388,-2167402
1668628763,205376,true,1205256790,28,1203691053,-1565737
1668628799,205375,true,1205377316,28,1203811422,-1565894
1668629723,205375,true,1205377316,28,1205256790,-120526
1668630167,205376,true,1205256790,28,1205618403,361613
1668630803,205375,true,1205377316,28,1205859539,482223
1668631343,205375,true,1205377316,28,1205980125,602809
1668631475,205374,true,1205497854,28,1205980125,482271
1668631715,205376,true,1205256790,28,1205980125,723335
1668631763,205375,true,1205377316,28,1205980125,602809
1668632207,205375,true,1205377316,28,1206221333,844017
1668632219,205374,true,1205497854,28,1206221333,723479
1668632771,205375,true,1205377316,28,1207186648,1809332
1668632783,205375,true,1205377316,28,1207186648,1809332
1668633815,205374,true,1205497854,28,1209240508,3742654
1668634295,205374,true,1205497854,28,1209724277,4226423
1668634499,205375,true,1205377316,28,1209845249,4467933
1668634547,205374,true,1205497854,28,1209845249,4347395
1668635051,205374,true,1205497854,28,1209845249,4347395
1668636395,205373,true,1205618403,28,1208998696,3380293
1668637319,205374,true,1205497854,28,1208394378,2896524
1668637571,205374,true,1205497854,28,1207790362,2292508
1668637655,205373,true,1205618403,28,1207669595,2051192
1668638411,205373,true,1205618403,28,1206100723,482320
1668638927,205374,true,1205497854,28,1205136276,-361578
1668639179,205373,true,1205618403,28,1204774808,-843595
1668639191,205371,true,1205859539,28,1204895285,-964254
1668639215,205370,true,1205980125,28,1204895285,-1084840
1668639371,205370,true,1205980125,28,1205256790,-723335
1668639467,205368,true,1206221333,28,1205497854,-723479
1668639587,205365,true,1206583236,28,1205738965,-844271
1668639659,205364,true,1206703894,28,1206100723,-603171
1668639827,205363,true,1206824564,28,1207065941,241377
1668640319,205361,true,1207065941,28,1210208239,3142298
1668640343,205358,true,1207428097,28,1210329260,2901163
1668640355,205357,true,1207548840,28,1210329260,2780420
1668640607,205356,true,1207669595,28,1211903632,4234037
1668640619,205354,true,1207911141,28,1212024823,4113682
1668640643,205351,true,1208273551,28,1212146025,3872474
1668640655,205350,true,1208394378,28,1212146025,3751647
1668640667,205349,true,1208515217,28,1212267240,3752023
1668641375,205348,true,1208636069,28,1214815548,6179479
1668641411,205346,true,1208877808,28,1214815548,5937740
1668641435,205346,true,1208877808,28,1214815548,5937740
1668641627,205345,true,1208998696,28,1214572622,5573926
1668641651,205344,true,1209119596,28,1214572622,5453026
1668642227,205341,true,1209482368,28,1214086914,4604546
1668642767,205341,true,1209482368,28,1213965517,4483149
1668643451,205341,true,1209482368,28,1214086914,4604546
1668643499,205340,true,1209603316,28,1214086914,4483598
1668643715,205337,true,1209966234,28,1214086914,4120680
1668643727,205337,true,1209966234,28,1214086914,4120680
1668644003,205337,true,1209966234,28,1214329743,4363509
1668645287,205337,true,1209966234,28,1215058523,5092289
1668645383,205335,true,1210208239,28,1215180029,4971790
1668645443,205335,true,1210208239,28,1215180029,4971790
1668645683,205336,true,1210087230,28,1215180029,5092799
1668645707,205336,true,1210087230,28,1215180029,5092799
1668645803,205333,true,1210450293,28,1215180029,4729736
1668645827,205334,true,1210329260,28,1215301547,4972287
1668645863,205334,true,1210329260,28,1215301547,4972287
1668646163,205334,true,1210329260,28,1215301547,4972287
1668646175,205331,true,1210692395,28,1215301547,4609152
1668646235,205332,true,1210571338,28,1215544620,4973282
1668646259,205332,true,1210571338,28,1215666174,5094836
1668646427,205330,true,1210813464,28,1216152514,5339050
1668646763,205329,true,1210934545,28,1217369214,6434669
1668646919,205329,true,1210934545,28,1217856234,6921689
1668647255,205329,true,1210934545,28,1219074639,8140094
1668647267,205328,true,1211055639,28,1219074639,8019000
1668647315,205327,true,1211176744,28,1219318466,8141722
1668647423,205327,true,1211176744,28,1219684298,8507554
1668647471,205327,true,1211176744,28,1219928247,8751503
1668647567,205326,true,1211297862,28,1220294262,8996400
1668647723,205325,true,1211418992,28,1220904531,9485539
1668647747,205326,true,1211297862,28,1220904531,9606669
1668648227,205325,true,1211418992,28,1222370423,10951431
1668648491,205324,true,1211540134,28,1222737171,11197037
1668649583,205323,true,1211661288,28,1223838074,12176786
1668649619,205323,true,1211661288,28,1223838074,12176786
1668649703,205323,true,1211661288,28,1223838074,12176786
1668649751,205322,true,1211782454,28,1223838074,12055620
1668649811,205320,true,1212024823,28,1223838074,11813251
1668649835,205320,true,1212024823,28,1223838074,11813251
1668649871,205320,true,1212024823,28,1223838074,11813251
1668649895,205319,true,1212146025,28,1223715703,11569678
1668649907,205318,true,1212267240,28,1223715703,11448463
1668650567,205318,true,1212267240,28,1222859444,10592204
1668650639,205317,true,1212388466,28,1222737171,10348705
1668650771,205316,true,1212509705,28,1222492660,9982955
1668651023,205315,true,1212630956,28,1222003785,9372829
1668651035,205315,true,1212630956,28,1222003785,9372829
1668651119,205314,true,1212752219,28,1221881597,9129378
1668651143,205312,true,1212994782,28,1221881597,8886815
1668651179,205311,true,1213116081,28,1221759421,8643340
1668651191,205311,true,1213116081,28,1221759421,8643340
1668651527,205310,true,1213237393,28,1220904531,7667138
1668651683,205307,true,1213601401,28,1220538333,6936932
1668651887,205306,true,1213722761,28,1220294262,6571501
1668651935,205306,true,1213722761,28,1220172245,6449484
1668651983,205305,true,1213844133,28,1220172245,6328112
1668652043,205302,true,1214208323,28,1220050240,5841917
1668652211,205301,true,1214329743,28,1219806266,5476523
1668652691,205301,true,1214329743,28,1219074639,4744896
1668653087,205300,true,1214451176,28,1218587131,4135955
1668653195,205297,true,1214815548,28,1218465284,3649736
1668653267,205297,true,1214815548,28,1218465284,3649736
1668653363,205297,true,1214815548,28,1218343450,3527902
1668653375,205296,true,1214937030,28,1218343450,3406420
1668653411,205294,true,1215180029,28,1218343450,3163421
1668653435,205293,true,1215301547,28,1218221628,2920081
1668653531,205294,true,1215180029,28,1218099818,2919789
1668653591,205293,true,1215301547,28,1217978020,2676473
1668653687,205291,true,1215544620,28,1217734461,2189841
1668653699,205290,true,1215666174,28,1217612700,1946526
1668653759,205291,true,1215544620,28,1217490951,1946331
1668653831,205290,true,1215666174,28,1217247489,1581315
1668653903,205288,true,1215909320,28,1217125776,1216456
1668653915,205288,true,1215909320,28,1217004076,1094756
1668653999,205289,true,1215787741,28,1216760712,972971
1668654011,205288,true,1215909320,28,1216760712,851392
1668655067,205287,true,1216030911,28,1212024823,-4006088
1668655367,205287,true,1216030911,28,1211055639,-4975272
1668655787,205288,true,1215909320,28,1210208239,-5701081
1668655871,205288,true,1215909320,28,1210087230,-5822090
1668656735,205287,true,1216030911,28,1209603316,-6427595
1668657347,205287,true,1216030911,28,1209119596,-6911315
1668657407,205288,true,1215909320,28,1209119596,-6789724
1668657467,205288,true,1215909320,28,1208998696,-6910624
1668657515,205287,true,1216030911,28,1208877808,-7153103
1668657527,205288,true,1215909320,28,1208877808,-7031512
1668657587,205289,true,1215787741,28,1208756933,-7030808
1668657695,205289,true,1215787741,28,1208515217,-7272524
1668657719,205288,true,1215909320,28,1208394378,-7514942
1668657755,205288,true,1215909320,28,1208394378,-7514942
1668657767,205289,true,1215787741,28,1208273551,-7514190
1668657791,205289,true,1215787741,28,1208273551,-7514190
1668657803,205288,true,1215909320,28,1208273551,-7635769
1668657815,205289,true,1215787741,28,1208152735,-7635006
1668657839,205290,true,1215666174,28,1208031932,-7634242
1668657863,205290,true,1215666174,28,1208031932,-7634242
1668657875,205290,true,1215666174,28,1207911141,-7755033
1668657887,205291,true,1215544620,28,1207790362,-7754258
1668657899,205293,true,1215301547,28,1207790362,-7511185
1668657959,205294,true,1215180029,28,1207428097,-7751932
1668658007,205295,true,1215058523,28,1207065941,-7992582
1668658427,205297,true,1214815548,28,1204052196,-10763352
1668658463,205299,true,1214572622,28,1203811422,-10761200
1668658727,205300,true,1214451176,28,1201886960,-12564216
1668659003,205301,true,1214329743,28,1199845589,-14484154
1668659147,205303,true,1214086914,28,1198886145,-15200769
1668659531,205304,true,1213965517,28,1196969556,-16995961
1668659543,205306,true,1213722761,28,1196969556,-16753205
1668659555,205306,true,1213722761,28,1196849871,-16872890
1668659567,205307,true,1213601401,28,1196849871,-16751530
1668659591,205309,true,1213358717,28,1196849871,-16508846
1668659603,205310,true,1213237393,28,1196730198,-16507195
1668659663,205310,true,1213237393,28,1196730198,-16507195
1668659675,205312,true,1212994782,28,1196730198,-16264584
1668659699,205313,true,1212873495,28,1196730198,-16143297
1668659747,205314,true,1212752219,28,1196849871,-15902348
1668659855,205314,true,1212752219,28,1197089253,-15662966
1668659867,205316,true,1212509705,28,1197208962,-15300743
1668660383,205317,true,1212388466,28,1198646404,-13742062
1668660467,205318,true,1212267240,28,1198886145,-13381095
1668661007,205318,true,1212267240,28,1200325600,-11941640
1668661343,205320,true,1212024823,28,1201045975,-10978848
1668661355,205321,true,1211903632,28,1201166080,-10737552
1668661391,205322,true,1211782454,28,1201166080,-10616374
1668661403,205322,true,1211782454,28,1201166080,-10616374
1668661559,205323,true,1211661288,28,1201646618,-10014670
1668661775,205324,true,1211540134,28,1202127349,-9412785
1668661823,205325,true,1211418992,28,1202127349,-9291643
1668662243,205325,true,1211418992,28,1203330017,-8088975
1668662303,205326,true,1211297862,28,1203570695,-7727167
1668662399,205327,true,1211176744,28,1203811422,-7365322
1668662579,205328,true,1211055639,28,1204413448,-6642191
1668662591,205329,true,1210934545,28,1204413448,-6521097
1668662999,205330,true,1210813464,28,1205738965,-5074499
1668663179,205331,true,1210692395,28,1206221333,-4471062
1668663371,205332,true,1210571338,28,1206462589,-4108749
1668663407,205334,true,1210329260,28,1206462589,-3866671
1668663491,205334,true,1210329260,28,1206583236,-3746024
1668664103,205335,true,1210208239,28,1206824564,-3383675
1668664463,205337,true,1209966234,28,1206824564,-3141670
1668664499,205338,true,1209845249,28,1206824564,-3020685
1668664955,205339,true,1209724277,28,1206824564,-2899713
1668665003,205340,true,1209603316,28,1206824564,-2778752
1668665519,205341,true,1209482368,28,1207548840,-1933528
1668665663,205343,true,1209240508,28,1207790362,-1450146
1668665711,205343,true,1209240508,28,1207911141,-1329367
1668665831,205344,true,1209119596,28,1208152735,-966861
1668665987,205345,true,1208998696,28,1208394378,-604318
1668666119,205347,true,1208756933,28,1208756933,0
1668666191,205347,true,1208756933,28,1208877808,120875
1668666479,205348,true,1208636069,28,1209603316,967247
1668666599,205349,true,1208515217,28,1209845249,1330032
1668666887,205350,true,1208394378,28,1210450293,2055915
1668667415,205350,true,1208394378,28,1211055639,2661261
1668667775,205351,true,1208273551,28,1211055639,2782088
1668667847,205352,true,1208152735,28,1211055639,2902904
1668667859,205353,true,1208031932,28,1211055639,3023707
1668667871,205353,true,1208031932,28,1211055639,3023707
1668667883,205354,true,1207911141,28,1211055639,3144498
1668668171,205356,true,1207669595,28,1210571338,2901743
1668668231,205357,true,1207548840,28,1210450293,2901453
1668668243,205357,true,1207548840,28,1210329260,2780420
1668668255,205358,true,1207428097,28,1210329260,2901163
1668668879,205360,true,1207186648,28,1207307367,120719
1668669203,205362,true,1206945247,28,1205738965,-1206282
1668669215,205362,true,1206945247,28,1205618403,-1326844
1668669227,205363,true,1206824564,28,1205618403,-1206161
1668669599,205366,true,1206462589,28,1203330017,-3132572
1668669743,205367,true,1206341955,28,1202608272,-3733683
1668669791,205368,true,1206221333,28,1202367786,-3853547
1668669815,205368,true,1206221333,28,1202247562,-3973771
1668670067,205371,true,1205859539,28,1201045975,-4813564
1668670079,205373,true,1205618403,28,1201045975,-4572428
1668670091,205373,true,1205618403,28,1201045975,-4572428
1668670271,205374,true,1205497854,28,1200925883,-4571971
1668670787,205376,true,1205256790,28,1200805802,-4450988
1668671495,205377,true,1205136276,28,1201286196,-3850080
1668671903,205377,true,1205136276,28,1201886960,-3249316
1668672035,205378,true,1205015775,28,1201886960,-3128815
1668672143,205380,true,1204774808,28,1202007148,-2767660
1668672263,205381,true,1204654342,28,1202007148,-2647194
1668672275,205381,true,1204654342,28,1202007148,-2647194
1668672287,205381,true,1204654342,28,1202007148,-2647194
1668672335,205383,true,1204413448,28,1202007148,-2406300
1668672359,205384,true,1204293018,28,1202127349,-2165669
1668673823,205384,true,1204293018,28,1203570695,-722323
1668674111,205384,true,1204293018,28,1203691053,-601965
1668676343,205386,true,1204052196,28,1203570695,-481501
1668676967,205386,true,1204052196,28,1203330017,-722179
1668676991,205386,true,1204052196,28,1203330017,-722179
1668677567,205386,true,1204052196,28,1201406325,-2645871
1668677615,205389,true,1203691053,28,1201166080,-2524973
1668677639,205390,true,1203570695,28,1201045975,-2524720
1668677651,205390,true,1203570695,28,1201045975,-2524720
1668677783,205392,true,1203330017,28,1199725617,-3604400
1668677819,205395,true,1202969091,28,1199365771,-3603320
1668677831,205397,true,1202728533,28,1199245847,-3482686
1668678335,205396,true,1202848806,28,1195056032,-7792774
1668678431,205398,true,1202608272,28,1194219827,-8388445
1668678563,205401,true,1202247562,28,1193384208,-8863354
1668678599,205402,true,1202127349,28,1193145567,-8981782
1668678647,205400,true,1202367786,28,1192787695,-9580091
1668679271,205402,true,1202127349,28,1189452727,-12674622
1668680111,205405,true,1201766783,28,1189452727,-12314056
1668680171,205406,true,1201646618,28,1189571672,-12074946
1668680255,205404,true,1201886960,28,1189571672,-12315288
1668680615,205406,true,1201646618,28,1189690629,-11955989
1668680723,205409,true,1201286196,28,1189809598,-11476598
1668680759,205409,true,1201286196,28,1189809598,-11476598
1668680807,205408,true,1201406325,28,1189809598,-11596727
1668680819,205409,true,1201286196,28,1189809598,-11476598
1668680891,205411,true,1201045975,28,1189928579,-11117396
1668681863,205411,true,1201045975,28,1190880856,-10165119
1668681923,205409,true,1201286196,28,1190999944,-10286252
1668682163,205410,true,1201166080,28,1191119044,-10047036
1668682571,205412,true,1200925883,28,1191714722,-9211161
1668682739,205412,true,1200925883,28,1191833894,-9091989
1668682835,205410,true,1201166080,28,1191953077,-9213003
1668683015,205412,true,1200925883,28,1192072272,-8853611
1668683279,205413,true,1200805802,28,1192310699,-8495103
1668683291,205413,true,1200805802,28,1192310699,-8495103
1668683303,205411,true,1201045975,28,1192310699,-8735276
1668683327,205413,true,1200805802,28,1192310699,-8495103
1668683423,205414,true,1200685733,28,1192668428,-8017305
1668683447,205415,true,1200565677,28,1192668428,-7897249
1668683543,205413,true,1200805802,28,1192906973,-7898829
1668683555,205415,true,1200565677,28,1193026264,-7539413
1668683879,205415,true,1200565677,28,1193981019,-6584658
1668683891,205416,true,1200445632,28,1194100417,-6345215
1668683915,205414,true,1200685733,28,1194100417,-6585316
1668684119,205415,true,1200565677,28,1194817057,-5748620
1668685163,205416,true,1200445632,28,1198406710,-2038922
1668685307,205416,true,1200445632,28,1198646404,-1799228
1668685331,205414,true,1200685733,28,1198646404,-2039329
1668685487,205416,true,1200445632,28,1198646404,-1799228
1668685823,205417,true,1200325600,28,1198406710,-1918890
1668685835,205418,true,1200205579,28,1198406710,-1798869
1668685847,205417,true,1200325600,28,1198406710,-1918890
1668685859,205418,true,1200205579,28,1198406710,-1798869
1668685871,205419,true,1200085571,28,1198406710,-1678861
1668685883,205420,true,1199965574,28,1198406710,-1558864
1668686195,205418,true,1200205579,28,1198646404,-1559175
1668686471,205420,true,1199965574,28,1198886145,-1079429
1668686867,205421,true,1199845589,28,1199365771,-479818
1668687227,205421,true,1199845589,28,1199845589,0
1668687683,205420,true,1199965574,28,1200685733,720159
1668687863,205422,true,1199725617,28,1200685733,960116
1668688379,205423,true,1199605656,28,1200685733,1080077
1668688703,205423,true,1199605656,28,1200565677,960021
1668689219,205422,true,1199725617,28,1200445632,720015
1668689699,205424,true,1199485708,28,1200325600,839892
1668689879,205425,true,1199365771,28,1200325600,959829
1668690143,205425,true,1199365771,28,1200325600,959829
1668690191,205424,true,1199485708,28,1200325600,839892
1668690275,205426,true,1199245847,28,1200325600,1079753
1668690287,205427,true,1199125934,28,1200325600,1199666
1668690299,205428,true,1199006033,28,1200325600,1319567
1668690323,205426,true,1199245847,28,1200325600,1079753
1668690347,205429,true,1198886145,28,1200325600,1439455
1668690359,205430,true,1198766268,28,1200325600,1559332
1668690575,205431,true,1198646404,28,1199965574,1319170
1668690635,205430,true,1198766268,28,1199845589,1079321
1668690647,205433,true,1198406710,28,1199845589,1438879
1668690683,205434,true,1198286882,28,1199845589,1558707
1668690719,205435,true,1198167065,28,1199725617,1558552
1668690731,205434,true,1198286882,28,1199725617,1438735
1668690743,205437,true,1197927467,28,1199725617,1798150
1668690755,205438,true,1197807687,28,1199725617,1917930
1668690767,205440,true,1197568161,28,1199605656,2037495
1668691091,205439,true,1197687918,28,1198646404,958486
1668691139,205441,true,1197448416,28,1198526551,1078135
1668691151,205442,true,1197328683,28,1198526551,1197868
1668691175,205444,true,1197089253,28,1198406710,1317457
1668691235,205443,true,1197208962,28,1198047260,838298
1668691367,205446,true,1196849871,28,1197208962,359091
1668691595,205446,true,1196849871,28,1195892822,-957049
1668691619,205447,true,1196730198,28,1195773245,-956953
1668691775,205447,true,1196730198,28,1195056032,-1674166
1668691835,205450,true,1196371251,28,1194697587,-1673664
1668691847,205449,true,1196490888,28,1194697587,-1793301
1668691931,205450,true,1196371251,28,1194458683,-1912568
1668691979,205449,true,1196490888,28,1194339249,-2151639
1668692087,205451,true,1196251626,28,1193981019,-2270607
1668692111,205450,true,1196371251,28,1193981019,-2390232
1668692123,205451,true,1196251626,28,1193861633,-2389993
1668692135,205450,true,1196371251,28,1193861633,-2509618
1668692255,205453,true,1196012412,28,1193503546,-2508866
1668692303,205453,true,1196012412,28,1193384208,-2628204
1668692495,205454,true,1195892822,28,1192906973,-2985849
1668692507,205453,true,1196012412,28,1192906973,-3105439
1668692519,205456,true,1195653680,28,1192787695,-2865985
1668692531,205456,true,1195653680,28,1192787695,-2865985
1668692543,205457,true,1195534126,28,1192787695,-2746431
1668692555,205456,true,1195653680,28,1192668428,-2985252
1668692651,205460,true,1195175538,28,1192429930,-2745608
1668692663,205460,true,1195175538,28,1192310699,-2864839
1668692759,205461,true,1195056032,28,1192072272,-2983760
1668692879,205461,true,1195056032,28,1191714722,-3341310
1668692951,205464,true,1194697587,28,1191476415,-3221172
1668692999,205464,true,1194697587,28,1191357279,-3340308
1668693083,205465,true,1194578129,28,1191238156,-3339973
1668693563,205465,true,1194578129,28,1190642715,-3935414
1668693647,205469,true,1194100417,28,1190523663,-3576754
1668693815,205468,true,1194219827,28,1189928579,-4291248
1668693983,205468,true,1194219827,28,1189452727,-4767100
1668694523,205468,true,1194219827,28,1188501593,-5718234
1668694595,205469,true,1194100417,28,1188501593,-5598824
1668695267,205467,true,1194339249,28,1188858179,-5481070
1668695387,205467,true,1194339249,28,1188977065,-5362184
1668695579,205467,true,1194339249,28,1188977065,-5362184
1668695711,205468,true,1194219827,28,1189095962,-5123865
1668695771,205467,true,1194339249,28,1189095962,-5243287
1668695783,205467,true,1194339249,28,1189095962,-5243287
1668696047,205467,true,1194339249,28,1189333794,-5005455
1668696275,205468,true,1194219827,28,1189571672,-4648155
1668696299,205467,true,1194339249,28,1189571672,-4767577
1668696359,205467,true,1194339249,28,1189690629,-4648620
1668696371,205467,true,1194339249,28,1189690629,-4648620
1668697391,205467,true,1194339249,28,1191595563,-2743686
1668697571,205466,true,1194458683,28,1191833894,-2624789
1668698195,205466,true,1194458683,28,1192549173,-1909510
1668698219,205466,true,1194458683,28,1192549173,-1909510
1668698231,205467,true,1194339249,28,1192549173,-1790076
1668698243,205466,true,1194458683,28,1192549173,-1909510
1668698255,205465,true,1194578129,28,1192549173,-2028956
1668698267,205465,true,1194578129,28,1192668428,-1909701
1668698279,205465,true,1194578129,28,1192668428,-1909701
1668698423,205462,true,1194936538,28,1193861633,-1074905
1668698483,205461,true,1195056032,28,1194458683,-597349
1668698567,205460,true,1195175538,28,1195295055,119517
1668699083,205459,true,1195295055,28,1200685733,5390678
1668699095,205456,true,1195653680,28,1200805802,5152122
1668699179,205455,true,1195773245,28,1201766783,5993538
1668699191,205454,true,1195892822,28,1201886960,5994138
1668699203,205453,true,1196012412,28,1202007148,5994736
1668699251,205451,true,1196251626,28,1202608272,6356646
1668699263,205450,true,1196371251,28,1202728533,6357282
1668699275,205449,true,1196490888,28,1202848806,6357918
1668699287,205448,true,1196610537,28,1202969091,6358554
1668699299,205446,true,1196849871,28,1203089388,6239517
1668699323,205445,true,1196969556,28,1203330017,6360461
1668699347,205445,true,1196969556,28,1203570695,6601139
1668699431,205445,true,1196969556,28,1204413448,7443892
1668699635,205442,true,1197328683,28,1206462589,9133906
1668699671,205442,true,1197328683,28,1206824564,9495881
1668699959,205442,true,1197328683,28,1209724277,12395594
1668700079,205441,true,1197448416,28,1210692395,13243979
1668700091,205439,true,1197687918,28,1210692395,13004477
1668700127,205438,true,1197807687,28,1210813464,13005777
1668700139,205438,true,1197807687,28,1210813464,13005777
1668700163,205438,true,1197807687,28,1210813464,13005777
1668700175,205436,true,1198047260,28,1210813464,12766204
1668700259,205436,true,1198047260,28,1210571338,12524078
1668700283,205437,true,1197927467,28,1210450293,12522826
1668700307,205437,true,1197927467,28,1210208239,12280772
1668700703,205438,true,1197807687,28,1205980125,8172438
1668700979,205439,true,1197687918,28,1202848806,5160888
1668701099,205439,true,1197687918,28,1201526466,3838548
1668701243,205440,true,1197568161,28,1199965574,2397413
1668701255,205440,true,1197568161,28,1199845589,2277428
1668701267,205441,true,1197448416,28,1199725617,2277201
1668701279,205442,true,1197328683,28,1199725617,2396934
1668701291,205442,true,1197328683,28,1199605656,2276973
1668701579,205441,true,1197448416,28,1197448416,0
1668701663,205442,true,1197328683,28,1196849871,-478812
1668701723,205443,true,1197208962,28,1196490888,-718074
1668701831,205442,true,1197328683,28,1195773245,-1555438
1668701843,205442,true,1197328683,28,1195653680,-1675003
1668702359,205442,true,1197328683,28,1196251626,-1077057
1668702383,205443,true,1197208962,28,1196371251,-837711
1668702395,205442,true,1197328683,28,1196490888,-837795
1668702431,205441,true,1197448416,28,1196730198,-718218
1668702455,205441,true,1197448416,28,1196849871,-598545
1668702731,205440,true,1197568161,28,1199125934,1557773
1668702779,205439,true,1197687918,28,1199485708,1797790
1668704027,205439,true,1197687918,28,1206583236,8895318
1668704231,205438,true,1197807687,28,1207307367,9499680
1668704243,205437,true,1197927467,28,1207307367,9379900
1668704267,205436,true,1198047260,28,1207307367,9260107
1668704483,205435,true,1198167065,28,1207548840,9381775
1668704495,205434,true,1198286882,28,1207548840,9261958
1668704519,205433,true,1198406710,28,1207669595,9262885
1668704531,205432,true,1198526551,28,1207669595,9143044
1668704543,205431,true,1198646404,28,1207669595,9023191
1668704567,205430,true,1198766268,28,1207790362,9024094
1668704675,205428,true,1199006033,28,1208031932,9025899
1668704687,205426,true,1199245847,28,1208031932,8786085
1668705035,205424,true,1199485708,28,1208877808,9392100
1668705191,205423,true,1199605656,28,1209240508,9634852
1668705251,205421,true,1199845589,28,1209361432,9515843
1668705263,205420,true,1199965574,28,1209361432,9395858
1668705311,205418,true,1200205579,28,1209482368,9276789
1668705323,205418,true,1200205579,28,1209482368,9276789
1668705371,205416,true,1200445632,28,1209603316,9157684
1668705431,205415,true,1200565677,28,1209724277,9158600
1668705743,205414,true,1200685733,28,1209966234,9280501
1668705899,205413,true,1200805802,28,1210087230,9281428
1668706547,205412,true,1200925883,28,1209724277,8798394
1668706859,205411,true,1201045975,28,1209240508,8194533
1668706883,205409,true,1201286196,28,1209119596,7833400
1668707471,205409,true,1201286196,28,1207790362,6504166
1668707783,205408,true,1201406325,28,1207307367,5901042
1668707951,205407,true,1201526466,28,1207065941,5539475
1668707963,205405,true,1201766783,28,1207065941,5299158
1668707975,205405,true,1201766783,28,1207065941,5299158
1668708143,205403,true,1202007148,28,1206945247,4938099
1668708539,205401,true,1202247562,28,1207307367,5059805
1668708707,205399,true,1202488023,28,1207548840,5060817
1668709247,205399,true,1202488023,28,1208636069,6148046
1668709595,205397,true,1202728533,28,1209361432,6632899
1668709691,205395,true,1202969091,28,1209603316,6634225
1668709739,205393,true,1203209696,28,1209724277,6514581
1668709835,205392,true,1203330017,28,1209845249,6515232
1668709847,205391,true,1203450350,28,1209845249,6394899
1668709895,205388,true,1203811422,28,1209966234,6154812
1668710195,205387,true,1203931803,28,1209966234,6034431
1668710507,205386,true,1204052196,28,1209845249,5793053
1668711323,205384,true,1204293018,28,1209603316,5310298
1668711587,205382,true,1204533889,28,1209603316,5069427
1668711779,205381,true,1204654342,28,1209482368,4828026
1668711839,205380,true,1204774808,28,1209482368,4707560
1668711947,205378,true,1205015775,28,1209482368,4466593
1668712091,205376,true,1205256790,28,1209482368,4225578
1668712103,205375,true,1205377316,28,1209482368,4105052
1668712367,205374,true,1205497854,28,1209482368,3984514
1668712835,205373,true,1205618403,28,1209240508,3622105
1668713135,205370,true,1205980125,28,1208998696,3018571
1668713675,205369,true,1206100723,28,1208636069,2535346
1668713699,205369,true,1206100723,28,1208636069,2535346
1668714167,205367,true,1206341955,28,1208273551,1931596
1668714275,205366,true,1206462589,28,1208152735,1690146
1668714443,205365,true,1206583236,28,1208152735,1569499
1668715115,205364,true,1206703894,28,1207911141,1207247
1668715451,205363,true,1206824564,28,1207307367,482803
1668715691,205362,true,1206945247,28,1206703894,-241353
1668716123,205361,true,1207065941,28,1205738965,-1326976
1668717263,205361,true,1207065941,28,1204052196,-3013745
1668718667,205361,true,1207065941,28,1202848806,-4217135
1668719591,205360,true,1207186648,28,1202367786,-4818862
1668719807,205362,true,1206945247,28,1202367786,-4577461
1668719843,205363,true,1206824564,28,1202488023,-4336541
1668719855,205363,true,1206824564,28,1202488023,-4336541
1668720131,205362,true,1206945247,28,1202728533,-4216714
1668720155,205364,true,1206703894,28,1202728533,-3975361
1668720731,205365,true,1206583236,28,1203691053,-2892183
1668721247,205365,true,1206583236,28,1204533889,-2049347
1668721991,205365,true,1206583236,28,1205497854,-1085382
1668722327,205366,true,1206462589,28,1205497854,-964735
1668723575,205367,true,1206341955,28,1205618403,-723552
1668723971,205367,true,1206341955,28,1205618403,-723552
1668723983,205367,true,1206341955,28,1205618403,-723552
1668724103,205368,true,1206221333,28,1205618403,-602930
1668724127,205369,true,1206100723,28,1205618403,-482320
1668724415,205369,true,1206100723,28,1205618403,-482320
1668724763,205368,true,1206221333,28,1205618403,-602930
1668724871,205370,true,1205980125,28,1205618403,-361722
1668725627,205370,true,1205980125,28,1205618403,-361722
1668725795,205370,true,1205980125,28,1205618403,-361722
1668725831,205370,true,1205980125,28,1205618403,-361722
1668726095,205371,true,1205859539,28,1205618403,-241136
1668727019,205372,true,1205738965,28,1205497854,-241111
1668727511,205372,true,1205738965,28,1205136276,-602689
1668727679,205371,true,1205859539,28,1205015775,-843764
1668727763,205372,true,1205738965,28,1204895285,-843680
1668728147,205372,true,1205738965,28,1204293018,-1445947
1668728171,205372,true,1205738965,28,1204293018,-1445947
1668729395,205371,true,1205859539,28,1201166080,-4693459
1668730223,205370,true,1205980125,28,1200205579,-5774546
1668730235,205370,true,1205980125,28,1200205579,-5774546
1668730247,205370,true,1205980125,28,1200205579,-5774546
1668730259,205369,true,1206100723,28,1200205579,-5895144
1668730271,205367,true,1206341955,28,1200325600,-6016355
1668730283,205367,true,1206341955,28,1200325600,-6016355
1668730307,205366,true,1206462589,28,1200325600,-6136989
1668730319,205366,true,1206462589,28,1200445632,-6016957
1668730379,205364,true,1206703894,28,1200685733,-6018161
1668730667,205363,true,1206824564,28,1201886960,-4937604
1668730979,205363,true,1206824564,28,1203209696,-3614868
1668731471,205363,true,1206824564,28,1205256790,-1567774
1668731495,205361,true,1207065941,28,1205377316,-1688625
1668731555,205361,true,1207065941,28,1205618403,-1447538
1668731591,205361,true,1207065941,28,1205738965,-1326976
1668731699,205360,true,1207186648,28,1206341955,-844693
1668732203,205359,true,1207307367,28,1208394378,1087011
1668732239,205359,true,1207307367,28,1208394378,1087011
1668732311,205360,true,1207186648,28,1208515217,1328569
1668732431,205359,true,1207307367,28,1208636069,1328702
1668732935,205358,true,1207428097,28,1209361432,1933335
1668732959,205358,true,1207428097,28,1209361432,1933335
1668733055,205359,true,1207307367,28,1209603316,2295949
1668733067,205358,true,1207428097,28,1209603316,2175219
1668733187,205357,true,1207548840,28,1209966234,2417394
1668733331,205357,true,1207548840,28,1210329260,2780420
1668733511,205357,true,1207548840,28,1210692395,3143555
1668733859,205357,true,1207548840,28,1211540134,3991294
1668733883,205356,true,1207669595,28,1211540134,3870539
1668734987,205356,true,1207669595,28,1213480053,5810458
1668735143,205357,true,1207548840,28,1213480053,5931213
1668735455,205356,true,1207669595,28,1213480053,5810458
1668736391,205355,true,1207790362,28,1213480053,5689691
1668737519,205356,true,1207669595,28,1213480053,5810458
1668737843,205356,true,1207669595,28,1213480053,5810458
1668737975,205356,true,1207669595,28,1213480053,5810458
1668737987,205355,true,1207790362,28,1213480053,5689691
1668738023,205355,true,1207790362,28,1213480053,5689691
1668738047,205356,true,1207669595,28,1213480053,5810458
1668738647,205355,true,1207790362,28,1212994782,5204420
1668738935,205354,true,1207911141,28,1212752219,4841078
1668738983,205354,true,1207911141,28,1212752219,4841078
1668739103,205355,true,1207790362,28,1212630956,4840594
1668739175,205354,true,1207911141,28,1212630956,4719815
1668739187,205353,true,1208031932,28,1212630956,4599024
1668739247,205352,true,1208152735,28,1212752219,4599484
1668739271,205352,true,1208152735,28,1212873495,4720760
1668739283,205350,true,1208394378,28,1212994782,4600404
1668740255,205347,true,1208756933,28,1220416292,11659359
1668740315,205347,true,1208756933,28,1220904531,12147598
1668740339,205346,true,1208877808,28,1221026622,12148814
1668740579,205345,true,1208998696,28,1222981730,13983034
1668740603,205342,true,1209361432,28,1223104028,13742596
1668741011,205342,true,1209361432,28,1226165461,16804029
1668741035,205341,true,1209482368,28,1226288077,16805709
1668741275,205340,true,1209603316,28,1226410706,16807390
1668741359,205337,true,1209966234,28,1226410706,16444472
1668741371,205337,true,1209966234,28,1226410706,16444472
1668742187,205337,true,1209966234,28,1225797685,15831451
1668743123,205336,true,1210087230,28,1225307488,15220258
1668743447,205332,true,1210571338,28,1225184970,14613632
1668743771,205332,true,1210571338,28,1225062463,14491125
1668743795,205332,true,1210571338,28,1225062463,14491125
1668743843,205332,true,1210571338,28,1224939969,14368631
1668743975,205328,true,1211055639,28,1224817488,13761849
1668743987,205328,true,1211055639,28,1224695018,13639379
1668744047,205328,true,1211055639,28,1224695018,13639379
1668744095,205328,true,1211055639,28,1224572561,13516922
1668744155,205324,true,1211540134,28,1224450116,12909982
1668744599,205325,true,1211418992,28,1223715703,12296711
1668744647,205324,true,1211540134,28,1223715703,12175569
1668744659,205324,true,1211540134,28,1223593343,12053209
1668744683,205320,true,1212024823,28,1223593343,11568520
1668744755,205321,true,1211903632,28,1223348661,11445029
1668744815,205321,true,1211903632,28,1223226339,11322707
1668745307,205320,true,1212024823,28,1221515106,9490283
1668745451,205317,true,1212388466,28,1221148724,8760258
1668745607,205318,true,1212267240,28,1220660387,8393147
1668745883,205317,true,1212388466,28,1220172245,7783779
1668745895,205317,true,1212388466,28,1220050240,7661774
1668746279,205313,true,1212873495,28,1219196546,6323051
1668746819,205313,true,1212873495,28,1218465284,5591789
1668747011,205313,true,1212873495,28,1218343450,5469955
1668747023,205312,true,1212994782,28,1218343450,5348668
1668747035,205309,true,1213358717,28,1218343450,4984733
1668747119,205309,true,1213358717,28,1218221628,4862911
1668747707,205308,true,1213480053,28,1218221628,4741575
1668748211,205308,true,1213480053,28,1218465284,4985231
1668748247,205305,true,1213844133,28,1218587131,4742998
1668748307,205305,true,1213844133,28,1218587131,4742998
1668748403,205304,true,1213965517,28,1218708989,4743472
1668748511,205304,true,1213965517,28,1218952743,4987226
1668748583,205300,true,1214451176,28,1219074639,4623463
1668748751,205300,true,1214451176,28,1219318466,4867290
1668749231,205299,true,1214572622,28,1220172245,5599623
1668750023,205299,true,1214572622,28,1221270839,6698217
1668750167,205296,true,1214937030,28,1221515106,6578076
1668750275,205296,true,1214937030,28,1221515106,6578076
1668750395,205295,true,1215058523,28,1221515106,6456583
1668750419,205294,true,1215180029,28,1221515106,6335077
1668750443,205291,true,1215544620,28,1221515106,5970486
1668750839,205291,true,1215544620,28,1221392966,5848346
1668751103,205290,true,1215666174,28,1221270839,5604665
1668751115,205290,true,1215666174,28,1221270839,5604665
1668751319,205286,true,1216152514,28,1221148724,4996210
1668751691,205287,true,1216030911,28,1220782453,4751542
1668751715,205286,true,1216152514,28,1220782453,4629939
1668751763,205285,true,1216274129,28,1220782453,4508324
1668751847,205282,true,1216639048,28,1220660387,4021339
1668751931,205282,true,1216639048,28,1220538333,3899285
1668752003,205281,true,1216760712,28,1220416292,3655580
1668752015,205280,true,1216882388,28,1220416292,3533904
1668752195,205277,true,1217247489,28,1219928247,2680758
1668752447,205277,true,1217247489,28,1219196546,1949057
1668752735,205276,true,1217369214,28,1218587131,1217917
1668752747,205275,true,1217490951,28,1218465284,974333
1668752867,205273,true,1217734461,28,1218221628,487167
1668753875,205273,true,1217734461,28,1216395756,-1338705
1668754187,205273,true,1217734461,28,1216395756,-1338705
1668755411,205272,true,1217856234,28,1216395756,-1460478
1668755603,205270,true,1218099818,28,1216395756,-1704062
1668755735,205271,true,1217978020,28,1216395756,-1582264
1668755987,205270,true,1218099818,28,1216395756,-1704062
1668756071,205269,true,1218221628,28,1216395756,-1825872
1668756311,205268,true,1218343450,28,1216395756,-1947694
1668756467,205268,true,1218343450,28,1216395756,-1947694
1668756575,205268,true,1218343450,28,1216395756,-1947694
1668757127,205267,true,1218465284,28,1216395756,-2069528
1668757499,205266,true,1218587131,28,1216395756,-2191375
1668757511,205266,true,1218587131,28,1216395756,-2191375
1668757979,205266,true,1218587131,28,1216395756,-2191375
1668758303,205265,true,1218708989,28,1216395756,-2313233
1668758603,205264,true,1218830860,28,1216274129,-2556731
1668758639,205264,true,1218830860,28,1216152514,-2678346
1668758675,205264,true,1218830860,28,1216152514,-2678346
1668758783,205264,true,1218830860,28,1215787741,-3043119
1668758795,205264,true,1218830860,28,1215787741,-3043119
1668759131,205265,true,1218708989,28,1214694079,-4014910
1668759215,205265,true,1218708989,28,1214451176,-4257813
1668759455,205265,true,1218708989,28,1213722761,-4986228
1668759515,205265,true,1218708989,28,1213480053,-5228936
1668759683,205266,true,1218587131,28,1212873495,-5713636
1668759851,205266,true,1218587131,28,1212388466,-6198665
1668759959,205266,true,1218587131,28,1212024823,-6562308
1668760391,205265,true,1218708989,28,1210692395,-8016594
1668760403,205266,true,1218587131,28,1210692395,-7894736
1668761831,205266,true,1218587131,28,1210450293,-8136838
1668761927,205267,true,1218465284,28,1210450293,-8014991
1668762239,205266,true,1218587131,28,1210450293,-8136838
1668762539,205267,true,1218465284,28,1210450293,-8014991
1668763439,205267,true,1218465284,28,1210450293,-8014991
1668763691,205267,true,1218465284,28,1210450293,-8014991
1668763823,205267,true,1218465284,28,1210450293,-8014991
1668764123,205268,true,1218343450,28,1210450293,-7893157
1668764483,205268,true,1218343450,28,1210450293,-7893157
1668764519,205268,true,1218343450,28,1210571338,-7772112
1668764651,205267,true,1218465284,28,1210692395,-7772889
1668764663,205269,true,1218221628,28,1210692395,-7529233
1668764675,205269,true,1218221628,28,1210692395,-7529233
1668765791,205270,true,1218099818,28,1211903632,-6196186
1668766019,205271,true,1217978020,28,1212267240,-5710780
1668766031,205273,true,1217734461,28,1212267240,-5467221
1668766163,205273,true,1217734461,28,1212509705,-5224756
1668766319,205273,true,1217734461,28,1212873495,-4860966
1668766583,205275,true,1217490951,28,1213237393,-4253558
1668766595,205276,true,1217369214,28,1213237393,-4131821
1668766607,205276,true,1217369214,28,1213237393,-4131821
1668766667,205277,true,1217247489,28,1213358717,-3888772
1668766679,205278,true,1217125776,28,1213358717,-3767059
1668767351,205279,true,1217004076,28,1215301547,-1702529
1668767387,205279,true,1217004076,28,1215423077,-1580999
1668767423,205279,true,1217004076,28,1215544620,-1459456
1668767435,205280,true,1216882388,28,1215544620,-1337768
1668767471,205281,true,1216760712,28,1215787741,-972971
1668767495,205280,true,1216882388,28,1215787741,-1094647
1668767555,205280,true,1216882388,28,1216152514,-729874
1668768095,205281,true,1216760712,28,1218221628,1460916
1668768119,205281,true,1216760712,28,1218343450,1582738
1668768143,205281,true,1216760712,28,1218465284,1704572
1668768203,205281,true,1216760712,28,1218587131,1826419
1668768539,205282,true,1216639048,28,1219318466,2679418
1668768743,205282,true,1216639048,28,1219440398,2801350
1668769535,205282,true,1216639048,28,1219562342,2923294
1668770087,205282,true,1216639048,28,1219196546,2557498
1668770135,205283,true,1216517396,28,1219196546,2679150
1668770351,205283,true,1216517396,28,1219196546,2679150
1668771707,205282,true,1216639048,28,1219196546,2557498
1668771815,205282,true,1216639048,28,1219196546,2557498
1668771827,205283,true,1216517396,28,1219196546,2679150
1668771851,205283,true,1216517396,28,1219196546,2679150
1668771875,205282,true,1216639048,28,1219196546,2557498
1668772055,205282,true,1216639048,28,1219074639,2435591
1668772079,205283,true,1216517396,28,1219074639,2557243
1668772211,205283,true,1216517396,28,1218952743,2435347
1668772439,205282,true,1216639048,28,1218708989,2069941
1668772691,205282,true,1216639048,28,1218465284,1826236
1668773255,205283,true,1216517396,28,1217856234,1338838
1668773747,205283,true,1216517396,28,1217490951,973555
1668774515,205283,true,1216517396,28,1217490951,973555
1668774659,205282,true,1216639048,28,1217490951,851903
1668774935,205283,true,1216517396,28,1217490951,973555
1668775415,205283,true,1216517396,28,1217490951,973555
1668775571,205283,true,1216517396,28,1217490951,973555
1668777071,205283,true,1216517396,28,1217490951,973555
1668777083,205284,true,1216395756,28,1217490951,1095195
1668777119,205284,true,1216395756,28,1217490951,1095195
1668777239,205284,true,1216395756,28,1217490951,1095195
1668777359,205284,true,1216395756,28,1217490951,1095195
1668777395,205285,true,1216274129,28,1217490951,1216822
1668777587,205285,true,1216274129,28,1217490951,1216822
1668777611,205285,true,1216274129,28,1217490951,1216822
1668777683,205286,true,1216152514,28,1217490951,1338437
1668777851,205286,true,1216152514,28,1217856234,1703720
1668778547,205286,true,1216152514,28,1219074639,2922125
1668779255,205286,true,1216152514,28,1220294262,4141748
1668779651,205286,true,1216152514,28,1220416292,4263778
1668780479,205286,true,1216152514,28,1219806266,3653752
1668781343,205286,true,1216152514,28,1219440398,3287884
1668781367,205286,true,1216152514,28,1219440398,3287884
1668781919,205286,true,1216152514,28,1219440398,3287884
1668781931,205286,true,1216152514,28,1219440398,3287884
1668781955,205286,true,1216152514,28,1219440398,3287884
1668781967,205286,true,1216152514,28,1219440398,3287884
1668782411,205287,true,1216030911,28,1218708989,2678078
1668782543,205287,true,1216030911,28,1218465284,2434373
1668782555,205286,true,1216152514,28,1218465284,2312770
1668782579,205286,true,1216152514,28,1218343450,2190936
1668782591,205287,true,1216030911,28,1218343450,2312539
1668782615,205287,true,1216030911,28,1218343450,2312539
1668782939,205286,true,1216152514,28,1217369214,1216700
1668783035,205286,true,1216152514,28,1217125776,973262
1668783227,205287,true,1216030911,28,1216517396,486485
1668783827,205288,true,1215909320,28,1214694079,-1215241
1668784667,205288,true,1215909320,28,1211903632,-4005688
1668784703,205288,true,1215909320,28,1211903632,-4005688
1668784955,205289,true,1215787741,28,1211297862,-4489879
1668785003,205290,true,1215666174,28,1211297862,-4368312
1668785111,205289,true,1215787741,28,1211055639,-4732102
1668785387,205289,true,1215787741,28,1210571338,-5216403
1668785471,205290,true,1215666174,28,1210450293,-5215881
1668785603,205291,true,1215544620,28,1210208239,-5336381
1668785675,205291,true,1215544620,28,1210329260,-5215360
1668785939,205291,true,1215544620,28,1210571338,-4973282
1668786419,205292,true,1215423077,28,1211055639,-4367438
1668787547,205293,true,1215301547,28,1211661288,-3640259
1668787655,205292,true,1215423077,28,1211661288,-3761789
1668787739,205292,true,1215423077,28,1211661288,-3761789
1668788579,205293,true,1215301547,28,1211661288,-3640259
1668789095,205293,true,1215301547,28,1211661288,-3640259
1668789383,205292,true,1215423077,28,1211540134,-3882943
1668790223,205292,true,1215423077,28,1211176744,-4246333
1668790247,205293,true,1215301547,28,1211176744,-4124803
1668790283,205293,true,1215301547,28,1211176744,-4124803
1668790295,205292,true,1215423077,28,1211176744,-4246333
1668790307,205292,true,1215423077,28,1211055639,-4367438
1668791255,205294,true,1215180029,28,1208636069,-6543960
1668791267,205294,true,1215180029,28,1208515217,-6664812
1668791327,205293,true,1215301547,28,1208394378,-6907169
1668791399,205293,true,1215301547,28,1208152735,-7148812
1668791411,205295,true,1215058523,28,1208152735,-6905788
1668791423,205295,true,1215058523,28,1208031932,-7026591
1668791651,205295,true,1215058523,28,1206945247,-8113276
1668792899,205296,true,1214937030,28,1203209696,-11727334
1668793607,205297,true,1214815548,28,1202488023,-12327525
1668794135,205298,true,1214694079,28,1202488023,-12206056
1668795275,205298,true,1214694079,28,1202488023,-12206056
1668795311,205298,true,1214694079,28,1202488023,-12206056
1668795947,205300,true,1214451176,28,1202488023,-11963153
1668796079,205300,true,1214451176,28,1202488023,-11963153
1668796175,205300,true,1214451176,28,1202488023,-11963153
1668796199,205301,true,1214329743,28,1202488023,-11841720
1668797387,205303,true,1214086914,28,1202488023,-11598891
1668797807,205303,true,1214086914,28,1202488023,-11598891
1668797819,205303,true,1214086914,28,1202608272,-11478642
1668797975,205304,true,1213965517,28,1202969091,-10996426
1668798023,205306,true,1213722761,28,1203089388,-10633373
1668798131,205305,true,1213844133,28,1203330017,-10514116
1668798407,205306,true,1213722761,28,1203931803,-9790958
1668798671,205306,true,1213722761,28,1204533889,-9188872
1668799019,205308,true,1213480053,28,1205377316,-8102737
1668799319,205308,true,1213480053,28,1205980125,-7499928
1668799391,205309,true,1213358717,28,1206100723,-7257994
1668800243,205309,true,1213358717,28,1206583236,-6775481
1668800411,205311,true,1213116081,28,1206583236,-6532845
1668801611,205311,true,1213116081,28,1206583236,-6532845
1668801815,205312,true,1212994782,28,1206583236,-6411546
1668801827,205313,true,1212873495,28,1206583236,-6290259
1668801839,205315,true,1212630956,28,1206583236,-6047720
1668801899,205316,true,1212509705,28,1206583236,-5926469
1668802235,205317,true,1212388466,28,1206583236,-5805230
1668802391,205317,true,1212388466,28,1206703894,-5684572
1668802403,205320,true,1212024823,28,1206703894,-5320929
1668802427,205319,true,1212146025,28,1206703894,-5442131
1668802463,205320,true,1212024823,28,1206703894,-5320929
1668802499,205320,true,1212024823,28,1206824564,-5200259
1668802595,205323,true,1211661288,28,1206945247,-4716041
1668802883,205322,true,1211782454,28,1207186648,-4595806
1668803183,205323,true,1211661288,28,1207548840,-4112448
1668803219,205324,true,1211540134,28,1207669595,-3870539
1668803423,205326,true,1211297862,28,1207911141,-3386721
1668804611,205325,true,1211418992,28,1209240508,-2178484
1668805403,205326,true,1211297862,28,1209240508,-2057354
1668805463,205326,true,1211297862,28,1209240508,-2057354
1668805475,205328,true,1211055639,28,1209240508,-1815131
1668805823,205328,true,1211055639,28,1209240508,-1815131
1668806243,205329,true,1210934545,28,1209240508,-1694037
1668806663,205329,true,1210934545,28,1209240508,-1694037
1668807671,205331,true,1210692395,28,1209240508,-1451887
1668807971,205330,true,1210813464,28,1209240508,-1572956
1668808079,205331,true,1210692395,28,1209119596,-1572799
1668808967,205331,true,1210692395,28,1209119596,-1572799
1668809183,205333,true,1210450293,28,1209119596,-1330697
1668809423,205333,true,1210450293,28,1209119596,-1330697
1668809555,205334,true,1210329260,28,1209119596,-1209664
1668810191,205334,true,1210329260,28,1209119596,-1209664
1668813227,205336,true,1210087230,28,1209119596,-967634
1668813311,205335,true,1210208239,28,1209119596,-1088643
1668813383,205336,true,1210087230,28,1209119596,-967634
1668813419,205336,true,1210087230,28,1209119596,-967634
1668813479,205338,true,1209845249,28,1208998696,-846553
1668813587,205338,true,1209845249,28,1208998696,-846553
1668814247,205339,true,1209724277,28,1208515217,-1209060
1668814547,205339,true,1209724277,28,1208394378,-1329899
1668814583,205341,true,1209482368,28,1208394378,-1087990
1668814847,205341,true,1209482368,28,1208152735,-1329633
1668814919,205342,true,1209361432,28,1208152735,-1208697
1668815123,205343,true,1209240508,28,1208031932,-1208576
1668815147,205345,true,1208998696,28,1208031932,-966764
1668815279,205345,true,1208998696,28,1208031932,-966764
1668815399,205346,true,1208877808,28,1208031932,-845876
1668815423,205346,true,1208877808,28,1208152735,-725073
1668815507,205348,true,1208636069,28,1208152735,-483334
1668815747,205348,true,1208636069,28,1208273551,-362518
1668815843,205349,true,1208515217,28,1208394378,-120839
1668816647,205349,true,1208515217,28,1208998696,483479
1668816923,205350,true,1208394378,28,1209119596,725218
1668817091,205350,true,1208394378,28,1209361432,967054
1668817835,205351,true,1208273551,28,1209724277,1450726
1668818687,205351,true,1208273551,28,1209966234,1692683
1668819167,205352,true,1208152735,28,1209966234,1813499
1668820427,205351,true,1208273551,28,1209966234,1692683
1668820607,205352,true,1208152735,28,1209966234,1813499
1668820715,205352,true,1208152735,28,1209966234,1813499
1668820931,205353,true,1208031932,28,1209966234,1934302
1668821255,205353,true,1208031932,28,1209966234,1934302
1668822287,205353,true,1208031932,28,1209966234,1934302
1668822323,205353,true,1208031932,28,1209966234,1934302
1668822359,205354,true,1207911141,28,1209966234,2055093
1668822623,205353,true,1208031932,28,1209966234,1934302
1668822659,205353,true,1208031932,28,1209966234,1934302
1668822683,205353,true,1208031932,28,1209966234,1934302
1668823487,205354,true,1207911141,28,1209966234,2055093
1668823547,205353,true,1208031932,28,1209966234,1934302
1668824291,205354,true,1207911141,28,1208636069,724928
1668824315,205354,true,1207911141,28,1208515217,604076
1668824879,205355,true,1207790362,28,1207307367,-482995
1668824927,205354,true,1207911141,28,1207186648,-724493
1668824963,205355,true,1207790362,28,1207065941,-724421
1668825083,205355,true,1207790362,28,1206824564,-965798
1668825155,205357,true,1207548840,28,1206583236,-965604
1668825167,205356,true,1207669595,28,1206583236,-1086359
1668827111,205357,true,1207548840,28,1204774808,-2774032
1668827363,205357,true,1207548840,28,1204774808,-2774032
1668827555,205359,true,1207307367,28,1204774808,-2532559
1668827747,205358,true,1207428097,28,1204774808,-2653289
1668828239,205359,true,1207307367,28,1204774808,-2532559
1668828959,205359,true,1207307367,28,1204774808,-2532559
1668829703,205360,true,1207186648,28,1204774808,-2411840
1668829715,205359,true,1207307367,28,1204774808,-2532559
1668830495,205360,true,1207186648,28,1204774808,-2411840
1668831155,205359,true,1207307367,28,1204774808,-2532559
1668831239,205360,true,1207186648,28,1204774808,-2411840
1668831935,205359,true,1207307367,28,1204774808,-2532559
1668832535,205359,true,1207307367,28,1204774808,-2532559
1668833591,205359,true,1207307367,28,1204774808,-2532559
1668834563,205359,true,1207307367,28,1204774808,-2532559
1668834671,205358,true,1207428097,28,1204774808,-2653289
1668834683,205358,true,1207428097,28,1204774808,-2653289
1668834971,205358,true,1207428097,28,1204774808,-2653289
1668834995,205358,true,1207428097,28,1204774808,-2653289
1668835019,205357,true,1207548840,28,1204774808,-2774032
1668835079,205358,true,1207428097,28,1204774808,-2653289
1668835103,205357,true,1207548840,28,1204774808,-2774032
1668835115,205358,true,1207428097,28,1204774808,-2653289
1668835247,205357,true,1207548840,28,1204533889,-3014951
1668835283,205358,true,1207428097,28,1204413448,-3014649
1668836783,205358,true,1207428097,28,1200925883,-6502214
1668836999,205359,true,1207307367,28,1200685733,-6621634
1668837251,205359,true,1207307367,28,1200565677,-6741690
1668838271,205360,true,1207186648,28,1200565677,-6620971
1668838871,205360,true,1207186648,28,1200565677,-6620971
1668839039,205361,true,1207065941,28,1200565677,-6500264
1668839051,205361,true,1207065941,28,1200685733,-6380208
1668839087,205362,true,1206945247,28,1200685733,-6259514
1668839099,205361,true,1207065941,28,1200685733,-6380208
1668839243,205362,true,1206945247,28,1200805802,-6139445
1668840227,205362,true,1206945247,28,1201766783,-5178464
1668840863,205363,true,1206824564,28,1202488023,-4336541
1668841079,205363,true,1206824564,28,1202608272,-4216292
1668841247,205363,true,1206824564,28,1202848806,-3975758
1668841259,205363,true,1206824564,28,1202848806,-3975758
1668841379,205364,true,1206703894,28,1202969091,-3734803
1668842087,205363,true,1206824564,28,1203931803,-2892761
1668842219,205364,true,1206703894,28,1204052196,-2651698
1668842327,205364,true,1206703894,28,1204172601,-2531293
1668842663,205364,true,1206703894,28,1204895285,-1808609
1668842999,205364,true,1206703894,28,1205497854,-1206040
1668843347,205364,true,1206703894,28,1205980125,-723769
1668843611,205364,true,1206703894,28,1206462589,-241305
1668843671,205365,true,1206583236,28,1206462589,-120647
1668843863,205364,true,1206703894,28,1206703894,0
1668844031,205365,true,1206583236,28,1206945247,362011
1668844079,205365,true,1206583236,28,1206945247,362011
1668844091,205365,true,1206583236,28,1206945247,362011
1668844379,205365,true,1206583236,28,1207065941,482705
1668844595,205366,true,1206462589,28,1206945247,482658
1668844907,205366,true,1206462589,28,1206945247,482658
1668845423,205366,true,1206462589,28,1206824564,361975
1668845495,205366,true,1206462589,28,1206703894,241305
1668845735,205366,true,1206462589,28,1206703894,241305
1668846083,205366,true,1206462589,28,1206703894,241305
1668846155,205367,true,1206341955,28,1206703894,361939
1668847031,205367,true,1206341955,28,1206703894,361939
1668847091,205367,true,1206341955,28,1206703894,361939
1668847283,205367,true,1206341955,28,1206703894,361939
1668847979,205368,true,1206221333,28,1206703894,482561
1668848063,205367,true,1206341955,28,1206824564,482609
1668848303,205368,true,1206221333,28,1206824564,603231
1668850079,205368,true,1206221333,28,1207307367,1086034
1668850475,205368,true,1206221333,28,1207307367,1086034
1668851015,205368,true,1206221333,28,1207307367,1086034
1668851267,205368,true,1206221333,28,1207307367,1086034
1668851819,205368,true,1206221333,28,1207307367,1086034
1668852383,205368,true,1206221333,28,1207307367,1086034
1668852551,205368,true,1206221333,28,1207307367,1086034
1668853595,205368,true,1206221333,28,1207307367,1086034
1668857303,205368,true,1206221333,28,1207307367,1086034
1668858215,205369,true,1206100723,28,1207307367,1206644
1668858275,205368,true,1206221333,28,1207307367,1086034
1668860207,205368,true,1206221333,28,1207307367,1086034
1668860711,205368,true,1206221333,28,1207307367,1086034
1668860783,205369,true,1206100723,28,1207307367,1206644
1668863183,205368,true,1206221333,28,1207186648,965315
1668863291,205369,true,1206100723,28,1207186648,1085925
1668863831,205369,true,1206100723,28,1207186648,1085925
1668863951,205369,true,1206100723,28,1207186648,1085925
1668864107,205369,true,1206100723,28,1207186648,1085925
1668864443,205369,true,1206100723,28,1207186648,1085925
1668864455,205370,true,1205980125,28,1207186648,1206523
1668864647,205370,true,1205980125,28,1207186648,1206523
1668866183,205370,true,1205980125,28,1207186648,1206523
1668866507,205370,true,1205980125,28,1207186648,1206523
1668866855,205370,true,1205980125,28,1207186648,1206523
1668868223,205371,true,1205859539,28,1207186648,1327109
1668869327,205371,true,1205859539,28,1207186648,1327109
1668869843,205371,true,1205859539,28,1207186648,1327109
1668870347,205371,true,1205859539,28,1207186648,1327109
1668870983,205372,true,1205738965,28,1207186648,1447683
1668871403,205372,true,1205738965,28,1207186648,1447683
1668871739,205372,true,1205738965,28,1207186648,1447683
1668872219,205372,true,1205738965,28,1207186648,1447683
1668872507,205373,true,1205618403,28,1207186648,1568245
1668872759,205372,true,1205738965,28,1207186648,1447683
1668873143,205373,true,1205618403,28,1207186648,1568245
1668873491,205373,true,1205618403,28,1207186648,1568245
1668874463,205373,true,1205618403,28,1207186648,1568245
1668874667,205373,true,1205618403,28,1207186648,1568245
1668874679,205372,true,1205738965,28,1207186648,1447683
1668874811,205373,true,1205618403,28,1207186648,1568245
1668875099,205373,true,1205618403,28,1207186648,1568245
1668875903,205372,true,1205738965,28,1207186648,1447683
1668876071,205372,true,1205738965,28,1207186648,1447683
1668876107,205372,true,1205738965,28,1207186648,1447683
1668877199,205372,true,1205738965,28,1207186648,1447683
1668877211,205372,true,1205738965,28,1207186648,1447683
1668877283,205371,true,1205859539,28,1207186648,1327109
1668877295,205371,true,1205859539,28,1207186648,1327109
1668877859,205371,true,1205859539,28,1207186648,1327109
1668878207,205371,true,1205859539,28,1207186648,1327109
1668879095,205370,true,1205980125,28,1207186648,1206523
1668879551,205371,true,1205859539,28,1207186648,1327109
1668879923,205371,true,1205859539,28,1207186648,1327109
1668880067,205370,true,1205980125,28,1207186648,1206523
1668880223,205370,true,1205980125,28,1207186648,1206523
1668880763,205370,true,1205980125,28,1207186648,1206523
1668881687,205370,true,1205980125,28,1207186648,1206523
1668882587,205369,true,1206100723,28,1207186648,1085925
1668883571,205369,true,1206100723,28,1207186648,1085925
1668884087,205369,true,1206100723,28,1207186648,1085925
1668884231,205369,true,1206100723,28,1207186648,1085925
1668884555,205369,true,1206100723,28,1207186648,1085925
1668884579,205368,true,1206221333,28,1207186648,965315
1668884687,205369,true,1206100723,28,1207186648,1085925
1668884915,205368,true,1206221333,28,1207186648,965315
1668884939,205368,true,1206221333,28,1207186648,965315
1668885131,205368,true,1206221333,28,1207186648,965315
1668885323,205367,true,1206341955,28,1207186648,844693
1668886631,205367,true,1206341955,28,1207186648,844693
1668886883,205366,true,1206462589,28,1207186648,724059
1668887111,205366,true,1206462589,28,1207186648,724059
1668890267,205365,true,1206583236,28,1207186648,603412
1668890735,205365,true,1206583236,28,1207186648,603412
1668890915,205364,true,1206703894,28,1207186648,482754
1668891263,205364,true,1206703894,28,1207186648,482754
1668891287,205363,true,1206824564,28,1207186648,362084
1668891599,205363,true,1206824564,28,1207186648,362084
1668891659,205362,true,1206945247,28,1207186648,241401
1668891803,205362,true,1206945247,28,1207186648,241401
1668891935,205362,true,1206945247,28,1207186648,241401
1668891983,205361,true,1207065941,28,1207186648,120707
1668892079,205361,true,1207065941,28,1207186648,120707
1668893435,205361,true,1207065941,28,1207186648,120707
1668893879,205361,true,1207065941,28,1207186648,120707
1668894119,205361,true,1207065941,28,1207186648,120707
1668894191,205360,true,1207186648,28,1207186648,0
1668894203,205360,true,1207186648,28,1207186648,0
1668894491,205360,true,1207186648,28,1207186648,0
1668894575,205360,true,1207186648,28,1207186648,0
1668894683,205360,true,1207186648,28,1207186648,0
1668894959,205360,true,1207186648,28,1207186648,0
1668895067,205360,true,1207186648,28,1207186648,0
1668895079,205360,true,1207186648,28,1207186648,0
1668895235,205360,true,1207186648,28,1207307367,120719
1668895247,205360,true,1207186648,28,1207307367,120719
1668895343,205359,true,1207307367,28,1207548840,241473
1668895355,205359,true,1207307367,28,1207669595,362228
1668895487,205358,true,1207428097,28,1208031932,603835
1668895559,205358,true,1207428097,28,1208273551,845454
1668895595,205357,true,1207548840,28,1208394378,845538
1668895907,205357,true,1207548840,28,1209482368,1933528
1668895919,205356,true,1207669595,28,1209482368,1812773
1668896003,205356,true,1207669595,28,1209966234,2296639
1668896111,205355,true,1207790362,28,1210571338,2780976
1668896135,205354,true,1207911141,28,1210692395,2781254
1668896159,205353,true,1208031932,28,1210813464,2781532
1668896183,205353,true,1208031932,28,1210934545,2902613
1668896387,205351,true,1208273551,28,1212388466,4114915
1668896555,205350,true,1208394378,28,1213601401,5207023
1668896567,205349,true,1208515217,28,1213601401,5086184
1668896699,205349,true,1208515217,28,1214694079,6178862
1668896867,205347,true,1208756933,28,1216152514,7395581
1668897047,205346,true,1208877808,28,1217978020,9100212
1668897191,205344,true,1209119596,28,1219074639,9955043
1668897899,205343,true,1209240508,28,1223838074,14597566
1668898115,205342,true,1209361432,28,1224572561,15211129
1668898715,205340,true,1209603316,28,1225797685,16194369
1668899039,205339,true,1209724277,28,1225675117,15950840
1668899135,205338,true,1209845249,28,1225552562,15707313
1668899219,205336,true,1210087230,28,1225552562,15465332
1668899603,205335,true,1210208239,28,1225307488,15099249
1668899759,205334,true,1210329260,28,1225307488,14978228
1668899987,205333,true,1210450293,28,1225184970,14734677
1668900239,205331,true,1210692395,28,1225184970,14492575
1668900263,205330,true,1210813464,28,1225184970,14371506
1668900275,205328,true,1211055639,28,1225184970,14129331
1668900287,205327,true,1211176744,28,1225184970,14008226
1668900467,205326,true,1211297862,28,1225184970,13887108
1668900491,205325,true,1211418992,28,1225062463,13643471
1668900575,205323,true,1211661288,28,1225062463,13401175
1668900851,205322,true,1211782454,28,1224817488,13035034
1668900875,205321,true,1211903632,28,1224695018,12791386
1668900887,205320,true,1212024823,28,1224695018,12670195
1668900899,205319,true,1212146025,28,1224695018,12548993
1668900947,205318,true,1212267240,28,1224572561,12305321
1668900983,205317,true,1212388466,28,1224450116,12061650
1668901079,205316,true,1212509705,28,1224205262,11695557
1668901103,205315,true,1212630956,28,1224082854,11451898
1668901403,205315,true,1212630956,28,1223104028,10473072
1668901571,205314,true,1212752219,28,1222492660,9740441
1668901655,205312,true,1212994782,28,1222248198,9253416
1668902183,205311,true,1213116081,28,1220538333,7422252
1668903287,205311,true,1213116081,28,1219074639,5958558
1668903515,205310,true,1213237393,28,1219074639,5837246
1668906107,205309,true,1213358717,28,1219074639,5715922
1668906131,205308,true,1213480053,28,1219196546,5716493
1668906155,205308,true,1213480053,28,1219196546,5716493
1668906191,205307,true,1213601401,28,1219196546,5595145
1668906731,205305,true,1213844133,28,1219928247,6084114
1668907151,205304,true,1213965517,28,1220538333,6572816
1668907235,205303,true,1214086914,28,1220660387,6573473
1668907271,205302,true,1214208323,28,1220660387,6452064
1668907391,205300,true,1214451176,28,1220782453,6331277
1668907427,205299,true,1214572622,28,1220904531,6331909
1668907583,205299,true,1214572622,28,1221026622,6454000
1668908411,205298,true,1214694079,28,1221026622,6332543
1668908567,205297,true,1214815548,28,1221026622,6211074
1668909215,205295,true,1215058523,28,1220660387,5601864
1668909311,205295,true,1215058523,28,1220660387,5601864
1668909491,205294,true,1215180029,28,1220660387,5480358
1668909731,205293,true,1215301547,28,1220660387,5358840
1668909755,205292,true,1215423077,28,1220660387,5237310
1668909911,205291,true,1215544620,28,1220660387,5115767
1668910283,205291,true,1215544620,28,1220538333,4993713
1668910799,205289,true,1215787741,28,1220294262,4506521
1668910823,205288,true,1215909320,28,1220172245,4262925
1668911951,205288,true,1215909320,28,1219928247,4018927
1668912203,205287,true,1216030911,28,1219806266,3775355
1668912743,205285,true,1216274129,28,1219806266,3532137
1668913223,205284,true,1216395756,28,1219806266,3410510
1668913631,205284,true,1216395756,28,1219806266,3410510
1668913907,205283,true,1216517396,28,1219806266,3288870
1668914447,205281,true,1216760712,28,1219806266,3045554
1668914723,205280,true,1216882388,28,1219806266,2923878
1668915167,205280,true,1216882388,28,1219440398,2558010
1668916223,205280,true,1216882388,28,1218587131,1704743
1668916859,205278,true,1217125776,28,1218221628,1095852
1668916919,205277,true,1217247489,28,1218221628,974139
1668918551,205277,true,1217247489,28,1218221628,974139
1668918683,205276,true,1217369214,28,1218221628,852414
1668919751,205275,true,1217490951,28,1218221628,730677
1668919907,205274,true,1217612700,28,1218221628,608928
1668920879,205274,true,1217612700,28,1218221628,608928
1668921359,205273,true,1217734461,28,1218221628,487167
1668922067,205272,true,1217856234,28,1218221628,365394
1668922079,205271,true,1217978020,28,1218221628,243608
1668922127,205271,true,1217978020,28,1218221628,243608
1668922295,205270,true,1218099818,28,1218221628,121810
1668922643,205268,true,1218343450,28,1218221628,-121822
1668922715,205267,true,1218465284,28,1218221628,-243656
1668923315,205267,true,1218465284,28,1218221628,-243656
1668923699,205267,true,1218465284,28,1218221628,-243656
1668924503,205265,true,1218708989,28,1218221628,-487361
1668925271,205264,true,1218830860,28,1218221628,-609232
1668925775,205264,true,1218830860,28,1218221628,-609232
1668926075,205263,true,1218952743,28,1218221628,-731115
1668926195,205262,true,1219074639,28,1218221628,-853011
1668926375,205261,true,1219196546,28,1218221628,-974918
1668926735,205261,true,1219196546,28,1218221628,-974918
1668927311,205260,true,1219318466,28,1218221628,-1096838
1668927455,205259,true,1219440398,28,1218221628,-1218770
1668927707,205258,true,1219562342,28,1218221628,-1340714
1668927731,205258,true,1219562342,28,1218221628,-1340714
1668927983,205257,true,1219684298,28,1218221628,-1462670
1668928175,205255,true,1219928247,28,1218221628,-1706619
1668928271,205254,true,1220050240,28,1218221628,-1828612
1668928427,205255,true,1219928247,28,1218221628,-1706619
1668928511,205254,true,1220050240,28,1218221628,-1828612
1668928799,205253,true,1220172245,28,1218221628,-1950617
1668928823,205253,true,1220172245,28,1218221628,-1950617
1668928955,205253,true,1220172245,28,1218221628,-1950617
1668929135,205253,true,1220172245,28,1218221628,-1950617
1668929291,205251,true,1220416292,28,1218221628,-2194664
1668929387,205251,true,1220416292,28,1218221628,-2194664
1668930239,205252,true,1220294262,28,1218221628,-2072634
1668930431,205252,true,1220294262,28,1218221628,-2072634
1668930443,205251,true,1220416292,28,1218221628,-2194664
1668930503,205251,true,1220416292,28,1218221628,-2194664
1668930851,205252,true,1220294262,28,1218221628,-2072634
1668931211,205252,true,1220294262,28,1218221628,-2072634
1668931235,205251,true,1220416292,28,1218221628,-2194664
1668931763,205251,true,1220416292,28,1218221628,-2194664
1668932735,205252,true,1220294262,28,1218221628,-2072634
1668933491,205253,true,1220172245,28,1218221628,-1950617
1668933623,205253,true,1220172245,28,1218221628,-1950617
1668933635,205253,true,1220172245,28,1218221628,-1950617
1668933647,205254,true,1220050240,28,1218221628,-1828612
1668933659,205256,true,1219806266,28,1218221628,-1584638
1668933671,205256,true,1219806266,28,1218099818,-1706448
1668933743,205258,true,1219562342,28,1217734461,-1827881
1668934331,205260,true,1219318466,28,1214208323,-5110143
1668934499,205261,true,1219196546,28,1213237393,-5959153
1668934631,205262,true,1219074639,28,1212267240,-6807399
1668935255,205263,true,1218952743,28,1208031932,-10920811
1668935495,205265,true,1218708989,28,1206583236,-12125753
1668935627,205266,true,1218587131,28,1206462589,-12124542
1668936335,205267,true,1218465284,28,1206341955,-12123329
1668936731,205269,true,1218221628,28,1206583236,-11638392
1668937079,205271,true,1217978020,28,1206824564,-11153456
1668937235,205271,true,1217978020,28,1206945247,-11032773
1668937499,205272,true,1217856234,28,1206945247,-10910987
1668937871,205274,true,1217612700,28,1206945247,-10667453
1668938231,205276,true,1217369214,28,1206945247,-10423967
1668938471,205276,true,1217369214,28,1206945247,-10423967
1668938903,205277,true,1217247489,28,1206945247,-10302242
1668939107,205279,true,1217004076,28,1206945247,-10058829
1668939551,205280,true,1216882388,28,1206945247,-9937141
1668940391,205280,true,1216882388,28,1206945247,-9937141
1668940703,205281,true,1216760712,28,1206945247,-9815465
1668940739,205283,true,1216517396,28,1206945247,-9572149
1668940763,205284,true,1216395756,28,1206945247,-9450509
1668940799,205284,true,1216395756,28,1206945247,-9450509
1668940955,205285,true,1216274129,28,1206824564,-9449565
1668940967,205287,true,1216030911,28,1206824564,-9206347
1668941027,205288,true,1215909320,28,1206703894,-9205426
1668941039,205288,true,1215909320,28,1206703894,-9205426
1668941051,205290,true,1215666174,28,1206583236,-9082938
1668941063,205292,true,1215423077,28,1206583236,-8839841
1668941075,205293,true,1215301547,28,1206583236,-8718311
1668941195,205295,true,1215058523,28,1205738965,-9319558
1668941507,205298,true,1214694079,28,1203450350,-11243729
1668941651,205300,true,1214451176,28,1202488023,-11963153
1668942251,205301,true,1214329743,28,1198286882,-16042861
1668942755,205303,true,1214086914,28,1194817057,-19269857
1668942815,205306,true,1213722761,28,1194458683,-19264078
1668943139,205307,true,1213601401,28,1194339249,-19262152
1668943187,205309,true,1213358717,28,1194339249,-19019468
1668943199,205311,true,1213116081,28,1194339249,-18776832
1668943259,205314,true,1212752219,28,1194100417,-18651802
1668943307,205316,true,1212509705,28,1193981019,-18528686
1668943607,205319,true,1212146025,28,1192906973,-19239052
1668943691,205321,true,1211903632,28,1192668428,-19235204
1668943895,205324,true,1211540134,28,1191833894,-19706240
1668943907,205326,true,1211297862,28,1191833894,-19463968
1668943943,205329,true,1210934545,28,1191595563,-19338982
1668944027,205332,true,1210571338,28,1190642715,-19928623
1668944075,205336,true,1210087230,28,1190166577,-19920653
1668944087,205339,true,1209724277,28,1190047572,-19676705
1668944135,205343,true,1209240508,28,1189214872,-20025636
1668944159,205347,true,1208756933,28,1188858179,-19898754
1668944207,205353,true,1208031932,28,1188026311,-20005621
1668944279,205356,true,1207669595,28,1186838938,-20830657
1668944291,205359,true,1207307367,28,1186601606,-20705761
1668944471,205363,true,1206824564,28,1183757319,-23067245
1668944495,205369,true,1206100723,28,1183402262,-22698461
1668944519,205372,true,1205738965,28,1183047313,-22691652
1668944939,205375,true,1205377316,28,1176676393,-28700923
1668945011,205378,true,1205015775,28,1175735475,-29280300
1668945035,205384,true,1204293018,28,1175500363,-28792655
1668945131,205387,true,1203931803,28,1174560386,-29371417
1668945419,205389,true,1203691053,28,1171744962,-31946091
1668945503,205393,true,1203209696,28,1170925068,-32284628
1668945575,205399,true,1202488023,28,1170105748,-32382275
1668945611,205401,true,1202247562,28,1169754787,-32492775
1668945623,205404,true,1201886960,28,1169637823,-32249137
1668945635,205407,true,1201526466,28,1169520871,-32005595
1668945659,205413,true,1200805802,28,1169287002,-31518800
1668945671,205417,true,1200325600,28,1169053180,-31272420
1668945683,205420,true,1199965574,28,1168936286,-31029288
1668945827,205425,true,1199365771,28,1167417732,-31948039
1668945935,205431,true,1198646404,28,1166834198,-31812206
1668945983,205434,true,1198286882,28,1166834198,-31452684
1668946115,205437,true,1197927467,28,1166600866,-31326601
1668946127,205442,true,1197328683,28,1166600866,-30727817
1668946271,205447,true,1196730198,28,1166367581,-30362617
1668946319,205451,true,1196251626,28,1166250956,-30000670
1668946355,205454,true,1195892822,28,1166134343,-29758479
1668946475,205458,true,1195414585,28,1165784572,-29630013
1668946703,205464,true,1194697587,28,1165085346,-29612241
1668946715,205468,true,1194219827,28,1165085346,-29134481
1668946823,205471,true,1193861633,28,1164619429,-29242204
1668946847,205475,true,1193384208,28,1164502978,-28881230
1668947027,205481,true,1192668428,28,1163688152,-28980276
1668947039,205484,true,1192310699,28,1163571795,-28738904
1668947291,205487,true,1191953077,28,1162873896,-29079181
1668947315,205492,true,1191357279,28,1162873896,-28483383
1668947579,205497,true,1190761779,28,1162873896,-27887883
1668947675,205500,true,1190404622,28,1163222793,-27181829
1668947747,205503,true,1190047572,28,1163339116,-26708456
1668947975,205507,true,1189571672,28,1163920901,-25650771
1668948419,205512,true,1188977065,28,1165434907,-23542158
1668948599,205515,true,1188620443,28,1166134343,-22486100
1668948827,205518,true,1188263928,28,1166950882,-21313046
1668948863,205522,true,1187788741,28,1167067577,-20721164
1668949055,205527,true,1187195025,28,1167417732,-19777293
1668949115,205530,true,1186838938,28,1167534474,-19304464
1668949127,205533,true,1186482957,28,1167417732,-19065225
1668949247,205538,true,1185889894,28,1167301002,-18588892
1668949259,205544,true,1185178609,28,1167301002,-17877607
1668949307,205547,true,1184823126,28,1167184283,-17638843
1668949355,205550,true,1184467751,28,1167067577,-17400174
1668949367,205555,true,1183875694,28,1167067577,-16808117
1668949391,205560,true,1183283934,28,1167067577,-16216357
1668949403,205564,true,1182810739,28,1166950882,-15859857
1668949415,205566,true,1182574212,28,1166950882,-15623330
1668949427,205571,true,1181983102,28,1166950882,-15032220
1668949667,205577,true,1181274161,28,1166600866,-14673295
1668949679,205580,true,1180919849,28,1166484218,-14435631
1668949739,205583,true,1180565644,28,1166484218,-14081426
1668949835,205587,true,1180093536,28,1166250956,-13842580
1668949871,205592,true,1179503666,28,1166250956,-13252710
1668949895,205594,true,1179267801,28,1166134343,-13133458
1668949907,205596,true,1179031983,28,1166134343,-12897640
1668949979,205600,true,1178560488,28,1166017741,-12542747
1668950099,205604,true,1178089181,28,1165901151,-12188030
1668950279,205606,true,1177853599,28,1165784572,-12069027
1668950291,205608,true,1177618063,28,1165784572,-11833491
1668950303,205612,true,1177147134,28,1165784572,-11362562
1668950315,205616,true,1176676393,28,1165784572,-10891821
1668950531,205616,true,1176676393,28,1166367581,-10308812
1668950927,205618,true,1176441093,28,1167417732,-9023361
1668950975,205622,true,1175970634,28,1167651227,-8319407
1668950999,205626,true,1175500363,28,1167767992,-7732371
1668951167,205627,true,1175382825,28,1168819404,-6563421
1668951179,205628,true,1175265298,28,1168819404,-6445894
1668951251,205632,true,1174795310,28,1169170085,-5625225
1668951611,205636,true,1174325509,28,1170690918,-3634591
1668951767,205637,true,1174208088,28,1171276381,-2931707
1668951887,205639,true,1173973282,28,1171627799,-2345483
1668952283,205643,true,1173503810,28,1171862136,-1641674
1668952391,205647,true,1173034526,28,1171862136,-1172390
1668952559,205648,true,1172917234,28,1171744962,-1172272
1668952679,205649,true,1172799954,28,1171627799,-1172155
1668952943,205654,true,1172213730,28,1171510648,-703082
1668952979,205657,true,1171862136,28,1171510648,-351488
1668953111,205658,true,1171744962,28,1171510648,-234314
1668953159,205659,true,1171627799,28,1171627799,0
1668953219,205663,true,1171159265,28,1171627799,468534
1668953243,205667,true,1170690918,28,1171627799,936881
1668953435,205667,true,1170690918,28,1171744962,1054044
1668953471,205668,true,1170573861,28,1171744962,1171101
1668953543,205670,true,1170339781,28,1171862136,1522355
1668953699,205673,true,1169988750,28,1172213730,2224980
1668953759,205673,true,1169988750,28,1172330951,2342201
1668955079,205673,true,1169988750,28,1174912789,4924039
1668955151,205676,true,1169637823,28,1175030281,5392458
1668955271,205679,true,1169287002,28,1175147784,5860782
1668955283,205679,true,1169287002,28,1175147784,5860782
1668955415,205679,true,1169287002,28,1175147784,5860782
1668956447,205682,true,1168936286,28,1173973282,5036996
1668956483,205685,true,1168585675,28,1173855896,5270221
1668956603,205684,true,1168702534,28,1173738522,5035988
1668956867,205684,true,1168702534,28,1173386471,4683937
1668957347,205687,true,1168351993,28,1173034526,4682533
1668957371,205689,true,1168118358,28,1173151829,5033471
1668957887,205688,true,1168235170,28,1173151829,4916659
1668958667,205688,true,1168235170,28,1173269144,5033974
1668959075,205690,true,1168001558,28,1173386471,5384913
1668959183,205690,true,1168001558,28,1173503810,5502252
1668960167,205689,true,1168118358,28,1173973282,5854924
1668960383,205688,true,1168235170,28,1174090679,5855509
1668960431,205689,true,1168118358,28,1174090679,5972321
1668961007,205688,true,1168235170,28,1174560386,6325216
1668961307,205686,true,1168468828,28,1174677842,6209014
1668961331,205684,true,1168702534,28,1174677842,5975308
1668961391,205686,true,1168468828,28,1174677842,6209014
1668962147,205685,true,1168585675,28,1174090679,5505004
1668962615,205684,true,1168702534,28,1173621160,4918626
1668962663,205683,true,1168819404,28,1173503810,4684406
1668962711,205684,true,1168702534,28,1173503810,4801276
1668962795,205683,true,1168819404,28,1173386471,4567067
1668962855,205682,true,1168936286,28,1173269144,4332858
1668962999,205682,true,1168936286,28,1173034526,4098240
1668963023,205683,true,1168819404,28,1173034526,4215122
1668963107,205683,true,1168819404,28,1172917234,4097830
1668963587,205682,true,1168936286,28,1172682686,3746400
1668964259,205681,true,1169053180,28,1172448184,3395004
1668964487,205682,true,1168936286,28,1172330951,3394665
1668964643,205682,true,1168936286,28,1172330951,3394665
1668965999,205680,true,1169170085,28,1172213730,3043645
1668967355,205679,true,1169287002,28,1172330951,3043949
1668967475,205679,true,1169287002,28,1172330951,3043949
1668967487,205678,true,1169403931,28,1172330951,2927020
1668967511,205677,true,1169520871,28,1172330951,2810080
1668967775,205675,true,1169754787,28,1172330951,2576164
1668968111,205676,true,1169637823,28,1172330951,2693128
1668968555,205675,true,1169754787,28,1172330951,2576164
1668969131,205674,true,1169871762,28,1172330951,2459189
1668969227,205672,true,1170105748,28,1172330951,2225203
1668969371,205673,true,1169988750,28,1172448184,2459434
1668969515,205672,true,1170105748,28,1172448184,2342436
1668969971,205670,true,1170339781,28,1172448184,2108403
1668970583,205669,true,1170456815,28,1172565429,2108614
1668970787,205669,true,1170456815,28,1172565429,2108614
1668970883,205668,true,1170573861,28,1172682686,2108825
1668970991,205667,true,1170690918,28,1172682686,1991768
1668971195,205666,true,1170807987,28,1172799954,1991967
1668971279,205666,true,1170807987,28,1172917234,2109247
1668971411,205666,true,1170807987,28,1172917234,2109247
1668971471,205664,true,1171042161,28,1173034526,1992365
1668971651,205664,true,1171042161,28,1173151829,2109668
1668974027,205664,true,1171042161,28,1173973282,2931121
1668974099,205664,true,1171042161,28,1173973282,2931121
1668974111,205662,true,1171276381,28,1174090679,2814298
1668974123,205662,true,1171276381,28,1174090679,2814298
1668974135,205662,true,1171276381,28,1174090679,2814298
1668974159,205661,true,1171393508,28,1174208088,2814580
1668974183,205659,true,1171627799,28,1174325509,2697710
1668974195,205658,true,1171744962,28,1174325509,2580547
1668974591,205657,true,1171862136,28,1176205840,4343704
1668974783,205655,true,1172096520,28,1177029431,4932911
1668974831,205653,true,1172330951,28,1177264849,4933898
1668975383,205652,true,1172448184,28,1179857553,7409369
1668975599,205651,true,1172565429,28,1180801769,8236340
1668975695,205649,true,1172799954,28,1181274161,8474207
1668975755,205647,true,1173034526,28,1181510427,8475901
1668975791,205646,true,1173151829,28,1181628578,8476749
1668975803,205645,true,1173269144,28,1181746741,8477597
1668975827,205644,true,1173386471,28,1181746741,8360270
1668976031,205642,true,1173621160,28,1181628578,8007418
1668976139,205641,true,1173738522,28,1181274161,7535639
1668976151,205641,true,1173738522,28,1181274161,7535639
1668976175,205640,true,1173855896,28,1181156045,7300149
1668976187,205638,true,1174090679,28,1181156045,7065366
1668976235,205638,true,1174090679,28,1180919849,6829170
1668976283,205638,true,1174090679,28,1180801769,6711090
1668976523,205637,true,1174208088,28,1179739579,5531491
1668976895,205636,true,1174325509,28,1178324811,3999302
1668976907,205635,true,1174442942,28,1178206990,3764048
1668976991,205635,true,1174442942,28,1177971384,3528442
1668977687,205635,true,1174442942,28,1175382825,939883
1668977939,205635,true,1174442942,28,1175147784,704842
1668978047,205635,true,1174442942,28,1175030281,587339
1668979259,205635,true,1174442942,28,1175030281,587339
1668979619,205634,true,1174560386,28,1175030281,469895
1668979751,205634,true,1174560386,28,1175030281,469895
1668979883,205634,true,1174560386,28,1175030281,469895
1668979907,205634,true,1174560386,28,1174912789,352403
1668979943,205633,true,1174677842,28,1174912789,234947
1668979967,205633,true,1174677842,28,1174912789,234947
1668979979,205634,true,1174560386,28,1174912789,352403
1668979991,205634,true,1174560386,28,1174795310,234924
1668980159,205635,true,1174442942,28,1173855896,-587046
1668980315,205635,true,1174442942,28,1173034526,-1408416
1668980411,205635,true,1174442942,28,1172448184,-1994758
1668980759,205636,true,1174325509,28,1170573861,-3751648
1668980795,205637,true,1174208088,28,1170339781,-3868307
1668980831,205637,true,1174208088,28,1170105748,-4102340
1668980987,205638,true,1174090679,28,1169053180,-5037499
1668980999,205639,true,1173973282,28,1168936286,-5036996
1668981155,205640,true,1173855896,28,1167534474,-6321422
1668981191,205641,true,1173738522,28,1167067577,-6670945
1668981203,205642,true,1173621160,28,1166950882,-6670278
1668981215,205644,true,1173386471,28,1166717526,-6668945
1668981311,205648,true,1172917234,28,1165201855,-7715379
1668981371,205650,true,1172682686,28,1164037294,-8645392
1668981467,205652,true,1172448184,28,1162408863,-10039321
1668981479,205653,true,1172330951,28,1162176416,-10154535
1668981491,205658,true,1171744962,28,1162060210,-9684752
1668981539,205660,true,1171510648,28,1161130980,-10379668
1668981551,205662,true,1171276381,28,1160898789,-10377592
1668981695,205663,true,1171159265,28,1158231923,-12927342
1668981743,205668,true,1170573861,28,1157305754,-13268107
1668981767,205670,true,1170339781,28,1156842948,-13496833
1668981863,205672,true,1170105748,28,1155340104,-14765644
1668981887,205674,true,1169871762,28,1154993571,-14878191
1668981899,205679,true,1169287002,28,1154878083,-14408919
1668981911,205681,true,1169053180,28,1154762607,-14290573
1668981935,205682,true,1168936286,28,1154416248,-14520038
1668981959,205683,true,1168819404,28,1154069992,-14749412
1668981983,205688,true,1168235170,28,1153839213,-14395957
1668982055,205690,true,1168001558,28,1153031848,-14969710
1668982115,205692,true,1167767992,28,1152340271,-15427721
1668982187,205693,true,1167651227,28,1151533956,-16117271
1668982223,205697,true,1167184283,28,1151073457,-16110826
1668982235,205700,true,1166834198,28,1150958361,-15875837
1668982367,205700,true,1166834198,28,1149693066,-17141132
1668982535,205701,true,1166717526,28,1147969906,-18747620
1668982655,205706,true,1166134343,28,1146822567,-19311776
1668982679,205708,true,1165901151,28,1146593237,-19307914
1668982799,205709,true,1165784572,28,1145676375,-20108197
1668983039,205709,true,1165784572,28,1144531328,-21253244
1668983051,205714,true,1165201855,28,1144531328,-20670527
1668983063,205716,true,1164968849,28,1144531328,-20437521
1668983087,205716,true,1164968849,28,1144531328,-20437521
1668983111,205717,true,1164852364,28,1144645781,-20206583
1668983243,205721,true,1164386540,28,1144989209,-19397331
1668983567,205723,true,1164153697,28,1146478589,-17675108
1668983915,205723,true,1164153697,28,1147969906,-16183791
1668983939,205724,true,1164037294,28,1148084703,-15952591
1668984059,205728,true,1163571795,28,1148199511,-15372284
1668984071,205730,true,1163339116,28,1148084703,-15254413
1668984083,205731,true,1163222793,28,1148084703,-15138090
1668984107,205732,true,1163106483,28,1148084703,-15021780
1668984167,205736,true,1162641356,28,1147969906,-14671450
1668984191,205738,true,1162408863,28,1147969906,-14438957
1668984203,205740,true,1162176416,28,1147969906,-14206510
1668984215,205740,true,1162176416,28,1147855120,-14321296
1668984239,205746,true,1161479354,28,1147855120,-13624234
1668984635,205748,true,1161247093,28,1146363952,-14883141
1668984707,205750,true,1161014879,28,1146020112,-14994767
1668984935,205750,true,1161014879,28,1145103708,-15911171
1668985343,205756,true,1160318513,28,1143044478,-17274035
1668985559,205758,true,1160086484,28,1142016253,-18070231
1668985607,205760,true,1159854502,28,1141673716,-18180786
1668985619,205760,true,1159854502,28,1141673716,-18180786
1668985643,205766,true,1159158833,28,1141445416,-17713417
1668985667,205769,true,1158811155,28,1141331283,-17479872
1668985679,205771,true,1158579427,28,1141217161,-17362266
1668985775,205772,true,1158463581,28,1140532670,-17930911
1668985799,205778,true,1157768746,28,1140418628,-17350118
1668986003,205781,true,1157421485,28,1139164920,-18256565
1668986015,205783,true,1157190035,28,1139164920,-18025115
1668986039,205784,true,1157074328,28,1139164920,-17909408
1668986111,205789,true,1156495964,28,1139051015,-17444949
1668986579,205792,true,1156149085,28,1138481660,-17667425
1668986591,205794,true,1155917890,28,1138481660,-17436230
1668986879,205795,true,1155802309,28,1138140184,-17662125
1668986975,205802,true,1154993571,28,1138026382,-16967189
1668987071,205805,true,1154647142,28,1137912590,-16734552
1668987167,205807,true,1154416248,28,1137798810,-16617438
1668987455,205809,true,1154185399,28,1137571285,-16614114
1668988007,205816,true,1153377792,28,1138253998,-15123794
1668988259,205819,true,1153031848,28,1138253998,-14777850
1668988895,205821,true,1152801276,28,1138595509,-14205767
1668989027,205822,true,1152686008,28,1138595509,-14090499
1668989099,205829,true,1151879450,28,1138595509,-13283941
1668989243,205832,true,1151533956,28,1138481660,-13052296
1668989339,205835,true,1151188564,28,1138140184,-13048380
1668989531,205837,true,1150958361,28,1137343805,-13614556
1668989627,205844,true,1150153013,28,1137002670,-13150343
1668989831,205846,true,1149923016,28,1136320707,-13602309
1668989843,205849,true,1149578109,28,1136207086,-13371023
1668989879,205851,true,1149348227,28,1136093477,-13254750
1668989939,205858,true,1148544005,28,1135979879,-12564126
1668990407,205860,true,1148314331,28,1134731050,-13583281
1668990419,205862,true,1148084703,28,1134731050,-13353653
1668990671,205864,true,1147855120,28,1134050450,-13804670
1668990899,205870,true,1147166648,28,1133370258,-13796390
1668990983,205872,true,1146937249,28,1133256932,-13680317
1668990995,205875,true,1146593237,28,1133256932,-13336305
1668991655,205877,true,1146363952,28,1133483595,-12880357
1668991823,205883,true,1145676375,28,1133256932,-12419443
1668991919,205885,true,1145447274,28,1133256932,-12190342
1668991979,205888,true,1145103708,28,1133370258,-11733450
1668992075,205890,true,1144874722,28,1133483595,-11391127
1668992243,205896,true,1144188037,28,1133710303,-10477734
1668992255,205897,true,1144073630,28,1133710303,-10363327
1668992603,205900,true,1143730477,28,1134050450,-9680027
1668992723,205902,true,1143501765,28,1134163855,-9337910
1668992783,205907,true,1142930185,28,1134277271,-8652914
1668992795,205909,true,1142701634,28,1134277271,-8424363
1668992939,205911,true,1142473128,28,1134731050,-7742078
1668993179,205912,true,1142358892,28,1135412059,-6946833
1668993311,205916,true,1141902062,28,1135866292,-6035770
1668993815,205918,true,1141673716,28,1137116370,-4557346
1668994691,205920,true,1141445416,28,1137685042,-3760374
1668995207,205921,true,1141331283,28,1137457539,-3873744
1668995867,205925,true,1140874864,28,1137002670,-3872194
1668995891,205926,true,1140760788,28,1137002670,-3758118
1668995903,205928,true,1140532670,28,1137002670,-3530000
1668995915,205929,true,1140418628,28,1137002670,-3415958
1668995927,205933,true,1139962575,28,1136888981,-3073594
1668996023,205935,true,1139734617,28,1136547982,-3186635
1668996035,205936,true,1139620655,28,1136547982,-3072673
1668996071,205937,true,1139506704,28,1136320707,-3185997
1668996275,205939,true,1139278837,28,1135412059,-3866778
1668996299,205940,true,1139164920,28,1135298529,-3866391
1668996443,205941,true,1139051015,28,1134504138,-4546877
1668996455,205942,true,1138937121,28,1134504138,-4432983
1668996467,205943,true,1138823239,28,1134390699,-4432540
1668996539,205945,true,1138595509,28,1133937056,-4658453
1668996563,205946,true,1138481660,28,1133823674,-4657986
1668996575,205947,true,1138367824,28,1133710303,-4657521
1668996599,205948,true,1138253998,28,1133483595,-4770403
1668996623,205951,true,1137912590,28,1133256932,-4655658
1668996635,205952,true,1137798810,28,1133143618,-4655192
1668996695,205953,true,1137685042,28,1132463969,-5221073
1668996719,205955,true,1137457539,28,1132124298,-5333241
1668996863,205958,true,1137116370,28,1130427470,-6688900
1668997103,205960,true,1136888981,28,1127717832,-9171149
1668997151,205962,true,1136661637,28,1127154142,-9507495
1668997175,205964,true,1136434339,28,1126816064,-9618275
1668997319,205967,true,1136093477,28,1125239704,-10853773
1668997331,205969,true,1135866292,28,1125127191,-10739101
1668997343,205971,true,1135639153,28,1124902199,-10736954
1668997379,205973,true,1135412059,28,1124564796,-10847263
1668997439,205976,true,1135071504,28,1123777915,-11293589
1668997463,205979,true,1134731050,28,1123553194,-11177856
1668997475,205981,true,1134504138,28,1123328517,-11175621
1668997499,205983,true,1134277271,28,1123103885,-11173386
1668997511,205987,true,1133823674,28,1122991585,-10832089
1668997607,205989,true,1133596943,28,1121757036,-11839907
1668997703,205991,true,1133370258,28,1120523843,-12846415
1668997751,205994,true,1133030315,28,1120075745,-12954570
1668998003,205997,true,1132690474,28,1117949728,-14740746
1668998075,206000,true,1132350734,28,1117279193,-15071541
1668998087,206002,true,1132124298,28,1117279193,-14845105
1668998099,206005,true,1131784729,28,1117167476,-14617253
1668998123,206008,true,1131445261,28,1116944076,-14501185
1668998147,206011,true,1131105896,28,1116720721,-14385175
1668998159,206013,true,1130879708,28,1116720721,-14158987
1668998171,206015,true,1130653566,28,1116609060,-14044506
1668998207,206018,true,1130314438,28,1116385772,-13928666
1668998219,206020,true,1130088409,28,1116274144,-13814265
1668998315,206022,true,1129862425,28,1115827746,-14034679
1668998411,206024,true,1129636487,28,1115604614,-14031873
1668998483,206026,true,1129410593,28,1115716175,-13694418
1668998507,206028,true,1129184745,28,1115716175,-13468570
1668998651,206030,true,1128958942,28,1116050923,-12908019
1668998675,206031,true,1128846057,28,1116162528,-12683529
1668998867,206033,true,1128620322,28,1116497410,-12122912
1668999083,206035,true,1128394632,28,1116832393,-11562239
1668999191,206036,true,1128281804,28,1117055771,-11226033
1668999263,206037,true,1128168987,28,1117279193,-10889794
1668999395,206039,true,1127943387,28,1117614410,-10328977
1668999599,206041,true,1127717832,28,1118285147,-9432685
1668999731,206043,true,1127492322,28,1118620666,-8871656
1668999743,206044,true,1127379584,28,1118732528,-8647056
1668999803,206045,true,1127266858,28,1118844401,-8422457
1668999815,206047,true,1127041438,28,1118956285,-8085153
1668999827,206048,true,1126928745,28,1118956285,-7972460
1669000103,206048,true,1126928745,28,1120075745,-6853000
1669000307,206049,true,1126816064,28,1120523843,-6292221
1669000379,206050,true,1126703393,28,1120747959,-5955434
1669000415,206051,true,1126590734,28,1120860034,-5730700
1669000535,206052,true,1126478086,28,1121084217,-5393869
1669000559,206054,true,1126252825,28,1121196325,-5056500
1669000595,206055,true,1126140210,28,1121196325,-4943885
1669000607,206056,true,1126027608,28,1121308445,-4719163
1669000619,206057,true,1125915016,28,1121308445,-4606571
1669000703,206059,true,1125689867,28,1121420576,-4269291
1669000715,206060,true,1125577309,28,1121420576,-4156733
1669000775,206062,true,1125352228,28,1121420576,-3931652
1669000799,206062,true,1125352228,28,1121420576,-3931652
1669001003,206065,true,1125014689,28,1121308445,-3706244
1669001039,206067,true,1124789720,28,1121196325,-3593395
1669001075,206068,true,1124677252,28,1121084217,-3593035
1669001111,206069,true,1124564796,28,1121084217,-3480579
1669001123,206072,true,1124227494,28,1121084217,-3143277
1669001459,206074,true,1124002682,28,1119851764,-4150918
1669001471,206075,true,1123890293,28,1119851764,-4038529
1669001507,206075,true,1123890293,28,1119739790,-4150503
1669001567,206078,true,1123553194,28,1119515875,-4037319
1669001627,206080,true,1123328517,28,1119292006,-4036511
1669001651,206080,true,1123328517,28,1119180088,-4148429
1669001699,206081,true,1123216195,28,1118956285,-4259910
1669001855,206084,true,1122879298,28,1118285147,-4594151
1669002011,206085,true,1122767021,28,1117614410,-5152611
1669002047,206086,true,1122654755,28,1117390921,-5263834
1669002107,206087,true,1122542501,28,1117167476,-5375025
1669002623,206089,true,1122318026,28,1115827746,-6490280
1669002743,206091,true,1122093596,28,1115827746,-6265850
1669002779,206091,true,1122093596,28,1115827746,-6265850
1669002791,206092,true,1121981398,28,1115827746,-6153652
1669002803,206094,true,1121757036,28,1115827746,-5929290
1669002827,206095,true,1121644871,28,1115827746,-5817125
1669002839,206096,true,1121532718,28,1115827746,-5704972
1669003127,206096,true,1121532718,28,1116944076,-4588642
1669003295,206099,true,1121196325,28,1117614410,-3581915
1669003367,206100,true,1121084217,28,1117949728,-3134489
1669003379,206101,true,1120972120,28,1117949728,-3022392
1669003403,206101,true,1120972120,28,1118173329,-2798791
1669003415,206103,true,1120747959,28,1118285147,-2462812
1669003535,206102,true,1120860034,28,1119403935,-1456099
1669003547,206103,true,1120747959,28,1119515875,-1232084
1669003619,206103,true,1120747959,28,1120075745,-672214
1669003787,206105,true,1120523843,28,1121532718,1008875
1669004123,206104,true,1120635895,28,1124115083,3479188
1669004303,206105,true,1120523843,28,1125577309,5053466
1669005083,206105,true,1120523843,28,1131445261,10921418
1669005371,206106,true,1120411802,28,1132011097,11599295
1669005587,206106,true,1120411802,28,1132124298,11712496
1669005659,206106,true,1120411802,28,1132124298,11712496
1669005731,206106,true,1120411802,28,1132124298,11712496
1669005779,206107,true,1120299772,28,1132011097,11711325
1669005827,206106,true,1120411802,28,1132011097,11599295
1669006031,206106,true,1120411802,28,1131784729,11372927
1669006319,206106,true,1120411802,28,1131332128,10920326
1669006367,206106,true,1120411802,28,1131219006,10807204
1669006763,206106,true,1120411802,28,1130540512,10128710
1669007255,206106,true,1120411802,28,1129862425,9450623
1669007387,206105,true,1120523843,28,1129749450,9225607
1669007471,206106,true,1120411802,28,1129749450,9337648
1669007891,206104,true,1120635895,28,1129975412,9339517
1669007999,206104,true,1120635895,28,1130088409,9452514
1669008263,206103,true,1120747959,28,1130314438,9566479
1669008479,206103,true,1120747959,28,1130427470,9679511
1669008491,206101,true,1120972120,28,1130540512,9568392
1669008719,206100,true,1121084217,28,1130653566,9569349
1669009175,206099,true,1121196325,28,1131105896,9909571
1669009235,206098,true,1121308445,28,1131105896,9797451
1669009343,206096,true,1121532718,28,1131105896,9573178
1669009511,206095,true,1121644871,28,1131219006,9574135
1669009811,206094,true,1121757036,28,1131332128,9575092
1669010051,206093,true,1121869211,28,1131332128,9462917
1669010435,206091,true,1122093596,28,1131558406,9464810
1669010531,206090,true,1122205806,28,1131558406,9352600
1669010603,206089,true,1122318026,28,1131671562,9353536
1669010663,206088,true,1122430258,28,1131671562,9241304
1669010735,206085,true,1122767021,28,1131784729,9017708
1669011287,206084,true,1122879298,28,1132350734,9471436
1669011383,206083,true,1122991585,28,1132463969,9472384
1669011659,206082,true,1123103885,28,1132690474,9586589
1669011803,206079,true,1123440849,28,1132690474,9249625
1669011863,206078,true,1123553194,28,1132803743,9250549
1669011875,206077,true,1123665549,28,1132803743,9138194
1669011935,206076,true,1123777915,28,1132803743,9025828
1669012103,206073,true,1124115083,28,1132917023,8801940
1669012283,206073,true,1124115083,28,1133030315,8915232
1669012331,206071,true,1124339917,28,1133030315,8690398
1669012343,206070,true,1124452351,28,1133030315,8577964
1669012619,206068,true,1124677252,28,1132917023,8239771
1669012643,206067,true,1124789720,28,1132917023,8127303
1669013267,206065,true,1125014689,28,1132577216,7562527
1669013375,206065,true,1125014689,28,1132463969,7449280
1669013435,206063,true,1125239704,28,1132463969,7224265
1669013735,206063,true,1125239704,28,1132237511,6997807
1669013747,206061,true,1125464763,28,1132237511,6772748
1669013903,206061,true,1125464763,28,1131897907,6433144
1669014371,206060,true,1125577309,28,1130992796,5415487
1669015319,206059,true,1125689867,28,1129523534,3833667
1669015331,206058,true,1125802436,28,1129523534,3721098
1669015391,206058,true,1125802436,28,1129523534,3721098
1669015571,206056,true,1126027608,28,1129297664,3270056
1669016183,206056,true,1126027608,28,1129071838,3044230
1669016195,206055,true,1126140210,28,1128958942,2818732
1669016411,206055,true,1126140210,28,1128958942,2818732
1669016423,206054,true,1126252825,28,1128958942,2706117
1669016471,206054,true,1126252825,28,1128846057,2593232
1669016603,206052,true,1126478086,28,1128733184,2255098
1669016615,206053,true,1126365450,28,1128733184,2367734
1669016639,206051,true,1126590734,28,1128620322,2029588
1669016663,206052,true,1126478086,28,1128620322,2142236
1669016675,206052,true,1126478086,28,1128507471,2029385
1669016699,206053,true,1126365450,28,1128394632,2029182
1669016783,206052,true,1126478086,28,1127943387,1465301
1669016795,206053,true,1126365450,28,1127943387,1577937
1669017035,206053,true,1126365450,28,1126590734,225284
1669017131,206054,true,1126252825,28,1126027608,-225217
1669017143,206053,true,1126365450,28,1125915016,-450434
1669017395,206054,true,1126252825,28,1124677252,-1575573
1669017599,206054,true,1126252825,28,1123665549,-2587276
1669017671,206054,true,1126252825,28,1123328517,-2924308
1669017743,206054,true,1126252825,28,1123103885,-3148940
1669017815,206054,true,1126252825,28,1122767021,-3485804
1669017887,206054,true,1126252825,28,1122542501,-3710324
1669017947,206054,true,1126252825,28,1122318026,-3934799
1669019195,206052,true,1126478086,28,1122093596,-4384490
1669019795,206052,true,1126478086,28,1122542501,-3935585
1669019927,206052,true,1126478086,28,1122542501,-3935585
1669020563,206051,true,1126590734,28,1122542501,-4048233
1669020575,206050,true,1126703393,28,1122542501,-4160892
1669020611,206050,true,1126703393,28,1122542501,-4160892
1669020647,206049,true,1126816064,28,1122542501,-4273563
1669020659,206049,true,1126816064,28,1122542501,-4273563
1669020791,206048,true,1126928745,28,1122318026,-4610719
1669020899,206048,true,1126928745,28,1122093596,-4835149
1669020923,206048,true,1126928745,28,1122093596,-4835149
1669021103,206048,true,1126928745,28,1121757036,-5171709
1669021139,206046,true,1127154142,28,1121644871,-5509271
1669021487,206046,true,1127154142,28,1120972120,-6182022
1669021715,206047,true,1127041438,28,1120523843,-6517595
1669021763,206047,true,1127041438,28,1120411802,-6629636
1669021799,206046,true,1127154142,28,1120299772,-6854370
1669021871,206046,true,1127154142,28,1120187753,-6966389
1669021883,206046,true,1127154142,28,1120075745,-7078397
1669021919,206047,true,1127041438,28,1120075745,-6965693
1669022171,206045,true,1127266858,28,1119851764,-7415094
1669022219,206045,true,1127266858,28,1119851764,-7415094
1669022423,206046,true,1127154142,28,1119739790,-7414352
1669022567,206047,true,1127041438,28,1119739790,-7301648
1669022627,206045,true,1127266858,28,1119739790,-7527068
1669022651,206046,true,1127154142,28,1119739790,-7414352
1669022675,206047,true,1127041438,28,1119739790,-7301648
1669022687,206048,true,1126928745,28,1119627827,-7300918
1669022699,206050,true,1126703393,28,1119627827,-7075566
1669022723,206051,true,1126590734,28,1119515875,-7074859
1669022735,206052,true,1126478086,28,1119515875,-6962211
1669022819,206055,true,1126140210,28,1119068181,-7072029
1669022927,206056,true,1126027608,28,1118620666,-7406942
1669022975,206057,true,1125915016,28,1118396975,-7518041
1669023071,206059,true,1125689867,28,1117837944,-7851923
1669023083,206062,true,1125352228,28,1117726172,-7626056
1669023167,206064,true,1125127191,28,1117279193,-7847998
1669023203,206065,true,1125014689,28,1117055771,-7958918
1669023407,206067,true,1124789720,28,1115939329,-8850391
1669023443,206069,true,1124564796,28,1115716175,-8848621
1669023455,206070,true,1124452351,28,1115604614,-8847737
1669023551,206071,true,1124339917,28,1115158484,-9181433
1669023647,206073,true,1124115083,28,1114824003,-9291080
1669023671,206075,true,1123890293,28,1114712532,-9177761
1669024031,206076,true,1123777915,28,1112596695,-11181220
1669024043,206077,true,1123665549,28,1112596695,-11068854
1669024079,206079,true,1123440849,28,1112374209,-11066640
1669024271,206081,true,1123216195,28,1111373572,-11842623
1669024307,206082,true,1123103885,28,1111262446,-11841439
1669024319,206083,true,1122991585,28,1111262446,-11729139
1669024331,206085,true,1122767021,28,1111151331,-11615690
1669024343,206086,true,1122654755,28,1111151331,-11503424
1669024451,206087,true,1122542501,28,1111040227,-11502274
1669024463,206088,true,1122430258,28,1111040227,-11390031
1669024475,206089,true,1122318026,28,1111040227,-11277799
1669024487,206091,true,1122093596,28,1111040227,-11053369
1669024919,206090,true,1122205806,28,1113598432,-8607374
1669024979,206091,true,1122093596,28,1114043938,-8049658
1669025339,206093,true,1121869211,28,1116274144,-5595067
1669025351,206094,true,1121757036,28,1116385772,-5371264
1669025435,206094,true,1121757036,28,1116832393,-4924643
1669025603,206095,true,1121644871,28,1117614410,-4030461
1669025699,206096,true,1121532718,28,1118173329,-3359389
1669025723,206098,true,1121308445,28,1118285147,-3023298
1669025771,206098,true,1121308445,28,1118508815,-2799630
1669025795,206099,true,1121196325,28,1118620666,-2575659
1669025831,206101,true,1120972120,28,1118732528,-2239592
1669025855,206102,true,1120860034,28,1118844401,-2015633
1669026323,206103,true,1120747959,28,1119627827,-1120132
1669026587,206104,true,1120635895,28,1119180088,-1455807
1669026827,206106,true,1120411802,28,1118508815,-1902987
1669026959,206107,true,1120299772,28,1118173329,-2126443
1669026971,206108,true,1120187753,28,1118173329,-2014424
1669027571,206109,true,1120075745,28,1116944076,-3131669
1669027631,206111,true,1119851764,28,1116832393,-3019371
1669027643,206113,true,1119627827,28,1116832393,-2795434
1669027703,206113,true,1119627827,28,1116832393,-2795434
1669027727,206114,true,1119515875,28,1116832393,-2683482
1669027775,206115,true,1119403935,28,1116944076,-2459859
1669027895,206117,true,1119180088,28,1117167476,-2012612
1669028039,206117,true,1119180088,28,1117279193,-1900895
1669028231,206118,true,1119068181,28,1117614410,-1453771
1669028243,206119,true,1118956285,28,1117726172,-1230113
1669028279,206120,true,1118844401,28,1117726172,-1118229
1669028303,206119,true,1118956285,28,1117837944,-1118341
1669028351,206120,true,1118844401,28,1118061523,-782878
1669028411,206121,true,1118732528,28,1118285147,-447381
1669028423,206122,true,1118620666,28,1118285147,-335519
1669028435,206121,true,1118732528,28,1118396975,-335553
1669028651,206121,true,1118732528,28,1119515875,783347
1669029083,206122,true,1118620666,28,1121757036,3136370
1669029095,206123,true,1118508815,28,1121869211,3360396
1669029203,206122,true,1118620666,28,1122542501,3921835
1669029227,206121,true,1118732528,28,1122654755,3922227
1669029707,206123,true,1118508815,28,1124227494,5718679
1669029767,206123,true,1118508815,28,1124452351,5943536
1669029875,206123,true,1118508815,28,1124677252,6168437
1669030703,206122,true,1118620666,28,1124564796,5944130
1669030763,206123,true,1118508815,28,1124452351,5943536
1669030979,206123,true,1118508815,28,1124115083,5606268
1669031219,206122,true,1118620666,28,1124002682,5382016
1669031291,206121,true,1118732528,28,1124002682,5270154
1669031363,206122,true,1118620666,28,1124002682,5382016
1669031579,206122,true,1118620666,28,1123890293,5269627
1669031963,206121,true,1118732528,28,1123553194,4820666
1669032143,206120,true,1118844401,28,1123440849,4596448
1669032227,206121,true,1118732528,28,1123328517,4595989
1669032251,206121,true,1118732528,28,1123328517,4595989
1669032371,206120,true,1118844401,28,1123216195,4371794
1669032431,206119,true,1118956285,28,1123103885,4147600
1669032539,206121,true,1118732528,28,1122991585,4259057
1669032647,206121,true,1118732528,28,1122767021,4034493
1669032707,206120,true,1118844401,28,1122654755,3810354
1669032791,206120,true,1118844401,28,1122318026,3473625
1669032875,206122,true,1118620666,28,1121981398,3360732
1669032947,206123,true,1118508815,28,1121644871,3136056
1669033175,206122,true,1118620666,28,1120860034,2239368
1669033319,206122,true,1118620666,28,1120411802,1791136
1669033499,206123,true,1118508815,28,1119851764,1342949
1669033535,206124,true,1118396975,28,1119739790,1342815
1669033571,206123,true,1118508815,28,1119627827,1119012
1669034315,206123,true,1118508815,28,1117614410,-894405
1669034447,206124,true,1118396975,28,1117390921,-1006054
1669034615,206125,true,1118285147,28,1117279193,-1005954
1669034627,206124,true,1118396975,28,1117279193,-1117782
1669034639,206124,true,1118396975,28,1117279193,-1117782
1669034675,206125,true,1118285147,28,1117279193,-1005954
1669034687,206125,true,1118285147,28,1117279193,-1005954
1669034699,206124,true,1118396975,28,1117390921,-1006054
1669034723,206123,true,1118508815,28,1117390921,-1117894
1669034771,206123,true,1118508815,28,1117614410,-894405
1669034831,206123,true,1118508815,28,1117837944,-670871
1669034867,206123,true,1118508815,28,1117949728,-559087
1669034999,206122,true,1118620666,28,1118285147,-335519
1669035239,206123,true,1118508815,28,1119068181,559366
1669035311,206123,true,1118508815,28,1119292006,783191
1669035587,206122,true,1118620666,28,1120411802,1791136
1669035671,206121,true,1118732528,28,1120747959,2015431
1669035767,206121,true,1118732528,28,1121084217,2351689
1669035827,206121,true,1118732528,28,1121308445,2575917
1669035851,206119,true,1118956285,28,1121420576,2464291
1669035863,206118,true,1119068181,28,1121420576,2352395
1669035911,206118,true,1119068181,28,1121644871,2576690
1669035923,206117,true,1119180088,28,1121757036,2576948
1669035935,206115,true,1119403935,28,1121757036,2353101
1669035959,206113,true,1119627827,28,1121981398,2353571
1669035995,206112,true,1119739790,28,1122205806,2466016
1669036043,206111,true,1119851764,28,1122430258,2578494
1669036103,206108,true,1120187753,28,1122767021,2579268
1669036235,206107,true,1120299772,28,1123777915,3478143
1669036259,206106,true,1120411802,28,1123890293,3478491
1669036331,206104,true,1120635895,28,1124452351,3816456
1669036355,206102,true,1120860034,28,1124677252,3817218
1669036691,206100,true,1121084217,28,1126590734,5506517
1669036715,206099,true,1121196325,28,1126703393,5507068
1669036775,206097,true,1121420576,28,1127041438,5620862
1669036823,206095,true,1121644871,28,1127266858,5621987
1669036859,206093,true,1121869211,28,1127492322,5623111
1669036871,206092,true,1121981398,28,1127605071,5623673
1669036919,206089,true,1122318026,28,1128056181,5738155
1669036931,206087,true,1122542501,28,1128168987,5626486
1669036943,206084,true,1122879298,28,1128281804,5402506
1669036967,206083,true,1122991585,28,1128507471,5515886
1669037171,206081,true,1123216195,28,1130540512,7324317
1669037231,206079,true,1123440849,28,1131105896,7665047
1669037243,206077,true,1123665549,28,1131105896,7440347
1669037255,206076,true,1123777915,28,1131219006,7441091
1669037447,206074,true,1124002682,28,1132917023,8914341
1669037519,206073,true,1124115083,28,1133483595,9368512
1669037603,206071,true,1124339917,28,1134163855,9823938
1669037723,206070,true,1124452351,28,1135071504,10619153
1669037903,206068,true,1124677252,28,1136093477,11416225
1669037939,206068,true,1124677252,28,1136320707,11643455
1669037951,206065,true,1125014689,28,1136320707,11306018
1669037963,206064,true,1125127191,28,1136434339,11307148
1669037999,206062,true,1125352228,28,1136547982,11195754
1669038035,206062,true,1125352228,28,1136661637,11309409
1669038491,206059,true,1125689867,28,1138253998,12564131
1669038515,206058,true,1125802436,28,1138253998,12451562
1669038527,206057,true,1125915016,28,1138367824,12452808
1669038563,206056,true,1126027608,28,1138367824,12340216
1669038683,206054,true,1126252825,28,1138367824,12114999
1669038707,206053,true,1126365450,28,1138367824,12002374
1669038779,206051,true,1126590734,28,1138140184,11549450
1669038851,206050,true,1126703393,28,1137798810,11095417
1669038923,206048,true,1126928745,28,1137571285,10642540
1669038959,206047,true,1127041438,28,1137457539,10416101
1669039187,206045,true,1127266858,28,1136661637,9394779
1669039475,206045,true,1127266858,28,1135752717,8485859
1669039595,206043,true,1127492322,28,1135412059,7919737
1669039631,206042,true,1127605071,28,1135298529,7693458
1669039703,206041,true,1127717832,28,1135185011,7467179
1669039847,206041,true,1127717832,28,1134844524,7126692
1669039895,206039,true,1127943387,28,1134731050,6787663
1669040063,206038,true,1128056181,28,1134504138,6447957
1669040327,206037,true,1128168987,28,1134050450,5881463
1669040531,206036,true,1128281804,28,1133937056,5655252
1669040603,206035,true,1128394632,28,1133937056,5542424
1669040615,206034,true,1128507471,28,1134050450,5542979
1669040639,206033,true,1128620322,28,1134050450,5430128
1669040699,206033,true,1128620322,28,1134050450,5430128
1669040711,206032,true,1128733184,28,1134050450,5317266
1669041107,206031,true,1128846057,28,1134617589,5771532
1669041239,206030,true,1128958942,28,1134958008,5999066
1669041251,206029,true,1129071838,28,1134958008,5886170
1669041287,206028,true,1129184745,28,1135071504,5886759
1669041419,206027,true,1129297664,28,1135185011,5887347
1669042679,206026,true,1129410593,28,1135979879,6569286
1669042943,206026,true,1129410593,28,1135866292,6455699
1669042955,206025,true,1129523534,28,1135866292,6342758
1669042967,206024,true,1129636487,28,1135752717,6116230
1669042979,206023,true,1129749450,28,1135752717,6003267
1669042991,206022,true,1129862425,28,1135752717,5890292
1669043303,206022,true,1129862425,28,1135298529,5436104
1669043795,206021,true,1129975412,28,1134617589,4642177
1669043903,206020,true,1130088409,28,1134504138,4415729
1669044179,206019,true,1130201418,28,1134163855,3962437
1669044239,206018,true,1130314438,28,1134050450,3736012
1669044767,206017,true,1130427470,28,1133143618,2716148
1669045187,206016,true,1130540512,28,1132803743,2263231
1669045307,206016,true,1130540512,28,1132803743,2263231
1669045547,206015,true,1130653566,28,1132690474,2036908
1669046423,206014,true,1130766632,28,1132011097,1244465
1669047107,206013,true,1130879708,28,1131671562,791854
1669047119,206013,true,1130879708,28,1131671562,791854
1669047131,206012,true,1130992796,28,1131671562,678766
1669047155,206010,true,1131219006,28,1131558406,339400
1669047407,206010,true,1131219006,28,1130766632,-452374
1669047467,206010,true,1131219006,28,1130540512,-678494
1669047479,206009,true,1131332128,28,1130540512,-791616
1669047491,206007,true,1131558406,28,1130427470,-1130936
1669047515,206008,true,1131445261,28,1130314438,-1130823
1669047719,206009,true,1131332128,28,1128733184,-2598944
1669047731,206008,true,1131445261,28,1128620322,-2824939
1669047743,206007,true,1131558406,28,1128620322,-2938084
1669047755,206008,true,1131445261,28,1128394632,-3050629
1669047767,206010,true,1131219006,28,1128281804,-2937202
1669047779,206009,true,1131332128,28,1128168987,-3163141
1669047935,206008,true,1131445261,28,1126703393,-4741868
1669047995,206010,true,1131219006,28,1126140210,-5078796
1669048067,206011,true,1131105896,28,1125352228,-5753668
1669048079,206011,true,1131105896,28,1125239704,-5866192
1669048091,206011,true,1131105896,28,1125127191,-5978705
1669048175,206013,true,1130879708,28,1124115083,-6764625
1669048235,206015,true,1130653566,28,1123440849,-7212717
1669048283,206015,true,1130653566,28,1122879298,-7774268
1669048295,206015,true,1130653566,28,1122767021,-7886545
1669048307,206017,true,1130427470,28,1122542501,-7884969
1669048319,206020,true,1130088409,28,1122430258,-7658151
1669048331,206020,true,1130088409,28,1122205806,-7882603
1669048367,206021,true,1129975412,28,1121644871,-8330541
1669048391,206023,true,1129749450,28,1121308445,-8441005
1669048463,206027,true,1129297664,28,1120187753,-9109911
1669048487,206027,true,1129297664,28,1119739790,-9557874
1669048511,206028,true,1129184745,28,1119403935,-9780810
1669048523,206030,true,1128958942,28,1119180088,-9778854
1669048535,206034,true,1128507471,28,1119068181,-9439290
1669048919,206033,true,1128620322,28,1113932545,-14687777
1669048931,206034,true,1128507471,28,1113821163,-14686308
1669048979,206037,true,1128168987,28,1113375746,-14793241
1669049147,206040,true,1127830604,28,1111929370,-15901234
1669049159,206039,true,1127943387,28,1111818188,-16125199
1669049171,206040,true,1127830604,28,1111707018,-16123586
1669049195,206043,true,1127492322,28,1111595858,-15896464
1669049207,206046,true,1127154142,28,1111484710,-15669432
1669049219,206045,true,1127266858,28,1111373572,-15893286
1669049243,206046,true,1127154142,28,1111262446,-15891696
1669049255,206049,true,1126816064,28,1111151331,-15664733
1669049267,206051,true,1126590734,28,1111040227,-15550507
1669049279,206051,true,1126590734,28,1111040227,-15550507
1669049291,206052,true,1126478086,28,1111040227,-15437859
1669049867,206055,true,1126140210,28,1111151331,-14988879
1669050095,206058,true,1125802436,28,1111818188,-13984248
1669050131,206058,true,1125802436,28,1112040563,-13761873
1669050167,206059,true,1125689867,28,1112262982,-13426885
1669050191,206063,true,1125239704,28,1112485446,-12754258
1669050287,206066,true,1124902199,28,1113153104,-11749095
1669050299,206066,true,1124902199,28,1113264420,-11637779
1669050311,206067,true,1124789720,28,1113375746,-11413974
1669050359,206070,true,1124452351,28,1113598432,-10853919
1669050419,206073,true,1124115083,28,1113821163,-10293920
1669050431,206074,true,1124002682,28,1113821163,-10181519
1669050587,206075,true,1123890293,28,1114489623,-9400670
1669050611,206078,true,1123553194,28,1114601072,-8952122
1669050647,206081,true,1123216195,28,1114712532,-8503663
1669050767,206081,true,1123216195,28,1115046979,-8169216
1669050803,206083,true,1122991585,28,1115046979,-7944606
1669050887,206086,true,1122654755,28,1115158484,-7496271
1669051067,206089,true,1122318026,28,1115046979,-7271047
1669051283,206089,true,1122318026,28,1114601072,-7716954
1669051679,206091,true,1122093596,28,1113598432,-8495164
1669051691,206094,true,1121757036,28,1113487084,-8269952
1669051787,206097,true,1121420576,28,1113041800,-8378776
1669051835,206097,true,1121420576,28,1112819225,-8601351
1669052171,206100,true,1121084217,28,1110818052,-10266165
1669052183,206103,true,1120747959,28,1110818052,-9929907
1669052195,206106,true,1120411802,28,1110706981,-9704821
1669052207,206106,true,1120411802,28,1110706981,-9704821
1669052231,206108,true,1120187753,28,1110595922,-9591831
1669052351,206110,true,1119963749,28,1110373836,-9589913
1669052423,206114,true,1119515875,28,1110262810,-9253065
1669052567,206114,true,1119515875,28,1110040790,-9475085
1669052987,206115,true,1119403935,28,1109929797,-9474138
1669053131,206118,true,1119068181,28,1109818816,-9249365
1669053299,206121,true,1118732528,28,1109596885,-9135643
1669053311,206121,true,1118732528,28,1109596885,-9135643
1669053323,206123,true,1118508815,28,1109596885,-8911930
1669053563,206126,true,1118173329,28,1109153157,-9020172
1669053659,206130,true,1117726172,28,1109153157,-8573015
1669053863,206130,true,1117726172,28,1109042253,-8683919
1669053887,206132,true,1117502660,28,1109042253,-8460407
1669053947,206135,true,1117167476,28,1108931360,-8236116
1669053959,206140,true,1116609060,28,1108931360,-7677700
1669054103,206142,true,1116385772,28,1107933821,-8451951
1669054115,206144,true,1116162528,28,1107823038,-8339490
1669054151,206148,true,1115716175,28,1107490758,-8225417
1669054235,206152,true,1115270000,28,1106715824,-8554176
1669054259,206155,true,1114935486,28,1106494514,-8440972
1669054271,206157,true,1114712532,28,1106383876,-8328656
1669054283,206161,true,1114266758,28,1106383876,-7882882
1669054295,206165,true,1113821163,28,1106273249,-7547914
1669054331,206166,true,1113709792,28,1106052027,-7657765
1669054379,206168,true,1113487084,28,1105830850,-7656234
1669054439,206172,true,1113041800,28,1105388628,-7653172
1669054451,206176,true,1112596695,28,1105388628,-7208067
1669054535,206177,true,1112485446,28,1104946583,-7538863
1669054547,206178,true,1112374209,28,1104836100,-7538109
1669054667,206182,true,1111929370,28,1104173430,-7755940
1669054691,206186,true,1111484710,28,1104063024,-7421686
1669054715,206187,true,1111373572,28,1103952628,-7420944
1669054727,206189,true,1111151331,28,1103842244,-7309087
1669054763,206192,true,1110818052,28,1103621509,-7196543
1669054775,206196,true,1110373836,28,1103621509,-6752327
1669054787,206198,true,1110151794,28,1103511158,-6640636
1669054799,206199,true,1110040790,28,1103400817,-6639973
1669054811,206203,true,1109596885,28,1103290488,-6306397
1669054835,206207,true,1109153157,28,1103180170,-5972987
1669054847,206208,true,1109042253,28,1103069863,-5972390
1669054883,206209,true,1108931360,28,1102849283,-6082077
1669055075,206212,true,1108598747,28,1101416582,-7182165
1669055243,206216,true,1108155418,28,1100315771,-7839647
1669055387,206218,true,1107933821,28,1099435914,-8497907
1669055423,206219,true,1107823038,28,1099216060,-8606978
1669055471,206221,true,1107601507,28,1098996249,-8605258
1669055579,206223,true,1107380020,28,1098556761,-8823259
1669055603,206224,true,1107269293,28,1098446916,-8822377
1669055699,206226,true,1107047872,28,1098117448,-8930424
1669055831,206228,true,1106826496,28,1098007647,-8818849
1669055891,206229,true,1106715824,28,1098007647,-8708177
1669055903,206230,true,1106605164,28,1098007647,-8597517
1669055915,206231,true,1106494514,28,1098007647,-8486867
1669056023,206233,true,1106273249,28,1098227260,-8045989
1669056119,206234,true,1106162632,28,1098227260,-7935372
1669056179,206235,true,1106052027,28,1098227260,-7824767
1669056203,206236,true,1105941433,28,1098227260,-7714173
1669056227,206237,true,1105830850,28,1098117448,-7713402
1669056239,206238,true,1105720278,28,1098117448,-7602830
1669056359,206238,true,1105720278,28,1098007647,-7712631
1669056371,206239,true,1105609717,28,1098007647,-7602070
1669056647,206240,true,1105499167,28,1098007647,-7491520
1669056743,206241,true,1105388628,28,1098227260,-7161368
1669056767,206241,true,1105388628,28,1098337082,-7051546
1669056947,206241,true,1105388628,28,1098886361,-6502267
1669056971,206241,true,1105388628,28,1098996249,-6392379
1669056983,206241,true,1105388628,28,1098996249,-6392379
1669057547,206241,true,1105388628,28,1100095740,-5292888
1669057679,206242,true,1105278100,28,1100315771,-4962329
1669058039,206242,true,1105278100,28,1100755963,-4522137
1669058339,206242,true,1105278100,28,1100866038,-4412062
1669058435,206243,true,1105167584,28,1100976125,-4191459
1669058843,206244,true,1105057078,28,1100755963,-4301115
1669058867,206244,true,1105057078,28,1100755963,-4301115
1669058903,206245,true,1104946583,28,1100755963,-4190620
1669058927,206247,true,1104725627,28,1100755963,-3969664
1669058975,206248,true,1104615165,28,1100425802,-4189363
1669059011,206250,true,1104394276,28,1100315771,-4078505
1669059035,206251,true,1104283847,28,1100095740,-4188107
1669059155,206253,true,1104063024,28,1099545857,-4517167
1669059239,206255,true,1103842244,28,1099216060,-4626184
1669059263,206257,true,1103621509,28,1098996249,-4625260
1669059275,206259,true,1103400817,28,1098996249,-4404568
1669059287,206261,true,1103180170,28,1098886361,-4293809
1669059299,206264,true,1102849283,28,1098776483,-4072800
1669059359,206267,true,1102518494,28,1098227260,-4291234
1669059371,206268,true,1102408253,28,1098117448,-4290805
1669059407,206271,true,1102077597,28,1097788079,-4289518
1669059419,206274,true,1101747040,28,1097678311,-4068729
1669059551,206277,true,1101416582,28,1096471589,-4944993
1669059575,206279,true,1101196331,28,1096252327,-4944004
1669059659,206282,true,1100866038,28,1095485258,-5380780
1669059815,206284,true,1100645898,28,1094062123,-6583775
1669059899,206287,true,1100315771,28,1093296586,-7019185
1669059947,206289,true,1100095740,28,1092859377,-7236363
1669059971,206292,true,1099765778,28,1092531584,-7234194
1669059983,206295,true,1099435914,28,1092422342,-7013572
1669060031,206298,true,1099106149,28,1091876295,-7229854
1669060247,206298,true,1099106149,28,1090239790,-8866359
1669060487,206301,true,1098776483,28,1088496888,-10279595
1669060715,206303,true,1098556761,28,1086865448,-11691313
1669060727,206306,true,1098227260,28,1086865448,-11361812
1669060751,206306,true,1098227260,28,1086865448,-11361812
1669060859,206308,true,1098007647,28,1086756772,-11250875
1669061063,206310,true,1097788079,28,1086539454,-11248625
1669061303,206313,true,1097458808,28,1087408990,-10049818
1669061327,206313,true,1097458808,28,1087517730,-9941078
1669061339,206315,true,1097239349,28,1087517730,-9721619
1669061351,206315,true,1097239349,28,1087626482,-9612867
1669061363,206317,true,1097019934,28,1087735245,-9284689
1669061375,206317,true,1097019934,28,1087844018,-9175916
1669061387,206318,true,1096910243,28,1087844018,-9066225
1669061399,206319,true,1096800563,28,1087952803,-8847760
1669061447,206321,true,1096581236,28,1088388049,-8193187
1669061495,206320,true,1096690894,28,1088823470,-7867424
1669061567,206321,true,1096581236,28,1089476927,-7104309
1669061771,206322,true,1096471589,28,1091330520,-5141069
1669061867,206324,true,1096252327,28,1092203890,-4048437
1669061879,206324,true,1096252327,28,1092313111,-3939216
1669061891,206325,true,1096142713,28,1092422342,-3720371
1669061903,206326,true,1096033110,28,1092531584,-3501526
1669061975,206326,true,1096033110,28,1093187267,-2845843
1669062179,206325,true,1096142713,28,1095047173,-1095540
1669062203,206325,true,1096142713,28,1095266193,-876520
1669062263,206326,true,1096033110,28,1095813936,-219174
1669062287,206326,true,1096033110,28,1096033110,0
1669062323,206325,true,1096142713,28,1096361953,219240
1669062359,206324,true,1096252327,28,1096581236,328909
1669062383,206325,true,1096142713,28,1096800563,657850
1669062707,206325,true,1096142713,28,1098886361,2743648
1669062755,206323,true,1096361953,28,1099216060,2854107
1669062923,206322,true,1096471589,28,1100095740,3624151
1669062971,206323,true,1096361953,28,1100425802,4063849
1669062983,206323,true,1096361953,28,1100535845,4173892
1669062995,206322,true,1096471589,28,1100535845,4064256
1669063007,206321,true,1096581236,28,1100645898,4064662
1669063271,206321,true,1096581236,28,1102628746,6047510
1669063295,206321,true,1096581236,28,1102739009,6157773
1669063427,206320,true,1096690894,28,1103290488,6599594
1669063499,206319,true,1096800563,28,1103511158,6710595
1669063703,206319,true,1096800563,28,1104394276,7593713
1669063907,206319,true,1096800563,28,1104836100,8035537
1669063919,206318,true,1096910243,28,1104836100,7925857
1669063943,206317,true,1097019934,28,1104836100,7816166
1669065863,206317,true,1097019934,28,1106052027,9032093
1669066067,206317,true,1097019934,28,1106052027,9032093
1669066307,206316,true,1097129636,28,1106052027,8922391
1669066415,206315,true,1097239349,28,1106052027,8812678
1669066643,206315,true,1097239349,28,1105941433,8702084
1669066991,206315,true,1097239349,28,1105830850,8591501
1669067147,206314,true,1097349073,28,1105830850,8481777
1669067159,206313,true,1097458808,28,1105830850,8372042
1669067171,206313,true,1097458808,28,1105720278,8261470
1669067183,206313,true,1097458808,28,1105609717,8150909
1669067195,206314,true,1097349073,28,1105609717,8260644
1669067219,206314,true,1097349073,28,1105388628,8039555
1669067243,206315,true,1097239349,28,1105057078,7817729
1669067267,206315,true,1097239349,28,1104836100,7596751
1669067279,206316,true,1097129636,28,1104725627,7595991
1669067483,206317,true,1097019934,28,1102739009,5719075
1669067495,206318,true,1096910243,28,1102628746,5718503
1669067531,206318,true,1096910243,28,1102298023,5387780
1669067579,206319,true,1096800563,28,1101747040,4946477
1669067603,206321,true,1096581236,28,1101416582,4835346
1669067615,206322,true,1096471589,28,1101306451,4834862
1669067699,206322,true,1096471589,28,1100425802,3954213
1669067711,206323,true,1096361953,28,1100315771,3953818
1669067723,206324,true,1096252327,28,1100205750,3953423
1669067735,206325,true,1096142713,28,1100095740,3953027
1669067891,206324,true,1096252327,28,1098996249,2743922
1669067939,206325,true,1096142713,28,1098666617,2523904
1669068023,206326,true,1096033110,28,1098117448,2084338
1669068083,206327,true,1095923517,28,1097678311,1754794
1669068095,206326,true,1096033110,28,1097678311,1645201
1669068131,206327,true,1095923517,28,1097458808,1535291
1669068275,206327,true,1095923517,28,1097019934,1096417
1669068287,206328,true,1095813936,28,1096910243,1096307
1669068299,206327,true,1095923517,28,1096910243,986726
1669068335,206328,true,1095813936,28,1096690894,876958
1669068347,206328,true,1095813936,28,1096690894,876958
1669068371,206329,true,1095704366,28,1096581236,876870
1669068563,206328,true,1095813936,28,1095813936,0
1669068683,206329,true,1095704366,28,1095266193,-438173
1669069271,206329,true,1095704366,28,1095813936,109570
1669069295,206329,true,1095704366,28,1095923517,219151
1669069307,206328,true,1095813936,28,1096142713,328777
1669069427,206329,true,1095704366,28,1097568554,1864188
1669069451,206327,true,1095923517,28,1097897857,1974340
1669069535,206326,true,1096033110,28,1098776483,2743373
1669069595,206324,true,1096252327,28,1099216060,2963733
1669069799,206324,true,1096252327,28,1100866038,4613711
1669069811,206322,true,1096471589,28,1100976125,4504536
1669069823,206320,true,1096690894,28,1101086223,4395329
1669069847,206318,true,1096910243,28,1101306451,4396208
1669070603,206317,true,1097019934,28,1108155418,11135484
1669070807,206314,true,1097349073,28,1109929797,12580724
1669070831,206312,true,1097568554,28,1110040790,12472236
1669070855,206309,true,1097897857,28,1110262810,12364953
1669070903,206307,true,1098117448,28,1110706981,12589533
1669070927,206305,true,1098337082,28,1110818052,12480970
1669070939,206303,true,1098556761,28,1110929134,12372373
1669070999,206300,true,1098886361,28,1111373572,12487211
1669071071,206299,true,1098996249,28,1111818188,12821939
1669071143,206297,true,1099216060,28,1112040563,12824503
1669071167,206295,true,1099435914,28,1112040563,12604649
1669071563,206292,true,1099765778,28,1112374209,12608431
1669071743,206290,true,1099985742,28,1112151767,12166025
1669072079,206288,true,1100205750,28,1111262446,11056696
1669072343,206286,true,1100425802,28,1110595922,10170120
1669072451,206283,true,1100755963,28,1110262810,9506847
1669072511,206283,true,1100755963,28,1110151794,9395831
1669072859,206281,true,1100976125,28,1109818816,8842691
1669073651,206279,true,1101196331,28,1110262810,9066479
1669073747,206276,true,1101526723,28,1110373836,8847113
1669074035,206275,true,1101636876,28,1110484873,8847997
1669074251,206274,true,1101747040,28,1110484873,8737833
1669074263,206272,true,1101967400,28,1110484873,8517473
1669074335,206270,true,1102187805,28,1110484873,8297068
1669074431,206269,true,1102298023,28,1110373836,8075813
1669074467,206267,true,1102518494,28,1110373836,7855342
1669074647,206266,true,1102628746,28,1110262810,7634064
1669074923,206265,true,1102739009,28,1110151794,7412785
1669074935,206264,true,1102849283,28,1110040790,7191507
1669074947,206263,true,1102959567,28,1110040790,7081223
1669074995,206262,true,1103069863,28,1110040790,6970927
1669075043,206261,true,1103180170,28,1109929797,6749627
1669075235,206262,true,1103069863,28,1109596885,6527022
1669075331,206261,true,1103180170,28,1109374999,6194829
1669075343,206260,true,1103290488,28,1109374999,6084511
1669075355,206259,true,1103400817,28,1109264073,5863256
1669075367,206260,true,1103290488,28,1109264073,5973585
1669075379,206260,true,1103290488,28,1109153157,5862669
1669075439,206259,true,1103400817,28,1108931360,5530543
1669075559,206259,true,1103400817,28,1108487898,5087081
1669075655,206260,true,1103290488,28,1108155418,4864930
1669075667,206260,true,1103290488,28,1108044614,4754126
1669075679,206259,true,1103400817,28,1108044614,4643797
1669075691,206259,true,1103400817,28,1108044614,4643797
1669075751,206259,true,1103400817,28,1107933821,4533004
1669075943,206258,true,1103511158,28,1107601507,4090349
1669075955,206258,true,1103511158,28,1107601507,4090349
1669076039,206257,true,1103621509,28,1107601507,3979998
1669076303,206257,true,1103621509,28,1107601507,3979998
1669076339,206256,true,1103731871,28,1107601507,3869636
1669076555,206255,true,1103842244,28,1107601507,3759263
1669076567,206254,true,1103952628,28,1107712267,3759639
1669077287,206253,true,1104063024,28,1109818816,5755792
1669077515,206252,true,1104173430,28,1110929134,6755704
1669077539,206253,true,1104063024,28,1110929134,6866110
1669077551,206252,true,1104173430,28,1111040227,6866797
1669077875,206252,true,1104173430,28,1111595858,7422428
1669077923,206251,true,1104283847,28,1111595858,7312011
1669078235,206252,true,1104173430,28,1111707018,7533588
1669078535,206252,true,1104173430,28,1111484710,7311280
1669078715,206251,true,1104283847,28,1111151331,6867484
1669078835,206251,true,1104283847,28,1110929134,6645287
1669078859,206251,true,1104283847,28,1110818052,6534205
1669079207,206251,true,1104283847,28,1110040790,5756943
1669079279,206250,true,1104394276,28,1109818816,5424540
1669079399,206250,true,1104394276,28,1109596885,5202609
1669079411,206250,true,1104394276,28,1109596885,5202609
1669079507,206250,true,1104394276,28,1109374999,4980723
1669080131,206250,true,1104394276,28,1108266234,3871958
1669080143,206249,true,1104504715,28,1108266234,3761519
1669080467,206250,true,1104394276,28,1107712267,3317991
1669080479,206249,true,1104504715,28,1107712267,3207552
1669080491,206246,true,1104836100,28,1107712267,2876167
1669080563,206245,true,1104946583,28,1107601507,2654924
1669080719,206245,true,1104946583,28,1107269293,2322710
1669080731,206244,true,1105057078,28,1107158577,2101499
1669080743,206241,true,1105388628,28,1107158577,1769949
1669081211,206240,true,1105499167,28,1105720278,221111
1669081583,206240,true,1105499167,28,1104836100,-663067
1669081991,206239,true,1105609717,28,1103511158,-2098559
1669082663,206237,true,1105830850,28,1102187805,-3643045
1669082675,206235,true,1106052027,28,1102187805,-3864222
1669082699,206235,true,1106052027,28,1102187805,-3864222
1669082735,206234,true,1106162632,28,1102077597,-4085035
1669082819,206233,true,1106273249,28,1101857214,-4416035
1669082831,206231,true,1106494514,28,1101857214,-4637300
1669083263,206232,true,1106383876,28,1100535845,-5848031
1669083311,206233,true,1106273249,28,1100425802,-5847447
1669083467,206231,true,1106494514,28,1099985742,-6508772
1669083587,206230,true,1106605164,28,1099655812,-6949352
1669083971,206231,true,1106494514,28,1098886361,-7608153
1669084067,206232,true,1106383876,28,1098666617,-7717259
1669084859,206230,true,1106605164,28,1097897857,-8707307
1669085315,206230,true,1106605164,28,1098007647,-8597517
1669085399,206231,true,1106494514,28,1098117448,-8377066
1669085411,206232,true,1106383876,28,1098117448,-8266428
1669085651,206230,true,1106605164,28,1098446916,-8158248
1669085783,206229,true,1106715824,28,1098666617,-8049207
1669085843,206230,true,1106605164,28,1098776483,-7828681
1669085867,206231,true,1106494514,28,1098776483,-7718031
1669085903,206229,true,1106715824,28,1098886361,-7829463
1669085915,206228,true,1106826496,28,1098886361,-7940135
1669085963,206228,true,1106826496,28,1099106149,-7720347
1669085999,206229,true,1106715824,28,1099216060,-7499764
1669086023,206228,true,1106826496,28,1099325981,-7500515
1669086407,206228,true,1106826496,28,1100976125,-5850371
1669086419,206229,true,1106715824,28,1100976125,-5739699
1669086455,206230,true,1106605164,28,1101196331,-5408833
1669086467,206228,true,1106826496,28,1101196331,-5630165
1669086635,206229,true,1106715824,28,1102077597,-4638227
1669086671,206229,true,1106715824,28,1102298023,-4417801
1669086899,206230,true,1106605164,28,1103511158,-3094006
1669086947,206230,true,1106605164,28,1103731871,-2873293
1669087391,206231,true,1106494514,28,1105830850,-663664
1669087595,206232,true,1106383876,28,1106605164,221288
1669087691,206232,true,1106383876,28,1106826496,442620
1669087871,206232,true,1106383876,28,1107158577,774701
1669088063,206233,true,1106273249,28,1107269293,996044
1669088147,206233,true,1106273249,28,1107380020,1106771
1669088375,206234,true,1106162632,28,1107490758,1328126
1669088507,206233,true,1106273249,28,1107490758,1217509
1669088543,206233,true,1106273249,28,1107490758,1217509
1669088663,206234,true,1106162632,28,1107380020,1217388
1669088699,206235,true,1106052027,28,1107380020,1327993
1669088711,206235,true,1106052027,28,1107380020,1327993
1669089587,206235,true,1106052027,28,1105830850,-221177
1669089683,206236,true,1105941433,28,1105720278,-221155
1669089707,206236,true,1105941433,28,1105609717,-331716
1669090007,206236,true,1105941433,28,1105167584,-773849
1669090031,206237,true,1105830850,28,1105057078,-773772
1669090043,206238,true,1105720278,28,1105057078,-663200
1669091087,206238,true,1105720278,28,1104504715,-1215563
1669091243,206238,true,1105720278,28,1104504715,-1215563
1669091279,206239,true,1105609717,28,1104504715,-1105002
1669091291,206240,true,1105499167,28,1104504715,-994452
1669092263,206240,true,1105499167,28,1103731871,-1767296
1669092611,206240,true,1105499167,28,1103400817,-2098350
1669092959,206241,true,1105388628,28,1103069863,-2318765
1669092995,206242,true,1105278100,28,1103069863,-2208237
1669093007,206242,true,1105278100,28,1103069863,-2208237
1669093115,206243,true,1105167584,28,1102959567,-2208017
1669093295,206243,true,1105167584,28,1102849283,-2318301
1669093487,206244,true,1105057078,28,1102739009,-2318069
1669093547,206245,true,1104946583,28,1102628746,-2317837
1669093619,206244,true,1105057078,28,1102628746,-2428332
1669094039,206245,true,1104946583,28,1102298023,-2648560
1669094063,206246,true,1104836100,28,1102298023,-2538077
1669094135,206246,true,1104836100,28,1102187805,-2648295
1669094159,206246,true,1104836100,28,1102187805,-2648295
1669094171,206246,true,1104836100,28,1102077597,-2758503
1669094867,206247,true,1104725627,28,1100425802,-4299825
1669095503,206248,true,1104615165,28,1099216060,-5399105
1669096427,206247,true,1104725627,28,1099325981,-5399646
1669096475,206248,true,1104615165,28,1099435914,-5179251
1669096595,206249,true,1104504715,28,1099435914,-5068801
1669097075,206249,true,1104504715,28,1099765778,-4738937
1669097099,206250,true,1104394276,28,1099655812,-4738464
1669097555,206250,true,1104394276,28,1099106149,-5288127
1669097663,206252,true,1104173430,28,1098996249,-5177181
1669097879,206253,true,1104063024,28,1098556761,-5506263
1669098155,206253,true,1104063024,28,1098117448,-5945576
1669098203,206254,true,1103952628,28,1098007647,-5944981
1669098251,206256,true,1103731871,28,1098007647,-5724224
1669098275,206257,true,1103621509,28,1097897857,-5723652
1669098359,206258,true,1103511158,28,1097678311,-5832847
1669098635,206260,true,1103290488,28,1096910243,-6380245
1669098779,206262,true,1103069863,28,1096252327,-6817536
1669098971,206263,true,1102959567,28,1095485258,-7474309
1669099067,206265,true,1102739009,28,1095156678,-7582331
1669099163,206266,true,1102628746,28,1094828196,-7800550
1669099187,206268,true,1102408253,28,1094718725,-7689528
1669099871,206270,true,1102187805,28,1092203890,-9983915
1669099943,206271,true,1102077597,28,1091985482,-10092115
1669100003,206273,true,1101857214,28,1091657952,-10199262
1669100015,206275,true,1101636876,28,1091657952,-9978924
1669100027,206276,true,1101526723,28,1091548797,-9977926
1669100267,206278,true,1101306451,28,1090457849,-10848602
1669100291,206280,true,1101086223,28,1090348814,-10737409
1669100339,206282,true,1100866038,28,1090130777,-10735261
1669100363,206283,true,1100755963,28,1090021775,-10734188
1669100447,206285,true,1100535845,28,1089694833,-10841012
1669100471,206287,true,1100315771,28,1089585875,-10729896
1669100495,206289,true,1100095740,28,1089476927,-10618813
1669100651,206291,true,1099875754,28,1088714598,-11161156
1669100675,206293,true,1099655812,28,1088605738,-11050074
1669100759,206295,true,1099435914,28,1088170404,-11265510
1669100783,206296,true,1099325981,28,1088061598,-11264383
1669100795,206298,true,1099106149,28,1088061598,-11044551
1669100855,206300,true,1098886361,28,1087844018,-11042343
1669101011,206301,true,1098776483,28,1087300260,-11476223
1669101323,206302,true,1098666617,28,1086213557,-12453060
1669101407,206304,true,1098446916,28,1085887758,-12559158
1669101419,206306,true,1098227260,28,1085887758,-12339502
1669101431,206307,true,1098117448,28,1085887758,-12229690
1669101467,206308,true,1098007647,28,1085779180,-12228467
1669101779,206309,true,1097897857,28,1085127941,-12769916
1669101923,206310,true,1097788079,28,1085019439,-12768640
1669102043,206311,true,1097678311,28,1085019439,-12658872
1669102295,206311,true,1097678311,28,1085127941,-12550370
1669102619,206312,true,1097568554,28,1086213557,-11354997
1669102871,206313,true,1097458808,28,1086648108,-10810700
1669103723,206314,true,1097349073,28,1087735245,-9613828
1669103771,206314,true,1097349073,28,1087844018,-9505055
1669103927,206315,true,1097239349,28,1088061598,-9177751
1669105019,206316,true,1097129636,28,1089259064,-7870572
1669105043,206316,true,1097129636,28,1089259064,-7870572
1669105055,206317,true,1097019934,28,1089259064,-7760870
1669105067,206318,true,1096910243,28,1089259064,-7651179
1669105091,206320,true,1096690894,28,1089259064,-7431830
1669105127,206321,true,1096581236,28,1089150149,-7431087
1669105283,206324,true,1096252327,28,1088279221,-7973106
1669105571,206325,true,1096142713,28,1086756772,-9385941
1669105583,206327,true,1095923517,28,1086648108,-9275409
1669105643,206329,true,1095704366,28,1086322178,-9382188
1669105703,206332,true,1095375720,28,1086104947,-9270773
1669105751,206333,true,1095266193,28,1085779180,-9487013
1669105847,206335,true,1095047173,28,1085344977,-9702196
1669105859,206337,true,1094828196,28,1085236453,-9591743
1669105883,206340,true,1094499814,28,1085127941,-9371873
1669105967,206341,true,1094390375,28,1084693998,-9696377
1669106735,206343,true,1094171529,28,1081228698,-12942831
1669106759,206346,true,1093843344,28,1081120586,-12722758
1669106795,206348,true,1093624608,28,1080904394,-12720214
1669107191,206349,true,1093515256,28,1081769420,-11745836
1669107359,206351,true,1093296586,28,1082418644,-10877942
1669107431,206353,true,1093077959,28,1082635139,-10442820
1669107863,206355,true,1092859377,28,1083826633,-9032744
1669107875,206356,true,1092750102,28,1083826633,-8923469
1669107947,206358,true,1092531584,28,1084043409,-8488175
1669108283,206360,true,1092313111,28,1085344977,-6968134
1669108379,206362,true,1092094681,28,1085779180,-6315501
1669108679,206363,true,1091985482,28,1086756772,-5228710
1669108703,206364,true,1091876295,28,1086756772,-5119523
1669108727,206366,true,1091657952,28,1086756772,-4901180
1669108751,206368,true,1091439653,28,1086865448,-4574205
1669108775,206369,true,1091330520,28,1086865448,-4465072
1669108823,206370,true,1091221398,28,1086865448,-4355950
1669108919,206372,true,1091003187,28,1086865448,-4137739
1669109039,206374,true,1090785019,28,1086865448,-3919571
1669109075,206375,true,1090675951,28,1086865448,-3810503
1669109087,206376,true,1090566894,28,1086865448,-3701446
1669109123,206378,true,1090348814,28,1086865448,-3483366
1669109135,206380,true,1090130777,28,1086865448,-3265329
1669109327,206381,true,1090021775,28,1086865448,-3156327
1669109951,206383,true,1089803803,28,1086213557,-3590246
1669110395,206384,true,1089694833,28,1085562057,-4132776
1669110611,206387,true,1089367990,28,1085127941,-4240049
1669110695,206387,true,1089367990,28,1085019439,-4348551
1669110755,206389,true,1089150149,28,1084910948,-4239201
1669110767,206391,true,1088932352,28,1084910948,-4021404
1669110779,206393,true,1088714598,28,1084910948,-3803650
1669110839,206394,true,1088605738,28,1084802467,-3803271
1669110983,206396,true,1088388049,28,1084477092,-3910957
1669111019,206397,true,1088279221,28,1084368655,-3910566
1669111331,206400,true,1087952803,28,1083609900,-4342903
1669111415,206401,true,1087844018,28,1083393211,-4450807
1669111823,206403,true,1087626482,28,1082202193,-5424289
1669112123,206404,true,1087517730,28,1081336821,-6180909
1669112279,206407,true,1087191540,28,1081012485,-6179055
1669112291,206408,true,1087082832,28,1081012485,-6070347
1669112327,206409,true,1086974135,28,1081012485,-5961650
1669112411,206411,true,1086756772,28,1080904394,-5852378
1669112459,206412,true,1086648108,28,1080904394,-5743714
1669112951,206413,true,1086539454,28,1081228698,-5310756
1669112963,206415,true,1086322178,28,1081228698,-5093480
1669112987,206416,true,1086213557,28,1081336821,-4876736
1669113107,206418,true,1085996347,28,1081553099,-4443248
1669113683,206418,true,1085996347,28,1082959962,-3036385
1669113731,206420,true,1085779180,28,1083068258,-2710922
1669114127,206421,true,1085670613,28,1083935016,-1735597
1669114151,206422,true,1085562057,28,1083935016,-1627041
1669114199,206422,true,1085562057,28,1084043409,-1518648
1669114211,206424,true,1085344977,28,1084043409,-1301568
1669114271,206424,true,1085344977,28,1084151814,-1193163
1669114487,206426,true,1085127941,28,1084585539,-542402
1669114607,206426,true,1085127941,28,1084802467,-325474
1669114619,206427,true,1085019439,28,1084802467,-216972
1669114655,206427,true,1085019439,28,1084910948,-108491
1669114667,206428,true,1084910948,28,1084910948,0
1669114691,206428,true,1084910948,28,1085019439,108491
1669114703,206428,true,1084910948,28,1085019439,108491
1669114751,206428,true,1084910948,28,1085127941,216993
1669114775,206429,true,1084802467,28,1085236453,433986
1669114823,206428,true,1084910948,28,1085344977,434029
1669114847,206429,true,1084802467,28,1085453512,651045
1669115183,206428,true,1084910948,28,1086322178,1411230
1669115387,206429,true,1084802467,28,1086974135,2171668
1669116179,206428,true,1084910948,28,1088932352,4021404
1669116203,206428,true,1084910948,28,1089041245,4130297
1669116311,206428,true,1084910948,28,1089150149,4239201
1669116347,206428,true,1084910948,28,1089259064,4348116
1669116803,206428,true,1084910948,28,1089150149,4239201
1669116815,206427,true,1085019439,28,1089150149,4130710
1669116851,206427,true,1085019439,28,1089150149,4130710
1669116863,206427,true,1085019439,28,1089041245,4021806
1669116875,206426,true,1085127941,28,1089041245,3913304
1669117019,206426,true,1085127941,28,1088823470,3695529
1669117043,206425,true,1085236453,28,1088823470,3587017
1669117079,206426,true,1085127941,28,1088714598,3586657
1669117103,206425,true,1085236453,28,1088714598,3478145
1669117115,206425,true,1085236453,28,1088605738,3369285
1669117307,206425,true,1085236453,28,1088170404,2933951
1669117379,206426,true,1085127941,28,1087952803,2824862
1669117511,206425,true,1085236453,28,1087626482,2390029
1669117643,206425,true,1085236453,28,1087300260,2063807
1669117703,206425,true,1085236453,28,1087082832,1846379
1669117871,206426,true,1085127941,28,1086648108,1520167
1669118231,206425,true,1085236453,28,1085779180,542727
1669118615,206426,true,1085127941,28,1085019439,-108502
1669118663,206426,true,1085127941,28,1084910948,-216993
1669118795,206426,true,1085127941,28,1084802467,-325474
1669118807,206426,true,1085127941,28,1084802467,-325474
1669118831,206427,true,1085019439,28,1084693998,-325441
1669118843,206427,true,1085019439,28,1084693998,-325441
1669119071,206428,true,1084910948,28,1084368655,-542293
1669119083,206428,true,1084910948,28,1084368655,-542293
1669119215,206429,true,1084802467,28,1084043409,-759058
1669119227,206429,true,1084802467,28,1084043409,-759058
1669119251,206431,true,1084585539,28,1083935016,-650523
1669119263,206431,true,1084585539,28,1083935016,-650523
1669119311,206430,true,1084693998,28,1084043409,-650589
1669119323,206430,true,1084693998,28,1084043409,-650589
1669119347,206429,true,1084802467,28,1084043409,-759058
1669119359,206429,true,1084802467,28,1084043409,-759058
1669119407,206427,true,1085019439,28,1084260229,-759210
1669119431,206426,true,1085127941,28,1084368655,-759286
1669119527,206425,true,1085236453,28,1084802467,-433986
1669120115,206425,true,1085236453,28,1087082832,1846379
1669120199,206423,true,1085453512,28,1087408990,1955478
1669120235,206422,true,1085562057,28,1087517730,1955673
1669120319,206421,true,1085670613,28,1087735245,2064632
1669120703,206421,true,1085670613,28,1089150149,3479536
1669120835,206420,true,1085779180,28,1089912783,4133603
1669121375,206419,true,1085887758,28,1091439653,5551895
1669121543,206418,true,1085996347,28,1091439653,5443306
1669121555,206418,true,1085996347,28,1091439653,5443306
1669121855,206417,true,1086104947,28,1091657952,5553005
1669121891,206416,true,1086213557,28,1091657952,5444395
1669121915,206416,true,1086213557,28,1091767118,5553561
1669121927,206416,true,1086213557,28,1091767118,5553561
1669121939,206415,true,1086322178,28,1091767118,5444940
1669122107,206413,true,1086539454,28,1092313111,5773657
1669122167,206413,true,1086539454,28,1092531584,5992130
1669122491,206413,true,1086539454,28,1093952728,7413274
1669122503,206411,true,1086756772,28,1094062123,7305351
1669122515,206410,true,1086865448,28,1094062123,7196675
1669122527,206409,true,1086974135,28,1094171529,7197394
1669122575,206408,true,1087082832,28,1094390375,7307543
1669122587,206407,true,1087191540,28,1094499814,7308274
1669122599,206405,true,1087408990,28,1094499814,7090824
1669122611,206404,true,1087517730,28,1094609264,7091534
1669122623,206403,true,1087626482,28,1094718725,7092243
1669122683,206401,true,1087844018,28,1095156678,7312660
1669122707,206398,true,1088170404,28,1095375720,7205316
1669122731,206398,true,1088170404,28,1095485258,7314854
1669122743,206396,true,1088388049,28,1095594806,7206757
1669122755,206394,true,1088605738,28,1095704366,7098628
1669122779,206391,true,1088932352,28,1096033110,7100758
1669122911,206389,true,1089150149,28,1097458808,8308659
1669122935,206387,true,1089367990,28,1097788079,8420089
1669123091,206384,true,1089694833,28,1099985742,10290909
1669123103,206381,true,1090021775,28,1100095740,10073965
1669123115,206378,true,1090348814,28,1100315771,9966957
1669123127,206376,true,1090566894,28,1100425802,9858908
1669123151,206373,true,1090894097,28,1100755963,9861866
1669123163,206370,true,1091221398,28,1100866038,9644640
1669123223,206367,true,1091548797,28,1101636876,10088079
1669123295,206365,true,1091767118,28,1102518494,10751376
1669123511,206362,true,1092094681,28,1104946583,12851902
1669123739,206359,true,1092422342,28,1107490758,15068416
1669123787,206356,true,1092750102,28,1108044614,15294512
1669124003,206354,true,1092968663,28,1110373836,17405173
1669124015,206351,true,1093296586,28,1110484873,17188287
1669124063,206348,true,1093624608,28,1111040227,17415619
1669124075,206345,true,1093952728,28,1111262446,17309718
1669124135,206342,true,1094280947,28,1111929370,17648423
1669124147,206339,true,1094609264,28,1112040563,17431299
1669124183,206336,true,1094937679,28,1112374209,17436530
1669124231,206334,true,1095156678,28,1112930507,17773829
1669124255,206332,true,1095375720,28,1113153104,17777384
1669124267,206329,true,1095704366,28,1113264420,17560054
1669124327,206326,true,1096033110,28,1113821163,17788053
1669125035,206324,true,1096252327,28,1115158484,18906157
1669125047,206322,true,1096471589,28,1115270000,18798411
1669125083,206319,true,1096800563,28,1115270000,18469437
1669125107,206316,true,1097129636,28,1115381527,18251891
1669125119,206314,true,1097349073,28,1115381527,18032454
1669125191,206311,true,1097678311,28,1115716175,18037864
1669125275,206307,true,1098117448,28,1116274144,18156696
1669125371,206304,true,1098446916,28,1116944076,18497160
1669125467,206301,true,1098776483,28,1117726172,18949689
1669125491,206298,true,1099106149,28,1117949728,18843579
1669125611,206294,true,1099545857,28,1118956285,19410428
1669125647,206291,true,1099875754,28,1119180088,19304334
1669125671,206288,true,1100205750,28,1119403935,19198185
1669126043,206285,true,1100535845,28,1122093596,21557751
1669126055,206281,true,1100976125,28,1122205806,21229681
1669126079,206277,true,1101416582,28,1122430258,21013676
1669126091,206275,true,1101636876,28,1122542501,20905625
1669126163,206270,true,1102187805,28,1123440849,21253044
1669126175,206265,true,1102739009,28,1123553194,20814185
1669126223,206262,true,1103069863,28,1124115083,21045220
1669126247,206259,true,1103400817,28,1124452351,21051534
1669126391,206255,true,1103842244,28,1126027608,22185364
1669126403,206250,true,1104394276,28,1126140210,21745934
1669126439,206247,true,1104725627,28,1126590734,21865107
1669126463,206245,true,1104946583,28,1126816064,21869481
1669126475,206240,true,1105499167,28,1126928745,21429578
1669126487,206235,true,1106052027,28,1127041438,20989411
1669126499,206232,true,1106383876,28,1127154142,20770266
1669126535,206230,true,1106605164,28,1127605071,20999907
1669126547,206225,true,1107158577,28,1127717832,20559255
1669126595,206221,true,1107601507,28,1128056181,20454674
1669126967,206218,true,1107933821,28,1130427470,22493649
1669127147,206216,true,1108155418,28,1130766632,22611214
1669127471,206211,true,1108709607,28,1130427470,21717863
1669127675,206207,true,1109153157,28,1129975412,20822255
1669127687,206204,true,1109485936,28,1129975412,20489476
1669127699,206202,true,1109707845,28,1129975412,20267567
1669127723,206197,true,1110262810,28,1129862425,19599615
1669127807,206194,true,1110595922,28,1129636487,19040565
1669127843,206191,true,1110929134,28,1129523534,18594400
1669127867,206189,true,1111151331,28,1129410593,18259262
1669127939,206184,true,1111707018,28,1128846057,17139039
1669127951,206181,true,1112040563,28,1128846057,16805494
1669127963,206179,true,1112262982,28,1128733184,16470202
1669127975,206176,true,1112596695,28,1128620322,16023627
1669127987,206172,true,1113041800,28,1128507471,15465671
1669128275,206168,true,1113487084,28,1126252825,12765741
1669128599,206166,true,1113709792,28,1124677252,10967460
1669128695,206163,true,1114043938,28,1124227494,10183556
1669128935,206159,true,1114489623,28,1123328517,8838894
1669128959,206156,true,1114824003,28,1123216195,8392192
1669129343,206154,true,1115046979,28,1121757036,6710057
1669129403,206151,true,1115381527,28,1121644871,6263344
1669129451,206148,true,1115716175,28,1121532718,5816543
1669129463,206146,true,1115939329,28,1121420576,5481247
1669129487,206144,true,1116162528,28,1121420576,5258048
1669129511,206141,true,1116497410,28,1121420576,4923166
1669129631,206137,true,1116944076,28,1121420576,4476500
1669129691,206135,true,1117167476,28,1121420576,4253100
1669129931,206133,true,1117390921,28,1121981398,4590477
1669130279,206130,true,1117726172,28,1122767021,5040849
1669130291,206126,true,1118173329,28,1122879298,4705969
1669130303,206124,true,1118396975,28,1122879298,4482323
1669130675,206122,true,1118620666,28,1124227494,5606828
1669130699,206119,true,1118956285,28,1124339917,5383632
1669130975,206114,true,1119515875,28,1125464763,5948888
1669131035,206113,true,1119627827,28,1125689867,6062040
1669131167,206111,true,1119851764,28,1126140210,6288446
1669131215,206108,true,1120187753,28,1126252825,6065072
1669131251,206103,true,1120747959,28,1126365450,5617491
1669131263,206102,true,1120860034,28,1126365450,5505416
1669131587,206101,true,1120972120,28,1126590734,5618614
1669131839,206098,true,1121308445,28,1126816064,5507619
1669131851,206094,true,1121757036,28,1126816064,5059028
1669131887,206093,true,1121869211,28,1126816064,4946853
1669131899,206092,true,1121981398,28,1126816064,4834666
1669131923,206089,true,1122318026,28,1126816064,4498038
1669132151,206086,true,1122654755,28,1127041438,4386683
1669132163,206085,true,1122767021,28,1127041438,4274417
1669132211,206084,true,1122879298,28,1127041438,4162140
1669132223,206081,true,1123216195,28,1127154142,3937947
1669132235,206077,true,1123665549,28,1127154142,3488593
1669132307,206076,true,1123777915,28,1127266858,3488943
1669132331,206075,true,1123890293,28,1127379584,3489291
1669132343,206073,true,1124115083,28,1127379584,3264501
1669132367,206069,true,1124564796,28,1127492322,2927526
1669132403,206068,true,1124677252,28,1127605071,2927819
1669132463,206066,true,1124902199,28,1128056181,3153982
1669132475,206064,true,1125127191,28,1128056181,2928990
1669132487,206061,true,1125464763,28,1128168987,2704224
1669132535,206060,true,1125577309,28,1128394632,2817323
1669132619,206059,true,1125689867,28,1128733184,3043317
1669132643,206058,true,1125802436,28,1128846057,3043621
1669133015,206055,true,1126140210,28,1130540512,4400302
1669133171,206053,true,1126365450,28,1131445261,5079811
1669133207,206052,true,1126478086,28,1131671562,5193476
1669133219,206051,true,1126590734,28,1131671562,5080828
1669133231,206048,true,1126928745,28,1131784729,4855984
1669133267,206047,true,1127041438,28,1131897907,4856469
1669133291,206046,true,1127154142,28,1132011097,4856955
1669133483,206045,true,1127266858,28,1132690474,5423616
1669133615,206042,true,1127605071,28,1133143618,5538547
1669133663,206041,true,1127717832,28,1133370258,5652426
1669133819,206041,true,1127717832,28,1133710303,5992471
1669134383,206041,true,1127717832,28,1133256932,5539100
1669134875,206038,true,1128056181,28,1131897907,3841726
1669135715,206038,true,1128056181,28,1130766632,2710451
1669135727,206037,true,1128168987,28,1130766632,2597645
1669135799,206037,true,1128168987,28,1130653566,2484579
1669135871,206034,true,1128507471,28,1130653566,2146095
1669135907,206034,true,1128507471,28,1130653566,2146095
1669135943,206033,true,1128620322,28,1130540512,1920190
1669136243,206032,true,1128733184,28,1130314438,1581254
1669136279,206030,true,1128958942,28,1130314438,1355496
1669136327,206029,true,1129071838,28,1130201418,1129580
1669136531,206028,true,1129184745,28,1130088409,903664
1669137551,206028,true,1129184745,28,1129071838,-112907
1669137611,206027,true,1129297664,28,1129071838,-225826
1669137635,206027,true,1129297664,28,1129071838,-225826
1669137695,206027,true,1129297664,28,1129071838,-225826
1669137755,206028,true,1129184745,28,1128958942,-225803
1669137791,206026,true,1129410593,28,1128958942,-451651
1669137851,206027,true,1129297664,28,1128846057,-451607
1669137863,206028,true,1129184745,28,1128846057,-338688
1669137935,206028,true,1129184745,28,1128733184,-451561
1669138211,206028,true,1129184745,28,1128281804,-902941
1669138391,206029,true,1129071838,28,1127943387,-1128451
1669138415,206029,true,1129071838,28,1127943387,-1128451
1669138439,206030,true,1128958942,28,1127830604,-1128338
1669138667,206032,true,1128733184,28,1127041438,-1691746
1669138715,206033,true,1128620322,28,1126816064,-1804258
1669138727,206034,true,1128507471,28,1126816064,-1691407
1669138739,206035,true,1128394632,28,1126816064,-1578568
1669138943,206036,true,1128281804,28,1125915016,-2366788
1669139135,206037,true,1128168987,28,1125239704,-2929283
1669139231,206038,true,1128056181,28,1124902199,-3153982
1669139255,206039,true,1127943387,28,1124789720,-3153667
1669139651,206040,true,1127830604,28,1123103885,-4726719
1669139843,206041,true,1127717832,28,1122542501,-5175331
1669139927,206042,true,1127605071,28,1122318026,-5287045
1669139939,206042,true,1127605071,28,1122318026,-5287045
1669139951,206043,true,1127492322,28,1122318026,-5174296
1669139963,206045,true,1127266858,28,1122205806,-5061052
1669139975,206045,true,1127266858,28,1122205806,-5061052
1669140011,206045,true,1127266858,28,1121981398,-5285460
1669140059,206047,true,1127041438,28,1121757036,-5284402
1669140191,206048,true,1126928745,28,1121084217,-5844528
1669140215,206048,true,1126928745,28,1120972120,-5956625
1669140227,206049,true,1126816064,28,1120972120,-5843944
1669140287,206050,true,1126703393,28,1120860034,-5843359
1669140443,206050,true,1126703393,28,1120523843,-6179550
1669140467,206050,true,1126703393,28,1120411802,-6291591
1669140551,206051,true,1126590734,28,1120411802,-6178932
1669140587,206051,true,1126590734,28,1120523843,-6066891
1669140731,206051,true,1126590734,28,1120635895,-5954839
1669140767,206050,true,1126703393,28,1120747959,-5955434
1669141619,206050,true,1126703393,28,1121981398,-4721995
1669142171,206050,true,1126703393,28,1123665549,-3037844
1669142231,206050,true,1126703393,28,1123777915,-2925478
1669142243,206049,true,1126816064,28,1123890293,-2925771
1669142267,206049,true,1126816064,28,1123890293,-2925771
1669142579,206050,true,1126703393,28,1123553194,-3150199
1669142591,206049,true,1126816064,28,1123440849,-3375215
1669142747,206049,true,1126816064,28,1123216195,-3599869
1669142831,206049,true,1126816064,28,1123103885,-3712179
1669142903,206050,true,1126703393,28,1122879298,-3824095
1669142951,206049,true,1126816064,28,1122879298,-3936766
1669143047,206049,true,1126816064,28,1122654755,-4161309
1669143095,206050,true,1126703393,28,1122542501,-4160892
1669143167,206051,true,1126590734,28,1122542501,-4048233
1669143323,206051,true,1126590734,28,1122318026,-4272708
1669143335,206051,true,1126590734,28,1122318026,-4272708
1669143407,206051,true,1126590734,28,1122318026,-4272708
1669143443,206052,true,1126478086,28,1122318026,-4160060
1669143659,206051,true,1126590734,28,1122318026,-4272708
1669144103,206051,true,1126590734,28,1122542501,-4048233
1669144307,206052,true,1126478086,28,1122991585,-3486501
1669144511,206053,true,1126365450,28,1123328517,-3036933
1669144559,206052,true,1126478086,28,1123553194,-2924892
1669144703,206052,true,1126478086,28,1124115083,-2363003
1669144727,206052,true,1126478086,28,1124227494,-2250592
1669144931,206053,true,1126365450,28,1125239704,-1125746
1669144967,206051,true,1126590734,28,1125352228,-1238506
1669144979,206051,true,1126590734,28,1125352228,-1238506
1669145015,206051,true,1126590734,28,1125464763,-1125971
1669145087,206052,true,1126478086,28,1125802436,-675650
1669145123,206050,true,1126703393,28,1125915016,-788377
1669145147,206050,true,1126703393,28,1126027608,-675785
1669145279,206050,true,1126703393,28,1126703393,0
1669145375,206050,true,1126703393,28,1127154142,450749
1669145387,206049,true,1126816064,28,1127154142,338078
1669145411,206048,true,1126928745,28,1127266858,338113
1669145423,206048,true,1126928745,28,1127266858,338113
1669145615,206050,true,1126703393,28,1127830604,1127211
1669145687,206049,true,1126816064,28,1128056181,1240117
1669145771,206049,true,1126816064,28,1128394632,1578568
1669146047,206049,true,1126816064,28,1129071838,2255774
1669146131,206051,true,1126590734,28,1129297664,2706930
1669146419,206050,true,1126703393,28,1129749450,3046057
1669146467,206051,true,1126590734,28,1129749450,3158716
1669146503,206052,true,1126478086,28,1129749450,3271364
1669146743,206053,true,1126365450,28,1129523534,3158084
1669148759,206054,true,1126252825,28,1126703393,450568
1669148927,206054,true,1126252825,28,1126816064,563239
1669149035,206055,true,1126140210,28,1126928745,788535
1669149059,206056,true,1126027608,28,1126928745,901137
1669149119,206056,true,1126027608,28,1127041438,1013830
1669150883,206056,true,1126027608,28,1128620322,2592714
1669150979,206057,true,1125915016,28,1128620322,2705306
1669151015,206059,true,1125689867,28,1128620322,2930455
1669151063,206058,true,1125802436,28,1128620322,2817886
1669151195,206058,true,1125802436,28,1128394632,2592196
1669151255,206059,true,1125689867,28,1128394632,2704765
1669151279,206061,true,1125464763,28,1128281804,2817041
1669151711,206060,true,1125577309,28,1127492322,1915013
1669152671,206061,true,1125464763,28,1125577309,112546
1669153823,206061,true,1125464763,28,1125127191,-337572
1669153859,206063,true,1125239704,28,1125239704,0
1669153907,206062,true,1125352228,28,1125239704,-112524
1669153919,206062,true,1125352228,28,1125239704,-112524
1669153931,206062,true,1125352228,28,1125239704,-112524
1669153943,206064,true,1125127191,28,1125239704,112513
1669154051,206063,true,1125239704,28,1125352228,112524
1669154063,206063,true,1125239704,28,1125352228,112524
1669154351,206063,true,1125239704,28,1125802436,562732
1669154807,206065,true,1125014689,28,1126478086,1463397
1669155863,206063,true,1125239704,28,1128620322,3380618
1669155923,206063,true,1125239704,28,1128620322,3380618
1669156079,206063,true,1125239704,28,1128620322,3380618
1669156151,206065,true,1125014689,28,1128620322,3605633
1669157135,206063,true,1125239704,28,1128507471,3267767
1669157267,206064,true,1125127191,28,1128394632,3267441
1669157315,206063,true,1125239704,28,1128394632,3154928
1669157327,206065,true,1125014689,28,1128394632,3379943
1669157351,206063,true,1125239704,28,1128394632,3154928
1669157387,206063,true,1125239704,28,1128394632,3154928
1669157459,206062,true,1125352228,28,1128394632,3042404
1669157591,206063,true,1125239704,28,1128507471,3267767
1669157603,206062,true,1125352228,28,1128507471,3155243
1669157639,206062,true,1125352228,28,1128620322,3268094
1669157651,206061,true,1125464763,28,1128620322,3155559
1669157663,206061,true,1125464763,28,1128620322,3155559
1669157675,206059,true,1125689867,28,1128620322,2930455
1669157699,206059,true,1125689867,28,1128733184,3043317
1669157807,206057,true,1125915016,28,1129071838,3156822
1669158587,206057,true,1125915016,28,1132011097,6096081
1669158779,206055,true,1126140210,28,1132690474,6550264
1669159019,206055,true,1126140210,28,1133596943,7456733
1669159787,206053,true,1126365450,28,1134844524,8479074
1669160243,206053,true,1126365450,28,1134844524,8479074
1669160699,206051,true,1126590734,28,1134731050,8140316
1669161611,206050,true,1126703393,28,1135298529,8595136
1669161695,206049,true,1126816064,28,1135298529,8482465
1669162643,206048,true,1126928745,28,1135752717,8823972
1669162991,206046,true,1127154142,28,1135752717,8598575
1669163123,206045,true,1127266858,28,1136093477,8826619
1669163291,206043,true,1127492322,28,1136661637,9169315
1669163303,206042,true,1127605071,28,1136661637,9056566
1669163543,206039,true,1127943387,28,1137343805,9400418
1669163555,206038,true,1128056181,28,1137457539,9401358
1669163567,206035,true,1128394632,28,1137457539,9062907
1669163591,206034,true,1128507471,28,1137457539,8950068
1669163603,206032,true,1128733184,28,1137571285,8838101
1669163723,206031,true,1128846057,28,1137798810,8952753
1669163735,206029,true,1129071838,28,1137798810,8726972
1669163759,206028,true,1129184745,28,1137798810,8614065
1669163795,206027,true,1129297664,28,1137912590,8614926
1669163999,206026,true,1129410593,28,1138026382,8615789
1669164323,206025,true,1129523534,28,1138253998,8730464
1669164503,206024,true,1129636487,28,1138367824,8731337
1669165379,206023,true,1129749450,28,1136775303,7025853
1669165403,206022,true,1129862425,28,1136775303,6912878
1669165595,206021,true,1129975412,28,1136093477,6118065
1669165607,206020,true,1130088409,28,1136093477,6005068
1669166063,206019,true,1130201418,28,1134958008,4756590
1669166099,206019,true,1130201418,28,1134844524,4643106
1669166219,206017,true,1130427470,28,1134504138,4076668
1669166519,206016,true,1130540512,28,1133823674,3283162
1669166555,206016,true,1130540512,28,1133710303,3169791
1669166615,206015,true,1130653566,28,1133596943,2943377
1669166651,206014,true,1130766632,28,1133483595,2716963
1669166675,206013,true,1130879708,28,1133370258,2490550
1669167059,206013,true,1130879708,28,1132124298,1244590
1669168151,206013,true,1130879708,28,1130201418,-678290
1669168883,206011,true,1131105896,28,1129862425,-1243471
1669168931,206011,true,1131105896,28,1129862425,-1243471
1669169003,206011,true,1131105896,28,1129862425,-1243471
1669169159,206011,true,1131105896,28,1129975412,-1130484
1669169267,206010,true,1131219006,28,1129975412,-1243594
1669169375,206009,true,1131332128,28,1129975412,-1356716
1669169567,206009,true,1131332128,28,1129975412,-1356716
1669169771,206009,true,1131332128,28,1129975412,-1356716
1669169795,206008,true,1131445261,28,1129975412,-1469849
1669169819,206008,true,1131445261,28,1129975412,-1469849
1669169831,206009,true,1131332128,28,1129975412,-1356716
1669169843,206009,true,1131332128,28,1129975412,-1356716
1669169867,206008,true,1131445261,28,1130088409,-1356852
1669169891,206007,true,1131558406,28,1130088409,-1469997
1669170011,206007,true,1131558406,28,1130540512,-1017894
1669170083,206007,true,1131558406,28,1130879708,-678698
1669170095,206006,true,1131671562,28,1130992796,-678766
1669170215,206005,true,1131784729,28,1131897907,113178
1669170275,206004,true,1131897907,28,1132463969,566062
1669170323,206003,true,1132011097,28,1132803743,792646
1669170443,206002,true,1132124298,28,1133937056,1812758
1669170455,206000,true,1132350734,28,1134050450,1699716
1669170467,205999,true,1132463969,28,1134163855,1699886
1669170479,205997,true,1132690474,28,1134390699,1700225
1669170539,205994,true,1133030315,28,1135298529,2268214
1669170563,205991,true,1133370258,28,1135639153,2268895
1669170695,205989,true,1133596943,28,1137798810,4201867
1669170767,205988,true,1133710303,28,1138937121,5226818
1669170803,205984,true,1134163855,28,1139506704,5342849
1669170827,205981,true,1134504138,28,1139848590,5344452
1669170887,205979,true,1134731050,28,1140874864,6143814
1669170911,205978,true,1134844524,28,1141217161,6372637
1669171283,205973,true,1135412059,28,1147969906,12557847
1669171691,205971,true,1135639153,28,1154878083,19238930
1669171955,205969,true,1135866292,28,1158116111,22249819
1669171991,205968,true,1135979879,28,1158463581,22483702
1669172015,205963,true,1136547982,28,1158695285,22147303
1669172039,205961,true,1136775303,28,1158927036,22151733
1669172183,205959,true,1137002670,28,1160086484,23083814
1669172315,205957,true,1137230082,28,1160782710,23552628
1669172411,205953,true,1137685042,28,1160898789,23213747
1669172495,205950,true,1138026382,28,1161014879,22988497
1669172507,205948,true,1138253998,28,1161014879,22760881
1669172519,205946,true,1138481660,28,1161014879,22533219
1669172531,205942,true,1138937121,28,1161014879,22077758
1669172771,205939,true,1139278837,28,1161130980,21852143
1669172843,205937,true,1139506704,28,1161014879,21508175
1669172903,205935,true,1139734617,28,1161014879,21280262
1669172927,205931,true,1140190579,28,1160898789,20708210
1669173047,205928,true,1140532670,28,1160782710,20250040
1669173083,205926,true,1140760788,28,1160782710,20021922
1669173395,205925,true,1140874864,28,1160782710,19907846
1669173599,205920,true,1141445416,28,1160666644,19221228
1669173611,205918,true,1141673716,28,1160666644,18992928
1669174631,205916,true,1141902062,28,1160666644,18764582
1669174787,205915,true,1142016253,28,1160666644,18650391
1669174991,205910,true,1142587375,28,1160666644,18079269
1669175291,205908,true,1142815904,28,1160666644,17850740
1669175327,205906,true,1143044478,28,1160782710,17738232
1669175351,205905,true,1143158783,28,1160782710,17623927
1669175555,205900,true,1143730477,28,1161130980,17400503
1669175567,205897,true,1144073630,28,1161130980,17057350
1669175603,205895,true,1144302456,28,1161247093,16944637
1669175999,205894,true,1144416887,28,1162060210,17643323
1669176011,205889,true,1144989209,28,1162060210,17071001
1669176023,205886,true,1145332741,28,1162060210,16727469
1669176059,205884,true,1145561819,28,1162176416,16614597
1669176071,205882,true,1145790942,28,1162292634,16501692
1669176095,205878,true,1146249327,28,1162292634,16043307
1669176479,205875,true,1146593237,28,1163571795,16978558
1669176611,205874,true,1146707896,28,1163920901,17213005
1669176755,205872,true,1146937249,28,1164386540,17449291
1669176923,205868,true,1147396093,28,1164968849,17572756
1669177139,205865,true,1147740346,28,1165551450,17811104
1669177679,205864,true,1147855120,28,1166134343,18279223
1669177823,205862,true,1148084703,28,1166250956,18166253
1669177883,205858,true,1148544005,28,1166250956,17706951
1669178063,205856,true,1148773726,28,1166134343,17360617
1669178135,205854,true,1149003492,28,1166134343,17130851
1669178339,205853,true,1149118392,28,1166017741,16899349
1669178351,205849,true,1149578109,28,1165901151,16323042
1669180199,205847,true,1149808036,28,1164037294,14229258
1669180211,205845,true,1150038009,28,1164037294,13999285
1669180271,205844,true,1150153013,28,1164037294,13884281
1669180475,205840,true,1150613143,28,1163920901,13307758
1669181543,205839,true,1150728204,28,1163106483,12378279
1669181555,205839,true,1150728204,28,1163106483,12378279
1669181759,205837,true,1150958361,28,1162873896,11915535
1669182131,205834,true,1151303683,28,1162757620,11453937
1669182575,205832,true,1151533956,28,1162641356,11107400
1669182803,205832,true,1151533956,28,1162641356,11107400
1669183043,205830,true,1151764274,28,1162641356,10877082
1669183055,205826,true,1152225049,28,1162641356,10416307
1669183091,205825,true,1152340271,28,1162641356,10301085
1669183235,205825,true,1152340271,28,1162525104,10184833
1669183559,205823,true,1152570751,28,1161944016,9373265
1669186319,205819,true,1153031848,28,1159738528,6706680
1669186703,205818,true,1153147151,28,1159738528,6591377
1669187723,205817,true,1153262466,28,1159738528,6476062
1669188419,205816,true,1153377792,28,1159738528,6360736
1669188839,205812,true,1153839213,28,1159738528,5899315
1669188875,205811,true,1153954597,28,1159854502,5899905
1669189055,205809,true,1154185399,28,1160202493,6017094
1669189451,205807,true,1154416248,28,1161130980,6714732
1669189523,205802,true,1154993571,28,1161247093,6253522
1669190039,205801,true,1155109071,28,1162408863,7299792
1669190435,205799,true,1155340104,28,1163339116,7999012
1669190447,205797,true,1155571184,28,1163455449,7884265
1669190483,205792,true,1156149085,28,1163571795,7422710
1669190495,205790,true,1156380326,28,1163571795,7191469
1669190507,205788,true,1156611614,28,1163571795,6960181
1669190663,205785,true,1156958632,28,1164270113,7311481
1669190723,205780,true,1157537227,28,1164502978,6965751
1669190771,205779,true,1157652981,28,1164619429,6966448
1669190915,205776,true,1158000311,28,1164735891,6735580
1669191371,205774,true,1158231923,28,1165318375,7086452
1669191419,205769,true,1158811155,28,1165434907,6623752
1669191599,205767,true,1159042929,28,1165551450,6508521
1669191767,205765,true,1159274749,28,1165551450,6276701
1669191803,205763,true,1159506615,28,1165551450,6044835
1669191827,205758,true,1160086484,28,1165551450,5464966
1669192007,205757,true,1160202493,28,1165434907,5232414
1669192355,205755,true,1160434545,28,1165085346,4650801
1669192799,205753,true,1160666644,28,1164153697,3487053
1669192859,205749,true,1161130980,28,1164037294,2906314
1669193207,205748,true,1161247093,28,1163455449,2208356
1669193339,205746,true,1161479354,28,1163339116,1859762
1669193759,205745,true,1161595502,28,1162990184,1394682
1669194203,205741,true,1162060210,28,1162990184,929974
1669194407,205740,true,1162176416,28,1163106483,930067
1669194503,205740,true,1162176416,28,1163106483,930067
1669194527,205739,true,1162292634,28,1163106483,813849
1669194839,205735,true,1162757620,28,1163222793,465173
1669195067,205735,true,1162757620,28,1163339116,581496
1669195115,205735,true,1162757620,28,1163339116,581496
1669195295,205734,true,1162873896,28,1163339116,465220
1669195331,205732,true,1163106483,28,1163455449,348966
1669195427,205733,true,1162990184,28,1163455449,465265
1669195547,205733,true,1162990184,28,1163571795,581611
1669195895,205732,true,1163106483,28,1163688152,581669
1669196363,205731,true,1163222793,28,1164153697,930904
1669196915,205731,true,1163222793,28,1164386540,1163747
1669196927,205731,true,1163222793,28,1164386540,1163747
1669196975,205731,true,1163222793,28,1164502978,1280185
1669196987,205730,true,1163339116,28,1164502978,1163862
1669197143,205730,true,1163339116,28,1164619429,1280313
1669197263,205730,true,1163339116,28,1164735891,1396775
1669197659,205729,true,1163455449,28,1165085346,1629897
1669198307,205728,true,1163571795,28,1165434907,1863112
1669198943,205729,true,1163455449,28,1165668005,2212556
1669198991,205729,true,1163455449,28,1165668005,2212556
1669199015,205728,true,1163571795,28,1165668005,2096210
1669199027,205727,true,1163688152,28,1165668005,1979853
1669199483,205727,true,1163688152,28,1165318375,1630223
1669200275,205727,true,1163688152,28,1164502978,814826
1669200599,205727,true,1163688152,28,1164153697,465545
1669200635,205726,true,1163804521,28,1164153697,349176
1669200647,205726,true,1163804521,28,1164153697,349176
1669200683,205726,true,1163804521,28,1164153697,349176
1669200695,205725,true,1163920901,28,1164153697,232796
1669200743,205723,true,1164153697,28,1164386540,232843
1669200815,205723,true,1164153697,28,1164735891,582194
1669201043,205723,true,1164153697,28,1165901151,1747454
1669201895,205721,true,1164386540,28,1169988750,5602210
1669202255,205719,true,1164619429,28,1171744962,7125533
1669202279,205719,true,1164619429,28,1171862136,7242707
1669202387,205719,true,1164619429,28,1172448184,7828755
1669202447,205718,true,1164735891,28,1172682686,7946795
1669202819,205716,true,1164968849,28,1172799954,7831105
1669202927,205716,true,1164968849,28,1172682686,7713837
1669202939,205715,true,1165085346,28,1172682686,7597340
1669202951,205714,true,1165201855,28,1172682686,7480831
1669202987,205713,true,1165318375,28,1172682686,7364311
1669203071,205714,true,1165201855,28,1172565429,7363574
1669203083,205713,true,1165318375,28,1172565429,7247054
1669203287,205712,true,1165434907,28,1172330951,6896044
1669203347,205711,true,1165551450,28,1172330951,6779501
1669203395,205711,true,1165551450,28,1172330951,6779501
1669203479,205711,true,1165551450,28,1172213730,6662280
1669203911,205710,true,1165668005,28,1172565429,6897424
1669203959,205708,true,1165901151,28,1172682686,6781535
1669204067,205709,true,1165784572,28,1172682686,6898114
1669204511,205709,true,1165784572,28,1173034526,7249954
1669204763,205707,true,1166017741,28,1173269144,7251403
1669205255,205706,true,1166134343,28,1174090679,7956336
1669205291,205707,true,1166017741,28,1174090679,8072938
1669206251,205706,true,1166134343,28,1174090679,7956336
1669206815,205705,true,1166250956,28,1174090679,7839723
1669206971,205704,true,1166367581,28,1174090679,7723098
1669207043,205704,true,1166367581,28,1174090679,7723098
1669207223,205704,true,1166367581,28,1174090679,7723098
1669207247,205702,true,1166600866,28,1174090679,7489813
1669207259,205701,true,1166717526,28,1174090679,7373153
1669207283,205701,true,1166717526,28,1173973282,7255756
1669207391,205701,true,1166717526,28,1173855896,7138370
1669207415,205700,true,1166834198,28,1173855896,7021698
1669207427,205699,true,1166950882,28,1173855896,6905014
1669207499,205699,true,1166950882,28,1173621160,6670278
1669207583,205699,true,1166950882,28,1173386471,6435589
1669207679,205698,true,1167067577,28,1173151829,6084252
1669207691,205697,true,1167184283,28,1173151829,5967546
1669207859,205697,true,1167184283,28,1172565429,5381146
1669208063,205697,true,1167184283,28,1171744962,4560679
1669208111,205696,true,1167301002,28,1171627799,4326797
1669208159,205695,true,1167417732,28,1171393508,3975776
1669208399,205696,true,1167301002,28,1170573861,3272859
1669208423,205696,true,1167301002,28,1170456815,3155813
1669208711,205694,true,1167534474,28,1169287002,1752528
1669208735,205693,true,1167651227,28,1169170085,1518858
1669208747,205694,true,1167534474,28,1169053180,1518706
1669208771,205694,true,1167534474,28,1168936286,1401812
1669208879,205692,true,1167767992,28,1168468828,700836
1669209707,205691,true,1167884769,28,1166017741,-1867028
1669209995,205692,true,1167767992,28,1165668005,-2099987
1669210007,205692,true,1167767992,28,1165668005,-2099987
1669210055,205692,true,1167767992,28,1165551450,-2216542
1669210103,205691,true,1167884769,28,1165551450,-2333319
1669210343,205692,true,1167767992,28,1165201855,-2566137
1669210943,205692,true,1167767992,28,1164852364,-2915628
1669210967,205691,true,1167884769,28,1164735891,-3148878
1669211171,205691,true,1167884769,28,1164735891,-3148878
1669211183,205692,true,1167767992,28,1164735891,-3032101
1669211195,205692,true,1167767992,28,1164735891,-3032101
1669211219,205692,true,1167767992,28,1164735891,-3032101
1669211267,205692,true,1167767992,28,1164619429,-3148563
1669211279,205693,true,1167651227,28,1164619429,-3031798
1669211327,205694,true,1167534474,28,1164502978,-3031496
1669211639,205694,true,1167534474,28,1163920901,-3613573
1669211687,205694,true,1167534474,28,1163804521,-3729953
1669211735,205695,true,1167417732,28,1163688152,-3729580
1669211747,205695,true,1167417732,28,1163688152,-3729580
1669211843,205695,true,1167417732,28,1163455449,-3962283
1669211879,205695,true,1167417732,28,1163339116,-4078616
1669211903,205696,true,1167301002,28,1163339116,-3961886
1669211915,205696,true,1167301002,28,1163222793,-4078209
1669211939,205696,true,1167301002,28,1163222793,-4078209
1669212431,205696,true,1167301002,28,1161363218,-5937784
1669213031,205697,true,1167184283,28,1159158833,-8025450
1669213187,205698,true,1167067577,28,1158811155,-8256422
1669213571,205698,true,1167067577,28,1158116111,-8951466
1669214003,205698,true,1167067577,28,1157884523,-9183054
1669214315,205699,true,1166950882,28,1157884523,-9066359
1669214663,205699,true,1166950882,28,1157884523,-9066359
1669214687,205699,true,1166950882,28,1157884523,-9066359
1669214711,205700,true,1166834198,28,1158000311,-8833887
1669215047,205700,true,1166834198,28,1158463581,-8370617
1669215119,205700,true,1166834198,28,1158579427,-8254771
1669215167,205700,true,1166834198,28,1158695285,-8138913
1669215215,205701,true,1166717526,28,1158811155,-7906371
1669215227,205701,true,1166717526,28,1158811155,-7906371
1669215275,205701,true,1166717526,28,1158927036,-7790490
1669215431,205701,true,1166717526,28,1159506615,-7210911
1669215767,205701,true,1166717526,28,1160550589,-6166937
1669215791,205701,true,1166717526,28,1160666644,-6050882
1669215803,205701,true,1166717526,28,1160666644,-6050882
1669215839,205701,true,1166717526,28,1160898789,-5818737
1669216475,205700,true,1166834198,28,1163920901,-2913297
1669216619,205701,true,1166717526,28,1164386540,-2330986
1669216679,205701,true,1166717526,28,1164502978,-2214548
1669216907,205701,true,1166717526,28,1165201855,-1515671
1669217207,205700,true,1166834198,28,1165784572,-1049626
1669217219,205701,true,1166717526,28,1165784572,-932954
1669218383,205701,true,1166717526,28,1164968849,-1748677
1669218431,205701,true,1166717526,28,1164968849,-1748677
1669218515,205701,true,1166717526,28,1164852364,-1865162
1669218527,205701,true,1166717526,28,1164735891,-1981635
1669218563,205701,true,1166717526,28,1164735891,-1981635
1669218575,205701,true,1166717526,28,1164735891,-1981635
1669218767,205701,true,1166717526,28,1164270113,-2447413
1669219499,205701,true,1166717526,28,1163106483,-3611043
1669220267,205702,true,1166600866,28,1161944016,-4656850
1669220483,205702,true,1166600866,28,1161944016,-4656850
1669220759,205704,true,1166367581,28,1161944016,-4423565
1669220783,205704,true,1166367581,28,1161944016,-4423565
1669220795,205705,true,1166250956,28,1161944016,-4306940
1669220807,205706,true,1166134343,28,1161944016,-4190327
1669221011,205707,true,1166017741,28,1161711662,-4306079
1669221083,205708,true,1165901151,28,1161711662,-4189489
1669221167,205709,true,1165784572,28,1161595502,-4189070
1669221371,205710,true,1165668005,28,1161363218,-4304787
1669221503,205711,true,1165551450,28,1161247093,-4304357
1669222511,205712,true,1165434907,28,1160086484,-5348423
1669222547,205713,true,1165318375,28,1160086484,-5231891
1669222559,205714,true,1165201855,28,1159970487,-5231368
1669222595,205715,true,1165085346,28,1159970487,-5114859
1669222607,205716,true,1164968849,28,1159970487,-4998362
1669222667,205717,true,1164852364,28,1159854502,-4997862
1669222691,205718,true,1164735891,28,1159738528,-4997363
1669222751,205719,true,1164619429,28,1159622566,-4996863
1669222787,205720,true,1164502978,28,1159506615,-4996363
1669222847,205722,true,1164270113,28,1159274749,-4995364
1669223099,205724,true,1164037294,28,1158347746,-5689548
1669223795,205725,true,1163920901,28,1155455638,-8465263
1669224035,205727,true,1163688152,28,1154531689,-9156463
1669224191,205729,true,1163455449,28,1153839213,-9616236
1669224431,205730,true,1163339116,28,1153031848,-10307268
1669224707,205732,true,1163106483,28,1152686008,-10420475
1669224731,205733,true,1162990184,28,1152686008,-10304176
1669225211,205735,true,1162757620,28,1152570751,-10186869
1669225499,205737,true,1162525104,28,1152570751,-9954353
1669225871,205739,true,1162292634,28,1152455505,-9837129
1669225895,205740,true,1162176416,28,1152455505,-9720911
1669226903,205742,true,1161944016,28,1152340271,-9603745
1669226951,205743,true,1161827833,28,1152455505,-9372328
1669227839,205745,true,1161595502,28,1153493130,-8102372
1669227863,205746,true,1161479354,28,1153608479,-7870875
1669227971,205747,true,1161363218,28,1153723840,-7639378
1669228103,205749,true,1161130980,28,1154069992,-7060988
1669228115,205750,true,1161014879,28,1154069992,-6944887
1669228199,205750,true,1161014879,28,1154416248,-6598631
1669228607,205751,true,1160898789,28,1156033481,-4865308
1669229867,205751,true,1160898789,28,1160086484,-812305
1669229891,205752,true,1160782710,28,1160202493,-580217
1669229939,205753,true,1160666644,28,1160202493,-464151
1669229951,205753,true,1160666644,28,1160318513,-348131
1669229963,205753,true,1160666644,28,1160318513,-348131
1669229975,205754,true,1160550589,28,1160318513,-232076
1669230059,205753,true,1160666644,28,1160782710,116066
1669230107,205753,true,1160666644,28,1160898789,232145
1669230119,205753,true,1160666644,28,1161014879,348235
1669230131,205754,true,1160550589,28,1161014879,464290
1669230143,205753,true,1160666644,28,1161130980,464336
1669230155,205752,true,1160782710,28,1161247093,464383
1669230167,205752,true,1160782710,28,1161247093,464383
1669230191,205752,true,1160782710,28,1161479354,696644
1669230203,205750,true,1161014879,28,1161595502,580623
1669230215,205749,true,1161130980,28,1161711662,580682
1669230251,205748,true,1161247093,28,1162060210,813117
1669230299,205747,true,1161363218,28,1162641356,1278138
1669230311,205746,true,1161479354,28,1162757620,1278266
1669230323,205744,true,1161711662,28,1162873896,1162234
1669230407,205742,true,1161944016,28,1164037294,2093278
1669230419,205742,true,1161944016,28,1164153697,2209681
1669230455,205740,true,1162176416,28,1164619429,2443013
1669230467,205738,true,1162408863,28,1164735891,2327028
1669230479,205737,true,1162525104,28,1164852364,2327260
1669230587,205736,true,1162641356,28,1166134343,3492987
1669230599,205734,true,1162873896,28,1166250956,3377060
1669230623,205733,true,1162990184,28,1166484218,3494034
1669230635,205731,true,1163222793,28,1166717526,3494733
1669230683,205731,true,1163222793,28,1167067577,3844784
1669230695,205729,true,1163455449,28,1167184283,3728834
1669230707,205728,true,1163571795,28,1167301002,3729207
1669230731,205726,true,1163804521,28,1167534474,3729953
1669230743,205726,true,1163804521,28,1167651227,3846706
1669230899,205724,true,1164037294,28,1168936286,4898992
1669231115,205723,true,1164153697,28,1170807987,6654290
1669231127,205721,true,1164386540,28,1170925068,6538528
1669231139,205721,true,1164386540,28,1171042161,6655621
1669231151,205719,true,1164619429,28,1171042161,6422732
1669231163,205718,true,1164735891,28,1171159265,6423374
1669231187,205717,true,1164852364,28,1171276381,6424017
1669231523,205716,true,1164968849,28,1173386471,8417622
1669231535,205715,true,1165085346,28,1173386471,8301125
1669231547,205714,true,1165201855,28,1173503810,8301955
1669231583,205713,true,1165318375,28,1173738522,8420147
1669231607,205713,true,1165318375,28,1173855896,8537521
1669231679,205712,true,1165434907,28,1174090679,8655772
1669232279,205712,true,1165434907,28,1171510648,6075741
1669232651,205711,true,1165551450,28,1169053180,3501730
1669232975,205711,true,1165551450,28,1167534474,1983024
1669233023,205711,true,1165551450,28,1167417732,1866282
1669233203,205711,true,1165551450,28,1166950882,1399432
1669234079,205710,true,1165668005,28,1166600866,932861
1669234295,205710,true,1165668005,28,1166600866,932861
1669234367,205710,true,1165668005,28,1166600866,932861
1669234391,205710,true,1165668005,28,1166600866,932861
1669234631,205709,true,1165784572,28,1166484218,699646
1669234859,205710,true,1165668005,28,1166250956,582951
1669235279,205710,true,1165668005,28,1166017741,349736
1669235303,205710,true,1165668005,28,1166017741,349736
1669235615,205710,true,1165668005,28,1165784572,116567
1669235627,205711,true,1165551450,28,1165784572,233122
1669235651,205710,true,1165668005,28,1165784572,116567
1669235963,205710,true,1165668005,28,1165668005,0
1669236035,205709,true,1165784572,28,1165784572,0
1669236923,205710,true,1165668005,28,1166950882,1282877
1669236959,205709,true,1165784572,28,1167067577,1283005
1669237079,205708,true,1165901151,28,1167301002,1399851
1669237199,205708,true,1165901151,28,1167651227,1750076
1669237211,205707,true,1166017741,28,1167651227,1633486
1669237355,205707,true,1166017741,28,1168001558,1983817
1669238495,205706,true,1166134343,28,1170105748,3971405
1669238531,205705,true,1166250956,28,1170222759,3971803
1669238735,205705,true,1166250956,28,1170690918,4439962
1669238915,205704,true,1166367581,28,1171042161,4674580
1669239023,205703,true,1166484218,28,1171276381,4792163
1669239455,205702,true,1166600866,28,1171744962,5144096
1669240247,205701,true,1166717526,28,1172799954,6082428
1669240475,205700,true,1166834198,28,1172799954,5965756
1669240631,205699,true,1166950882,28,1172799954,5849072
1669240703,205698,true,1167067577,28,1172799954,5732377
1669240751,205697,true,1167184283,28,1172799954,5615671
1669240775,205696,true,1167301002,28,1172799954,5498952
1669240787,205695,true,1167417732,28,1172799954,5382222
1669240823,205694,true,1167534474,28,1172682686,5148212
1669241027,205693,true,1167651227,28,1172565429,4914202
1669241627,205692,true,1167767992,28,1172213730,4445738
1669241735,205691,true,1167884769,28,1172096520,4211751
1669241843,205690,true,1168001558,28,1172096520,4094962
1669242371,205689,true,1168118358,28,1171862136,3743778
1669242395,205688,true,1168235170,28,1171862136,3626966
1669242407,205686,true,1168468828,28,1171862136,3393308
1669242443,205684,true,1168702534,28,1171744962,3042428
1669242479,205683,true,1168819404,28,1171744962,2925558
1669244363,205682,true,1168936286,28,1170807987,1871701
1669244531,205680,true,1169170085,28,1170807987,1637902
1669244543,205678,true,1169403931,28,1170925068,1521137
1669244675,205678,true,1169403931,28,1171159265,1755334
1669244699,205676,true,1169637823,28,1171276381,1638558
1669244735,205673,true,1169988750,28,1171393508,1404758
1669244771,205671,true,1170222759,28,1171510648,1287889
1669245035,205670,true,1170339781,28,1172330951,1991170
1669245167,205668,true,1170573861,28,1172682686,2108825
1669245455,205666,true,1170807987,28,1173621160,2813173
1669245479,205664,true,1171042161,28,1173621160,2578999
1669245983,205663,true,1171159265,28,1175500363,4341098
1669246031,205661,true,1171393508,28,1175735475,4341967
1669246067,205659,true,1171627799,28,1175970634,4342835
1669246175,205657,true,1171862136,28,1176558737,4696601
1669246187,205656,true,1171979322,28,1176558737,4579415
1669246235,205654,true,1172213730,28,1176911740,4698010
1669246259,205652,true,1172448184,28,1177029431,4581247
1669246307,205650,true,1172682686,28,1177382575,4699889
1669246367,205649,true,1172799954,28,1177618063,4818109
1669246847,205647,true,1173034526,28,1179503666,6469140
1669247027,205645,true,1173269144,28,1180211545,6942401
1669247051,205644,true,1173386471,28,1180329566,6943095
1669247147,205643,true,1173503810,28,1180683701,7179891
1669247159,205642,true,1173621160,28,1180683701,7062541
1669247219,205640,true,1173855896,28,1181037941,7182045
1669247267,205639,true,1173973282,28,1181156045,7182763
1669247279,205638,true,1174090679,28,1181274161,7183482
1669247807,205637,true,1174208088,28,1183165617,8957529
1669247963,205636,true,1174325509,28,1183638955,9313446
1669248191,205635,true,1174442942,28,1183875694,9432752
1669248275,205634,true,1174560386,28,1183994082,9433696
1669250183,205634,true,1174560386,28,1184349316,9788930
1669250195,205633,true,1174677842,28,1184349316,9671474
1669250435,205632,true,1174795310,28,1184349316,9554006
1669250771,205633,true,1174677842,28,1184112481,9434639
1669251083,205632,true,1174795310,28,1183994082,9198772
1669251167,205632,true,1174795310,28,1183994082,9198772
1669251419,205632,true,1174795310,28,1183757319,8962009
1669251431,205633,true,1174677842,28,1183757319,9079477
1669251479,205632,true,1174795310,28,1183757319,8962009
1669253639,205632,true,1174795310,28,1182929020,8133710
1669254119,205632,true,1174795310,28,1182929020,8133710
1669254143,205632,true,1174795310,28,1183047313,8252003
1669254179,205632,true,1174795310,28,1183047313,8252003
1669254191,205631,true,1174912789,28,1183047313,8134524
1669254227,205630,true,1175030281,28,1183283934,8253653
1669254287,205629,true,1175147784,28,1183520603,8372819
1669254443,205628,true,1175265298,28,1184349316,9084018
1669254575,205626,true,1175500363,28,1185178609,9678246
1669254635,205625,true,1175617913,28,1185415656,9797743
1669254695,205623,true,1175853049,28,1185771317,9918268
1669254707,205622,true,1175970634,28,1185889894,9919260
1669254827,205621,true,1176088231,28,1186601606,10513375
1669254935,205620,true,1176205840,28,1187195025,10989185
1669254959,205618,true,1176441093,28,1187313745,10872652
1669255019,205617,true,1176558737,28,1187788741,11230004
1669255091,205615,true,1176794060,28,1188382755,11588695
1669255247,205612,true,1177147134,28,1189809598,12662464
1669255259,205610,true,1177382575,28,1189928579,12546004
1669255391,205608,true,1177618063,28,1191357279,13739216
1669255463,205606,true,1177853599,28,1192072272,14218673
1669255487,205603,true,1178206990,28,1192429930,14222940
1669255523,205600,true,1178560488,28,1192906973,14346485
1669255811,205597,true,1178914091,28,1196371251,17457160
1669256003,205594,true,1179267801,28,1198646404,19378603
1669256387,205591,true,1179621616,28,1201286196,21664580
1669256711,205588,true,1179975538,28,1203450350,23474812
1669256783,205585,true,1180329566,28,1203811422,23481856
1669256795,205583,true,1180565644,28,1203931803,23366159
1669256915,205579,true,1181037941,28,1204172601,23134660
1669256975,205577,true,1181274161,28,1204293018,23018857
1669256999,205574,true,1181628578,28,1204413448,22784870
1669257935,205572,true,1181864916,28,1203570695,21705779
1669258799,205568,true,1182337733,28,1202488023,20150290
1669258823,205566,true,1182574212,28,1202488023,19913811
1669258859,205563,true,1182929020,28,1202488023,19559003
1669258871,205560,true,1183283934,28,1202488023,19204089
1669258907,205557,true,1183638955,28,1202488023,18849068
1669259003,205555,true,1183875694,28,1202488023,18612329
1669259039,205552,true,1184230893,28,1202367786,18136893
1669259087,205550,true,1184467751,28,1202367786,17900035
1669259195,205547,true,1184823126,28,1202247562,17424436
1669259975,205545,true,1185060103,28,1201286196,16226093
1669260503,205542,true,1185415656,28,1200925883,15510227
1669260695,205540,true,1185652751,28,1201045975,15393224
1669261091,205537,true,1186008483,28,1201526466,15517983
1669262507,205535,true,1186245696,28,1203330017,17084321
1669262855,205532,true,1186601606,28,1203330017,16728411
1669264103,205530,true,1186838938,28,1203330017,16491079
1669264175,205527,true,1187195025,28,1203330017,16134992
1669265615,205525,true,1187432476,28,1202367786,14935310
1669265843,205523,true,1187669974,28,1202247562,14577588
1669267991,205521,true,1187907520,28,1202127349,14219829
1669268147,205518,true,1188263928,28,1202127349,13863421
1669270163,205517,true,1188382755,28,1202127349,13744594
1669271495,205514,true,1188739305,28,1202127349,13388044
1669272311,205512,true,1188977065,28,1202127349,13150284
1669272443,205509,true,1189333794,28,1202127349,12793555
1669272935,205508,true,1189452727,28,1202127349,12674622
1669272947,205505,true,1189809598,28,1202127349,12317751
1669273127,205503,true,1190047572,28,1202247562,12199990
1669273151,205500,true,1190404622,28,1202247562,11842940
1669273163,205498,true,1190642715,28,1202247562,11604847
1669273175,205495,true,1190999944,28,1202367786,11367842
1669273331,205492,true,1191357279,28,1203089388,11732109
1669273391,205489,true,1191714722,28,1203330017,11615295
1669273403,205486,true,1192072272,28,1203450350,11378078
1669273475,205484,true,1192310699,28,1203811422,11500723
1669273523,205480,true,1192787695,28,1204172601,11384906
1669273691,205476,true,1193264881,28,1205136276,11871395
1669273847,205474,true,1193503546,28,1206221333,12717787
1669273967,205471,true,1193861633,28,1206945247,13083614
1669274003,205467,true,1194339249,28,1207186648,12847399
1669274015,205464,true,1194697587,28,1207186648,12489061
1669274123,205461,true,1195056032,28,1207790362,12734330
1669274291,205459,true,1195295055,28,1208756933,13461878
1669276379,205456,true,1195653680,28,1211903632,16249952
1669276547,205453,true,1196012412,28,1211903632,15891220
1669276643,205451,true,1196251626,28,1211903632,15652006
1669276667,205448,true,1196610537,28,1211903632,15293095
1669276703,205446,true,1196849871,28,1211903632,15053761
1669277075,205443,true,1197208962,28,1211297862,14088900
1669277207,205441,true,1197448416,28,1210934545,13486129
1669277219,205439,true,1197687918,28,1210813464,13125546
1669277231,205436,true,1198047260,28,1210813464,12766204
1669277267,205434,true,1198286882,28,1210692395,12405513
1669277363,205434,true,1198286882,28,1210329260,12042378
1669277399,205432,true,1198526551,28,1210208239,11681688
1669277447,205429,true,1198886145,28,1209966234,11080089
1669277483,205428,true,1199006033,28,1209845249,10839216
1669277507,205427,true,1199125934,28,1209724277,10598343
1669277795,205426,true,1199245847,28,1208394378,9148531
1669277855,205423,true,1199605656,28,1208031932,8426276
1669277903,205421,true,1199845589,28,1207790362,7944773
1669277975,205421,true,1199845589,28,1207548840,7703251
1669278263,205420,true,1199965574,28,1206100723,6135149
1669278275,205417,true,1200325600,28,1205980125,5654525
1669278299,205416,true,1200445632,28,1205859539,5413907
1669278323,205415,true,1200565677,28,1205738965,5173288
1669278443,205414,true,1200685733,28,1205136276,4450543
1669278467,205412,true,1200925883,28,1205015775,4089892
1669278491,205411,true,1201045975,28,1204895285,3849310
1669278503,205410,true,1201166080,28,1204895285,3729205
1669278611,205410,true,1201166080,28,1204172601,3006521
1669278767,205408,true,1201406325,28,1203209696,1803371
1669279091,205406,true,1201646618,28,1201526466,-120152
1669279355,205406,true,1201646618,28,1200445632,-1200986
1669280387,205406,true,1201646618,28,1197089253,-4557365
1669280807,205404,true,1201886960,28,1196730198,-5156762
1669281899,205402,true,1202127349,28,1196730198,-5397151
1669282055,205402,true,1202127349,28,1196730198,-5397151
1669282103,205402,true,1202127349,28,1196730198,-5397151
1669282187,205400,true,1202367786,28,1196849871,-5517915
1669282199,205398,true,1202608272,28,1196849871,-5758401
1669282355,205398,true,1202608272,28,1196969556,-5638716
1669282859,205397,true,1202728533,28,1197448416,-5280117
1669283027,205395,true,1202969091,28,1197568161,-5400930
1669283747,205395,true,1202969091,28,1198286882,-4682209
1669283879,205395,true,1202969091,28,1198406710,-4562381
1669284011,205395,true,1202969091,28,1198526551,-4442540
1669284023,205393,true,1203209696,28,1198526551,-4683145
1669284143,205393,true,1203209696,28,1198526551,-4683145
1669284263,205394,true,1203089388,28,1198526551,-4562837
1669284515,205394,true,1203089388,28,1198526551,-4562837
1669284671,205392,true,1203330017,28,1198646404,-4683613
1669285043,205391,true,1203450350,28,1198766268,-4684082
1669286027,205392,true,1203330017,28,1199245847,-4084170
1669286159,205392,true,1203330017,28,1199245847,-4084170
1669286243,205391,true,1203450350,28,1199245847,-4204503
1669286255,205391,true,1203450350,28,1199125934,-4324416
1669286267,205392,true,1203330017,28,1199125934,-4204083
1669286303,205393,true,1203209696,28,1199125934,-4083762
1669286315,205392,true,1203330017,28,1199125934,-4204083
1669286399,205393,true,1203209696,28,1199006033,-4203663
1669286543,205394,true,1203089388,28,1198766268,-4323120
1669286615,205395,true,1202969091,28,1198646404,-4322687
1669286711,205394,true,1203089388,28,1198526551,-4562837
1669286723,205396,true,1202848806,28,1198526551,-4322255
1669286831,205396,true,1202848806,28,1198286882,-4561924
1669286855,205398,true,1202608272,28,1198286882,-4321390
1669286903,205397,true,1202728533,28,1198167065,-4561468
1669286927,205398,true,1202608272,28,1198167065,-4441207
1669288091,205399,true,1202488023,28,1195414585,-7073438
1669288763,205400,true,1202367786,28,1195056032,-7311754
1669290347,205399,true,1202488023,28,1195056032,-7431991
1669290359,205400,true,1202367786,28,1195056032,-7311754
1669290575,205401,true,1202247562,28,1195056032,-7191530
1669291403,205403,true,1202007148,28,1195056032,-6951116
1669291535,205402,true,1202127349,28,1195056032,-7071317
1669291967,205402,true,1202127349,28,1195056032,-7071317
1669292999,205403,true,1202007148,28,1195056032,-6951116
1669293263,205404,true,1201886960,28,1195056032,-6830928
1669293323,205403,true,1202007148,28,1195175538,-6831610
1669293887,205404,true,1201886960,28,1195653680,-6233280
1669294067,205404,true,1201886960,28,1195892822,-5994138
1669294079,205406,true,1201646618,28,1195892822,-5753796
1669294139,205405,true,1201766783,28,1195892822,-5873961
1669294343,205406,true,1201646618,28,1195892822,-5753796
1669295291,205407,true,1201526466,28,1195892822,-5633644
1669295399,205408,true,1201406325,28,1195892822,-5513503
1669295423,205407,true,1201526466,28,1195892822,-5633644
1669296431,205408,true,1201406325,28,1195414585,-5991740
1669296467,205409,true,1201286196,28,1195414585,-5871611
1669296623,205410,true,1201166080,28,1195414585,-5751495
1669297031,205409,true,1201286196,28,1195414585,-5871611
1669298063,205410,true,1201166080,28,1195414585,-5751495
1669298087,205411,true,1201045975,28,1195534126,-5511849
1669298159,205412,true,1200925883,28,1195534126,-5391757
1669298171,205411,true,1201045975,28,1195534126,-5511849
1669299383,205411,true,1201045975,28,1197568161,-3477814
1669299407,205412,true,1200925883,28,1197568161,-3357722
1669299419,205413,true,1200805802,28,1197568161,-3237641
1669299431,205412,true,1200925883,28,1197568161,-3357722
1669299443,205413,true,1200805802,28,1197568161,-3237641
1669299467,205415,true,1200565677,28,1197568161,-2997516
1669299599,205417,true,1200325600,28,1197089253,-3236347
1669300415,205418,true,1200205579,28,1193384208,-6821371
1669300535,205419,true,1200085571,28,1192787695,-7297876
1669300619,205421,true,1199845589,28,1192429930,-7415659
1669300727,205424,true,1199485708,28,1191953077,-7532631
1669300775,205425,true,1199365771,28,1191714722,-7651049
1669300835,205426,true,1199245847,28,1191476415,-7769432
1669300907,205428,true,1199006033,28,1191119044,-7886989
1669300919,205431,true,1198646404,28,1191119044,-7527360
1669300931,205432,true,1198526551,28,1190999944,-7526607
1669301039,205433,true,1198406710,28,1190523663,-7883047
1669301099,205434,true,1198286882,28,1190285594,-8001288
1669301207,205437,true,1197927467,28,1189809598,-8117869
1669301291,205438,true,1197807687,28,1189809598,-7998089
1669301303,205439,true,1197687918,28,1189809598,-7878320
1669301375,205440,true,1197568161,28,1189809598,-7758563
1669301603,205443,true,1197208962,28,1190285594,-6923368
1669302383,205444,true,1197089253,28,1191476415,-5612838
1669302539,205444,true,1197089253,28,1191714722,-5374531
1669302671,205445,true,1196969556,28,1191953077,-5016479
1669302719,205448,true,1196610537,28,1191953077,-4657460
1669303655,205448,true,1196610537,28,1192429930,-4180607
1669303811,205448,true,1196610537,28,1192549173,-4061364
1669303835,205449,true,1196490888,28,1192549173,-3941715
1669303931,205451,true,1196251626,28,1192668428,-3583198
1669304627,205452,true,1196132013,28,1193145567,-2986446
1669305155,205451,true,1196251626,28,1193622897,-2628729
1669305467,205452,true,1196132013,28,1193861633,-2270380
1669306115,205454,true,1195892822,28,1194100417,-1792405
1669306127,205455,true,1195773245,28,1194100417,-1672828
1669306259,205454,true,1195892822,28,1194219827,-1672995
1669306283,205455,true,1195773245,28,1194219827,-1553418
1669306295,205456,true,1195653680,28,1194219827,-1433853
1669306307,205457,true,1195534126,28,1194219827,-1314299
1669306631,205455,true,1195773245,28,1195295055,-478190
1669306655,205456,true,1195653680,28,1195414585,-239095
1669306931,205457,true,1195534126,28,1196610537,1076411
1669306979,205457,true,1195534126,28,1196849871,1315745
1669307243,205455,true,1195773245,28,1197807687,2034442
1669307267,205456,true,1195653680,28,1197927467,2273787
1669307279,205456,true,1195653680,28,1197927467,2273787
1669307327,205456,true,1195653680,28,1198047260,2393580
1669307339,205455,true,1195773245,28,1198167065,2393820
1669307447,205455,true,1195773245,28,1198406710,2633465
1669307471,205456,true,1195653680,28,1198406710,2753030
1669307483,205456,true,1195653680,28,1198526551,2872871
1669307495,205454,true,1195892822,28,1198526551,2633729
1669308083,205455,true,1195773245,28,1199125934,3352689
1669308563,205456,true,1195653680,28,1198167065,2513385
1669308779,205456,true,1195653680,28,1197568161,1914481
1669309055,205454,true,1195892822,28,1196969556,1076734
1669309091,205456,true,1195653680,28,1196849871,1196191
1669309535,205456,true,1195653680,28,1197089253,1435573
1669309547,205456,true,1195653680,28,1197089253,1435573
1669309559,205454,true,1195892822,28,1197089253,1196431
1669309571,205456,true,1195653680,28,1197089253,1435573
1669309583,205456,true,1195653680,28,1197208962,1555282
1669309955,205455,true,1195773245,28,1198646404,2873159
1669310579,205453,true,1196012412,28,1201286196,5273784
1669310591,205454,true,1195892822,28,1201286196,5393374
1669310663,205454,true,1195892822,28,1201526466,5633644
1669310975,205453,true,1196012412,28,1202367786,6355374
1669311443,205452,true,1196132013,28,1203089388,6957375
1669312607,205453,true,1196012412,28,1201646618,5634206
1669312763,205453,true,1196012412,28,1201646618,5634206
1669313291,205453,true,1196012412,28,1201406325,5393913
1669314671,205451,true,1196251626,28,1201045975,4794349
1669315355,205453,true,1196012412,28,1201045975,5033563
1669315451,205452,true,1196132013,28,1201166080,5034067
1669315883,205451,true,1196251626,28,1201166080,4914454
1669316123,205450,true,1196371251,28,1201166080,4794829
1669316447,205451,true,1196251626,28,1201166080,4914454
1669316483,205451,true,1196251626,28,1201166080,4914454
1669316879,205450,true,1196371251,28,1201406325,5035074
1669317191,205448,true,1196610537,28,1201526466,4915929
1669318187,205450,true,1196371251,28,1201886960,5515709
1669318403,205449,true,1196490888,28,1201886960,5396072
1669319339,205448,true,1196610537,28,1201886960,5276423
1669319483,205447,true,1196730198,28,1201886960,5156762
1669319975,205448,true,1196610537,28,1201886960,5276423
1669320839,205447,true,1196730198,28,1201646618,4916420
1669320923,205446,true,1196849871,28,1201526466,4676595
1669321403,205445,true,1196969556,28,1201406325,4436769
1669321595,205446,true,1196849871,28,1201286196,4436325
1669321655,205445,true,1196969556,28,1201286196,4316640
1669322135,205444,true,1197089253,28,1201045975,3956722
1669322651,205443,true,1197208962,28,1200805802,3596840
1669322843,205444,true,1197089253,28,1200565677,3476424
1669323383,205444,true,1197089253,28,1199845589,2756336
1669323599,205443,true,1197208962,28,1199605656,2396694
1669324499,205442,true,1197328683,28,1198766268,1437585
1669325303,205444,true,1197089253,28,1198646404,1557151
1669325351,205443,true,1197208962,28,1198646404,1437442
1669325675,205443,true,1197208962,28,1198646404,1437442
1669325687,205441,true,1197448416,28,1198646404,1197988
1669325699,205443,true,1197208962,28,1198646404,1437442
1669325735,205443,true,1197208962,28,1198646404,1437442
1669326203,205442,true,1197328683,28,1198047260,718577
1669326347,205441,true,1197448416,28,1197927467,479051
1669327259,205442,true,1197328683,28,1196969556,-359127
1669327283,205442,true,1197328683,28,1196969556,-359127
1669327787,205442,true,1197328683,28,1196610537,-718146
1669327979,205441,true,1197448416,28,1196610537,-837879
1669328231,205442,true,1197328683,28,1196610537,-718146
1669328615,205442,true,1197328683,28,1196730198,-598485
1669328723,205442,true,1197328683,28,1196730198,-598485
1669328747,205441,true,1197448416,28,1196730198,-718218
1669328783,205442,true,1197328683,28,1196730198,-598485
1669328795,205442,true,1197328683,28,1196730198,-598485
1669329347,205442,true,1197328683,28,1197208962,-119721
1669329503,205441,true,1197448416,28,1197328683,-119733
1669329563,205441,true,1197448416,28,1197448416,0
1669330055,205440,true,1197568161,28,1198047260,479099
1669330271,205439,true,1197687918,28,1198286882,598964
1669330283,205438,true,1197807687,28,1198286882,479195
1669330643,205438,true,1197807687,28,1199006033,1198346
1669331987,205437,true,1197927467,28,1200325600,2398133
1669332179,205436,true,1198047260,28,1200325600,2278340
1669332287,205435,true,1198167065,28,1200445632,2278567
1669332323,205435,true,1198167065,28,1200445632,2278567
1669332359,205434,true,1198286882,28,1200445632,2158750
1669332407,205433,true,1198406710,28,1200445632,2038922
1669332455,205432,true,1198526551,28,1200445632,1919081
1669332659,205432,true,1198526551,28,1200565677,2039126
1669334279,205430,true,1198766268,28,1201406325,2640057
1669334687,205430,true,1198766268,28,1201406325,2640057
1669335023,205429,true,1198886145,28,1201406325,2520180
1669335035,205429,true,1198886145,28,1201406325,2520180
1669335071,205428,true,1199006033,28,1201406325,2400292
1669335095,205427,true,1199125934,28,1201406325,2280391
1669335155,205426,true,1199245847,28,1201406325,2160478
1669335167,205427,true,1199125934,28,1201406325,2280391
1669335179,205425,true,1199365771,28,1201406325,2040554
1669335731,205425,true,1199365771,28,1200565677,1199906
1669335743,205424,true,1199485708,28,1200445632,959924
1669336571,205425,true,1199365771,28,1198646404,-719367
1669337075,205424,true,1199485708,28,1197687918,-1797790
1669337339,205424,true,1199485708,28,1197568161,-1917547
1669337387,205423,true,1199605656,28,1197448416,-2157240
1669337399,205424,true,1199485708,28,1197448416,-2037292
1669337411,205423,true,1199605656,28,1197448416,-2157240
1669337423,205423,true,1199605656,28,1197448416,-2157240
1669337495,205423,true,1199605656,28,1197328683,-2276973
1669339631,205424,true,1199485708,28,1194219827,-5265881
1669340507,205423,true,1199605656,28,1194339249,-5266407
1669340615,205423,true,1199605656,28,1194339249,-5266407
1669341215,205424,true,1199485708,28,1194339249,-5146459
1669341323,205426,true,1199245847,28,1194339249,-4906598
1669341383,205425,true,1199365771,28,1194339249,-5026522
1669341671,205425,true,1199365771,28,1194339249,-5026522
1669341683,205427,true,1199125934,28,1194339249,-4786685
1669341695,205428,true,1199006033,28,1194339249,-4666784
1669341719,205427,true,1199125934,28,1194339249,-4786685
1669341803,205428,true,1199006033,28,1194219827,-4786206
1669341839,205429,true,1198886145,28,1194100417,-4785728
1669341851,205430,true,1198766268,28,1194100417,-4665851
1669342235,205431,true,1198646404,28,1191953077,-6693327
1669342271,205432,true,1198526551,28,1191833894,-6692657
1669343291,205433,true,1198406710,28,1186245696,-12161014
1669343543,205434,true,1198286882,28,1184941609,-13345273
1669344911,205435,true,1198167065,28,1184586197,-13580868
1669345463,205436,true,1198047260,28,1184586197,-13461063
1669346051,205437,true,1197927467,28,1184586197,-13341270
1669346255,205438,true,1197807687,28,1184704656,-13103031
1669346807,205438,true,1197807687,28,1184704656,-13103031
1669347491,205439,true,1197687918,28,1184823126,-12864792
1669347635,205441,true,1197448416,28,1184823126,-12625290
1669347839,205442,true,1197328683,28,1184823126,-12505557
1669347959,205443,true,1197208962,28,1184823126,-12385836
1669348895,205445,true,1196969556,28,1184823126,-12146430
1669349363,205447,true,1196730198,28,1184823126,-11907072
1669349651,205447,true,1196730198,28,1184823126,-11907072
1669350815,205449,true,1196490888,28,1184823126,-11667762
1669351199,205451,true,1196251626,28,1184823126,-11428500
1669351211,205452,true,1196132013,28,1184823126,-11308887
1669351307,205452,true,1196132013,28,1184704656,-11427357
1669351439,205454,true,1195892822,28,1184349316,-11543506
1669351463,205457,true,1195534126,28,1184230893,-11303233
1669351475,205458,true,1195414585,28,1184230893,-11183692
1669351487,205459,true,1195295055,28,1184112481,-11182574
1669351703,205461,true,1195056032,28,1183165617,-11890415
1669352087,205464,true,1194697587,28,1181274161,-13423426
1669352099,205466,true,1194458683,28,1181156045,-13302638
1669352159,205466,true,1194458683,28,1180919849,-13538834
1669352183,205469,true,1194100417,28,1180801769,-13298648
1669352279,205472,true,1193742259,28,1180211545,-13530714
1669352939,205474,true,1193503546,28,1176441093,-17062453
1669352951,205475,true,1193384208,28,1176323460,-17060748
1669352975,205477,true,1193145567,28,1176088231,-17057336
1669352987,205481,true,1192668428,28,1175970634,-16697794
1669353047,205483,true,1192429930,28,1175617913,-16812017
1669353287,205484,true,1192310699,28,1174677842,-17632857
1669353299,205486,true,1192072272,28,1174560386,-17511886
1669353491,205490,true,1191595563,28,1173855896,-17739667
1669353527,205492,true,1191357279,28,1173738522,-17618757
1669353551,205493,true,1191238156,28,1173738522,-17499634
1669353587,205496,true,1190880856,28,1173621160,-17259696
1669353659,205498,true,1190642715,28,1173503810,-17138905
1669353707,205500,true,1190404622,28,1173386471,-17018151
1669353863,205501,true,1190285594,28,1173151829,-17133765
1669353875,205504,true,1189928579,28,1173151829,-16776750
1669354043,205506,true,1189690629,28,1172799954,-16890675
1669354343,205508,true,1189452727,28,1172448184,-17004543
1669354691,205509,true,1189333794,28,1172096520,-17237274
1669354967,205511,true,1189095962,28,1172448184,-16647778
1669355159,205514,true,1188739305,28,1172799954,-15939351
1669355663,205516,true,1188501593,28,1173503810,-14997783
1669356695,205516,true,1188501593,28,1174560386,-13941207
1669356851,205519,true,1188145114,28,1174560386,-13584728
1669357715,205521,true,1187907520,28,1174442942,-13464578
1669357763,205523,true,1187669974,28,1174442942,-13227032
1669357775,205523,true,1187669974,28,1174442942,-13227032
1669357787,205525,true,1187432476,28,1174560386,-12872090
1669357811,205527,true,1187195025,28,1174560386,-12634639
1669357847,205529,true,1186957622,28,1174560386,-12397236
1669357907,205530,true,1186838938,28,1174560386,-12278552
1669357919,205532,true,1186601606,28,1174560386,-12041220
1669357931,205534,true,1186364321,28,1174560386,-11803935
1669357943,205535,true,1186245696,28,1174560386,-11685310
1669358063,205535,true,1186245696,28,1174795310,-11450386
1669358135,205538,true,1185889894,28,1174912789,-10977105
1669358567,205540,true,1185652751,28,1175617913,-10034838
1669358819,205542,true,1185415656,28,1175970634,-9445022
1669358855,205542,true,1185415656,28,1175970634,-9445022
1669358951,205544,true,1185178609,28,1176205840,-8972769
1669359155,205546,true,1184941609,28,1176558737,-8382872
1669359299,205548,true,1184704656,28,1176911740,-7792916
1669359551,205548,true,1184704656,28,1177500313,-7204343
1669359851,205551,true,1184349316,28,1177971384,-6377932
1669360187,205553,true,1184112481,28,1178089181,-6023300
1669360535,205554,true,1183994082,28,1178324811,-5669271
1669360835,205555,true,1183875694,28,1178324811,-5550883
1669361075,205557,true,1183638955,28,1178324811,-5314144
1669361315,205560,true,1183283934,28,1178324811,-4959123
1669361327,205561,true,1183165617,28,1178206990,-4958627
1669361339,205562,true,1183047313,28,1178206990,-4840323
1669361351,205564,true,1182810739,28,1178206990,-4603749
1669361663,205567,true,1182455966,28,1178324811,-4131155
1669361711,205568,true,1182337733,28,1178324811,-4012922
1669361747,205568,true,1182337733,28,1178324811,-4012922
1669361819,205571,true,1181983102,28,1178442643,-3540459
1669361903,205573,true,1181746741,28,1178442643,-3304098
1669362383,205574,true,1181628578,28,1179149886,-2478692
1669362395,205574,true,1181628578,28,1179149886,-2478692
1669362491,205577,true,1181274161,28,1179385727,-1888434
1669362599,205578,true,1181156045,28,1179621616,-1534429
1669362719,205579,true,1181037941,28,1179975538,-1062403
1669363403,205579,true,1181037941,28,1181510427,472486
1669364711,205581,true,1180801769,28,1182692469,1890700
1669364999,205583,true,1180565644,28,1182692469,2126825
1669365191,205583,true,1180565644,28,1182692469,2126825
1669365527,205583,true,1180565644,28,1182692469,2126825
1669365659,205586,true,1180211545,28,1182574212,2362667
1669366079,205587,true,1180093536,28,1182219511,2125975
1669366151,205588,true,1179975538,28,1182219511,2243973
1669366307,205587,true,1180093536,28,1181983102,1889566
1669366739,205590,true,1179739579,28,1181746741,2007162
1669367543,205591,true,1179621616,28,1181274161,1652545
1669367819,205591,true,1179621616,28,1181274161,1652545
1669368239,205591,true,1179621616,28,1181274161,1652545
1669368611,205594,true,1179267801,28,1181274161,2006360
1669369739,205595,true,1179149886,28,1181274161,2124275
1669370087,205595,true,1179149886,28,1181274161,2124275
1669370759,205595,true,1179149886,28,1180801769,1651883
1669370831,205598,true,1178796211,28,1180801769,2005558
1669370879,205599,true,1178678344,28,1180683701,2005357
1669370903,205599,true,1178678344,28,1180683701,2005357
1669371047,205599,true,1178678344,28,1180447599,1769255
1669371143,205600,true,1178560488,28,1180329566,1769078
1669371311,205601,true,1178442643,28,1179975538,1532895
1669371371,205601,true,1178442643,28,1179975538,1532895
1669371383,205601,true,1178442643,28,1179857553,1414910
1669372175,205602,true,1178324811,28,1179031983,707172
1669372211,205602,true,1178324811,28,1179031983,707172
1669372307,205602,true,1178324811,28,1179031983,707172
1669372451,205602,true,1178324811,28,1178914091,589280
1669372571,205603,true,1178206990,28,1178914091,707101
1669372607,205604,true,1178089181,28,1178914091,824910
1669372619,205604,true,1178089181,28,1178914091,824910
1669372631,205604,true,1178089181,28,1178914091,824910
1669372643,205604,true,1178089181,28,1178914091,824910
1669374227,205604,true,1178089181,28,1184112481,6023300
1669374335,205604,true,1178089181,28,1184349316,6260135
1669374827,205604,true,1178089181,28,1184586197,6497016
1669374899,205604,true,1178089181,28,1184586197,6497016
1669374911,205604,true,1178089181,28,1184704656,6615475
1669374923,205604,true,1178089181,28,1184704656,6615475
1669375379,205602,true,1178324811,28,1186957622,8632811
1669375391,205601,true,1178442643,28,1187076318,8633675
1669375415,205600,true,1178560488,28,1187195025,8634537
1669375451,205600,true,1178560488,28,1187432476,8871988
1669375463,205597,true,1178914091,28,1187432476,8518385
1669376423,205596,true,1179031983,28,1192310699,13278716
1669376507,205595,true,1179149886,28,1192787695,13637809
1669376567,205595,true,1179149886,28,1193026264,13876378
1669377827,205592,true,1179503666,28,1193742259,14238593
1669377875,205591,true,1179621616,28,1193742259,14120643
1669378739,205589,true,1179857553,28,1193742259,13884706
1669378787,205589,true,1179857553,28,1193742259,13884706
1669378859,205586,true,1180211545,28,1193981019,13769474
1669378883,205585,true,1180329566,28,1193981019,13651453
1669379231,205582,true,1180683701,28,1194578129,13894428
1669379411,205581,true,1180801769,28,1194936538,14134769
1669379627,205579,true,1181037941,28,1195414585,14376644
1669380179,205577,true,1181274161,28,1196012412,14738251
1669380407,205575,true,1181510427,28,1196251626,14741199
1669380419,205574,true,1181628578,28,1196251626,14623048
1669380455,205571,true,1181983102,28,1196251626,14268524
1669380479,205570,true,1182101301,28,1196251626,14150325
1669380599,205568,true,1182337733,28,1196251626,13913893
1669381271,205567,true,1182455966,28,1195056032,12600066
1669381715,205565,true,1182692469,28,1194339249,11646780
1669381751,205564,true,1182810739,28,1194339249,11528510
1669381763,205562,true,1183047313,28,1194339249,11291936
1669381799,205561,true,1183165617,28,1194219827,11054210
1669381811,205558,true,1183520603,28,1194219827,10699224
1669381847,205558,true,1183520603,28,1194100417,10579814
1669381859,205556,true,1183757319,28,1194100417,10343098
1669381871,205555,true,1183875694,28,1194100417,10224723
1669381895,205553,true,1184112481,28,1193981019,9868538
1669381907,205553,true,1184112481,28,1193981019,9868538
1669383527,205551,true,1184349316,28,1190523663,6174347
1669383647,205550,true,1184467751,28,1190404622,5936871
1669384679,205548,true,1184704656,28,1190285594,5580938
1669385051,205548,true,1184704656,28,1190285594,5580938
1669385315,205546,true,1184941609,28,1190166577,5224968
1669385339,205546,true,1184941609,28,1190166577,5224968
1669385351,205544,true,1185178609,28,1190166577,4987968
1669385363,205544,true,1185178609,28,1190166577,4987968
1669385459,205543,true,1185297127,28,1189928579,4631452
1669385471,205543,true,1185297127,28,1189928579,4631452
1669386047,205542,true,1185415656,28,1188145114,2729458
1669386443,205541,true,1185534198,28,1186957622,1423424
1669386803,205541,true,1185534198,28,1185889894,355696
1669386851,205540,true,1185652751,28,1185771317,118566
1669387439,205539,true,1185771317,28,1184941609,-829708
1669387823,205539,true,1185771317,28,1184941609,-829708
1669387835,205538,true,1185889894,28,1184941609,-948285
1669387967,205538,true,1185889894,28,1184941609,-948285
1669387979,205537,true,1186008483,28,1184941609,-1066874
1669388003,205537,true,1186008483,28,1184941609,-1066874
1669388015,205536,true,1186127084,28,1184941609,-1185475
1669388063,205536,true,1186127084,28,1185060103,-1066981
1669388075,205535,true,1186245696,28,1185060103,-1185593
1669388207,205534,true,1186364321,28,1185415656,-948665
1669388483,205533,true,1186482957,28,1186008483,-474474
1669388531,205533,true,1186482957,28,1186127084,-355873
1669388543,205531,true,1186720266,28,1186127084,-593182
1669388555,205531,true,1186720266,28,1186127084,-593182
1669388639,205530,true,1186838938,28,1186364321,-474617
1669388723,205529,true,1186957622,28,1186720266,-237356
1669389143,205528,true,1187076318,28,1188026311,949993
1669389167,205527,true,1187195025,28,1188145114,950089
1669389611,205526,true,1187313745,28,1189690629,2376884
1669390475,205526,true,1187313745,28,1191119044,3805299
1669390511,205525,true,1187432476,28,1191119044,3686568
1669390823,205524,true,1187551219,28,1191238156,3686937
1669391003,205523,true,1187669974,28,1191238156,3568182
1669391063,205523,true,1187669974,28,1191238156,3568182
1669391207,205522,true,1187788741,28,1191238156,3449415
1669391219,205521,true,1187907520,28,1191238156,3330636
1669391255,205521,true,1187907520,28,1191238156,3330636
1669391315,205521,true,1187907520,28,1191119044,3211524
1669391723,205520,true,1188026311,28,1190761779,2735468
1669391747,205519,true,1188145114,28,1190761779,2616665
1669392191,205519,true,1188145114,28,1190285594,2140480
1669392383,205519,true,1188145114,28,1190047572,1902458
1669392707,205517,true,1188382755,28,1189571672,1188917
1669392851,205517,true,1188382755,28,1189452727,1069972
1669392947,205516,true,1188501593,28,1189452727,951134
1669393151,205516,true,1188501593,28,1189333794,832201
1669393163,205515,true,1188620443,28,1189333794,713351
1669393235,205514,true,1188739305,28,1189333794,594489
1669393247,205514,true,1188739305,28,1189333794,594489
1669393259,205514,true,1188739305,28,1189333794,594489
1669393271,205513,true,1188858179,28,1189333794,475615
1669393295,205512,true,1188977065,28,1189333794,356729
1669394147,205512,true,1188977065,28,1187788741,-1188324
1669394303,205512,true,1188977065,28,1187432476,-1544589
1669394591,205511,true,1189095962,28,1186957622,-2138340
1669395023,205510,true,1189214872,28,1186127084,-3087788
1669395275,205510,true,1189214872,28,1186008483,-3206389
1669395587,205510,true,1189214872,28,1186008483,-3206389
1669396535,205508,true,1189452727,28,1186008483,-3444244
1669396643,205508,true,1189452727,28,1186008483,-3444244
1669396691,205508,true,1189452727,28,1186008483,-3444244
1669397195,205508,true,1189452727,28,1186127084,-3325643
1669397267,205506,true,1189690629,28,1186127084,-3563545
1669397315,205506,true,1189690629,28,1186127084,-3563545
1669397351,205506,true,1189690629,28,1186127084,-3563545
1669397447,205505,true,1189809598,28,1186127084,-3682514
1669397483,205504,true,1189928579,28,1186245696,-3682883
1669397567,205504,true,1189928579,28,1186364321,-3564258
1669397879,205504,true,1189928579,28,1186838938,-3089641
1669398035,205504,true,1189928579,28,1187076318,-2852261
1669398095,205503,true,1190047572,28,1187076318,-2971254
1669398227,205503,true,1190047572,28,1187313745,-2733827
1669398395,205503,true,1190047572,28,1187551219,-2496353
1669398479,205503,true,1190047572,28,1187669974,-2377598
1669398563,205504,true,1189928579,28,1187788741,-2139838
1669398575,205504,true,1189928579,28,1187907520,-2021059
1669398767,205505,true,1189809598,28,1188263928,-1545670
1669399679,205504,true,1189928579,28,1189333794,-594785
1669399835,205505,true,1189809598,28,1189452727,-356871
1669399847,205505,true,1189809598,28,1189452727,-356871
1669399859,205506,true,1189690629,28,1189452727,-237902
1669400099,205505,true,1189809598,28,1189690629,-118969
1669400351,205506,true,1189690629,28,1189809598,118969
1669400723,205507,true,1189571672,28,1189928579,356907
1669400819,205507,true,1189571672,28,1189928579,356907
1669401383,205506,true,1189690629,28,1190047572,356943
1669402271,205507,true,1189571672,28,1190047572,475900
1669402487,205508,true,1189452727,28,1190047572,594845
1669402559,205509,true,1189333794,28,1190047572,713778
1669403375,205509,true,1189333794,28,1190047572,713778
1669403615,205509,true,1189333794,28,1190047572,713778
1669403639,205510,true,1189214872,28,1190166577,951705
1669403855,205511,true,1189095962,28,1190285594,1189632
1669403915,205510,true,1189214872,28,1190285594,1070722
1669403951,205511,true,1189095962,28,1190404622,1308660
1669404059,205511,true,1189095962,28,1190642715,1546753
1669405007,205511,true,1189095962,28,1192668428,3572466
1669405079,205510,true,1189214872,28,1192906973,3692101
1669405703,205510,true,1189214872,28,1194219827,5004955
1669405811,205511,true,1189095962,28,1194339249,5243287
1669406111,205510,true,1189214872,28,1194697587,5482715
1669406471,205510,true,1189214872,28,1195056032,5841160
1669407059,205510,true,1189214872,28,1195653680,6438808
1669407635,205509,true,1189333794,28,1195892822,6559028
1669408331,205509,true,1189333794,28,1198286882,8953088
1669408595,205508,true,1189452727,28,1199125934,9673207
1669409231,205507,true,1189571672,28,1201286196,11714524
1669409303,205506,true,1189690629,28,1201526466,11835837
1669411319,205505,true,1189809598,28,1201886960,12077362
1669411727,205504,true,1189928579,28,1201886960,11958381
1669411775,205504,true,1189928579,28,1201886960,11958381
1669412951,205503,true,1190047572,28,1201886960,11839388
1669413263,205502,true,1190166577,28,1201886960,11720383
1669413995,205501,true,1190285594,28,1201886960,11601366
1669414295,205500,true,1190404622,28,1201886960,11482338
1669414307,205499,true,1190523663,28,1201886960,11363297
1669414319,205497,true,1190761779,28,1201886960,11125181
1669414331,205496,true,1190880856,28,1201886960,11006104
1669414451,205495,true,1190999944,28,1201766783,10766839
1669414475,205495,true,1190999944,28,1201646618,10646674
1669414619,205493,true,1191238156,28,1201526466,10288310
1669414775,205492,true,1191357279,28,1201286196,9928917
1669415855,205491,true,1191476415,28,1199725617,8249202
1669416299,205490,true,1191595563,28,1199245847,7650284
1669417775,205489,true,1191714722,28,1199245847,7531125
1669418939,205487,true,1191953077,28,1199125934,7172857
1669418987,205487,true,1191953077,28,1199125934,7172857
1669419947,205486,true,1192072272,28,1199245847,7173575
1669420943,205485,true,1192191480,28,1199006033,6814553
1669421759,205484,true,1192310699,28,1198646404,6335705
1669422467,205483,true,1192429930,28,1198646404,6216474
1669422743,205483,true,1192429930,28,1198646404,6216474
1669422755,205482,true,1192549173,28,1198646404,6097231
1669422767,205481,true,1192668428,28,1198766268,6097840
1669423031,205480,true,1192787695,28,1199245847,6458152
1669423043,205479,true,1192906973,28,1199245847,6338874
1669424183,205477,true,1193145567,28,1202969091,9823524
1669424591,205477,true,1193145567,28,1204293018,11147451
1669424603,205476,true,1193264881,28,1204293018,11028137
1669424879,205475,true,1193384208,28,1204774808,11390600
1669424975,205473,true,1193622897,28,1205015775,11392878
1669424999,205472,true,1193742259,28,1205136276,11394017
1669425251,205471,true,1193861633,28,1205859539,11997906
1669425311,205469,true,1194100417,28,1206100723,12000306
1669425347,205467,true,1194339249,28,1206341955,12002706
1669425659,205466,true,1194458683,28,1207548840,13090157
1669425671,205465,true,1194578129,28,1207548840,12970711
1669425683,205463,true,1194817057,28,1207669595,12852538
1669425695,205461,true,1195056032,28,1207790362,12734330
1669426223,205457,true,1195534126,28,1212873495,17339369
1669426403,205455,true,1195773245,28,1214694079,18920834
1669426631,205453,true,1196012412,28,1216760712,20748300
1669426703,205451,true,1196251626,28,1217369214,21117588
1669427711,205447,true,1196730198,28,1222125985,25395787
1669427771,205445,true,1196969556,28,1222125985,25156429
1669427795,205444,true,1197089253,28,1222125985,25036732
1669427819,205441,true,1197448416,28,1222125985,24677569
1669428203,205438,true,1197807687,28,1222003785,24196098
1669428263,205436,true,1198047260,28,1222003785,23956525
1669429019,205434,true,1198286882,28,1221637257,23350375
1669429175,205432,true,1198526551,28,1221515106,22988555
1669429247,205428,true,1199006033,28,1221515106,22509073
1669430375,205426,true,1199245847,28,1221270839,22024992
1669431047,205424,true,1199485708,28,1221270839,21785131
1669431155,205422,true,1199725617,28,1221270839,21545222
1669431275,205418,true,1200205579,28,1221270839,21065260
1669431299,205416,true,1200445632,28,1221270839,20825207
1669431323,205414,true,1200685733,28,1221270839,20585106
1669431491,205411,true,1201045975,28,1221148724,20102749
1669431755,205408,true,1201406325,28,1220904531,19498206
1669432259,205406,true,1201646618,28,1220416292,18769674
1669432343,205404,true,1201886960,28,1220294262,18407302
1669432451,205402,true,1202127349,28,1220172245,18044896
1669432559,205398,true,1202608272,28,1219928247,17319975
1669432895,205396,true,1202848806,28,1219318466,16469660
1669434011,205394,true,1203089388,28,1218221628,15132240
1669434203,205392,true,1203330017,28,1218099818,14769801
1669434359,205388,true,1203811422,28,1217978020,14166598
1669434779,205387,true,1203931803,28,1217978020,14046217
1669434851,205385,true,1204172601,28,1217978020,13805419
1669434983,205383,true,1204413448,28,1217978020,13564572
1669435043,205380,true,1204774808,28,1217978020,13203212
1669435079,205378,true,1205015775,28,1217978020,12962245
1669435139,205377,true,1205136276,28,1217978020,12841744
1669435175,205375,true,1205377316,28,1217978020,12600704
1669435343,205371,true,1205859539,28,1217856234,11996695
1669435487,205370,true,1205980125,28,1217856234,11876109
1669435787,205368,true,1206221333,28,1217734461,11513128
1669436675,205366,true,1206462589,28,1217247489,10784900
1669437935,205363,true,1206824564,28,1217004076,10179512
1669437947,205362,true,1206945247,28,1217125776,10180529
1669438271,205360,true,1207186648,28,1217490951,10304303
1669438307,205358,true,1207428097,28,1217490951,10062854
1669438667,205354,true,1207911141,28,1217978020,10066879
1669438739,205353,true,1208031932,28,1218221628,10189696
1669438847,205351,true,1208273551,28,1218465284,10191733
1669440407,205349,true,1208515217,28,1221515106,12999889
1669441139,205345,true,1208998696,28,1221637257,12638561
1669442207,205344,true,1209119596,28,1221637257,12517661
1669442603,205342,true,1209361432,28,1221637257,12275825
1669442915,205340,true,1209603316,28,1221637257,12033941
1669442987,205336,true,1210087230,28,1221637257,11550027
1669443011,205334,true,1210329260,28,1221637257,11307997
1669443023,205333,true,1210450293,28,1221637257,11186964
1669443035,205331,true,1210692395,28,1221637257,10944862
1669443095,205327,true,1211176744,28,1221515106,10338362
1669443107,205326,true,1211297862,28,1221515106,10217244
1669443119,205324,true,1211540134,28,1221515106,9974972
1669443239,205323,true,1211661288,28,1221392966,9731678
1669443875,205319,true,1212146025,28,1220416292,8270267
1669444655,205319,true,1212146025,28,1219074639,6928614
1669446299,205317,true,1212388466,28,1218465284,6076818
1669446419,205316,true,1212509705,28,1218465284,5955579
1669446671,205313,true,1212873495,28,1218465284,5591789
1669446695,205312,true,1212994782,28,1218465284,5470502
1669447175,205310,true,1213237393,28,1218465284,5227891
1669447943,205310,true,1213237393,28,1218221628,4984235
1669447991,205307,true,1213601401,28,1218221628,4620227
1669448003,205307,true,1213601401,28,1218221628,4620227
1669448087,205306,true,1213722761,28,1218221628,4498867
1669448111,205306,true,1213722761,28,1218099818,4377057
1669448771,205303,true,1214086914,28,1217004076,2917162
1669449119,205303,true,1214086914,28,1216395756,2308842
1669449131,205302,true,1214208323,28,1216395756,2187433
1669449155,205302,true,1214208323,28,1216274129,2065806
1669449203,205299,true,1214572622,28,1216274129,1701507
1669450115,205298,true,1214694079,28,1215787741,1093662
1669450163,205297,true,1214815548,28,1215909320,1093772
1669450223,205297,true,1214815548,28,1215909320,1093772
1669450559,205295,true,1215058523,28,1216152514,1093991
1669450799,205294,true,1215180029,28,1216395756,1215727
1669451003,205293,true,1215301547,28,1216517396,1215849
1669451147,205292,true,1215423077,28,1216517396,1094319
1669451771,205289,true,1215787741,28,1216517396,729655
1669452011,205289,true,1215787741,28,1216517396,729655
1669453451,205287,true,1216030911,28,1216517396,486485
1669453691,205287,true,1216030911,28,1216517396,486485
1669455779,205284,true,1216395756,28,1216517396,121640
1669455839,205283,true,1216517396,28,1216517396,0
1669456139,205282,true,1216639048,28,1216760712,121664
1669456223,205282,true,1216639048,28,1216760712,121664
1669456883,205279,true,1217004076,28,1217490951,486875
1669456967,205278,true,1217125776,28,1217612700,486924
1669457027,205276,true,1217369214,28,1217612700,243486
1669457099,205276,true,1217369214,28,1217734461,365247
1669457423,205273,true,1217734461,28,1218099818,365357
1669457495,205272,true,1217856234,28,1218221628,365394
1669457531,205272,true,1217856234,28,1218221628,365394
1669457543,205272,true,1217856234,28,1218343450,487216
1669457771,205268,true,1218343450,28,1218952743,609293
1669458239,205267,true,1218465284,28,1220050240,1584956
1669458911,205266,true,1218587131,28,1221515106,2927975
1669458947,205267,true,1218465284,28,1221637257,3171973
1669459235,205263,true,1218952743,28,1222248198,3295455
1669460819,205263,true,1218952743,28,1222370423,3417680
1669461203,205263,true,1218952743,28,1222248198,3295455
1669461251,205263,true,1218952743,28,1222248198,3295455
1669462019,205260,true,1219318466,28,1221759421,2440955
1669462163,205260,true,1219318466,28,1221637257,2318791
1669462427,205260,true,1219318466,28,1221392966,2074500
1669462991,205261,true,1219196546,28,1221026622,1830076
1669463087,205260,true,1219318466,28,1220904531,1586065
1669463363,205260,true,1219318466,28,1220904531,1586065
1669464599,205261,true,1219196546,28,1220904531,1707985
1669466411,205261,true,1219196546,28,1220904531,1707985
1669467239,205261,true,1219196546,28,1220904531,1707985
1669467755,205261,true,1219196546,28,1220904531,1707985
1669468367,205261,true,1219196546,28,1220904531,1707985
1669468847,205262,true,1219074639,28,1220904531,1829892
1669468955,205261,true,1219196546,28,1220904531,1707985
1669469255,205261,true,1219196546,28,1220904531,1707985
1669469279,205261,true,1219196546,28,1220904531,1707985
1669469483,205262,true,1219074639,28,1220904531,1829892
1669469771,205261,true,1219196546,28,1220904531,1707985
1669469879,205261,true,1219196546,28,1220904531,1707985
1669469927,205261,true,1219196546,28,1220904531,1707985
1669470083,205262,true,1219074639,28,1220904531,1829892
1669470251,205261,true,1219196546,28,1220904531,1707985
1669470443,205261,true,1219196546,28,1220904531,1707985
1669470971,205261,true,1219196546,28,1220904531,1707985
1669471223,205262,true,1219074639,28,1220904531,1829892
1669471331,205261,true,1219196546,28,1220904531,1707985
1669471619,205261,true,1219196546,28,1220904531,1707985
1669471655,205261,true,1219196546,28,1220904531,1707985
1669471763,205261,true,1219196546,28,1220904531,1707985
1669471955,205260,true,1219318466,28,1220904531,1586065
1669471991,205260,true,1219318466,28,1220904531,1586065
1669472255,205260,true,1219318466,28,1220904531,1586065
1669472399,205260,true,1219318466,28,1220904531,1586065
1669472519,205260,true,1219318466,28,1220904531,1586065
1669472639,205259,true,1219440398,28,1220904531,1464133
1669472963,205259,true,1219440398,28,1220904531,1464133
1669473323,205260,true,1219318466,28,1220904531,1586065
1669473635,205259,true,1219440398,28,1220904531,1464133
1669473647,205258,true,1219562342,28,1220904531,1342189
1669473683,205258,true,1219562342,28,1220904531,1342189
1669473899,205258,true,1219562342,28,1221637257,2074915
1669474019,205256,true,1219806266,28,1222003785,2197519
1669474067,205256,true,1219806266,28,1222125985,2319719
1669474139,205256,true,1219806266,28,1222248198,2441932
1669474175,205255,true,1219928247,28,1222370423,2442176
1669474187,205254,true,1220050240,28,1222370423,2320183
1669474199,205253,true,1220172245,28,1222370423,2198178
1669474211,205254,true,1220050240,28,1222370423,2320183
1669474247,205254,true,1220050240,28,1222370423,2320183
1669474259,205253,true,1220172245,28,1222370423,2198178
1669474283,205253,true,1220172245,28,1222492660,2320415
1669474295,205253,true,1220172245,28,1222370423,2198178
1669474331,205254,true,1220050240,28,1222370423,2320183
1669474343,205254,true,1220050240,28,1222370423,2320183
1669474391,205254,true,1220050240,28,1222248198,2197958
1669474415,205254,true,1220050240,28,1222248198,2197958
1669474583,205256,true,1219806266,28,1221759421,1953155
1669474775,205255,true,1219928247,28,1221026622,1098375
1669475399,205256,true,1219806266,28,1218221628,-1584638
1669475987,205257,true,1219684298,28,1214086914,-5597384
1669476011,205258,true,1219562342,28,1213965517,-5596825
1669476035,205258,true,1219562342,28,1213722761,-5839581
1669476347,205259,true,1219440398,28,1212388466,-7051932
1669477271,205260,true,1219318466,28,1210813464,-8505002
1669477343,205261,true,1219196546,28,1210571338,-8625208
1669478159,205261,true,1219196546,28,1209482368,-9714178
1669478267,205261,true,1219196546,28,1209361432,-9835114
1669478483,205263,true,1218952743,28,1209240508,-9712235
1669478615,205264,true,1218830860,28,1209240508,-9590352
1669479119,205263,true,1218952743,28,1208877808,-10074935
1669479323,205264,true,1218830860,28,1208877808,-9953052
1669479395,205265,true,1218708989,28,1208998696,-9710293
1669479407,205266,true,1218587131,28,1208998696,-9588435
1669479443,205266,true,1218587131,28,1208998696,-9588435
1669479503,205267,true,1218465284,28,1208998696,-9466588
1669479539,205268,true,1218343450,28,1208998696,-9344754
1669479575,205268,true,1218343450,28,1208998696,-9344754
1669479743,205268,true,1218343450,28,1209119596,-9223854
1669480031,205268,true,1218343450,28,1209240508,-9102942
1669480199,205269,true,1218221628,28,1209361432,-8860196
1669480463,205270,true,1218099818,28,1209603316,-8496502
1669480487,205269,true,1218221628,28,1209603316,-8618312
1669482887,205270,true,1218099818,28,1210329260,-7770558
1669483091,205271,true,1217978020,28,1210329260,-7648760
1669483427,205272,true,1217856234,28,1210329260,-7526974
1669483619,205271,true,1217978020,28,1210329260,-7648760
1669484615,205272,true,1217856234,28,1210329260,-7526974
1669485023,205273,true,1217734461,28,1210450293,-7284168
1669485371,205274,true,1217612700,28,1210571338,-7041362
1669485767,205273,true,1217734461,28,1210692395,-7042066
1669486391,205274,true,1217612700,28,1210934545,-6678155
1669486607,205275,true,1217490951,28,1210934545,-6556406
1669487795,205275,true,1217490951,28,1210934545,-6556406
1669487975,205274,true,1217612700,28,1210934545,-6678155
1669488827,205275,true,1217490951,28,1210934545,-6556406
1669489091,205276,true,1217369214,28,1210934545,-6434669
1669489259,205277,true,1217247489,28,1210813464,-6434025
1669489283,205277,true,1217247489,28,1210813464,-6434025
1669489307,205278,true,1217125776,28,1210813464,-6312312
1669489451,205279,true,1217004076,28,1210329260,-6674816
1669489991,205281,true,1216760712,28,1208515217,-8245495
1669491851,205281,true,1216760712,28,1204895285,-11865427
1669492031,205282,true,1216639048,28,1204895285,-11743763
1669492331,205283,true,1216517396,28,1204895285,-11622111
1669493171,205285,true,1216274129,28,1204895285,-11378844
1669493219,205285,true,1216274129,28,1204895285,-11378844
1669493399,205287,true,1216030911,28,1205015775,-11015136
1669494023,205288,true,1215909320,28,1205015775,-10893545
1669496483,205290,true,1215666174,28,1205377316,-10288858
1669496771,205290,true,1215666174,28,1205497854,-10168320
1669497491,205292,true,1215423077,28,1205497854,-9925223
1669497503,205293,true,1215301547,28,1205497854,-9803693
1669497515,205295,true,1215058523,28,1205497854,-9560669
1669497611,205295,true,1215058523,28,1205618403,-9440120
1669497815,205296,true,1214937030,28,1205738965,-9198065
1669497935,205298,true,1214694079,28,1205859539,-8834540
1669497995,205299,true,1214572622,28,1205980125,-8592497
1669500023,205299,true,1214572622,28,1208394378,-6178244
1669501619,205300,true,1214451176,28,1208394378,-6056798
1669502219,205301,true,1214329743,28,1208394378,-5935365
1669502471,205303,true,1214086914,28,1208394378,-5692536
1669502639,205303,true,1214086914,28,1208394378,-5692536
1669502651,205303,true,1214086914,28,1208394378,-5692536
1669502759,205305,true,1213844133,28,1208152735,-5691398
1669502771,205307,true,1213601401,28,1208152735,-5448666
1669502783,205307,true,1213601401,28,1208152735,-5448666
1669502915,205309,true,1213358717,28,1207669595,-5689122
1669502927,205311,true,1213116081,28,1207548840,-5567241
1669502963,205313,true,1212873495,28,1207428097,-5445398
1669503311,205314,true,1212752219,28,1205618403,-7133816
1669503551,205315,true,1212630956,28,1204293018,-8337938
1669503575,205317,true,1212388466,28,1204172601,-8215865
1669503779,205319,true,1212146025,28,1203209696,-8936329
1669504091,205320,true,1212024823,28,1201646618,-10378205
1669504295,205321,true,1211903632,28,1200685733,-11217899
1669504355,205323,true,1211661288,28,1200445632,-11215656
1669504379,205325,true,1211418992,28,1200325600,-11093392
1669504583,205326,true,1211297862,28,1199725617,-11572245
1669504727,205327,true,1211176744,28,1199725617,-11451127
1669504775,205329,true,1210934545,28,1199725617,-11208928
1669505207,205331,true,1210692395,28,1200685733,-10006662
1669505735,205331,true,1210692395,28,1201766783,-8925612
1669506011,205333,true,1210450293,28,1202247562,-8202731
1669507895,205335,true,1210208239,28,1202848806,-7359433
1669508339,205336,true,1210087230,28,1202969091,-7118139
1669508471,205337,true,1209966234,28,1202969091,-6997143
1669508987,205338,true,1209845249,28,1202969091,-6876158
1669509143,205340,true,1209603316,28,1202969091,-6634225
1669509155,205341,true,1209482368,28,1203089388,-6392980
1669509587,205342,true,1209361432,28,1203450350,-5911082
1669509803,205343,true,1209240508,28,1203570695,-5669813
1669511135,205345,true,1208998696,28,1204533889,-4464807
1669511615,205347,true,1208756933,28,1204533889,-4223044
1669511723,205348,true,1208636069,28,1204533889,-4102180
1669512059,205349,true,1208515217,28,1204533889,-3981328
1669512203,205351,true,1208273551,28,1204654342,-3619209
1669512299,205353,true,1208031932,28,1204654342,-3377590
1669512515,205354,true,1207911141,28,1204895285,-3015856
1669512551,205355,true,1207790362,28,1204895285,-2895077
1669512719,205356,true,1207669595,28,1205136276,-2533319
1669512731,205358,true,1207428097,28,1205136276,-2291821
1669512755,205358,true,1207428097,28,1205136276,-2291821
1669512767,205359,true,1207307367,28,1205136276,-2171091
1669512803,205361,true,1207065941,28,1205256790,-1809151
1669513019,205361,true,1207065941,28,1205738965,-1326976
1669513235,205362,true,1206945247,28,1206221333,-723914
1669513259,205362,true,1206945247,28,1206221333,-723914
1669513475,205363,true,1206824564,28,1206824564,0
1669513931,205364,true,1206703894,28,1207911141,1207247
1669515011,205363,true,1206824564,28,1209240508,2415944
1669515059,205363,true,1206824564,28,1209240508,2415944
1669515071,205364,true,1206703894,28,1209240508,2536614
1669515179,205365,true,1206583236,28,1209361432,2778196
1669515347,205364,true,1206703894,28,1209603316,2899422
1669516247,205363,true,1206824564,28,1210813464,3988900
1669517027,205364,true,1206703894,28,1211540134,4836240
1669518107,205364,true,1206703894,28,1211540134,4836240
1669518887,205363,true,1206824564,28,1212752219,5927655
1669519631,205362,true,1206945247,28,1213722761,6777514
1669519643,205363,true,1206824564,28,1213844133,7019569
1669519871,205362,true,1206945247,28,1214694079,7748832
1669521287,205361,true,1207065941,28,1218099818,11033877
1669521695,205360,true,1207186648,28,1218343450,11156802
1669522295,205360,true,1207186648,28,1218343450,11156802
1669522403,205360,true,1207186648,28,1218343450,11156802
1669523159,205358,true,1207428097,28,1218221628,10793531
1669524311,205357,true,1207548840,28,1217856234,10307394
1669524323,205357,true,1207548840,28,1217978020,10429180
1669524431,205357,true,1207548840,28,1217978020,10429180
1669524995,205355,true,1207790362,28,1218343450,10553088
1669527383,205354,true,1207911141,28,1218952743,11041602
1669527563,205355,true,1207790362,28,1218952743,11162381
1669527635,205355,true,1207790362,28,1218952743,11162381
1669527827,205353,true,1208031932,28,1218952743,10920811
1669527839,205352,true,1208152735,28,1218952743,10800008
1669528439,205352,true,1208152735,28,1218952743,10800008
1669528475,205352,true,1208152735,28,1219074639,10921904
1669528499,205350,true,1208394378,28,1219074639,10680261
1669528691,205349,true,1208515217,28,1218952743,10437526
1669529255,205350,true,1208394378,28,1218830860,10436482
1669529759,205350,true,1208394378,28,1218587131,10192753
1669529831,205348,true,1208636069,28,1218587131,9951062
1669530215,205347,true,1208756933,28,1218465284,9708351
1669530251,205348,true,1208636069,28,1218465284,9829215
1669530359,205347,true,1208756933,28,1218465284,9708351
1669530599,205346,true,1208877808,28,1218465284,9587476
1669531247,205345,true,1208998696,28,1218952743,9954047
1669531439,205345,true,1208998696,28,1219074639,10075943
1669531931,205345,true,1208998696,28,1219440398,10441702
1669532039,205343,true,1209240508,28,1219562342,10321834
1669532879,205342,true,1209361432,28,1219684298,10322866
1669532963,205342,true,1209361432,28,1219684298,10322866
1669535111,205341,true,1209482368,28,1219562342,10079974
1669535543,205339,true,1209724277,28,1219562342,9838065
1669535663,205337,true,1209966234,28,1219562342,9596108
1669535675,205337,true,1209966234,28,1219562342,9596108
1669536215,205336,true,1210087230,28,1219562342,9475112
1669536239,205334,true,1210329260,28,1219562342,9233082
1669536263,205333,true,1210450293,28,1219562342,9112049
1669536419,205333,true,1210450293,28,1219562342,9112049
1669536803,205332,true,1210571338,28,1219440398,8869060
1669537079,205330,true,1210813464,28,1219440398,8626934
1669537175,205329,true,1210934545,28,1219318466,8383921
1669537247,205329,true,1210934545,28,1219318466,8383921
1669537523,205328,true,1211055639,28,1219318466,8262827
1669537559,205326,true,1211297862,28,1219196546,7898684
1669537583,205326,true,1211297862,28,1219196546,7898684
1669537727,205326,true,1211297862,28,1218952743,7654881
1669537751,205325,true,1211418992,28,1218952743,7533751
1669538027,205324,true,1211540134,28,1218343450,6803316
1669538039,205323,true,1211661288,28,1218221628,6560340
1669538063,205324,true,1211540134,28,1218221628,6681494
1669538111,205323,true,1211661288,28,1218099818,6438530
1669538975,205322,true,1211782454,28,1215666174,3883720
1669539095,205322,true,1211782454,28,1215301547,3519093
1669539563,205322,true,1211782454,28,1214329743,2547289
1669540163,205321,true,1211903632,28,1213965517,2061885
1669540187,205320,true,1212024823,28,1213965517,1940694
1669540307,205319,true,1212146025,28,1213965517,1819492
1669540331,205318,true,1212267240,28,1213965517,1698277
1669541411,205318,true,1212267240,28,1213116081,848841
1669541447,205316,true,1212509705,28,1213116081,606376
1669541579,205315,true,1212630956,28,1213116081,485125
1669541711,205314,true,1212752219,28,1212994782,242563
1669542383,205314,true,1212752219,28,1212752219,0
1669543679,205312,true,1212994782,28,1212752219,-242563
1669543895,205311,true,1213116081,28,1212509705,-606376
1669544231,205311,true,1213116081,28,1212024823,-1091258
1669544687,205310,true,1213237393,28,1211297862,-1939531
1669545251,205309,true,1213358717,28,1210450293,-2908424
1669545275,205308,true,1213480053,28,1210450293,-3029760
1669545311,205308,true,1213480053,28,1210450293,-3029760
1669545431,205308,true,1213480053,28,1210329260,-3150793
1669545467,205307,true,1213601401,28,1210208239,-3393162
1669545515,205305,true,1213844133,28,1210208239,-3635894
1669545575,205305,true,1213844133,28,1210329260,-3514873
1669545587,205305,true,1213844133,28,1210329260,-3514873
1669545599,205304,true,1213965517,28,1210329260,-3636257
1669545815,205302,true,1214208323,28,1210813464,-3394859
1669545827,205302,true,1214208323,28,1210813464,-3394859
1669545839,205302,true,1214208323,28,1210813464,-3394859
1669546067,205301,true,1214329743,28,1211661288,-2668455
1669546343,205299,true,1214572622,28,1212630956,-1941666
1669546607,205299,true,1214572622,28,1213601401,-971221
1669546643,205299,true,1214572622,28,1213722761,-849861
1669546655,205297,true,1214815548,28,1213722761,-1092787
1669546679,205295,true,1215058523,28,1213844133,-1214390
1669546727,205296,true,1214937030,28,1213965517,-971513
1669547123,205296,true,1214937030,28,1214937030,0
1669547171,205294,true,1215180029,28,1215058523,-121506
1669547363,205293,true,1215301547,28,1215423077,121530
1669548023,205293,true,1215301547,28,1215180029,-121518
1669550315,205293,true,1215301547,28,1214694079,-607468
1669550843,205292,true,1215423077,28,1214694079,-728998
1669551431,205290,true,1215666174,28,1214694079,-972095
1669551827,205291,true,1215544620,28,1214694079,-850541
1669551851,205291,true,1215544620,28,1214694079,-850541
1669552139,205290,true,1215666174,28,1214694079,-972095
1669552559,205289,true,1215787741,28,1214694079,-1093662
1669552691,205289,true,1215787741,28,1214694079,-1093662
1669553495,205290,true,1215666174,28,1214694079,-972095
1669553783,205289,true,1215787741,28,1214694079,-1093662
1669553831,205287,true,1216030911,28,1214694079,-1336832
1669553927,205288,true,1215909320,28,1214694079,-1215241
1669553987,205288,true,1215909320,28,1214694079,-1215241
1669554095,205287,true,1216030911,28,1214694079,-1336832
1669554239,205286,true,1216152514,28,1214694079,-1458435
1669554887,205287,true,1216030911,28,1214694079,-1336832
1669555091,205287,true,1216030911,28,1214694079,-1336832
1669555919,205287,true,1216030911,28,1214694079,-1336832
1669556471,205285,true,1216274129,28,1214694079,-1580050
1669556603,205286,true,1216152514,28,1214694079,-1458435
1669556711,205287,true,1216030911,28,1214694079,-1336832
1669556759,205287,true,1216030911,28,1214694079,-1336832
1669556855,205287,true,1216030911,28,1214694079,-1336832
1669557047,205288,true,1215909320,28,1214572622,-1336698
1669557935,205288,true,1215909320,28,1214208323,-1700997
1669558055,205289,true,1215787741,28,1214086914,-1700827
1669558619,205288,true,1215909320,28,1214694079,-1215241
1669559579,205288,true,1215909320,28,1216152514,243194
1669559807,205289,true,1215787741,28,1216517396,729655
1669559867,205289,true,1215787741,28,1216517396,729655
1669560335,205288,true,1215909320,28,1216517396,608076
1669560491,205289,true,1215787741,28,1216395756,608015
1669560551,205290,true,1215666174,28,1216395756,729582
1669560587,205290,true,1215666174,28,1216395756,729582
1669560755,205289,true,1215787741,28,1216274129,486388
1669560887,205290,true,1215666174,28,1216030911,364737
1669560923,205291,true,1215544620,28,1216030911,486291
1669560935,205291,true,1215544620,28,1216030911,486291
1669560983,205291,true,1215544620,28,1215909320,364700
1669561175,205291,true,1215544620,28,1215666174,121554
1669561187,205292,true,1215423077,28,1215666174,243097
1669561559,205293,true,1215301547,28,1215180029,-121518
1669561703,205292,true,1215423077,28,1214694079,-728998
1669561763,205293,true,1215301547,28,1214572622,-728925
1669562483,205294,true,1215180029,28,1212752219,-2427810
1669563251,205295,true,1215058523,28,1211661288,-3397235
1669563287,205294,true,1215180029,28,1211540134,-3639895
1669563455,205295,true,1215058523,28,1211540134,-3518389
1669563515,205296,true,1214937030,28,1211540134,-3396896
1669563623,205297,true,1214815548,28,1211661288,-3154260
1669563827,205297,true,1214815548,28,1211782454,-3033094
1669564307,205297,true,1214815548,28,1212146025,-2669523
1669564391,205298,true,1214694079,28,1212267240,-2426839
1669564595,205299,true,1214572622,28,1212509705,-2062917
1669564619,205299,true,1214572622,28,1212509705,-2062917
1669565807,205299,true,1214572622,28,1214451176,-121446
1669565819,205300,true,1214451176,28,1214451176,0
1669565831,205300,true,1214451176,28,1214451176,0
1669565843,205300,true,1214451176,28,1214451176,0
1669565855,205300,true,1214451176,28,1214451176,0
1669565867,205301,true,1214329743,28,1214451176,121433
1669566179,205301,true,1214329743,28,1214937030,607287
1669566599,205301,true,1214329743,28,1215423077,1093334
1669566623,205301,true,1214329743,28,1215423077,1093334
1669567799,205302,true,1214208323,28,1215909320,1700997
1669568555,205302,true,1214208323,28,1215909320,1700997
1669568615,205302,true,1214208323,28,1215909320,1700997
1669568651,205302,true,1214208323,28,1215909320,1700997
1669568891,205302,true,1214208323,28,1215787741,1579418
1669571147,205302,true,1214208323,28,1214937030,728707
1669572407,205302,true,1214208323,28,1214937030,728707
1669572935,205302,true,1214208323,28,1214937030,728707
1669573799,205302,true,1214208323,28,1214937030,728707
1669574063,205302,true,1214208323,28,1214937030,728707
1669574159,205302,true,1214208323,28,1215058523,850200
1669574411,205302,true,1214208323,28,1215058523,850200
1669574819,205302,true,1214208323,28,1215058523,850200
1669575791,205302,true,1214208323,28,1215058523,850200
1669576763,205301,true,1214329743,28,1215058523,728780
1669577459,205301,true,1214329743,28,1215058523,728780
1669578119,205301,true,1214329743,28,1214937030,607287
1669578539,205301,true,1214329743,28,1214937030,607287
1669582283,205301,true,1214329743,28,1213358717,-971026
1669582355,205301,true,1214329743,28,1213358717,-971026
1669582679,205301,true,1214329743,28,1213480053,-849690
1669583915,205301,true,1214329743,28,1213480053,-849690
1669585139,205301,true,1214329743,28,1213480053,-849690
1669585775,205301,true,1214329743,28,1213480053,-849690
1669585895,205301,true,1214329743,28,1213601401,-728342
1669586123,205300,true,1214451176,28,1213601401,-849775
1669587851,205300,true,1214451176,28,1213601401,-849775
1669588079,205300,true,1214451176,28,1213601401,-849775
1669588943,205300,true,1214451176,28,1213601401,-849775
1669589639,205299,true,1214572622,28,1213722761,-849861
1669590179,205299,true,1214572622,28,1213722761,-849861
1669590191,205299,true,1214572622,28,1213722761,-849861
1669590203,205299,true,1214572622,28,1213722761,-849861
1669590227,205299,true,1214572622,28,1213722761,-849861
1669590239,205300,true,1214451176,28,1213601401,-849775
1669590251,205300,true,1214451176,28,1213601401,-849775
1669591007,205301,true,1214329743,28,1210571338,-3758405
1669591247,205301,true,1214329743,28,1209603316,-4726427
1669591319,205303,true,1214086914,28,1209361432,-4725482
1669591331,205303,true,1214086914,28,1209361432,-4725482
1669591355,205304,true,1213965517,28,1209240508,-4725009
1669591391,205304,true,1213965517,28,1208998696,-4966821
1669591403,205306,true,1213722761,28,1208998696,-4724065
1669591439,205306,true,1213722761,28,1208756933,-4965828
1669591451,205307,true,1213601401,28,1208756933,-4844468
1669591463,205307,true,1213601401,28,1208636069,-4965332
1669591883,205310,true,1213237393,28,1205738965,-7498428
1669591895,205310,true,1213237393,28,1205618403,-7618990
1669591991,205311,true,1213116081,28,1204895285,-8220796
1669592279,205312,true,1212994782,28,1203811422,-9183360
1669592615,205314,true,1212752219,28,1202488023,-10264196
1669592711,205315,true,1212630956,28,1202007148,-10623808
1669592723,205315,true,1212630956,28,1201886960,-10743996
1669593239,205317,true,1212388466,28,1199245847,-13142619
1669593251,205320,true,1212024823,28,1199125934,-12898889
1669593263,205320,true,1212024823,28,1199125934,-12898889
1669593275,205321,true,1211903632,28,1199125934,-12777698
1669593287,205322,true,1211782454,28,1199006033,-12776421
1669593479,205326,true,1211297862,28,1198167065,-13130797
1669593671,205326,true,1211297862,28,1197208962,-14088900
1669593971,205327,true,1211176744,28,1196132013,-15044731
1669593983,205329,true,1210934545,28,1196012412,-14922133
1669594091,205332,true,1210571338,28,1195653680,-14917658
1669594235,205333,true,1210450293,28,1195175538,-15274755
1669594763,205333,true,1210450293,28,1193981019,-16469274
1669594835,205335,true,1210208239,28,1193861633,-16346606
1669594859,205339,true,1209724277,28,1193861633,-15862644
1669595243,205339,true,1209724277,28,1193742259,-15982018
1669595351,205339,true,1209724277,28,1193861633,-15862644
1669595567,205341,true,1209482368,28,1193981019,-15501349
1669596239,205344,true,1209119596,28,1194458683,-14660913
1669596287,205345,true,1208998696,28,1194578129,-14420567
1669597739,205345,true,1208998696,28,1194936538,-14062158
1669597835,205346,true,1208877808,28,1194936538,-13941270
1669597847,205350,true,1208394378,28,1194936538,-13457840
1669597859,205351,true,1208273551,28,1194936538,-13337013
1669597871,205352,true,1208152735,28,1194936538,-13216197
1669597883,205353,true,1208031932,28,1194936538,-13095394
1669597943,205358,true,1207428097,28,1194697587,-12730510
1669598135,205359,true,1207307367,28,1193981019,-13326348
1669598147,205360,true,1207186648,28,1193981019,-13205629
1669598291,205362,true,1206945247,28,1193384208,-13561039
1669598303,205366,true,1206462589,28,1193384208,-13078381
1669598315,205367,true,1206341955,28,1193264881,-13077074
1669598423,205368,true,1206221333,28,1192668428,-13552905
1669598483,205371,true,1205859539,28,1192310699,-13548840
1669598495,205375,true,1205377316,28,1192310699,-13066617
1669598507,205376,true,1205256790,28,1192191480,-13065310
1669598519,205377,true,1205136276,28,1192072272,-13064004
1669598555,205380,true,1204774808,28,1191833894,-12940914
1669598567,205384,true,1204293018,28,1191833894,-12459124
1669598627,205385,true,1204172601,28,1191357279,-12815322
1669598699,205386,true,1204052196,28,1190880856,-13171340
1669598723,205388,true,1203811422,28,1190761779,-13049643
1669598735,205393,true,1203209696,28,1190642715,-12566981
1669598783,205393,true,1203209696,28,1190285594,-12924102
1669598795,205395,true,1202969091,28,1190166577,-12802514
1669598855,205398,true,1202608272,28,1189690629,-12917643
1669598879,205402,true,1202127349,28,1189452727,-12674622
1669598915,205403,true,1202007148,28,1189214872,-12792276
1669598927,205405,true,1201766783,28,1189095962,-12670821
1669599047,205408,true,1201406325,28,1188026311,-13380014
1669599059,205412,true,1200925883,28,1187907520,-13018363
1669599083,205414,true,1200685733,28,1187669974,-13015759
1669599095,205415,true,1200565677,28,1187551219,-13014458
1669599119,205419,true,1200085571,28,1187313745,-12771826
1669599143,205423,true,1199605656,28,1187076318,-12529338
1669599155,205426,true,1199245847,28,1186838938,-12406909
1669599167,205428,true,1199006033,28,1186720266,-12285767
1669599179,205432,true,1198526551,28,1186601606,-11924945
1669599191,205438,true,1197807687,28,1186364321,-11443366
1669599215,205439,true,1197687918,28,1186008483,-11679435
1669599287,205441,true,1197448416,28,1185178609,-12269807
1669599299,205445,true,1196969556,28,1184941609,-12027947
1669599311,205451,true,1196251626,28,1184823126,-11428500
1669599359,205453,true,1196012412,28,1184112481,-11899931
1669599383,205455,true,1195773245,28,1183875694,-11897551
1669599827,205460,true,1195175538,28,1176794060,-18381478
1669599863,205466,true,1194458683,28,1176205840,-18252843
1669599899,205468,true,1194219827,28,1175735475,-18484352
1669599923,205470,true,1193981019,28,1175500363,-18480656
1669600067,205476,true,1193264881,28,1173503810,-19761071
1669600403,205481,true,1192668428,28,1169754787,-22913641
1669600931,205483,true,1192429930,28,1165085346,-27344584
1669600943,205485,true,1192191480,28,1165085346,-27106134
1669600979,205491,true,1191476415,28,1164968849,-26507566
1669601111,205497,true,1190761779,28,1164270113,-26491666
1669601879,205499,true,1190523663,28,1163222793,-27300870
1669601903,205501,true,1190285594,28,1163222793,-27062801
1669601915,205507,true,1189571672,28,1163222793,-26348879
1669601927,205512,true,1188977065,28,1163222793,-25754272
1669601939,205514,true,1188739305,28,1163222793,-25516512
1669601951,205516,true,1188501593,28,1163222793,-25278800
1669601987,205522,true,1187788741,28,1163222793,-24565948
1669602143,205527,true,1187195025,28,1163106483,-24088542
1669602155,205529,true,1186957622,28,1163106483,-23851139
1669602203,205531,true,1186720266,28,1163106483,-23613783
1669602227,205537,true,1186008483,28,1163222793,-22785690
1669602275,205541,true,1185534198,28,1163222793,-22311405
1669602971,205543,true,1185297127,28,1164502978,-20794149
1669603271,205545,true,1185060103,28,1165201855,-19858248
1669603343,205551,true,1184349316,28,1165434907,-18914409
1669603355,205556,true,1183757319,28,1165434907,-18322412
1669603379,205558,true,1183520603,28,1165434907,-18085696
1669604027,205560,true,1183283934,28,1165901151,-17382783
1669604759,205565,true,1182692469,28,1164852364,-17840105
1669605143,205569,true,1182219511,28,1164270113,-17949398
1669605203,205571,true,1181983102,28,1164270113,-17712989
1669605227,205573,true,1181746741,28,1164270113,-17476628
1669605299,205578,true,1181156045,28,1164270113,-16885932
1669605335,205582,true,1180683701,28,1164270113,-16413588
1669605347,205583,true,1180565644,28,1164386540,-16179104
1669605371,205585,true,1180329566,28,1164386540,-15943026
1669605431,205590,true,1179739579,28,1164386540,-15353039
1669605443,205594,true,1179267801,28,1164386540,-14881261
1669605455,205595,true,1179149886,28,1164386540,-14763346
1669605491,205597,true,1178914091,28,1164502978,-14411113
1669605551,205602,true,1178324811,28,1164502978,-13821833
1669605803,205604,true,1178089181,28,1164852364,-13236817
1669606091,205606,true,1177853599,28,1165318375,-12535224
1669606151,205607,true,1177735825,28,1165434907,-12300918
1669606715,205612,true,1177147134,28,1166367581,-10779553
1669606919,205614,true,1176911740,28,1166717526,-10194214
1669606931,205615,true,1176794060,28,1166717526,-10076534
1669606967,205617,true,1176558737,28,1166834198,-9724539
1669606991,205621,true,1176088231,28,1166834198,-9254033
1669607099,205623,true,1175853049,28,1167067577,-8785472
1669607159,205624,true,1175735475,28,1167184283,-8551192
1669607963,205625,true,1175617913,28,1168235170,-7382743
1669608119,205629,true,1175147784,28,1168468828,-6678956
1669608743,205630,true,1175030281,28,1169053180,-5977101
1669608755,205631,true,1174912789,28,1169053180,-5859609
1669608827,205632,true,1174795310,28,1169170085,-5625225
1669608863,205636,true,1174325509,28,1169170085,-5155424
1669609415,205637,true,1174208088,28,1169520871,-4687217
1669609475,205638,true,1174090679,28,1169637823,-4452856
1669609547,205639,true,1173973282,28,1169637823,-4335459
1669609595,205643,true,1173503810,28,1169754787,-3749023
1669609631,205644,true,1173386471,28,1169754787,-3631684
1669609667,205645,true,1173269144,28,1169871762,-3397382
1669609859,205646,true,1173151829,28,1170456815,-2695014
1669610063,205649,true,1172799954,28,1171042161,-1757793
1669610327,205650,true,1172682686,28,1171744962,-937724
1669610399,205651,true,1172565429,28,1171979322,-586107
1669610435,205652,true,1172448184,28,1172096520,-351664
1669612523,205656,true,1171979322,28,1174442942,2463620
1669612547,205656,true,1171979322,28,1174442942,2463620
1669612655,205657,true,1171862136,28,1174442942,2580806
1669612667,205658,true,1171744962,28,1174442942,2697980
1669612679,205661,true,1171393508,28,1174442942,3049434
1669612691,205661,true,1171393508,28,1174442942,3049434
1669612763,205662,true,1171276381,28,1174442942,3166561
1669612823,205663,true,1171159265,28,1174325509,3166244
1669613123,205666,true,1170807987,28,1173855896,3047909
1669613759,205666,true,1170807987,28,1172799954,1991967
1669613855,205667,true,1170690918,28,1172682686,1991768
1669614311,205667,true,1170690918,28,1171862136,1171218
1669614443,205670,true,1170339781,28,1171627799,1288018
1669614539,205670,true,1170339781,28,1171510648,1170867
1669614647,205671,true,1170222759,28,1171510648,1287889
1669615007,205671,true,1170222759,28,1171276381,1053622
1669615127,205674,true,1169871762,28,1171276381,1404619
1669615139,205674,true,1169871762,28,1171276381,1404619
1669615151,205675,true,1169754787,28,1171276381,1521594
1669616555,205675,true,1169754787,28,1169754787,0
1669616591,205678,true,1169403931,28,1169754787,350856
1669617839,205678,true,1169403931,28,1169637823,233892
1669618079,205678,true,1169403931,28,1169637823,233892
1669618115,205679,true,1169287002,28,1169637823,350821
1669618187,205681,true,1169053180,28,1169754787,701607
1669618343,205681,true,1169053180,28,1169871762,818582
1669618799,205681,true,1169053180,28,1170105748,1052568
1669618907,205682,true,1168936286,28,1170222759,1286473
1669618991,205684,true,1168702534,28,1170222759,1520225
1669619075,205683,true,1168819404,28,1170339781,1520377
1669620191,205684,true,1168702534,28,1171159265,2456731
1669620215,205684,true,1168702534,28,1171159265,2456731
1669620623,205686,true,1168468828,28,1171276381,2807553
1669620947,205685,true,1168585675,28,1171276381,2690706
1669621199,205685,true,1168585675,28,1171276381,2690706
1669623059,205685,true,1168585675,28,1171276381,2690706
1669624175,205686,true,1168468828,28,1171276381,2807553
1669624343,205684,true,1168702534,28,1171276381,2573847
1669626131,205684,true,1168702534,28,1171744962,3042428
1669626947,205685,true,1168585675,28,1172096520,3510845
1669626959,205686,true,1168468828,28,1172096520,3627692
1669627163,205684,true,1168702534,28,1172096520,3393986
1669627763,205684,true,1168702534,28,1172330951,3628417
1669627907,205684,true,1168702534,28,1172330951,3628417
1669628099,205683,true,1168819404,28,1172330951,3511547
1669628183,205682,true,1168936286,28,1172330951,3394665
1669629011,205682,true,1168936286,28,1172330951,3394665
1669629335,205682,true,1168936286,28,1172330951,3394665
1669629515,205681,true,1169053180,28,1172330951,3277771
1669629671,205679,true,1169287002,28,1172330951,3043949
1669629695,205679,true,1169287002,28,1172330951,3043949
1669629707,205679,true,1169287002,28,1172330951,3043949
1669629767,205679,true,1169287002,28,1172213730,2926728
1669630151,205678,true,1169403931,28,1171627799,2223868
1669630415,205677,true,1169520871,28,1171276381,1755510
1669631279,205677,true,1169520871,28,1170105748,584877
1669633019,205676,true,1169637823,28,1169988750,350927
1669633031,205675,true,1169754787,28,1169988750,233963
1669633439,205675,true,1169754787,28,1169637823,-116964
1669634219,205675,true,1169754787,28,1168702534,-1052253
1669634375,205675,true,1169754787,28,1168585675,-1169112
1669634867,205674,true,1169871762,28,1168351993,-1519769
1669635131,205673,true,1169988750,28,1168585675,-1403075
1669637663,205673,true,1169988750,28,1168936286,-1052464
1669637735,205674,true,1169871762,28,1169053180,-818582
1669638707,205673,true,1169988750,28,1169520871,-467879
1669638719,205672,true,1170105748,28,1169520871,-584877
1669638791,205672,true,1170105748,28,1169637823,-467925
1669639319,205673,true,1169988750,28,1170105748,116998
1669643387,205672,true,1170105748,28,1170573861,468113
1669643951,205671,true,1170222759,28,1170573861,351102
1669644539,205671,true,1170222759,28,1170573861,351102
1669644731,205671,true,1170222759,28,1170573861,351102
1669645595,205670,true,1170339781,28,1170573861,234080
1669645943,205669,true,1170456815,28,1170573861,117046
1669645955,205669,true,1170456815,28,1170690918,234103
1669646111,205669,true,1170456815,28,1170807987,351172
1669646123,205668,true,1170573861,28,1170807987,234126
1669646135,205667,true,1170690918,28,1170807987,117069
1669646147,205666,true,1170807987,28,1170807987,0
1669646195,205666,true,1170807987,28,1171042161,234174
1669646603,205664,true,1171042161,28,1172565429,1523268
1669646867,205664,true,1171042161,28,1173503810,2461649
1669646927,205663,true,1171159265,28,1173738522,2579257
1669646939,205662,true,1171276381,28,1173738522,2462141
1669646963,205661,true,1171393508,28,1173855896,2462388
1669646975,205661,true,1171393508,28,1173855896,2462388
1669647035,205661,true,1171393508,28,1173973282,2579774
1669647047,205660,true,1171510648,28,1173973282,2462634
1669647395,205659,true,1171627799,28,1174442942,2815143
1669647407,205659,true,1171627799,28,1174442942,2815143
1669647419,205659,true,1171627799,28,1174442942,2815143
1669647443,205658,true,1171744962,28,1174442942,2697980
1669647635,205659,true,1171627799,28,1174208088,2580289
1669648091,205659,true,1171627799,28,1172682686,1054887
1669648139,205659,true,1171627799,28,1172330951,703152
1669648151,205659,true,1171627799,28,1172213730,585931
1669648739,205661,true,1171393508,28,1167534474,-3859034
1669648991,205661,true,1171393508,28,1166017741,-5375767
1669649435,205662,true,1171276381,28,1163222793,-8053588
1669649447,205661,true,1171393508,28,1163106483,-8287025
1669650059,205664,true,1171042161,28,1160550589,-10491572
1669650095,205665,true,1170925068,28,1160434545,-10490523
1669650383,205665,true,1170925068,28,1159738528,-11186540
1669650395,205665,true,1170925068,28,1159738528,-11186540
1669650983,205667,true,1170690918,28,1158811155,-11879763
1669650995,205668,true,1170573861,28,1158811155,-11762706
1669651019,205670,true,1170339781,28,1158811155,-11528626
1669651583,205669,true,1170456815,28,1159738528,-10718287
1669651607,205671,true,1170222759,28,1159854502,-10368257
1669651751,205672,true,1170105748,28,1159970487,-10135261
1669651811,205674,true,1169871762,28,1159970487,-9901275
1669651919,205673,true,1169988750,28,1160086484,-9902266
1669652087,205676,true,1169637823,28,1160202493,-9435330
1669652243,205677,true,1169520871,28,1160434545,-9086326
1669652279,205678,true,1169403931,28,1160434545,-8969386
1669652315,205678,true,1169403931,28,1160434545,-8969386
1669652327,205680,true,1169170085,28,1160434545,-8735540
1669652363,205681,true,1169053180,28,1160434545,-8618635
1669652375,205682,true,1168936286,28,1160434545,-8501741
1669652459,205683,true,1168819404,28,1160202493,-8616911
1669652639,205685,true,1168585675,28,1159738528,-8847147
1669652663,205686,true,1168468828,28,1159738528,-8730300
1669652687,205687,true,1168351993,28,1159738528,-8613465
1669652735,205688,true,1168235170,28,1159622566,-8612604
1669652771,205690,true,1168001558,28,1159622566,-8378992
1669652819,205690,true,1168001558,28,1159622566,-8378992
1669652939,205691,true,1167884769,28,1159390676,-8494093
1669653059,205691,true,1167884769,28,1159158833,-8725936
1669653071,205693,true,1167651227,28,1159158833,-8492394
1669653131,205694,true,1167534474,28,1159042929,-8491545
1669653143,205694,true,1167534474,28,1159042929,-8491545
1669653215,205694,true,1167534474,28,1159042929,-8491545
1669653287,205696,true,1167301002,28,1159042929,-8258073
1669653623,205696,true,1167301002,28,1159274749,-8026253
1669653671,205697,true,1167184283,28,1159390676,-7793607
1669653839,205696,true,1167301002,28,1159622566,-7678436
1669653863,205698,true,1167067577,28,1159622566,-7445011
1669653899,205699,true,1166950882,28,1159738528,-7212354
1669653995,205699,true,1166950882,28,1159970487,-6980395
1669654007,205698,true,1167067577,28,1160086484,-6981093
1669654019,205700,true,1166834198,28,1160086484,-6747714
1669654103,205700,true,1166834198,28,1160434545,-6399653
1669654523,205700,true,1166834198,28,1163222793,-3611405
1669654535,205699,true,1166950882,28,1163339116,-3611766
1669654547,205701,true,1166717526,28,1163339116,-3378410
1669654571,205701,true,1166717526,28,1163571795,-3145731
1669654583,205700,true,1166834198,28,1163688152,-3146046
1669654595,205699,true,1166950882,28,1163688152,-3262730
1669654607,205701,true,1166717526,28,1163804521,-2913005
1669654631,205700,true,1166834198,28,1164153697,-2680501
1669654751,205698,true,1167067577,28,1165551450,-1516127
1669654799,205697,true,1167184283,28,1166134343,-1049940
1669654931,205698,true,1167067577,28,1167651227,583650
1669654955,205698,true,1167067577,28,1167884769,817192
1669655123,205696,true,1167301002,28,1169403931,2102929
1669655171,205695,true,1167417732,28,1169871762,2454030
1669655195,205696,true,1167301002,28,1170105748,2804746
1669655339,205695,true,1167417732,28,1171510648,4092916
1669655351,205694,true,1167534474,28,1171627799,4093325
1669655363,205693,true,1167651227,28,1171744962,4093735
1669655387,205694,true,1167534474,28,1171979322,4444848
1669655555,205694,true,1167534474,28,1173386471,5851997
1669655567,205692,true,1167767992,28,1173503810,5735818
1669655591,205691,true,1167884769,28,1173738522,5853753
1669655615,205692,true,1167767992,28,1173855896,6087904
1669655627,205691,true,1167884769,28,1173973282,6088513
1669655687,205690,true,1168001558,28,1174442942,6441384
1669655975,205689,true,1168118358,28,1176088231,7969873
1669656287,205690,true,1168001558,28,1177618063,9616505
1669657715,205689,true,1168118358,28,1176558737,8440379
1669657751,205687,true,1168351993,28,1176558737,8206744
1669657787,205686,true,1168468828,28,1176558737,8089909
1669657883,205687,true,1168351993,28,1176558737,8206744
1669657907,205687,true,1168351993,28,1176558737,8206744
1669658087,205686,true,1168468828,28,1176323460,7854632
1669658123,205684,true,1168702534,28,1176323460,7620926
1669658639,205685,true,1168585675,28,1175735475,7149800
1669658675,205685,true,1168585675,28,1175617913,7032238
1669658783,205684,true,1168702534,28,1175500363,6797829
1669658831,205683,true,1168819404,28,1175382825,6563421
1669658843,205684,true,1168702534,28,1175382825,6680291
1669658855,205684,true,1168702534,28,1175382825,6680291
1669659563,205684,true,1168702534,28,1173738522,5035988
1669659635,205682,true,1168936286,28,1173621160,4684874
1669659719,205684,true,1168702534,28,1173503810,4801276
1669660703,205684,true,1168702534,28,1172448184,3745650
1669661183,205683,true,1168819404,28,1172448184,3628780
1669661543,205682,true,1168936286,28,1172448184,3511898
1669661843,205683,true,1168819404,28,1172330951,3511547
1669661855,205684,true,1168702534,28,1172330951,3628417
1669661951,205683,true,1168819404,28,1172213730,3394326
1669662059,205683,true,1168819404,28,1172096520,3277116
1669662287,205685,true,1168585675,28,1171979322,3393647
1669662443,205686,true,1168468828,28,1171744962,3276134
1669662803,205685,true,1168585675,28,1171159265,2573590
1669664399,205686,true,1168468828,28,1168819404,350576
1669664483,205688,true,1168235170,28,1168702534,467364
1669664663,205688,true,1168235170,28,1168585675,350505
1669664687,205687,true,1168351993,28,1168702534,350541
1669664699,205687,true,1168351993,28,1168702534,350541
1669664723,205689,true,1168118358,28,1168702534,584176
1669664747,205689,true,1168118358,28,1168702534,584176
1669664759,205688,true,1168235170,28,1168702534,467364
1669668083,205688,true,1168235170,28,1169988750,1753580
1669668443,205689,true,1168118358,28,1170105748,1987390
1669668455,205689,true,1168118358,28,1170105748,1987390
1669669103,205688,true,1168235170,28,1170339781,2104611
1669669115,205687,true,1168351993,28,1170339781,1987788
1669669163,205687,true,1168351993,28,1170339781,1987788
1669669367,205686,true,1168468828,28,1170456815,1987987
1669669427,205685,true,1168585675,28,1170456815,1871140
1669669667,205684,true,1168702534,28,1170690918,1988384
1669670015,205684,true,1168702534,28,1170925068,2222534
1669670411,205683,true,1168819404,28,1171159265,2339861
1669671179,205681,true,1169053180,28,1171276381,2223201
1669674407,205680,true,1169170085,28,1171276381,2106296
1669675511,205680,true,1169170085,28,1170807987,1637902
1669675763,205679,true,1169287002,28,1170573861,1286859
1669676003,205677,true,1169520871,28,1170456815,935944
1669676351,205677,true,1169520871,28,1170339781,818910
1669676663,205677,true,1169520871,28,1170339781,818910
1669676891,205676,true,1169637823,28,1170339781,701958
1669678571,205674,true,1169871762,28,1170339781,468019
1669679087,205674,true,1169871762,28,1170339781,468019
1669680107,205674,true,1169871762,28,1170339781,468019
1669680335,205673,true,1169988750,28,1170339781,351031
1669680683,205671,true,1170222759,28,1170339781,117022
1669680695,205671,true,1170222759,28,1170339781,117022
1669680707,205671,true,1170222759,28,1170339781,117022
1669680803,205670,true,1170339781,28,1170105748,-234033
1669680815,205669,true,1170456815,28,1170105748,-351067
1669680839,205668,true,1170573861,28,1169988750,-585111
1669680851,205668,true,1170573861,28,1169871762,-702099
1669680899,205667,true,1170690918,28,1169754787,-936131
1669681439,205667,true,1170690918,28,1167301002,-3389916
1669682279,205666,true,1170807987,28,1163455449,-7352538
1669682351,205666,true,1170807987,28,1163222793,-7585194
1669682387,205666,true,1170807987,28,1163106483,-7701504
1669682399,205665,true,1170925068,28,1162990184,-7934884
1669682411,205664,true,1171042161,28,1162990184,-8051977
1669682507,205664,true,1171042161,28,1162757620,-8284541
1669683563,205664,true,1171042161,28,1163920901,-7121260
1669683755,205663,true,1171159265,28,1164270113,-6889152
1669683911,205663,true,1171159265,28,1164502978,-6656287
1669684055,205663,true,1171159265,28,1164619429,-6539836
1669684427,205663,true,1171159265,28,1164852364,-6306901
1669684655,205663,true,1171159265,28,1164852364,-6306901
1669685831,205662,true,1171276381,28,1164852364,-6424017
1669685903,205662,true,1171276381,28,1164968849,-6307532
1669685927,205663,true,1171159265,28,1164968849,-6190416
1669685963,205662,true,1171276381,28,1165085346,-6191035
1669685975,205662,true,1171276381,28,1165085346,-6191035
1669686107,205661,true,1171393508,28,1165434907,-5958601
1669686131,205662,true,1171276381,28,1165434907,-5841474
1669686143,205662,true,1171276381,28,1165551450,-5724931
1669686383,205661,true,1171393508,28,1166484218,-4909290
1669686407,205660,true,1171510648,28,1166600866,-4909782
1669686419,205660,true,1171510648,28,1166717526,-4793122
1669686443,205661,true,1171393508,28,1166834198,-4559310
1669686455,205659,true,1171627799,28,1166950882,-4676917
1669686875,205658,true,1171744962,28,1169637823,-2107139
1669686935,205660,true,1171510648,28,1170105748,-1404900
1669686947,205662,true,1171276381,28,1170105748,-1170633
1669687079,205660,true,1171510648,28,1171042161,-468487
1669687343,205659,true,1171627799,28,1172799954,1172155
1669687463,205661,true,1171393508,28,1173621160,2227652
1669687751,205662,true,1171276381,28,1175382825,4106444
1669687979,205661,true,1171393508,28,1176323460,4929952
1669688147,205660,true,1171510648,28,1176794060,5283412
1669688183,205662,true,1171276381,28,1176911740,5635359
1669688243,205663,true,1171159265,28,1177147134,5987869
1669688387,205661,true,1171393508,28,1177382575,5989067
1669688987,205659,true,1171627799,28,1180093536,8465737
1669691015,205660,true,1171510648,28,1184941609,13430961
1669691111,205661,true,1171393508,28,1184941609,13548101
1669691159,205659,true,1171627799,28,1184941609,13313810
1669693619,205657,true,1171862136,28,1184704656,12842520
1669694687,205657,true,1171862136,28,1184704656,12842520
1669694711,205659,true,1171627799,28,1184823126,13195327
1669696067,205656,true,1171979322,28,1187788741,15809419
1669696079,205654,true,1172213730,28,1187788741,15575011
1669696103,205654,true,1172213730,28,1187907520,15693790
1669696559,205655,true,1172096520,28,1189690629,17594109
1669696631,205652,true,1172448184,28,1189809598,17361414
1669696703,205649,true,1172799954,28,1190047572,17247618
1669697111,205649,true,1172799954,28,1191119044,18319090
1669697123,205649,true,1172799954,28,1191238156,18438202
1669697147,205646,true,1173151829,28,1191238156,18086327
1669697159,205643,true,1173503810,28,1191357279,17853469
1669697363,205643,true,1173503810,28,1191953077,18449267
1669697399,205643,true,1173503810,28,1192072272,18568462
1669697447,205640,true,1173855896,28,1192310699,18454803
1669697471,205637,true,1174208088,28,1192310699,18102611
1669697507,205636,true,1174325509,28,1192549173,18223664
1669697519,205636,true,1174325509,28,1192549173,18223664
1669697663,205633,true,1174677842,28,1193264881,18587039
1669697927,205629,true,1175147784,28,1194458683,19310899
1669698239,205628,true,1175265298,28,1195414585,20149287
1669698251,205628,true,1175265298,28,1195414585,20149287
1669698263,205625,true,1175617913,28,1195414585,19796672
1669698371,205621,true,1176088231,28,1196132013,20043782
1669698407,205619,true,1176323460,28,1196251626,19928166
1669698635,205619,true,1176323460,28,1197687918,21364458
1669698683,205615,true,1176794060,28,1197927467,21133407
1669698887,205611,true,1177264849,28,1199365771,22100922
1669698899,205609,true,1177500313,28,1199485708,21985395
1669699007,205608,true,1177618063,28,1200205579,22587516
1669699019,205604,true,1178089181,28,1200325600,22236419
1669699031,205600,true,1178560488,28,1200445632,21885144
1669699187,205597,true,1178914091,28,1201526466,22612375
1669700015,205596,true,1179031983,28,1206824564,27792581
1669700663,205592,true,1179503666,28,1208273551,28769885
1669701527,205588,true,1179975538,28,1208394378,28418840
1669701647,205586,true,1180211545,28,1208394378,28182833
1669701755,205584,true,1180447599,28,1208394378,27946779
1669702775,205581,true,1180801769,28,1208394378,27592609
1669702991,205576,true,1181392288,28,1208394378,27002090
1669703183,205574,true,1181628578,28,1208394378,26765800
1669703783,205573,true,1181746741,28,1208273551,26526810
1669704179,205569,true,1182219511,28,1208152735,25933224
1669704215,205565,true,1182692469,28,1208152735,25460266
1669704287,205563,true,1182929020,28,1208152735,25223715
1669704587,205562,true,1183047313,28,1207911141,24863828
1669704755,205558,true,1183520603,28,1207911141,24390538
1669704875,205554,true,1183994082,28,1207790362,23796280
1669705643,205552,true,1184230893,28,1207428097,23197204
1669706495,205551,true,1184349316,28,1207065941,22716625
1669706543,205548,true,1184704656,28,1207065941,22361285
1669706567,205543,true,1185297127,28,1207065941,21768814
1669706579,205541,true,1185534198,28,1207065941,21531743
1669706603,205540,true,1185652751,28,1207065941,21413190
1669706699,205536,true,1186127084,28,1207065941,20938857
1669706771,205532,true,1186601606,28,1207186648,20585042
1669707083,205530,true,1186838938,28,1207428097,20589159
1669707311,205529,true,1186957622,28,1207669595,20711973
1669707659,205525,true,1187432476,28,1208031932,20599456
1669707995,205520,true,1188026311,28,1208394378,20368067
1669708271,205518,true,1188263928,28,1208636069,20372141
1669708511,205517,true,1188382755,28,1208636069,20253314
1669708751,205513,true,1188858179,28,1208636069,19777890
1669708883,205509,true,1189333794,28,1208636069,19302275
1669709207,205507,true,1189571672,28,1208515217,18943545
1669709447,205505,true,1189809598,28,1208394378,18584780
1669709627,205501,true,1190285594,28,1208394378,18108784
1669710263,205496,true,1190880856,28,1208152735,17271879
1669710695,205493,true,1191238156,28,1208031932,16793776
1669710707,205491,true,1191476415,28,1208152735,16676320
1669710719,205487,true,1191953077,28,1208152735,16199658
1669710755,205482,true,1192549173,28,1208152735,15603562
1669710995,205478,true,1193026264,28,1208636069,15609805
1669711367,205476,true,1193264881,28,1209361432,16096551
1669711403,205472,true,1193742259,28,1209482368,15740109
1669711487,205468,true,1194219827,28,1209603316,15383489
1669711523,205464,true,1194697587,28,1209724277,15026690
1669711871,205462,true,1194936538,28,1210813464,15876926
1669711883,205457,true,1195534126,28,1210934545,15400419
1669711919,205453,true,1196012412,28,1211055639,15043227
1669711931,205449,true,1196490888,28,1211176744,14685856
1669712711,205446,true,1196849871,28,1214451176,17601305
1669713431,205442,true,1197328683,28,1216274129,18945446
1669714235,205438,true,1197807687,28,1216639048,18831361
1669714343,205434,true,1198286882,28,1216639048,18352166
1669714427,205431,true,1198646404,28,1216639048,17992644
1669714439,205427,true,1199125934,28,1216639048,17513114
1669714619,205424,true,1199485708,28,1216639048,17153340
1669715063,205420,true,1199965574,28,1216395756,16430182
1669715135,205417,true,1200325600,28,1216395756,16070156
1669715267,205414,true,1200685733,28,1216274129,15588396
1669715279,205410,true,1201166080,28,1216274129,15108049
1669715351,205407,true,1201526466,28,1216274129,14747663
1669715363,205404,true,1201886960,28,1216274129,14387169
1669715387,205402,true,1202127349,28,1216274129,14146780
1669715963,205399,true,1202488023,28,1215544620,13056597
1669716083,205395,true,1202969091,28,1215423077,12453986
1669716143,205393,true,1203209696,28,1215423077,12213381
1669716155,205390,true,1203570695,28,1215423077,11852382
1669716995,205388,true,1203811422,28,1215058523,11247101
1669718171,205384,true,1204293018,28,1215301547,11008529
1669718507,205381,true,1204654342,28,1215301547,10647205
1669719479,205379,true,1204895285,28,1215301547,10406262
1669719635,205376,true,1205256790,28,1215301547,10044757
1669720715,205373,true,1205618403,28,1215301547,9683144
1669720919,205370,true,1205980125,28,1215301547,9321422
1669720943,205368,true,1206221333,28,1215423077,9201744
1669721015,205367,true,1206341955,28,1215423077,9081122
1669721075,205363,true,1206824564,28,1215423077,8598513
1669721519,205360,true,1207186648,28,1215909320,8722672
1669722515,205358,true,1207428097,28,1217734461,10306364
1669723859,205357,true,1207548840,28,1218708989,11160149
1669724087,205353,true,1208031932,28,1218708989,10677057
1669724099,205350,true,1208394378,28,1218708989,10314611
1669724171,205348,true,1208636069,28,1218708989,10072920
1669724243,205347,true,1208756933,28,1218708989,9952056
1669724411,205345,true,1208998696,28,1218708989,9710293
1669726535,205342,true,1209361432,28,1218099818,8738386
1669726619,205341,true,1209482368,28,1218099818,8617450
1669726643,205340,true,1209603316,28,1218099818,8496502
1669726715,205337,true,1209966234,28,1218099818,8133584
1669727195,205335,true,1210208239,28,1217856234,7647995
1669727267,205334,true,1210329260,28,1217734461,7405201
1669727351,205333,true,1210450293,28,1217612700,7162407
1669727435,205331,true,1210692395,28,1217490951,6798556
1669727579,205329,true,1210934545,28,1217369214,6434669
1669727591,205328,true,1211055639,28,1217369214,6313575
1669727795,205327,true,1211176744,28,1217004076,5827332
1669727807,205325,true,1211418992,28,1216882388,5463396
1669728839,205323,true,1211661288,28,1215301547,3640259
1669728851,205322,true,1211782454,28,1215301547,3519093
1669729103,205322,true,1211782454,28,1214815548,3033094
1669729139,205320,true,1212024823,28,1214694079,2669256
1669729175,205318,true,1212267240,28,1214572622,2305382
1669729187,205318,true,1212267240,28,1214572622,2305382
1669729199,205318,true,1212267240,28,1214572622,2305382
1669729499,205317,true,1212388466,28,1213965517,1577051
1669729919,205316,true,1212509705,28,1213116081,606376
1669730003,205316,true,1212509705,28,1212873495,363790
1669731035,205316,true,1212509705,28,1210571338,-1938367
1669732307,205316,true,1212509705,28,1209966234,-2543471
1669732475,205315,true,1212630956,28,1209966234,-2664722
1669732499,205315,true,1212630956,28,1209966234,-2664722
1669732871,205315,true,1212630956,28,1209845249,-2785707
1669732883,205315,true,1212630956,28,1209845249,-2785707
1669733015,205315,true,1212630956,28,1209845249,-2785707
1669733255,205314,true,1212752219,28,1209845249,-2906970
1669733315,205315,true,1212630956,28,1209845249,-2785707
1669733363,205315,true,1212630956,28,1209845249,-2785707
1669733375,205314,true,1212752219,28,1209845249,-2906970
1669733435,205314,true,1212752219,28,1209845249,-2906970
1669733567,205314,true,1212752219,28,1210087230,-2664989
1669733819,205313,true,1212873495,28,1210329260,-2544235
1669733843,205313,true,1212873495,28,1210329260,-2544235
1669733855,205312,true,1212994782,28,1210329260,-2665522
1669733867,205313,true,1212873495,28,1210329260,-2544235
1669734227,205314,true,1212752219,28,1209724277,-3027942
1669734383,205313,true,1212873495,28,1209482368,-3391127
1669734395,205313,true,1212873495,28,1209361432,-3512063
1669735175,205313,true,1212873495,28,1208031932,-4841563
1669735319,205314,true,1212752219,28,1207669595,-5082624
1669735355,205313,true,1212873495,28,1207548840,-5324655
1669735703,205313,true,1212873495,28,1206583236,-6290259
1669735775,205313,true,1212873495,28,1206703894,-6169601
1669735787,205314,true,1212752219,28,1206703894,-6048325
1669735811,205314,true,1212752219,28,1206703894,-6048325
1669735823,205313,true,1212873495,28,1206703894,-6169601
1669735835,205313,true,1212873495,28,1206703894,-6169601
1669735859,205314,true,1212752219,28,1206824564,-5927655
1669736699,205312,true,1212994782,28,1209724277,-3270505
1669737191,205312,true,1212994782,28,1211297862,-1696920
1669737203,205312,true,1212994782,28,1211418992,-1575790
1669737239,205313,true,1212873495,28,1211418992,-1454503
1669737251,205311,true,1213116081,28,1211540134,-1575947
1669737851,205311,true,1213116081,28,1212146025,-970056
1669737863,205311,true,1213116081,28,1212146025,-970056
1669737911,205312,true,1212994782,28,1212024823,-969959
1669737959,205311,true,1213116081,28,1212024823,-1091258
1669738175,205311,true,1213116081,28,1211540134,-1575947
1669738211,205311,true,1213116081,28,1211418992,-1697089
1669738223,205312,true,1212994782,28,1211418992,-1575790
1669738271,205310,true,1213237393,28,1211297862,-1939531
1669739267,205311,true,1213116081,28,1207669595,-5446486
1669739303,205312,true,1212994782,28,1207669595,-5325187
1669739363,205313,true,1212873495,28,1207428097,-5445398
1669739435,205312,true,1212994782,28,1207307367,-5687415
1669739615,205313,true,1212873495,28,1206824564,-6048931
1669739651,205313,true,1212873495,28,1206703894,-6169601
1669739819,205315,true,1212630956,28,1206462589,-6168367
1669739831,205314,true,1212752219,28,1206462589,-6289630
1669739927,205315,true,1212630956,28,1206462589,-6168367
1669740131,205315,true,1212630956,28,1206583236,-6047720
1669740143,205316,true,1212509705,28,1206583236,-5926469
1669740167,205316,true,1212509705,28,1206583236,-5926469
1669741655,205317,true,1212388466,28,1208636069,-3752397
1669742543,205317,true,1212388466,28,1208636069,-3752397
1669743131,205319,true,1212146025,28,1208636069,-3509956
1669743743,205319,true,1212146025,28,1208636069,-3509956
1669744907,205320,true,1212024823,28,1208636069,-3388754
1669745891,205320,true,1212024823,28,1208636069,-3388754
1669745999,205321,true,1211903632,28,1208636069,-3267563
1669746671,205321,true,1211903632,28,1208636069,-3267563
1669747499,205322,true,1211782454,28,1208636069,-3146385
1669747667,205322,true,1211782454,28,1208636069,-3146385
1669747715,205323,true,1211661288,28,1208756933,-2904355
1669748315,205323,true,1211661288,28,1209119596,-2541692
1669748339,205323,true,1211661288,28,1209119596,-2541692
1669748351,205323,true,1211661288,28,1209119596,-2541692
1669748435,205324,true,1211540134,28,1209240508,-2299626
1669748519,205324,true,1211540134,28,1209482368,-2057766
1669748531,205324,true,1211540134,28,1209482368,-2057766
1669748567,205324,true,1211540134,28,1209603316,-1936818
1669748603,205325,true,1211418992,28,1209724277,-1694715
1669749035,205323,true,1211661288,28,1211540134,-121154
1669749071,205324,true,1211540134,28,1211782454,242320
1669749311,205324,true,1211540134,28,1212752219,1212085
1669749851,205325,true,1211418992,28,1214815548,3396556
1669750091,205323,true,1211661288,28,1215666174,4004886
1669750127,205324,true,1211540134,28,1215787741,4247607
1669751531,205323,true,1211661288,28,1216274129,4612841
1669751567,205324,true,1211540134,28,1216274129,4733995
1669752443,205323,true,1211661288,28,1216274129,4612841
1669752527,205324,true,1211540134,28,1216274129,4733995
1669752779,205324,true,1211540134,28,1217004076,5463942
1669752887,205325,true,1211418992,28,1217369214,5950222
1669752899,205323,true,1211661288,28,1217369214,5707926
1669753559,205323,true,1211661288,28,1219318466,7657178
1669753571,205323,true,1211661288,28,1219318466,7657178
1669753871,205324,true,1211540134,28,1220172245,8632111
1669753943,205322,true,1211782454,28,1220294262,8511808
1669754243,205322,true,1211782454,28,1221148724,9366270
1669754291,205322,true,1211782454,28,1221270839,9488385
1669755071,205323,true,1211661288,28,1221148724,9487436
1669755131,205321,true,1211903632,28,1221148724,9245092
1669755659,205321,true,1211903632,28,1221148724,9245092
1669757315,205321,true,1211903632,28,1221026622,9122990
1669758767,205322,true,1211782454,28,1221026622,9244168
1669759883,205319,true,1212146025,28,1221026622,8880597
1669760651,205320,true,1212024823,28,1221026622,9001799
1669760663,205319,true,1212146025,28,1221026622,8880597
1669760759,205320,true,1212024823,28,1221026622,9001799
1669760819,205317,true,1212388466,28,1221026622,8638156
1669761275,205318,true,1212267240,28,1220904531,8637291
1669762823,205318,true,1212267240,28,1219318466,7051226
1669762979,205318,true,1212267240,28,1219562342,7295102
1669763087,205315,true,1212630956,28,1219684298,7053342
1669763423,205316,true,1212509705,28,1220294262,7784557
1669763663,205315,true,1212630956,28,1220782453,8151497
1669763687,205315,true,1212630956,28,1220782453,8151497
1669764071,205312,true,1212994782,28,1221515106,8520324
1669764083,205313,true,1212873495,28,1221515106,8641611
1669764203,205311,true,1213116081,28,1221759421,8643340
1669764275,205312,true,1212994782,28,1221759421,8764639
1669764347,205309,true,1213358717,28,1221881597,8522880
1669764371,205309,true,1213358717,28,1222003785,8645068
1669764527,205308,true,1213480053,28,1222125985,8645932
1669764659,205308,true,1213480053,28,1222248198,8768145
1669764707,205305,true,1213844133,28,1222248198,8404065
1669764719,205306,true,1213722761,28,1222248198,8525437
1669764731,205304,true,1213965517,28,1222248198,8282681
1669764743,205305,true,1213844133,28,1222248198,8404065
1669764755,205302,true,1214208323,28,1222125985,7917662
1669765127,205303,true,1214086914,28,1221515106,7428192
1669765967,205302,true,1214208323,28,1220050240,5841917
1669767143,205303,true,1214086914,28,1218952743,4865829
1669767263,205300,true,1214451176,28,1218952743,4501567
1669767323,205301,true,1214329743,28,1218830860,4501117
1669768307,205300,true,1214451176,28,1217369214,2918038
1669768331,205300,true,1214451176,28,1217369214,2918038
1669768355,205297,true,1214815548,28,1217369214,2553666
1669768379,205298,true,1214694079,28,1217369214,2675135
1669768403,205297,true,1214815548,28,1217247489,2431941
1669768475,205297,true,1214815548,28,1217247489,2431941
1669768559,205294,true,1215180029,28,1217247489,2067460
1669768595,205295,true,1215058523,28,1217247489,2188966
1669768631,205294,true,1215180029,28,1217247489,2067460
1669768655,205293,true,1215301547,28,1217247489,1945942
1669768667,205290,true,1215666174,28,1217247489,1581315
1669768763,205291,true,1215544620,28,1217247489,1702869
1669768787,205290,true,1215666174,28,1217369214,1703040
1669768799,205290,true,1215666174,28,1217369214,1703040
1669768811,205288,true,1215909320,28,1217369214,1459894
1669768823,205288,true,1215909320,28,1217490951,1581631
1669768835,205285,true,1216274129,28,1217612700,1338571
1669768847,205283,true,1216517396,28,1217856234,1338838
1669768859,205279,true,1217004076,28,1218099818,1095742
1669768883,205276,true,1217369214,28,1218587131,1217917
1669768907,205272,true,1217856234,28,1219074639,1218405
1669768979,205269,true,1218221628,28,1220660387,2438759
1669768991,205265,true,1218708989,28,1220904531,2195542
1669769003,205262,true,1219074639,28,1221270839,2196200
1669769015,205257,true,1219684298,28,1221637257,1952959
1669769027,205252,true,1220294262,28,1221881597,1587335
1669769063,205247,true,1220904531,28,1223104028,2199497
1669769135,205242,true,1221515106,28,1225307488,3792382
1669769147,205238,true,1222003785,28,1225675117,3671332
1669769159,205232,true,1222737171,28,1226042856,3305685
1669769171,205227,true,1223348661,28,1226410706,3062045
1669769351,205223,true,1223838074,28,1231818531,7980457
1669769363,205219,true,1224327683,28,1232188114,7860431
1669769375,205214,true,1224939969,28,1232557807,7617838
1669769387,205208,true,1225675117,28,1232927611,7252494
1669769423,205204,true,1226165461,28,1234161094,7995633
1669769531,205199,true,1226778666,28,1237745176,10966510
1669769555,205194,true,1227392178,28,1238611858,11219680
1669769639,205189,true,1228005997,28,1241339667,13333670
1669769759,205185,true,1228497273,28,1245318117,16820844
1669769975,205180,true,1229111644,28,1252311111,23199467
1669769987,205175,true,1229726323,28,1252812111,23085788
1669769999,205169,true,1230464343,28,1253187992,22723649
1669770107,205165,true,1230956603,28,1256953012,25996409
1669770131,205160,true,1231572204,28,1257833144,26260940
1669770143,205155,true,1232188114,28,1258336352,26148238
1669770155,205149,true,1232927611,28,1258713891,25786280
1669770167,205144,true,1233544199,28,1259091543,25547344
1669770251,205139,true,1234161094,28,1261990641,27829547
1669770311,205135,true,1234654833,28,1264011341,29356508
1669770359,205129,true,1235395811,28,1265655542,30259731
1669770371,205125,true,1235890043,28,1266035277,30145234
1669770383,205120,true,1236508112,28,1266415126,29907014
1669770395,205115,true,1237126489,28,1266795088,29668599
1669770407,205111,true,1237621414,28,1267175165,29553751
1669770431,205107,true,1238116537,28,1267935660,29819123
1669770443,205102,true,1238735719,28,1268316079,29580360
1669770515,205098,true,1239231288,28,1270473942,31242654
1669770527,205094,true,1239727055,28,1270855122,31128067
1669770587,205090,true,1240223020,28,1272635476,32412456
1669770719,205086,true,1240719184,28,1274673221,33954037
1669770731,205082,true,1241215546,28,1274800688,33585142
1669770755,205078,true,1241712106,28,1274928168,33216062
1669770803,205074,true,1242208866,28,1275183166,32974300
1669771043,205070,true,1242705824,28,1275055661,32349837
1669771199,205066,true,1243202981,28,1275055661,31852680
1669771427,205062,true,1243700336,28,1274290895,30590559
1669771439,205058,true,1244197891,28,1274290895,30093004
1669771751,205055,true,1244571188,28,1273271921,28700733
1669772447,205051,true,1245069091,28,1270473942,25404851
1669772531,205048,true,1245442649,28,1270346907,24904258
1669772951,205044,true,1245940901,28,1269458020,23517119
1669773071,205041,true,1246314721,28,1269331087,23016366
1669773395,205037,true,1246813321,28,1269331087,22517766
1669773527,205034,true,1247187403,28,1269458020,22270617
1669773863,205030,true,1247686352,28,1269711924,22025572
1669774043,205027,true,1248060696,28,1269965879,21905183
1669774055,205023,true,1248559995,28,1269965879,21405884
1669774727,205019,true,1249059494,28,1271744987,22685493
1669774823,205015,true,1249559193,28,1271999349,22440156
1669774967,205012,true,1249934098,28,1272253762,22319664
1669774991,205008,true,1250434147,28,1272253762,21819615
1669775003,205004,true,1250934395,28,1272253762,21319367
1669775015,205000,true,1251434844,28,1272380987,20946143
1669775267,204996,true,1251935493,28,1273526588,21591095
1669775555,204991,true,1252561586,28,1274673221,22111635
1669775687,204988,true,1252937392,28,1275310685,22373293
1669775795,204984,true,1253438642,28,1275693316,22254674
1669775807,204979,true,1254065487,28,1275693316,21627829
1669775819,204974,true,1254692645,28,1275693316,21000671
1669775951,204971,true,1255069090,28,1276076063,21006973
1669776191,204967,true,1255571193,28,1276586570,21015377
1669776599,204963,true,1256073497,28,1277352713,21279216
1669776707,204959,true,1256576002,28,1277480448,20904446
1669776791,204956,true,1256953012,28,1277608196,20655184
1669777007,204952,true,1257455869,28,1277224990,19769121
1669777127,204948,true,1257958927,28,1276969584,19010657
1669777139,204944,true,1258462186,28,1276969584,18507398
1669777319,204941,true,1258839762,28,1276586570,17746808
1669777451,204937,true,1259343374,28,1276203670,16860296
1669777511,204933,true,1259847187,28,1276076063,16228876
1669777535,204929,true,1260351201,28,1275948468,15597267
1669778603,204926,true,1260729344,28,1274036075,13306731
1669778663,204922,true,1261233712,28,1274036075,12802363
1669778975,204918,true,1261738281,28,1273781306,12043025
1669778987,204914,true,1262243052,28,1273781306,11538254
1669779731,204911,true,1262621763,28,1272890016,10268253
1669779743,204907,true,1263126887,28,1272890016,9763129
1669780055,204903,true,1263632214,28,1272508225,8876011
1669780103,204898,true,1264264156,28,1272380987,8116831
1669780127,204896,true,1264517022,28,1272380987,7863965
1669780199,204892,true,1265022904,28,1272253762,7230858
1669780259,204888,true,1265528989,28,1272126549,6597560
1669780271,204883,true,1266161881,28,1272126549,5964668
1669780439,204880,true,1266541767,28,1271744987,5203220
1669780559,204876,true,1267048460,28,1271490677,4442217
1669780619,204873,true,1267428612,28,1271236417,3807805
1669781027,204868,true,1268062453,28,1270219885,2157432
1669781615,204866,true,1268316079,28,1268823481,507402
1669781855,204862,true,1268823481,28,1268316079,-507402
1669782911,204858,true,1269331087,28,1267428612,-1902475
1669782983,204854,true,1269838895,28,1267428612,-2410283
1669784531,204852,true,1270092876,28,1267428612,-2664264
1669785359,204848,true,1270600989,28,1267682111,-2918878
1669786043,204845,true,1270982207,28,1267935660,-3046547
1669786115,204841,true,1271490677,28,1268062453,-3428224
1669786355,204838,true,1271872162,28,1268189260,-3682902
1669786367,204836,true,1272126549,28,1268189260,-3937289
1669786403,204834,true,1272380987,28,1268189260,-4191727
1669786571,204832,true,1272635476,28,1268316079,-4319397
1669786583,204831,true,1272762740,28,1268316079,-4446661
1669786895,204830,true,1272890016,28,1268696611,-4193405
1669786955,204829,true,1273017305,28,1268696611,-4320694
1669787051,204828,true,1273144607,28,1268823481,-4321126
1669787651,204828,true,1273144607,28,1269331087,-3813520
1669787903,204828,true,1273144607,28,1269584966,-3559641
1669788131,204827,true,1273271921,28,1269838895,-3433026
1669788443,204828,true,1273144607,28,1270092876,-3051731
1669788827,204829,true,1273017305,28,1270219885,-2797420
1669788851,204829,true,1273017305,28,1270219885,-2797420
1669788935,204828,true,1273144607,28,1270219885,-2924722
1669790447,204829,true,1273017305,28,1270473942,-2543363
1669791623,204830,true,1272890016,28,1270346907,-2543109
1669792727,204829,true,1273017305,28,1270346907,-2670398
1669792967,204828,true,1273144607,28,1270346907,-2797700
1669793315,204829,true,1273017305,28,1270346907,-2670398
1669794227,204830,true,1272890016,28,1270346907,-2543109
1669794767,204830,true,1272890016,28,1270346907,-2543109
1669795487,204830,true,1272890016,28,1271872162,-1017854
1669795715,204830,true,1272890016,28,1272380987,-509029
1669796399,204831,true,1272762740,28,1273781306,1018566
1669796435,204831,true,1272762740,28,1273781306,1018566
1669796495,204830,true,1272890016,28,1273908684,1018668
1669796783,204831,true,1272762740,28,1273908684,1145944
1669796951,204832,true,1272635476,28,1273908684,1273208
1669797047,204832,true,1272635476,28,1273781306,1145830
1669797167,204832,true,1272635476,28,1273781306,1145830
1669797215,204833,true,1272508225,28,1273653941,1145716
1669797359,204834,true,1272380987,28,1273526588,1145601
1669797395,204834,true,1272380987,28,1273526588,1145601
1669797479,204834,true,1272380987,28,1273526588,1145601
1669797515,204834,true,1272380987,28,1273399248,1018261
1669797527,204835,true,1272253762,28,1273399248,1145486
1669797575,204836,true,1272126549,28,1273271921,1145372
1669797911,204836,true,1272126549,28,1272508225,381676
1669799315,204837,true,1271999349,28,1269711924,-2287425
1669799975,204837,true,1271999349,28,1269584966,-2414383
1669800407,204837,true,1271999349,28,1269584966,-2414383
1669800419,204837,true,1271999349,28,1269584966,-2414383
1669800467,204838,true,1271872162,28,1269584966,-2287196
1669800479,204838,true,1271872162,28,1269584966,-2287196
1669800587,204839,true,1271744987,28,1269331087,-2413900
1669802579,204840,true,1271617826,28,1265149407,-6468419
1669802735,204840,true,1271617826,28,1265149407,-6468419
1669803095,204841,true,1271490677,28,1264769938,-6720739
1669803131,204842,true,1271363540,28,1264769938,-6593602
1669803167,204842,true,1271363540,28,1264643473,-6720067
1669803371,204842,true,1271363540,28,1264517022,-6846518
1669803467,204843,true,1271236417,28,1264517022,-6719395
1669803575,204844,true,1271109306,28,1264390583,-6718723
1669805375,204844,true,1271109306,28,1264137742,-6971564
1669805699,204844,true,1271109306,28,1264137742,-6971564
1669805831,204844,true,1271109306,28,1264137742,-6971564
1669806287,204845,true,1270982207,28,1264137742,-6844465
1669806659,204845,true,1270982207,28,1264137742,-6844465
1669806719,204845,true,1270982207,28,1264137742,-6844465
1669807199,204846,true,1270855122,28,1264137742,-6717380
1669807235,204847,true,1270728049,28,1264137742,-6590307
1669807991,204847,true,1270728049,28,1264264156,-6463893
1669808243,204847,true,1270728049,28,1264264156,-6463893
1669808375,204848,true,1270600989,28,1264264156,-6336833
1669810079,204849,true,1270473942,28,1264517022,-5956920
1669810175,204849,true,1270473942,28,1264517022,-5956920
1669810259,204850,true,1270346907,28,1264643473,-5703434
1669810439,204851,true,1270219885,28,1264643473,-5576412
1669810655,204852,true,1270092876,28,1264643473,-5449403
1669810907,204853,true,1269965879,28,1264643473,-5322406
1669811711,204854,true,1269838895,28,1264769938,-5068957
1669812263,204854,true,1269838895,28,1264896415,-4942480
1669813103,204856,true,1269584966,28,1264896415,-4688551
1669813211,204857,true,1269458020,28,1264769938,-4688082
1669814123,204858,true,1269331087,28,1263253200,-6077887
1669814135,204858,true,1269331087,28,1263126887,-6204200
1669814675,204860,true,1269077258,28,1263632214,-5445044
1669814855,204861,true,1268950363,28,1263758577,-5191786
1669814927,204861,true,1268950363,28,1263884953,-5065410
1669815035,204861,true,1268950363,28,1264137742,-4812621
1669815071,204862,true,1268823481,28,1264264156,-4559325
1669815083,204863,true,1268696611,28,1264390583,-4306028
1669815203,204863,true,1268696611,28,1264643473,-4053138
1669815251,204864,true,1268569754,28,1264896415,-3673339
1669815263,204864,true,1268569754,28,1264896415,-3673339
1669815623,204866,true,1268316079,28,1265402449,-2913630
1669815707,204866,true,1268316079,28,1265528989,-2787090
1669816223,204866,true,1268316079,28,1265402449,-2913630
1669816451,204867,true,1268189260,28,1265149407,-3039853
1669816667,204868,true,1268062453,28,1264769938,-3292515
1669816739,204869,true,1267935660,28,1264769938,-3165722
1669816931,204869,true,1267935660,28,1264390583,-3545077
1669817147,204869,true,1267935660,28,1264137742,-3797918
1669818515,204871,true,1267682111,28,1263758577,-3923534
1669819055,204871,true,1267682111,28,1263632214,-4049897
1669819127,204871,true,1267682111,28,1263632214,-4049897
1669819391,204872,true,1267555355,28,1263632214,-3923141
1669819679,204873,true,1267428612,28,1263758577,-3670035
1669820675,204872,true,1267555355,28,1264264156,-3291199
1669820855,204872,true,1267555355,28,1264264156,-3291199
1669821383,204873,true,1267428612,28,1264390583,-3038029
1669822235,204874,true,1267301882,28,1264390583,-2911299
1669822463,204874,true,1267301882,28,1264390583,-2911299
1669822535,204873,true,1267428612,28,1264390583,-3038029
1669822811,204874,true,1267301882,28,1264390583,-2911299
1669823075,204875,true,1267175165,28,1264390583,-2784582
1669823279,204874,true,1267301882,28,1264390583,-2911299
1669823387,204874,true,1267301882,28,1264390583,-2911299
1669823987,204875,true,1267175165,28,1264390583,-2784582
1669824023,204876,true,1267048460,28,1264390583,-2657877
1669824179,204875,true,1267175165,28,1264517022,-2658143
1669824659,204875,true,1267175165,28,1264643473,-2531692
1669824695,204876,true,1267048460,28,1264643473,-2404987
1669824803,204877,true,1266921768,28,1264769938,-2151830
1669825007,204876,true,1267048460,28,1265149407,-1899053
1669825019,204876,true,1267048460,28,1265275922,-1772538
1669826423,204876,true,1267048460,28,1269965879,2917419
1669826483,204877,true,1266921768,28,1270219885,3298117
1669826591,204876,true,1267048460,28,1270728049,3679589
1669826639,204875,true,1267175165,28,1270982207,3807042
1669827179,204874,true,1267301882,28,1272253762,4951880
1669827707,204875,true,1267175165,28,1273144607,5969442
1669827719,204875,true,1267175165,28,1273144607,5969442
1669827815,204874,true,1267301882,28,1273399248,6097366
1669827827,204873,true,1267428612,28,1273399248,5970636
1669828679,204874,true,1267301882,28,1273908684,6606802
1669828691,204874,true,1267301882,28,1273908684,6606802
1669828895,204873,true,1267428612,28,1273908684,6480072
1669828919,204872,true,1267555355,28,1273908684,6353329
1669828931,204873,true,1267428612,28,1273908684,6480072
1669828967,204873,true,1267428612,28,1273908684,6480072
1669829003,204873,true,1267428612,28,1273781306,6352694
1669829027,204872,true,1267555355,28,1273781306,6225951
1669829051,204873,true,1267428612,28,1273781306,6352694
1669829063,204873,true,1267428612,28,1273653941,6225329
1669829075,204873,true,1267428612,28,1273653941,6225329
1669829123,204874,true,1267301882,28,1273526588,6224706
1669829171,204875,true,1267175165,28,1273271921,6096756
1669829531,204875,true,1267175165,28,1271617826,4442661
1669829591,204876,true,1267048460,28,1271363540,4315080
1669830839,204876,true,1267048460,28,1265402449,-1646011
1669831067,204878,true,1266795088,28,1265275922,-1519166
1669831271,204877,true,1266921768,28,1265149407,-1772361
1669831607,204878,true,1266795088,28,1265022904,-1772184
1669832327,204878,true,1266795088,28,1265022904,-1772184
1669832939,204880,true,1266541767,28,1265022904,-1518863
1669833011,204880,true,1266541767,28,1265022904,-1518863
1669833035,204880,true,1266541767,28,1265022904,-1518863
1669833047,204880,true,1266541767,28,1265022904,-1518863
1669833107,204880,true,1266541767,28,1265275922,-1265845
1669833119,204880,true,1266541767,28,1265275922,-1265845
1669833131,204879,true,1266668421,28,1265402449,-1265972
1669833203,204879,true,1266668421,28,1265655542,-1012879
1669833251,204880,true,1266541767,28,1265908686,-633081
1669833479,204879,true,1266668421,28,1266795088,126667
1669833515,204879,true,1266668421,28,1266921768,253347
1669833527,204877,true,1266921768,28,1267048460,126692
1669833539,204878,true,1266795088,28,1267175165,380077
1669833587,204876,true,1267048460,28,1267555355,506895
1669833731,204875,true,1267175165,28,1268696611,1521446
1669833779,204873,true,1267428612,28,1269077258,1648646
1669833815,204873,true,1267428612,28,1269331087,1902475
1669833851,204871,true,1267682111,28,1269458020,1775909
1669833947,204871,true,1267682111,28,1270092876,2410765
1669833995,204870,true,1267808879,28,1270346907,2538028
1669834007,204870,true,1267808879,28,1270473942,2665063
1669834139,204868,true,1268062453,28,1271109306,3046853
1669834163,204868,true,1268062453,28,1271236417,3173964
1669834175,204867,true,1268189260,28,1271236417,3047157
1669834187,204867,true,1268189260,28,1271363540,3174280
1669834331,204865,true,1268442910,28,1272253762,3810852
1669834703,204865,true,1268442910,28,1274545766,6102856
1669834715,204864,true,1268569754,28,1274545766,5976012
1669834799,204864,true,1268569754,28,1275183166,6613412
1669834871,204862,true,1268823481,28,1275565760,6742279
1669834919,204861,true,1268950363,28,1275820886,6870523
1669835003,204860,true,1269077258,28,1276076063,6998805
1669835051,204860,true,1269077258,28,1276331291,7254033
1669835075,204857,true,1269458020,28,1276458924,7000904
1669835087,204857,true,1269458020,28,1276458924,7000904
1669835099,204855,true,1269711924,28,1276586570,6874646
1669835123,204855,true,1269711924,28,1276714228,7002304
1669835171,204852,true,1270092876,28,1276969584,6876708
1669835183,204851,true,1270219885,28,1277097281,6877396
1669835375,204850,true,1270346907,28,1278247128,7900221
1669835387,204849,true,1270473942,28,1278247128,7773186
1669835411,204846,true,1270855122,28,1278374953,7519831
1669835459,204845,true,1270982207,28,1278630641,7648434
1669835531,204843,true,1271236417,28,1279014268,7777851
1669835543,204842,true,1271363540,28,1279014268,7650728
1669835579,204840,true,1271617826,28,1279270084,7652258
1669835615,204838,true,1271872162,28,1279525951,7653789
1669835723,204835,true,1272253762,28,1280677985,8424223
1669835891,204835,true,1272253762,28,1282472100,10218338
1669836047,204832,true,1272635476,28,1284397155,11761679
1669836167,204830,true,1272890016,28,1285682130,12792114
1669836683,204827,true,1273271921,28,1291351311,18079390
1669836695,204826,true,1273399248,28,1291351311,17952063
1669836707,204823,true,1273781306,28,1291480447,17699141
1669836731,204822,true,1273908684,28,1291738756,17830072
1669836743,204819,true,1274290895,28,1291867929,17577034
1669836779,204817,true,1274545766,28,1292126316,17580550
1669836791,204815,true,1274800688,28,1292255529,17454841
1669836803,204813,true,1275055661,28,1292384754,17329093
1669836815,204811,true,1275310685,28,1292384754,17074069
1669837079,204810,true,1275438216,28,1293677721,18239505
1669837175,204807,true,1275820886,28,1294065863,18244977
1669837295,204805,true,1276076063,28,1294324689,18248626
1669837379,204803,true,1276331291,28,1294324689,17993398
1669837451,204802,true,1276458924,28,1294324689,17865765
1669837715,204800,true,1276714228,28,1293419024,16704796
1669838351,204798,true,1276969584,28,1290963984,13994400
1669839743,204796,true,1277224990,28,1289157989,11932999
1669839779,204795,true,1277352713,28,1289286905,11934192
1669839983,204793,true,1277608196,28,1289286905,11678709
1669840007,204791,true,1277863731,28,1289286905,11423174
1669840043,204789,true,1278119316,28,1289286905,11167589
1669840331,204788,true,1278247128,28,1289415833,11168705
1669840523,204785,true,1278630641,28,1289544775,10914134
1669840595,204784,true,1278758504,28,1289544775,10786271
1669840679,204781,true,1279142170,28,1289673729,10531559
1669841159,204780,true,1279270084,28,1290060670,10790586
1669841183,204778,true,1279525951,28,1290060670,10534719
1669841555,204777,true,1279653903,28,1290447727,10793824
1669841627,204774,true,1280037838,28,1290447727,10409889
1669841975,204773,true,1280165842,28,1290705829,10539987
1669841987,204771,true,1280421888,28,1290705829,10283941
1669842035,204770,true,1280549930,28,1290705829,10155899
1669842239,204768,true,1280806053,28,1290963984,10157931
1669842503,204767,true,1280934133,28,1291351311,10417178
1669842815,204765,true,1281190333,28,1291738756,10548423
1669842839,204764,true,1281318452,28,1291738756,10420304
1669842971,204763,true,1281446584,28,1291867929,10421345
1669843739,204762,true,1281574728,28,1292255529,10680801
1669843799,204760,true,1281831056,28,1292384754,10553698
1669844315,204759,true,1281959239,28,1291867929,9908690
1669844447,204758,true,1282087435,28,1291738756,9651321
1669844483,204757,true,1282215644,28,1291738756,9523112
1669844603,204755,true,1282472100,28,1291738756,9266656
1669844675,204754,true,1282600347,28,1291738756,9138409
1669844771,204753,true,1282728607,28,1291738756,9010149
1669844783,204752,true,1282856880,28,1291867929,9011049
1669845059,204749,true,1283241775,28,1292255529,9013754
1669845215,204748,true,1283370100,28,1292513993,9143893
1669845263,204747,true,1283498437,28,1292643244,9144807
1669846175,204745,true,1283755149,28,1294324689,10569540
1669846667,204743,true,1284011913,28,1294971981,10960068
1669847075,204741,true,1284268728,28,1295101478,10832750
1669847855,204739,true,1284525595,28,1295360511,10834916
1669849127,204737,true,1284782513,28,1295360511,10577998
1669849175,204735,true,1285039482,28,1295490047,10450565
1669849187,204733,true,1285296503,28,1295490047,10193544
1669849283,204731,true,1285553575,28,1295749158,10195583
1669849331,204728,true,1285939280,28,1295749158,9809878
1669849367,204725,true,1286325100,28,1295878733,9553633
1669849391,204723,true,1286582378,28,1295878733,9296355
1669849847,204721,true,1286839707,28,1296656455,9816748
1669850111,204719,true,1287097088,28,1297045491,9948403
1669850327,204716,true,1287483256,28,1297434643,9951387
1669850411,204714,true,1287740765,28,1297694143,9953378
1669850531,204712,true,1287998326,28,1298083490,10085164
1669850615,204710,true,1288255939,28,1298472954,10217015
1669851179,204707,true,1288642454,28,1300291998,11649544
1669851203,204705,true,1288900196,28,1300291998,11391802
1669851227,204703,true,1289157989,28,1300291998,11134009
1669851251,204701,true,1289415833,28,1300422028,11006195
1669851263,204698,true,1289802697,28,1300422028,10619331
1669851335,204697,true,1289931677,28,1300552070,10620393
1669851959,204695,true,1290189676,28,1301332596,11142920
1669852223,204694,true,1290318695,28,1301462729,11144034
1669852235,204692,true,1290576772,28,1301462729,10885957
1669852271,204692,true,1290576772,28,1301462729,10885957
1669852415,204690,true,1290834900,28,1301072369,10237469
1669852427,204688,true,1291093080,28,1301072369,9979289
1669852583,204686,true,1291351311,28,1300682125,9330814
1669852931,204686,true,1291351311,28,1299642047,8290736
1669853123,204684,true,1291609595,28,1299252233,7642638
1669853159,204682,true,1291867929,28,1299122320,7254391
1669853183,204680,true,1292126316,28,1299122320,6996004
1669853207,204679,true,1292255529,28,1299122320,6866791
1669853219,204678,true,1292384754,28,1298992421,6607667
1669853231,204676,true,1292643244,28,1298992421,6349177
1669853243,204675,true,1292772508,28,1298992421,6219913
1669853459,204675,true,1292772508,28,1297953695,5181187
1669853627,204673,true,1293031076,28,1297304913,4273837
1669854419,204672,true,1293160379,28,1294324689,1164310
1669854443,204670,true,1293419024,28,1294324689,905665
1669854515,204671,true,1293289695,28,1294065863,776168
1669854659,204669,true,1293548366,28,1293677721,129355
1669854695,204668,true,1293677721,28,1293677721,0
1669854935,204667,true,1293807088,28,1293031076,-776012
1669855151,204667,true,1293807088,28,1292772508,-1034580
1669855283,204666,true,1293936469,28,1292772508,-1163961
1669855511,204665,true,1294065863,28,1292772508,-1293355
1669855595,204664,true,1294195269,28,1292772508,-1422761
1669855883,204665,true,1294065863,28,1292643244,-1422619
1669855895,204663,true,1294324689,28,1292643244,-1681445
1669855943,204663,true,1294324689,28,1292513993,-1810696
1669856003,204662,true,1294454121,28,1292513993,-1940128
1669856147,204663,true,1294324689,28,1292255529,-2069160
1669856483,204663,true,1294324689,28,1291867929,-2456760
1669857071,204662,true,1294454121,28,1291093080,-3361041
1669857599,204662,true,1294454121,28,1290318695,-4135426
1669857935,204663,true,1294324689,28,1290189676,-4135013
1669857959,204664,true,1294195269,28,1290060670,-4134599
1669857983,204663,true,1294324689,28,1290060670,-4264019
1669858115,204663,true,1294324689,28,1290060670,-4264019
1669859495,204665,true,1294065863,28,1287612004,-6453859
1669859531,204666,true,1293936469,28,1287483256,-6453213
1669859963,204666,true,1293936469,28,1286839707,-7096762
1669860107,204666,true,1293936469,28,1286839707,-7096762
1669861283,204668,true,1293677721,28,1286839707,-6838014
1669861883,204668,true,1293677721,28,1286839707,-6838014
1669862003,204668,true,1293677721,28,1286839707,-6838014
1669862843,204668,true,1293677721,28,1286453733,-7223988
1669863275,204670,true,1293419024,28,1286196480,-7222544
1669863323,204670,true,1293419024,28,1286196480,-7222544
1669863491,204670,true,1293419024,28,1286067874,-7351150
1669863743,204670,true,1293419024,28,1285939280,-7479744
1669863803,204672,true,1293160379,28,1285810699,-7349680
1669864259,204672,true,1293160379,28,1285810699,-7349680
1669864379,204671,true,1293289695,28,1285939280,-7350415
1669864427,204671,true,1293289695,28,1285939280,-7350415
1669864499,204673,true,1293031076,28,1285939280,-7091796
1669864535,204673,true,1293031076,28,1285939280,-7091796
1669864559,204672,true,1293160379,28,1285939280,-7221099
1669864571,204672,true,1293160379,28,1285939280,-7221099
1669864763,204674,true,1292901786,28,1286067874,-6833912
1669865147,204674,true,1292901786,28,1286325100,-6576686
1669865471,204673,true,1293031076,28,1286582378,-6448698
1669865987,204673,true,1293031076,28,1286968391,-6062685
1669866467,204674,true,1292901786,28,1287225798,-5675988
1669866491,204675,true,1292772508,28,1287225798,-5546710
1669866791,204674,true,1292901786,28,1287225798,-5675988
1669867319,204674,true,1292901786,28,1287225798,-5675988
1669867979,204675,true,1292772508,28,1287225798,-5546710
1669868675,204676,true,1292643244,28,1287225798,-5417446
1669869731,204675,true,1292772508,28,1287225798,-5546710
1669870175,204675,true,1292772508,28,1287225798,-5546710
1669870319,204676,true,1292643244,28,1287225798,-5417446
1669870499,204677,true,1292513993,28,1287225798,-5288195
1669870643,204676,true,1292643244,28,1287225798,-5417446
1669870715,204676,true,1292643244,28,1287225798,-5417446
1669871783,204678,true,1292384754,28,1287225798,-5158956
1669872419,204678,true,1292384754,28,1287225798,-5158956
1669872743,204678,true,1292384754,28,1287225798,-5158956
1669872851,204677,true,1292513993,28,1287225798,-5288195
1669873163,204679,true,1292255529,28,1286839707,-5415822
1669873583,204680,true,1292126316,28,1285810699,-6315617
1669873883,204680,true,1292126316,28,1284654047,-7472269
1669874147,204680,true,1292126316,28,1283755149,-8371167
1669874555,204682,true,1291867929,28,1282215644,-9652285
1669875287,204684,true,1291609595,28,1280806053,-10803542
1669875395,204684,true,1291609595,28,1280549930,-11059665
1669875839,204684,true,1291609595,28,1280549930,-11059665
1669876535,204686,true,1291351311,28,1280549930,-10801381
1669877027,204687,true,1291222189,28,1280549930,-10672259
1669877123,204687,true,1291222189,28,1280677985,-10544204
1669877219,204688,true,1291093080,28,1280677985,-10415095
1669877267,204690,true,1290834900,28,1280677985,-10156915
1669877291,204691,true,1290705829,28,1280677985,-10027844
1669877459,204691,true,1290705829,28,1280677985,-10027844
1669877963,204692,true,1290576772,28,1281062227,-9514545
1669878227,204694,true,1290318695,28,1281318452,-9000243
1669880855,204695,true,1290189676,28,1281959239,-8230437
1669880999,204696,true,1290060670,28,1281959239,-8101431
1669881143,204696,true,1290060670,28,1281959239,-8101431
1669881287,204699,true,1289673729,28,1281959239,-7714490
1669881359,204700,true,1289544775,28,1281959239,-7585536
1669881707,204701,true,1289415833,28,1281702886,-7712947
1669882187,204701,true,1289415833,28,1281318452,-8097381
1669882295,204704,true,1289029086,28,1281190333,-7838753
1669883111,204705,true,1288900196,28,1280549930,-8350266
1669884107,204706,true,1288771319,28,1280421888,-8349431
1669884479,204707,true,1288642454,28,1280421888,-8220566
1669884491,204710,true,1288255939,28,1280549930,-7706009
1669884503,204711,true,1288127126,28,1280549930,-7577196
1669884527,204712,true,1287998326,28,1280549930,-7448396
1669884995,204713,true,1287869539,28,1280934133,-6935406
1669885127,204715,true,1287612004,28,1281062227,-6549777
1669886723,204716,true,1287483256,28,1282087435,-5395821
1669887491,204718,true,1287225798,28,1282087435,-5138363
1669887563,204718,true,1287225798,28,1282087435,-5138363
1669887863,204720,true,1286968391,28,1282087435,-4880956
1669888127,204721,true,1286839707,28,1282087435,-4752272
1669889411,204722,true,1286711036,28,1282087435,-4623601
1669890419,204722,true,1286711036,28,1282087435,-4623601
1669891151,204725,true,1286325100,28,1282087435,-4237665
1669891247,204726,true,1286196480,28,1282087435,-4109045
1669892483,204726,true,1286196480,28,1282087435,-4109045
1669892939,204727,true,1286067874,28,1281959239,-4108635
1669893179,204729,true,1285810699,28,1281959239,-3851460
1669894679,204730,true,1285682130,28,1281446584,-4235546
1669895819,204730,true,1285682130,28,1281446584,-4235546
1669896527,204730,true,1285682130,28,1281446584,-4235546
1669896719,204732,true,1285425033,28,1281446584,-3978449
1669896743,204733,true,1285296503,28,1281574728,-3721775
1669896767,204734,true,1285167986,28,1281574728,-3593258
1669896803,204733,true,1285296503,28,1281574728,-3721775
1669896815,204735,true,1285039482,28,1281574728,-3464754
1669896827,204736,true,1284910991,28,1281574728,-3336263
1669896923,204736,true,1284910991,28,1281702886,-3208105
1669896959,204736,true,1284910991,28,1281702886,-3208105
1669896983,204737,true,1284782513,28,1281702886,-3079627
1669897019,204738,true,1284654047,28,1281831056,-2822991
1669897055,204739,true,1284525595,28,1281831056,-2694539
1669897979,204738,true,1284654047,28,1283626787,-1027260
1669898663,204740,true,1284397155,28,1284910991,513836
1669898855,204740,true,1284397155,28,1285296503,899348
1669899275,204740,true,1284397155,28,1285682130,1284975
1669899863,204740,true,1284397155,28,1286196480,1799325
1669899899,204741,true,1284268728,28,1286196480,1927752
1669900043,204741,true,1284268728,28,1286325100,2056372
1669900163,204741,true,1284268728,28,1286453733,2185005
1669900763,204741,true,1284268728,28,1286711036,2442308
1669900979,204742,true,1284140314,28,1286839707,2699393
1669901411,204742,true,1284140314,28,1286968391,2828077
1669901435,204742,true,1284140314,28,1286968391,2828077
1669901447,204741,true,1284268728,28,1286968391,2699663
1669901459,204742,true,1284140314,28,1286968391,2828077
1669901495,204741,true,1284268728,28,1287097088,2828360
1669901831,204741,true,1284268728,28,1288127126,3858398
1669901843,204740,true,1284397155,28,1288255939,3858784
1669902203,204740,true,1284397155,28,1289029086,4631931
1669902227,204740,true,1284397155,28,1289029086,4631931
1669902251,204740,true,1284397155,28,1289029086,4631931
1669902263,204739,true,1284525595,28,1289029086,4503491
1669902311,204739,true,1284525595,28,1289157989,4632394
1669902323,204739,true,1284525595,28,1289157989,4632394
1669902335,204739,true,1284525595,28,1289157989,4632394
1669902347,204738,true,1284654047,28,1289157989,4503942
1669902383,204740,true,1284397155,28,1289029086,4631931
1669902503,204741,true,1284268728,28,1288384765,4116037
1669902515,204741,true,1284268728,28,1288255939,3987211
1669902611,204740,true,1284397155,28,1287740765,3343610
1669902983,204742,true,1284140314,28,1285425033,1284719
1669903043,204744,true,1283883525,28,1285039482,1155957
1669903367,204744,true,1283883525,28,1282985166,-898359
1669903391,204743,true,1284011913,28,1282728607,-1283306
1669903511,204745,true,1283755149,28,1281831056,-1924093
1669903991,204746,true,1283626787,28,1278247128,-5379659
1669904219,204746,true,1283626787,28,1277097281,-6529506
1669904303,204746,true,1283626787,28,1277097281,-6529506
1669904399,204748,true,1283370100,28,1277224990,-6145110
1669904831,204749,true,1283241775,28,1277608196,-5633579
1669904843,204749,true,1283241775,28,1277608196,-5633579
1669904903,204749,true,1283241775,28,1277608196,-5633579
1669905299,204751,true,1282985166,28,1277097281,-5887885
1669905599,204752,true,1282856880,28,1276714228,-6142652
1669905659,204752,true,1282856880,28,1276586570,-6270310
1669905779,204752,true,1282856880,28,1276458924,-6397956
1669906235,204754,true,1282600347,28,1275820886,-6779461
1669906247,204756,true,1282343865,28,1275820886,-6522979
1669906307,204756,true,1282343865,28,1275820886,-6522979
1669906331,204755,true,1282472100,28,1275693316,-6778784
1669906403,204757,true,1282215644,28,1275693316,-6522328
1669906451,204759,true,1281959239,28,1275693316,-6265923
1669906463,204759,true,1281959239,28,1275565760,-6393479
1669906499,204758,true,1282087435,28,1275565760,-6521675
1669906511,204760,true,1281831056,28,1275565760,-6265296
1669906523,204761,true,1281702886,28,1275565760,-6137126
1669906535,204760,true,1281831056,28,1275565760,-6265296
1669906559,204760,true,1281831056,28,1275565760,-6265296
1669906571,204761,true,1281702886,28,1275565760,-6137126
1669906583,204761,true,1281702886,28,1275565760,-6137126
1669906847,204761,true,1281702886,28,1276203670,-5499216
1669907243,204760,true,1281831056,28,1277097281,-4733775
1669907267,204761,true,1281702886,28,1277224990,-4477896
1669907279,204762,true,1281574728,28,1277224990,-4349738
1669907303,204761,true,1281702886,28,1277224990,-4477896
1669907495,204761,true,1281702886,28,1277480448,-4222438
1669907507,204762,true,1281574728,28,1277480448,-4094280
1669907519,204763,true,1281446584,28,1277480448,-3966136
1669907555,204762,true,1281574728,28,1277608196,-3966532
1669907567,204762,true,1281574728,28,1277608196,-3966532
1669907579,204764,true,1281318452,28,1277608196,-3710256
1669907591,204764,true,1281318452,28,1277480448,-3838004
1669907603,204764,true,1281318452,28,1277480448,-3838004
1669907615,204764,true,1281318452,28,1277480448,-3838004
1669907663,204766,true,1281062227,28,1277480448,-3581779
1669907759,204768,true,1280806053,28,1277097281,-3708772
1669907807,204767,true,1280934133,28,1276969584,-3964549
1669907843,204767,true,1280934133,28,1276841900,-4092233
1669907855,204769,true,1280677985,28,1276841900,-3836085
1669907867,204771,true,1280421888,28,1276714228,-3707660
1669907975,204771,true,1280421888,28,1276203670,-4218218
1669908215,204771,true,1280421888,28,1275055661,-5366227
1669908335,204773,true,1280165842,28,1274418324,-5747518
1669909151,204774,true,1280037838,28,1268823481,-11214357
1669909895,204775,true,1279909847,28,1267048460,-12861387
1669910075,204775,true,1279909847,28,1267175165,-12734682
1669910135,204777,true,1279653903,28,1267301882,-12352021
1669910207,204779,true,1279398011,28,1267301882,-12096129
1669910603,204778,true,1279525951,28,1267555355,-11970596
1669910687,204779,true,1279398011,28,1267682111,-11715900
1669910699,204781,true,1279142170,28,1267682111,-11460059
1669910723,204782,true,1279014268,28,1267682111,-11332157
1669912007,204782,true,1279014268,28,1269077258,-9937010
1669912643,204783,true,1278886380,28,1269331087,-9555293
1669912883,204785,true,1278630641,28,1269331087,-9299554
1669912907,204786,true,1278502790,28,1269458020,-9044770
1669912967,204785,true,1278630641,28,1269458020,-9172621
1669913039,204786,true,1278502790,28,1269458020,-9044770
1669913183,204788,true,1278247128,28,1269584966,-8662162
1669915883,204789,true,1278119316,28,1271109306,-7010010
1669915919,204788,true,1278247128,28,1271236417,-7010711
1669916027,204789,true,1278119316,28,1271236417,-6882899
1669917527,204790,true,1277991517,28,1272253762,-5737755
1669917971,204791,true,1277863731,28,1272380987,-5482744
1669918199,204791,true,1277863731,28,1272508225,-5355506
1669918403,204791,true,1277863731,28,1272762740,-5100991
1669918571,204793,true,1277608196,28,1273017305,-4590891
1669919999,204794,true,1277480448,28,1275055661,-2424787
1669920599,204793,true,1277608196,28,1275055661,-2552535
1669920803,204794,true,1277480448,28,1275055661,-2424787
1669921871,204795,true,1277352713,28,1275055661,-2297052
1669924715,204796,true,1277224990,28,1275055661,-2169329
1669924979,204796,true,1277224990,28,1275055661,-2169329
1669928327,204797,true,1277097281,28,1275055661,-2041620
1669928483,204798,true,1276969584,28,1275055661,-1913923
1669928531,204799,true,1276841900,28,1275055661,-1786239
1669928543,204799,true,1276841900,28,1275055661,-1786239
1669928555,204800,true,1276714228,28,1275055661,-1658567
1669930355,204802,true,1276458924,28,1271363540,-5095384
1669930907,204803,true,1276331291,28,1271490677,-4840614
1669931003,204803,true,1276331291,28,1271490677,-4840614
1669931255,204804,true,1276203670,28,1271490677,-4712993
1669931351,204807,true,1275820886,28,1271490677,-4330209
1669931363,204807,true,1275820886,28,1271490677,-4330209
1669931399,204807,true,1275820886,28,1271490677,-4330209
1669931423,204808,true,1275693316,28,1271490677,-4202639
1669931531,204811,true,1275310685,28,1271617826,-3692859
1669931711,204812,true,1275183166,28,1271744987,-3438179
1669931735,204812,true,1275183166,28,1271872162,-3311004
1669932467,204814,true,1274928168,28,1272762740,-2165428
1669933247,204816,true,1274673221,28,1273908684,-764537
1669933343,204817,true,1274545766,28,1274036075,-509691
1669934015,204817,true,1274545766,28,1275948468,1402702
1669934159,204818,true,1274418324,28,1276458924,2040600
1669934651,204819,true,1274290895,28,1277608196,3317301
1669934987,204820,true,1274163479,28,1278502790,4339311
1669936319,204819,true,1274290895,28,1278758504,4467609
1669936427,204820,true,1274163479,28,1278758504,4595025
1669936847,204820,true,1274163479,28,1278758504,4595025
1669936883,204820,true,1274163479,28,1278758504,4595025
1669936919,204819,true,1274290895,28,1278758504,4467609
1669936931,204820,true,1274163479,28,1278758504,4595025
1669937099,204820,true,1274163479,28,1278630641,4467162
1669937123,204820,true,1274163479,28,1278630641,4467162
1669937495,204819,true,1274290895,28,1278247128,3956233
1669937927,204820,true,1274163479,28,1277735957,3572478
1669938179,204820,true,1274163479,28,1277480448,3316969
1669939679,204820,true,1274163479,28,1276841900,2678421
1669940267,204820,true,1274163479,28,1276841900,2678421
1669940375,204820,true,1274163479,28,1276969584,2806105
1669940975,204820,true,1274163479,28,1276969584,2806105
1669941071,204820,true,1274163479,28,1276969584,2806105
1669941107,204820,true,1274163479,28,1276969584,2806105
1669941887,204820,true,1274163479,28,1276841900,2678421
1669942739,204820,true,1274163479,28,1276841900,2678421
1669942751,204820,true,1274163479,28,1276841900,2678421
1669942787,204819,true,1274290895,28,1276841900,2551005
1669942799,204820,true,1274163479,28,1276841900,2678421
1669942811,204819,true,1274290895,28,1276841900,2551005
1669942835,204819,true,1274290895,28,1276969584,2678689
1669943591,204818,true,1274418324,28,1278886380,4468056
1669943771,204818,true,1274418324,28,1279398011,4979687
1669943795,204818,true,1274418324,28,1279398011,4979687
1669943903,204817,true,1274545766,28,1279653903,5108137
1669943939,204816,true,1274673221,28,1279781869,5108648
1669944239,204816,true,1274673221,28,1280549930,5876709
1669945391,204816,true,1274673221,28,1281318452,6645231
1669945511,204816,true,1274673221,28,1281318452,6645231
1669945559,204815,true,1274800688,28,1281318452,6517764
1669945595,204815,true,1274800688,28,1281318452,6517764
1669945607,204816,true,1274673221,28,1281318452,6645231
1669945619,204816,true,1274673221,28,1281318452,6645231
1669945631,204815,true,1274800688,28,1281190333,6389645
1669945643,204816,true,1274673221,28,1281190333,6517112
1669945667,204817,true,1274545766,28,1281062227,6516461
1669945679,204817,true,1274545766,28,1281062227,6516461
1669945727,204817,true,1274545766,28,1280806053,6260287
1669945751,204818,true,1274418324,28,1280677985,6259661
1669945763,204818,true,1274418324,28,1280677985,6259661
1669945871,204818,true,1274418324,28,1280037838,5619514
1669945931,204819,true,1274290895,28,1279653903,5363008
1669946627,204819,true,1274290895,28,1275565760,1274865
1669946783,204819,true,1274290895,28,1274673221,382326
1669946867,204820,true,1274163479,28,1274163479,0
1669946903,204820,true,1274163479,28,1274036075,-127404
1669947215,204820,true,1274163479,28,1272380987,-1782492
1669947263,204820,true,1274163479,28,1272126549,-2036930
1669947287,204819,true,1274290895,28,1271872162,-2418733
1669948067,204820,true,1274163479,28,1270346907,-3816572
1669948763,204820,true,1274163479,28,1269711924,-4451555
1669949567,204820,true,1274163479,28,1269584966,-4578513
1669950839,204819,true,1274290895,28,1269838895,-4452000
1669950887,204819,true,1274290895,28,1269965879,-4325016
1669950935,204819,true,1274290895,28,1269965879,-4325016
1669950947,204819,true,1274290895,28,1269965879,-4325016
1669951451,204818,true,1274418324,28,1270092876,-4325448
1669952363,204818,true,1274418324,28,1270473942,-3944382
1669952795,204818,true,1274418324,28,1270600989,-3817335
1669953707,204818,true,1274418324,28,1270982207,-3436117
1669953935,204817,true,1274545766,28,1270982207,-3563559
1669954775,204817,true,1274545766,28,1271109306,-3436460
1669957991,204818,true,1274418324,28,1271109306,-3309018
1669958627,204817,true,1274545766,28,1271109306,-3436460
1669959599,204817,true,1274545766,28,1271236417,-3309349
1669960499,204817,true,1274545766,28,1271236417,-3309349
1669961447,204817,true,1274545766,28,1271236417,-3309349
1669962299,204817,true,1274545766,28,1271236417,-3309349
1669962335,204816,true,1274673221,28,1271363540,-3309681
1669962731,204816,true,1274673221,28,1271617826,-3055395
1669963799,204816,true,1274673221,28,1272508225,-2164996
1669963871,204816,true,1274673221,28,1272635476,-2037745
1669965059,204816,true,1274673221,28,1272890016,-1783205
1669967927,204816,true,1274673221,28,1272890016,-1783205
1669968359,204816,true,1274673221,28,1273017305,-1655916
1669968455,204816,true,1274673221,28,1273017305,-1655916
1669968491,204815,true,1274800688,28,1273017305,-1783383
1669968503,204815,true,1274800688,28,1273017305,-1783383
1669968959,204815,true,1274800688,28,1273399248,-1401440
1669968983,204816,true,1274673221,28,1273399248,-1273973
1669969595,204815,true,1274800688,28,1274290895,-509793
1669970339,204815,true,1274800688,28,1275310685,509997
1669970435,204815,true,1274800688,28,1275438216,637528
1669970603,204815,true,1274800688,28,1275565760,765072
1669971515,204815,true,1274800688,28,1275693316,892628
1669973771,204815,true,1274800688,28,1275693316,892628
1669973783,204815,true,1274800688,28,1275820886,1020198
1669973795,204815,true,1274800688,28,1275820886,1020198
1669974635,204815,true,1274800688,28,1276586570,1785882
1669975079,204815,true,1274800688,28,1277097281,2296593
1669975475,204814,true,1274928168,28,1277480448,2552280
1669975607,204813,true,1275055661,28,1277480448,2424787
1669975727,204813,true,1275055661,28,1277480448,2424787
1669976039,204813,true,1275055661,28,1277480448,2424787
1669977035,204813,true,1275055661,28,1277608196,2552535
1669977419,204812,true,1275183166,28,1277608196,2425030
1669977455,204811,true,1275310685,28,1277608196,2297511
1669977647,204811,true,1275310685,28,1277608196,2297511
1669978115,204811,true,1275310685,28,1277608196,2297511
1669978367,204810,true,1275438216,28,1277608196,2169980
1669978583,204810,true,1275438216,28,1277608196,2169980
1669978775,204810,true,1275438216,28,1277735957,2297741
1669978967,204810,true,1275438216,28,1277735957,2297741
1669978991,204809,true,1275565760,28,1277735957,2170197
1669979003,204809,true,1275565760,28,1277735957,2170197
1669979207,204809,true,1275565760,28,1277863731,2297971
1669980551,204809,true,1275565760,28,1279270084,3704324
1669980779,204809,true,1275565760,28,1280037838,4472078
1669980791,204809,true,1275565760,28,1280037838,4472078
1669980935,204808,true,1275693316,28,1280806053,5112737
1669980947,204807,true,1275820886,28,1280806053,4985167
1669980959,204806,true,1275948468,28,1280934133,4985665
1669981355,204806,true,1275948468,28,1283113464,7164996
1669981367,204805,true,1276076063,28,1283241775,7165712
1669981415,204804,true,1276203670,28,1283498437,7294767
1669981511,204803,true,1276331291,28,1284011913,7680622
1669983023,204802,true,1276458924,28,1290189676,13730752
1669983515,204802,true,1276458924,28,1290189676,13730752
1669983563,204800,true,1276714228,28,1290318695,13604467
1669986287,204799,true,1276841900,28,1290576772,13734872
1669986479,204798,true,1276969584,28,1290576772,13607188
1669986863,204798,true,1276969584,28,1291093080,14123496
1669987451,204796,true,1277224990,28,1291738756,14513766
1669987463,204795,true,1277352713,28,1291738756,14386043
1669987475,204794,true,1277480448,28,1291738756,14258308
1669987499,204794,true,1277480448,28,1291738756,14258308
1669987511,204792,true,1277735957,28,1291738756,14002799
1669987811,204791,true,1277863731,28,1291867929,14004198
1669987823,204790,true,1277991517,28,1291738756,13747239
1669987847,204790,true,1277991517,28,1291609595,13618078
1669987859,204789,true,1278119316,28,1291480447,13361131
1669987931,204791,true,1277863731,28,1290963984,13100253
1669987991,204791,true,1277863731,28,1290576772,12713041
1669988003,204791,true,1277863731,28,1290447727,12583996
1669988027,204790,true,1277991517,28,1290189676,12198159
1669988123,204793,true,1277608196,28,1289286905,11678709
1669988567,204793,true,1277608196,28,1284654047,7045851
1669988915,204793,true,1277608196,28,1280934133,3325937
1669988951,204792,true,1277735957,28,1280549930,2813973
1669988975,204795,true,1277352713,28,1280293858,2941145
1669989023,204795,true,1277352713,28,1279781869,2429156
1669989035,204796,true,1277224990,28,1279653903,2428913
1669989059,204795,true,1277352713,28,1279398011,2045298
1669989119,204797,true,1277097281,28,1278758504,1661223
1669989215,204797,true,1277097281,28,1277735957,638676
1669989275,204797,true,1277097281,28,1277097281,0
1669989287,204796,true,1277224990,28,1276969584,-255406
1669989299,204798,true,1276969584,28,1276841900,-127684
1669991123,204797,true,1277097281,28,1275438216,-1659065
1669991135,204797,true,1277097281,28,1275438216,-1659065
1669991567,204795,true,1277352713,28,1275438216,-1914497
1669991627,204797,true,1277097281,28,1275565760,-1531521
1669991723,204796,true,1277224990,28,1275565760,-1659230
1669991951,204796,true,1277224990,28,1275693316,-1531674
1669991975,204794,true,1277480448,28,1275693316,-1787132
1669992335,204795,true,1277352713,28,1276458924,-893789
1669994027,204794,true,1277480448,28,1279398011,1917563
1669994039,204793,true,1277608196,28,1279525951,1917755
1669994051,204791,true,1277863731,28,1279525951,1662220
1669994099,204793,true,1277608196,28,1279525951,1917755
1669994315,204791,true,1277863731,28,1279909847,2046116
1669995947,204790,true,1277991517,28,1282472100,4480583
1669996859,204788,true,1278247128,28,1282472100,4224972
1669996907,204789,true,1278119316,28,1282472100,4352784
1669997759,204787,true,1278374953,28,1282087435,3712482
1669997807,204786,true,1278502790,28,1281959239,3456449
1669997867,204784,true,1278758504,28,1281959239,3200735
1669997891,204786,true,1278502790,28,1281831056,3328266
1669998155,204785,true,1278630641,28,1281318452,2687811
1669999511,204784,true,1278758504,28,1278886380,127876
1670000447,204782,true,1279014268,28,1278630641,-383627
1670001131,204784,true,1278758504,28,1278630641,-127863
1670001467,204782,true,1279014268,28,1278630641,-383627
1670001527,204782,true,1279014268,28,1278630641,-383627
1670001803,204780,true,1279270084,28,1278758504,-511580
1670001827,204781,true,1279142170,28,1278758504,-383666
1670002007,204780,true,1279270084,28,1278886380,-383704
1670002211,204780,true,1279270084,28,1278886380,-383704
1670003219,204778,true,1279525951,28,1279270084,-255867
1670003411,204779,true,1279398011,28,1279270084,-127927
1670004227,204778,true,1279525951,28,1279398011,-127940
1670005583,204778,true,1279525951,28,1279398011,-127940
1670005655,204776,true,1279781869,28,1279398011,-383858
1670006327,204777,true,1279653903,28,1279398011,-255892
1670006447,204776,true,1279781869,28,1279398011,-383858
1670006519,204776,true,1279781869,28,1279525951,-255918
1670006543,204774,true,1280037838,28,1279525951,-511887
1670006831,204775,true,1279909847,28,1279653903,-255944
1670009711,204774,true,1280037838,28,1280677985,640147
1670010443,204774,true,1280037838,28,1280934133,896295
1670010563,204772,true,1280293858,28,1281062227,768369
1670010575,204773,true,1280165842,28,1281062227,896385
1670010647,204772,true,1280293858,28,1281062227,768369
1670010971,204772,true,1280293858,28,1281574728,1280870
1670010983,204770,true,1280549930,28,1281574728,1024798
1670011571,204771,true,1280421888,28,1282856880,2434992
1670011583,204770,true,1280549930,28,1282856880,2306950
1670011811,204769,true,1280677985,28,1283370100,2692115
1670012447,204767,true,1280934133,28,1284782513,3848380
1670012519,204768,true,1280806053,28,1284910991,4104938
1670012531,204767,true,1280934133,28,1284910991,3976858
1670012579,204767,true,1280934133,28,1285039482,4105349
1670012651,204765,true,1281190333,28,1285167986,3977653
1670013659,204766,true,1281062227,28,1285939280,4877053
1670013743,204765,true,1281190333,28,1285939280,4748947
1670013767,204764,true,1281318452,28,1285939280,4620828
1670013851,204763,true,1281446584,28,1286067874,4621290
1670013899,204764,true,1281318452,28,1286067874,4749422
1670014163,204762,true,1281574728,28,1286196480,4621752
1670014595,204762,true,1281574728,28,1286325100,4750372
1670014607,204760,true,1281831056,28,1286325100,4494044
1670014727,204761,true,1281702886,28,1286453733,4750847
1670014763,204760,true,1281831056,28,1286453733,4622677
1670014991,204759,true,1281959239,28,1286968391,5009152
1670015003,204757,true,1282215644,28,1286968391,4752747
1670015027,204758,true,1282087435,28,1287097088,5009653
1670015219,204756,true,1282343865,28,1287612004,5268139
1670015231,204755,true,1282472100,28,1287740765,5268665
1670015279,204754,true,1282600347,28,1287869539,5269192
1670015507,204754,true,1282600347,28,1288642454,6042107
1670017451,204753,true,1282728607,28,1292513993,9785386
1670017499,204752,true,1282856880,28,1292513993,9657113
1670019083,204752,true,1282856880,28,1292513993,9657113
1670020079,204753,true,1282728607,28,1292513993,9785386
1670020475,204752,true,1282856880,28,1292513993,9657113
1670020823,204751,true,1282985166,28,1292513993,9528827
1670021603,204751,true,1282985166,28,1292384754,9399588
1670021711,204752,true,1282856880,28,1292384754,9527874
1670022899,204751,true,1282985166,28,1292384754,9399588
1670023991,204750,true,1283113464,28,1292384754,9271290
1670024075,204750,true,1283113464,28,1292384754,9271290
1670025791,204752,true,1282856880,28,1292384754,9527874
1670025815,204751,true,1282985166,28,1292513993,9528827
1670026151,204750,true,1283113464,28,1293807088,10693624
1670026163,204750,true,1283113464,28,1293936469,10823005
1670026319,204750,true,1283113464,28,1294454121,11340657
1670026343,204749,true,1283241775,28,1294583567,11341792
1670026355,204748,true,1283370100,28,1294583567,11213467
1670026487,204748,true,1283370100,28,1294971981,11601881
1670026667,204748,true,1283370100,28,1295490047,12119947
1670026691,204747,true,1283498437,28,1295490047,11991610
1670026703,204746,true,1283626787,28,1295490047,11863260
1670026715,204746,true,1283626787,28,1295490047,11863260
1670026727,204743,true,1284011913,28,1295490047,11478134
1670027627,204742,true,1284140314,28,1295749158,11608844
1670027723,204741,true,1284268728,28,1295490047,11221319
1670027819,204741,true,1284268728,28,1295101478,10832750
1670028179,204738,true,1284654047,28,1293936469,9282422
1670028731,204737,true,1284782513,28,1293289695,8507182
1670029607,204736,true,1284910991,28,1293289695,8378704
1670029631,204735,true,1285039482,28,1293289695,8250213
1670029643,204733,true,1285296503,28,1293289695,7993192
1670029679,204731,true,1285553575,28,1293289695,7736120
1670030663,204730,true,1285682130,28,1292384754,6702624
1670030915,204730,true,1285682130,28,1292126316,6444186
1670031131,204728,true,1285939280,28,1291997116,6057836
1670031155,204726,true,1286196480,28,1291997116,5800636
1670033183,204725,true,1286325100,28,1290705829,4380729
1670033243,204725,true,1286325100,28,1290705829,4380729
1670033255,204723,true,1286582378,28,1290705829,4123451
1670033279,204722,true,1286711036,28,1290705829,3994793
1670033291,204721,true,1286839707,28,1290705829,3866122
1670034395,204722,true,1286711036,28,1289544775,2833739
1670034803,204719,true,1287097088,28,1289157989,2060901
1670035295,204718,true,1287225798,28,1288771319,1545521
1670037047,204718,true,1287225798,28,1288771319,1545521
1670037419,204718,true,1287225798,28,1288771319,1545521
1670037431,204716,true,1287483256,28,1288771319,1288063
1670037563,204716,true,1287483256,28,1288771319,1288063
1670037575,204715,true,1287612004,28,1288771319,1159315
1670037623,204716,true,1287483256,28,1288771319,1288063
1670037935,204714,true,1287740765,28,1288513603,772838
1670039015,204714,true,1287740765,28,1287612004,-128761
1670039567,204714,true,1287740765,28,1287225798,-514967
1670040059,204714,true,1287740765,28,1287225798,-514967
1670041619,204713,true,1287869539,28,1287225798,-643741
1670041667,204713,true,1287869539,28,1287225798,-643741
1670043551,204712,true,1287998326,28,1287225798,-772528
1670044355,204713,true,1287869539,28,1287225798,-643741
1670045027,204711,true,1288127126,28,1287225798,-901328
1670045087,204711,true,1288127126,28,1287225798,-901328
1670045639,204710,true,1288255939,28,1287225798,-1030141
1670046179,204710,true,1288255939,28,1287225798,-1030141
1670048027,204709,true,1288384765,28,1287225798,-1158967
1670048267,204708,true,1288513603,28,1287225798,-1287805
1670048291,204707,true,1288642454,28,1287225798,-1416656
1670048315,204708,true,1288513603,28,1287225798,-1287805
1670049191,204707,true,1288642454,28,1286582378,-2060076
1670050451,204706,true,1288771319,28,1286067874,-2703445
1670050739,204706,true,1288771319,28,1286067874,-2703445
1670050751,204706,true,1288771319,28,1286067874,-2703445
1670051351,204705,true,1288900196,28,1286067874,-2832322
1670052143,204705,true,1288900196,28,1286067874,-2832322
1670052179,204704,true,1289029086,28,1286067874,-2961212
1670052263,204704,true,1289029086,28,1286067874,-2961212
1670052275,204703,true,1289157989,28,1286067874,-3090115
1670052323,204703,true,1289157989,28,1286067874,-3090115
1670052455,204702,true,1289286905,28,1285810699,-3476206
1670052467,204703,true,1289157989,28,1285810699,-3347290
1670052527,204702,true,1289286905,28,1285553575,-3733330
1670052611,204703,true,1289157989,28,1285296503,-3861486
1670052731,204703,true,1289157989,28,1284782513,-4375476
1670052767,204704,true,1289029086,28,1284654047,-4375039
1670056499,204703,true,1289157989,28,1277863731,-11294258
1670056523,204704,true,1289029086,28,1277863731,-11165355
1670056583,204704,true,1289029086,28,1277863731,-11165355
1670056595,204705,true,1288900196,28,1277863731,-11036465
1670056631,204705,true,1288900196,28,1277863731,-11036465
1670057135,204706,true,1288771319,28,1277224990,-11546329
1670057795,204707,true,1288642454,28,1275693316,-12949138
1670057891,204708,true,1288513603,28,1275438216,-13075387
1670057963,204708,true,1288513603,28,1275183166,-13330437
1670058407,204709,true,1288384765,28,1273781306,-14603459
1670059163,204711,true,1288127126,28,1272380987,-15746139
1670059355,204712,true,1287998326,28,1272126549,-15871777
1670060663,204712,true,1287998326,28,1271744987,-16253339
1670061119,204713,true,1287869539,28,1271744987,-16124552
1670061467,204715,true,1287612004,28,1271744987,-15867017
1670061503,204716,true,1287483256,28,1271744987,-15738269
1670062547,204716,true,1287483256,28,1271744987,-15738269
1670063183,204718,true,1287225798,28,1271744987,-15480811
1670064383,204719,true,1287097088,28,1271744987,-15352101
1670064443,204720,true,1286968391,28,1271744987,-15223404
1670064515,204720,true,1286968391,28,1271744987,-15223404
1670065655,204722,true,1286711036,28,1271744987,-14966049
1670065667,204724,true,1286453733,28,1271744987,-14708746
1670065679,204725,true,1286325100,28,1271744987,-14580113
1670066375,204726,true,1286196480,28,1270346907,-15849573
1670066795,204728,true,1285939280,28,1269458020,-16481260
1670067143,204730,true,1285682130,28,1268823481,-16858649
1670067287,204732,true,1285425033,28,1268569754,-16855279
1670068703,204733,true,1285296503,28,1268062453,-17234050
1670068991,204735,true,1285039482,28,1268062453,-16977029
1670069543,204737,true,1284782513,28,1268062453,-16720060
1670069567,204738,true,1284654047,28,1268062453,-16591594
1670069675,204739,true,1284525595,28,1268189260,-16336335
1670069699,204742,true,1284140314,28,1268189260,-15951054
1670069915,204744,true,1283883525,28,1268316079,-15567446
1670070755,204745,true,1283755149,28,1268823481,-14931668
1670071091,204746,true,1283626787,28,1269077258,-14549529
1670073095,204748,true,1283370100,28,1269204166,-14165934
1670074655,204750,true,1283113464,28,1269584966,-13528498
1670074763,204751,true,1282985166,28,1269584966,-13400200
1670075123,204752,true,1282856880,28,1269584966,-13271914
1670078399,204755,true,1282472100,28,1269584966,-12887134
1670078603,204757,true,1282215644,28,1269584966,-12630678
1670081087,204758,true,1282087435,28,1269584966,-12502469
1670081135,204760,true,1281831056,28,1269584966,-12246090
1670081195,204763,true,1281446584,28,1269711924,-11734660
1670081327,204765,true,1281190333,28,1269711924,-11478409
1670081351,204766,true,1281062227,28,1269838895,-11223332
1670082119,204768,true,1280806053,28,1270346907,-10459146
1670082371,204770,true,1280549930,28,1270600989,-9948941
1670083007,204772,true,1280293858,28,1270982207,-9311651
1670083115,204773,true,1280165842,28,1270982207,-9183635
1670083175,204775,true,1279909847,28,1270982207,-8927640
1670083283,204776,true,1279781869,28,1270982207,-8799662
1670083343,204778,true,1279525951,28,1270982207,-8543744
1670083439,204779,true,1279398011,28,1270982207,-8415804
1670083595,204781,true,1279142170,28,1270982207,-8159963
1670083775,204783,true,1278886380,28,1270982207,-7904173
1670083895,204785,true,1278630641,28,1270982207,-7648434
1670084723,204785,true,1278630641,28,1270982207,-7648434
1670084807,204787,true,1278374953,28,1270982207,-7392746
1670084951,204789,true,1278119316,28,1270982207,-7137109
1670084975,204790,true,1277991517,28,1270982207,-7009310
1670085059,204791,true,1277863731,28,1270982207,-6881524
1670085815,204793,true,1277608196,28,1270982207,-6625989
1670086283,204795,true,1277352713,28,1270982207,-6370506
1670086919,204796,true,1277224990,28,1270982207,-6242783
1670086991,204797,true,1277097281,28,1270982207,-6115074
1670087219,204798,true,1276969584,28,1270982207,-5987377
1670087243,204800,true,1276714228,28,1270982207,-5732021
1670087531,204801,true,1276586570,28,1270982207,-5604363
1670087555,204802,true,1276458924,28,1270982207,-5476717
1670087567,204803,true,1276331291,28,1270982207,-5349084
1670087591,204805,true,1276076063,28,1270982207,-5093856
1670087603,204807,true,1275820886,28,1270982207,-4838679
1670087675,204807,true,1275820886,28,1270855122,-4965764
1670088455,204809,true,1275565760,28,1269965879,-5599881
1670088731,204811,true,1275310685,28,1269711924,-5598761
1670092127,204812,true,1275183166,28,1268950363,-6232803
1670092463,204812,true,1275183166,28,1269077258,-6105908
1670094203,204814,true,1274928168,28,1269077258,-5850910
1670095391,204816,true,1274673221,28,1269077258,-5595963
1670096375,204817,true,1274545766,28,1269077258,-5468508
1670096387,204818,true,1274418324,28,1269077258,-5341066
1670096675,204819,true,1274290895,28,1268823481,-5467414
1670098055,204821,true,1274036075,28,1267301882,-6734193
1670099543,204823,true,1273781306,28,1267048460,-6732846
1670099759,204823,true,1273781306,28,1267048460,-6732846
1670100095,204825,true,1273526588,28,1267048460,-6478128
1670100503,204827,true,1273271921,28,1266795088,-6476833
1670101535,204829,true,1273017305,28,1266035277,-6982028
1670101547,204829,true,1273017305,28,1266035277,-6982028
1670101583,204831,true,1272762740,28,1265908686,-6854054
1670102207,204833,true,1272508225,28,1264137742,-8370483
1670103311,204836,true,1272126549,28,1260855417,-11271132
1670103407,204837,true,1271999349,28,1260729344,-11270005
1670103623,204838,true,1271872162,28,1260729344,-11142818
1670104031,204841,true,1271490677,28,1260477236,-11013441
1670104787,204843,true,1271236417,28,1260225179,-11011238
1670105291,204844,true,1271109306,28,1259973171,-11136135
1670105807,204845,true,1270982207,28,1259973171,-11009036
1670106443,204848,true,1270600989,28,1259973171,-10627818
1670106707,204851,true,1270219885,28,1259973171,-10246714
1670106719,204851,true,1270219885,28,1259973171,-10246714
1670106995,204853,true,1269965879,28,1258084723,-11881156
1670107031,204857,true,1269458020,28,1257707373,-11750647
1670107415,204862,true,1268823481,28,1254316313,-14507168
1670107547,204862,true,1268823481,28,1252812111,-16011370
1670107907,204865,true,1268442910,28,1249059494,-19383416
1670108399,204868,true,1268062453,28,1243824706,-24237747
1670111111,204873,true,1267428612,28,1240719184,-26709428
1670112395,204873,true,1267428612,28,1240719184,-26709428
1670112407,204875,true,1267175165,28,1240843255,-26331910
1670112491,204879,true,1266668421,28,1240843255,-25825166
1670112539,204883,true,1266161881,28,1240843255,-25318626
1670112551,204883,true,1266161881,28,1240843255,-25318626
1670112575,204885,true,1265908686,28,1240843255,-25065431
1670112611,204888,true,1265528989,28,1240967340,-24561649
1670112719,204892,true,1265022904,28,1241091436,-23931468
1670112803,204892,true,1265022904,28,1241215546,-23807358
1670112851,204894,true,1264769938,28,1241339667,-23430271
1670112995,204897,true,1264390583,28,1241587948,-22802635
1670113091,204900,true,1264011341,28,1241836278,-22175063
1670113127,204900,true,1264011341,28,1241836278,-22175063
1670113151,204902,true,1263758577,28,1241960461,-21798116
1670113163,204904,true,1263505863,28,1241960461,-21545402
1670113247,204907,true,1263126887,28,1242333087,-20793800
1670113307,204907,true,1263126887,28,1242457320,-20669567
1670113319,204909,true,1262874300,28,1242581566,-20292734
1670113343,204911,true,1262621763,28,1242705824,-19915939
1670113427,204914,true,1262243052,28,1243078673,-19164379
1670114363,204914,true,1262243052,28,1247062696,-15180356
1670114687,204915,true,1262116840,28,1248060696,-14056144
1670115503,204918,true,1261738281,28,1249059494,-12678787
1670116343,204920,true,1261485971,28,1249309318,-12176653
1670116571,204920,true,1261485971,28,1249309318,-12176653
1670116943,204921,true,1261359835,28,1249309318,-12050517
1670116955,204923,true,1261107601,28,1249434249,-11673352
1670116967,204926,true,1260729344,28,1249434249,-11295095
1670116979,204925,true,1260855417,28,1249434249,-11421168
1670117003,204926,true,1260729344,28,1249434249,-11295095
1670117015,204927,true,1260603284,28,1249434249,-11169035
1670117027,204930,true,1260225179,28,1249434249,-10790930
1670117039,204929,true,1260351201,28,1249559193,-10792008
1670117075,204930,true,1260225179,28,1249684149,-10541030
1670117087,204931,true,1260099169,28,1249684149,-10415020
1670117135,204934,true,1259721215,28,1249809117,-9912098
1670117147,204933,true,1259847187,28,1249934098,-9913089
1670117207,204933,true,1259847187,28,1250184097,-9663090
1670117915,204934,true,1259721215,28,1254065487,-5655728
1670117999,204937,true,1259343374,28,1254441744,-4901630
1670118671,204936,true,1259469308,28,1258084723,-1384585
1670118791,204936,true,1259469308,28,1258713891,-755417
1670118947,204937,true,1259343374,28,1259091543,-251831
1670119367,204940,true,1258965646,28,1259091543,125897
1670119451,204939,true,1259091543,28,1259091543,0
1670119475,204939,true,1259091543,28,1259091543,0
1670119823,204940,true,1258965646,28,1258713891,-251755
1670120087,204943,true,1258588032,28,1258462186,-125846
1670120267,204943,true,1258588032,28,1258210531,-377501
1670120843,204943,true,1258588032,28,1257581615,-1006417
1670121095,204944,true,1258462186,28,1257330136,-1132050
1670121275,204947,true,1258084723,28,1257078708,-1006015
1670121647,204947,true,1258084723,28,1257078708,-1006015
1670122919,204947,true,1258084723,28,1257078708,-1006015
1670126495,204948,true,1257958927,28,1257078708,-880219
1670127947,204951,true,1257581615,28,1257078708,-502907
1670128403,204951,true,1257581615,28,1257078708,-502907
1670128451,204951,true,1257581615,28,1257204416,-377199
1670128475,204952,true,1257455869,28,1257204416,-251453
1670128499,204955,true,1257078708,28,1257204416,125708
1670128631,204954,true,1257204416,28,1257330136,125720
1670128703,204954,true,1257204416,28,1257330136,125720
1670129243,204955,true,1257078708,28,1257958927,880219
1670129399,204958,true,1256701660,28,1258084723,1383063
1670129435,204957,true,1256827330,28,1258210531,1383201
1670129507,204958,true,1256701660,28,1258336352,1634692
1670129639,204959,true,1256576002,28,1258462186,1886184
1670130371,204961,true,1256324724,28,1260099169,3774445
1670130395,204960,true,1256450357,28,1260099169,3648812
1670130959,204960,true,1256450357,28,1261359835,4909478
1670131235,204961,true,1256324724,28,1261864455,5539731
1670131823,204963,true,1256073497,28,1262369276,6295779
1670131895,204963,true,1256073497,28,1262495513,6422016
1670132291,204963,true,1256073497,28,1262621763,6548266
1670135303,204963,true,1256073497,28,1262621763,6548266
1670135567,204965,true,1255822320,28,1262621763,6799443
1670135807,204964,true,1255947902,28,1262621763,6673861
1670135951,204965,true,1255822320,28,1262621763,6799443
1670136191,204965,true,1255822320,28,1262495513,6673193
1670136203,204967,true,1255571193,28,1262495513,6924320
1670136731,204967,true,1255571193,28,1261990641,6419448
1670136875,204967,true,1255571193,28,1261864455,6293262
1670136887,204968,true,1255445649,28,1261864455,6418806
1670137415,204970,true,1255194597,28,1261233712,6039115
1670137763,204969,true,1255320117,28,1260855417,5535300
1670138339,204969,true,1255320117,28,1260225179,4905062
1670138603,204970,true,1255194597,28,1259973171,4778574
1670138687,204972,true,1254943596,28,1259973171,5029575
1670138891,204971,true,1255069090,28,1259847187,4778097
1670139143,204971,true,1255069090,28,1259595255,4526165
1670139551,204972,true,1254943596,28,1258965646,4022050
1670140211,204974,true,1254692645,28,1258462186,3769541
1670140535,204973,true,1254818114,28,1258210531,3392417
1670140619,204974,true,1254692645,28,1258084723,3392078
1670140955,204974,true,1254692645,28,1257833144,3140499
1670141519,204975,true,1254567188,28,1257833144,3265956
1670141783,204974,true,1254692645,28,1257833144,3140499
1670141795,204975,true,1254567188,28,1257833144,3265956
1670142011,204975,true,1254567188,28,1257707373,3140185
1670142023,204976,true,1254441744,28,1257707373,3265629
1670142479,204975,true,1254567188,28,1258336352,3769164
1670142491,204975,true,1254567188,28,1258336352,3769164
1670144735,204975,true,1254567188,28,1259973171,5405983
1670144975,204976,true,1254441744,28,1259973171,5531427
1670145971,204975,true,1254567188,28,1259973171,5405983
1670148155,204974,true,1254692645,28,1259973171,5280526
1670148611,204973,true,1254818114,28,1259973171,5155057
1670148815,204972,true,1254943596,28,1259973171,5029575
1670149547,204970,true,1255194597,28,1259973171,4778574
1670149643,204969,true,1255320117,28,1259973171,4653054
1670149847,204967,true,1255571193,28,1259973171,4401978
1670150975,204966,true,1255696751,28,1259973171,4276420
1670151323,204965,true,1255822320,28,1259973171,4150851
1670152355,204963,true,1256073497,28,1259973171,3899674
1670153027,204962,true,1256199105,28,1259973171,3774066
1670153075,204961,true,1256324724,28,1259973171,3648447
1670153087,204959,true,1256576002,28,1259973171,3397169
1670153531,204958,true,1256701660,28,1259595255,2893595
1670153759,204957,true,1256827330,28,1259343374,2516044
1670153795,204956,true,1256953012,28,1259343374,2390362
1670154083,204955,true,1257078708,28,1258965646,1886938
1670155787,204955,true,1257078708,28,1256953012,-125696
1670156099,204954,true,1257204416,28,1256827330,-377086
1670156135,204953,true,1257330136,28,1256827330,-502806
1670156147,204952,true,1257455869,28,1256827330,-628539
1670156939,204951,true,1257581615,28,1256324724,-1256891
1670157131,204951,true,1257581615,28,1256073497,-1508118
1670159423,204950,true,1257707373,28,1255571193,-2136180
1670159951,204949,true,1257833144,28,1255571193,-2261951
1670161967,204949,true,1257833144,28,1255571193,-2261951
1670163695,204948,true,1257958927,28,1255445649,-2513278
1670163959,204948,true,1257958927,28,1255320117,-2638810
1670164871,204947,true,1258084723,28,1255069090,-3015633
1670165255,204947,true,1258084723,28,1255069090,-3015633
1670165339,204947,true,1258084723,28,1254943596,-3141127
1670165687,204946,true,1258210531,28,1254943596,-3266935
1670165699,204946,true,1258210531,28,1254943596,-3266935
1670165783,204945,true,1258336352,28,1254943596,-3392756
1670165795,204945,true,1258336352,28,1254943596,-3392756
1670166071,204944,true,1258462186,28,1255445649,-3016537
1670166083,204943,true,1258588032,28,1255445649,-3142383
1670166311,204943,true,1258588032,28,1255947902,-2640130
1670167331,204943,true,1258588032,28,1258084723,-503309
1670168051,204942,true,1258713891,28,1258588032,-125859
1670169707,204942,true,1258713891,28,1258588032,-125859
1670171459,204942,true,1258713891,28,1260477236,1763345
1670173007,204942,true,1258713891,28,1262495513,3781622
1670173751,204941,true,1258839762,28,1262369276,3529514
1670173787,204940,true,1258965646,28,1262369276,3403630
1670174507,204941,true,1258839762,28,1261612120,2772358
1670175599,204941,true,1258839762,28,1260729344,1889582
1670176079,204940,true,1258965646,28,1260729344,1763698
1670176763,204940,true,1258965646,28,1260729344,1763698
1670176787,204940,true,1258965646,28,1260855417,1889771
1670176799,204940,true,1258965646,28,1260855417,1889771
1670176811,204940,true,1258965646,28,1260855417,1889771
1670176823,204938,true,1259217452,28,1260855417,1637965
1670176883,204938,true,1259217452,28,1261107601,1890149
1670176895,204938,true,1259217452,28,1261233712,2016260
1670177411,204935,true,1259595255,28,1265022904,5427649
1670177435,204934,true,1259721215,28,1265149407,5428192
1670177507,204933,true,1259847187,28,1265655542,5808355
1670177579,204933,true,1259847187,28,1266161881,6314694
1670177891,204931,true,1260099169,28,1268062453,7963284
1670178263,204930,true,1260225179,28,1270346907,10121728
1670178275,204929,true,1260351201,28,1270346907,9995706
1670179307,204929,true,1260351201,28,1271744987,11393786
1670179847,204927,true,1260603284,28,1271744987,11141703
1670180555,204926,true,1260729344,28,1271617826,10888482
1670180663,204925,true,1260855417,28,1271617826,10762409
1670180675,204925,true,1260855417,28,1271617826,10762409
1670182871,204921,true,1261359835,28,1278886380,17526545
1670183603,204920,true,1261485971,28,1278886380,17400409
1670183819,204919,true,1261612120,28,1278886380,17274260
1670183915,204919,true,1261612120,28,1278886380,17274260
1670183951,204916,true,1261990641,28,1278886380,16895739
1670185211,204914,true,1262243052,28,1278886380,16643328
1670186051,204914,true,1262243052,28,1278758504,16515452
1670186591,204914,true,1262243052,28,1278758504,16515452
1670186843,204911,true,1262621763,28,1278758504,16136741
1670186855,204909,true,1262874300,28,1278886380,16012080
1670187443,204909,true,1262874300,28,1279014268,16139968
1670187755,204909,true,1262874300,28,1279142170,16267870
1670188307,204906,true,1263253200,28,1279270084,16016884
1670189015,204905,true,1263379525,28,1279270084,15890559
1670189111,204904,true,1263505863,28,1279270084,15764221
1670189615,204904,true,1263505863,28,1279142170,15636307
1670189783,204901,true,1263884953,28,1279014268,15129315
1670190167,204900,true,1264011341,28,1278630641,14619300
1670192291,204900,true,1264011341,28,1277608196,13596855
1670193467,204900,true,1264011341,28,1277608196,13596855
1670193671,204897,true,1264390583,28,1277608196,13217613
1670193827,204896,true,1264517022,28,1277608196,13091174
1670193863,204895,true,1264643473,28,1277608196,12964723
1670193923,204896,true,1264517022,28,1277608196,13091174
1670194655,204893,true,1264896415,28,1277352713,12456298
1670196683,204891,true,1265149407,28,1276969584,11820177
1670196707,204890,true,1265275922,28,1277097281,11821359
1670196731,204891,true,1265149407,28,1277097281,11947874
1670196851,204888,true,1265528989,28,1277224990,11696001
1670196863,204886,true,1265782108,28,1277224990,11442882
1670197499,204884,true,1266035277,28,1278502790,12467513
1670198807,204885,true,1265908686,28,1280549930,14641244
1670200127,204881,true,1266415126,28,1280549930,14134804
1670200199,204879,true,1266668421,28,1280549930,13881509
1670200223,204878,true,1266795088,28,1280549930,13754842
1670200271,204878,true,1266795088,28,1280549930,13754842
1670200295,204875,true,1267175165,28,1280677985,13502820
1670200331,204873,true,1267428612,28,1280677985,13249373
1670200355,204872,true,1267555355,28,1280677985,13122630
1670200451,204871,true,1267682111,28,1280677985,12995874
1670200463,204868,true,1268062453,28,1280677985,12615532
1670200475,204866,true,1268316079,28,1280677985,12361906
1670200511,204865,true,1268442910,28,1280806053,12363143
1670200523,204865,true,1268442910,28,1280806053,12363143
1670200607,204861,true,1268950363,28,1281062227,12111864
1670200643,204859,true,1269204166,28,1281190333,11986167
1670200655,204858,true,1269331087,28,1281190333,11859246
1670200703,204857,true,1269458020,28,1281318452,11860432
1670200739,204854,true,1269838895,28,1281574728,11735833
1670201567,204851,true,1270219885,28,1286196480,15976595
1670203583,204849,true,1270473942,28,1290705829,20231887
1670203811,204849,true,1270473942,28,1290705829,20231887
1670203943,204845,true,1270982207,28,1290705829,19723622
1670205155,204842,true,1271363540,28,1290705829,19342289
1670205815,204841,true,1271490677,28,1290705829,19215152
1670206091,204840,true,1271617826,28,1290705829,19088003
1670206211,204836,true,1272126549,28,1290705829,18579280
1670207267,204834,true,1272380987,28,1290705829,18324842
1670208071,204832,true,1272635476,28,1291093080,18457604
1670208155,204831,true,1272762740,28,1291222189,18459449
1670208455,204827,true,1273271921,28,1291351311,18079390
1670209487,204824,true,1273653941,28,1292901786,19247845
1670209691,204821,true,1274036075,28,1293160379,19124304
1670209703,204821,true,1274036075,28,1293289695,19253620
1670211323,204817,true,1274545766,28,1293936469,19390703
1670211455,204814,true,1274928168,28,1293936469,19008301
1670211491,204811,true,1275310685,28,1293936469,18625784
1670212559,204810,true,1275438216,28,1293936469,18498253
1670212619,204806,true,1275948468,28,1293936469,17988001
1670213483,204803,true,1276331291,28,1293936469,17605178
1670214443,204800,true,1276714228,28,1293807088,17092860
1670214899,204799,true,1276841900,28,1293807088,16965188
1670215523,204795,true,1277352713,28,1293807088,16454375
1670216195,204792,true,1277735957,28,1293807088,16071131
1670216207,204789,true,1278119316,28,1293807088,15687772
1670216267,204789,true,1278119316,28,1293807088,15687772
1670216279,204784,true,1278758504,28,1293936469,15177965
1670216291,204781,true,1279142170,28,1293936469,14794299
1670216579,204777,true,1279653903,28,1294842496,15188593
1670216603,204776,true,1279781869,28,1294842496,15060627
1670216627,204773,true,1280165842,28,1294971981,14806139
1670216687,204769,true,1280677985,28,1295230988,14553003
1670216831,204765,true,1281190333,28,1295749158,14558825
1670217683,204764,true,1281318452,28,1299122320,17803868
1670218619,204761,true,1281702886,28,1300812193,19109307
1670219147,204757,true,1282215644,28,1300812193,18596549
1670219543,204754,true,1282600347,28,1300812193,18211846
1670219555,204753,true,1282728607,28,1300812193,18083586
1670219675,204750,true,1283113464,28,1300812193,17698729
1670219831,204746,true,1283626787,28,1300682125,17055338
1670220767,204743,true,1284011913,28,1299901989,15890076
1670221175,204742,true,1284140314,28,1299512096,15371782
1670221451,204739,true,1284525595,28,1299382158,14856563
1670221463,204736,true,1284910991,28,1299382158,14471167
1670222051,204733,true,1285296503,28,1299122320,13825817
1670222675,204732,true,1285425033,28,1298992421,13567388
1670224223,204728,true,1285939280,28,1298862535,12923255
1670224247,204726,true,1286196480,28,1298862535,12666055
1670224271,204724,true,1286453733,28,1298862535,12408802
1670225519,204723,true,1286582378,28,1298343120,11760742
1670225819,204721,true,1286839707,28,1298213298,11373591
1670225855,204719,true,1287097088,28,1298213298,11116210
1670226515,204717,true,1287354520,28,1298083490,10728970
1670226611,204716,true,1287483256,28,1298083490,10600234
1670226923,204714,true,1287740765,28,1298083490,10342725
1670228567,204712,true,1287998326,28,1298083490,10085164
1670228663,204710,true,1288255939,28,1298083490,9827551
1670228735,204709,true,1288384765,28,1298083490,9698725
1670228783,204707,true,1288642454,28,1298213298,9570844
1670228795,204704,true,1289029086,28,1298213298,9184212
1670228843,204702,true,1289286905,28,1298213298,8926393
1670228855,204701,true,1289415833,28,1298213298,8797465
1670230307,204700,true,1289544775,28,1300812193,11267418
1670230355,204698,true,1289802697,28,1300942274,11139577
1670231771,204696,true,1290060670,28,1301332596,11271926
1670232179,204695,true,1290189676,28,1301332596,11142920
1670232191,204694,true,1290318695,28,1301332596,11013901
1670233415,204692,true,1290576772,28,1299382158,8805386
1670234123,204690,true,1290834900,28,1298472954,7638054
1670234291,204690,true,1290834900,28,1298472954,7638054
1670234591,204688,true,1291093080,28,1298472954,7379874
1670234759,204687,true,1291222189,28,1298343120,7120931
1670234771,204685,true,1291480447,28,1298343120,6862673
1670234915,204685,true,1291480447,28,1298343120,6862673
1670234927,204683,true,1291738756,28,1298213298,6474542
1670236499,204682,true,1291867929,28,1296526802,4658873
1670236679,204680,true,1292126316,28,1296526802,4400486
1670237111,204680,true,1292126316,28,1296397162,4270846
1670239175,204678,true,1292384754,28,1296267536,3882782
1670241923,204677,true,1292513993,28,1296267536,3753543
1670241935,204675,true,1292772508,28,1296267536,3495028
1670241959,204675,true,1292772508,28,1296267536,3495028
1670242031,204673,true,1293031076,28,1296267536,3236460
1670242751,204672,true,1293160379,28,1295619596,2459217
1670242787,204670,true,1293419024,28,1295619596,2200572
1670242799,204670,true,1293419024,28,1295619596,2200572
1670244023,204669,true,1293548366,28,1293807088,258722
1670244035,204667,true,1293807088,28,1293807088,0
1670244071,204666,true,1293936469,28,1293677721,-258748
1670244155,204665,true,1294065863,28,1293548366,-517497
1670244263,204664,true,1294195269,28,1293419024,-776245
1670244587,204664,true,1294195269,28,1292901786,-1293483
1670245331,204663,true,1294324689,28,1292126316,-2198373
1670246015,204662,true,1294454121,28,1291609595,-2844526
1670246243,204661,true,1294583567,28,1291609595,-2973972
1670246783,204661,true,1294583567,28,1291351311,-3232256
1670248583,204660,true,1294713025,28,1290705829,-4007196
1670248607,204659,true,1294842496,28,1290705829,-4136667
1670248811,204659,true,1294842496,28,1290447727,-4394769
1670249615,204658,true,1294971981,28,1288900196,-6071785
1670250539,204658,true,1294971981,28,1287483256,-7488725
1670250575,204658,true,1294971981,28,1287483256,-7488725
1670250587,204657,true,1295101478,28,1287483256,-7618222
1670250623,204657,true,1295101478,28,1287483256,-7618222
1670251295,204657,true,1295101478,28,1286839707,-8261771
1670251499,204657,true,1295101478,28,1286582378,-8519100
1670251691,204657,true,1295101478,28,1286453733,-8647745
1670252387,204657,true,1295101478,28,1285810699,-9290779
1670252411,204657,true,1295101478,28,1285810699,-9290779
1670252567,204657,true,1295101478,28,1285425033,-9676445
1670252747,204658,true,1294971981,28,1284910991,-10060990
1670252843,204659,true,1294842496,28,1284525595,-10316901
1670252855,204660,true,1294713025,28,1284525595,-10187430
1670252867,204660,true,1294713025,28,1284397155,-10315870
1670252891,204661,true,1294583567,28,1284268728,-10314839
1670252975,204664,true,1294195269,28,1283626787,-10568482
1670252987,204665,true,1294065863,28,1283498437,-10567426
1670252999,204665,true,1294065863,28,1283498437,-10567426
1670253047,204666,true,1293936469,28,1283113464,-10823005
1670253239,204669,true,1293548366,28,1281574728,-11973638
1670253311,204670,true,1293419024,28,1280934133,-12484891
1670253323,204671,true,1293289695,28,1280806053,-12483642
1670253623,204672,true,1293160379,28,1278247128,-14913251
1670253659,204676,true,1292643244,28,1277863731,-14779513
1670253707,204677,true,1292513993,28,1277352713,-15161280
1670253719,204677,true,1292513993,28,1277224990,-15289003
1670253767,204679,true,1292255529,28,1276714228,-15541301
1670253911,204683,true,1291738756,28,1275183166,-16555590
1670254163,204685,true,1291480447,28,1272380987,-19099460
1670254307,204685,true,1291480447,28,1270855122,-20625325
1670255339,204688,true,1291093080,28,1264769938,-26323142
1670255999,204692,true,1290576772,28,1263758577,-26818195
1670256515,204693,true,1290447727,28,1263758577,-26689150
1670256539,204694,true,1290318695,28,1263758577,-26560118
1670256599,204696,true,1290060670,28,1263758577,-26302093
1670256623,204700,true,1289544775,28,1263758577,-25786198
1670256647,204701,true,1289415833,28,1263758577,-25657256
1670256707,204702,true,1289286905,28,1263884953,-25401952
1670256803,204704,true,1289029086,28,1264011341,-25017745
1670257019,204708,true,1288513603,28,1264264156,-24249447
1670257343,204710,true,1288255939,28,1264643473,-23612466
1670257367,204711,true,1288127126,28,1264643473,-23483653
1670257379,204713,true,1287869539,28,1264643473,-23226066
1670257511,204718,true,1287225798,28,1264769938,-22455860
1670257523,204720,true,1286968391,28,1264769938,-22198453
1670257535,204721,true,1286839707,28,1264769938,-22069769
1670257547,204723,true,1286582378,28,1264769938,-21812440
1670257631,204728,true,1285939280,28,1264643473,-21295807
1670257739,204731,true,1285553575,28,1264643473,-20910102
1670257823,204732,true,1285425033,28,1264517022,-20908011
1670258171,204734,true,1285167986,28,1264137742,-21030244
1670259455,204739,true,1284525595,28,1261738281,-22787314
1670259623,204742,true,1284140314,28,1261738281,-22402033
1670259983,204742,true,1284140314,28,1261738281,-22402033
1670260019,204745,true,1283755149,28,1261738281,-22016868
1670260031,204750,true,1283113464,28,1261738281,-21375183
1670260067,204752,true,1282856880,28,1261738281,-21118599
1670260535,204753,true,1282728607,28,1260981503,-21747104
1670260823,204756,true,1282343865,28,1260603284,-21740581
1670260955,204761,true,1281702886,28,1260477236,-21225650
1670260979,204763,true,1281446584,28,1260351201,-21095383
1670261075,204764,true,1281318452,28,1260351201,-20967251
1670261363,204767,true,1280934133,28,1260099169,-20834964
1670261483,204771,true,1280421888,28,1259973171,-20448717
1670261507,204774,true,1280037838,28,1259973171,-20064667
1670261687,204775,true,1279909847,28,1259847187,-20062660
1670261831,204777,true,1279653903,28,1259721215,-19932688
1670261891,204782,true,1279014268,28,1259847187,-19167081
1670261963,204784,true,1278758504,28,1259847187,-18911317
1670262383,204785,true,1278630641,28,1260351201,-18279440
1670262479,204787,true,1278374953,28,1260603284,-17771669
1670262611,204792,true,1277735957,28,1260729344,-17006613
1670263871,204795,true,1277352713,28,1261990641,-15362072
1670264123,204796,true,1277224990,28,1262116840,-15108150
1670264159,204798,true,1276969584,28,1262116840,-14852744
1670264171,204803,true,1276331291,28,1262116840,-14214451
1670264183,204805,true,1276076063,28,1262116840,-13959223
1670264219,204806,true,1275948468,28,1262116840,-13831628
1670264243,204809,true,1275565760,28,1262243052,-13322708
1670264279,204813,true,1275055661,28,1262243052,-12812609
1670264927,204814,true,1274928168,28,1263884953,-11043215
1670265179,204815,true,1274800688,28,1264517022,-10283666
1670265491,204818,true,1274418324,28,1265275922,-9142402
1670266619,204822,true,1273908684,28,1266415126,-7493558
1670266715,204823,true,1273781306,28,1266415126,-7366180
1670267207,204824,true,1273653941,28,1266161881,-7492060
1670267243,204826,true,1273399248,28,1266035277,-7363971
1670267291,204831,true,1272762740,28,1266035277,-6727463
1670267315,204832,true,1272635476,28,1266035277,-6600199
1670267399,204833,true,1272508225,28,1265908686,-6599539
1670267411,204835,true,1272253762,28,1265908686,-6345076
1670267483,204840,true,1271617826,28,1265655542,-5962284
1670267759,204841,true,1271490677,28,1265149407,-6341270
1670267795,204842,true,1271363540,28,1265022904,-6340636
1670267819,204845,true,1270982207,28,1264896415,-6085792
1670267831,204849,true,1270473942,28,1264896415,-5577527
1670267843,204851,true,1270219885,28,1264769938,-5449947
1670267855,204852,true,1270092876,28,1264769938,-5322938
1670267975,204855,true,1269711924,28,1264137742,-5574182
1670268047,204859,true,1269204166,28,1263758577,-5445589
1670268059,204861,true,1268950363,28,1263632214,-5318149
1670268071,204862,true,1268823481,28,1263632214,-5191267
1670268323,204865,true,1268442910,28,1261990641,-6452269
1670268779,204870,true,1267808879,28,1258965646,-8843233
1670268815,204872,true,1267555355,28,1258713891,-8841464
1670268827,204873,true,1267428612,28,1258588032,-8840580
1670269091,204876,true,1267048460,28,1256576002,-10472458
1670270099,204881,true,1266415126,28,1251810312,-14604814
1670270579,204883,true,1266161881,28,1251309713,-14852168
1670270975,204884,true,1266035277,28,1251434844,-14600433
1670271011,204887,true,1265655542,28,1251434844,-14220698
1670271227,204892,true,1265022904,28,1251685143,-13337761
1670271239,204893,true,1264896415,28,1251685143,-13211272
1670271347,204894,true,1264769938,28,1251935493,-12834445
1670274683,204897,true,1264390583,28,1253689342,-10701241
1670275019,204901,true,1263884953,28,1253814711,-10070242
1670275139,204902,true,1263758577,28,1253814711,-9943866
1670275199,204903,true,1263632214,28,1253814711,-9817503
1670276363,204905,true,1263379525,28,1254567188,-8812337
1670277527,204910,true,1262748025,28,1255445649,-7302376
1670277563,204910,true,1262748025,28,1255445649,-7302376
1670278043,204911,true,1262621763,28,1255822320,-6799443
1670279807,204913,true,1262369276,28,1255947902,-6421374
1670279939,204917,true,1261864455,28,1256073497,-5790958
1670280059,204917,true,1261864455,28,1256073497,-5790958
1670280563,204918,true,1261738281,28,1256199105,-5539176
1670283455,204919,true,1261612120,28,1256701660,-4910460
1670283695,204921,true,1261359835,28,1256701660,-4658175
1670283731,204922,true,1261233712,28,1256701660,-4532052
1670283743,204922,true,1261233712,28,1256827330,-4406382
1670284187,204924,true,1260981503,28,1256827330,-4154173
1670284811,204925,true,1260855417,28,1256953012,-3902405
1670285087,204926,true,1260729344,28,1256953012,-3776332
1670285291,204926,true,1260729344,28,1257078708,-3650636
1670285303,204928,true,1260477236,28,1257078708,-3398528
1670285327,204929,true,1260351201,28,1257078708,-3272493
1670285339,204930,true,1260225179,28,1257078708,-3146471
1670285363,204930,true,1260225179,28,1257078708,-3146471
1670285375,204930,true,1260225179,28,1257078708,-3146471
1670285519,204931,true,1260099169,28,1257330136,-2769033
1670285531,204931,true,1260099169,28,1257330136,-2769033
1670285543,204931,true,1260099169,28,1257330136,-2769033
1670286143,204931,true,1260099169,28,1258462186,-1636983
1670286251,204932,true,1259973171,28,1258588032,-1385139
1670286263,204932,true,1259973171,28,1258588032,-1385139
1670286299,204932,true,1259973171,28,1258713891,-1259280
1670287019,204932,true,1259973171,28,1260099169,125998
1670287079,204933,true,1259847187,28,1260225179,377992
1670287091,204933,true,1259847187,28,1260225179,377992
1670287823,204933,true,1259847187,28,1261107601,1260414
1670288291,204933,true,1259847187,28,1261485971,1638784
1670288315,204934,true,1259721215,28,1261485971,1764756
1670288387,204935,true,1259595255,28,1261612120,2016865
1670288411,204935,true,1259595255,28,1261612120,2016865
1670288435,204934,true,1259721215,28,1261612120,1890905
1670288663,204935,true,1259595255,28,1262243052,2647797
1670288927,204935,true,1259595255,28,1262874300,3279045
1670289059,204934,true,1259721215,28,1263126887,3405672
1670289143,204934,true,1259721215,28,1263253200,3531985
1670289155,204934,true,1259721215,28,1263253200,3531985
1670289215,204934,true,1259721215,28,1263379525,3658310
1670290979,204933,true,1259847187,28,1266161881,6314694
1670291519,204933,true,1259847187,28,1266161881,6314694
1670292647,204933,true,1259847187,28,1265908686,6061499
1670293967,204932,true,1259973171,28,1265655542,5682371
1670296727,204932,true,1259973171,28,1265655542,5682371
1670297855,204932,true,1259973171,28,1265655542,5682371
1670298167,204931,true,1260099169,28,1265655542,5556373
1670298527,204931,true,1260099169,28,1265655542,5556373
1670298851,204930,true,1260225179,28,1265655542,5430363
1670298911,204930,true,1260225179,28,1265655542,5430363
1670299115,204930,true,1260225179,28,1265655542,5430363
1670300003,204930,true,1260225179,28,1265402449,5177270
1670300171,204929,true,1260351201,28,1265275922,4924721
1670300183,204928,true,1260477236,28,1265275922,4798686
1670300243,204928,true,1260477236,28,1265149407,4672171
1670300303,204928,true,1260477236,28,1265022904,4545668
1670301167,204928,true,1260477236,28,1263505863,3028627
1670301431,204928,true,1260477236,28,1263126887,2649651
1670301995,204928,true,1260477236,28,1262116840,1639604
1670302319,204928,true,1260477236,28,1262116840,1639604
1670303339,204928,true,1260477236,28,1261864455,1387219
1670304551,204928,true,1260477236,28,1261864455,1387219
1670304839,204928,true,1260477236,28,1261864455,1387219
1670304875,204928,true,1260477236,28,1261864455,1387219
1670304887,204928,true,1260477236,28,1261864455,1387219
1670304923,204928,true,1260477236,28,1261864455,1387219
1670305283,204928,true,1260477236,28,1261612120,1134884
1670305319,204929,true,1260351201,28,1261612120,1260919
1670305343,204929,true,1260351201,28,1261612120,1260919
1670305355,204929,true,1260351201,28,1261612120,1260919
1670305535,204930,true,1260225179,28,1261359835,1134656
1670305871,204930,true,1260225179,28,1260855417,630238
1670305979,204931,true,1260099169,28,1260729344,630175
1670306051,204931,true,1260099169,28,1260603284,504115
1670306447,204932,true,1259973171,28,1260099169,125998
1670307335,204932,true,1259973171,28,1259217452,-755719
1670308355,204933,true,1259847187,28,1258965646,-881541
1670309471,204933,true,1259847187,28,1258965646,-881541
1670310143,204933,true,1259847187,28,1259091543,-755644
1670310755,204934,true,1259721215,28,1259217452,-503763
1670310947,204934,true,1259721215,28,1259217452,-503763
1670311511,204934,true,1259721215,28,1259217452,-503763
1670312903,204934,true,1259721215,28,1260351201,629986
1670314163,204935,true,1259595255,28,1260603284,1008029
1670314175,204935,true,1259595255,28,1260729344,1134089
1670315555,204935,true,1259595255,28,1261107601,1512346
1670315627,204935,true,1259595255,28,1261107601,1512346
1670317103,204935,true,1259595255,28,1260225179,629924
1670317307,204934,true,1259721215,28,1260099169,377954
1670318111,204934,true,1259721215,28,1259973171,251956
1670318519,204934,true,1259721215,28,1259973171,251956
1670318795,204934,true,1259721215,28,1259973171,251956
1670319107,204934,true,1259721215,28,1259973171,251956
1670319623,204933,true,1259847187,28,1259973171,125984
1670319983,204932,true,1259973171,28,1259973171,0
1670320163,204932,true,1259973171,28,1259973171,0
1670320223,204932,true,1259973171,28,1259973171,0
1670320391,204930,true,1260225179,28,1259973171,-252008
1670320487,204930,true,1260225179,28,1259973171,-252008
1670321039,204930,true,1260225179,28,1259847187,-377992
1670321063,204929,true,1260351201,28,1259847187,-504014
1670321411,204928,true,1260477236,28,1259217452,-1259784
1670322611,204928,true,1260477236,28,1256953012,-3524224
1670322635,204929,true,1260351201,28,1256827330,-3523871
1670323595,204929,true,1260351201,28,1255320117,-5031084
1670324627,204928,true,1260477236,28,1253187992,-7289244
1670325179,204928,true,1260477236,28,1252686842,-7790394
1670325647,204929,true,1260351201,28,1252436342,-7914859
1670325659,204929,true,1260351201,28,1252436342,-7914859
1670325815,204929,true,1260351201,28,1252185893,-8165308
1670325839,204929,true,1260351201,28,1252185893,-8165308
1670325911,204930,true,1260225179,28,1252060687,-8164492
1670326043,204931,true,1260099169,28,1251935493,-8163676
1670326283,204930,true,1260225179,28,1251810312,-8414867
1670326295,204931,true,1260099169,28,1251810312,-8288857
1670327471,204931,true,1260099169,28,1252060687,-8038482
1670327795,204932,true,1259973171,28,1252561586,-7411585
1670327999,204931,true,1260099169,28,1252812111,-7287058
1670328071,204932,true,1259973171,28,1252937392,-7035779
1670328191,204932,true,1259973171,28,1252937392,-7035779
1670328335,204932,true,1259973171,28,1253062686,-6910485
1670329715,204932,true,1259973171,28,1254065487,-5907684
1670329907,204933,true,1259847187,28,1254190893,-5656294
1670330063,204933,true,1259847187,28,1254190893,-5656294
1670330183,204933,true,1259847187,28,1254316313,-5530874
1670330279,204933,true,1259847187,28,1254441744,-5405443
1670330291,204933,true,1259847187,28,1254441744,-5405443
1670330927,204934,true,1259721215,28,1255069090,-4652125
1670331131,204934,true,1259721215,28,1255320117,-4401098
1670332283,204933,true,1259847187,28,1256073497,-3773690
1670332571,204934,true,1259721215,28,1256073497,-3647718
1670332823,204934,true,1259721215,28,1256199105,-3522110
1670332883,204935,true,1259595255,28,1256199105,-3396150
1670332919,204934,true,1259721215,28,1256199105,-3522110
1670334887,204935,true,1259595255,28,1257707373,-1887882
1670335103,204935,true,1259595255,28,1257707373,-1887882
1670335355,204935,true,1259595255,28,1257707373,-1887882
1670336219,204935,true,1259595255,28,1257204416,-2390839
1670336603,204936,true,1259469308,28,1256953012,-2516296
1670336627,204936,true,1259469308,28,1256953012,-2516296
1670337227,204937,true,1259343374,28,1256701660,-2641714
1670337311,204937,true,1259343374,28,1256701660,-2641714
1670337491,204937,true,1259343374,28,1256701660,-2641714
1670337839,204938,true,1259217452,28,1256701660,-2515792
1670337875,204938,true,1259217452,28,1256576002,-2641450
1670337911,204939,true,1259091543,28,1256576002,-2515541
1670337947,204940,true,1258965646,28,1256576002,-2389644
1670338067,204941,true,1258839762,28,1256450357,-2389405
1670338415,204942,true,1258713891,28,1255822320,-2891571
1670338991,204942,true,1258713891,28,1254818114,-3895777
1670339195,204943,true,1258588032,28,1254316313,-4271719
1670339267,204944,true,1258462186,28,1254190893,-4271293
1670339279,204945,true,1258336352,28,1254065487,-4270865
1670339315,204946,true,1258210531,28,1253940093,-4270438
1670339687,204948,true,1257958927,28,1252561586,-5397341
1670339999,204949,true,1257833144,28,1251685143,-6148001
1670340035,204950,true,1257707373,28,1251685143,-6022230
1670340047,204951,true,1257581615,28,1251559987,-6021628
1670340071,204952,true,1257455869,28,1251559987,-5895882
1670340167,204953,true,1257330136,28,1251434844,-5895292
1670340311,204954,true,1257204416,28,1251309713,-5894703
1670340791,204954,true,1257204416,28,1251059489,-6144927
1670341211,204956,true,1256953012,28,1251309713,-5643299
1670341679,204957,true,1256827330,28,1252060687,-4766643
1670341871,204957,true,1256827330,28,1252436342,-4390988
1670342027,204958,true,1256701660,28,1252561586,-4140074
1670342867,204960,true,1256450357,28,1252812111,-3638246
1670342915,204960,true,1256450357,28,1252812111,-3638246
1670343071,204960,true,1256450357,28,1252937392,-3512965
1670343779,204960,true,1256450357,28,1253313311,-3137046
1670343935,204962,true,1256199105,28,1253438642,-2760463
1670343947,204962,true,1256199105,28,1253438642,-2760463
1670343983,204962,true,1256199105,28,1253438642,-2760463
1670344055,204963,true,1256073497,28,1253563986,-2509511
1670344079,204964,true,1255947902,28,1253563986,-2383916
1670344091,204964,true,1255947902,28,1253563986,-2383916
1670344271,204964,true,1255947902,28,1253689342,-2258560
1670344559,204965,true,1255822320,28,1254065487,-1756833
1670345195,204966,true,1255696751,28,1254692645,-1004106
1670345747,204966,true,1255696751,28,1255320117,-376634
1670346611,204966,true,1255696751,28,1255320117,-376634
1670347019,204966,true,1255696751,28,1255320117,-376634
1670347031,204967,true,1255571193,28,1255320117,-251076
1670347127,204967,true,1255571193,28,1255320117,-251076
1670347139,204967,true,1255571193,28,1255320117,-251076
1670347859,204968,true,1255445649,28,1254441744,-1003905
1670348231,204969,true,1255320117,28,1253940093,-1380024
1670349803,204969,true,1255320117,28,1253187992,-2132125
1670349935,204969,true,1255320117,28,1253187992,-2132125
1670350331,204969,true,1255320117,28,1253062686,-2257431
1670350499,204970,true,1255194597,28,1253062686,-2131911
1670351459,204971,true,1255069090,28,1252185893,-2883197
1670351531,204971,true,1255069090,28,1252185893,-2883197
1670351543,204972,true,1254943596,28,1252060687,-2882909
1670351627,204973,true,1254818114,28,1251935493,-2882621
1670351723,204974,true,1254692645,28,1251685143,-3007502
1670352563,204974,true,1254692645,28,1250184097,-4508548
1670353775,204975,true,1254567188,28,1249434249,-5132939
1670353895,204976,true,1254441744,28,1249434249,-5007495
1670353907,204977,true,1254316313,28,1249434249,-4882064
1670353943,204977,true,1254316313,28,1249434249,-4882064
1670353955,204978,true,1254190893,28,1249434249,-4756644
1670353967,204979,true,1254065487,28,1249434249,-4631238
1670354123,204981,true,1253814711,28,1249059494,-4755217
1670354435,204981,true,1253814711,28,1248559995,-5254716
1670354567,204982,true,1253689342,28,1248310320,-5379022
1670355011,204983,true,1253563986,28,1247436853,-6127133
1670355023,204985,true,1253313311,28,1247436853,-5876458
1670355959,204985,true,1253313311,28,1245940901,-7372410
1670355983,204986,true,1253187992,28,1246065495,-7122497
1670356235,204987,true,1253062686,28,1246190102,-6872584
1670356943,204988,true,1252937392,28,1246439352,-6498040
1670357015,204989,true,1252812111,28,1246563996,-6248115
1670357315,204989,true,1252812111,28,1246813321,-5998790
1670357339,204990,true,1252686842,28,1246813321,-5873521
1670357843,204991,true,1252561586,28,1247187403,-5374183
1670359343,204991,true,1252561586,28,1247561596,-4999990
1670359379,204991,true,1252561586,28,1247686352,-4875234
1670359391,204992,true,1252436342,28,1247686352,-4749990
1670359403,204992,true,1252436342,28,1247686352,-4749990
1670359439,204992,true,1252436342,28,1247686352,-4749990
1670359775,204992,true,1252436342,28,1248060696,-4375646
1670359799,204992,true,1252436342,28,1248185502,-4250840
1670360099,204992,true,1252436342,28,1248684851,-3751491
1670360135,204992,true,1252436342,28,1248809719,-3626623
1670360735,204992,true,1252436342,28,1249934098,-2502244
1670361599,204992,true,1252436342,28,1250934395,-1501947
1670362127,204993,true,1252311111,28,1250934395,-1376716
1670362835,204993,true,1252311111,28,1250934395,-1376716
1670362871,204992,true,1252436342,28,1251059489,-1376853
1670363087,204993,true,1252311111,28,1251059489,-1251622
1670363759,204993,true,1252311111,28,1251559987,-751124
1670363771,204993,true,1252311111,28,1251559987,-751124
1670367875,204993,true,1252311111,28,1252686842,375731
1670368199,204993,true,1252311111,28,1252812111,501000
1670368235,204994,true,1252185893,28,1252937392,751499
1670368247,204994,true,1252185893,28,1252937392,751499
1670368259,204993,true,1252311111,28,1252937392,626281
1670368283,204993,true,1252311111,28,1252937392,626281
1670368295,204994,true,1252185893,28,1252937392,751499
1670368391,204993,true,1252311111,28,1253313311,1002200
1670368475,204992,true,1252436342,28,1253689342,1253000
1670368511,204992,true,1252436342,28,1253814711,1378369
1670368523,204993,true,1252311111,28,1253940093,1628982
1670368859,204991,true,1252561586,28,1255696751,3135165
1670368871,204991,true,1252561586,28,1255822320,3260734
1670368895,204991,true,1252561586,28,1255947902,3386316
1670369015,204991,true,1252561586,28,1256701660,4140074
1670369111,204989,true,1252812111,28,1257455869,4643758
1670369195,204988,true,1252937392,28,1257958927,5021535
1670369219,204989,true,1252812111,28,1258210531,5398420
1670369555,204988,true,1252937392,28,1261107601,8170209
1670369591,204986,true,1253187992,28,1261359835,8171843
1670369663,204985,true,1253313311,28,1261990641,8677330
1670369771,204985,true,1253313311,28,1262874300,9560989
1670369831,204985,true,1253313311,28,1263505863,10192552
1670370095,204983,true,1253563986,28,1265782108,12218122
1670371079,204981,true,1253814711,28,1269711924,15897213
1670371787,204981,true,1253814711,28,1270346907,16532196
1670372915,204980,true,1253940093,28,1270346907,16406814
1670373071,204978,true,1254190893,28,1270346907,16156014
1670373623,204977,true,1254316313,28,1270346907,16030594
1670374043,204976,true,1254441744,28,1270982207,16540463
1670374427,204975,true,1254567188,28,1271490677,16923489
1670374451,204973,true,1254818114,28,1271490677,16672563
1670374499,204971,true,1255069090,28,1271490677,16421587
1670374571,204970,true,1255194597,28,1271617826,16423229
1670375099,204969,true,1255320117,28,1271744987,16424870
1670375303,204967,true,1255571193,28,1271744987,16173794
1670375651,204965,true,1255822320,28,1271236417,15414097
1670375675,204964,true,1255947902,28,1271236417,15288515
1670375759,204964,true,1255947902,28,1271109306,15161404
1670375771,204962,true,1256199105,28,1271109306,14910201
1670375915,204960,true,1256450357,28,1270728049,14277692
1670376227,204959,true,1256576002,28,1269965879,13389877
1670376623,204959,true,1256576002,28,1269331087,12755085
1670376659,204957,true,1256827330,28,1269204166,12376836
1670377007,204956,true,1256953012,28,1268569754,11616742
1670377667,204955,true,1257078708,28,1267808879,10730171
1670379299,204955,true,1257078708,28,1267175165,10096457
1670379527,204953,true,1257330136,28,1267175165,9845029
1670380175,204952,true,1257455869,28,1267175165,9719296
1670380559,204951,true,1257581615,28,1267175165,9593550
1670380787,204951,true,1257581615,28,1267175165,9593550
1670380883,204949,true,1257833144,28,1267175165,9342021
1670381615,204948,true,1257958927,28,1267175165,9216238
1670382719,204948,true,1257958927,28,1266795088,8836161
1670383283,204948,true,1257958927,28,1266541767,8582840
1670383319,204946,true,1258210531,28,1266541767,8331236
1670383415,204945,true,1258336352,28,1266415126,8078774
1670383463,204945,true,1258336352,28,1266415126,8078774
1670383775,204945,true,1258336352,28,1266035277,7698925
1670383787,204943,true,1258588032,28,1266035277,7447245
1670383799,204942,true,1258713891,28,1266035277,7321386
1670383883,204942,true,1258713891,28,1265908686,7194795
1670384615,204943,true,1258588032,28,1264769938,6181906
1670385695,204941,true,1258839762,28,1263379525,4539763
1670386535,204939,true,1259091543,28,1263379525,4287982
1670387339,204939,true,1259091543,28,1263379525,4287982
1670387891,204940,true,1258965646,28,1263379525,4413879
1670389859,204938,true,1259217452,28,1263379525,4162073
1670391047,204936,true,1259469308,28,1263379525,3910217
1670391059,204936,true,1259469308,28,1263379525,3910217
1670391107,204937,true,1259343374,28,1263379525,4036151
1670391407,204935,true,1259595255,28,1263253200,3657945
1670391995,204933,true,1259847187,28,1263000587,3153400
1670392307,204933,true,1259847187,28,1262874300,3027113
1670392511,204933,true,1259847187,28,1262748025,2900838
1670392607,204931,true,1260099169,28,1262621763,2522594
1670392763,204930,true,1260225179,28,1262621763,2396584
1670392871,204929,true,1260351201,28,1262621763,2270562
1670393015,204929,true,1260351201,28,1262495513,2144312
1670393075,204927,true,1260603284,28,1262495513,1892229
1670393339,204926,true,1260729344,28,1262495513,1766169
1670393495,204925,true,1260855417,28,1262495513,1640096
1670393507,204925,true,1260855417,28,1262495513,1640096
1670393543,204923,true,1261107601,28,1262495513,1387912
1670393555,204921,true,1261359835,28,1262495513,1135678
1670394371,204921,true,1261359835,28,1261612120,252285
1670394515,204921,true,1261359835,28,1261485971,126136
1670394539,204918,true,1261738281,28,1261359835,-378446
1670394623,204917,true,1261864455,28,1261233712,-630743
1670395223,204917,true,1261864455,28,1260099169,-1765286
1670395259,204917,true,1261864455,28,1259973171,-1891284
1670395739,204915,true,1262116840,28,1258839762,-3277078
1670395907,204914,true,1262243052,28,1258588032,-3655020
1670395919,204915,true,1262116840,28,1258588032,-3528808
1670395943,204915,true,1262116840,28,1258462186,-3654654
1670395955,204913,true,1262369276,28,1258462186,-3907090
1670396015,204912,true,1262495513,28,1258210531,-4284982
1670396051,204913,true,1262369276,28,1258084723,-4284553
1670396075,204913,true,1262369276,28,1257958927,-4410349
1670396303,204911,true,1262621763,28,1257078708,-5543055
1670396351,204911,true,1262621763,28,1256827330,-5794433
1670396711,204912,true,1262495513,28,1255571193,-6924320
1670396759,204912,true,1262495513,28,1255320117,-7175396
1670396795,204911,true,1262621763,28,1255194597,-7427166
1670396891,204911,true,1262621763,28,1254692645,-7929118
1670396903,204912,true,1262495513,28,1254692645,-7802868
1670396975,204912,true,1262495513,28,1254316313,-8179200
1670397071,204911,true,1262621763,28,1253814711,-8807052
1670397155,204911,true,1262621763,28,1253313311,-9308452
1670397167,204913,true,1262369276,28,1253313311,-9055965
1670397191,204913,true,1262369276,28,1253062686,-9306590
1670397203,204913,true,1262369276,28,1252937392,-9431884
1670397215,204915,true,1262116840,28,1252812111,-9304729
1670397227,204917,true,1261864455,28,1252686842,-9177613
1670397383,204919,true,1261612120,28,1250434147,-11177973
1670397647,204919,true,1261612120,28,1246813321,-14798799
1670397815,204921,true,1261359835,28,1244571188,-16788647
1670398703,204924,true,1260981503,28,1234284510,-26696993
1670398811,204926,true,1260729344,28,1233297527,-27431817
1670399003,204927,true,1260603284,28,1231572204,-29031080
1670399135,204929,true,1260351201,28,1231449060,-28902141
1670399159,204932,true,1259973171,28,1231449060,-28524111
1670399423,204935,true,1259595255,28,1231202807,-28392448
1670399435,204936,true,1259469308,28,1231202807,-28266501
1670399447,204938,true,1259217452,28,1231202807,-28014645
1670400083,204942,true,1258713891,28,1229357479,-29356412
1670400107,204945,true,1258336352,28,1229234556,-29101796
1670400179,204947,true,1258084723,28,1228988746,-29095977
1670400191,204949,true,1257833144,28,1228988746,-28844398
1670401619,204954,true,1257204416,28,1225062463,-32141953
1670401703,204957,true,1256827330,28,1224939969,-31887361
1670401775,204959,true,1256576002,28,1224939969,-31636033
1670401811,204962,true,1256199105,28,1224939969,-31259136
1670402027,204966,true,1255696751,28,1224939969,-30756782
1670402039,204970,true,1255194597,28,1224939969,-30254628
1670402111,204971,true,1255069090,28,1225062463,-30006627
1670402243,204974,true,1254692645,28,1225184970,-29507675
1670402267,204978,true,1254190893,28,1225184970,-29005923
1670402375,204982,true,1253689342,28,1225307488,-28381854
1670402663,204984,true,1253438642,28,1225675117,-27763525
1670405411,204987,true,1253062686,28,1226901344,-26161342
1670406095,204991,true,1252561586,28,1226901344,-25660242
1670406791,204995,true,1252060687,28,1226901344,-25159343
1670407151,204997,true,1251810312,28,1226901344,-24908968
1670409071,205000,true,1251434844,28,1227146736,-24288108
1670409095,205004,true,1250934395,28,1227146736,-23787659
1670409635,205008,true,1250434147,28,1227146736,-23287411
1670411231,205009,true,1250309116,28,1227146736,-23162380
1670411291,205012,true,1249934098,28,1227146736,-22787362
1670411531,205016,true,1249434249,28,1227146736,-22287513
1670412263,205020,true,1248934600,28,1227146736,-21787864
1670412863,205021,true,1248809719,28,1227146736,-21662983
1670412875,205024,true,1248435151,28,1227269451,-21165700
1670412983,205028,true,1247935902,28,1227269451,-20666451
1670413775,205031,true,1247561596,28,1227637669,-19923927
1670413943,205033,true,1247312121,28,1227637669,-19674452
1670414699,205036,true,1246938003,28,1227760432,-19177571
1670414807,205040,true,1246439352,28,1227637669,-18801683
1670415107,205043,true,1246065495,28,1227637669,-18427826
1670415311,205044,true,1245940901,28,1227514917,-18425984
1670415659,205047,true,1245567193,28,1227514917,-18052276
1670415683,205051,true,1245069091,28,1227392178,-17676913
1670416079,205054,true,1244695645,28,1227024034,-17671611
1670416595,205056,true,1244446743,28,1226533347,-17913396
1670416619,205059,true,1244073484,28,1226533347,-17540137
1670416631,205063,true,1243575979,28,1226533347,-17042632
1670416667,205066,true,1243202981,28,1226533347,-16669634
1670416967,205068,true,1242954377,28,1226165461,-16788916
1670417195,205071,true,1242581566,28,1225797685,-16783881
1670418455,205075,true,1242084657,28,1224327683,-17756974
1670418659,205078,true,1241712106,28,1224082854,-17629252
1670418671,205079,true,1241587948,28,1224082854,-17505094
1670418695,205082,true,1241215546,28,1224082854,-17132692
1670418707,205086,true,1240719184,28,1224082854,-16636330
1670418719,205089,true,1240347042,28,1224082854,-16264188
1670418731,205091,true,1240099010,28,1224082854,-16016156
1670418743,205093,true,1239851027,28,1224082854,-15768173
1670418779,205097,true,1239355211,28,1224082854,-15272357
1670418791,205100,true,1238983479,28,1224082854,-14900625
1670418839,205101,true,1238859593,28,1224205262,-14654331
1670418851,205104,true,1238488009,28,1224205262,-14282747
1670418947,205108,true,1237992738,28,1224327683,-13665055
1670418959,205110,true,1237745176,28,1224327683,-13417493
1670418983,205112,true,1237497664,28,1224450116,-13047548
1670419007,205114,true,1237250202,28,1224450116,-12800086
1670419127,205117,true,1236879101,28,1224817488,-12061613
1670419355,205120,true,1236508112,28,1225552562,-10955550
1670419739,205121,true,1236384473,28,1226901344,-9483129
1670419835,205123,true,1236137233,28,1227269451,-8867782
1670419895,205127,true,1235642902,28,1227514917,-8127985
1670420315,205129,true,1235395811,28,1229111644,-6284167
1670421299,205130,true,1235272283,28,1231079699,-4192584
1670421323,205132,true,1235025266,28,1231079699,-3945567
1670422559,205136,true,1234531379,28,1231572204,-2959175
1670422907,205138,true,1234284510,28,1231695362,-2589148
1670423003,205139,true,1234161094,28,1231695362,-2465732
1670423015,205141,true,1233914299,28,1231695362,-2218937
1670423435,205144,true,1233544199,28,1231695362,-1848837
1670423615,205146,true,1233297527,28,1231818531,-1478996
1670423663,205147,true,1233174209,28,1231941713,-1232496
1670423675,205149,true,1232927611,28,1231941713,-985898
1670423771,205151,true,1232681063,28,1232064907,-616156
1670423831,205153,true,1232434564,28,1232188114,-246450
1670424623,205153,true,1232434564,28,1234284510,1849946
1670424803,205155,true,1232188114,28,1234778298,2590184
1670425679,205157,true,1231941713,28,1236137233,4195520
1670425871,205159,true,1231695362,28,1236013632,4318270
1670425883,205159,true,1231695362,28,1236013632,4318270
1670426099,205161,true,1231449060,28,1235766466,4317406
1670426651,205163,true,1231202807,28,1235272283,4069476
1670426663,205165,true,1230956603,28,1235272283,4315680
1670426795,205165,true,1230956603,28,1235148769,4192166
1670427323,205166,true,1230833520,28,1234654833,3821313
1670427383,205168,true,1230587390,28,1234531379,3943989
1670427443,205170,true,1230341309,28,1234531379,4190070
1670427551,205170,true,1230341309,28,1234284510,3943201
1670427587,205172,true,1230095278,28,1234284510,4189232
1670427611,205173,true,1229972281,28,1234284510,4312229
1670427647,205175,true,1229726323,28,1234161094,4434771
1670428067,205175,true,1229726323,28,1233544199,3817876
1670428571,205177,true,1229480415,28,1232681063,3200648
1670428631,205178,true,1229357479,28,1232681063,3323584
1670429363,205179,true,1229234556,28,1231941713,2707157
1670430827,205179,true,1229234556,28,1231818531,2583975
1670430947,205179,true,1229234556,28,1231818531,2583975
1670431259,205180,true,1229111644,28,1231818531,2706887
1670431571,205180,true,1229111644,28,1231818531,2706887
1670431583,205179,true,1229234556,28,1231818531,2583975
1670431919,205179,true,1229234556,28,1231818531,2583975
1670433023,205180,true,1229111644,28,1231325927,2214283
1670434019,205180,true,1229111644,28,1231202807,2091163
1670434283,205179,true,1229234556,28,1231202807,1968251
1670434859,205179,true,1229234556,28,1231202807,1968251
1670435471,205180,true,1229111644,28,1231202807,2091163
1670435591,205179,true,1229234556,28,1231202807,1968251
1670435615,205179,true,1229234556,28,1231202807,1968251
1670436887,205179,true,1229234556,28,1231202807,1968251
1670437019,205179,true,1229234556,28,1231325927,2091371
1670437043,205178,true,1229357479,28,1231325927,1968448
1670437067,205177,true,1229480415,28,1231325927,1845512
1670439647,205177,true,1229480415,28,1233174209,3693794
1670439767,205176,true,1229603363,28,1233174209,3570846
1670439899,205176,true,1229603363,28,1233174209,3570846
1670440919,205175,true,1229726323,28,1232927611,3201288
1670441855,205175,true,1229726323,28,1232557807,2831484
1670441975,205174,true,1229849296,28,1232557807,2708511
1670444243,205174,true,1229849296,28,1231572204,1722908
1670444351,205173,true,1229972281,28,1231572204,1599923
1670444615,205173,true,1229972281,28,1231572204,1599923
1670445383,205173,true,1229972281,28,1231572204,1599923
1670446871,205172,true,1230095278,28,1231572204,1476926
1670447915,205172,true,1230095278,28,1231572204,1476926
1670449655,205172,true,1230095278,28,1231572204,1476926
1670450411,205171,true,1230218288,28,1231572204,1353916
1670450927,205171,true,1230218288,28,1231572204,1353916
1670451407,205170,true,1230341309,28,1231572204,1230895
1670451479,205171,true,1230218288,28,1231572204,1353916
1670451575,205170,true,1230341309,28,1231572204,1230895
1670452319,205170,true,1230341309,28,1231325927,984618
1670452331,205169,true,1230464343,28,1231325927,861584
1670452343,205169,true,1230464343,28,1231325927,861584
1670453099,205170,true,1230341309,28,1229480415,-860894
1670453351,205170,true,1230341309,28,1228865859,-1475450
1670453555,205169,true,1230464343,28,1228620123,-1844220
1670454167,205169,true,1230464343,28,1227883209,-2581134
1670454455,205169,true,1230464343,28,1228005997,-2458346
1670454467,205169,true,1230464343,28,1228005997,-2458346
1670454479,205169,true,1230464343,28,1228005997,-2458346
1670454527,205169,true,1230464343,28,1228128797,-2335546
1670454791,205169,true,1230464343,28,1228374435,-2089908
1670454815,205169,true,1230464343,28,1228497273,-1967070
1670455703,205168,true,1230587390,28,1229726323,-861067
1670456567,205168,true,1230587390,28,1230587390,0
1670456819,205168,true,1230587390,28,1230587390,0
1670456987,205168,true,1230587390,28,1230710449,123059
1670458859,205167,true,1230710449,28,1231325927,615478
1670458871,205166,true,1230833520,28,1231449060,615540
1670460803,205166,true,1230833520,28,1233790920,2957400
1670461019,205166,true,1230833520,28,1233790920,2957400
1670461031,205164,true,1231079699,28,1233790920,2711221
1670461043,205164,true,1231079699,28,1233790920,2711221
1670461079,205163,true,1231202807,28,1233667553,2464746
1670461115,205163,true,1231202807,28,1233667553,2464746
1670461139,205162,true,1231325927,28,1233667553,2341626
1670461271,205162,true,1231325927,28,1233297527,1971600
1670461307,205161,true,1231449060,28,1233297527,1848467
1670461691,205162,true,1231325927,28,1232311333,985406
1670462099,205161,true,1231449060,28,1231202807,-246253
1670462195,205161,true,1231449060,28,1231079699,-369361
1670463275,205160,true,1231572204,28,1228742985,-2829219
1670463311,205161,true,1231449060,28,1228742985,-2706075
1670463323,205160,true,1231572204,28,1228742985,-2829219
1670463815,205160,true,1231572204,28,1228251610,-3320594
1670463875,205160,true,1231572204,28,1228128797,-3443407
1670464487,205161,true,1231449060,28,1227637669,-3811391
1670464619,205160,true,1231572204,28,1227514917,-4057287
1670465783,205160,true,1231572204,28,1226901344,-4670860
1670467151,205161,true,1231449060,28,1226901344,-4547716
1670467187,205162,true,1231325927,28,1227024034,-4301893
1670467223,205161,true,1231449060,28,1227024034,-4425026
1670467283,205161,true,1231449060,28,1227024034,-4425026
1670467307,205162,true,1231325927,28,1227024034,-4301893
1670467319,205163,true,1231202807,28,1227024034,-4178773
1670467355,205162,true,1231325927,28,1227024034,-4301893
1670467367,205162,true,1231325927,28,1227024034,-4301893
1670467391,205162,true,1231325927,28,1227146736,-4179191
1670467403,205163,true,1231202807,28,1227146736,-4056071
1670467415,205162,true,1231325927,28,1227146736,-4179191
1670467463,205162,true,1231325927,28,1227269451,-4056476
1670467475,205162,true,1231325927,28,1227392178,-3933749
1670467511,205163,true,1231202807,28,1227514917,-3687890
1670467523,205162,true,1231325927,28,1227514917,-3811010
1670467931,205162,true,1231325927,28,1229234556,-2091371
1670468051,205162,true,1231325927,28,1229849296,-1476631
1670468903,205163,true,1231202807,28,1233420856,2218049
1670469527,205163,true,1231202807,28,1234654833,3452026
1670471531,205162,true,1231325927,28,1234654833,3328906
1670472335,205162,true,1231325927,28,1234654833,3328906
1670472815,205163,true,1231202807,28,1234654833,3452026
1670472863,205163,true,1231202807,28,1234654833,3452026
1670473127,205162,true,1231325927,28,1234531379,3205452
1670473139,205163,true,1231202807,28,1234531379,3328572
1670473187,205164,true,1231079699,28,1234531379,3451680
1670473199,205163,true,1231202807,28,1234531379,3328572
1670473295,205163,true,1231202807,28,1234407939,3205132
1670473355,205163,true,1231202807,28,1234284510,3081703
1670473367,205164,true,1231079699,28,1234284510,3204811
1670473403,205164,true,1231079699,28,1234284510,3204811
1670473427,205163,true,1231202807,28,1234161094,2958287
1670473511,205163,true,1231202807,28,1234037690,2834883
1670473571,205165,true,1230956603,28,1233914299,2957696
1670473727,205164,true,1231079699,28,1233544199,2464500
1670473763,205163,true,1231202807,28,1233420856,2218049
1670475755,205164,true,1231079699,28,1230341309,-738390
1670476271,205165,true,1230956603,28,1230218288,-738315
1670476391,205164,true,1231079699,28,1230218288,-861411
1670477699,205164,true,1231079699,28,1229849296,-1230403
1670478443,205164,true,1231079699,28,1229849296,-1230403
1670479655,205166,true,1230833520,28,1229849296,-984224
1670480387,205165,true,1230956603,28,1229480415,-1476188
1670480435,205164,true,1231079699,28,1229480415,-1599284
1670482859,205165,true,1230956603,28,1228865859,-2090744
1670483399,205166,true,1230833520,28,1228865859,-1967661
1670483639,205166,true,1230833520,28,1228865859,-1967661
1670483747,205165,true,1230956603,28,1228988746,-1967857
1670483771,205166,true,1230833520,28,1228988746,-1844774
1670484167,205167,true,1230710449,28,1229234556,-1475893
1670484179,205166,true,1230833520,28,1229234556,-1598964
1670484227,205165,true,1230956603,28,1229357479,-1599124
1670484899,205166,true,1230833520,28,1230218288,-615232
1670485079,205167,true,1230710449,28,1230464343,-246106
1670485127,205166,true,1230833520,28,1230464343,-369177
1670485211,205166,true,1230833520,28,1230587390,-246130
1670486771,205166,true,1230833520,28,1232311333,1477813
1670486855,205167,true,1230710449,28,1232311333,1600884
1670487131,205166,true,1230833520,28,1232311333,1477813
1670488883,205166,true,1230833520,28,1232311333,1477813
1670489483,205166,true,1230833520,28,1232311333,1477813
1670490815,205167,true,1230710449,28,1232311333,1600884
1670491343,205166,true,1230833520,28,1232311333,1477813
1670491883,205166,true,1230833520,28,1232311333,1477813
1670492915,205166,true,1230833520,28,1232311333,1477813
1670493275,205167,true,1230710449,28,1232311333,1600884
1670494367,205166,true,1230833520,28,1232311333,1477813
1670495159,205165,true,1230956603,28,1232311333,1354730
1670495735,205166,true,1230833520,28,1232311333,1477813
1670496335,205166,true,1230833520,28,1232311333,1477813
1670496491,205166,true,1230833520,28,1232311333,1477813
1670496815,205165,true,1230956603,28,1232311333,1354730
1670496947,205165,true,1230956603,28,1232311333,1354730
1670497307,205166,true,1230833520,28,1232311333,1477813
1670497403,205165,true,1230956603,28,1232311333,1354730
1670498123,205165,true,1230956603,28,1232311333,1354730
1670498231,205164,true,1231079699,28,1232311333,1231634
1670498531,205165,true,1230956603,28,1232311333,1354730
1670498663,205164,true,1231079699,28,1232311333,1231634
1670499083,205164,true,1231079699,28,1232311333,1231634
1670499323,205163,true,1231202807,28,1232311333,1108526
1670499443,205164,true,1231079699,28,1232311333,1231634
1670499503,205163,true,1231202807,28,1232311333,1108526
1670499539,205162,true,1231325927,28,1232311333,985406
1670500151,205162,true,1231325927,28,1232311333,985406
1670500163,205163,true,1231202807,28,1232434564,1231757
1670500223,205162,true,1231325927,28,1232681063,1355136
1670500499,205161,true,1231449060,28,1234037690,2588630
1670500619,205159,true,1231695362,28,1234654833,2959471
1670501123,205160,true,1231572204,28,1237126489,5554285
1670501135,205159,true,1231695362,28,1237250202,5554840
1670501963,205158,true,1231818531,28,1241339667,9521136
1670502167,205157,true,1231941713,28,1241463801,9522088
1670502251,205157,true,1231941713,28,1241463801,9522088
1670502527,205157,true,1231941713,28,1241463801,9522088
1670502587,205156,true,1232064907,28,1241463801,9398894
1670502647,205154,true,1232311333,28,1241463801,9152468
1670502815,205154,true,1232311333,28,1241463801,9152468
1670503259,205154,true,1232311333,28,1241463801,9152468
1670503355,205153,true,1232434564,28,1241463801,9029237
1670503499,205151,true,1232681063,28,1241463801,8782738
1670504723,205151,true,1232681063,28,1241463801,8782738
1670504759,205150,true,1232804331,28,1241463801,8659470
1670504831,205149,true,1232927611,28,1241463801,8536190
1670505203,205148,true,1233050904,28,1241215546,8164642
1670505347,205148,true,1233050904,28,1241215546,8164642
1670505887,205147,true,1233174209,28,1240843255,7669046
1670505971,205146,true,1233297527,28,1240719184,7421657
1670506871,205144,true,1233544199,28,1240347042,6802843
1670507051,205144,true,1233544199,28,1240223020,6678821
1670507183,205143,true,1233667553,28,1240223020,6555467
1670507327,205142,true,1233790920,28,1240223020,6432100
1670507615,205140,true,1234037690,28,1240223020,6185330
1670507627,205140,true,1234037690,28,1240347042,6309352
1670507819,205139,true,1234161094,28,1240347042,6185948
1670507987,205138,true,1234284510,28,1240471077,6186567
1670508047,205136,true,1234531379,28,1240471077,5939698
1670508083,205136,true,1234531379,28,1240471077,5939698
1670508167,205136,true,1234531379,28,1240471077,5939698
1670508215,205134,true,1234778298,28,1240595124,5816826
1670508323,205132,true,1235025266,28,1240843255,5817989
1670508431,205132,true,1235025266,28,1240967340,5942074
1670508539,205132,true,1235025266,28,1241215546,6190280
1670508563,205131,true,1235148769,28,1241215546,6066777
1670508815,205129,true,1235395811,28,1241712106,6316295
1670509343,205129,true,1235395811,28,1242830094,7434283
1670509391,205129,true,1235395811,28,1242830094,7434283
1670509667,205128,true,1235519350,28,1243327301,7807951
1670510687,205126,true,1235766466,28,1243700336,7933870
1670511419,205126,true,1235766466,28,1243700336,7933870
1670511563,205126,true,1235766466,28,1243700336,7933870
1670511623,205125,true,1235890043,28,1243824706,7934663
1670511779,205124,true,1236013632,28,1243949089,7935457
1670511947,205123,true,1236137233,28,1244197891,8060658
1670511983,205123,true,1236137233,28,1244197891,8060658
1670511995,205122,true,1236260847,28,1244197891,7937044
1670512007,205120,true,1236508112,28,1244197891,7689779
1670512067,205120,true,1236508112,28,1244322311,7814199
1670512103,205119,true,1236631763,28,1244446743,7814980
1670512115,205118,true,1236755426,28,1244446743,7691317
1670512139,205116,true,1237002789,28,1244446743,7443954
1670512499,205115,true,1237126489,28,1245567193,8440704
1670512547,205114,true,1237250202,28,1245691750,8441548
1670513183,205113,true,1237373927,28,1247436853,10062926
1670513195,205111,true,1237621414,28,1247561596,9940182
1670513279,205110,true,1237745176,28,1248060696,10315520
1670513291,205109,true,1237868951,28,1248060696,10191745
1670513351,205106,true,1238240349,28,1248435151,10194802
1670513363,205104,true,1238488009,28,1248435151,9947142
1670513375,205103,true,1238611858,28,1248559995,9948137
1670513399,205102,true,1238735719,28,1248684851,9949132
1670513435,205100,true,1238983479,28,1248809719,9826240
1670513447,205097,true,1239355211,28,1248934600,9579389
1670513519,205096,true,1239479146,28,1249184400,9705254
1670513579,205095,true,1239603094,28,1249434249,9831155
1670513615,205093,true,1239851027,28,1249559193,9708166
1670513723,205091,true,1240099010,28,1249934098,9835088
1670513867,205090,true,1240223020,28,1250309116,10086096
1670513987,205089,true,1240347042,28,1250559190,10212148
1670514071,205086,true,1240719184,28,1250809314,10090130
1670514395,205084,true,1240967340,28,1251309713,10342373
1670514539,205083,true,1241091436,28,1251559987,10468551
1670514695,205082,true,1241215546,28,1251935493,10719947
1670514803,205080,true,1241463801,28,1252060687,10596886
1670514911,205078,true,1241712106,28,1252311111,10599005
1670515079,205077,true,1241836278,28,1252311111,10474833
1670515115,205076,true,1241960461,28,1252311111,10350650
1670516087,205074,true,1242208866,28,1252060687,9851821
1670516495,205072,true,1242457320,28,1252060687,9603367
1670517119,205071,true,1242581566,28,1252060687,9479121
1670517911,205071,true,1242581566,28,1252060687,9479121
1670518691,205069,true,1242830094,28,1252060687,9230593
1670519051,205067,true,1243078673,28,1252060687,8982014
1670519363,205066,true,1243202981,28,1252060687,8857706
1670520491,205065,true,1243327301,28,1252060687,8733386
1670520587,205063,true,1243575979,28,1252060687,8484708
1670520611,205061,true,1243824706,28,1252060687,8235981
1670521055,205060,true,1243949089,28,1252060687,8111598
1670522015,205059,true,1244073484,28,1252060687,7987203
1670523203,205057,true,1244322311,28,1252436342,8114031
1670523863,205055,true,1244571188,28,1252561586,7990398
1670524163,205054,true,1244695645,28,1252561586,7865941
1670524271,205054,true,1244695645,28,1252686842,7991197
1670524427,205051,true,1245069091,28,1252812111,7743020
1670524499,205049,true,1245318117,28,1252937392,7619275
1670524511,205048,true,1245442649,28,1252937392,7494743
1670524523,205047,true,1245567193,28,1252937392,7370199
1670524535,205044,true,1245940901,28,1253062686,7121785
1670524547,205042,true,1246190102,28,1253062686,6872584
1670524571,205040,true,1246439352,28,1253187992,6748640
1670524583,205039,true,1246563996,28,1253313311,6749315
1670524595,205036,true,1246938003,28,1253438642,6500639
1670524607,205032,true,1247436853,28,1253438642,6001789
1670524643,205030,true,1247686352,28,1253814711,6128359
1670525135,205028,true,1247935902,28,1258462186,10526284
1670525147,205025,true,1248310320,28,1258588032,10277712
1670525183,205022,true,1248684851,28,1258839762,10154911
1670525435,205019,true,1249059494,28,1261864455,12804961
1670525471,205016,true,1249434249,28,1262495513,13061264
1670525555,205014,true,1249684149,28,1263758577,14074428
1670525939,205010,true,1250184097,28,1271490677,21306580
1670526071,205006,true,1250684246,28,1273908684,23224438
1670526083,205003,true,1251059489,28,1274163479,23103990
1670526287,205000,true,1251434844,28,1277863731,26428887
1670526431,204997,true,1251810312,28,1279909847,28099535
1670526443,204993,true,1252311111,28,1280037838,27726727
1670526491,204990,true,1252686842,28,1280421888,27735046
1670526515,204988,true,1252937392,28,1280677985,27740593
1670526731,204985,true,1253313311,28,1282343865,29030554
1670526767,204981,true,1253814711,28,1282728607,28913896
1670527115,204978,true,1254190893,28,1285039482,30848589
1670527211,204976,true,1254441744,28,1285553575,31111831
1670527463,204973,true,1254818114,28,1285553575,30735461
1670528291,204969,true,1255320117,28,1283498437,28178320
1670528927,204967,true,1255571193,28,1283113464,27542271
1670528939,204964,true,1255947902,28,1283241775,27293873
1670528963,204961,true,1256324724,28,1283241775,26917051
1670528975,204957,true,1256827330,28,1283370100,26542770
1670529023,204953,true,1257330136,28,1283498437,26168301
1670529035,204950,true,1257707373,28,1283498437,25791064
1670529047,204947,true,1258084723,28,1283498437,25413714
1670529863,204944,true,1258462186,28,1283498437,25036251
1670530187,204941,true,1258839762,28,1283498437,24658675
1670530223,204938,true,1259217452,28,1283498437,24280985
1670531159,204935,true,1259595255,28,1283113464,23518209
1670531459,204932,true,1259973171,28,1283113464,23140293
1670531519,204929,true,1260351201,28,1283113464,22762263
1670531591,204926,true,1260729344,28,1283113464,22384120
1670531843,204923,true,1261107601,28,1283113464,22005863
1670531939,204920,true,1261485971,28,1283113464,21627493
1670532575,204917,true,1261864455,28,1282728607,20864152
1670532611,204914,true,1262243052,28,1282728607,20485555
1670532635,204912,true,1262495513,28,1282728607,20233094
1670532683,204909,true,1262874300,28,1282728607,19854307
1670532707,204906,true,1263253200,28,1282600347,19347147
1670532755,204904,true,1263505863,28,1282600347,19094484
1670532803,204902,true,1263758577,28,1282472100,18713523
1670532839,204899,true,1264137742,28,1282472100,18334358
1670532851,204896,true,1264517022,28,1282472100,17955078
1670533379,204894,true,1264769938,28,1280934133,16164195
1670533403,204892,true,1265022904,28,1280806053,15783149
1670534627,204889,true,1265402449,28,1278119316,12716867
1670535767,204886,true,1265782108,28,1277991517,12209409
1670536439,204884,true,1266035277,28,1277991517,11956240
1670537123,204882,true,1266288497,28,1277991517,11703020
1670537279,204880,true,1266541767,28,1277991517,11449750
1670537471,204877,true,1266921768,28,1277991517,11069749
1670537555,204875,true,1267175165,28,1277991517,10816352
1670538059,204873,true,1267428612,28,1278247128,10818516
1670538155,204871,true,1267682111,28,1278247128,10565017
1670538179,204868,true,1268062453,28,1278247128,10184675
1670539127,204866,true,1268316079,28,1278758504,10442425
1670539139,204864,true,1268569754,28,1278758504,10188750
1670539439,204862,true,1268823481,28,1279014268,10190787
1670539571,204859,true,1269204166,28,1279270084,10065918
1670539655,204857,true,1269458020,28,1279398011,9939991
1670539883,204855,true,1269711924,28,1279653903,9941979
1670540519,204853,true,1269965879,28,1280549930,10584051
1670541143,204850,true,1270346907,28,1281318452,10971545
1670541179,204850,true,1270346907,28,1281446584,11099677
1670541359,204847,true,1270728049,28,1281574728,10846679
1670543315,204845,true,1270982207,28,1282600347,11618140
1670543843,204842,true,1271363540,28,1282600347,11236807
1670543999,204842,true,1271363540,28,1282600347,11236807
1670545019,204839,true,1271744987,28,1282600347,10855360
1670545031,204837,true,1271999349,28,1282600347,10600998
1670545043,204834,true,1272380987,28,1282600347,10219360
1670545055,204833,true,1272508225,28,1282600347,10092122
1670545451,204831,true,1272762740,28,1282343865,9581125
1670545475,204829,true,1273017305,28,1282215644,9198339
1670545499,204826,true,1273399248,28,1282215644,8816396
1670545523,204825,true,1273526588,28,1282215644,8689056
1670545679,204823,true,1273781306,28,1281959239,8177933
1670545739,204821,true,1274036075,28,1281831056,7794981
1670545763,204818,true,1274418324,28,1281831056,7412732
1670545775,204817,true,1274545766,28,1281702886,7157120
1670545787,204816,true,1274673221,28,1281702886,7029665
1670545799,204814,true,1274928168,28,1281702886,6774718
1670545979,204811,true,1275310685,28,1281062227,5751542
1670546615,204810,true,1275438216,28,1279014268,3576052
1670548943,204809,true,1275565760,28,1276586570,1020810
1670548955,204807,true,1275820886,28,1276714228,893342
1670548967,204804,true,1276203670,28,1276714228,510558
1670549339,204803,true,1276331291,28,1277097281,765990
1670549351,204801,true,1276586570,28,1277097281,510711
1670549363,204799,true,1276841900,28,1277097281,255381
1670549375,204797,true,1277097281,28,1277097281,0
1670549411,204795,true,1277352713,28,1277224990,-127723
1670549495,204792,true,1277735957,28,1277608196,-127761
1670549795,204790,true,1277991517,28,1279142170,1150653
1670549951,204787,true,1278374953,28,1279909847,1534894
1670550311,204786,true,1278502790,28,1281702886,3200096
1670550611,204783,true,1278886380,28,1283113464,4227084
1670550695,204780,true,1279270084,28,1283498437,4228353
1670550779,204778,true,1279525951,28,1283883525,4357574
1670551571,204777,true,1279653903,28,1285039482,5385579
1670553899,204774,true,1280037838,28,1284654047,4616209
1670554055,204772,true,1280293858,28,1284654047,4360189
1670554127,204770,true,1280549930,28,1284654047,4104117
1670554151,204769,true,1280677985,28,1284654047,3976062
1670554163,204767,true,1280934133,28,1284654047,3719914
1670554463,204765,true,1281190333,28,1284525595,3335262
1670558039,204764,true,1281318452,28,1283241775,1923323
1670559155,204763,true,1281446584,28,1283241775,1795191
1670559515,204761,true,1281702886,28,1283241775,1538889
1670561147,204761,true,1281702886,28,1283241775,1538889
1670563403,204760,true,1281831056,28,1283241775,1410719
1670564279,204759,true,1281959239,28,1283241775,1282536
1670566091,204758,true,1282087435,28,1283241775,1154340
1670566583,204758,true,1282087435,28,1283241775,1154340
1670566739,204757,true,1282215644,28,1283113464,897820
1670566883,204757,true,1282215644,28,1283113464,897820
1670567363,204758,true,1282087435,28,1282985166,897731
1670568083,204759,true,1281959239,28,1282600347,641108
1670569127,204759,true,1281959239,28,1281831056,-128183
1670572127,204759,true,1281959239,28,1281702886,-256353
1670572895,204759,true,1281959239,28,1281831056,-128183
1670572955,204760,true,1281831056,28,1281831056,0
1670573435,204760,true,1281831056,28,1282472100,641044
1670574635,204760,true,1281831056,28,1283498437,1667381
1670574719,204759,true,1281959239,28,1283626787,1667548
1670574779,204761,true,1281702886,28,1283498437,1795551
1670575679,204760,true,1281831056,28,1283241775,1410719
1670578055,204760,true,1281831056,28,1282856880,1025824
1670578799,204759,true,1281959239,28,1282856880,897641
1670579483,204761,true,1281702886,28,1282856880,1153994
1670579903,204760,true,1281831056,28,1282856880,1025824
1670580287,204760,true,1281831056,28,1283113464,1282408
1670580311,204760,true,1281831056,28,1283113464,1282408
1670580455,204761,true,1281702886,28,1283113464,1410578
1670580467,204762,true,1281574728,28,1283241775,1667047
1670580599,204761,true,1281702886,28,1283370100,1667214
1670581187,204760,true,1281831056,28,1284782513,2951457
1670581259,204760,true,1281831056,28,1284910991,3079935
1670581271,204761,true,1281702886,28,1284910991,3208105
1670581367,204760,true,1281831056,28,1285039482,3208426
1670582831,204759,true,1281959239,28,1286067874,4108635
1670584223,204759,true,1281959239,28,1285810699,3851460
1670584583,204760,true,1281831056,28,1285810699,3979643
1670586263,204759,true,1281959239,28,1285810699,3851460
1670586695,204759,true,1281959239,28,1285810699,3851460
1670586983,204758,true,1282087435,28,1285939280,3851845
1670586995,204759,true,1281959239,28,1285939280,3980041
1670587487,204758,true,1282087435,28,1286453733,4366298
1670587571,204757,true,1282215644,28,1286453733,4238089
1670588555,204757,true,1282215644,28,1287483256,5267612
1670589647,204757,true,1282215644,28,1287612004,5396360
1670589683,204756,true,1282343865,28,1287740765,5396900
1670589695,204755,true,1282472100,28,1287740765,5268665
1670589731,204755,true,1282472100,28,1287740765,5268665
1670589767,204755,true,1282472100,28,1287869539,5397439
1670589779,204753,true,1282728607,28,1287869539,5140932
1670589803,204752,true,1282856880,28,1287869539,5012659
1670589827,204751,true,1282985166,28,1287869539,4884373
1670589875,204752,true,1282856880,28,1287869539,5012659
1670589947,204750,true,1283113464,28,1287869539,4756075
1670589959,204749,true,1283241775,28,1287869539,4627764
1670589971,204749,true,1283241775,28,1287869539,4627764
1670591675,204750,true,1283113464,28,1284525595,1412131
1670591759,204748,true,1283370100,28,1284525595,1155495
1670592611,204747,true,1283498437,28,1284397155,898718
1670592623,204747,true,1283498437,28,1284397155,898718
1670592659,204748,true,1283370100,28,1284268728,898628
1670592755,204747,true,1283498437,28,1283370100,-128337
1670592887,204750,true,1283113464,28,1282343865,-769599
1670592935,204750,true,1283113464,28,1281959239,-1154225
1670593283,204751,true,1282985166,28,1279142170,-3842996
1670593343,204750,true,1283113464,28,1278758504,-4354960
1670593499,204753,true,1282728607,28,1277608196,-5120411
1670593979,204753,true,1282728607,28,1274036075,-8692532
1670593991,204754,true,1282600347,28,1273908684,-8691663
1670594015,204753,true,1282728607,28,1273781306,-8947301
1670594027,204756,true,1282343865,28,1273653941,-8689924
1670595719,204755,true,1282472100,28,1273399248,-9072852
1670595767,204756,true,1282343865,28,1273399248,-8944617
1670595779,204756,true,1282343865,28,1273399248,-8944617
1670595839,204758,true,1282087435,28,1273399248,-8688187
1670595947,204758,true,1282087435,28,1273399248,-8688187
1670595971,204759,true,1281959239,28,1273271921,-8687318
1670596331,204759,true,1281959239,28,1272890016,-9069223
1670596475,204761,true,1281702886,28,1272635476,-9067410
1670596679,204761,true,1281702886,28,1272126549,-9576337
1670596943,204762,true,1281574728,28,1271617826,-9956902
1670596955,204762,true,1281574728,28,1271617826,-9956902
1670597099,204764,true,1281318452,28,1271363540,-9954912
1670597135,204764,true,1281318452,28,1271363540,-9954912
1670598251,204765,true,1281190333,28,1270728049,-10462284
1670598923,204764,true,1281318452,28,1271617826,-9700626
1670599883,204766,true,1281062227,28,1272126549,-8935678
1670599895,204766,true,1281062227,28,1272126549,-8935678
1670600591,204766,true,1281062227,28,1272635476,-8426751
1670601359,204765,true,1281190333,28,1273271921,-7918412
1670601863,204767,true,1280934133,28,1273526588,-7407545
1670601911,204767,true,1280934133,28,1273526588,-7407545
1670608103,204767,true,1280934133,28,1274290895,-6643238
1670608991,204766,true,1281062227,28,1274290895,-6771332
1670609183,204768,true,1280806053,28,1274290895,-6515158
1670609195,204768,true,1280806053,28,1274290895,-6515158
1670609423,204768,true,1280806053,28,1274036075,-6769978
1670609555,204768,true,1280806053,28,1273908684,-6897369
1670609567,204771,true,1280421888,28,1273908684,-6513204
1670610563,204772,true,1280293858,28,1271872162,-8421696
1670611331,204772,true,1280293858,28,1270728049,-9565809
1670612591,204772,true,1280293858,28,1270473942,-9819916
1670612603,204775,true,1279909847,28,1270473942,-9435905
1670618051,204776,true,1279781869,28,1267935660,-11846209
1670618363,204777,true,1279653903,28,1267935660,-11718243
1670618711,204777,true,1279653903,28,1267935660,-11718243
1670618735,204780,true,1279270084,28,1267935660,-11334424
1670618759,204781,true,1279142170,28,1267935660,-11206510
1670619887,204782,true,1279014268,28,1266415126,-12599142
1670619983,204782,true,1279014268,28,1266288497,-12725771
1670619995,204785,true,1278630641,28,1266288497,-12342144
1670620979,204787,true,1278374953,28,1264264156,-14110797
1670621243,204788,true,1278247128,28,1263884953,-14362175
1670621291,204788,true,1278247128,28,1263758577,-14488551
1670621375,204791,true,1277863731,28,1263632214,-14231517
1670621399,204792,true,1277735957,28,1263505863,-14230094
1670621411,204793,true,1277608196,28,1263505863,-14102333
1670621711,204794,true,1277480448,28,1262748025,-14732423
1670622947,204797,true,1277097281,28,1260981503,-16115778
1670624375,204799,true,1276841900,28,1260477236,-16364664
1670624459,204800,true,1276714228,28,1260477236,-16236992
1670626187,204800,true,1276714228,28,1260477236,-16236992
1670626811,204804,true,1276203670,28,1260477236,-15726434
1670626955,204805,true,1276076063,28,1260603284,-15472779
1670628143,204806,true,1275948468,28,1261359835,-14588633
1670628815,204806,true,1275948468,28,1261612120,-14336348
1670628947,204809,true,1275565760,28,1261612120,-13953640
1670630507,204810,true,1275438216,28,1261612120,-13826096
1670631851,204811,true,1275310685,28,1261612120,-13698565
1670631899,204812,true,1275183166,28,1261738281,-13444885
1670631923,204815,true,1274800688,28,1261738281,-13062407
1670635031,204816,true,1274673221,28,1263253200,-11420021
1670635439,204817,true,1274545766,28,1263379525,-11166241
1670635835,204818,true,1274418324,28,1263505863,-10912461
1670635859,204821,true,1274036075,28,1263505863,-10530212
1670637467,204821,true,1274036075,28,1264769938,-9266137
1670638643,204822,true,1273908684,28,1264769938,-9138746
1670638847,204823,true,1273781306,28,1264769938,-9011368
1670641907,204826,true,1273399248,28,1264769938,-8629310
1670642819,204827,true,1273271921,28,1264769938,-8501983
1670642927,204827,true,1273271921,28,1264769938,-8501983
1670644067,204828,true,1273144607,28,1264769938,-8374669
1670645219,204832,true,1272635476,28,1264769938,-7865538
1670646419,204833,true,1272508225,28,1264769938,-7738287
1670647223,204834,true,1272380987,28,1264769938,-7611049
1670648099,204835,true,1272253762,28,1264769938,-7483824
1670648303,204838,true,1271872162,28,1264643473,-7228689
1670648387,204839,true,1271744987,28,1264643473,-7101514
1670648699,204839,true,1271744987,28,1264643473,-7101514
1670649023,204841,true,1271490677,28,1264643473,-6847204
1670649131,204844,true,1271109306,28,1264643473,-6465833
1670649659,204845,true,1270982207,28,1264643473,-6338734
1670650451,204845,true,1270982207,28,1264643473,-6338734
1670650763,204847,true,1270728049,28,1264643473,-6084576
1670650931,204850,true,1270346907,28,1264643473,-5703434
1670653031,204851,true,1270219885,28,1264643473,-5576412
1670656019,204852,true,1270092876,28,1264643473,-5449403
1670656871,204853,true,1269965879,28,1264643473,-5322406
1670658059,204857,true,1269458020,28,1264643473,-4814547
1670658299,204858,true,1269331087,28,1264643473,-4687614
1670658419,204859,true,1269204166,28,1264769938,-4434228
1670659667,204861,true,1268950363,28,1264769938,-4180425
1670661923,204864,true,1268569754,28,1264769938,-3799816
1670664227,204865,true,1268442910,28,1264769938,-3672972
1670664419,204866,true,1268316079,28,1264769938,-3546141
1670665187,204867,true,1268189260,28,1264517022,-3672238
1670666951,204870,true,1267808879,28,1264011341,-3797538
1670667179,204871,true,1267682111,28,1264011341,-3670770
1670668127,204871,true,1267682111,28,1264011341,-3670770
1670668607,204873,true,1267428612,28,1264011341,-3417271
1670672243,204876,true,1267048460,28,1264011341,-3037119
1670672843,204877,true,1266921768,28,1264011341,-2910427
1670672903,204877,true,1266921768,28,1264011341,-2910427
1670672939,204878,true,1266795088,28,1264011341,-2783747
1670673527,204878,true,1266795088,28,1264011341,-2783747
1670673575,204878,true,1266795088,28,1264011341,-2783747
1670676143,204879,true,1266668421,28,1264011341,-2657080
1670676311,204880,true,1266541767,28,1264011341,-2530426
1670677247,204880,true,1266541767,28,1264011341,-2530426
1670677319,204880,true,1266541767,28,1264011341,-2530426
1670677331,204881,true,1266415126,28,1264011341,-2403785
1670677463,204882,true,1266288497,28,1264011341,-2277156
1670677895,204882,true,1266288497,28,1264011341,-2277156
1670678075,204883,true,1266161881,28,1264011341,-2150540
1670678087,204883,true,1266161881,28,1264137742,-2024139
1670678123,204884,true,1266035277,28,1264137742,-1897535
1670678651,204884,true,1266035277,28,1265022904,-1012373
1670678963,204884,true,1266035277,28,1265655542,-379735
1670679251,204885,true,1265908686,28,1266161881,253195
1670679815,204885,true,1265908686,28,1267175165,1266479
1670681099,204885,true,1265908686,28,1267301882,1393196
1670682143,204885,true,1265908686,28,1267301882,1393196
1670682803,204886,true,1265782108,28,1267301882,1519774
1670682827,204886,true,1265782108,28,1267301882,1519774
1670683175,204886,true,1265782108,28,1267555355,1773247
1670683211,204886,true,1265782108,28,1267555355,1773247
1670683343,204886,true,1265782108,28,1267682111,1900003
1670683415,204887,true,1265655542,28,1267808879,2153337
1670684783,204886,true,1265782108,28,1269965879,4183771
1670685251,204886,true,1265782108,28,1270346907,4564799
1670685467,204887,true,1265655542,28,1270346907,4691365
1670685503,204888,true,1265528989,28,1270473942,4944953
1670685551,204887,true,1265655542,28,1270473942,4818400
1670685587,204887,true,1265655542,28,1270473942,4818400
1670685803,204888,true,1265528989,28,1270728049,5199060
1670685827,204888,true,1265528989,28,1270728049,5199060
1670685983,204887,true,1265655542,28,1270855122,5199580
1670686523,204887,true,1265655542,28,1271999349,6343807
1670687207,204888,true,1265528989,28,1273526588,7997599
1670687855,204888,true,1265528989,28,1274290895,8761906
1670687939,204887,true,1265655542,28,1274290895,8635353
1670688083,204887,true,1265655542,28,1274418324,8762782
1670688095,204886,true,1265782108,28,1274418324,8636216
1670688107,204887,true,1265655542,28,1274418324,8762782
1670688131,204886,true,1265782108,28,1274418324,8636216
1670688191,204884,true,1266035277,28,1274545766,8510489
1670688347,204884,true,1266035277,28,1274928168,8892891
1670690603,204884,true,1266035277,28,1277991517,11956240
1670691635,204883,true,1266161881,28,1277991517,11829636
1670691839,204881,true,1266415126,28,1277991517,11576391
1670692631,204880,true,1266541767,28,1277863731,11321964
1670692691,204880,true,1266541767,28,1277863731,11321964
1670692991,204879,true,1266668421,28,1277863731,11195310
1670693171,204878,true,1266795088,28,1277735957,10940869
1670693183,204876,true,1267048460,28,1277735957,10687497
1670693243,204876,true,1267048460,28,1277735957,10687497
1670693255,204875,true,1267175165,28,1277735957,10560792
1670693291,204874,true,1267301882,28,1277735957,10434075
1670693675,204872,true,1267555355,28,1277480448,9925093
1670694215,204872,true,1267555355,28,1277224990,9669635
1670694227,204871,true,1267682111,28,1277224990,9542879
1670694767,204869,true,1267935660,28,1276841900,8906240
1670694815,204868,true,1268062453,28,1276714228,8651775
1670694827,204868,true,1268062453,28,1276714228,8651775
1670694839,204866,true,1268316079,28,1276714228,8398149
1670694863,204865,true,1268442910,28,1276714228,8271318
1670694875,204864,true,1268569754,28,1276714228,8144474
1670694899,204864,true,1268569754,28,1276714228,8144474
1670694935,204863,true,1268696611,28,1276586570,7889959
1670694971,204862,true,1268823481,28,1276458924,7635443
1670694995,204861,true,1268950363,28,1276458924,7508561
1670695055,204861,true,1268950363,28,1276203670,7253307
1670695079,204860,true,1269077258,28,1276076063,6998805
1670696735,204859,true,1269204166,28,1270855122,1650956
1670697755,204859,true,1269204166,28,1270728049,1523883
1670698703,204859,true,1269204166,28,1270728049,1523883
1670700407,204858,true,1269331087,28,1270728049,1396962
1670701991,204858,true,1269331087,28,1270728049,1396962
1670703719,204857,true,1269458020,28,1270728049,1270029
1670705231,204857,true,1269458020,28,1270728049,1270029
1670709647,204856,true,1269584966,28,1270728049,1143083
1670711795,204856,true,1269584966,28,1270728049,1143083
1670711867,204855,true,1269711924,28,1270728049,1016125
1670714627,204855,true,1269711924,28,1270728049,1016125
1670715407,204855,true,1269711924,28,1270728049,1016125
1670715851,204854,true,1269838895,28,1270728049,889154
1670715863,204853,true,1269965879,28,1270728049,762170
1670715983,204854,true,1269838895,28,1270473942,635047
1670715995,204853,true,1269965879,28,1270473942,508063
1670716079,204853,true,1269965879,28,1270346907,381028
1670716163,204853,true,1269965879,28,1270219885,254006
1670716223,204853,true,1269965879,28,1270092876,126997
1670716487,204852,true,1270092876,28,1269458020,-634856
1670716535,204853,true,1269965879,28,1269331087,-634792
1670719247,204852,true,1270092876,28,1266668421,-3424455
1670719355,204853,true,1269965879,28,1266668421,-3297458
1670722367,204852,true,1270092876,28,1266668421,-3424455
1670723279,204852,true,1270092876,28,1266668421,-3424455
1670723855,204852,true,1270092876,28,1266668421,-3424455
1670723903,204852,true,1270092876,28,1266795088,-3297788
1670724011,204851,true,1270219885,28,1266795088,-3424797
1670724347,204851,true,1270219885,28,1266921768,-3298117
1670724551,204851,true,1270219885,28,1267048460,-3171425
1670724995,204851,true,1270219885,28,1267301882,-2918003
1670725307,204850,true,1270346907,28,1267555355,-2791552
1670725427,204851,true,1270219885,28,1267555355,-2664530
1670726279,204850,true,1270346907,28,1267682111,-2664796
1670726327,204850,true,1270346907,28,1267682111,-2664796
1670726507,204849,true,1270473942,28,1267682111,-2791831
1670726723,204850,true,1270346907,28,1267808879,-2538028
1670726939,204849,true,1270473942,28,1267808879,-2665063
1670729267,204849,true,1270473942,28,1267935660,-2538282
1670729339,204848,true,1270600989,28,1267935660,-2665329
1670729387,204848,true,1270600989,28,1267935660,-2665329
1670729855,204848,true,1270600989,28,1267935660,-2665329
1670729915,204848,true,1270600989,28,1268062453,-2538536
1670730131,204847,true,1270728049,28,1268062453,-2665596
1670730155,204847,true,1270728049,28,1268062453,-2665596
1670730839,204846,true,1270855122,28,1268442910,-2412212
1670730995,204847,true,1270728049,28,1268569754,-2158295
1670731043,204846,true,1270855122,28,1268569754,-2285368
1670731607,204846,true,1270855122,28,1269204166,-1650956
1670731835,204845,true,1270982207,28,1269331087,-1651120
1670732483,204845,true,1270982207,28,1269838895,-1143312
1670735279,204844,true,1271109306,28,1270092876,-1016430
1670735579,204844,true,1271109306,28,1270092876,-1016430
1670735867,204843,true,1271236417,28,1270092876,-1143541
1670735915,204843,true,1271236417,28,1270219885,-1016532
1670735927,204843,true,1271236417,28,1270219885,-1016532
1670736863,204843,true,1271236417,28,1271363540,127123
1670736899,204842,true,1271363540,28,1271363540,0
1670736923,204842,true,1271363540,28,1271490677,127137
1670737127,204841,true,1271490677,28,1271744987,254310
1670737139,204841,true,1271490677,28,1271872162,381485
1670737571,204840,true,1271617826,28,1272762740,1144914
1670737727,204840,true,1271617826,28,1273017305,1399479
1670737775,204840,true,1271617826,28,1273144607,1526781
1670738375,204839,true,1271744987,28,1273653941,1908954
1670738915,204838,true,1271872162,28,1273908684,2036522
1670743043,204838,true,1271872162,28,1274163479,2291317
1670744891,204839,true,1271744987,28,1274163479,2418492
1670745683,204838,true,1271872162,28,1274163479,2291317
1670747207,204837,true,1271999349,28,1274163479,2164130
1670749139,204837,true,1271999349,28,1274163479,2164130
1670749655,204838,true,1271872162,28,1274290895,2418733
1670750735,204837,true,1271999349,28,1274290895,2291546
1670750879,204837,true,1271999349,28,1274290895,2291546
1670750987,204837,true,1271999349,28,1274290895,2291546
1670751539,204837,true,1271999349,28,1274290895,2291546
1670753111,204837,true,1271999349,28,1274290895,2291546
1670753267,204837,true,1271999349,28,1274290895,2291546
1670753291,204837,true,1271999349,28,1274290895,2291546
1670754563,204837,true,1271999349,28,1274290895,2291546
1670755355,204837,true,1271999349,28,1274290895,2291546
1670755535,204837,true,1271999349,28,1274290895,2291546
1670756327,204837,true,1271999349,28,1274290895,2291546
1670758787,204837,true,1271999349,28,1274290895,2291546
1670758835,204838,true,1271872162,28,1274290895,2418733
1670758931,204838,true,1271872162,28,1274290895,2418733
1670760923,204838,true,1271872162,28,1274290895,2418733
1670761295,204838,true,1271872162,28,1274290895,2418733
1670762579,204839,true,1271744987,28,1274290895,2545908
1670763131,204839,true,1271744987,28,1274163479,2418492
1670764691,204839,true,1271744987,28,1274163479,2418492
1670766071,204839,true,1271744987,28,1274163479,2418492
1670767607,204840,true,1271617826,28,1274290895,2673069
1670768531,204840,true,1271617826,28,1274036075,2418249
1670769767,204840,true,1271617826,28,1273653941,2036115
1670770079,204840,true,1271617826,28,1273653941,2036115
1670770655,204841,true,1271490677,28,1273653941,2163264
1670771183,204841,true,1271490677,28,1273653941,2163264
1670771207,204841,true,1271490677,28,1273653941,2163264
1670772947,204841,true,1271490677,28,1273653941,2163264
1670773187,204842,true,1271363540,28,1273653941,2290401
1670773199,204841,true,1271490677,28,1273653941,2163264
1670773355,204842,true,1271363540,28,1273653941,2290401
1670773403,204842,true,1271363540,28,1273653941,2290401
1670773691,204842,true,1271363540,28,1273653941,2290401
1670774063,204842,true,1271363540,28,1273653941,2290401
1670774231,204842,true,1271363540,28,1273653941,2290401
1670774483,204842,true,1271363540,28,1273653941,2290401
1670777999,204842,true,1271363540,28,1273526588,2163048
1670778683,204842,true,1271363540,28,1273526588,2163048
1670778875,204842,true,1271363540,28,1273526588,2163048
1670778971,204842,true,1271363540,28,1273526588,2163048
1670779643,204842,true,1271363540,28,1273526588,2163048
1670779715,204841,true,1271490677,28,1273526588,2035911
1670779751,204841,true,1271490677,28,1273526588,2035911
1670779979,204841,true,1271490677,28,1273526588,2035911
1670781383,204841,true,1271490677,28,1273653941,2163264
1670784371,204840,true,1271617826,28,1273653941,2036115
1670784419,204840,true,1271617826,28,1273653941,2036115
1670784983,204840,true,1271617826,28,1273653941,2036115
1670785151,204840,true,1271617826,28,1273908684,2290858
1670785223,204839,true,1271744987,28,1274036075,2291088
1670785283,204839,true,1271744987,28,1274163479,2418492
1670785295,204838,true,1271872162,28,1274163479,2291317
1670785307,204838,true,1271872162,28,1274163479,2291317
1670785391,204837,true,1271999349,28,1274418324,2418975
1670787263,204836,true,1272126549,28,1280165842,8039293
1670787275,204836,true,1272126549,28,1280165842,8039293
1670787299,204835,true,1272253762,28,1280165842,7912080
1670787347,204833,true,1272508225,28,1280165842,7657617
1670787455,204833,true,1272508225,28,1279909847,7401622
1670787467,204833,true,1272508225,28,1279909847,7401622
1670789471,204832,true,1272635476,28,1275693316,3057840
1670789591,204831,true,1272762740,28,1275693316,2930576
1670789615,204831,true,1272762740,28,1275693316,2930576
1670789759,204830,true,1272890016,28,1275565760,2675744
1670789783,204830,true,1272890016,28,1275565760,2675744
1670789807,204829,true,1273017305,28,1275565760,2548455
1670789819,204829,true,1273017305,28,1275438216,2420911
1670789927,204829,true,1273017305,28,1275055661,2038356
1670790035,204829,true,1273017305,28,1274673221,1655916
1670790047,204828,true,1273144607,28,1274673221,1528614
1670791079,204829,true,1273017305,28,1269965879,-3051426
1670792315,204829,true,1273017305,28,1267428612,-5588693
1670792411,204829,true,1273017305,28,1267428612,-5588693
1670792579,204829,true,1273017305,28,1267428612,-5588693
1670792639,204829,true,1273017305,28,1267428612,-5588693
1670792807,204829,true,1273017305,28,1267428612,-5588693
1670794319,204829,true,1273017305,28,1267428612,-5588693
1670794415,204829,true,1273017305,28,1267428612,-5588693
1670794607,204829,true,1273017305,28,1267428612,-5588693
1670794727,204830,true,1272890016,28,1267428612,-5461404
1670795519,204829,true,1273017305,28,1267428612,-5588693
1670796035,204829,true,1273017305,28,1267428612,-5588693
1670796071,204829,true,1273017305,28,1267428612,-5588693
1670796239,204830,true,1272890016,28,1267428612,-5461404
1670797259,204830,true,1272890016,28,1267428612,-5461404
1670797775,204829,true,1273017305,28,1267428612,-5588693
1670798291,204830,true,1272890016,28,1267301882,-5588134
1670798303,204830,true,1272890016,28,1267301882,-5588134
1670798507,204831,true,1272762740,28,1266541767,-6220973
1670799671,204831,true,1272762740,28,1262116840,-10645900
1670799683,204832,true,1272635476,28,1262116840,-10518636
1670799695,204833,true,1272508225,28,1261990641,-10517584
1670799743,204833,true,1272508225,28,1261864455,-10643770
1670799755,204834,true,1272380987,28,1261864455,-10516532
1670800115,204834,true,1272380987,28,1261107601,-11273386
1670800691,204835,true,1272253762,28,1261990641,-10263121
1670800739,204836,true,1272126549,28,1262116840,-10009709
1670800943,204836,true,1272126549,28,1262495513,-9631036
1670801015,204837,true,1271999349,28,1262495513,-9503836
1670801147,204838,true,1271872162,28,1262748025,-9124137
1670801159,204838,true,1271872162,28,1262748025,-9124137
1670801291,204839,true,1271744987,28,1263000587,-8744400
1670801303,204840,true,1271617826,28,1263000587,-8617239
1670801351,204841,true,1271490677,28,1263126887,-8363790
1670801399,204841,true,1271490677,28,1263126887,-8363790
1670801771,204842,true,1271363540,28,1263253200,-8110340
1670801843,204843,true,1271236417,28,1263253200,-7983217
1670803307,204844,true,1271109306,28,1263253200,-7856106
1670804063,204845,true,1270982207,28,1262874300,-8107907
1670804075,204845,true,1270982207,28,1262874300,-8107907
1670804135,204846,true,1270855122,28,1262748025,-8107097
1670804387,204847,true,1270728049,28,1262243052,-8484997
1670804603,204849,true,1270473942,28,1261864455,-8609487
1670804615,204849,true,1270473942,28,1261864455,-8609487
1670804735,204850,true,1270346907,28,1261485971,-8860936
1670804975,204852,true,1270092876,28,1260729344,-9363532
1670805383,204853,true,1269965879,28,1259469308,-10496571
1670805419,204854,true,1269838895,28,1259343374,-10495521
1670805791,204855,true,1269711924,28,1258210531,-11501393
1670805803,204857,true,1269458020,28,1258210531,-11247489
1670805887,204858,true,1269331087,28,1257833144,-11497943
1670806883,204859,true,1269204166,28,1255696751,-13507415
1670806907,204861,true,1268950363,28,1255696751,-13253612
1670807351,204862,true,1268823481,28,1255194597,-13628884
1670807411,204864,true,1268569754,28,1255194597,-13375157
1670808383,204865,true,1268442910,28,1254943596,-13499314
1670808431,204866,true,1268316079,28,1254943596,-13372483
1670810219,204868,true,1268062453,28,1254943596,-13118857
1670810519,204869,true,1267935660,28,1254943596,-12992064
1670810855,204870,true,1267808879,28,1254943596,-12865283
1670811215,204872,true,1267555355,28,1254943596,-12611759
1670811275,204873,true,1267428612,28,1254943596,-12485016
1670811887,204875,true,1267175165,28,1254943596,-12231569
1670812307,204876,true,1267048460,28,1254943596,-12104864
1670812499,204877,true,1266921768,28,1254943596,-11978172
1670813483,204878,true,1266795088,28,1254943596,-11851492
1670813495,204880,true,1266541767,28,1254943596,-11598171
1670813615,204881,true,1266415126,28,1254567188,-11847938
1670813663,204882,true,1266288497,28,1254441744,-11846753
1670813699,204885,true,1265908686,28,1254190893,-11717793
1670813891,204888,true,1265528989,28,1253313311,-12215678
1670814035,204889,true,1265402449,28,1252436342,-12966107
1670814899,204890,true,1265275922,28,1247811121,-17464801
1670815475,204893,true,1264896415,28,1245318117,-19578298
1670815487,204896,true,1264517022,28,1245318117,-19198905
1670816279,204897,true,1264390583,28,1245193598,-19196985
1670816363,204899,true,1264137742,28,1245193598,-18944144
1670816987,204901,true,1263884953,28,1245193598,-18691355
1670818151,204904,true,1263505863,28,1245193598,-18312265
1670820023,204905,true,1263379525,28,1244944597,-18434928
1670820371,204907,true,1263126887,28,1244944597,-18182290
1670820515,204910,true,1262748025,28,1244944597,-17803428
1670822471,204912,true,1262495513,28,1244944597,-17550916
1670823779,204913,true,1262369276,28,1244944597,-17424679
1670824139,204915,true,1262116840,28,1244944597,-17172243
1670824331,204918,true,1261738281,28,1244944597,-16793684
1670825051,204920,true,1261485971,28,1244944597,-16541374
1670825375,204921,true,1261359835,28,1244944597,-16415238
1670825495,204923,true,1261107601,28,1244944597,-16163004
1670826815,204926,true,1260729344,28,1244944597,-15784747
1670826947,204928,true,1260477236,28,1244944597,-15532639
1670826959,204930,true,1260225179,28,1244944597,-15280582
1670828567,204931,true,1260099169,28,1244944597,-15154572
1670828735,204935,true,1259595255,28,1244944597,-14650658
1670829035,204937,true,1259343374,28,1244944597,-14398777
1670831495,204939,true,1259091543,28,1244944597,-14146946
1670833247,204941,true,1258839762,28,1244944597,-13895165
1670834183,204945,true,1258336352,28,1244944597,-13391755
1670834639,204947,true,1258084723,28,1244944597,-13140126
1670834699,204949,true,1257833144,28,1244944597,-12888547
1670834867,204950,true,1257707373,28,1244944597,-12762776
1670835515,204954,true,1257204416,28,1244944597,-12259819
1670835779,204956,true,1256953012,28,1244944597,-12008415
1670835791,204958,true,1256701660,28,1245069091,-11632569
1670835815,204959,true,1256576002,28,1245069091,-11506911
1670835839,204962,true,1256199105,28,1245069091,-11130014
1670836007,204964,true,1255947902,28,1245069091,-10878811
1670836163,204966,true,1255696751,28,1245318117,-10378634
1670836211,204967,true,1255571193,28,1245318117,-10253076
1670836331,204969,true,1255320117,28,1245442649,-9877468
1670836415,204970,true,1255194597,28,1245567193,-9627404
1670836859,204972,true,1254943596,28,1246190102,-8753494
1670837711,204972,true,1254943596,28,1247312121,-7631475
1670837855,204975,true,1254567188,28,1247436853,-7130335
1670837999,204976,true,1254441744,28,1247561596,-6880148
1670838023,204977,true,1254316313,28,1247561596,-6754717
1670838371,204978,true,1254190893,28,1248060696,-6130197
1670838551,204980,true,1253940093,28,1248310320,-5629773
1670840447,204981,true,1253814711,28,1249809117,-4005594
1670840519,204982,true,1253689342,28,1249934098,-3755244
1670840579,204983,true,1253563986,28,1249934098,-3629888
1670840963,204985,true,1253313311,28,1250059091,-3254220
1670840999,204986,true,1253187992,28,1250184097,-3003895
1670841755,204987,true,1253062686,28,1250934395,-2128291
1670841935,204987,true,1253062686,28,1251184595,-1878091
1670842451,204989,true,1252812111,28,1252185893,-626218
1670842763,204990,true,1252686842,28,1252561586,-125256
1670843027,204991,true,1252561586,28,1252812111,250525
1670843315,204991,true,1252561586,28,1253062686,501100
1670844251,204993,true,1252311111,28,1253313311,1002200
1670846315,204994,true,1252185893,28,1253313311,1127418
1670846507,204993,true,1252311111,28,1253313311,1002200
1670847815,204993,true,1252311111,28,1253313311,1002200
1670847863,204995,true,1252060687,28,1253313311,1252624
1670848187,204996,true,1251935493,28,1253187992,1252499
1670848247,204996,true,1251935493,28,1253187992,1252499
1670848259,204996,true,1251935493,28,1253187992,1252499
1670848271,204998,true,1251685143,28,1253187992,1502849
1670848403,204999,true,1251559987,28,1252937392,1377405
1670848463,204999,true,1251559987,28,1252812111,1252124
1670848475,205000,true,1251434844,28,1252812111,1377267
1670848655,205002,true,1251184595,28,1252436342,1251747
1670848691,205003,true,1251059489,28,1252311111,1251622
1670848703,205003,true,1251059489,28,1252311111,1251622
1670848715,205004,true,1250934395,28,1252311111,1376716
1670848739,205006,true,1250684246,28,1252185893,1501647
1670848763,205007,true,1250559190,28,1252185893,1626703
1670848799,205008,true,1250434147,28,1252060687,1626540
1670849207,205008,true,1250434147,28,1250684246,250099
1670849699,205010,true,1250184097,28,1249184400,-999697
1670849915,205012,true,1249934098,28,1248559995,-1374103
1670849987,205012,true,1249934098,28,1248435151,-1498947
1670850287,205013,true,1249809117,28,1247811121,-1997996
1670850563,205014,true,1249684149,28,1247686352,-1997797
1670851523,205015,true,1249559193,28,1247561596,-1997597
1670852087,205016,true,1249434249,28,1247561596,-1872653
1670852099,205016,true,1249434249,28,1247686352,-1747897
1670852231,205017,true,1249309318,28,1247686352,-1622966
1670853683,205018,true,1249184400,28,1248435151,-749249
1670854667,205018,true,1249184400,28,1248435151,-749249
1670854787,205018,true,1249184400,28,1248435151,-749249
1670854883,205020,true,1248934600,28,1248559995,-374605
1670855219,205020,true,1248934600,28,1248934600,0
1670857091,205020,true,1248934600,28,1250184097,1249497
1670857811,205020,true,1248934600,28,1250184097,1249497
1670858351,205021,true,1248809719,28,1250184097,1374378
1670858831,205021,true,1248809719,28,1250184097,1374378
1670859815,205021,true,1248809719,28,1250184097,1374378
1670860799,205021,true,1248809719,28,1250184097,1374378
1670861483,205023,true,1248559995,28,1250184097,1624102
1670862947,205023,true,1248559995,28,1250184097,1624102
1670863247,205022,true,1248684851,28,1250184097,1499246
1670863259,205022,true,1248684851,28,1250309116,1624265
1670867615,205024,true,1248435151,28,1250434147,1998996
1670867639,205024,true,1248435151,28,1250559190,2124039
1670869463,205024,true,1248435151,28,1251309713,2874562
1670870771,205024,true,1248435151,28,1251309713,2874562
1670871131,205025,true,1248310320,28,1251309713,2999393
1670871155,205025,true,1248310320,28,1251434844,3124524
1670871167,205024,true,1248435151,28,1251434844,2999693
1670871995,205024,true,1248435151,28,1251810312,3375161
1670875631,205024,true,1248435151,28,1252185893,3750742
1670876423,205023,true,1248559995,28,1252436342,3876347
1670876483,205023,true,1248559995,28,1252436342,3876347
1670877575,205022,true,1248684851,28,1252686842,4001991
1670877779,205022,true,1248684851,28,1252686842,4001991
1670878379,205021,true,1248809719,28,1252686842,3877123
1670878463,205020,true,1248934600,28,1252686842,3752242
1670878523,205020,true,1248934600,28,1252812111,3877511
1670878655,205019,true,1249059494,28,1252937392,3877898
1670878667,205019,true,1249059494,28,1253062686,4003192
1670878703,205017,true,1249309318,28,1253187992,3878674
1670878715,205017,true,1249309318,28,1253187992,3878674
1670878799,205015,true,1249559193,28,1253689342,4130149
1670878811,205014,true,1249684149,28,1253689342,4005193
1670878859,205012,true,1249934098,28,1254065487,4131389
1670878907,205011,true,1250059091,28,1254316313,4257222
1670878919,205009,true,1250309116,28,1254441744,4132628
1670878967,205008,true,1250434147,28,1254692645,4258498
1670878979,205007,true,1250559190,28,1254818114,4258924
1670879051,205006,true,1250684246,28,1255320117,4635871
1670879183,205003,true,1251059489,28,1256450357,5390868
1670879195,205002,true,1251184595,28,1256576002,5391407
1670879243,205000,true,1251434844,28,1256953012,5518168
1670879255,204999,true,1251559987,28,1257078708,5518721
1670879279,204997,true,1251810312,28,1257204416,5394104
1670879291,204995,true,1252060687,28,1257330136,5269449
1670879339,204993,true,1252311111,28,1257833144,5522033
1670880167,204992,true,1252436342,28,1266035277,13598935
1670880251,204989,true,1252812111,28,1266921768,14109657
1670880263,204988,true,1252937392,28,1267048460,14111068
1670880275,204986,true,1253187992,28,1267175165,13987173
1670880311,204984,true,1253438642,28,1267555355,14116713
1670880323,204981,true,1253814711,28,1267682111,13867400
1670880647,204980,true,1253940093,28,1270346907,16406814
1670880683,204978,true,1254190893,28,1270600989,16410096
1670881367,204976,true,1254441744,28,1273017305,18575561
1670881691,204973,true,1254818114,28,1273781306,18963192
1670881931,204972,true,1254943596,28,1274290895,19347299
1670881955,204970,true,1255194597,28,1274290895,19096298
1670882699,204968,true,1255445649,28,1274673221,19227572
1670883767,204965,true,1255822320,28,1274673221,18850901
1670889143,204964,true,1255947902,28,1274673221,18725319
1670889923,204962,true,1256199105,28,1274673221,18474116
1670890019,204960,true,1256450357,28,1274673221,18222864
1670891471,204957,true,1256827330,28,1274673221,17845891
1670891987,204956,true,1256953012,28,1274673221,17720209
1670892599,204954,true,1257204416,28,1274673221,17468805
1670892683,204953,true,1257330136,28,1274673221,17343085
1670892707,204950,true,1257707373,28,1274673221,16965848
1670892839,204949,true,1257833144,28,1274545766,16712622
1670893427,204948,true,1257958927,28,1274163479,16204552
1670893475,204946,true,1258210531,28,1274036075,15825544
1670894219,204944,true,1258462186,28,1273271921,14809735
1670895071,204943,true,1258588032,28,1273017305,14429273
1670895491,204942,true,1258713891,28,1272890016,14176125
1670895515,204940,true,1258965646,28,1272890016,13924370
1670895599,204938,true,1259217452,28,1272890016,13672564
1670895635,204937,true,1259343374,28,1272890016,13546642
1670895659,204936,true,1259469308,28,1272890016,13420708
1670895863,204935,true,1259595255,28,1272762740,13167485
1670896127,204933,true,1259847187,28,1272508225,12661038
1670896535,204932,true,1259973171,28,1271999349,12026178
1670896571,204931,true,1260099169,28,1271872162,11772993
1670896655,204930,true,1260225179,28,1271744987,11519808
1670897087,204928,true,1260477236,28,1270982207,10504971
1670897903,204928,true,1260477236,28,1269965879,9488643
1670898527,204927,true,1260603284,28,1269584966,8981682
1670898719,204925,true,1260855417,28,1269584966,8729549
1670898935,204923,true,1261107601,28,1269584966,8477365
1670900987,204922,true,1261233712,28,1269584966,8351254
1670902631,204921,true,1261359835,28,1269584966,8225131
1670902955,204920,true,1261485971,28,1269584966,8098995
1670903195,204918,true,1261738281,28,1269584966,7846685
1670904899,204917,true,1261864455,28,1269584966,7720511
1670904923,204916,true,1261990641,28,1269584966,7594325
1670905211,204914,true,1262243052,28,1269711924,7468872
1670905619,204912,true,1262495513,28,1269711924,7216411
1670905679,204911,true,1262621763,28,1269711924,7090161
1670905835,204909,true,1262874300,28,1269711924,6837624
1670906087,204908,true,1263000587,28,1269965879,6965292
1670906399,204905,true,1263379525,28,1270092876,6713351
1670906591,204904,true,1263505863,28,1270346907,6841044
1670907395,204903,true,1263632214,28,1270982207,7349993
1670907515,204901,true,1263884953,28,1271109306,7224353
1670910239,204898,true,1264264156,28,1271236417,6972261
1670910383,204897,true,1264390583,28,1271236417,6845834
1670910575,204896,true,1264517022,28,1271236417,6719395
1670910647,204895,true,1264643473,28,1271236417,6592944
1670910683,204892,true,1265022904,28,1271236417,6213513
1670911223,204891,true,1265149407,28,1271236417,6087010
1670911895,204890,true,1265275922,28,1271236417,5960495
1670912039,204888,true,1265528989,28,1271236417,5707428
1670912147,204885,true,1265908686,28,1271236417,5327731
1670913527,204884,true,1266035277,28,1271236417,5201140
1670913731,204884,true,1266035277,28,1271236417,5201140
1670914043,204882,true,1266288497,28,1271363540,5075043
1670914451,204879,true,1266668421,28,1271363540,4695119
1670914463,204878,true,1266795088,28,1271363540,4568452
1670914571,204878,true,1266795088,28,1271363540,4568452
1670914607,204876,true,1267048460,28,1271363540,4315080
1670914931,204873,true,1267428612,28,1271236417,3807805
1670914943,204873,true,1267428612,28,1271236417,3807805
1670915027,204872,true,1267555355,28,1271236417,3681062
1670915051,204870,true,1267808879,28,1271236417,3427538
1670915063,204868,true,1268062453,28,1271236417,3173964
1670915555,204868,true,1268062453,28,1270092876,2030423
1670915639,204867,true,1268189260,28,1269838895,1649635
1670915663,204866,true,1268316079,28,1269838895,1522816
1670915687,204863,true,1268696611,28,1269711924,1015313
1670915723,204863,true,1268696611,28,1269584966,888355
1670915735,204863,true,1268696611,28,1269584966,888355
1670915843,204862,true,1268823481,28,1269204166,380685
1670915855,204860,true,1269077258,28,1269204166,126908
1670915879,204860,true,1269077258,28,1269077258,0
1670915891,204859,true,1269204166,28,1268950363,-253803
1670915903,204859,true,1269204166,28,1268950363,-253803
1670915975,204857,true,1269458020,28,1268569754,-888266
1670915987,204857,true,1269458020,28,1268442910,-1015110
1670915999,204857,true,1269458020,28,1268316079,-1141941
1670916047,204856,true,1269584966,28,1268062453,-1522513
1670916119,204855,true,1269711924,28,1267682111,-2029813
1670916215,204856,true,1269584966,28,1267048460,-2536506
1670917247,204856,true,1269584966,28,1261738281,-7846685
1670917403,204855,true,1269711924,28,1261107601,-8604323
1670917415,204855,true,1269711924,28,1260981503,-8730421
1670917427,204856,true,1269584966,28,1260981503,-8603463
1670917463,204856,true,1269584966,28,1260855417,-8729549
1670917475,204856,true,1269584966,28,1260855417,-8729549
1670917559,204856,true,1269584966,28,1260729344,-8855622
1670917595,204857,true,1269458020,28,1260729344,-8728676
1670917715,204857,true,1269458020,28,1260603284,-8854736
1670917727,204857,true,1269458020,28,1260603284,-8854736
1670918063,204857,true,1269458020,28,1261233712,-8224308
1670918135,204857,true,1269458020,28,1261485971,-7972049
1670918195,204858,true,1269331087,28,1261612120,-7718967
1670918387,204858,true,1269331087,28,1261990641,-7340446
1670918711,204858,true,1269331087,28,1262621763,-6709324
1670920103,204859,true,1269204166,28,1263758577,-5445589
1670920127,204860,true,1269077258,28,1263884953,-5192305
1670920175,204860,true,1269077258,28,1263884953,-5192305
1670920187,204860,true,1269077258,28,1263884953,-5192305
1670920439,204860,true,1269077258,28,1264264156,-4813102
1670920511,204861,true,1268950363,28,1264264156,-4686207
1670920619,204861,true,1268950363,28,1264517022,-4433341
1670922107,204861,true,1268950363,28,1268189260,-761103
1670922179,204862,true,1268823481,28,1268316079,-507402
1670922539,204862,true,1268823481,28,1268569754,-253727
1670923223,204863,true,1268696611,28,1268442910,-253701
1670923463,204863,true,1268696611,28,1268316079,-380532
1670924219,204864,true,1268569754,28,1268189260,-380494
1670925527,204864,true,1268569754,28,1268189260,-380494
1670925551,204865,true,1268442910,28,1268316079,-126831
1670925563,204865,true,1268442910,28,1268316079,-126831
1670925575,204865,true,1268442910,28,1268316079,-126831
1670925587,204865,true,1268442910,28,1268442910,0
1670925743,204864,true,1268569754,28,1269331087,761333
1670925791,204864,true,1268569754,28,1269584966,1015212
1670925875,204864,true,1268569754,28,1270092876,1523122
1670925911,204864,true,1268569754,28,1270346907,1777153
1670925983,204862,true,1268823481,28,1270855122,2031641
1670926031,204862,true,1268823481,28,1271236417,2412936
1670926043,204862,true,1268823481,28,1271236417,2412936
1670926331,204861,true,1268950363,28,1274036075,5085712
1670926343,204859,true,1269204166,28,1274163479,4959313
1670926355,204859,true,1269204166,28,1274163479,4959313
1670926367,204859,true,1269204166,28,1274290895,5086729
1670927075,204858,true,1269331087,28,1280293858,10962771
1670927603,204856,true,1269584966,28,1283370100,13785134
1670928575,204856,true,1269584966,28,1283498437,13913471
1670928719,204856,true,1269584966,28,1283498437,13913471
1670929031,204855,true,1269711924,28,1283370100,13658176
1670929415,204853,true,1269965879,28,1283241775,13275896
1670930111,204853,true,1269965879,28,1282856880,12891001
1670930171,204853,true,1269965879,28,1282856880,12891001
1670930207,204851,true,1270219885,28,1282856880,12636995
1670930219,204849,true,1270473942,28,1282856880,12382938
1670930243,204849,true,1270473942,28,1282856880,12382938
1670930255,204849,true,1270473942,28,1282856880,12382938
1670930303,204847,true,1270728049,28,1282856880,12128831
1670930315,204845,true,1270982207,28,1282856880,11874673
1670930351,204845,true,1270982207,28,1282856880,11874673
1670930651,204845,true,1270982207,28,1283241775,12259568
1670930723,204843,true,1271236417,28,1283370100,12133683
1670931299,204841,true,1271490677,28,1284268728,12778051
1670931347,204841,true,1271490677,28,1284397155,12906478
1670932151,204840,true,1271617826,28,1285810699,14192873
1670932223,204838,true,1271872162,28,1285939280,14067118
1670933243,204836,true,1272126549,28,1286453733,14327184
1670933363,204836,true,1272126549,28,1286453733,14327184
1670933639,204835,true,1272253762,28,1286453733,14199971
1670933903,204834,true,1272380987,28,1286582378,14201391
1670934011,204832,true,1272635476,28,1286582378,13946902
1670934095,204831,true,1272762740,28,1286582378,13819638
1670934119,204831,true,1272762740,28,1286582378,13819638
1670934647,204828,true,1273144607,28,1288900196,15755589
1670934995,204825,true,1273526588,28,1290447727,16921139
1670935271,204825,true,1273526588,28,1291609595,18083007
1670935523,204824,true,1273653941,28,1292772508,19118567
1670936171,204821,true,1274036075,28,1294454121,20418046
1670936231,204819,true,1274290895,28,1294454121,20163226
1670936411,204819,true,1274290895,28,1294324689,20033794
1670936435,204818,true,1274418324,28,1294324689,19906365
1670936495,204815,true,1274800688,28,1294324689,19524001
1670936639,204813,true,1275055661,28,1294195269,19139608
1670936663,204813,true,1275055661,28,1294195269,19139608
1670936807,204812,true,1275183166,28,1293936469,18753303
1670936891,204809,true,1275565760,28,1293807088,18241328
1670937599,204807,true,1275820886,28,1292772508,16951622
1670937611,204807,true,1275820886,28,1292772508,16951622
1670937623,204806,true,1275948468,28,1292901786,16953318
1670937659,204803,true,1276331291,28,1293031076,16699785
1670937695,204799,true,1276841900,28,1293160379,16318479
1670937707,204799,true,1276841900,28,1293160379,16318479
1670937719,204798,true,1276969584,28,1293160379,16190795
1670937863,204796,true,1277224990,28,1293548366,16323376
1670938187,204792,true,1277735957,28,1294195269,16459312
1670938211,204791,true,1277863731,28,1294195269,16331538
1670938235,204789,true,1278119316,28,1294583567,16464251
1670938247,204786,true,1278502790,28,1294842496,16339706
1670938259,204778,true,1279525951,28,1295101478,15575527
1670938295,204773,true,1280165842,28,1296008321,15842479
1670938391,204771,true,1280421888,28,1298213298,17791410
1670938403,204768,true,1280806053,28,1298472954,17666901
1670938415,204759,true,1281959239,28,1298732662,16773423
1670938427,204754,true,1282600347,28,1298992421,16392074
1670938439,204751,true,1282985166,28,1299382158,16396992
1670938475,204748,true,1283370100,28,1300161982,16791882
1670938607,204737,true,1284782513,28,1303807355,19024842
1670938955,204733,true,1285296503,28,1313228171,27931668
1670939171,204729,true,1285810699,28,1318755051,32944352
1670939255,204726,true,1286196480,28,1320998729,34802249
1670939363,204716,true,1287483256,28,1323775602,36292346
1670939531,204711,true,1288127126,28,1327619931,39492805
1670939675,204708,true,1288513603,28,1330809886,42296283
1670939711,204704,true,1289029086,28,1331741732,42712646
1670939759,204694,true,1290318695,28,1332807498,42488803
1670940059,204690,true,1290834900,28,1338818346,47983446
1670940203,204686,true,1291351311,28,1339086123,47734812
1670940515,204683,true,1291738756,28,1339086123,47347367
1670940635,204673,true,1293031076,28,1339086123,46055047
1670940815,204668,true,1293677721,28,1339086123,45408402
1670940827,204665,true,1294065863,28,1339086123,45020260
1670940875,204662,true,1294454121,28,1339086123,44632002
1670941199,204652,true,1295749158,28,1339621838,43872680
1670941463,204646,true,1296526802,28,1340425812,43899010
1670941487,204643,true,1296915799,28,1340559854,43644055
1670941667,204640,true,1297304913,28,1341096159,43791246
1670941703,204630,true,1298602801,28,1341230268,42627467
1670941715,204625,true,1299252233,28,1341230268,41978035
1670941727,204621,true,1299772012,28,1341230268,41458256
1670941739,204618,true,1300161982,28,1341230268,41068286
1670941895,204608,true,1301462729,28,1341632678,40169949
1670941943,204603,true,1302113591,28,1341632678,39519087
1670941955,204601,true,1302374027,28,1341632678,39258651
1670941967,204598,true,1302764778,28,1341632678,38867900
1670942183,204588,true,1304068129,28,1341498528,37430399
1670942207,204584,true,1304589835,28,1341364391,36774556
1670942267,204582,true,1304850766,28,1341364391,36513625
1670942327,204579,true,1305242260,28,1341230268,35988008
1670942339,204569,true,1306548090,28,1341230268,34682178
1670942531,204565,true,1307070787,28,1340693910,33623123
1670942627,204563,true,1307332215,28,1340425812,33093597
1670943227,204560,true,1307724454,28,1338015336,30290882
1670943923,204551,true,1308901876,28,1335075085,26173209
1670944115,204547,true,1309425516,28,1334674642,25249126
1670944631,204545,true,1309687414,28,1334274320,24586906
1670944967,204543,true,1309949364,28,1334007505,24058141
1670944979,204536,true,1310866604,28,1334007505,23140901
1670944991,204532,true,1311391029,28,1334007505,22616476
1670945075,204530,true,1311653321,28,1333874118,22220797
1670945087,204529,true,1311784486,28,1333874118,22089632
1670945171,204522,true,1312703011,28,1333740744,21037733
1670945399,204518,true,1313228171,28,1333340701,20112530
1670945411,204516,true,1313490830,28,1333207381,19716551
1670945435,204516,true,1313490830,28,1333207381,19716551
1670945555,204509,true,1314410549,28,1332940779,18530230
1670945615,204506,true,1314804912,28,1332807498,18002586
1670945627,204504,true,1315067886,28,1332674231,17606345
1670946035,204504,true,1315067886,28,1331342289,16274403
1670946047,204497,true,1315988709,28,1331209168,15220459
1670946059,204494,true,1316383546,28,1331209168,14825622
1670946131,204492,true,1316646835,28,1330942967,14296132
1670946239,204492,true,1316646835,28,1330410722,13763887
1670946407,204485,true,1317568765,28,1329745717,12176952
1670946767,204482,true,1317964075,28,1328283874,10319799
1670946959,204480,true,1318227681,28,1327619931,9392250
1670947571,204480,true,1318227681,28,1326558313,8330632
1670948303,204473,true,1319150717,28,1326160425,7009708
1670950511,204470,true,1319546502,28,1326027822,6481320
1670950595,204469,true,1319678457,28,1325895232,6216775
1670951015,204469,true,1319678457,28,1325099974,5421517
1670951291,204462,true,1320602509,28,1324305192,3702683
1670951507,204460,true,1320866642,28,1323907980,3041338
1670951747,204458,true,1321130829,28,1323510887,2380058
1670951843,204458,true,1321130829,28,1323246224,2115395
1670951975,204452,true,1321923706,28,1322849330,925624
1670952047,204450,true,1322188104,28,1322584800,396696
1670952059,204449,true,1322320322,28,1322584800,264478
1670952143,204449,true,1322320322,28,1322320322,0
1670952263,204443,true,1323113913,28,1321791526,-1322387
1670952275,204441,true,1323378549,28,1321791526,-1587023
1670952527,204440,true,1323510887,28,1321395068,-2115819
1670952599,204440,true,1323510887,28,1321262942,-2247945
1670952935,204434,true,1324305192,28,1320866642,-3438550
1670952971,204432,true,1324570066,28,1320734569,-3835497
1670952983,204431,true,1324702523,28,1320734569,-3967954
1670953235,204433,true,1324437622,28,1320338428,-4099194
1670953283,204427,true,1325232484,28,1320206407,-5026077
1670953355,204425,true,1325497543,28,1319942405,-5555138
1670953391,204424,true,1325630093,28,1319810424,-5819669
1670953511,204427,true,1325232484,28,1319282632,-5949852
1670953775,204421,true,1326027822,28,1318359504,-7668318
1670953799,204420,true,1326160425,28,1318227681,-7932744
1670953895,204419,true,1326293041,28,1317964075,-8328966
1670953907,204421,true,1326027822,28,1317964075,-8063747
1670954171,204416,true,1326690969,28,1316778500,-9912469
1670954183,204414,true,1326956320,28,1316778500,-10177820
1670954195,204413,true,1327089016,28,1316646835,-10442181
1670955083,204416,true,1326690969,28,1311391029,-15299940
1670955191,204411,true,1327354447,28,1310997691,-16356756
1670955443,204410,true,1327487182,28,1310211367,-17275815
1670955467,204409,true,1327619931,28,1310080359,-17539572
1670955491,204411,true,1327354447,28,1310080359,-17274088
1670955527,204409,true,1327619931,28,1309949364,-17670567
1670955539,204407,true,1327885468,28,1309949364,-17936104
1670955563,204406,true,1328018257,28,1309818383,-18199874
1670955635,204408,true,1327752693,28,1309818383,-17934310
1670955803,204405,true,1328151058,28,1309687414,-18463644
1670955839,204403,true,1328416702,28,1309687414,-18729288
1670955887,204402,true,1328549544,28,1309687414,-18862130
1670955911,204405,true,1328151058,28,1309687414,-18463644
1670956163,204406,true,1328018257,28,1310211367,-17806890
1670956283,204408,true,1327752693,28,1310604470,-17148223
1670956331,204408,true,1327752693,28,1310735531,-17017162
1670956343,204411,true,1327354447,28,1310735531,-16618916
1670956391,204412,true,1327221725,28,1310866604,-16355121
1670956511,204413,true,1327089016,28,1311259903,-15829113
1670956571,204414,true,1326956320,28,1311522169,-15434151
1670958335,204416,true,1326690969,28,1315199392,-11491577
1670958443,204419,true,1326293041,28,1315199392,-11093649
1670958599,204420,true,1326160425,28,1315199392,-10961033
1670958755,204421,true,1326027822,28,1315199392,-10828430
1670958791,204423,true,1325762656,28,1315199392,-10563264
1670959259,204425,true,1325497543,28,1315199392,-10298151
1670959547,204426,true,1325365007,28,1315199392,-10165615
1670960303,204427,true,1325232484,28,1315199392,-10033092
1670960771,204430,true,1324834993,28,1315199392,-9635601
1670960783,204431,true,1324702523,28,1315330912,-9371611
1670960795,204433,true,1324437622,28,1315330912,-9106710
1670960879,204433,true,1324437622,28,1315330912,-9106710
1670962067,204435,true,1324172775,28,1316646835,-7525940
1670962139,204437,true,1323907980,28,1316646835,-7261145
1670962187,204439,true,1323643238,28,1316778500,-6864738
1670962199,204439,true,1323643238,28,1316778500,-6864738
1670962427,204442,true,1323246224,28,1316910178,-6336046
1670964767,204444,true,1322981615,28,1315462446,-7519169
1670964779,204446,true,1322717058,28,1315462446,-7254612
1670964827,204447,true,1322584800,28,1315593992,-6990808
1670964863,204449,true,1322320322,28,1315593992,-6726330
1670965175,204452,true,1321923706,28,1315725551,-6198155
1670965307,204453,true,1321791526,28,1315725551,-6065975
1670966063,204454,true,1321659361,28,1316120308,-5539053
1670966123,204456,true,1321395068,28,1316120308,-5274760
1670966147,204459,true,1320998729,28,1316251920,-4746809
1670966183,204460,true,1320866642,28,1316251920,-4614722
1670966747,204460,true,1320866642,28,1316910178,-3956464
1670967443,204463,true,1320470462,28,1316910178,-3560284
1670968235,204464,true,1320338428,28,1316778500,-3559928
1670968247,204466,true,1320074400,28,1316778500,-3295900
1670968715,204466,true,1320074400,28,1316778500,-3295900
1670968883,204468,true,1319810424,28,1316778500,-3031924
1670969879,204470,true,1319546502,28,1317437021,-2109481
1670969891,204471,true,1319414560,28,1317437021,-1977539
1670970179,204471,true,1319414560,28,1317437021,-1977539
1670971247,204473,true,1319150717,28,1317437021,-1713696
1670971535,204474,true,1319018815,28,1317437021,-1581794
1670972111,204475,true,1318886927,28,1317437021,-1449906
1670972255,204476,true,1318755051,28,1317437021,-1318030
1670972315,204478,true,1318491340,28,1317437021,-1054319
1670974271,204479,true,1318359504,28,1317437021,-922483
1670974283,204480,true,1318227681,28,1317568765,-658916
1670974499,204480,true,1318227681,28,1317700522,-527159
1670975411,204481,true,1318095871,28,1318359504,263633
1670976251,204482,true,1317964075,28,1318886927,922852
1670976359,204483,true,1317832292,28,1319018815,1186523
1670976611,204483,true,1317832292,28,1319150717,1318425
1670978039,204485,true,1317568765,28,1319810424,2241659
1670978051,204485,true,1317568765,28,1319810424,2241659
1670978471,204486,true,1317437021,28,1319942405,2505384
1670978507,204486,true,1317437021,28,1319942405,2505384
1670978531,204487,true,1317305290,28,1319942405,2637115
1670978651,204487,true,1317305290,28,1320074400,2769110
1670978879,204487,true,1317305290,28,1320470462,3165172
1670979155,204487,true,1317305290,28,1320866642,3561352
1670979455,204488,true,1317173573,28,1321262942,4089369
1670979635,204488,true,1317173573,28,1321527208,4353635
1670981123,204488,true,1317173573,28,1322981615,5808042
1670983163,204488,true,1317173573,28,1322981615,5808042
1670983415,204489,true,1317041869,28,1322981615,5939746
1670983583,204489,true,1317041869,28,1322981615,5939746
1670983703,204489,true,1317041869,28,1322981615,5939746
1670983991,204489,true,1317041869,28,1322981615,5939746
1670984255,204489,true,1317041869,28,1322981615,5939746
1670984291,204490,true,1316910178,28,1322981615,6071437
1670984351,204489,true,1317041869,28,1322981615,5939746
1670984483,204489,true,1317041869,28,1322849330,5807461
1670984531,204489,true,1317041869,28,1322849330,5807461
1670984555,204490,true,1316910178,28,1322849330,5939152
1670985239,204489,true,1317041869,28,1322055898,5014029
1670985467,204489,true,1317041869,28,1321923706,4881837
1670985635,204489,true,1317041869,28,1321791526,4749657
1670985803,204489,true,1317041869,28,1321527208,4485339
1670987987,204489,true,1317041869,28,1319942405,2900536
1670988023,204488,true,1317173573,28,1320074400,2900827
1670988047,204489,true,1317041869,28,1320074400,3032531
1670988335,204489,true,1317041869,28,1320074400,3032531
1670988731,204489,true,1317041869,28,1320206407,3164538
1670988875,204488,true,1317173573,28,1320206407,3032834
1670989163,204489,true,1317041869,28,1320338428,3296559
1670989475,204489,true,1317041869,28,1320470462,3428593
1670989583,204488,true,1317173573,28,1320470462,3296889
1670989715,204488,true,1317173573,28,1320470462,3296889
1670990483,204488,true,1317173573,28,1320470462,3296889
1670991275,204487,true,1317305290,28,1320470462,3165172
1670993027,204487,true,1317305290,28,1320470462,3165172
1670993099,204486,true,1317437021,28,1320470462,3033441
1670993183,204486,true,1317437021,28,1320470462,3033441
1670993219,204485,true,1317568765,28,1320470462,2901697
1670993423,204484,true,1317700522,28,1320470462,2769940
1670993519,204484,true,1317700522,28,1320470462,2769940
1670994983,204483,true,1317832292,28,1320470462,2638170
1670994995,204482,true,1317964075,28,1320470462,2506387
1670995319,204481,true,1318095871,28,1320470462,2374591
1670995895,204481,true,1318095871,28,1320470462,2374591
1670996123,204480,true,1318227681,28,1320470462,2242781
1670996435,204479,true,1318359504,28,1320470462,2110958
1670996579,204478,true,1318491340,28,1320470462,1979122
1670996831,204478,true,1318491340,28,1320470462,1979122
1670998043,204477,true,1318623189,28,1320338428,1715239
1671000419,204477,true,1318623189,28,1320338428,1715239
1671002027,204476,true,1318755051,28,1320338428,1583377
1671002375,204476,true,1318755051,28,1320338428,1583377
1671002459,204475,true,1318886927,28,1320470462,1583535
1671002819,204475,true,1318886927,28,1320470462,1583535
1671003035,204474,true,1319018815,28,1320470462,1451647
1671004739,204474,true,1319018815,28,1320866642,1847827
1671006479,204473,true,1319150717,28,1320866642,1715925
1671006539,204473,true,1319150717,28,1320866642,1715925
1671006959,204472,true,1319282632,28,1320866642,1584010
1671007223,204472,true,1319282632,28,1321262942,1980310
1671007751,204471,true,1319414560,28,1321791526,2376966
1671008363,204471,true,1319414560,28,1322320322,2905762
1671011435,204470,true,1319546502,28,1322717058,3170556
1671011903,204470,true,1319546502,28,1322717058,3170556
1671012107,204469,true,1319678457,28,1322717058,3038601
1671012911,204469,true,1319678457,28,1322717058,3038601
1671013403,204468,true,1319810424,28,1322717058,2906634
1671013427,204468,true,1319810424,28,1322717058,2906634
1671013559,204467,true,1319942405,28,1322717058,2774653
1671013691,204467,true,1319942405,28,1322717058,2774653
1671014135,204466,true,1320074400,28,1322849330,2774930
1671015503,204466,true,1320074400,28,1322981615,2907215
1671015911,204466,true,1320074400,28,1322981615,2907215
1671015971,204465,true,1320206407,28,1323113913,2907506
1671016043,204465,true,1320206407,28,1323113913,2907506
1671016799,204464,true,1320338428,28,1323907980,3569552
1671017183,204463,true,1320470462,28,1324305192,3834730
1671017891,204463,true,1320470462,28,1324702523,4232061
1671018107,204462,true,1320602509,28,1324702523,4100014
1671018419,204461,true,1320734569,28,1324702523,3967954
1671019235,204461,true,1320734569,28,1324702523,3967954
1671019607,204460,true,1320866642,28,1324702523,3835881
1671019763,204460,true,1320866642,28,1324702523,3835881
1671019943,204459,true,1320998729,28,1324702523,3703794
1671020063,204459,true,1320998729,28,1324702523,3703794
1671020075,204458,true,1321130829,28,1324834993,3704164
1671020495,204457,true,1321262942,28,1325365007,4102065
1671020771,204457,true,1321262942,28,1325762656,4499714
1671020831,204456,true,1321395068,28,1325895232,4500164
1671020951,204455,true,1321527208,28,1326027822,4500614
1671021395,204454,true,1321659361,28,1326690969,5031608
1671021467,204454,true,1321659361,28,1326823638,5164277
1671021611,204453,true,1321791526,28,1327089016,5297490
1671021623,204453,true,1321791526,28,1327221725,5430199
1671021647,204451,true,1322055898,28,1327221725,5165827
1671021707,204451,true,1322055898,28,1327354447,5298549
1671021863,204450,true,1322188104,28,1327752693,5564589
1671022439,204449,true,1322320322,28,1328549544,6229222
1671022691,204448,true,1322452554,28,1328948148,6495594
1671022763,204448,true,1322452554,28,1329081043,6628489
1671022811,204447,true,1322584800,28,1329081043,6496243
1671022847,204446,true,1322717058,28,1329081043,6363985
1671023075,204445,true,1322849330,28,1329479807,6630477
1671023663,204444,true,1322981615,28,1329745717,6764102
1671023927,204443,true,1323113913,28,1329745717,6631804
1671024191,204443,true,1323113913,28,1329745717,6631804
1671024947,204442,true,1323246224,28,1329745717,6499493
1671025499,204441,true,1323378549,28,1329745717,6367168
1671025619,204441,true,1323378549,28,1329745717,6367168
1671025631,204440,true,1323510887,28,1329745717,6234830
1671025895,204439,true,1323643238,28,1329745717,6102479
1671026879,204439,true,1323643238,28,1329213951,5570713
1671027707,204438,true,1323775602,28,1328948148,5172546
1671027971,204438,true,1323775602,28,1328948148,5172546
1671028223,204438,true,1323775602,28,1328948148,5172546
1671028235,204437,true,1323907980,28,1329081043,5173063
1671028655,204436,true,1324040371,28,1329745717,5705346
1671028691,204436,true,1324040371,28,1329745717,5705346
1671028703,204435,true,1324172775,28,1329745717,5572942
1671028787,204435,true,1324172775,28,1330011679,5838904
1671028799,204433,true,1324437622,28,1330011679,5574057
1671028811,204433,true,1324437622,28,1330011679,5574057
1671029663,204432,true,1324570066,28,1333207381,8637315
1671029675,204431,true,1324702523,28,1333207381,8504858
1671029735,204430,true,1324834993,28,1333474035,8639042
1671029747,204430,true,1324834993,28,1333607383,8772390
1671029795,204428,true,1325099974,28,1333740744,8640770
1671029819,204427,true,1325232484,28,1333874118,8641634
1671029927,204426,true,1325365007,28,1334407747,9042740
1671030503,204425,true,1325497543,28,1336544402,11046859
1671030803,204424,true,1325630093,28,1337079100,11449007
1671031031,204423,true,1325762656,28,1337346529,11583873
1671031211,204421,true,1326027822,28,1337614012,11586190
1671031415,204421,true,1326027822,28,1337881548,11853726
1671031427,204419,true,1326293041,28,1337881548,11588507
1671031475,204418,true,1326425670,28,1337881548,11455878
1671031487,204417,true,1326558313,28,1337881548,11323235
1671032591,204416,true,1326690969,28,1339086123,12395154
1671033503,204414,true,1326956320,28,1339755800,12799480
1671034379,204413,true,1327089016,28,1339755800,12666784
1671034559,204411,true,1327354447,28,1339755800,12401353
1671035147,204410,true,1327487182,28,1339621838,12134656
1671035771,204408,true,1327752693,28,1339353954,11601261
1671036119,204408,true,1327752693,28,1339220032,11467339
1671036851,204406,true,1328018257,28,1338550622,10532365
1671037055,204406,true,1328018257,28,1338416781,10398524
1671037067,204404,true,1328283874,28,1338416781,10132907
1671037115,204403,true,1328416702,28,1338416781,10000079
1671037187,204402,true,1328549544,28,1338282952,9733408
1671037439,204401,true,1328682399,28,1338149137,9466738
1671037919,204399,true,1328948148,28,1337881548,8933400
1671038171,204399,true,1328948148,28,1337881548,8933400
1671038831,204397,true,1329213951,28,1337881548,8667597
1671039023,204396,true,1329346873,28,1337881548,8534675
1671039275,204394,true,1329612755,28,1337881548,8268793
1671039635,204394,true,1329612755,28,1337881548,8268793
1671039659,204392,true,1329878691,28,1337881548,8002857
1671039683,204392,true,1329878691,28,1337881548,8002857
1671041303,204390,true,1330144680,28,1337747773,7603093
1671042155,204389,true,1330277695,28,1337747773,7470078
1671042167,204388,true,1330410722,28,1337747773,7337051
1671042191,204387,true,1330543764,28,1337747773,7204009
1671042227,204385,true,1330809886,28,1337747773,6937887
1671042635,204383,true,1331076061,28,1338684477,7608416
1671042707,204382,true,1331209168,28,1338818346,7609178
1671042731,204381,true,1331342289,28,1338952228,7609939
1671042815,204379,true,1331608571,28,1339086123,7477552
1671042827,204378,true,1331741732,28,1339220032,7478300
1671042995,204376,true,1332008094,28,1339621838,7613744
1671043007,204375,true,1332141295,28,1339755800,7614505
1671043187,204373,true,1332407736,28,1340425812,8018076
1671043223,204372,true,1332540977,28,1340559854,8018877
1671043271,204370,true,1332807498,28,1340827980,8020482
1671043283,204369,true,1332940779,28,1340827980,7887201
1671043547,204367,true,1333207381,28,1342303628,9096247
1671044327,204365,true,1333474035,28,1345663417,12189382
1671044375,204364,true,1333607383,28,1345125286,11517903
1671044399,204363,true,1333740744,28,1344990787,11250043
1671044411,204361,true,1334007505,28,1344856302,10848797
1671044423,204364,true,1333607383,28,1344721830,11114447
1671044471,204362,true,1333874118,28,1344452926,10578808
1671044519,204361,true,1334007505,28,1344184075,10176570
1671044531,204359,true,1334274320,28,1344049670,9775350
1671044555,204363,true,1333740744,28,1343780901,10040157
1671044567,204361,true,1334007505,28,1343646536,9639031
1671044579,204361,true,1334007505,28,1343512185,9504680
1671044615,204360,true,1334140906,28,1342840630,8699724
1671044627,204365,true,1333474035,28,1342706360,9232325
1671044639,204364,true,1333607383,28,1342437859,8830476
1671044651,204364,true,1333607383,28,1342303628,8696245
1671044663,204363,true,1333740744,28,1342169411,8428667
1671044699,204368,true,1333074073,28,1341632678,8558605
1671044831,204366,true,1333340701,28,1339621838,6281137
1671044903,204366,true,1333340701,28,1338684477,5343776
1671044939,204365,true,1333474035,28,1338015336,4541301
1671044963,204370,true,1332807498,28,1337747773,4940275
1671044975,204368,true,1333074073,28,1337480264,4406191
1671045383,204369,true,1332940779,28,1330277695,-2663084
1671045887,204368,true,1333074073,28,1321395068,-11679005
1671045983,204373,true,1332407736,28,1319678457,-12729279
1671046151,204371,true,1332674231,28,1317041869,-15632362
1671046415,204372,true,1332540977,28,1315593992,-16946985
1671046439,204371,true,1332674231,28,1315593992,-17080239
1671046451,204376,true,1332008094,28,1315462446,-16545648
1671046463,204375,true,1332141295,28,1315462446,-16678849
1671046511,204377,true,1331874906,28,1315199392,-16675514
1671046523,204377,true,1331874906,28,1315067886,-16807020
1671046535,204382,true,1331209168,28,1315067886,-16141282
1671046583,204381,true,1331342289,28,1314673444,-16668845
1671046871,204384,true,1330942967,28,1312965565,-17977402
1671046883,204383,true,1331076061,28,1312834281,-18241780
1671046895,204388,true,1330410722,28,1312834281,-17576441
1671046919,204388,true,1330410722,28,1312703011,-17707711
1671047051,204389,true,1330277695,28,1312178061,-18099634
1671047063,204389,true,1330277695,28,1312178061,-18099634
1671048083,204394,true,1329612755,28,1309294586,-20318169
1671048095,204393,true,1329745717,28,1309163670,-20582047
1671048107,204395,true,1329479807,28,1309163670,-20316137
1671048131,204395,true,1329479807,28,1309032767,-20447040
1671048251,204400,true,1328815267,28,1308640135,-20175132
1671048299,204399,true,1328948148,28,1308640135,-20308013
1671048311,204401,true,1328682399,28,1308640135,-20042264
1671048563,204400,true,1328815267,28,1309032767,-19782500
1671048671,204406,true,1328018257,28,1309163670,-18854587
1671048683,204405,true,1328151058,28,1309163670,-18987388
1671048695,204406,true,1328018257,28,1309163670,-18854587
1671048707,204406,true,1328018257,28,1309163670,-18854587
1671048779,204410,true,1327487182,28,1309294586,-18192596
1671048791,204410,true,1327487182,28,1309294586,-18192596
1671049787,204411,true,1327354447,28,1311522169,-15832278
1671049799,204411,true,1327354447,28,1311522169,-15832278
1671049811,204415,true,1326823638,28,1311522169,-15301469
1671049847,204415,true,1326823638,28,1311522169,-15301469
1671049859,204418,true,1326425670,28,1311522169,-14903501
1671050051,204418,true,1326425670,28,1311391029,-15034641
1671050063,204423,true,1325762656,28,1311391029,-14371627
1671051035,204423,true,1325762656,28,1308378447,-17384209
1671051059,204426,true,1325365007,28,1308378447,-16986560
1671051251,204427,true,1325232484,28,1307462948,-17769536
1671052127,204431,true,1324702523,28,1306025601,-18676922
1671052175,204431,true,1324702523,28,1306025601,-18676922
1671052211,204434,true,1324305192,28,1306156204,-18148988
1671052247,204435,true,1324172775,28,1306156204,-18016571
1671052295,204440,true,1323510887,28,1306156204,-17354683
1671052439,204440,true,1323510887,28,1306417448,-17093439
1671052535,204442,true,1323246224,28,1306548090,-16698134
1671052775,204443,true,1323113913,28,1307070787,-16043126
1671052823,204447,true,1322584800,28,1307201494,-15383306
1671053207,204447,true,1322584800,28,1308116810,-14467990
1671054263,204450,true,1322188104,28,1310080359,-12107745
1671055895,204451,true,1322055898,28,1310080359,-11975539
1671055955,204455,true,1321527208,28,1310080359,-11446849
1671055979,204455,true,1321527208,28,1310080359,-11446849
1671056147,204458,true,1321130829,28,1310080359,-11050470
1671056603,204459,true,1320998729,28,1309949364,-11049365
1671056699,204463,true,1320470462,28,1309818383,-10652079
1671057083,204463,true,1320470462,28,1309818383,-10652079
1671057119,204466,true,1320074400,28,1309949364,-10125036
1671057779,204467,true,1319942405,28,1310211367,-9731038
1671058019,204471,true,1319414560,28,1310342389,-9072171
1671058055,204470,true,1319546502,28,1310342389,-9204113
1671058187,204473,true,1319150717,28,1310473423,-8677294
1671059171,204474,true,1319018815,28,1310473423,-8545392
1671065723,204478,true,1318491340,28,1309687414,-8803926
1671066551,204478,true,1318491340,28,1308901876,-9589464
1671068231,204481,true,1318095871,28,1307855226,-10240645
1671068291,204482,true,1317964075,28,1307855226,-10108849
1671068375,204486,true,1317437021,28,1307855226,-9581795
1671068699,204486,true,1317437021,28,1307462948,-9974073
1671068711,204490,true,1316910178,28,1307462948,-9447230
1671068759,204491,true,1316778500,28,1306940093,-9838407
1671068771,204496,true,1316120308,28,1306809412,-9310896
1671068963,204499,true,1315725551,28,1305111749,-10613802
1671069071,204502,true,1315330912,28,1304068129,-11262783
1671069107,204504,true,1315067886,28,1303676987,-11390899
1671069167,204509,true,1314410549,28,1303155646,-11254903
1671069239,204513,true,1313884916,28,1302374027,-11510889
1671070763,204517,true,1313359494,28,1286453733,-26905761
1671070775,204519,true,1313096861,28,1286453733,-26643128
1671072371,204525,true,1312309279,28,1287097088,-25212191
1671072431,204528,true,1311915665,28,1287225798,-24689867
1671073043,204533,true,1311259903,28,1287225798,-24034105
1671073067,204534,true,1311128791,28,1287225798,-23902993
1671073079,204540,true,1310342389,28,1287225798,-23116591
1671073091,204543,true,1309949364,28,1287354520,-22594844
1671073175,204548,true,1309294586,28,1287354520,-21940066
1671073379,204550,true,1309032767,28,1287483256,-21549511
1671073703,204556,true,1308247622,28,1287612004,-20635618
1671073955,204559,true,1307855226,28,1287740765,-20114461
1671074195,204564,true,1307201494,28,1287998326,-19203168
1671074279,204566,true,1306940093,28,1288127126,-18812967
1671074303,204566,true,1306940093,28,1288127126,-18812967
1671074327,204570,true,1306417448,28,1288127126,-18290322
1671076067,204575,true,1305764435,28,1290189676,-15574759
1671076199,204577,true,1305503321,28,1290189676,-15313645
1671076631,204577,true,1305503321,28,1290189676,-15313645
1671077627,204580,true,1305111749,28,1290318695,-14793054
1671077771,204583,true,1304720294,28,1290318695,-14401599
1671078587,204584,true,1304589835,28,1290318695,-14271140
1671079331,204583,true,1304720294,28,1290318695,-14401599
1671079967,204586,true,1304328956,28,1290189676,-14139280
1671081395,204589,true,1303937735,28,1290189676,-13748059
1671083723,204590,true,1303807355,28,1290318695,-13488660
1671084035,204590,true,1303807355,28,1290318695,-13488660
1671085547,204594,true,1303285962,28,1290318695,-12967267
1671086267,204597,true,1302895054,28,1290318695,-12576359
1671086471,204598,true,1302764778,28,1290318695,-12446083
1671087827,204598,true,1302764778,28,1290447727,-12317051
1671087935,204601,true,1302374027,28,1290447727,-11926300
1671088127,204604,true,1301983393,28,1290447727,-11535666
1671089447,204605,true,1301853207,28,1290447727,-11405480
1671091139,204604,true,1301983393,28,1290447727,-11535666
1671091247,204608,true,1301462729,28,1290447727,-11015002
1671092171,204611,true,1301072369,28,1290318695,-10753674
1671092195,204612,true,1300942274,28,1290318695,-10623579
1671092243,204611,true,1301072369,28,1290318695,-10753674
1671092399,204615,true,1300552070,28,1290318695,-10233375
1671092519,204616,true,1300422028,28,1290318695,-10103333
1671092567,204616,true,1300422028,28,1290318695,-10103333
1671092615,204616,true,1300422028,28,1290318695,-10103333
1671092699,204619,true,1300031979,28,1290318695,-9713284
1671094319,204620,true,1299901989,28,1289673729,-10228260
1671094343,204621,true,1299772012,28,1289673729,-10098283
1671094463,204620,true,1299901989,28,1289544775,-10357214
1671094811,204624,true,1299382158,28,1289286905,-10095253
1671094883,204626,true,1299122320,28,1289157989,-9964331
1671094943,204626,true,1299122320,28,1289157989,-9964331
1671094955,204626,true,1299122320,28,1289157989,-9964331
1671094991,204630,true,1298602801,28,1289157989,-9444812
1671095783,204632,true,1298343120,28,1287612004,-10731116
1671096227,204633,true,1298213298,28,1286839707,-11373591
1671098183,204632,true,1298343120,28,1286196480,-12146640
1671098675,204636,true,1297823912,28,1286196480,-11627432
1671098759,204638,true,1297564387,28,1286196480,-11367907
1671100667,204639,true,1297434643,28,1286196480,-11238163
1671101291,204638,true,1297564387,28,1286196480,-11367907
1671102347,204642,true,1297045491,28,1286196480,-10849011
1671102539,204644,true,1296786120,28,1286196480,-10589640
1671103775,204645,true,1296656455,28,1286196480,-10459975
1671103955,204645,true,1296656455,28,1286196480,-10459975
1671104027,204649,true,1296137922,28,1286325100,-9812822
1671104039,204652,true,1295749158,28,1286325100,-9424058
1671104315,204652,true,1295749158,28,1286325100,-9424058
1671105155,204652,true,1295749158,28,1286711036,-9038122
1671105251,204656,true,1295230988,28,1286839707,-8391281
1671105335,204658,true,1294971981,28,1286839707,-8132274
1671105515,204658,true,1294971981,28,1286968391,-8003590
1671105599,204658,true,1294971981,28,1286968391,-8003590
1671106115,204661,true,1294583567,28,1287225798,-7357769
1671106379,204663,true,1294324689,28,1287354520,-6970169
1671107015,204663,true,1294324689,28,1287483256,-6841433
1671107495,204663,true,1294324689,28,1287483256,-6841433
1671108791,204666,true,1293936469,28,1287483256,-6453213
1671109019,204668,true,1293677721,28,1287483256,-6194465
1671109703,204668,true,1293677721,28,1287483256,-6194465
1671109943,204668,true,1293677721,28,1287483256,-6194465
1671109991,204672,true,1293160379,28,1287483256,-5677123
1671110027,204674,true,1292901786,28,1287354520,-5547266
1671111395,204676,true,1292643244,28,1280165842,-12477402
1671111431,204677,true,1292513993,28,1279909847,-12604146
1671111539,204681,true,1291997116,28,1279398011,-12599105
1671111647,204683,true,1291738756,28,1278758504,-12980252
1671112067,204685,true,1291480447,28,1277480448,-13999999
1671112463,204686,true,1291351311,28,1277097281,-14254030
1671112535,204690,true,1290834900,28,1277097281,-13737619
1671112595,204692,true,1290576772,28,1276969584,-13607188
1671112835,204695,true,1290189676,28,1276714228,-13475448
1671113327,204695,true,1290189676,28,1276331291,-13858385
1671113363,204699,true,1289673729,28,1276331291,-13342438
1671113627,204701,true,1289415833,28,1276203670,-13212163
1671114239,204704,true,1289029086,28,1276203670,-12825416
1671114515,204705,true,1288900196,28,1276203670,-12696526
1671114575,204709,true,1288384765,28,1276203670,-12181095
1671114791,204711,true,1288127126,28,1276203670,-11923456
1671115055,204714,true,1287740765,28,1276203670,-11537095
1671115235,204714,true,1287740765,28,1276203670,-11537095
1671115403,204718,true,1287225798,28,1276203670,-11022128
1671115871,204720,true,1286968391,28,1276203670,-10764721
1671115955,204723,true,1286582378,28,1276203670,-10378708
1671116195,204723,true,1286582378,28,1276076063,-10506315
1671116207,204727,true,1286067874,28,1276076063,-9991811
1671116327,204729,true,1285810699,28,1275693316,-10117383
1671116351,204731,true,1285553575,28,1275693316,-9860259
1671117503,204732,true,1285425033,28,1271999349,-13425684
1671118427,204733,true,1285296503,28,1270473942,-14822561
1671118439,204734,true,1285167986,28,1270473942,-14694044
1671118655,204737,true,1284782513,28,1270346907,-14435606
1671118775,204738,true,1284654047,28,1270219885,-14434162
1671118787,204739,true,1284525595,28,1270219885,-14305710
1671118811,204739,true,1284525595,28,1270219885,-14305710
1671119051,204742,true,1284140314,28,1269965879,-14174435
1671120347,204743,true,1284011913,28,1267682111,-16329802
1671120395,204744,true,1283883525,28,1267682111,-16201414
1671120635,204745,true,1283755149,28,1267428612,-16326537
1671120899,204747,true,1283498437,28,1267175165,-16323272
1671120935,204749,true,1283241775,28,1267175165,-16066610
1671121307,204750,true,1283113464,28,1267301882,-15811582
1671121763,204750,true,1283113464,28,1267555355,-15558109
1671122771,204753,true,1282728607,28,1268189260,-14539347
1671123107,204755,true,1282472100,28,1268189260,-14282840
1671124631,204755,true,1282472100,28,1268189260,-14282840
1671124655,204756,true,1282343865,28,1268316079,-14027786
1671124727,204759,true,1281959239,28,1268316079,-13643160
1671124799,204760,true,1281831056,28,1268316079,-13514977
1671124895,204761,true,1281702886,28,1268442910,-13259976
1671125459,204762,true,1281574728,28,1268823481,-12751247
1671125603,204764,true,1281318452,28,1268950363,-12368089
1671126239,204766,true,1281062227,28,1269711924,-11350303
1671126575,204766,true,1281062227,28,1269965879,-11096348
1671128543,204767,true,1280934133,28,1270219885,-10714248
1671130139,204770,true,1280549930,28,1270219885,-10330045
1671130379,204772,true,1280293858,28,1270219885,-10073973
1671130907,204772,true,1280293858,28,1269965879,-10327979
1671131507,204773,true,1280165842,28,1269711924,-10453918
1671131771,204776,true,1279781869,28,1269711924,-10069945
1671132791,204777,true,1279653903,28,1269584966,-10068937
1671132863,204778,true,1279525951,28,1269711924,-9814027
1671133067,204779,true,1279398011,28,1269838895,-9559116
1671133079,204781,true,1279142170,28,1269838895,-9303275
1671133307,204783,true,1278886380,28,1270092876,-8793504
1671133595,204783,true,1278886380,28,1270473942,-8412438
1671134507,204784,true,1278758504,28,1271617826,-7140678
1671137351,204787,true,1278374953,28,1271999349,-6375604
1671138359,204788,true,1278247128,28,1271999349,-6247779
1671138971,204788,true,1278247128,28,1271999349,-6247779
1671139679,204789,true,1278119316,28,1271999349,-6119967
1671140315,204792,true,1277735957,28,1271999349,-5736608
1671140387,204793,true,1277608196,28,1271999349,-5608847
1671140423,204793,true,1277608196,28,1271999349,-5608847
1671140447,204794,true,1277480448,28,1271999349,-5481099
1671140663,204797,true,1277097281,28,1271872162,-5225119
1671140687,204798,true,1276969584,28,1271872162,-5097422
1671140723,204799,true,1276841900,28,1271744987,-5096913
1671141023,204800,true,1276714228,28,1270473942,-6240286
1671141587,204804,true,1276203670,28,1268062453,-8141217
1671142343,204805,true,1276076063,28,1264896415,-11179648
1671142955,204806,true,1275948468,28,1264264156,-11684312
1671143003,204807,true,1275820886,28,1264264156,-11556730
1671148667,204811,true,1275310685,28,1264011341,-11299344
1671149087,204812,true,1275183166,28,1264011341,-11171825
1671149111,204812,true,1275183166,28,1264011341,-11171825
1671149495,204813,true,1275055661,28,1264011341,-11044320
1671149543,204817,true,1274545766,28,1264137742,-10408024
1671149555,204818,true,1274418324,28,1264137742,-10280582
1671151043,204817,true,1274545766,28,1267935660,-6610106
1671151787,204818,true,1274418324,28,1268696611,-5721713
1671151823,204822,true,1273908684,28,1268823481,-5085203
1671151955,204823,true,1273781306,28,1268823481,-4957825
1671152291,204822,true,1273908684,28,1268950363,-4958321
1671153527,204823,true,1273781306,28,1269838895,-3942411
1671154127,204826,true,1273399248,28,1269965879,-3433369
1671155459,204828,true,1273144607,28,1269965879,-3178728
1671156047,204827,true,1273271921,28,1269965879,-3306042
1671157379,204827,true,1273271921,28,1269965879,-3306042
1671158687,204831,true,1272762740,28,1269965879,-2796861
1671161399,204832,true,1272635476,28,1269965879,-2669597
1671161759,204832,true,1272635476,28,1269965879,-2669597
1671163607,204832,true,1272635476,28,1269965879,-2669597
1671163715,204836,true,1272126549,28,1269965879,-2160670
1671164027,204837,true,1271999349,28,1269965879,-2033470
1671165419,204836,true,1272126549,28,1269965879,-2160670
1671166391,204837,true,1271999349,28,1269965879,-2033470
1671168767,204841,true,1271490677,28,1269965879,-1524798
1671170255,204842,true,1271363540,28,1269965879,-1397661
1671171203,204841,true,1271490677,28,1269965879,-1524798
1671172619,204842,true,1271363540,28,1269965879,-1397661
1671173435,204846,true,1270855122,28,1269965879,-889243
1671174131,204847,true,1270728049,28,1269965879,-762170
1671174239,204846,true,1270855122,28,1269965879,-889243
1671174263,204847,true,1270728049,28,1270092876,-635173
1671174287,204848,true,1270600989,28,1270092876,-508113
1671174323,204849,true,1270473942,28,1270092876,-381066
1671174443,204848,true,1270600989,28,1270219885,-381104
1671174695,204848,true,1270600989,28,1270600989,0
1671174779,204849,true,1270473942,28,1270728049,254107
1671174911,204850,true,1270346907,28,1270982207,635300
1671174923,204849,true,1270473942,28,1270982207,508265
1671174935,204849,true,1270473942,28,1271109306,635364
1671175295,204850,true,1270346907,28,1272253762,1906855
1671175415,204850,true,1270346907,28,1272635476,2288569
1671176735,204849,true,1270473942,28,1275820886,5346944
1671176951,204849,true,1270473942,28,1275820886,5346944
1671177659,204850,true,1270346907,28,1275820886,5473979
1671180611,204851,true,1270219885,28,1275693316,5473431
1671180647,204849,true,1270473942,28,1275693316,5219374
1671180659,204849,true,1270473942,28,1275693316,5219374
1671180683,204850,true,1270346907,28,1275693316,5346409
1671180719,204851,true,1270219885,28,1275693316,5473431
1671180803,204851,true,1270219885,28,1275183166,4963281
1671180863,204852,true,1270092876,28,1274800688,4707812
1671180887,204853,true,1269965879,28,1274673221,4707342
1671180899,204854,true,1269838895,28,1274545766,4706871
1671180911,204855,true,1269711924,28,1274418324,4706400
1671181211,204858,true,1269331087,28,1269965879,634792
1671181223,204859,true,1269204166,28,1269711924,507758
1671181235,204860,true,1269077258,28,1269584966,507708
1671181247,204861,true,1268950363,28,1269331087,380724
1671181259,204867,true,1268189260,28,1268950363,761103
1671181271,204870,true,1267808879,28,1268696611,887732
1671181295,204873,true,1267428612,28,1267935660,507048
1671181319,204874,true,1267301882,28,1267175165,-126717
1671181331,204881,true,1266415126,28,1266795088,379962
1671181343,204884,true,1266035277,28,1266415126,379849
1671181367,204887,true,1265655542,28,1265655542,0
1671181559,204889,true,1265402449,28,1259217452,-6184997
1671181595,204895,true,1264643473,28,1257958927,-6684546
1671181631,204898,true,1264264156,28,1256701660,-7562496
1671181643,204902,true,1263758577,28,1256324724,-7433853
1671181751,204904,true,1263505863,28,1252561586,-10944277
1671182027,204911,true,1262621763,28,1242830094,-19791669
1671182183,204915,true,1262116840,28,1237126489,-24990351
1671182195,204918,true,1261738281,28,1236755426,-24982855
1671182303,204920,true,1261485971,28,1232927611,-28558360
1671182387,204928,true,1260477236,28,1229972281,-30504955
1671182399,204931,true,1260099169,28,1229603363,-30495806
1671182843,204934,true,1259721215,28,1217247489,-42473726
1671182975,204937,true,1259343374,28,1214572622,-44770752
1671182999,204944,true,1258462186,28,1214086914,-44375272
1671183539,204947,true,1258084723,28,1212024823,-46059900
1671183623,204951,true,1257581615,28,1212024823,-45556792
1671183719,204953,true,1257330136,28,1211903632,-45426504
1671184367,204961,true,1256324724,28,1211661288,-44663436
1671184547,204964,true,1255947902,28,1211661288,-44286614
1671184835,204967,true,1255571193,28,1211540134,-44031059
1671185195,204970,true,1255194597,28,1211418992,-43775605
1671185471,204978,true,1254190893,28,1211176744,-43014149
1671186215,204981,true,1253814711,28,1210813464,-43001247
1671186647,204985,true,1253313311,28,1210450293,-42863018
1671187127,204988,true,1252937392,28,1210087230,-42850162
1671187571,204995,true,1252060687,28,1210087230,-41973457
1671189059,204999,true,1251559987,28,1208515217,-43044770
1671189251,205002,true,1251184595,28,1208394378,-42790217
1671189299,205006,true,1250684246,28,1208394378,-42289868
1671190007,205013,true,1249809117,28,1208636069,-41173048
1671190067,205017,true,1249309318,28,1208636069,-40673249
1671190103,205021,true,1248809719,28,1208636069,-40173650
1671190115,205024,true,1248435151,28,1208756933,-39678218
1671190127,205031,true,1247561596,28,1208756933,-38804663
1671190151,205035,true,1247062696,28,1208756933,-38305763
1671190163,205038,true,1246688652,28,1208756933,-37931719
1671190259,205041,true,1246314721,28,1208877808,-37436913
1671190355,205049,true,1245318117,28,1208998696,-36319421
1671190439,205052,true,1244944597,28,1209119596,-35825001
1671190559,205056,true,1244446743,28,1209361432,-35085311
1671191723,205058,true,1244197891,28,1211297862,-32900029
1671191819,205065,true,1243327301,28,1211418992,-31908309
1671191891,205067,true,1243078673,28,1211540134,-31538539
1671195479,205071,true,1242581566,28,1211661288,-30920278
1671197147,205074,true,1242208866,28,1211661288,-30547578
1671197699,205080,true,1241463801,28,1211661288,-29802513
1671197795,205083,true,1241091436,28,1211661288,-29430148
1671197975,205086,true,1240719184,28,1211540134,-29179050
1671198131,205089,true,1240347042,28,1211297862,-29049180
1671198359,205096,true,1239479146,28,1211176744,-28302402
1671198527,205098,true,1239231288,28,1211055639,-28175649
1671199007,205102,true,1238735719,28,1210571338,-28164381
1671199403,205105,true,1238364173,28,1210208239,-28155934
1671200327,205113,true,1237373927,28,1210087230,-27286697
1671200423,205115,true,1237126489,28,1209724277,-27402212
1671200435,205119,true,1236631763,28,1209603316,-27028447
1671200447,205123,true,1236137233,28,1209603316,-26533917
1671200483,205132,true,1235025266,28,1209603316,-25421950
1671200495,205134,true,1234778298,28,1209482368,-25295930
1671200531,205137,true,1234407939,28,1209482368,-24925571
1671200591,205141,true,1233914299,28,1209482368,-24431931
1671200639,205150,true,1232804331,28,1209361432,-23442899
1671200687,205151,true,1232681063,28,1209361432,-23319631
1671200807,205154,true,1232311333,28,1209361432,-22949901
1671200891,205158,true,1231818531,28,1209361432,-22457099
1671200903,205167,true,1230710449,28,1209361432,-21349017
1671201035,205168,true,1230587390,28,1209482368,-21105022
1671201143,205171,true,1230218288,28,1209603316,-20614972
1671201203,205175,true,1229726323,28,1209724277,-20002046
1671201275,205183,true,1228742985,28,1209966234,-18776751
1671202655,205184,true,1228620123,28,1213965517,-14654606
1671203303,205187,true,1228251610,28,1214329743,-13921867
1671203339,205191,true,1227760432,28,1214329743,-13430689
1671203483,205199,true,1226778666,28,1214329743,-12448923
1671203543,205201,true,1226533347,28,1214329743,-12203604
1671203567,205203,true,1226288077,28,1214208323,-12079754
1671203579,205207,true,1225797685,28,1214208323,-11589362
1671203663,205216,true,1224695018,28,1214208323,-10486695
1671203711,205217,true,1224572561,28,1214086914,-10485647
1671203975,205220,true,1224205262,28,1213722761,-10482501
1671203999,205224,true,1223715703,28,1213722761,-9992942
1671204071,205233,true,1222614909,28,1213480053,-9134856
1671204203,205235,true,1222370423,28,1213237393,-9133030
1671204215,205238,true,1222003785,28,1213116081,-8887704
1671204227,205242,true,1221515106,28,1213116081,-8399025
1671204311,205252,true,1220294262,28,1212873495,-7420767
1671204563,205254,true,1220050240,28,1212024823,-8025417
1671204575,205258,true,1219562342,28,1212024823,-7537519
1671204587,205261,true,1219196546,28,1211903632,-7292914
1671204599,205271,true,1217978020,28,1211903632,-6074388
1671204623,205274,true,1217612700,28,1211782454,-5830246
1671204635,205278,true,1217125776,28,1211661288,-5464488
1671204671,205282,true,1216639048,28,1211540134,-5098914
1671205127,205293,true,1215301547,28,1207911141,-7390406
1671205163,205295,true,1215058523,28,1207669595,-7388928
1671205259,205299,true,1214572622,28,1207065941,-7506681
1671205283,205302,true,1214208323,28,1206945247,-7263076
1671205367,205312,true,1212994782,28,1206341955,-6652827
1671205391,205314,true,1212752219,28,1206221333,-6530886
1671205847,205317,true,1212388466,28,1203931803,-8456663
1671206291,205319,true,1212146025,28,1202367786,-9778239
1671206831,205326,true,1211297862,28,1202367786,-8930076
1671206927,205328,true,1211055639,28,1202608272,-8447367
1671206939,205331,true,1210692395,28,1202488023,-8204372
1671206951,205333,true,1210450293,28,1202488023,-7962270
1671206987,205338,true,1209845249,28,1202367786,-7477463
1671207095,205340,true,1209603316,28,1201886960,-7716356
1671207179,205340,true,1209603316,28,1201406325,-8196991
1671207227,205342,true,1209361432,28,1201166080,-8195352
1671207275,205346,true,1208877808,28,1200925883,-7951925
1671207287,205348,true,1208636069,28,1200805802,-7830267
1671207323,205348,true,1208636069,28,1200685733,-7950336
1671207611,205348,true,1208636069,28,1199605656,-9030413
1671207731,205352,true,1208152735,28,1199125934,-9026801
1671207767,205354,true,1207911141,28,1199006033,-8905108
1671207827,205354,true,1207911141,28,1198646404,-9264737
1671208079,205354,true,1207911141,28,1197328683,-10582458
1671208787,205358,true,1207428097,28,1193503546,-13924551
1671209159,205360,true,1207186648,28,1193384208,-13802440
1671209519,205360,true,1207186648,28,1193026264,-14160384
1671209663,205360,true,1207186648,28,1192906973,-14279675
1671209675,205364,true,1206703894,28,1192906973,-13796921
1671209807,205366,true,1206462589,28,1192549173,-13913416
1671210011,205366,true,1206462589,28,1192072272,-14390317
1671210083,205367,true,1206341955,28,1191833894,-14508061
1671210119,205371,true,1205859539,28,1191714722,-14144817
1671210155,205373,true,1205618403,28,1191595563,-14022840
1671210203,205374,true,1205497854,28,1191476415,-14021439
1671210239,205374,true,1205497854,28,1191357279,-14140575
1671210251,205378,true,1205015775,28,1191357279,-13658496
1671210407,205380,true,1204774808,28,1191119044,-13655764
1671210419,205380,true,1204774808,28,1190999944,-13774864
1671210563,205380,true,1204774808,28,1190999944,-13774864
1671210827,205384,true,1204293018,28,1190761779,-13531239
1671210995,205385,true,1204172601,28,1190523663,-13648938
1671211055,205386,true,1204052196,28,1190523663,-13528533
1671211391,205386,true,1204052196,28,1190166577,-13885619
1671211643,205390,true,1203570695,28,1190404622,-13166073
1671212003,205391,true,1203450350,28,1191238156,-12212194
1671212171,205391,true,1203450350,28,1191476415,-11973935
1671212291,205391,true,1203450350,28,1191476415,-11973935
1671212303,205395,true,1202969091,28,1191476415,-11492676
1671212315,205396,true,1202848806,28,1191476415,-11372391
1671214103,205396,true,1202848806,28,1192668428,-10180378
1671214127,205396,true,1202848806,28,1192787695,-10061111
1671214151,205400,true,1202367786,28,1192787695,-9580091
1671214163,205401,true,1202247562,28,1192787695,-9459867
1671214211,205401,true,1202247562,28,1192906973,-9340589
1671214259,205400,true,1202367786,28,1192906973,-9460813
1671214895,205404,true,1201886960,28,1193861633,-8025327
1671215483,205405,true,1201766783,28,1194817057,-6949726
1671215939,205405,true,1201766783,28,1195414585,-6352198
1671216263,205405,true,1201766783,28,1195414585,-6352198
1671216479,205409,true,1201286196,28,1195414585,-5871611
1671216563,205410,true,1201166080,28,1195414585,-5751495
1671217055,205410,true,1201166080,28,1195414585,-5751495
1671217187,205410,true,1201166080,28,1195414585,-5751495
1671217379,205414,true,1200685733,28,1195414585,-5271148
1671217427,205415,true,1200565677,28,1195414585,-5151092
1671217583,205415,true,1200565677,28,1195414585,-5151092
1671217595,205415,true,1200565677,28,1195414585,-5151092
1671217667,205418,true,1200205579,28,1195414585,-4790994
1671219719,205419,true,1200085571,28,1195892822,-4192749
1671220199,205419,true,1200085571,28,1195892822,-4192749
1671220247,205419,true,1200085571,28,1196012412,-4073159
1671220259,205422,true,1199725617,28,1196012412,-3713205
1671220295,205423,true,1199605656,28,1196132013,-3473643
1671220379,205422,true,1199725617,28,1196251626,-3473991
1671221639,205422,true,1199725617,28,1199245847,-479770
1671221687,205423,true,1199605656,28,1199365771,-239885
1671222119,205425,true,1199365771,28,1200205579,839808
1671222251,205424,true,1199485708,28,1200205579,719871
1671222287,205424,true,1199485708,28,1200205579,719871
1671222323,205426,true,1199245847,28,1200325600,1079753
1671222335,205427,true,1199125934,28,1200325600,1199666
1671222407,205426,true,1199245847,28,1200445632,1199785
1671222431,205425,true,1199365771,28,1200565677,1199906
1671223571,205426,true,1199245847,28,1204895285,5649438
1671223847,205428,true,1199006033,28,1205859539,6853506
1671224255,205427,true,1199125934,28,1206945247,7819313
1671224507,205427,true,1199125934,28,1206945247,7819313
1671224519,205428,true,1199006033,28,1206945247,7939214
1671224555,205431,true,1198646404,28,1206945247,8298843
1671224591,205430,true,1198766268,28,1206945247,8178979
1671225311,205430,true,1198766268,28,1205377316,6611048
1671225395,205431,true,1198646404,28,1205136276,6489872
1671225851,205434,true,1198286882,28,1203931803,5644921
1671225923,205433,true,1198406710,28,1203691053,5284343
1671226043,205434,true,1198286882,28,1203450350,5163468
1671226343,205435,true,1198167065,28,1202488023,4320958
1671226355,205437,true,1197927467,28,1202488023,4560556
1671226403,205436,true,1198047260,28,1202367786,4320526
1671226451,205437,true,1197927467,28,1202367786,4440319
1671226463,205438,true,1197807687,28,1202247562,4439875
1671226475,205440,true,1197568161,28,1202247562,4679401
1671226523,205439,true,1197687918,28,1202127349,4439431
1671226655,205440,true,1197568161,28,1201766783,4198622
1671227027,205441,true,1197448416,28,1200685733,3237317
1671227159,205443,true,1197208962,28,1200325600,3116638
1671227207,205442,true,1197328683,28,1200205579,2876896
1671227663,205444,true,1197089253,28,1199006033,1916780
1671227675,205444,true,1197089253,28,1199006033,1916780
1671227903,205446,true,1196849871,28,1198406710,1556839
1671230051,205445,true,1196969556,28,1196251626,-717930
1671230063,205446,true,1196849871,28,1196251626,-598245
1671230075,205446,true,1196849871,28,1196251626,-598245
1671230087,205447,true,1196730198,28,1196251626,-478572
1671230135,205448,true,1196610537,28,1196012412,-598125
1671230267,205449,true,1196490888,28,1195653680,-837208
1671230291,205449,true,1196490888,28,1195534126,-956762
1671230339,205451,true,1196251626,28,1195175538,-1076088
1671230483,205453,true,1196012412,28,1194219827,-1792585
1671230495,205454,true,1195892822,28,1194219827,-1672995
1671230699,205454,true,1195892822,28,1193145567,-2747255
1671230711,205456,true,1195653680,28,1193026264,-2627416
1671230915,205458,true,1195414585,28,1191833894,-3580691
1671231287,205459,true,1195295055,28,1189690629,-5604426
1671231299,205458,true,1195414585,28,1189690629,-5723956
1671231323,205459,true,1195295055,28,1189571672,-5723383
1671231335,205460,true,1195175538,28,1189452727,-5722811
1671231347,205462,true,1194936538,28,1189333794,-5602744
1671231467,205463,true,1194817057,28,1188026311,-6790746
1671231527,205463,true,1194817057,28,1187313745,-7503312
1671231551,205465,true,1194578129,28,1187076318,-7501811
1671231623,205468,true,1194219827,28,1186245696,-7974131
1671231743,205468,true,1194219827,28,1185060103,-9159724
1671231803,205469,true,1194100417,28,1184349316,-9751101
1671231815,205471,true,1193861633,28,1184112481,-9749152
1671231827,205473,true,1193622897,28,1183994082,-9628815
1671231935,205475,true,1193384208,28,1182692469,-10691739
1671231971,205476,true,1193264881,28,1182337733,-10927148
1671231983,205477,true,1193145567,28,1182219511,-10926056
1671232055,205479,true,1192906973,28,1181510427,-11396546
1671232067,205481,true,1192668428,28,1181392288,-11276140
1671232211,205482,true,1192549173,28,1180447599,-12101574
1671232307,205482,true,1192549173,28,1179621616,-12927557
1671232343,205484,true,1192310699,28,1179267801,-13042898
1671232355,205486,true,1192072272,28,1179149886,-12922386
1671232427,205487,true,1191953077,28,1178324811,-13628266
1671232439,205488,true,1191833894,28,1178206990,-13626904
1671232475,205491,true,1191476415,28,1177735825,-13740590
1671232535,205493,true,1191238156,28,1177029431,-14208725
1671232547,205495,true,1190999944,28,1176911740,-14088204
1671232607,205496,true,1190880856,28,1176205840,-14675016
1671232883,205498,true,1190642715,28,1173151829,-17490886
1671232907,205500,true,1190404622,28,1172799954,-17604668
1671232919,205502,true,1190166577,28,1172682686,-17483891
1671232967,205504,true,1189928579,28,1172096520,-17832059
1671232979,205507,true,1189571672,28,1171979322,-17592350
1671233003,205509,true,1189333794,28,1171627799,-17705995
1671233303,205511,true,1189095962,28,1169053180,-20042782
1671233447,205512,true,1188977065,28,1168001558,-20975507
1671233627,205515,true,1188620443,28,1166484218,-22136225
1671233639,205517,true,1188382755,28,1166367581,-22015174
1671233663,205520,true,1188026311,28,1166250956,-21775355
1671233723,205522,true,1187788741,28,1165784572,-22004169
1671233771,205525,true,1187432476,28,1165434907,-21997569
1671233951,205527,true,1187195025,28,1164270113,-22924912
1671233963,205530,true,1186838938,28,1164153697,-22685241
1671233987,205532,true,1186601606,28,1164037294,-22564312
1671234011,205536,true,1186127084,28,1163920901,-22206183
1671234035,205538,true,1185889894,28,1163804521,-22085373
1671234167,205540,true,1185652751,28,1163339116,-22313635
1671234851,205542,true,1185415656,28,1162292634,-23123022
1671234923,205546,true,1184941609,28,1162176416,-22765193
1671235079,205547,true,1184823126,28,1162176416,-22646710
1671235115,205549,true,1184586197,28,1162176416,-22409781
1671235283,205552,true,1184230893,28,1162292634,-21938259
1671235307,205555,true,1183875694,28,1162408863,-21466831
1671235487,205557,true,1183638955,28,1162873896,-20765059
1671235499,205559,true,1183402262,28,1162873896,-20528366
1671235571,205561,true,1183165617,28,1163106483,-20059134
1671235595,205564,true,1182810739,28,1163222793,-19587946
1671235691,205566,true,1182574212,28,1163571795,-19002417
1671235763,205568,true,1182337733,28,1163804521,-18533212
1671235775,205570,true,1182101301,28,1163920901,-18180400
1671235799,205573,true,1181746741,28,1163920901,-17825840
1671235811,205574,true,1181628578,28,1164037294,-17591284
1671235823,205576,true,1181392288,28,1164037294,-17354994
1671235847,205579,true,1181037941,28,1164153697,-16884244
1671235871,205582,true,1180683701,28,1164270113,-16413588
1671235931,205583,true,1180565644,28,1164502978,-16062666
1671236315,205585,true,1180329566,28,1166367581,-13961985
1671236327,205587,true,1180093536,28,1166484218,-13609318
1671236411,205591,true,1179621616,28,1166834198,-12787418
1671236711,205592,true,1179503666,28,1168235170,-11268496
1671236783,205594,true,1179267801,28,1168585675,-10682126
1671236843,205597,true,1178914091,28,1168819404,-10094687
1671238151,205601,true,1178442643,28,1171510648,-6931995
1671238295,205603,true,1178206990,28,1171510648,-6696342
1671238895,205604,true,1178089181,28,1171510648,-6578533
1671239303,205608,true,1177618063,28,1171510648,-6107415
1671239315,205611,true,1177264849,28,1171627799,-5637050
1671239687,205613,true,1177029431,28,1171627799,-5401632
1671240371,205615,true,1176794060,28,1171862136,-4931924
1671241463,205618,true,1176441093,28,1171979322,-4461771
1671241691,205621,true,1176088231,28,1171979322,-4108909
1671241835,205623,true,1175853049,28,1171979322,-3873727
1671242147,205624,true,1175735475,28,1171979322,-3756153
1671242411,205627,true,1175382825,28,1171862136,-3520689
1671242471,205630,true,1175030281,28,1171862136,-3168145
1671242687,205632,true,1174795310,28,1171862136,-2933174
1671242783,205633,true,1174677842,28,1171862136,-2815706
1671242807,205636,true,1174325509,28,1171862136,-2463373
1671242819,205639,true,1173973282,28,1171862136,-2111146
1671242843,205641,true,1173738522,28,1171744962,-1993560
1671242903,205642,true,1173621160,28,1171744962,-1876198
1671242963,205645,true,1173269144,28,1171627799,-1641345
1671243287,205648,true,1172917234,28,1171042161,-1875073
1671243299,205649,true,1172799954,28,1171042161,-1757793
1671243719,205651,true,1172565429,28,1170105748,-2459681
1671243803,205654,true,1172213730,28,1169988750,-2224980
1671243863,205657,true,1171862136,28,1169754787,-2107349
1671243947,205658,true,1171744962,28,1169520871,-2224091
1671244007,205660,true,1171510648,28,1169403931,-2106717
1671244055,205663,true,1171159265,28,1169287002,-1872263
1671244163,205666,true,1170807987,28,1168936286,-1871701
1671244307,205667,true,1170690918,28,1168468828,-2222090
1671244499,205670,true,1170339781,28,1167884769,-2455012
1671244511,205671,true,1170222759,28,1167767992,-2454767
1671244559,205673,true,1169988750,28,1167651227,-2337523
1671244571,205675,true,1169754787,28,1167651227,-2103560
1671244595,205676,true,1169637823,28,1167534474,-2103349
1671244607,205677,true,1169520871,28,1167534474,-1986397
1671244727,205678,true,1169403931,28,1167417732,-1986199
1671244955,205680,true,1169170085,28,1167301002,-1869083
1671245051,205682,true,1168936286,28,1167184283,-1752003
1671245231,205682,true,1168936286,28,1167184283,-1752003
1671245243,205684,true,1168702534,28,1167184283,-1518251
1671245255,205686,true,1168468828,28,1167184283,-1284545
1671245327,205687,true,1168351993,28,1167184283,-1167710
1671245471,205688,true,1168235170,28,1167301002,-934168
1671245687,205688,true,1168235170,28,1167534474,-700696
1671245699,205688,true,1168235170,28,1167534474,-700696
1671245855,205690,true,1168001558,28,1167767992,-233566
1671245867,205690,true,1168001558,28,1167767992,-233566
1671246107,205690,true,1168001558,28,1168468828,467270
1671246119,205690,true,1168001558,28,1168468828,467270
1671246371,205691,true,1167884769,28,1169287002,1402233
1671246419,205691,true,1167884769,28,1169403931,1519162
1671246803,205692,true,1167767992,28,1170222759,2454767
1671247367,205691,true,1167884769,28,1171276381,3391612
1671247427,205691,true,1167884769,28,1171276381,3391612
1671247667,205691,true,1167884769,28,1171627799,3743030
1671248951,205692,true,1167767992,28,1171744962,3976970
1671248975,205691,true,1167884769,28,1171862136,3977367
1671248987,205691,true,1167884769,28,1171862136,3977367
1671250499,205691,true,1167884769,28,1174912789,7028020
1671251327,205690,true,1168001558,28,1175382825,7381267
1671251375,205690,true,1168001558,28,1175500363,7498805
1671251411,205689,true,1168118358,28,1175500363,7382005
1671251423,205688,true,1168235170,28,1175500363,7265193
1671252299,205687,true,1168351993,28,1176205840,7853847
1671253175,205686,true,1168468828,28,1176911740,8442912
1671253211,205686,true,1168468828,28,1176911740,8442912
1671253367,205685,true,1168585675,28,1177029431,8443756
1671253379,205684,true,1168702534,28,1177029431,8326897
1671253691,205682,true,1168936286,28,1177147134,8210848
1671254639,205682,true,1168936286,28,1177618063,8681777
1671257195,205681,true,1169053180,28,1177853599,8800419
1671257327,205679,true,1169287002,28,1177853599,8566597
1671258335,205678,true,1169403931,28,1177735825,8331894
1671258923,205678,true,1169403931,28,1177618063,8214132
1671258971,205677,true,1169520871,28,1177618063,8097192
1671258983,205675,true,1169754787,28,1177618063,7863276
1671259007,205674,true,1169871762,28,1177618063,7746301
1671259019,205672,true,1170105748,28,1177618063,7512315
1671259283,205670,true,1170339781,28,1178324811,7985030
1671263255,205668,true,1170573861,28,1181746741,11172880
1671263435,205667,true,1170690918,28,1181746741,11055823
1671264299,205666,true,1170807987,28,1181746741,10938754
1671264863,205664,true,1171042161,28,1181746741,10704580
1671265307,205662,true,1171276381,28,1181746741,10470360
1671266555,205661,true,1171393508,28,1181746741,10353233
1671267995,205660,true,1171510648,28,1181746741,10236093
1671268355,205658,true,1171744962,28,1181746741,10001779
1671268679,205656,true,1171979322,28,1181746741,9767419
1671268883,205655,true,1172096520,28,1181746741,9650221
1671268895,205654,true,1172213730,28,1181746741,9533011
1671269015,205652,true,1172448184,28,1181746741,9298557
1671269159,205651,true,1172565429,28,1181746741,9181312
1671269507,205650,true,1172682686,28,1181392288,8709602
1671269735,205649,true,1172799954,28,1181274161,8474207
1671269807,205648,true,1172917234,28,1181156045,8238811
1671269903,205646,true,1173151829,28,1181037941,7886112
1671269915,205646,true,1173151829,28,1181037941,7886112
1671269975,205645,true,1173269144,28,1180919849,7650705
1671271283,205644,true,1173386471,28,1179385727,5999256
1671273587,205642,true,1173621160,28,1179149886,5528726
1671274463,205643,true,1173503810,28,1178678344,5174534
1671274475,205642,true,1173621160,28,1178678344,5057184
1671274523,205641,true,1173738522,28,1178678344,4939822
1671274571,205640,true,1173855896,28,1178678344,4822448
1671274667,205640,true,1173855896,28,1178796211,4940315
1671274763,205639,true,1173973282,28,1179031983,5058701
1671275183,205637,true,1174208088,28,1180447599,6239511
1671276023,205636,true,1174325509,28,1183875694,9550185
1671276107,205635,true,1174442942,28,1184230893,9787951
1671276167,205635,true,1174442942,28,1184467751,10024809
1671276491,205633,true,1174677842,28,1185178609,10500767
1671276995,205632,true,1174795310,28,1185060103,10264793
1671277163,205631,true,1174912789,28,1184941609,10028820
1671277343,205631,true,1174912789,28,1184704656,9791867
1671277463,205629,true,1175147784,28,1184704656,9556872
1671277499,205628,true,1175265298,28,1184586197,9320899
1671277571,205628,true,1175265298,28,1184586197,9320899
1671277667,205627,true,1175382825,28,1184467751,9084926
1671277895,205625,true,1175617913,28,1184230893,8612980
1671277931,205624,true,1175735475,28,1184230893,8495418
1671277943,205624,true,1175735475,28,1184230893,8495418
1671278051,205624,true,1175735475,28,1183994082,8258607
1671279947,205622,true,1175970634,28,1182101301,6130667
1671280643,205621,true,1176088231,28,1182101301,6013070
1671281015,205621,true,1176088231,28,1182101301,6013070
1671281135,205621,true,1176088231,28,1182101301,6013070
1671281147,205619,true,1176323460,28,1182101301,5777841
1671281243,205618,true,1176441093,28,1182101301,5660208
1671281459,205618,true,1176441093,28,1181983102,5542009
1671283667,205617,true,1176558737,28,1180683701,4124964
1671283691,205616,true,1176676393,28,1180683701,4007308
1671285263,205615,true,1176794060,28,1179621616,2827556
1671285731,205614,true,1176911740,28,1179503666,2591926
1671286031,205614,true,1176911740,28,1179503666,2591926
1671286991,205612,true,1177147134,28,1179503666,2356532
1671287087,205611,true,1177264849,28,1179503666,2238817
1671288611,205611,true,1177264849,28,1179503666,2238817
1671289871,205610,true,1177382575,28,1179503666,2121091
1671289895,205608,true,1177618063,28,1179503666,1885603
1671289943,205607,true,1177735825,28,1179503666,1767841
1671290771,205607,true,1177735825,28,1179267801,1531976
1671290819,205606,true,1177853599,28,1179267801,1414202
1671291407,205604,true,1178089181,28,1179031983,942802
1671291503,205603,true,1178206990,28,1179031983,824993
1671291743,205603,true,1178206990,28,1178914091,707101
1671293567,205602,true,1178324811,28,1178914091,589280
1671294035,205601,true,1178442643,28,1178796211,353568
1671294047,205600,true,1178560488,28,1178796211,235723
1671295619,205600,true,1178560488,28,1178442643,-117845
1671296051,205599,true,1178678344,28,1178442643,-235701
1671296135,205598,true,1178796211,28,1178442643,-353568
1671296255,205597,true,1178914091,28,1178442643,-471448
1671296267,205596,true,1179031983,28,1178442643,-589340
1671296423,205596,true,1179031983,28,1178442643,-589340
1671297203,205595,true,1179149886,28,1178442643,-707243
1671297467,205594,true,1179267801,28,1178442643,-825158
1671297611,205594,true,1179267801,28,1178442643,-825158
1671298691,205593,true,1179385727,28,1178442643,-943084
1671298703,205592,true,1179503666,28,1178442643,-1061023
1671298739,205591,true,1179621616,28,1178442643,-1178973
1671300119,205592,true,1179503666,28,1176205840,-3297826
1671300623,205592,true,1179503666,28,1175500363,-4003303
1671302351,205591,true,1179621616,28,1175500363,-4121253
1671304067,205590,true,1179739579,28,1175617913,-4121666
1671304103,205591,true,1179621616,28,1175617913,-4003703
1671304163,205591,true,1179621616,28,1175735475,-3886141
1671305483,205589,true,1179857553,28,1176088231,-3769322
1671306983,205589,true,1179857553,28,1176205840,-3651713
1671308903,205589,true,1179857553,28,1176205840,-3651713
1671309323,205589,true,1179857553,28,1176205840,-3651713
1671311423,205589,true,1179857553,28,1176205840,-3651713
1671311891,205589,true,1179857553,28,1176441093,-3416460
1671314411,205589,true,1179857553,28,1178089181,-1768372
1671314603,205589,true,1179857553,28,1178089181,-1768372
1671317171,205588,true,1179975538,28,1177382575,-2592963
1671317195,205588,true,1179975538,28,1177500313,-2475225
1671317267,205588,true,1179975538,28,1177500313,-2475225
1671317279,205589,true,1179857553,28,1177500313,-2357240
1671317939,205587,true,1180093536,28,1178442643,-1650893
1671317951,205587,true,1180093536,28,1178560488,-1533048
1671317963,205588,true,1179975538,28,1178560488,-1415050
1671317987,205588,true,1179975538,28,1178560488,-1415050
1671318383,205585,true,1180329566,28,1180093536,-236030
1671318419,205586,true,1180211545,28,1180211545,0
1671318431,205586,true,1180211545,28,1180211545,0
1671318575,205586,true,1180211545,28,1180801769,590224
1671319763,205583,true,1180565644,28,1184586197,4020553
1671319919,205583,true,1180565644,28,1184704656,4139012
1671320063,205584,true,1180447599,28,1184823126,4375527
1671320723,205584,true,1180447599,28,1184941609,4494010
1671321755,205582,true,1180683701,28,1185771317,5087616
1671321779,205582,true,1180683701,28,1185771317,5087616
1671323063,205582,true,1180683701,28,1186127084,5443383
1671323159,205583,true,1180565644,28,1186127084,5561440
1671324311,205581,true,1180801769,28,1186127084,5325315
1671326063,205581,true,1180801769,28,1186127084,5325315
1671326567,205581,true,1180801769,28,1186127084,5325315
1671326579,205582,true,1180683701,28,1186127084,5443383
1671326687,205579,true,1181037941,28,1186127084,5089143
1671326819,205580,true,1180919849,28,1186127084,5207235
1671326831,205580,true,1180919849,28,1186127084,5207235
1671326915,205581,true,1180801769,28,1186008483,5206714
1671331307,205578,true,1181156045,28,1184349316,3193271
1671334811,205579,true,1181037941,28,1184467751,3429810
1671336011,205579,true,1181037941,28,1184467751,3429810
1671336251,205579,true,1181037941,28,1184467751,3429810
1671336275,205577,true,1181274161,28,1184586197,3312036
1671336311,205577,true,1181274161,28,1184586197,3312036
1671336611,205577,true,1181274161,28,1184704656,3430495
1671336659,205578,true,1181156045,28,1184823126,3667081
1671336683,205575,true,1181510427,28,1184823126,3312699
1671336719,205575,true,1181510427,28,1184823126,3312699
1671336731,205575,true,1181510427,28,1184823126,3312699
1671336743,205575,true,1181510427,28,1184941609,3431182
1671336863,205572,true,1181864916,28,1185178609,3313693
1671336875,205572,true,1181864916,28,1185178609,3313693
1671336959,205572,true,1181864916,28,1185534198,3669282
1671337343,205573,true,1181746741,28,1186838938,5092197
1671337427,205570,true,1182101301,28,1187076318,4975017
1671337667,205570,true,1182101301,28,1188026311,5925010
1671337679,205571,true,1181983102,28,1188145114,6162012
1671337811,205571,true,1181983102,28,1188620443,6637341
1671337835,205568,true,1182337733,28,1188739305,6401572
1671337859,205568,true,1182337733,28,1188858179,6520446
1671337895,205568,true,1182337733,28,1188977065,6639332
1671338051,205568,true,1182337733,28,1189690629,7352896
1671338075,205566,true,1182574212,28,1189809598,7235386
1671338315,205565,true,1182692469,28,1190880856,8188387
1671338483,205565,true,1182692469,28,1191595563,8903094
1671340223,205565,true,1182692469,28,1193503546,10811077
1671340247,205563,true,1182929020,28,1193503546,10574526
1671340343,205562,true,1183047313,28,1193503546,10456233
1671340511,205563,true,1182929020,28,1193503546,10574526
1671340547,205563,true,1182929020,28,1193384208,10455188
1671340655,205560,true,1183283934,28,1193384208,10100274
1671341255,205559,true,1183402262,28,1192906973,9504711
1671341279,205559,true,1183402262,28,1192906973,9504711
1671341675,205560,true,1183283934,28,1192549173,9265239
1671341699,205557,true,1183638955,28,1192549173,8910218
1671341915,205556,true,1183757319,28,1192310699,8553380
1671341951,205556,true,1183757319,28,1192191480,8434161
1671341975,205556,true,1183757319,28,1192191480,8434161
1671342251,205554,true,1183994082,28,1191953077,7958995
1671342815,205553,true,1184112481,28,1191357279,7244798
1671343283,205553,true,1184112481,28,1190999944,6887463
1671343583,205553,true,1184112481,28,1190761779,6649298
1671344015,205550,true,1184467751,28,1190404622,5936871
1671344243,205550,true,1184467751,28,1190285594,5817843
1671344795,205550,true,1184467751,28,1190166577,5698826
1671344807,205550,true,1184467751,28,1190166577,5698826
1671344819,205547,true,1184823126,28,1190166577,5343451
1671344843,205547,true,1184823126,28,1190047572,5224446
1671344855,205547,true,1184823126,28,1190047572,5224446
1671345623,205547,true,1184823126,28,1189214872,4391746
1671345839,205544,true,1185178609,28,1188858179,3679570
1671345887,205544,true,1185178609,28,1188858179,3679570
1671347075,205544,true,1185178609,28,1187551219,2372610
1671347891,205544,true,1185178609,28,1187195025,2016416
1671348563,205542,true,1185415656,28,1187195025,1779369
1671349283,205542,true,1185415656,28,1187195025,1779369
1671349367,205542,true,1185415656,28,1187195025,1779369
1671349643,205542,true,1185415656,28,1187195025,1779369
1671350099,205539,true,1185771317,28,1187195025,1423708
1671350279,205539,true,1185771317,28,1187195025,1423708
1671351827,205539,true,1185771317,28,1187195025,1423708
1671353363,205539,true,1185771317,28,1187195025,1423708
1671355379,205537,true,1186008483,28,1187195025,1186542
1671355427,205536,true,1186127084,28,1187195025,1067941
1671355535,205536,true,1186127084,28,1187195025,1067941
1671355547,205536,true,1186127084,28,1187195025,1067941
1671355571,205534,true,1186364321,28,1187195025,830704
1671355607,205534,true,1186364321,28,1187195025,830704
1671355619,205534,true,1186364321,28,1187195025,830704
1671355667,205534,true,1186364321,28,1186957622,593301
1671355715,205532,true,1186601606,28,1186838938,237332
1671355727,205532,true,1186601606,28,1186838938,237332
1671355835,205532,true,1186601606,28,1186364321,-237285
1671355847,205533,true,1186482957,28,1186245696,-237261
1671355871,205531,true,1186720266,28,1186245696,-474570
1671355943,205531,true,1186720266,28,1185889894,-830372
1671356135,205532,true,1186601606,28,1184704656,-1896950
1671356603,205532,true,1186601606,28,1181864916,-4736690
1671357443,205531,true,1186720266,28,1177029431,-9690835
1671359027,205531,true,1186720266,28,1176676393,-10043873
1671359075,205532,true,1186601606,28,1176676393,-9925213
1671359315,205533,true,1186482957,28,1176911740,-9571217
1671360563,205531,true,1186720266,28,1177853599,-8866667
1671360635,205531,true,1186720266,28,1177971384,-8748882
1671360959,205532,true,1186601606,28,1178206990,-8394616
1671361835,205532,true,1186601606,28,1178324811,-8276795
1671361883,205531,true,1186720266,28,1178324811,-8395455
1671361955,205532,true,1186601606,28,1178324811,-8276795
1671362027,205532,true,1186601606,28,1178324811,-8276795
1671362051,205533,true,1186482957,28,1178324811,-8158146
1671362747,205533,true,1186482957,28,1178560488,-7922469
1671363071,205533,true,1186482957,28,1178678344,-7804613
1671363335,205534,true,1186364321,28,1178914091,-7450230
1671363419,205534,true,1186364321,28,1178914091,-7450230
1671363491,205534,true,1186364321,28,1179031983,-7332338
1671363563,205535,true,1186245696,28,1179149886,-7095810
1671363611,205535,true,1186245696,28,1179149886,-7095810
1671363623,205536,true,1186127084,28,1179267801,-6859283
1671363935,205536,true,1186127084,28,1179621616,-6505468
1671363971,205536,true,1186127084,28,1179621616,-6505468
1671364487,205537,true,1186008483,28,1180211545,-5796938
1671364739,205537,true,1186008483,28,1180565644,-5442839
1671365075,205537,true,1186008483,28,1180801769,-5206714
1671365927,205538,true,1185889894,28,1180919849,-4970045
1671366239,205538,true,1185889894,28,1180919849,-4970045
1671366287,205539,true,1185771317,28,1180919849,-4851468
1671367727,205539,true,1185771317,28,1180919849,-4851468
1671367907,205539,true,1185771317,28,1180919849,-4851468
1671369959,205540,true,1185652751,28,1180919849,-4732902
1671370403,205540,true,1185652751,28,1180919849,-4732902
1671370631,205540,true,1185652751,28,1180919849,-4732902
1671371015,205540,true,1185652751,28,1180919849,-4732902
1671371819,205541,true,1185534198,28,1180919849,-4614349
1671373391,205541,true,1185534198,28,1180919849,-4614349
1671373403,205541,true,1185534198,28,1180919849,-4614349
1671373427,205541,true,1185534198,28,1180919849,-4614349
1671373451,205542,true,1185415656,28,1180919849,-4495807
1671373463,205543,true,1185297127,28,1180919849,-4377278
1671373475,205543,true,1185297127,28,1180919849,-4377278
1671374591,205544,true,1185178609,28,1178678344,-6500265
1671376139,205545,true,1185060103,28,1177382575,-7677528
1671378995,205546,true,1184941609,28,1177382575,-7559034
1671379067,205546,true,1184941609,28,1177382575,-7559034
1671379091,205547,true,1184823126,28,1177382575,-7440551
1671379103,205549,true,1184586197,28,1177382575,-7203622
1671379127,205550,true,1184467751,28,1177382575,-7085176
1671379331,205551,true,1184349316,28,1177264849,-7084467
1671380267,205552,true,1184230893,28,1176911740,-7319153
1671380735,205553,true,1184112481,28,1176676393,-7436088
1671381191,205555,true,1183875694,28,1176558737,-7316957
1671381623,205555,true,1183875694,28,1176558737,-7316957
1671385151,205556,true,1183757319,28,1176558737,-7198582
1671386519,205558,true,1183520603,28,1176558737,-6961866
1671386531,205559,true,1183402262,28,1176676393,-6725869
1671386555,205560,true,1183283934,28,1176676393,-6607541
1671386567,205561,true,1183165617,28,1176676393,-6489224
1671386603,205561,true,1183165617,28,1176794060,-6371557
1671386615,205563,true,1182929020,28,1176911740,-6017280
1671386999,205562,true,1183047313,28,1179149886,-3897427
1671387827,205563,true,1182929020,28,1183875694,946674
1671387863,205563,true,1182929020,28,1184112481,1183461
1671388031,205564,true,1182810739,28,1184941609,2130870
1671388739,205564,true,1182810739,28,1186245696,3434957
1671388763,205565,true,1182692469,28,1186245696,3553227
1671388799,205565,true,1182692469,28,1186245696,3553227
1671388823,205566,true,1182574212,28,1186127084,3552872
1671389123,205566,true,1182574212,28,1185771317,3197105
1671389327,205567,true,1182455966,28,1185534198,3078232
1671389339,205567,true,1182455966,28,1185415656,2959690
1671389435,205569,true,1182219511,28,1185297127,3077616
1671389447,205568,true,1182337733,28,1185297127,2959394
1671389471,205569,true,1182219511,28,1185178609,2959098
1671389483,205570,true,1182101301,28,1185178609,3077308
1671389495,205571,true,1181983102,28,1185178609,3195507
1671389555,205571,true,1181983102,28,1184941609,2958507
1671389567,205572,true,1181864916,28,1184823126,2958210
1671389651,205573,true,1181746741,28,1184586197,2839456
1671389663,205574,true,1181628578,28,1184467751,2839173
1671390143,205575,true,1181510427,28,1182692469,1182042
1671393707,205575,true,1181510427,28,1180211545,-1298882
1671393755,205575,true,1181510427,28,1180329566,-1180861
1671394703,205577,true,1181274161,28,1181510427,236266
1671396179,205577,true,1181274161,28,1182574212,1300051
1671396227,205577,true,1181274161,28,1182574212,1300051
1671396371,205577,true,1181274161,28,1182574212,1300051
1671396755,205578,true,1181156045,28,1182574212,1418167
1671396779,205578,true,1181156045,28,1182692469,1536424
1671397655,205578,true,1181156045,28,1182810739,1654694
1671397691,205578,true,1181156045,28,1182810739,1654694
1671397787,205579,true,1181037941,28,1182929020,1891079
1671398171,205579,true,1181037941,28,1183165617,2127676
1671398579,205579,true,1181037941,28,1183402262,2364321
1671399635,205579,true,1181037941,28,1183638955,2601014
1671402911,205580,true,1180919849,28,1183638955,2719106
1671402923,205580,true,1180919849,28,1183757319,2837470
1671402959,205580,true,1180919849,28,1183757319,2837470
1671402971,205580,true,1180919849,28,1183757319,2837470
1671403679,205580,true,1180919849,28,1186364321,5444472
1671403703,205579,true,1181037941,28,1186482957,5445016
1671403715,205579,true,1181037941,28,1186482957,5445016
1671403727,205579,true,1181037941,28,1186482957,5445016
1671404603,205579,true,1181037941,28,1187788741,6750800
1671404675,205578,true,1181156045,28,1188026311,6870266
1671404711,205578,true,1181156045,28,1188026311,6870266
1671404975,205577,true,1181274161,28,1187907520,6633359
1671405071,205576,true,1181392288,28,1187788741,6396453
1671405095,205576,true,1181392288,28,1187788741,6396453
1671405239,205575,true,1181510427,28,1187669974,6159547
1671405251,205573,true,1181746741,28,1187669974,5923233
1671405263,205573,true,1181746741,28,1187669974,5923233
1671405287,205572,true,1181864916,28,1187669974,5805058
1671406199,205571,true,1181983102,28,1189214872,7231770
1671406727,205569,true,1182219511,28,1190285594,8066083
1671407243,205568,true,1182337733,28,1190523663,8185930
1671407291,205568,true,1182337733,28,1190523663,8185930
1671407495,205567,true,1182455966,28,1190523663,8067697
1671407507,205565,true,1182692469,28,1190523663,7831194
1671407579,205565,true,1182692469,28,1190404622,7712153
1671407591,205564,true,1182810739,28,1190404622,7593883
1671407615,205564,true,1182810739,28,1190404622,7593883
1671407675,205562,true,1183047313,28,1190404622,7357309
1671407687,205562,true,1183047313,28,1190285594,7238281
1671407723,205561,true,1183165617,28,1190285594,7119977
1671407735,205561,true,1183165617,28,1190285594,7119977
1671407819,205560,true,1183283934,28,1190047572,6763638
1671407879,205560,true,1183283934,28,1189928579,6644645
1671407891,205559,true,1183402262,28,1189928579,6526317
1671409331,205559,true,1183402262,28,1185771317,2369055
1671409403,205558,true,1183520603,28,1185534198,2013595
1671409427,205558,true,1183520603,28,1185534198,2013595
1671409607,205558,true,1183520603,28,1185415656,1895053
1671409619,205558,true,1183520603,28,1185415656,1895053
1671409643,205557,true,1183638955,28,1185415656,1776701
1671409679,205556,true,1183757319,28,1185415656,1658337
1671409691,205556,true,1183757319,28,1185415656,1658337
1671409703,205556,true,1183757319,28,1185415656,1658337
1671409751,205555,true,1183875694,28,1185534198,1658504
1671409787,205554,true,1183994082,28,1185534198,1540116
1671409823,205554,true,1183994082,28,1185652751,1658669
1671409835,205554,true,1183994082,28,1185652751,1658669
1671409871,205552,true,1184230893,28,1185771317,1540424
1671409955,205551,true,1184349316,28,1186008483,1659167
1671410003,205551,true,1184349316,28,1186245696,1896380
1671410723,205551,true,1184349316,28,1188620443,4271127
1671411275,205549,true,1184586197,28,1190404622,5818425
1671412259,205548,true,1184704656,28,1191238156,6533500
1671414335,205548,true,1184704656,28,1190999944,6295288
1671414407,205548,true,1184704656,28,1190999944,6295288
1671414659,205546,true,1184941609,28,1190999944,6058335
1671415955,205545,true,1185060103,28,1190999944,5939841
1671416627,205544,true,1185178609,28,1190999944,5821335
1671416843,205543,true,1185297127,28,1190999944,5702817
1671416867,205542,true,1185415656,28,1190999944,5584288
1671416879,205541,true,1185534198,28,1190999944,5465746
1671416891,205540,true,1185652751,28,1190999944,5347193
1671416903,205540,true,1185652751,28,1190999944,5347193
1671416927,205538,true,1185889894,28,1190999944,5110050
1671417107,205537,true,1186008483,28,1190761779,4753296
1671417191,205536,true,1186127084,28,1190642715,4515631
1671417203,205536,true,1186127084,28,1190642715,4515631
1671417263,205535,true,1186245696,28,1190642715,4397019
1671417359,205534,true,1186364321,28,1190404622,4040301
1671417371,205533,true,1186482957,28,1190404622,3921665
1671417407,205533,true,1186482957,28,1190285594,3802637
1671417431,205531,true,1186720266,28,1190285594,3565328
1671417443,205531,true,1186720266,28,1190166577,3446311
1671417563,205530,true,1186838938,28,1189928579,3089641
1671417599,205530,true,1186838938,28,1189809598,2970660
1671418199,205530,true,1186838938,28,1188026311,1187373
1671419051,205530,true,1186838938,28,1186127084,-711854
1671419063,205530,true,1186838938,28,1186127084,-711854
1671419075,205530,true,1186838938,28,1186127084,-711854
1671419099,205530,true,1186838938,28,1186008483,-830455
1671419111,205530,true,1186838938,28,1186008483,-830455
1671419123,205531,true,1186720266,28,1186008483,-711783
1671419147,205531,true,1186720266,28,1185889894,-830372
1671419207,205531,true,1186720266,28,1185652751,-1067515
1671419243,205531,true,1186720266,28,1185534198,-1186068
1671421319,205532,true,1186601606,28,1180565644,-6035962
1671421343,205532,true,1186601606,28,1180565644,-6035962
1671421355,205533,true,1186482957,28,1180565644,-5917313
1671421391,205533,true,1186482957,28,1180565644,-5917313
1671421403,205533,true,1186482957,28,1180565644,-5917313
1671421415,205533,true,1186482957,28,1180565644,-5917313
1671421535,205534,true,1186364321,28,1180565644,-5798677
1671423047,205533,true,1186482957,28,1179149886,-7333071
1671423767,205534,true,1186364321,28,1178914091,-7450230
1671423875,205533,true,1186482957,28,1179031983,-7450974
1671424547,205534,true,1186364321,28,1179503666,-6860655
1671424799,205534,true,1186364321,28,1179621616,-6742705
1671425171,205534,true,1186364321,28,1179857553,-6506768
1671425195,205533,true,1186482957,28,1179857553,-6625404
1671425255,205534,true,1186364321,28,1179975538,-6388783
1671425507,205534,true,1186364321,28,1180211545,-6152776
1671425687,205534,true,1186364321,28,1180329566,-6034755
1671427739,205534,true,1186364321,28,1181037941,-5326380
1671428819,205534,true,1186364321,28,1181037941,-5326380
1671428855,205534,true,1186364321,28,1181037941,-5326380
1671429527,205534,true,1186364321,28,1181037941,-5326380
1671429815,205534,true,1186364321,28,1181037941,-5326380
1671429851,205535,true,1186245696,28,1181037941,-5207755
1671432335,205535,true,1186245696,28,1181037941,-5207755
1671434579,205535,true,1186245696,28,1181037941,-5207755
1671434771,205535,true,1186245696,28,1181037941,-5207755
1671436007,205536,true,1186127084,28,1181037941,-5089143
1671436247,205535,true,1186245696,28,1181037941,-5207755
1671437279,205536,true,1186127084,28,1181037941,-5089143
1671437783,205536,true,1186127084,28,1181037941,-5089143
1671438191,205537,true,1186008483,28,1181037941,-4970542
1671438227,205538,true,1185889894,28,1181037941,-4851953
1671438551,205538,true,1185889894,28,1181037941,-4851953
1671441227,205539,true,1185771317,28,1181037941,-4733376
1671441623,205539,true,1185771317,28,1181037941,-4733376
1671441635,205540,true,1185652751,28,1181156045,-4496706
1671441659,205540,true,1185652751,28,1181156045,-4496706
1671442235,205540,true,1185652751,28,1181392288,-4260463
1671443243,205541,true,1185534198,28,1182219511,-3314687
1671443723,205541,true,1185534198,28,1182455966,-3078232
1671443939,205542,true,1185415656,28,1182574212,-2841444
1671444167,205542,true,1185415656,28,1182574212,-2841444
1671444395,205543,true,1185297127,28,1182692469,-2604658
1671444779,205543,true,1185297127,28,1182810739,-2486388
1671444995,205544,true,1185178609,28,1182810739,-2367870
1671445055,205544,true,1185178609,28,1182929020,-2249589
1671445427,205545,true,1185060103,28,1183402262,-1657841
1671447095,205545,true,1185060103,28,1184823126,-236977
1671447431,205545,true,1185060103,28,1184823126,-236977
1671447707,205546,true,1184941609,28,1184823126,-118483
1671448259,205546,true,1184941609,28,1184823126,-118483
1671449027,205547,true,1184823126,28,1184823126,0
1671451283,205547,true,1184823126,28,1184823126,0
1671451571,205547,true,1184823126,28,1184823126,0
1671452003,205548,true,1184704656,28,1184823126,118470
1671453587,205548,true,1184704656,28,1184112481,-592175
1671453635,205548,true,1184704656,28,1184112481,-592175
1671453779,205548,true,1184704656,28,1184112481,-592175
1671454595,205548,true,1184704656,28,1184467751,-236905
1671455771,205548,true,1184704656,28,1184704656,0
1671458135,205549,true,1184586197,28,1184704656,118459
1671458735,205549,true,1184586197,28,1184704656,118459
1671458783,205549,true,1184586197,28,1184704656,118459
1671458843,205549,true,1184586197,28,1184704656,118459
1671460715,205549,true,1184586197,28,1182692469,-1893728
1671460727,205549,true,1184586197,28,1182810739,-1775458
1671460739,205550,true,1184467751,28,1182810739,-1657012
1671461279,205549,true,1184586197,28,1183638955,-947242
1671461291,205550,true,1184467751,28,1183638955,-828796
1671461303,205550,true,1184467751,28,1183638955,-828796
1671461327,205550,true,1184467751,28,1183757319,-710432
1671461339,205551,true,1184349316,28,1183757319,-591997
1671461951,205551,true,1184349316,28,1183757319,-591997
1671461987,205552,true,1184230893,28,1183757319,-473574
1671462023,205552,true,1184230893,28,1183757319,-473574
1671462035,205553,true,1184112481,28,1183757319,-355162
1671463079,205553,true,1184112481,28,1183757319,-355162
1671463211,205554,true,1183994082,28,1183757319,-236763
1671463391,205554,true,1183994082,28,1183875694,-118388
1671463475,205555,true,1183875694,28,1183994082,118388
1671463499,205555,true,1183875694,28,1183994082,118388
1671463547,205556,true,1183757319,28,1183994082,236763
1671465131,205556,true,1183757319,28,1184823126,1065807
1671465215,205557,true,1183638955,28,1184823126,1184171
1671465227,205557,true,1183638955,28,1184823126,1184171
1671465251,205558,true,1183520603,28,1184823126,1302523
1671465335,205558,true,1183520603,28,1184823126,1302523
1671465383,205559,true,1183402262,28,1184823126,1420864
1671465455,205559,true,1183402262,28,1184704656,1302394
1671465611,205560,true,1183283934,28,1184467751,1183817
1671465971,205560,true,1183283934,28,1184112481,828547
1671466019,205561,true,1183165617,28,1183994082,828465
1671466979,205562,true,1183047313,28,1182101301,-946012
1671466991,205562,true,1183047313,28,1182101301,-946012
1671467003,205562,true,1183047313,28,1182101301,-946012
1671467063,205563,true,1182929020,28,1181983102,-945918
1671467867,205565,true,1182692469,28,1178914091,-3778378
1671468287,205565,true,1182692469,28,1177500313,-5192156
1671468479,205566,true,1182574212,28,1176911740,-5662472
1671468695,205566,true,1182574212,28,1176205840,-6368372
1671469967,205568,true,1182337733,28,1175500363,-6837370
1671470651,205569,true,1182219511,28,1175500363,-6719148
1671470759,205569,true,1182219511,28,1175500363,-6719148
1671470999,205569,true,1182219511,28,1175500363,-6719148
1671471191,205571,true,1181983102,28,1175500363,-6482739
1671471251,205572,true,1181864916,28,1175382825,-6482091
1671471347,205573,true,1181746741,28,1175030281,-6716460
1671471359,205573,true,1181746741,28,1175030281,-6716460
1671471563,205576,true,1181392288,28,1174325509,-7066779
1671471575,205576,true,1181392288,28,1174325509,-7066779
1671471611,205576,true,1181392288,28,1174208088,-7184200
1671471743,205577,true,1181274161,28,1173738522,-7535639
1671472043,205579,true,1181037941,28,1172799954,-8237987
1671472055,205579,true,1181037941,28,1172682686,-8355255
1671472115,205580,true,1180919849,28,1172565429,-8354420
1671472283,205580,true,1180919849,28,1172213730,-8706119
1671472307,205582,true,1180683701,28,1172096520,-8587181
1671473819,205582,true,1180683701,28,1172448184,-8235517
1671474395,205582,true,1180683701,28,1172799954,-7883747
1671474407,205582,true,1180683701,28,1172799954,-7883747
1671474683,205584,true,1180447599,28,1172917234,-7530365
1671475691,205583,true,1180565644,28,1173621160,-6944484
1671475787,205583,true,1180565644,28,1173621160,-6944484
1671476099,205583,true,1180565644,28,1173738522,-6827122
1671476111,205586,true,1180211545,28,1173738522,-6473023
1671476243,205586,true,1180211545,28,1173621160,-6590385
1671476291,205586,true,1180211545,28,1173621160,-6590385
1671476327,205586,true,1180211545,28,1173621160,-6590385
1671476711,205588,true,1179975538,28,1173034526,-6941012
1671479351,205588,true,1179975538,28,1171276381,-8699157
1671481283,205589,true,1179857553,28,1171276381,-8581172
1671482339,205589,true,1179857553,28,1171276381,-8581172
1671482651,205591,true,1179621616,28,1171276381,-8345235
1671482711,205591,true,1179621616,28,1171393508,-8228108
1671482723,205591,true,1179621616,28,1171393508,-8228108
1671483191,205592,true,1179503666,28,1171510648,-7993018
1671483251,205594,true,1179267801,28,1171627799,-7640002
1671483287,205594,true,1179267801,28,1171627799,-7640002
1671483299,205594,true,1179267801,28,1171627799,-7640002
1671483335,205594,true,1179267801,28,1171627799,-7640002
1671483383,205597,true,1178914091,28,1171744962,-7169129
1671484691,205596,true,1179031983,28,1173034526,-5997457
1671484703,205597,true,1178914091,28,1173034526,-5879565
1671484715,205596,true,1179031983,28,1173034526,-5997457
1671484763,205599,true,1178678344,28,1173151829,-5526515
1671484895,205599,true,1178678344,28,1173269144,-5409200
1671484919,205599,true,1178678344,28,1173386471,-5291873
1671485087,205598,true,1178796211,28,1173621160,-5175051
1671485171,205601,true,1178442643,28,1173738522,-4704121
1671485183,205600,true,1178560488,28,1173738522,-4821966
1671486119,205600,true,1178560488,28,1176088231,-2472257
1671486407,205600,true,1178560488,28,1176794060,-1766428
1671488399,205602,true,1178324811,28,1177735825,-588986
1671488903,205602,true,1178324811,28,1177735825,-588986
1671488975,205602,true,1178324811,28,1177735825,-588986
1671488987,205601,true,1178442643,28,1177735825,-706818
1671489011,205604,true,1178089181,28,1177735825,-353356
1671489059,205604,true,1178089181,28,1177735825,-353356
1671489071,205604,true,1178089181,28,1177618063,-471118
1671489095,205604,true,1178089181,28,1177618063,-471118
1671489155,205608,true,1177618063,28,1177264849,-353214
1671489167,205608,true,1177618063,28,1177264849,-353214
1671489191,205609,true,1177500313,28,1177029431,-470882
1671489287,205611,true,1177264849,28,1176088231,-1176618
1671489383,205615,true,1176794060,28,1175147784,-1646276
1671489395,205616,true,1176676393,28,1175030281,-1646112
1671489587,205617,true,1176558737,28,1172565429,-3993308
1671489599,205619,true,1176323460,28,1172448184,-3875276
1671489755,205624,true,1175735475,28,1170573861,-5161614
1671489803,205624,true,1175735475,28,1170105748,-5629727
1671489815,205626,true,1175500363,28,1169871762,-5628601
1671489827,205628,true,1175265298,28,1169754787,-5510511
1671490799,205631,true,1174912789,28,1160086484,-14826305
1671490871,205632,true,1174795310,28,1159506615,-15288695
1671490895,205633,true,1174677842,28,1159274749,-15403093
1671490907,205635,true,1174442942,28,1159274749,-15168193
1671490931,205638,true,1174090679,28,1159158833,-14931846
1671490943,205638,true,1174090679,28,1159158833,-14931846
1671490991,205639,true,1173973282,28,1159158833,-14814449
1671492323,205641,true,1173738522,28,1164037294,-9701228
1671492515,205644,true,1173386471,28,1164619429,-8767042
1671492539,205645,true,1173269144,28,1164619429,-8649715
1671492575,205645,true,1173269144,28,1164735891,-8533253
1671492659,205647,true,1173034526,28,1164968849,-8065677
1671492671,205650,true,1172682686,28,1165085346,-7597340
1671495803,205650,true,1172682686,28,1166017741,-6664945
1671495815,205651,true,1172565429,28,1166134343,-6431086
1671495863,205652,true,1172448184,28,1166134343,-6313841
1671495875,205655,true,1172096520,28,1166134343,-5962177
1671495899,205654,true,1172213730,28,1166250956,-5962774
1671498395,205654,true,1172213730,28,1171627799,-585931
1671498407,205656,true,1171979322,28,1171627799,-351523
1671498875,205659,true,1171627799,28,1171627799,0
1671499115,205658,true,1171744962,28,1171627799,-117163
1671499259,205658,true,1171744962,28,1171627799,-117163
1671499295,205660,true,1171510648,28,1171744962,234314
1671499307,205663,true,1171159265,28,1171744962,585697
1671499319,205662,true,1171276381,28,1171744962,468581
1671499355,205662,true,1171276381,28,1171744962,468581
1671499439,205663,true,1171159265,28,1171862136,702871
1671499451,205666,true,1170807987,28,1171979322,1171335
1671499883,205665,true,1170925068,28,1172917234,1992166
1671499895,205664,true,1171042161,28,1172917234,1875073
1671499907,205665,true,1170925068,28,1172917234,1992166
1671499919,205667,true,1170690918,28,1173034526,2343608
1671499931,205666,true,1170807987,28,1173034526,2226539
1671499943,205665,true,1170925068,28,1173151829,2226761
1671499955,205665,true,1170925068,28,1173151829,2226761
1671499991,205666,true,1170807987,28,1173386471,2578484
1671500063,205664,true,1171042161,28,1173973282,2931121
1671500123,205663,true,1171159265,28,1174325509,3166244
1671500363,205662,true,1171276381,28,1176558737,5282356
1671500399,205662,true,1171276381,28,1176911740,5635359
1671500483,205660,true,1171510648,28,1177618063,6107415
1671502139,205659,true,1171627799,28,1186957622,15329823
1671502475,205659,true,1171627799,28,1186838938,15211139
1671502595,205659,true,1171627799,28,1186838938,15211139
1671504119,205657,true,1171862136,28,1186838938,14976802
1671504131,205655,true,1172096520,28,1186838938,14742418
1671504179,205654,true,1172213730,28,1186838938,14625208
1671504191,205654,true,1172213730,28,1186957622,14743892
1671504311,205651,true,1172565429,28,1187195025,14629596
1671504335,205649,true,1172799954,28,1187313745,14513791
1671505307,205648,true,1172917234,28,1190404622,17487388
1671505799,205647,true,1173034526,28,1192668428,19633902
1671505883,205643,true,1173503810,28,1193026264,19522454
1671506003,205642,true,1173621160,28,1193503546,19882386
1671506027,205640,true,1173855896,28,1193503546,19647650
1671506039,205640,true,1173855896,28,1193622897,19767001
1671506063,205637,true,1174208088,28,1193622897,19414809
1671506135,205636,true,1174325509,28,1193622897,19297388
1671506183,205634,true,1174560386,28,1193622897,19062511
1671506351,205634,true,1174560386,28,1193622897,19062511
1671506819,205631,true,1174912789,28,1193384208,18471419
1671507383,205630,true,1175030281,28,1192668428,17638147
1671508991,205629,true,1175147784,28,1191595563,16447779
1671510659,205628,true,1175265298,28,1191595563,16330265
1671510671,205626,true,1175500363,28,1191714722,16214359
1671510935,205625,true,1175617913,28,1191833894,16215981
1671510983,205623,true,1175853049,28,1191953077,16100028
1671511043,205622,true,1175970634,28,1191953077,15982443
1671511163,205619,true,1176323460,28,1192191480,15868020
1671511187,205618,true,1176441093,28,1192191480,15750387
1671511199,205616,true,1176676393,28,1192191480,15515087
1671511211,205615,true,1176794060,28,1192310699,15516639
1671511235,205611,true,1177264849,28,1192549173,15284324
1671511907,205606,true,1177853599,28,1199245847,21392248
1671511919,205604,true,1178089181,28,1199365771,21276590
1671512375,205604,true,1178089181,28,1203811422,25722241
1671512555,205599,true,1178678344,28,1205497854,26819510
1671513215,205595,true,1179149886,28,1209240508,30090622
1671513611,205594,true,1179267801,28,1209119596,29851795
1671514067,205593,true,1179385727,28,1208998696,29612969
1671514079,205589,true,1179857553,28,1208998696,29141143
1671514115,205585,true,1180329566,28,1208998696,28669130
1671514151,205583,true,1180565644,28,1208998696,28433052
1671514187,205582,true,1180683701,28,1208998696,28314995
1671514463,205578,true,1181156045,28,1208756933,27600888
1671514991,205575,true,1181510427,28,1208273551,26763124
1671516587,205573,true,1181746741,28,1207548840,25802099
1671516791,205573,true,1181746741,28,1207548840,25802099
1671516875,205569,true,1182219511,28,1207669595,25450084
1671517427,205565,true,1182692469,28,1207790362,25097893
1671517835,205564,true,1182810739,28,1207911141,25100402
1671518483,205563,true,1182929020,28,1208152735,25223715
1671518723,205560,true,1183283934,28,1208152735,24868801
1671518831,205556,true,1183757319,28,1208152735,24395416
1671518939,205555,true,1183875694,28,1208152735,24277041
1671519251,205554,true,1183994082,28,1208152735,24158653
1671519263,205550,true,1184467751,28,1208273551,23805800
1671519359,205546,true,1184941609,28,1208273551,23331942
1671519551,205545,true,1185060103,28,1208515217,23455114
1671519587,205543,true,1185297127,28,1208515217,23218090
1671519671,205538,true,1185889894,28,1208636069,22746175
1671521219,205534,true,1186364321,28,1210208239,23843918
1671522191,205531,true,1186720266,28,1210208239,23487973
1671522575,205528,true,1187076318,28,1210208239,23131921
1671524423,205523,true,1187669974,28,1210087230,22417256
1671525275,205518,true,1188263928,28,1209361432,21097504
1671526895,205515,true,1188620443,28,1208394378,19773935
1671527999,205512,true,1188977065,28,1208877808,19900743
1671528287,205507,true,1189571672,28,1208998696,19427024
1671528803,205502,true,1190166577,28,1209119596,18953019
1671531599,205499,true,1190523663,28,1209119596,18595933
1671532259,205497,true,1190761779,28,1209119596,18357817
1671533711,205492,true,1191357279,28,1209119596,17762317
1671533783,205487,true,1191953077,28,1209119596,17166519
1671535067,205484,true,1192310699,28,1209119596,16808897
1671537071,205482,true,1192549173,28,1213358717,20809544
1671538499,205477,true,1193145567,28,1213358717,20213150
1671540059,205473,true,1193622897,28,1213358717,19735820
1671540347,205470,true,1193981019,28,1213358717,19377698
1671540455,205467,true,1194339249,28,1213358717,19019468
1671540647,205463,true,1194817057,28,1213358717,18541660
1671540659,205458,true,1195414585,28,1213358717,17944132
1671540959,205455,true,1195773245,28,1213358717,17585472
1671542231,205453,true,1196012412,28,1213358717,17346305
1671543155,205449,true,1196490888,28,1213358717,16867829
1671543275,205444,true,1197089253,28,1213358717,16269464
1671544295,205441,true,1197448416,28,1213116081,15667665
1671545507,205439,true,1197687918,28,1212873495,15185577
1671545867,205435,true,1198167065,28,1212630956,14463891
1671546539,205432,true,1198526551,28,1212146025,13619474
1671547655,205429,true,1198886145,28,1211418992,12532847
1671547727,205427,true,1199125934,28,1211418992,12293058
1671548183,205424,true,1199485708,28,1210692395,11206687
1671548195,205420,true,1199965574,28,1210692395,10726821
1671548243,205418,true,1200205579,28,1210692395,10486816
1671548255,205416,true,1200445632,28,1210692395,10246763
1671548267,205412,true,1200925883,28,1210692395,9766512
1671548339,205408,true,1201406325,28,1210692395,9286070
1671548351,205406,true,1201646618,28,1210692395,9045777
1671548567,205403,true,1202007148,28,1211540134,9532986
1671549083,205399,true,1202488023,28,1213480053,10992030
1671549095,205396,true,1202848806,28,1213480053,10631247
1671549851,205394,true,1203089388,28,1216639048,13549660
1671549863,205391,true,1203450350,28,1216760712,13310362
1671550319,205387,true,1203931803,28,1217734461,13802658
1671550331,205384,true,1204293018,28,1217734461,13441443
1671550343,205382,true,1204533889,28,1217734461,13200572
1671550355,205380,true,1204774808,28,1217856234,13081426
1671551195,205375,true,1205377316,28,1221270839,15893523
1671551231,205372,true,1205738965,28,1221392966,15654001
1671551267,205371,true,1205859539,28,1221515106,15655567
1671551315,205369,true,1206100723,28,1221759421,15658698
1671551459,205364,true,1206703894,28,1222248198,15544304
1671551807,205361,true,1207065941,28,1223348661,16282720
1671551855,205360,true,1207186648,28,1223470996,16284348
1671551939,205358,true,1207428097,28,1223593343,16165246
1671551951,205353,true,1208031932,28,1223715703,15683771
1671551999,205350,true,1208394378,28,1223715703,15321325
1671552059,205349,true,1208515217,28,1223838074,15322857
1671552323,205348,true,1208636069,28,1223470996,14834927
1671552347,205344,true,1209119596,28,1223470996,14351400
1671552371,205341,true,1209482368,28,1223348661,13866293
1671552467,205341,true,1209482368,28,1222981730,13499362
1671552575,205340,true,1209603316,28,1222614909,13011593
1671552587,205336,true,1210087230,28,1222492660,12405430
1671552635,205334,true,1210329260,28,1222370423,12041163
1671552719,205334,true,1210329260,28,1222003785,11674525
1671552779,205334,true,1210329260,28,1221637257,11307997
1671552935,205330,true,1210813464,28,1220904531,10091067
1671553907,205329,true,1210934545,28,1213722761,2788216
1671555251,205329,true,1210934545,28,1209482368,-1452177
1671555371,205329,true,1210934545,28,1209361432,-1573113
1671555695,205324,true,1211540134,28,1209482368,-2057766
1671555815,205323,true,1211661288,28,1209482368,-2178920
1671558911,205324,true,1211540134,28,1209966234,-1573900
1671560435,205323,true,1211661288,28,1209966234,-1695054
1671560879,205319,true,1212146025,28,1209966234,-2179791
1671560951,205318,true,1212267240,28,1209966234,-2301006
1671561071,205319,true,1212146025,28,1210087230,-2058795
1671561131,205318,true,1212267240,28,1210087230,-2180010
1671561155,205314,true,1212752219,28,1210087230,-2664989
1671561167,205313,true,1212873495,28,1210087230,-2786265
1671561215,205313,true,1212873495,28,1210087230,-2786265
1671561407,205313,true,1212873495,28,1210329260,-2544235
1671561623,205310,true,1213237393,28,1210813464,-2423929
1671563435,205312,true,1212994782,28,1213965517,970735
1671564887,205312,true,1212994782,28,1214208323,1213541
1671565691,205312,true,1212994782,28,1214208323,1213541
1671565715,205309,true,1213358717,28,1214329743,971026
1671567371,205310,true,1213237393,28,1214329743,1092350
1671567551,205311,true,1213116081,28,1214451176,1335095
1671567959,205310,true,1213237393,28,1214815548,1578155
1671568139,205307,true,1213601401,28,1214937030,1335629
1671569087,205308,true,1213480053,28,1215909320,2429267
1671569231,205308,true,1213480053,28,1216152514,2672461
1671569723,205307,true,1213601401,28,1216274129,2672728
1671569855,205305,true,1213844133,28,1216274129,2429996
1671569879,205306,true,1213722761,28,1216274129,2551368
1671569891,205306,true,1213722761,28,1216274129,2551368
1671571199,205305,true,1213844133,28,1215544620,1700487
1671571559,205302,true,1214208323,28,1215301547,1093224
1671571607,205303,true,1214086914,28,1215301547,1214633
1671575447,205304,true,1213965517,28,1215180029,1214512
1671575615,205303,true,1214086914,28,1215180029,1093115
1671577091,205300,true,1214451176,28,1215180029,728853
1671577535,205301,true,1214329743,28,1215180029,850286
1671577559,205302,true,1214208323,28,1215180029,971706
1671577595,205301,true,1214329743,28,1215301547,971804
1671578651,205298,true,1214694079,28,1215423077,728998
1671579131,205299,true,1214572622,28,1215544620,971998
1671579155,205300,true,1214451176,28,1215544620,1093444
1671579167,205299,true,1214572622,28,1215544620,971998
1671579179,205296,true,1214937030,28,1215544620,607590
1671579839,205297,true,1214815548,28,1216152514,1336966
1671580811,205298,true,1214694079,28,1216882388,2188309
1671581615,205297,true,1214815548,28,1216882388,2066840
1671581627,205295,true,1215058523,28,1216882388,1823865
1671581651,205295,true,1215058523,28,1216882388,1823865
1671581723,205296,true,1214937030,28,1216882388,1945358
1671581747,205295,true,1215058523,28,1216882388,1823865
1671581759,205293,true,1215301547,28,1216882388,1580841
1671582035,205294,true,1215180029,28,1216274129,1094100
1671582047,205294,true,1215180029,28,1216274129,1094100
1671582359,205294,true,1215180029,28,1215666174,486145
1671582935,205291,true,1215544620,28,1214572622,-971998
1671583691,205292,true,1215423077,28,1213358717,-2064360
1671583715,205293,true,1215301547,28,1213358717,-1942830
1671583823,205293,true,1215301547,28,1213358717,-1942830
1671583979,205291,true,1215544620,28,1213116081,-2428539
1671584171,205293,true,1215301547,28,1212873495,-2428052
1671585635,205294,true,1215180029,28,1211055639,-4124390
1671585743,205294,true,1215180029,28,1211055639,-4124390
1671585887,205292,true,1215423077,28,1211055639,-4367438
1671586535,205293,true,1215301547,28,1211055639,-4245908
1671586559,205294,true,1215180029,28,1211055639,-4124390
1671586763,205295,true,1215058523,28,1211055639,-4002884
1671587543,205293,true,1215301547,28,1211055639,-4245908
1671587675,205294,true,1215180029,28,1211055639,-4124390
1671587843,205295,true,1215058523,28,1210934545,-4123978
1671588203,205295,true,1215058523,28,1210934545,-4123978
1671589271,205293,true,1215301547,28,1210934545,-4367002
1671589715,205295,true,1215058523,28,1210934545,-4123978
1671590795,205295,true,1215058523,28,1210934545,-4123978
1671591611,205296,true,1214937030,28,1210934545,-4002485
1671592235,205293,true,1215301547,28,1210934545,-4367002
1671592247,205295,true,1215058523,28,1210934545,-4123978
1671592547,205295,true,1215058523,28,1210813464,-4245059
1671592739,205295,true,1215058523,28,1210813464,-4245059
1671593327,205293,true,1215301547,28,1210571338,-4730209
1671593519,205295,true,1215058523,28,1210450293,-4608230
1671593603,205296,true,1214937030,28,1210450293,-4486737
1671596711,205297,true,1214815548,28,1210208239,-4607309
1671597215,205296,true,1214937030,28,1210208239,-4728791
1671598439,205298,true,1214694079,28,1210087230,-4606849
1671598487,205298,true,1214694079,28,1210087230,-4606849
1671598499,205299,true,1214572622,28,1210087230,-4485392
1671598871,205298,true,1214694079,28,1209966234,-4727845
1671598883,205300,true,1214451176,28,1209966234,-4484942
1671598943,205300,true,1214451176,28,1209966234,-4484942
1671598979,205302,true,1214208323,28,1209966234,-4242089
1671600167,205303,true,1214086914,28,1208877808,-5209106
1671601487,205305,true,1213844133,28,1208273551,-5570582
1671602507,205305,true,1213844133,28,1208273551,-5570582
1671602723,205307,true,1213601401,28,1208394378,-5207023
1671602879,205307,true,1213601401,28,1208394378,-5207023
1671603335,205309,true,1213358717,28,1208394378,-4964339
1671603515,205310,true,1213237393,28,1208394378,-4843015
1671603791,205311,true,1213116081,28,1208515217,-4600864
1671604007,205311,true,1213116081,28,1208515217,-4600864
1671604247,205313,true,1212873495,28,1208636069,-4237426
1671604355,205313,true,1212873495,28,1208756933,-4116562
1671604943,205314,true,1212752219,28,1208998696,-3753523
1671606395,205315,true,1212630956,28,1209240508,-3390448
1671606491,205316,true,1212509705,28,1209361432,-3148273
1671606863,205317,true,1212388466,28,1209482368,-2906098
1671607295,205317,true,1212388466,28,1209603316,-2785150
1671607499,205317,true,1212388466,28,1209603316,-2785150
1671607607,205319,true,1212146025,28,1209724277,-2421748
1671607919,205319,true,1212146025,28,1209845249,-2300776
1671608267,205319,true,1212146025,28,1209966234,-2179791
1671611519,205319,true,1212146025,28,1209966234,-2179791
1671611843,205319,true,1212146025,28,1209966234,-2179791
1671612299,205319,true,1212146025,28,1209966234,-2179791
1671612371,205319,true,1212146025,28,1209966234,-2179791
1671612575,205319,true,1212146025,28,1210087230,-2058795
1671612623,205319,true,1212146025,28,1210087230,-2058795
1671612779,205319,true,1212146025,28,1210208239,-1937786
1671612815,205319,true,1212146025,28,1210329260,-1816765
1671612827,205319,true,1212146025,28,1210329260,-1816765
1671612851,205318,true,1212267240,28,1210329260,-1937980
1671612863,205318,true,1212267240,28,1210329260,-1937980
1671612983,205317,true,1212388466,28,1210692395,-1696071
1671613547,205317,true,1212388466,28,1212267240,-121226
1671616595,205317,true,1212388466,28,1215058523,2670057
1671617303,205317,true,1212388466,28,1215058523,2670057
1671617579,205316,true,1212509705,28,1215058523,2548818
1671617843,205317,true,1212388466,28,1215058523,2670057
1671617903,205317,true,1212388466,28,1215058523,2670057
1671618311,205316,true,1212509705,28,1215058523,2548818
1671618851,205316,true,1212509705,28,1215058523,2548818
1671622571,205316,true,1212509705,28,1215058523,2548818
1671622823,205316,true,1212509705,28,1215058523,2548818
1671623591,205316,true,1212509705,28,1215058523,2548818
1671624023,205316,true,1212509705,28,1215058523,2548818
1671624371,205316,true,1212509705,28,1215058523,2548818
1671625691,205317,true,1212388466,28,1215058523,2670057
1671625823,205316,true,1212509705,28,1215058523,2548818
1671626147,205316,true,1212509705,28,1215058523,2548818
1671626435,205317,true,1212388466,28,1215058523,2670057
1671626651,205317,true,1212388466,28,1215058523,2670057
1671626975,205317,true,1212388466,28,1215058523,2670057
1671627479,205317,true,1212388466,28,1215058523,2670057
1671627827,205317,true,1212388466,28,1215058523,2670057
1671629483,205317,true,1212388466,28,1215058523,2670057
1671630347,205317,true,1212388466,28,1214572622,2184156
1671631427,205317,true,1212388466,28,1214086914,1698448
1671631643,205317,true,1212388466,28,1214086914,1698448
1671632087,205317,true,1212388466,28,1214086914,1698448
1671632267,205317,true,1212388466,28,1214086914,1698448
1671634091,205317,true,1212388466,28,1214086914,1698448
1671634223,205317,true,1212388466,28,1214451176,2062710
1671634475,205318,true,1212267240,28,1215180029,2912789
1671634535,205317,true,1212388466,28,1215301547,2913081
1671634559,205316,true,1212509705,28,1215301547,2791842
1671634571,205316,true,1212509705,28,1215301547,2791842
1671634607,205317,true,1212388466,28,1215423077,3034611
1671634631,205318,true,1212267240,28,1215423077,3155837
1671634667,205317,true,1212388466,28,1215423077,3034611
1671634679,205317,true,1212388466,28,1215423077,3034611
1671634751,205318,true,1212267240,28,1215423077,3155837
1671634763,205318,true,1212267240,28,1215423077,3155837
1671635363,205318,true,1212267240,28,1214451176,2183936
1671635399,205318,true,1212267240,28,1214451176,2183936
1671635411,205319,true,1212146025,28,1214451176,2305151
1671635771,205319,true,1212146025,28,1213965517,1819492
1671636767,205318,true,1212267240,28,1211782454,-484786
1671637019,205318,true,1212267240,28,1211903632,-363608
1671637103,205319,true,1212146025,28,1211903632,-242393
1671637175,205319,true,1212146025,28,1212024823,-121202
1671637379,205319,true,1212146025,28,1212024823,-121202
1671638435,205318,true,1212267240,28,1212630956,363716
1671638723,205319,true,1212146025,28,1212752219,606194
1671638819,205319,true,1212146025,28,1212873495,727470
1671639203,205318,true,1212267240,28,1212994782,727542
1671641111,205318,true,1212267240,28,1212994782,727542
1671642011,205318,true,1212267240,28,1212994782,727542
1671642071,205318,true,1212267240,28,1212994782,727542
1671642131,205317,true,1212388466,28,1212994782,606316
1671642155,205317,true,1212388466,28,1212994782,606316
1671644159,205318,true,1212267240,28,1210813464,-1453776
1671644327,205318,true,1212267240,28,1210813464,-1453776
1671644927,205317,true,1212388466,28,1210813464,-1575002
1671645527,205317,true,1212388466,28,1210813464,-1575002
1671645755,205318,true,1212267240,28,1210813464,-1453776
1671645923,205318,true,1212267240,28,1210813464,-1453776
1671648431,205317,true,1212388466,28,1210813464,-1575002
1671649187,205317,true,1212388466,28,1210813464,-1575002
1671649499,205318,true,1212267240,28,1210813464,-1453776
1671649799,205318,true,1212267240,28,1210813464,-1453776
1671649811,205317,true,1212388466,28,1210813464,-1575002
1671649919,205317,true,1212388466,28,1210813464,-1575002
1671650003,205318,true,1212267240,28,1210813464,-1453776
1671650015,205318,true,1212267240,28,1210813464,-1453776
1671650027,205317,true,1212388466,28,1210813464,-1575002
1671650051,205317,true,1212388466,28,1210813464,-1575002
1671651887,205318,true,1212267240,28,1210813464,-1453776
1671652139,205318,true,1212267240,28,1210813464,-1453776
1671652691,205317,true,1212388466,28,1210813464,-1575002
1671653027,205317,true,1212388466,28,1210813464,-1575002
1671653555,205318,true,1212267240,28,1210692395,-1574845
1671654311,205318,true,1212267240,28,1210450293,-1816947
1671654755,205317,true,1212388466,28,1210329260,-2059206
1671654875,205316,true,1212509705,28,1210329260,-2180445
1671654887,205317,true,1212388466,28,1210329260,-2059206
1671656987,205317,true,1212388466,28,1210329260,-2059206
1671657239,205316,true,1212509705,28,1210329260,-2180445
1671657839,205316,true,1212509705,28,1210329260,-2180445
1671657971,205317,true,1212388466,28,1210329260,-2059206
1671659159,205317,true,1212388466,28,1210329260,-2059206
1671661763,205316,true,1212509705,28,1210329260,-2180445
1671663731,205315,true,1212630956,28,1210329260,-2301696
1671664079,205316,true,1212509705,28,1210329260,-2180445
1671664463,205316,true,1212509705,28,1210329260,-2180445
1671664475,205315,true,1212630956,28,1210450293,-2180663
1671665015,205315,true,1212630956,28,1210692395,-1938561
1671665075,205316,true,1212509705,28,1210692395,-1817310
1671665087,205316,true,1212509705,28,1210692395,-1817310
1671666191,205315,true,1212630956,28,1211297862,-1333094
1671668087,205314,true,1212752219,28,1211297862,-1454357
1671669227,205315,true,1212630956,28,1211297862,-1333094
1671669239,205315,true,1212630956,28,1211418992,-1211964
1671670091,205314,true,1212752219,28,1211661288,-1090931
1671670103,205314,true,1212752219,28,1211661288,-1090931
1671670487,205315,true,1212630956,28,1212146025,-484931
1671670523,205314,true,1212752219,28,1212146025,-606194
1671670775,205313,true,1212873495,28,1212509705,-363790
1671670811,205313,true,1212873495,28,1212630956,-242539
1671670967,205313,true,1212873495,28,1212873495,0
1671673163,205313,true,1212873495,28,1214451176,1577681
1671673643,205312,true,1212994782,28,1214451176,1456394
1671674603,205312,true,1212994782,28,1214451176,1456394
1671674711,205313,true,1212873495,28,1214451176,1577681
1671675503,205313,true,1212873495,28,1214451176,1577681
1671677519,205312,true,1212994782,28,1214451176,1456394
1671679211,205312,true,1212994782,28,1214451176,1456394
1671679451,205313,true,1212873495,28,1214572622,1699127
1671679463,205313,true,1212873495,28,1214572622,1699127
1671680759,205313,true,1212873495,28,1214572622,1699127
1671685427,205312,true,1212994782,28,1214572622,1577840
1671685463,205313,true,1212873495,28,1214572622,1699127
1671685559,205313,true,1212873495,28,1214572622,1699127
1671685739,205313,true,1212873495,28,1214572622,1699127
1671686303,205313,true,1212873495,28,1214329743,1456248
1671686663,205314,true,1212752219,28,1214086914,1334695
1671690287,205314,true,1212752219,28,1213237393,485174
1671690371,205313,true,1212873495,28,1213237393,363898
1671690455,205313,true,1212873495,28,1213237393,363898
1671690659,205314,true,1212752219,28,1213237393,485174
1671691343,205314,true,1212752219,28,1213237393,485174
1671692903,205314,true,1212752219,28,1213237393,485174
1671694427,205314,true,1212752219,28,1213237393,485174
1671694535,205315,true,1212630956,28,1213237393,606437
1671695195,205315,true,1212630956,28,1213237393,606437
1671696335,205314,true,1212752219,28,1213237393,485174
1671696563,205314,true,1212752219,28,1213237393,485174
1671697667,205315,true,1212630956,28,1213237393,606437
1671697931,205315,true,1212630956,28,1213237393,606437
1671698039,205315,true,1212630956,28,1213358717,727761
1671698135,205314,true,1212752219,28,1213358717,606498
1671698615,205315,true,1212630956,28,1213844133,1213177
1671700319,205315,true,1212630956,28,1214937030,2306074
1671701843,205314,true,1212752219,28,1214937030,2184811
1671701855,205314,true,1212752219,28,1215058523,2306304
1671702071,205315,true,1212630956,28,1215301547,2670591
1671702923,205315,true,1212630956,28,1216639048,4008092
1671705887,205315,true,1212630956,28,1217856234,5225278
1671706043,205314,true,1212752219,28,1217856234,5104015
1671706175,205315,true,1212630956,28,1217856234,5225278
1671706991,205314,true,1212752219,28,1217856234,5104015
1671707675,205314,true,1212752219,28,1217856234,5104015
1671707927,205314,true,1212752219,28,1217856234,5104015
1671709619,205314,true,1212752219,28,1217856234,5104015
1671712619,205313,true,1212873495,28,1217856234,4982739
1671712703,205312,true,1212994782,28,1217856234,4861452
1671713831,205312,true,1212994782,28,1217856234,4861452
1671713951,205312,true,1212994782,28,1217856234,4861452
1671714563,205311,true,1213116081,28,1217856234,4740153
1671714887,205310,true,1213237393,28,1217856234,4618841
1671715811,205310,true,1213237393,28,1217612700,4375307
1671715823,205310,true,1213237393,28,1217612700,4375307
1671716651,205310,true,1213237393,28,1216274129,3036736
1671716663,205309,true,1213358717,28,1216274129,2915412
1671716675,205310,true,1213237393,28,1216274129,3036736
1671716711,205310,true,1213237393,28,1216152514,2915121
1671716927,205310,true,1213237393,28,1215666174,2428781
1671716939,205309,true,1213358717,28,1215666174,2307457
1671716987,205310,true,1213237393,28,1215423077,2185684
1671718487,205310,true,1213237393,28,1212024823,-1212570
1671719555,205310,true,1213237393,28,1211782454,-1454939
1671719591,205309,true,1213358717,28,1211782454,-1576263
1671719603,205310,true,1213237393,28,1211661288,-1576105
1671719711,205310,true,1213237393,28,1211055639,-2181754
1671719963,205313,true,1212873495,28,1209603316,-3270179
1671719975,205312,true,1212994782,28,1209603316,-3391466
1671719999,205313,true,1212873495,28,1209482368,-3391127
1671720035,205313,true,1212873495,28,1209240508,-3632987
1671720335,205316,true,1212509705,28,1207065941,-5443764
1671720479,205316,true,1212509705,28,1206100723,-6408982
1671720515,205316,true,1212509705,28,1205859539,-6650166
1671720635,205316,true,1212509705,28,1204895285,-7614420
1671720671,205320,true,1212024823,28,1204654342,-7370481
1671720683,205319,true,1212146025,28,1204533889,-7612136
1671721211,205321,true,1211903632,28,1199725617,-12178015
1671721223,205321,true,1211903632,28,1199605656,-12297976
1671721331,205324,true,1211540134,28,1198526551,-13013583
1671722315,205325,true,1211418992,28,1191833894,-19585098
1671722771,205327,true,1211176744,28,1189928579,-21248165
1671722843,205327,true,1211176744,28,1189690629,-21486115
1671723707,205331,true,1210692395,28,1188620443,-22071952
1671727763,205332,true,1210571338,28,1188620443,-21950895
1671728795,205334,true,1210329260,28,1188620443,-21708817
1671729683,205334,true,1210329260,28,1188620443,-21708817
1671730427,205338,true,1209845249,28,1188620443,-21224806
1671730859,205338,true,1209845249,28,1188620443,-21224806
1671731015,205340,true,1209603316,28,1188620443,-20982873
1671733823,205341,true,1209482368,28,1187669974,-21812394
1671734819,205344,true,1209119596,28,1187669974,-21449622
1671734975,205345,true,1208998696,28,1187669974,-21328722
1671736403,205347,true,1208756933,28,1187669974,-21086959
1671736487,205347,true,1208756933,28,1187788741,-20968192
1671737303,205351,true,1208273551,28,1188145114,-20128437
1671737327,205352,true,1208152735,28,1188145114,-20007621
1671737363,205353,true,1208031932,28,1188145114,-19886818
1671737399,205354,true,1207911141,28,1188263928,-19647213
1671737495,205357,true,1207548840,28,1188382755,-19166085
1671737543,205358,true,1207428097,28,1188382755,-19045342
1671737699,205359,true,1207307367,28,1188739305,-18568062
1671737723,205360,true,1207186648,28,1188739305,-18447343
1671739655,205363,true,1206824564,28,1191714722,-15109842
1671739763,205363,true,1206824564,28,1191833894,-14990670
1671739823,205365,true,1206583236,28,1191833894,-14749342
1671739835,205366,true,1206462589,28,1191833894,-14628695
1671739859,205369,true,1206100723,28,1191833894,-14266829
1671740039,205369,true,1206100723,28,1191953077,-14147646
1671740147,205371,true,1205859539,28,1192072272,-13787267
1671740315,205371,true,1205859539,28,1192191480,-13668059
1671740327,205374,true,1205497854,28,1192191480,-13306374
1671740411,205375,true,1205377316,28,1192310699,-13066617
1671740423,205377,true,1205136276,28,1192310699,-12825577
1671740435,205377,true,1205136276,28,1192429930,-12706346
1671740471,205380,true,1204774808,28,1192429930,-12344878
1671740495,205381,true,1204654342,28,1192549173,-12105169
1671740507,205382,true,1204533889,28,1192549173,-11984716
1671740531,205381,true,1204654342,28,1192787695,-11866647
1671740543,205383,true,1204413448,28,1192906973,-11506475
1671740555,205382,true,1204533889,28,1193145567,-11388322
1671740579,205381,true,1204654342,28,1193622897,-11031445
1671740591,205378,true,1205015775,28,1193981019,-11034756
1671740615,205379,true,1204895285,28,1194458683,-10436602
1671740639,205377,true,1205136276,28,1194936538,-10199738
1671740663,205376,true,1205256790,28,1195414585,-9842205
1671740723,205374,true,1205497854,28,1196610537,-8887317
1671740735,205375,true,1205377316,28,1196730198,-8647118
1671740759,205374,true,1205497854,28,1197208962,-8288892
1671740867,205373,true,1205618403,28,1199006033,-6612370
1671740891,205371,true,1205859539,28,1199485708,-6373831
1671740903,205372,true,1205738965,28,1199605656,-6133309
1671740927,205371,true,1205859539,28,1199965574,-5893965
1671741515,205371,true,1205859539,28,1208998696,3139157
1671741575,205370,true,1205980125,28,1209966234,3986109
1671741587,205371,true,1205859539,28,1210087230,4227691
1671741683,205369,true,1206100723,28,1211540134,5439411
1671741695,205370,true,1205980125,28,1211661288,5681163
1671741707,205368,true,1206221333,28,1211782454,5561121
1671741719,205369,true,1206100723,28,1212024823,5924100
1671745499,205368,true,1206221333,28,1216882388,10661055
1671745583,205369,true,1206100723,28,1216882388,10781665
1671746603,205367,true,1206341955,28,1216882388,10540433
1671747059,205368,true,1206221333,28,1216882388,10661055
1671747143,205367,true,1206341955,28,1216882388,10540433
1671750263,205368,true,1206221333,28,1216882388,10661055
1671751379,205366,true,1206462589,28,1216882388,10419799
1671751763,205368,true,1206221333,28,1216882388,10661055
1671751883,205367,true,1206341955,28,1216882388,10540433
1671751931,205367,true,1206341955,28,1216882388,10540433
1671752915,205366,true,1206462589,28,1216882388,10419799
1671752987,205367,true,1206341955,28,1216882388,10540433
1671753035,205367,true,1206341955,28,1216882388,10540433
1671753083,205367,true,1206341955,28,1216882388,10540433
1671753119,205366,true,1206462589,28,1216882388,10419799
1671753179,205368,true,1206221333,28,1216882388,10661055
1671753311,205367,true,1206341955,28,1216882388,10540433
1671753479,205368,true,1206221333,28,1216882388,10661055
1671753707,205366,true,1206462589,28,1216882388,10419799
1671756239,205368,true,1206221333,28,1216882388,10661055
1671760835,205367,true,1206341955,28,1216882388,10540433
1671761087,205368,true,1206221333,28,1216882388,10661055
1671761759,205367,true,1206341955,28,1216882388,10540433
1671763271,205368,true,1206221333,28,1216882388,10661055
1671763991,205368,true,1206221333,28,1216882388,10661055
1671764015,205368,true,1206221333,28,1216882388,10661055
1671764051,205367,true,1206341955,28,1217004076,10662121
1671764123,205368,true,1206221333,28,1217004076,10782743
1671764183,205367,true,1206341955,28,1217125776,10783821
1671764195,205367,true,1206341955,28,1217125776,10783821
1671764207,205366,true,1206462589,28,1217125776,10663187
1671764339,205366,true,1206462589,28,1217490951,11028362
1671764483,205364,true,1206703894,28,1217978020,11274126
1671764507,205364,true,1206703894,28,1217978020,11274126
1671764531,205363,true,1206824564,28,1218099818,11275254
1671765311,205362,true,1206945247,28,1221026622,14081375
1671766631,205361,true,1207065941,28,1224205262,17139321
1671767375,205361,true,1207065941,28,1224327683,17261742
1671769811,205359,true,1207307367,28,1224327683,17020316
1671770075,205356,true,1207669595,28,1224327683,16658088
1671770315,205354,true,1207911141,28,1224327683,16416542
1671770627,205354,true,1207911141,28,1224205262,16294121
1671772175,205352,true,1208152735,28,1223593343,15440608
1671772835,205349,true,1208515217,28,1223593343,15078126
1671772883,205347,true,1208756933,28,1223593343,14836410
1671774395,205347,true,1208756933,28,1223593343,14836410
1671774635,205345,true,1208998696,28,1223593343,14594647
1671775295,205341,true,1209482368,28,1223593343,14110975
1671776735,205340,true,1209603316,28,1223593343,13990027
1671776975,205339,true,1209724277,28,1223593343,13869066
1671777383,205337,true,1209966234,28,1223593343,13627109
1671778367,205333,true,1210450293,28,1223470996,13020703
1671779603,205330,true,1210813464,28,1223348661,12535197
1671779951,205329,true,1210934545,28,1223348661,12414116
1671782831,205326,true,1211297862,28,1223348661,12050799
1671782867,205323,true,1211661288,28,1223348661,11687373
1671782879,205320,true,1212024823,28,1223348661,11323838
1671782903,205318,true,1212267240,28,1223348661,11081421
1671782951,205317,true,1212388466,28,1223348661,10960195
1671782963,205313,true,1212873495,28,1223226339,10352844
1671785099,205310,true,1213237393,28,1220050240,6812847
1671785771,205309,true,1213358717,28,1220050240,6691523
1671786335,205307,true,1213601401,28,1220050240,6448839
1671786923,205303,true,1214086914,28,1220050240,5963326
1671786983,205301,true,1214329743,28,1220050240,5720497
1671787103,205299,true,1214572622,28,1220050240,5477618
1671787331,205297,true,1214815548,28,1220050240,5234692
1671787907,205294,true,1215180029,28,1220050240,4870211
1671788207,205291,true,1215544620,28,1220050240,4505620
1671788531,205290,true,1215666174,28,1220050240,4384066
1671791027,205288,true,1215909320,28,1220050240,4140920
1671791327,205285,true,1216274129,28,1220050240,3776111
1671791543,205282,true,1216639048,28,1220050240,3411192
1671791591,205281,true,1216760712,28,1220050240,3289528
1671791615,205279,true,1217004076,28,1220172245,3168169
1671791699,205276,true,1217369214,28,1220172245,2803031
1671791771,205274,true,1217612700,28,1220172245,2559545
1671792779,205272,true,1217856234,28,1221392966,3536732
1671795875,205270,true,1218099818,28,1222248198,4148380
1671801431,205267,true,1218465284,28,1222248198,3782914
1671801575,205265,true,1218708989,28,1222370423,3661434
1671802211,205264,true,1218830860,28,1222614909,3784049
1671802259,205262,true,1219074639,28,1222492660,3418021
1671802271,205259,true,1219440398,28,1222492660,3052262
1671802343,205256,true,1219806266,28,1222614909,2808643
1671802559,205255,true,1219928247,28,1222614909,2686662
1671802571,205253,true,1220172245,28,1222614909,2442664
1671802715,205250,true,1220538333,28,1222614909,2076576
1671802763,205248,true,1220782453,28,1222614909,1832456
1671802775,205247,true,1220904531,28,1222614909,1710378
1671802787,205247,true,1220904531,28,1222737171,1832640
1671802823,205244,true,1221270839,28,1222737171,1466332
1671803375,205244,true,1221270839,28,1223593343,2322504
1671803543,205246,true,1221026622,28,1223838074,2811452
1671803567,205247,true,1220904531,28,1223838074,2933543
1671803759,205246,true,1221026622,28,1223960458,2933836
1671803783,205246,true,1221026622,28,1223960458,2933836
1671804191,205247,true,1220904531,28,1224082854,3178323
1671804239,205248,true,1220782453,28,1224082854,3300401
1671804323,205247,true,1220904531,28,1224082854,3178323
1671804347,205247,true,1220904531,28,1223960458,3055927
1671805415,205248,true,1220782453,28,1222003785,1221332
1671805631,205249,true,1220660387,28,1221637257,976870
1671805691,205248,true,1220782453,28,1221515106,732653
1671805703,205247,true,1220904531,28,1221515106,610575
1671805715,205248,true,1220782453,28,1221515106,732653
1671806183,205249,true,1220660387,28,1220538333,-122054
1671806195,205248,true,1220782453,28,1220538333,-244120
1671806207,205247,true,1220904531,28,1220416292,-488239
1671806231,205248,true,1220782453,28,1220416292,-366161
1671806459,205249,true,1220660387,28,1219806266,-854121
1671806483,205248,true,1220782453,28,1219684298,-1098155
1671806519,205247,true,1220904531,28,1219684298,-1220233
1671806711,205248,true,1220782453,28,1219074639,-1707814
1671807311,205249,true,1220660387,28,1217612700,-3047687
1671807335,205248,true,1220782453,28,1217612700,-3169753
1671807983,205247,true,1220904531,28,1216639048,-4265483
1671808751,205248,true,1220782453,28,1216639048,-4143405
1671808787,205249,true,1220660387,28,1216639048,-4021339
1671808811,205248,true,1220782453,28,1216639048,-4143405
1671809459,205247,true,1220904531,28,1217125776,-3778755
1671809495,205248,true,1220782453,28,1217125776,-3656677
1671809519,205249,true,1220660387,28,1217125776,-3534611
1671809531,205248,true,1220782453,28,1217125776,-3656677
1671809543,205247,true,1220904531,28,1217247489,-3657042
1671809723,205247,true,1220904531,28,1217490951,-3413580
1671809759,205248,true,1220782453,28,1217490951,-3291502
1671809867,205247,true,1220904531,28,1217612700,-3291831
1671809903,205246,true,1221026622,28,1217734461,-3292161
1671809915,205246,true,1221026622,28,1217734461,-3292161
1671810179,205247,true,1220904531,28,1218343450,-2561081
1671810515,205246,true,1221026622,28,1219074639,-1951983
1671810887,205245,true,1221148724,28,1220050240,-1098484
1671811043,205245,true,1221148724,28,1220416292,-732432
1671811343,205246,true,1221026622,28,1221148724,122102
1671811403,205245,true,1221148724,28,1221148724,0
1671811883,205243,true,1221392966,28,1221637257,244291
1671812639,205244,true,1221270839,28,1221637257,366418
1671812651,205245,true,1221148724,28,1221637257,488533
1671813923,205244,true,1221270839,28,1220416292,-854547
1671814763,205243,true,1221392966,28,1219928247,-1464719
1671814823,205243,true,1221392966,28,1219928247,-1464719
1671815555,205244,true,1221270839,28,1219928247,-1342592
1671815771,205244,true,1221270839,28,1219928247,-1342592
1671816155,205243,true,1221392966,28,1219928247,-1464719
1671816227,205244,true,1221270839,28,1219928247,-1342592
1671816851,205245,true,1221148724,28,1219928247,-1220477
1671816863,205245,true,1221148724,28,1219928247,-1220477
1671818159,205245,true,1221148724,28,1219928247,-1220477
1671819143,205245,true,1221148724,28,1219928247,-1220477
1671820679,205246,true,1221026622,28,1219928247,-1098375
1671823703,205246,true,1221026622,28,1219928247,-1098375
1671826667,205246,true,1221026622,28,1219928247,-1098375
1671827435,205247,true,1220904531,28,1219928247,-976284
1671827639,205247,true,1220904531,28,1219928247,-976284
1671827891,205247,true,1220904531,28,1219928247,-976284
1671832331,205247,true,1220904531,28,1219928247,-976284
1671834803,205248,true,1220782453,28,1219806266,-976187
1671836735,205249,true,1220660387,28,1219806266,-854121
1671838739,205249,true,1220660387,28,1219806266,-854121
1671838967,205248,true,1220782453,28,1219806266,-976187
1671839627,205249,true,1220660387,28,1219806266,-854121
1671842375,205250,true,1220538333,28,1219806266,-732067
1671844247,205250,true,1220538333,28,1219928247,-610086
1671844823,205249,true,1220660387,28,1219928247,-732140
1671845159,205250,true,1220538333,28,1219928247,-610086
1671846575,205251,true,1220416292,28,1219928247,-488045
1671847031,205251,true,1220416292,28,1219928247,-488045
1671847175,205250,true,1220538333,28,1219928247,-610086
1671847271,205251,true,1220416292,28,1219928247,-488045
1671847283,205251,true,1220416292,28,1219928247,-488045
1671847523,205251,true,1220416292,28,1219806266,-610026
1671848159,205251,true,1220416292,28,1219318466,-1097826
1671850823,205251,true,1220416292,28,1218708989,-1707303
1671851543,205252,true,1220294262,28,1218708989,-1585273
1671852119,205252,true,1220294262,28,1218708989,-1585273
1671852203,205251,true,1220416292,28,1218708989,-1707303
1671856835,205251,true,1220416292,28,1218708989,-1707303
1671857435,205252,true,1220294262,28,1218708989,-1585273
1671857471,205252,true,1220294262,28,1218708989,-1585273
1671858491,205251,true,1220416292,28,1218708989,-1707303
1671859235,205252,true,1220294262,28,1218708989,-1585273
1671859619,205252,true,1220294262,28,1218708989,-1585273
1671861119,205252,true,1220294262,28,1217978020,-2316242
1671861239,205252,true,1220294262,28,1217856234,-2438028
1671861395,205252,true,1220294262,28,1217856234,-2438028
1671862007,205253,true,1220172245,28,1217490951,-2681294
1671862835,205253,true,1220172245,28,1217247489,-2924756
1671863531,205253,true,1220172245,28,1217004076,-3168169
1671864503,205254,true,1220050240,28,1217004076,-3046164
1671867803,205255,true,1219928247,28,1216882388,-3045859
1671868199,205255,true,1219928247,28,1216882388,-3045859
1671868823,205255,true,1219928247,28,1216882388,-3045859
1671868919,205256,true,1219806266,28,1216882388,-2923878
1671870287,205256,true,1219806266,28,1217004076,-2802190
1671872183,205257,true,1219684298,28,1217004076,-2680222
1671873479,205256,true,1219806266,28,1217004076,-2802190
1671873563,205257,true,1219684298,28,1217004076,-2680222
1671873647,205258,true,1219562342,28,1217004076,-2558266
1671877655,205258,true,1219562342,28,1217004076,-2558266
1671879695,205258,true,1219562342,28,1217004076,-2558266
1671879899,205259,true,1219440398,28,1217004076,-2436322
1671880055,205260,true,1219318466,28,1217004076,-2314390
1671881111,205260,true,1219318466,28,1217004076,-2314390
1671881123,205260,true,1219318466,28,1217004076,-2314390
1671881171,205261,true,1219196546,28,1217004076,-2192470
1671881915,205262,true,1219074639,28,1217004076,-2070563
1671881963,205263,true,1218952743,28,1217004076,-1948667
1671884891,205263,true,1218952743,28,1217004076,-1948667
1671887927,205263,true,1218952743,28,1217004076,-1948667
1671889163,205264,true,1218830860,28,1217004076,-1826784
1671890903,205264,true,1218830860,28,1217004076,-1826784
1671892703,205264,true,1218830860,28,1217004076,-1826784
1671893051,205264,true,1218830860,28,1217004076,-1826784
1671893111,205265,true,1218708989,28,1217004076,-1704913
1671893663,205266,true,1218587131,28,1217004076,-1583055
1671893963,205266,true,1218587131,28,1217004076,-1583055
1671894563,205265,true,1218708989,28,1217004076,-1704913
1671897287,205266,true,1218587131,28,1217004076,-1583055
1671897347,205266,true,1218587131,28,1217004076,-1583055
1671898067,205266,true,1218587131,28,1217004076,-1583055
1671900323,205266,true,1218587131,28,1217004076,-1583055
1671904067,205266,true,1218587131,28,1217004076,-1583055
1671904115,205266,true,1218587131,28,1217004076,-1583055
1671904655,205266,true,1218587131,28,1217004076,-1583055
1671904859,205266,true,1218587131,28,1217004076,-1583055
1671904883,205265,true,1218708989,28,1217125776,-1583213
1671905351,205266,true,1218587131,28,1217490951,-1096180
1671907679,205265,true,1218708989,28,1218587131,-121858
1671908411,205265,true,1218708989,28,1218587131,-121858
1671909059,205265,true,1218708989,28,1219440398,731409
1671909155,205265,true,1218708989,28,1219562342,853353
1671909167,205265,true,1218708989,28,1219562342,853353
1671909179,205264,true,1218830860,28,1219562342,731482
1671909311,205264,true,1218830860,28,1219806266,975406
1671911231,205264,true,1218830860,28,1222737171,3906311
1671911471,205263,true,1218952743,28,1222737171,3784428
1671913163,205263,true,1218952743,28,1222737171,3784428
1671913715,205263,true,1218952743,28,1222737171,3784428
1671913907,205263,true,1218952743,28,1222737171,3784428
1671914015,205262,true,1219074639,28,1222737171,3662532
1671916343,205262,true,1219074639,28,1222737171,3662532
1671918815,205262,true,1219074639,28,1222737171,3662532
1671919643,205262,true,1219074639,28,1222614909,3540270
1671920111,205262,true,1219074639,28,1222492660,3418021
1671920555,205262,true,1219074639,28,1222370423,3295784
1671921035,205262,true,1219074639,28,1222125985,3051346
1671921527,205262,true,1219074639,28,1221881597,2806958
1671922259,205262,true,1219074639,28,1221637257,2562618
1671926831,205262,true,1219074639,28,1221392966,2318327
1671929135,205262,true,1219074639,28,1221392966,2318327
1671935387,205262,true,1219074639,28,1221392966,2318327
1671939335,205262,true,1219074639,28,1221392966,2318327
1671943535,205262,true,1219074639,28,1221392966,2318327
1671944135,205261,true,1219196546,28,1221392966,2196420
1671944327,205261,true,1219196546,28,1221392966,2196420
1671944399,205261,true,1219196546,28,1221392966,2196420
1671944543,205261,true,1219196546,28,1221392966,2196420
1671944843,205261,true,1219196546,28,1221392966,2196420
1671945083,205261,true,1219196546,28,1221392966,2196420
1671945299,205261,true,1219196546,28,1221392966,2196420
1671945479,205261,true,1219196546,28,1221392966,2196420
1671945515,205260,true,1219318466,28,1221392966,2074500
1671945527,205261,true,1219196546,28,1221392966,2196420
1671945587,205261,true,1219196546,28,1221392966,2196420
1671945815,205261,true,1219196546,28,1221148724,1952178
1671946199,205261,true,1219196546,28,1220782453,1585907
1671946331,205261,true,1219196546,28,1220538333,1341787
1671947135,205261,true,1219196546,28,1219196546,0
1671947651,205261,true,1219196546,28,1218587131,-609415
1671949799,205261,true,1219196546,28,1218343450,-853096
1671950351,205261,true,1219196546,28,1218343450,-853096
1671952355,205261,true,1219196546,28,1218343450,-853096
1671953771,205262,true,1219074639,28,1218343450,-731189
1671956663,205261,true,1219196546,28,1218343450,-853096
1671961715,205262,true,1219074639,28,1218343450,-731189
1671961859,205262,true,1219074639,28,1218343450,-731189
1671961943,205262,true,1219074639,28,1218465284,-609355
1671962471,205262,true,1219074639,28,1218465284,-609355
1671962567,205262,true,1219074639,28,1218465284,-609355
1671967343,205262,true,1219074639,28,1218587131,-487508
1671968471,205262,true,1219074639,28,1218587131,-487508
1671970559,205262,true,1219074639,28,1218587131,-487508
1671970691,205262,true,1219074639,28,1218587131,-487508
1671973439,205262,true,1219074639,28,1218587131,-487508
1671973787,205262,true,1219074639,28,1218587131,-487508
1671974951,205262,true,1219074639,28,1218587131,-487508
1671975035,205262,true,1219074639,28,1218587131,-487508
1671978887,205262,true,1219074639,28,1218587131,-487508
1671978899,205262,true,1219074639,28,1218587131,-487508
1671978947,205262,true,1219074639,28,1218099818,-974821
1671978959,205262,true,1219074639,28,1217978020,-1096619
1671979067,205267,true,1218465284,28,1217004076,-1461208
1671979391,205267,true,1218465284,28,1214086914,-4378370
1671979403,205267,true,1218465284,28,1213965517,-4499767
1671979415,205267,true,1218465284,28,1213844133,-4621151
1671979427,205272,true,1217856234,28,1213722761,-4133473
1671980315,205270,true,1218099818,28,1208998696,-9101122
1671980363,205270,true,1218099818,28,1208756933,-9342885
1671980663,205269,true,1218221628,28,1207790362,-10431266
1671980675,205274,true,1217612700,28,1207669595,-9943105
1671981191,205271,true,1217978020,28,1210934545,-7043475
1671983531,205271,true,1217978020,28,1213601401,-4376619
1671983759,205270,true,1218099818,28,1213601401,-4498417
1671984263,205275,true,1217490951,28,1213601401,-3889550
1671984275,205272,true,1217856234,28,1213601401,-4254833
1671984455,205272,true,1217856234,28,1213480053,-4376181
1671984491,205271,true,1217978020,28,1213358717,-4619303
1671990899,205277,true,1217247489,28,1210692395,-6555094
1671992111,205274,true,1217612700,28,1210813464,-6799236
1671995303,205274,true,1217612700,28,1210813464,-6799236
1671995315,205273,true,1217734461,28,1210813464,-6920997
1671996563,205279,true,1217004076,28,1204654342,-12349734
1671996911,205277,true,1217247489,28,1202969091,-14278398
1671997343,205278,true,1217125776,28,1202127349,-14998427
1671997967,205278,true,1217125776,28,1202247562,-14878214
1671998039,205283,true,1216517396,28,1202367786,-14149610
1671998099,205281,true,1216760712,28,1202367786,-14392926
1671998111,205282,true,1216639048,28,1202367786,-14271262
1671998195,205282,true,1216639048,28,1202488023,-14151025
1671998243,205287,true,1216030911,28,1202608272,-13422639
1671999011,205284,true,1216395756,28,1204052196,-12343560
1671999359,205286,true,1216152514,28,1204774808,-11377706
1671999539,205285,true,1216274129,28,1205015775,-11258354
1671999971,205290,true,1215666174,28,1205738965,-9927209
1672003487,205288,true,1215909320,28,1205618403,-10290917
1672003511,205289,true,1215787741,28,1205738965,-10048776
1672003559,205288,true,1215909320,28,1205738965,-10170355
1672003619,205294,true,1215180029,28,1205980125,-9199904
1672003907,205290,true,1215666174,28,1206703894,-8962280
1672004267,205291,true,1215544620,28,1207669595,-7875025
1672004279,205290,true,1215666174,28,1207790362,-7875812
1672004315,205296,true,1214937030,28,1207911141,-7025889
1672004327,205292,true,1215423077,28,1207911141,-7511936
1672004363,205293,true,1215301547,28,1208031932,-7269615
1672004435,205292,true,1215423077,28,1208273551,-7149526
1672004483,205297,true,1214815548,28,1208515217,-6300331
1672005239,205293,true,1215301547,28,1211540134,-3761413
1672009643,205292,true,1215423077,28,1218708989,3285912
1672009847,205292,true,1215423077,28,1218708989,3285912
1672011515,205297,true,1214815548,28,1218708989,3893441
1672011947,205293,true,1215301547,28,1218708989,3407442
1672016291,205292,true,1215423077,28,1218708989,3285912
1672017647,205292,true,1215423077,28,1218708989,3285912
1672020167,205297,true,1214815548,28,1218708989,3893441
1672020191,205293,true,1215301547,28,1218830860,3529313
1672020443,205293,true,1215301547,28,1218830860,3529313
1672020455,205293,true,1215301547,28,1218830860,3529313
1672022627,205298,true,1214694079,28,1219928247,5234168
1672024487,205294,true,1215180029,28,1219928247,4748218
1672024703,205294,true,1215180029,28,1219928247,4748218
1672024907,205294,true,1215180029,28,1219928247,4748218
1672025867,205299,true,1214572622,28,1219928247,5355625
1672031915,205295,true,1215058523,28,1219928247,4869724
1672033583,205295,true,1215058523,28,1219928247,4869724
1672034939,205294,true,1215180029,28,1219928247,4748218
1672036631,205300,true,1214451176,28,1219928247,5477071
1672037471,205296,true,1214937030,28,1219928247,4991217
1672037843,205296,true,1214937030,28,1219928247,4991217
1672038107,205295,true,1215058523,28,1219928247,4869724
1672038875,205300,true,1214451176,28,1219928247,5477071
1672038923,205296,true,1214937030,28,1219928247,4991217
1672039679,205296,true,1214937030,28,1219928247,4991217
1672040351,205295,true,1215058523,28,1219928247,4869724
1672042487,205301,true,1214329743,28,1219928247,5598504
1672042643,205297,true,1214815548,28,1219928247,5112699
1672043627,205297,true,1214815548,28,1219928247,5112699
1672044095,205296,true,1214937030,28,1219928247,4991217
1672045235,205301,true,1214329743,28,1219928247,5598504
1672045403,205297,true,1214815548,28,1219928247,5112699
1672045871,205297,true,1214815548,28,1219928247,5112699
1672047239,205296,true,1214937030,28,1219928247,4991217
1672047359,205302,true,1214208323,28,1219928247,5719924
1672047431,205297,true,1214815548,28,1219928247,5112699
1672048055,205297,true,1214815548,28,1219928247,5112699
1672049075,205297,true,1214815548,28,1219928247,5112699
1672054007,205302,true,1214208323,28,1219928247,5719924
1672054931,205297,true,1214815548,28,1219928247,5112699
1672057331,205297,true,1214815548,28,1219928247,5112699
1672059275,205297,true,1214815548,28,1219928247,5112699
1672060331,205302,true,1214208323,28,1219928247,5719924
1672063319,205297,true,1214815548,28,1217856234,3040686
1672063379,205297,true,1214815548,28,1217856234,3040686
1672064795,205297,true,1214815548,28,1217856234,3040686
1672064939,205302,true,1214208323,28,1217856234,3647911
1672065287,205297,true,1214815548,28,1217856234,3040686
1672065623,205297,true,1214815548,28,1217856234,3040686
1672066967,205297,true,1214815548,28,1217856234,3040686
1672068047,205302,true,1214208323,28,1217856234,3647911
1672068479,205298,true,1214694079,28,1217856234,3162155
1672069355,205297,true,1214815548,28,1217856234,3040686
1672069451,205297,true,1214815548,28,1217856234,3040686
1672069715,205302,true,1214208323,28,1217856234,3647911
1672069955,205298,true,1214694079,28,1217856234,3162155
1672069967,205298,true,1214694079,28,1217856234,3162155
1672071011,205297,true,1214815548,28,1217734461,2918913
1672073363,205302,true,1214208323,28,1217490951,3282628
1672075247,205298,true,1214694079,28,1217490951,2796872
1672075391,205298,true,1214694079,28,1217490951,2796872
1672075787,205298,true,1214694079,28,1217490951,2796872
1672076783,205303,true,1214086914,28,1217369214,3282300
1672077731,205299,true,1214572622,28,1217247489,2674867
1672078031,205298,true,1214694079,28,1217247489,2553410
1672078343,205298,true,1214694079,28,1217247489,2553410
1672078439,205298,true,1214694079,28,1217247489,2553410
1672078739,205294,true,1215180029,28,1217125776,1945747
1672078811,205294,true,1215180029,28,1217125776,1945747
1672079303,205294,true,1215180029,28,1217004076,1824047
1672079711,205294,true,1215180029,28,1216760712,1580683
1672080995,205292,true,1215423077,28,1216517396,1094319
1672083803,205292,true,1215423077,28,1216517396,1094319
1672089659,205292,true,1215423077,28,1216517396,1094319
1672090619,205292,true,1215423077,28,1216517396,1094319
1672092359,205291,true,1215544620,28,1216517396,972776
1672092839,205291,true,1215544620,28,1216517396,972776
1672093943,205291,true,1215544620,28,1216517396,972776
1672094099,205291,true,1215544620,28,1216517396,972776
1672096499,205290,true,1215666174,28,1216517396,851222
1672096511,205290,true,1215666174,28,1216639048,972874
1672096595,205290,true,1215666174,28,1216639048,972874
1672097063,205290,true,1215666174,28,1217004076,1337902
1672097087,205288,true,1215909320,28,1217004076,1094756
1672097111,205288,true,1215909320,28,1217004076,1094756
1672097279,205288,true,1215909320,28,1217125776,1216456
1672097759,205287,true,1216030911,28,1217734461,1703550
1672097771,205285,true,1216274129,28,1217734461,1460332
1672097795,205283,true,1216517396,28,1217734461,1217065
1672098383,205282,true,1216639048,28,1219562342,2923294
1672098791,205281,true,1216760712,28,1220782453,4021741
1672098815,205279,true,1217004076,28,1220782453,3778377
1672098839,205277,true,1217247489,28,1220904531,3657042
1672098887,205276,true,1217369214,28,1221026622,3657408
1672098899,205275,true,1217490951,28,1221148724,3657773
1672098959,205273,true,1217734461,28,1221392966,3658505
1672099223,205271,true,1217978020,28,1222492660,4514640
1672099235,205270,true,1218099818,28,1222614909,4515091
1672099247,205269,true,1218221628,28,1222737171,4515543
1672099283,205267,true,1218465284,28,1222859444,4394160
1672099355,205264,true,1218830860,28,1223348661,4517801
1672099391,205263,true,1218952743,28,1223593343,4640600
1672099739,205262,true,1219074639,28,1225430019,6355380
1672100363,205261,true,1219196546,28,1228128797,8932251
1672101251,205258,true,1219562342,28,1229849296,10286954
1672101299,205258,true,1219562342,28,1229726323,10163981
1672101371,205256,true,1219806266,28,1229726323,9920057
1672101383,205255,true,1219928247,28,1229726323,9798076
1672101443,205253,true,1220172245,28,1229726323,9554078
1672101515,205253,true,1220172245,28,1229603363,9431118
1672101539,205252,true,1220294262,28,1229603363,9309101
1672101839,205251,true,1220416292,28,1229111644,8695352
1672101947,205251,true,1220416292,28,1228865859,8449567
1672102055,205250,true,1220538333,28,1228742985,8204652
1672102079,205249,true,1220660387,28,1228620123,7959736
1672102091,205249,true,1220660387,28,1228620123,7959736
1672102103,205248,true,1220782453,28,1228620123,7837670
1672105487,205248,true,1220782453,28,1225675117,4892664
1672105499,205247,true,1220904531,28,1225675117,4770586
1672107047,205247,true,1220904531,28,1225062463,4157932
1672108331,205246,true,1221026622,28,1224939969,3913347
1672109675,205246,true,1221026622,28,1224939969,3913347
1672109819,205245,true,1221148724,28,1224939969,3791245
1672109903,205245,true,1221148724,28,1224939969,3791245
1672113911,205245,true,1221148724,28,1224939969,3791245
1672116131,205245,true,1221148724,28,1224939969,3791245
1672117799,205244,true,1221270839,28,1224939969,3669130
1672121123,205244,true,1221270839,28,1224939969,3669130
1672124219,205243,true,1221392966,28,1224572561,3179595
1672125971,205243,true,1221392966,28,1224572561,3179595
1672126187,205243,true,1221392966,28,1224572561,3179595
1672126559,205243,true,1221392966,28,1224572561,3179595
1672126931,205242,true,1221515106,28,1224572561,3057455
1672127387,205242,true,1221515106,28,1224572561,3057455
1672128083,205241,true,1221637257,28,1224450116,2812859
1672128155,205241,true,1221637257,28,1224327683,2690426
1672128179,205241,true,1221637257,28,1224327683,2690426
1672128599,205241,true,1221637257,28,1223715703,2078446
1672128899,205241,true,1221637257,28,1223348661,1711404
1672128911,205241,true,1221637257,28,1223348661,1711404
1672130351,205240,true,1221759421,28,1221759421,0
1672131323,205241,true,1221637257,28,1221637257,0
1672131359,205240,true,1221759421,28,1221637257,-122164
1672131599,205240,true,1221759421,28,1221515106,-244315
1672131611,205240,true,1221759421,28,1221515106,-244315
1672131659,205240,true,1221759421,28,1221392966,-366455
1672132019,205240,true,1221759421,28,1221148724,-610697
1672132631,205240,true,1221759421,28,1220538333,-1221088
1672133939,205240,true,1221759421,28,1219806266,-1953155
1672134731,205240,true,1221759421,28,1219806266,-1953155
1672134911,205240,true,1221759421,28,1219806266,-1953155
1672134971,205240,true,1221759421,28,1219806266,-1953155
1672135043,205240,true,1221759421,28,1219806266,-1953155
1672135859,205240,true,1221759421,28,1219806266,-1953155
1672136147,205240,true,1221759421,28,1219806266,-1953155
1672136243,205240,true,1221759421,28,1219806266,-1953155
1672137155,205240,true,1221759421,28,1219806266,-1953155
1672137515,205240,true,1221759421,28,1219806266,-1953155
1672137959,205239,true,1221881597,28,1219806266,-2075331
1672140359,205240,true,1221759421,28,1219806266,-1953155
1672142855,205239,true,1221881597,28,1219806266,-2075331
1672144295,205239,true,1221881597,28,1219928247,-1953350
1672144307,205239,true,1221881597,28,1219928247,-1953350
1672144991,205239,true,1221881597,28,1219684298,-2197299
1672145207,205239,true,1221881597,28,1218952743,-2928854
1672145219,205239,true,1221881597,28,1218830860,-3050737
1672146779,205239,true,1221881597,28,1214572622,-7308975
1672147103,205240,true,1221759421,28,1214694079,-7065342
1672147415,205240,true,1221759421,28,1214694079,-7065342
1672149191,205240,true,1221759421,28,1214815548,-6943873
1672149311,205240,true,1221759421,28,1214815548,-6943873
1672151771,205241,true,1221637257,28,1214815548,-6821709
1672151783,205240,true,1221759421,28,1214815548,-6943873
1672152587,205241,true,1221637257,28,1213116081,-8521176
1672153607,205242,true,1221515106,28,1210208239,-11306867
1672153955,205243,true,1221392966,28,1209966234,-11426732
1672154315,205243,true,1221392966,28,1209724277,-11668689
1672154327,205243,true,1221392966,28,1209724277,-11668689
1672154351,205244,true,1221270839,28,1209724277,-11546562
1672154363,205245,true,1221148724,28,1209724277,-11424447
1672154567,205244,true,1221270839,28,1210087230,-11183609
1672154579,205245,true,1221148724,28,1210087230,-11061494
1672155107,205245,true,1221148724,28,1211297862,-9850862
1672156751,205246,true,1221026622,28,1213722761,-7303861
1672156859,205245,true,1221148724,28,1213722761,-7425963
1672157783,205245,true,1221148724,28,1213601401,-7547323
1672158071,205246,true,1221026622,28,1213480053,-7546569
1672158179,205247,true,1220904531,28,1213358717,-7545814
1672161815,205246,true,1221026622,28,1212267240,-8759382
1672161863,205247,true,1220904531,28,1212267240,-8637291
1672162511,205247,true,1220904531,28,1211782454,-9122077
1672163015,205248,true,1220782453,28,1211176744,-9605709
1672163027,205248,true,1220782453,28,1211055639,-9726814
1672163207,205249,true,1220660387,28,1210329260,-10331127
1672163591,205250,true,1220538333,28,1208636069,-11902264
1672163915,205252,true,1220294262,28,1207428097,-12866165
1672165163,205252,true,1220294262,28,1204654342,-15639920
1672165703,205253,true,1220172245,28,1204654342,-15517903
1672169039,205254,true,1220050240,28,1204654342,-15395898
1672169687,205256,true,1219806266,28,1204654342,-15151924
1672170167,205256,true,1219806266,28,1204774808,-15031458
1672170215,205257,true,1219684298,28,1204774808,-14909490
1672170227,205259,true,1219440398,28,1204895285,-14545113
1672170299,205261,true,1219196546,28,1204895285,-14301261
1672170395,205260,true,1219318466,28,1205015775,-14302691
1672170491,205262,true,1219074639,28,1205136276,-13938363
1672170779,205264,true,1218830860,28,1205377316,-13453544
1672171139,205267,true,1218465284,28,1205859539,-12605745
1672171847,205266,true,1218587131,28,1206824564,-11762567
1672172099,205268,true,1218343450,28,1207065941,-11277509
1672172111,205270,true,1218099818,28,1207065941,-11033877
1672172123,205272,true,1217856234,28,1207065941,-10790293
1672172147,205272,true,1217856234,28,1207065941,-10790293
1672175555,205274,true,1217612700,28,1208152735,-9459965
1672175831,205276,true,1217369214,28,1208152735,-9216479
1672179239,205279,true,1217004076,28,1208152735,-8851341
1672179251,205279,true,1217004076,28,1208273551,-8730525
1672179359,205280,true,1216882388,28,1208273551,-8608837
1672180055,205283,true,1216517396,28,1208636069,-7881327
1672180727,205285,true,1216274129,28,1209119596,-7154533
1672180787,205285,true,1216274129,28,1209119596,-7154533
1672183619,205286,true,1216152514,28,1209966234,-6186280
1672184231,205288,true,1215909320,28,1209966234,-5943086
1672184483,205290,true,1215666174,28,1209966234,-5699940
1672184639,205290,true,1215666174,28,1210087230,-5578944
1672184831,205291,true,1215544620,28,1210087230,-5457390
1672184903,205293,true,1215301547,28,1210087230,-5214317
1672187015,205295,true,1215058523,28,1210329260,-4729263
1672187123,205294,true,1215180029,28,1210571338,-4608691
1672187195,205295,true,1215058523,28,1210692395,-4366128
1672187435,205297,true,1214815548,28,1211055639,-3759909
1672187603,205298,true,1214694079,28,1211297862,-3396217
1672187747,205298,true,1214694079,28,1211540134,-3153945
1672188947,205299,true,1214572622,28,1212630956,-1941666
1672188971,205301,true,1214329743,28,1212630956,-1698787
1672189007,205302,true,1214208323,28,1212630956,-1577367
1672189019,205302,true,1214208323,28,1212630956,-1577367
1672189043,205303,true,1214086914,28,1212630956,-1455958
1672189775,205305,true,1213844133,28,1211176744,-2667389
1672189883,205306,true,1213722761,28,1211055639,-2667122
1672190147,205306,true,1213722761,28,1210450293,-3272468
1672191011,205308,true,1213480053,28,1208515217,-4964836
1672191035,205310,true,1213237393,28,1208515217,-4722176
1672191071,205311,true,1213116081,28,1208515217,-4600864
1672191119,205311,true,1213116081,28,1208515217,-4600864
1672192223,205312,true,1212994782,28,1209966234,-3028548
1672192487,205314,true,1212752219,28,1210450293,-2301926
1672193675,205315,true,1212630956,28,1211176744,-1454212
1672193939,205315,true,1212630956,28,1211176744,-1454212
1672195103,205315,true,1212630956,28,1210813464,-1817492
1672195211,205317,true,1212388466,28,1210813464,-1575002
1672195235,205319,true,1212146025,28,1210813464,-1332561
1672195979,205318,true,1212267240,28,1210208239,-2059001
1672196327,205319,true,1212146025,28,1210087230,-2058795
1672196471,205321,true,1211903632,28,1209966234,-1937398
1672196483,205322,true,1211782454,28,1209966234,-1816220
1672196579,205322,true,1211782454,28,1209845249,-1937205
1672196591,205322,true,1211782454,28,1209845249,-1937205
1672196603,205324,true,1211540134,28,1209845249,-1694885
1672196651,205326,true,1211297862,28,1209724277,-1573585
1672196795,205326,true,1211297862,28,1209361432,-1936430
1672196999,205326,true,1211297862,28,1208756933,-2540929
1672197023,205329,true,1210934545,28,1208756933,-2177612
1672197035,205330,true,1210813464,28,1208636069,-2177395
1672197059,205330,true,1210813464,28,1208515217,-2298247
1672197323,205334,true,1210329260,28,1206100723,-4228537
1672197899,205336,true,1210087230,28,1200925883,-9161347
1672198535,205337,true,1209966234,28,1195534126,-14432108
1672198547,205338,true,1209845249,28,1195534126,-14311123
1672199375,205341,true,1209482368,28,1193981019,-15501349
1672199723,205344,true,1209119596,28,1194219827,-14899769
1672201019,205345,true,1208998696,28,1194817057,-14181639
1672201031,205346,true,1208877808,28,1194817057,-14060751
1672201091,205349,true,1208515217,28,1194817057,-13698160
1672202711,205351,true,1208273551,28,1195056032,-13217519
1672203899,205352,true,1208152735,28,1195295055,-12857680
1672205831,205353,true,1208031932,28,1195414585,-12617347
1672206035,205355,true,1207790362,28,1195414585,-12375777
1672206071,205357,true,1207548840,28,1195414585,-12134255
1672206095,205358,true,1207428097,28,1195414585,-12013512
1672206191,205359,true,1207307367,28,1195175538,-12131829
1672206803,205362,true,1206945247,28,1193981019,-12964228
1672208663,205364,true,1206703894,28,1191714722,-14989172
1672211735,205365,true,1206583236,28,1191714722,-14868514
1672211747,205366,true,1206462589,28,1191833894,-14628695
1672212563,205369,true,1206100723,28,1192072272,-14028451
1672212647,205370,true,1205980125,28,1192191480,-13788645
1672212743,205370,true,1205980125,28,1192191480,-13788645
1672213043,205371,true,1205859539,28,1192310699,-13548840
1672213139,205374,true,1205497854,28,1192429930,-13067924
1672213355,205375,true,1205377316,28,1192549173,-12828143
1672213487,205375,true,1205377316,28,1192668428,-12708888
1672213571,205377,true,1205136276,28,1192668428,-12467848
1672214723,205380,true,1204774808,28,1193264881,-11509927
1672215395,205381,true,1204654342,28,1193384208,-11270134
1672217687,205381,true,1204654342,28,1193384208,-11270134
1672221047,205383,true,1204413448,28,1193384208,-11029240
1672221167,205386,true,1204052196,28,1193503546,-10548650
1672222463,205387,true,1203931803,28,1193742259,-10189544
1672225307,205387,true,1203931803,28,1194458683,-9473120
1672225871,205388,true,1203811422,28,1194458683,-9352739
1672226999,205391,true,1203450350,28,1194458683,-8991667
1672227539,205392,true,1203330017,28,1194458683,-8871334
1672228295,205392,true,1203330017,28,1194458683,-8871334
1672232111,205393,true,1203209696,28,1194458683,-8751013
1672233179,205395,true,1202969091,28,1194458683,-8510408
1672235627,205396,true,1202848806,28,1194458683,-8390123
1672236179,205395,true,1202969091,28,1194458683,-8510408
1672236611,205396,true,1202848806,28,1194458683,-8390123
1672237043,205399,true,1202488023,28,1194458683,-8029340
1672237271,205399,true,1202488023,28,1194458683,-8029340
1672237967,205398,true,1202608272,28,1194458683,-8149589
1672237991,205399,true,1202488023,28,1194578129,-7909894
1672238003,205402,true,1202127349,28,1194578129,-7549220
1672238015,205402,true,1202127349,28,1194578129,-7549220
1672238027,205400,true,1202367786,28,1194578129,-7789657
1672238051,205401,true,1202247562,28,1194697587,-7549975
1672238147,205403,true,1202007148,28,1194936538,-7070610
1672238159,205404,true,1201886960,28,1195056032,-6830928
1672238603,205402,true,1202127349,28,1196490888,-5636461
1672239035,205403,true,1202007148,28,1198526551,-3480597
1672241351,205405,true,1201766783,28,1203811422,2044639
1672241375,205405,true,1201766783,28,1203811422,2044639
1672241483,205403,true,1202007148,28,1203570695,1563547
1672241783,205404,true,1201886960,28,1202848806,961846
1672241795,205407,true,1201526466,28,1202728533,1202067
1672241807,205408,true,1201406325,28,1202728533,1322208
1672241819,205406,true,1201646618,28,1202728533,1081915
1672241891,205407,true,1201526466,28,1202367786,841320
1672241903,205411,true,1201045975,28,1202247562,1201587
1672241915,205412,true,1200925883,28,1202247562,1321679
1672241927,205410,true,1201166080,28,1202127349,961269
1672243007,205412,true,1200925883,28,1195534126,-5391757
1672243103,205416,true,1200445632,28,1194936538,-5509094
1672243127,205417,true,1200325600,28,1194817057,-5508543
1672243223,205415,true,1200565677,28,1194339249,-6226428
1672243343,205418,true,1200205579,28,1193861633,-6343946
1672244915,205422,true,1199725617,28,1191119044,-8606573
1672245455,205423,true,1199605656,28,1190999944,-8605712
1672245623,205421,true,1199845589,28,1190999944,-8845645
1672247327,205423,true,1199605656,28,1190999944,-8605712
1672248095,205427,true,1199125934,28,1190999944,-8125990
1672248839,205428,true,1199006033,28,1190999944,-8006089
1672248863,205428,true,1199006033,28,1191119044,-7886989
1672248899,205430,true,1198766268,28,1191119044,-7647224
1672248923,205434,true,1198286882,28,1191119044,-7167838
1672249139,205435,true,1198167065,28,1191238156,-6928909
1672250363,205434,true,1198286882,28,1192191480,-6095402
1672250375,205436,true,1198047260,28,1192191480,-5855780
1672250483,205439,true,1197687918,28,1192310699,-5377219
1672250495,205440,true,1197568161,28,1192310699,-5257462
1672250507,205439,true,1197687918,28,1192310699,-5377219
1672250531,205441,true,1197448416,28,1192310699,-5137717
1672251275,205443,true,1197208962,28,1194100417,-3108545
1672252559,205443,true,1197208962,28,1196371251,-837711
1672252907,205442,true,1197328683,28,1196371251,-957432
1672253519,205444,true,1197089253,28,1196371251,-718002
1672257119,205447,true,1196730198,28,1196371251,-358947
1672257155,205448,true,1196610537,28,1196371251,-239286
1672257227,205446,true,1196849871,28,1196371251,-478620
1672257587,205448,true,1196610537,28,1196251626,-358911
1672257791,205452,true,1196132013,28,1196132013,0
1672257803,205452,true,1196132013,28,1196132013,0
1672258727,205451,true,1196251626,28,1195295055,-956571
1672261715,205453,true,1196012412,28,1194817057,-1195355
1672262735,205456,true,1195653680,28,1194697587,-956093
1672262759,205456,true,1195653680,28,1194697587,-956093
1672263047,205456,true,1195653680,28,1193384208,-2269472
1672263059,205458,true,1195414585,28,1193384208,-2030377
1672263071,205463,true,1194817057,28,1193384208,-1432849
1672263611,205463,true,1194817057,28,1191357279,-3459778
1672265399,205462,true,1194936538,28,1187551219,-7385319
1672266083,205463,true,1194817057,28,1187432476,-7384581
1672266359,205468,true,1194219827,28,1187432476,-6787351
1672266407,205468,true,1194219827,28,1187432476,-6787351
1672266491,205467,true,1194339249,28,1187432476,-6906773
1672266659,205469,true,1194100417,28,1187432476,-6667941
1672267439,205471,true,1193861633,28,1187195025,-6666608
1672267499,205470,true,1193981019,28,1187195025,-6785994
1672269839,205469,true,1194100417,28,1186957622,-7142795
1672270199,205470,true,1193981019,28,1186957622,-7023397
1672271879,205473,true,1193622897,28,1186957622,-6665275
1672272311,205472,true,1193742259,28,1187076318,-6665941
1672272371,205471,true,1193861633,28,1187076318,-6785315
1672272443,205473,true,1193622897,28,1187076318,-6546579
1672272587,205475,true,1193384208,28,1187195025,-6189183
1672272647,205474,true,1193503546,28,1187195025,-6308521
1672273103,205474,true,1193503546,28,1187432476,-6071070
1672274279,205475,true,1193384208,28,1187788741,-5595467
1672274831,205477,true,1193145567,28,1187907520,-5238047
1672275203,205477,true,1193145567,28,1188026311,-5119256
1672275215,205476,true,1193264881,28,1188026311,-5238570
1672275227,205477,true,1193145567,28,1188026311,-5119256
1672275407,205478,true,1193026264,28,1188382755,-4643509
1672275743,205477,true,1193145567,28,1188858179,-4287388
1672276931,205476,true,1193264881,28,1190523663,-2741218
1672280375,205477,true,1193145567,28,1190642715,-2502852
1672280675,205479,true,1192906973,28,1190642715,-2264258
1672280771,205477,true,1193145567,28,1190642715,-2502852
1672285931,205477,true,1193145567,28,1190047572,-3097995
1672286399,205478,true,1193026264,28,1190166577,-2859687
1672287071,205479,true,1192906973,28,1190523663,-2383310
1672287947,205478,true,1193026264,28,1190999944,-2026320
1672287971,205477,true,1193145567,28,1190999944,-2145623
1672289879,205478,true,1193026264,28,1193264881,238617
1672289975,205479,true,1192906973,28,1193264881,357908
1672294667,205478,true,1193026264,28,1193384208,357944
1672294847,205477,true,1193145567,28,1193384208,238641
1672296251,205478,true,1193026264,28,1193384208,357944
1672297367,205480,true,1192787695,28,1193384208,596513
1672298039,205478,true,1193026264,28,1193384208,357944
1672298495,205477,true,1193145567,28,1193384208,238641
1672298771,205478,true,1193026264,28,1193384208,357944
1672298903,205480,true,1192787695,28,1193384208,596513
1672298915,205479,true,1192906973,28,1193384208,477235
1672299263,205478,true,1193026264,28,1193384208,357944
1672299611,205479,true,1192906973,28,1193384208,477235
1672300799,205480,true,1192787695,28,1193384208,596513
1672302983,205479,true,1192906973,28,1193384208,477235
1672305215,205478,true,1193026264,28,1193264881,238617
1672305347,205479,true,1192906973,28,1193264881,357908
1672305815,205480,true,1192787695,28,1193264881,477186
1672305839,205479,true,1192906973,28,1193384208,477235
1672305851,205478,true,1193026264,28,1193384208,357944
1672305911,205479,true,1192906973,28,1193503546,596573
1672307495,205480,true,1192787695,28,1196969556,4181861
1672310051,205478,true,1193026264,28,1197089253,4062989
1672310939,205478,true,1193026264,28,1197089253,4062989
1672312355,205480,true,1192787695,28,1197089253,4301558
1672312379,205480,true,1192787695,28,1197208962,4421267
1672312499,205479,true,1192906973,28,1197208962,4301989
1672312595,205479,true,1192906973,28,1197328683,4421710
1672312655,205481,true,1192668428,28,1197328683,4660255
1672315019,205482,true,1192549173,28,1199725617,7176444
1672318991,205480,true,1192787695,28,1199725617,6937922
1672320623,205480,true,1192787695,28,1199725617,6937922
1672322171,205482,true,1192549173,28,1201166080,8616907
1672326587,205481,true,1192668428,28,1201286196,8617768
1672327283,205480,true,1192787695,28,1201406325,8618630
1672328195,205480,true,1192787695,28,1201646618,8858923
1672330307,205480,true,1192787695,28,1201646618,8858923
1672331195,205480,true,1192787695,28,1201646618,8858923
1672332659,205478,true,1193026264,28,1201526466,8500202
1672334099,205478,true,1193026264,28,1201526466,8500202
1672335359,205478,true,1193026264,28,1201406325,8380061
1672335443,205477,true,1193145567,28,1201406325,8260758
1672335503,205475,true,1193384208,28,1201406325,8022117
1672335527,205475,true,1193384208,28,1201406325,8022117
1672336499,205475,true,1193384208,28,1200085571,6701363
1672338131,205475,true,1193384208,28,1199006033,5621825
1672342595,205473,true,1193622897,28,1199006033,5383136
1672345415,205473,true,1193622897,28,1199006033,5383136
1672345655,205473,true,1193622897,28,1199006033,5383136
1672346087,205472,true,1193742259,28,1199006033,5263774
1672346099,205471,true,1193861633,28,1198886145,5024512
1672346111,205471,true,1193861633,28,1198886145,5024512
1672346159,205471,true,1193861633,28,1198886145,5024512
1672346195,205470,true,1193981019,28,1198886145,4905126
1672346207,205469,true,1194100417,28,1198886145,4785728
1672346219,205469,true,1194100417,28,1198886145,4785728
1672346243,205470,true,1193981019,28,1198766268,4785249
1672352423,205469,true,1194100417,28,1195414585,1314168
1672353083,205468,true,1194219827,28,1195414585,1194758
1672353515,205468,true,1194219827,28,1195414585,1194758
1672353575,205469,true,1194100417,28,1195534126,1433709
1672354307,205469,true,1194100417,28,1196371251,2270834
1672355507,205468,true,1194219827,28,1197328683,3108856
1672355615,205468,true,1194219827,28,1197448416,3228589
1672356419,205468,true,1194219827,28,1198406710,4186883
1672356911,205468,true,1194219827,28,1199725617,5505790
1672359395,205466,true,1194458683,28,1202367786,7909103
1672359503,205466,true,1194458683,28,1202367786,7909103
1672360859,205467,true,1194339249,28,1202247562,7908313
1672361063,205466,true,1194458683,28,1202247562,7788879
1672361783,205464,true,1194697587,28,1202127349,7429762
1672363835,205464,true,1194697587,28,1202007148,7309561
1672363931,205464,true,1194697587,28,1202007148,7309561
1672364027,205464,true,1194697587,28,1202007148,7309561
1672364087,205462,true,1194936538,28,1202007148,7070610
1672364123,205462,true,1194936538,28,1202007148,7070610
1672364147,205462,true,1194936538,28,1202007148,7070610
1672364207,205460,true,1195175538,28,1201886960,6711422
1672364243,205459,true,1195295055,28,1201886960,6591905
1672364387,205459,true,1195295055,28,1201646618,6351563
1672368239,205459,true,1195295055,28,1198526551,3231496
1672370099,205457,true,1195534126,28,1198526551,2992425
1672374695,205455,true,1195773245,28,1198526551,2753306
1672376999,205455,true,1195773245,28,1198526551,2753306
1672377059,205455,true,1195773245,28,1198526551,2753306
1672377503,205454,true,1195892822,28,1198526551,2633729
1672377623,205452,true,1196132013,28,1198526551,2394538
1672378523,205452,true,1196132013,28,1198286882,2154869
1672379027,205452,true,1196132013,28,1198167065,2035052
1672379171,205450,true,1196371251,28,1198047260,1676009
1672379387,205448,true,1196610537,28,1197927467,1316930
1672379411,205449,true,1196490888,28,1197927467,1436579
1672379423,205449,true,1196490888,28,1197927467,1436579
1672379435,205447,true,1196730198,28,1197927467,1197269
1672379519,205446,true,1196849871,28,1197807687,957816
1672383371,205447,true,1196730198,28,1194817057,-1913141
1672385051,205447,true,1196730198,28,1194817057,-1913141
1672385075,205445,true,1196969556,28,1194817057,-2152499
1672385183,205444,true,1197089253,28,1194578129,-2511124
1672385507,205445,true,1196969556,28,1193622897,-3346659
1672385555,205446,true,1196849871,28,1193503546,-3346325
1672388951,205445,true,1196969556,28,1189095962,-7873594
1672391927,205444,true,1197089253,28,1189095962,-7993291
1672392047,205445,true,1196969556,28,1189214872,-7754684
1672392083,205447,true,1196730198,28,1189214872,-7515326
1672392107,205445,true,1196969556,28,1189214872,-7754684
1672392227,205445,true,1196969556,28,1189214872,-7754684
1672392299,205445,true,1196969556,28,1189333794,-7635762
1672392383,205447,true,1196730198,28,1189333794,-7396404
1672397147,205445,true,1196969556,28,1190523663,-6445893
1672401839,205445,true,1196969556,28,1190523663,-6445893
1672402943,205445,true,1196969556,28,1190523663,-6445893
1672407623,205447,true,1196730198,28,1190523663,-6206535
1672409243,205446,true,1196849871,28,1190523663,-6326208
1672409543,205445,true,1196969556,28,1190523663,-6445893
1672410575,205446,true,1196849871,28,1190523663,-6326208
1672410995,205448,true,1196610537,28,1190523663,-6086874
1672411763,205447,true,1196730198,28,1190523663,-6206535
1672411883,205446,true,1196849871,28,1190166577,-6683294
1672412063,205447,true,1196730198,28,1189690629,-7039569
1672412711,205450,true,1196371251,28,1188026311,-8344940
1672413263,205449,true,1196490888,28,1186720266,-9770622
1672413323,205449,true,1196490888,28,1186601606,-9889282
1672413395,205450,true,1196371251,28,1186364321,-10006930
1672413431,205452,true,1196132013,28,1186364321,-9767692
1672413443,205451,true,1196251626,28,1186245696,-10005930
1672413455,205451,true,1196251626,28,1186245696,-10005930
1672413479,205451,true,1196251626,28,1186245696,-10005930
1672413491,205453,true,1196012412,28,1186245696,-9766716
1672413515,205452,true,1196132013,28,1186245696,-9886317
1672413527,205451,true,1196251626,28,1186364321,-9887305
1672414799,205451,true,1196251626,28,1192191480,-4060146
1672415423,205453,true,1196012412,28,1194339249,-1673163
1672415927,205453,true,1196012412,28,1194339249,-1673163
1672417199,205452,true,1196132013,28,1194339249,-1792764
1672417571,205452,true,1196132013,28,1194458683,-1673330
1672418447,205454,true,1195892822,28,1194458683,-1434139
1672421255,205454,true,1195892822,28,1194458683,-1434139
1672422575,205453,true,1196012412,28,1194458683,-1553729
1672423391,205453,true,1196012412,28,1194458683,-1553729
1672423583,205455,true,1195773245,28,1194458683,-1314562
1672423727,205455,true,1195773245,28,1194458683,-1314562
1672424243,205455,true,1195773245,28,1194458683,-1314562
1672424543,205454,true,1195892822,28,1194458683,-1434139
1672427687,205456,true,1195653680,28,1194458683,-1194997
1672428143,205457,true,1195534126,28,1194458683,-1075443
1672429079,205457,true,1195534126,28,1194458683,-1075443
1672429775,205456,true,1195653680,28,1194458683,-1194997
1672432259,205459,true,1195295055,28,1194339249,-955806
1672434023,205459,true,1195295055,28,1194339249,-955806
1672434095,205459,true,1195295055,28,1194458683,-836372
1672434263,205458,true,1195414585,28,1194697587,-716998
1672434719,205460,true,1195175538,28,1195414585,239047
1672434779,205461,true,1195056032,28,1195534126,478094
1672435667,205460,true,1195175538,28,1197208962,2033424
1672438139,205460,true,1195175538,28,1197687918,2512380
1672447655,205461,true,1195056032,28,1197687918,2631886
1672451723,205461,true,1195056032,28,1197687918,2631886
1672453139,205460,true,1195175538,28,1197687918,2512380
1672453523,205460,true,1195175538,28,1197687918,2512380
1672457339,205461,true,1195056032,28,1197687918,2631886
1672458923,205461,true,1195056032,28,1197687918,2631886
1672459019,205461,true,1195056032,28,1197687918,2631886
1672459067,205460,true,1195175538,28,1197687918,2512380
1672459931,205462,true,1194936538,28,1197328683,2392145
1672466291,205462,true,1194936538,28,1196969556,2033018
1672472543,205461,true,1195056032,28,1195175538,119506
1672472891,205461,true,1195056032,28,1195175538,119506
1672478351,205462,true,1194936538,28,1195175538,239000
1672481063,205462,true,1194936538,28,1195175538,239000
1672482551,205461,true,1195056032,28,1195175538,119506
1672482623,205461,true,1195056032,28,1195295055,239023
1672482635,205462,true,1194936538,28,1195295055,358517
1672484627,205462,true,1194936538,28,1196969556,2033018
1672486043,205461,true,1195056032,28,1196969556,1913524
1672489571,205461,true,1195056032,28,1196969556,1913524
1672489763,205462,true,1194936538,28,1196969556,2033018
1672489847,205462,true,1194936538,28,1196969556,2033018
1672490531,205463,true,1194817057,28,1196969556,2152499
1672492859,205462,true,1194936538,28,1196969556,2033018
1672492943,205464,true,1194697587,28,1196969556,2271969
1672493015,205464,true,1194697587,28,1196969556,2271969
1672493075,205464,true,1194697587,28,1196969556,2271969
1672494239,205464,true,1194697587,28,1196969556,2271969
1672494911,205465,true,1194578129,28,1196969556,2391427
1672495067,205466,true,1194458683,28,1196969556,2510873
1672495235,205466,true,1194458683,28,1197089253,2630570
1672495403,205465,true,1194578129,28,1197089253,2511124
1672495463,205467,true,1194339249,28,1197089253,2750004
1672495703,205466,true,1194458683,28,1197208962,2750279
1672495919,205466,true,1194458683,28,1197208962,2750279
1672495931,205466,true,1194458683,28,1197208962,2750279
1672495979,205467,true,1194339249,28,1197208962,2869713
1672496171,205467,true,1194339249,28,1197448416,3109167
1672496531,205467,true,1194339249,28,1197687918,3348669
1672496555,205466,true,1194458683,28,1197807687,3349004
1672496567,205467,true,1194339249,28,1197807687,3468438
1672496783,205467,true,1194339249,28,1198047260,3708011
1672496915,205466,true,1194458683,28,1198406710,3948027
1672496939,205465,true,1194578129,28,1198406710,3828581
1672497011,205466,true,1194458683,28,1198646404,4187721
1672498139,205465,true,1194578129,28,1202608272,8030143
1672500215,205464,true,1194697587,28,1204052196,9354609
1672502555,205463,true,1194817057,28,1204052196,9235139
1672504187,205464,true,1194697587,28,1204052196,9354609
1672505375,205463,true,1194817057,28,1204052196,9235139
1672506299,205462,true,1194936538,28,1204052196,9115658
1672506899,205461,true,1195056032,28,1204052196,8996164
1672506911,205462,true,1194936538,28,1204052196,9115658
1672507175,205460,true,1195175538,28,1204052196,8876658
1672507187,205459,true,1195295055,28,1204052196,8757141
1672507211,205458,true,1195414585,28,1204052196,8637611
1672507235,205458,true,1195414585,28,1204052196,8637611
1672508843,205456,true,1195653680,28,1202247562,6593882
1672508879,205455,true,1195773245,28,1202127349,6354104
1672509623,205454,true,1195892822,28,1202007148,6114326
1672509767,205454,true,1195892822,28,1202007148,6114326
1672512491,205452,true,1196132013,28,1202007148,5875135
1672512623,205452,true,1196132013,28,1202007148,5875135
1672512743,205450,true,1196371251,28,1202007148,5635897
1672525151,205450,true,1196371251,28,1201766783,5395532
1672526339,205449,true,1196490888,28,1201406325,4915437
1672526531,205448,true,1196610537,28,1201286196,4675659
1672526579,205447,true,1196730198,28,1201166080,4435882
1672526711,205447,true,1196730198,28,1201166080,4435882
1672526831,205446,true,1196849871,28,1201045975,4196104
1672526915,205445,true,1196969556,28,1200925883,3956327
1672526939,205444,true,1197089253,28,1200925883,3836630
1672527023,205444,true,1197089253,28,1200805802,3716549
1672527047,205443,true,1197208962,28,1200805802,3596840
1672527059,205443,true,1197208962,28,1200805802,3596840
1672527179,205442,true,1197328683,28,1200445632,3116949
1672527263,205442,true,1197328683,28,1200205579,2876896
1672527347,205440,true,1197568161,28,1200085571,2517410
1672527371,205439,true,1197687918,28,1199965574,2277656
1672528355,205439,true,1197687918,28,1197328683,-359235
1672528619,205439,true,1197687918,28,1196730198,-957720
1672528847,205437,true,1197927467,28,1196371251,-1556216
1672533443,205437,true,1197927467,28,1196251626,-1675841
1672539299,205436,true,1198047260,28,1195892822,-2154438
1672542095,205436,true,1198047260,28,1195892822,-2154438
1672542911,205436,true,1198047260,28,1195653680,-2393580
1672545023,205435,true,1198167065,28,1194100417,-4066648
1672548563,205436,true,1198047260,28,1194100417,-3946843
1672550915,205437,true,1197927467,28,1192906973,-5020494
1672551215,205436,true,1198047260,28,1192906973,-5140287
1672551335,205435,true,1198167065,28,1192906973,-5260092
1672553411,205436,true,1198047260,28,1192787695,-5259565
1672555523,205437,true,1197927467,28,1192787695,-5139772
1672555643,205436,true,1198047260,28,1192906973,-5140287
1672557215,205436,true,1198047260,28,1192906973,-5140287
1672558223,205437,true,1197927467,28,1192906973,-5020494
1672558523,205438,true,1197807687,28,1192906973,-4900714
1672559435,205437,true,1197927467,28,1192906973,-5020494
1672561955,205436,true,1198047260,28,1192906973,-5140287
1672570883,205437,true,1197927467,28,1192906973,-5020494
1672570895,205438,true,1197807687,28,1193026264,-4781423
1672571051,205437,true,1197927467,28,1193026264,-4901203
1672571075,205437,true,1197927467,28,1193026264,-4901203
1672574699,205438,true,1197807687,28,1193384208,-4423479
1672576127,205438,true,1197807687,28,1193384208,-4423479
1672576727,205437,true,1197927467,28,1193742259,-4185208
1672578071,205437,true,1197927467,28,1195653680,-2273787
1672578851,205438,true,1197807687,28,1196012412,-1795275
1672579991,205438,true,1197807687,28,1196012412,-1795275
1672580447,205438,true,1197807687,28,1196012412,-1795275
1672583183,205437,true,1197927467,28,1196012412,-1915055
1672583195,205438,true,1197807687,28,1196012412,-1795275
1672583207,205439,true,1197687918,28,1196012412,-1675506
1672586231,205438,true,1197807687,28,1196012412,-1795275
1672586435,205438,true,1197807687,28,1196012412,-1795275
1672589099,205439,true,1197687918,28,1196012412,-1675506
1672590827,205439,true,1197687918,28,1196012412,-1675506
1672593671,205439,true,1197687918,28,1196012412,-1675506
1672593863,205438,true,1197807687,28,1196132013,-1675674
1672593983,205439,true,1197687918,28,1196251626,-1436292
1672593995,205440,true,1197568161,28,1196251626,-1316535
1672596515,205438,true,1197807687,28,1198886145,1078458
1672598975,205438,true,1197807687,28,1198886145,1078458
1672600391,205438,true,1197807687,28,1198886145,1078458
1672600655,205439,true,1197687918,28,1199006033,1318115
1672601567,205437,true,1197927467,28,1199485708,1558241
1672601711,205436,true,1198047260,28,1199605656,1558396
1672605575,205437,true,1197927467,28,1200205579,2278112
1672606211,205437,true,1197927467,28,1200205579,2278112
1672607027,205436,true,1198047260,28,1200205579,2158319
1672612643,205435,true,1198167065,28,1200205579,2038514
1672614719,205436,true,1198047260,28,1200205579,2158319
1672616315,205436,true,1198047260,28,1200205579,2158319
1672616579,205435,true,1198167065,28,1200205579,2038514
1672621571,205434,true,1198286882,28,1200205579,1918697
1672621583,205435,true,1198167065,28,1200205579,2038514
1672621595,205435,true,1198167065,28,1200205579,2038514
1672621655,205434,true,1198286882,28,1200205579,1918697
1672621691,205434,true,1198286882,28,1200205579,1918697
1672622183,205434,true,1198286882,28,1199725617,1438735
1672622195,205435,true,1198167065,28,1199725617,1558552
1672622207,205433,true,1198406710,28,1199605656,1198946
1672625315,205434,true,1198286882,28,1196849871,-1437011
1672630883,205434,true,1198286882,28,1196849871,-1437011
1672631627,205435,true,1198167065,28,1196849871,-1317194
1672631639,205434,true,1198286882,28,1196969556,-1317326
1672631675,205434,true,1198286882,28,1196969556,-1317326
1672631831,205434,true,1198286882,28,1197208962,-1077920
1672632527,205434,true,1198286882,28,1198047260,-239622
1672632587,205433,true,1198406710,28,1198167065,-239645
1672632863,205434,true,1198286882,28,1198526551,239669
1672635983,205434,true,1198286882,28,1199245847,958965
1672639091,205434,true,1198286882,28,1199245847,958965
1672639511,205433,true,1198406710,28,1199245847,839137
1672640663,205434,true,1198286882,28,1199965574,1678692
1672640783,205434,true,1198286882,28,1199965574,1678692
1672642319,205434,true,1198286882,28,1200205579,1918697
1672643615,205434,true,1198286882,28,1200205579,1918697
1672643663,205435,true,1198167065,28,1200205579,2038514
1672643675,205436,true,1198047260,28,1200205579,2158319
1672643687,205435,true,1198167065,28,1200325600,2158535
1672643699,205435,true,1198167065,28,1200325600,2158535
1672643735,205436,true,1198047260,28,1200325600,2278340
1672643747,205436,true,1198047260,28,1200325600,2278340
1672643771,205435,true,1198167065,28,1200565677,2398612
1672643783,205435,true,1198167065,28,1200565677,2398612
1672643795,205434,true,1198286882,28,1200685733,2398851
1672643819,205434,true,1198286882,28,1200805802,2518920
1672643831,205433,true,1198406710,28,1200925883,2519173
1672643855,205432,true,1198526551,28,1201045975,2519424
1672646171,205431,true,1198646404,28,1212267240,13620836
1672647851,205431,true,1198646404,28,1212267240,13620836
1672648283,205430,true,1198766268,28,1212267240,13500972
1672648379,205429,true,1198886145,28,1212388466,13502321
1672648427,205428,true,1199006033,28,1212388466,13382433
1672648451,205428,true,1199006033,28,1212388466,13382433
1672648679,205425,true,1199365771,28,1213237393,13871622
1672649615,205424,true,1199485708,28,1216639048,17153340
1672649627,205423,true,1199605656,28,1216639048,17033392
1672650131,205423,true,1199605656,28,1218343450,18737794
1672651499,205420,true,1199965574,28,1218099818,18134244
1672654151,205418,true,1200205579,28,1218099818,17894239
1672656575,205418,true,1200205579,28,1219684298,19478719
1672657055,205417,true,1200325600,28,1219684298,19358698
1672657775,205415,true,1200565677,28,1219806266,19240589
1672658315,205413,true,1200805802,28,1219806266,19000464
1672658747,205411,true,1201045975,28,1219806266,18760291
1672659251,205411,true,1201045975,28,1219562342,18516367
1672659467,205408,true,1201406325,28,1219318466,17912141
1672661159,205406,true,1201646618,28,1217734461,16087843
1672661171,205405,true,1201766783,28,1217734461,15967678
1672661903,205404,true,1201886960,28,1217612700,15725740
1672664831,205402,true,1202127349,28,1217612700,15485351
1672665131,205400,true,1202367786,28,1217612700,15244914
1672667015,205399,true,1202488023,28,1217612700,15124677
1672667255,205398,true,1202608272,28,1217612700,15004428
1672667303,205395,true,1202969091,28,1217612700,14643609
1672667375,205393,true,1203209696,28,1217612700,14403004
1672668023,205392,true,1203330017,28,1217490951,14160934
1672670639,205391,true,1203450350,28,1217125776,13675426
1672671707,205388,true,1203811422,28,1217125776,13314354
1672672763,205386,true,1204052196,28,1217125776,13073580
1672673351,205385,true,1204172601,28,1217125776,12953175
1672674287,205384,true,1204293018,28,1217125776,12832758
1672674671,205381,true,1204654342,28,1217125776,12471434
1672676819,205379,true,1204895285,28,1217125776,12230491
1672682711,205378,true,1205015775,28,1217125776,12110001
1672682963,205377,true,1205136276,28,1217125776,11989500
1672685759,205374,true,1205497854,28,1217125776,11627922
1672689839,205372,true,1205738965,28,1217125776,11386811
1672690043,205371,true,1205859539,28,1217125776,11266237
1672690583,205370,true,1205980125,28,1217125776,11145651
1672692167,205367,true,1206341955,28,1217125776,10783821
1672693835,205365,true,1206583236,28,1217125776,10542540
1672694171,205364,true,1206703894,28,1217125776,10421882
1672694687,205363,true,1206824564,28,1217125776,10301212
1672695875,205360,true,1207186648,28,1217125776,9939128
1672696727,205358,true,1207428097,28,1217125776,9697679
1672699715,205357,true,1207548840,28,1219684298,12135458
1672699727,205356,true,1207669595,28,1219684298,12014703
1672699739,205353,true,1208031932,28,1219684298,11652366
1672701299,205351,true,1208273551,28,1215787741,7514190
1672702043,205351,true,1208273551,28,1215180029,6906478
1672703939,205350,true,1208394378,28,1215180029,6785651
1672704059,205347,true,1208756933,28,1215180029,6423096
1672721315,205346,true,1208877808,28,1215180029,6302221
1672721783,205345,true,1208998696,28,1215180029,6181333
1672722827,205344,true,1209119596,28,1215180029,6060433
1672723547,205342,true,1209361432,28,1215180029,5818597
1672723631,205340,true,1209603316,28,1215180029,5576713
1672724075,205340,true,1209603316,28,1215180029,5576713
1672724291,205339,true,1209724277,28,1215180029,5455752
1672724663,205336,true,1210087230,28,1215058523,4971293
1672725815,205335,true,1210208239,28,1215058523,4850284
1672725935,205335,true,1210208239,28,1215180029,4971790
1672727447,205334,true,1210329260,28,1215423077,5093817
1672730999,205331,true,1210692395,28,1215666174,4973779
1672731479,205330,true,1210813464,28,1215666174,4852710
1672731503,205330,true,1210813464,28,1215666174,4852710
1672731803,205329,true,1210934545,28,1215666174,4731629
1672736951,205327,true,1211176744,28,1215666174,4489430
1672737191,205326,true,1211297862,28,1215666174,4368312
1672737467,205325,true,1211418992,28,1215666174,4247182
1672738355,205325,true,1211418992,28,1215666174,4247182
1672738835,205322,true,1211782454,28,1215666174,3883720
1672739975,205321,true,1211903632,28,1215666174,3762542
1672743347,205321,true,1211903632,28,1215666174,3762542
1672743863,205320,true,1212024823,28,1215666174,3641351
1672744859,205317,true,1212388466,28,1215666174,3277708
1672745567,205317,true,1212388466,28,1215666174,3277708
1672746779,205316,true,1212509705,28,1215666174,3156469
1672748099,205315,true,1212630956,28,1215666174,3035218
1672748735,205312,true,1212994782,28,1215666174,2671392
1672748747,205311,true,1213116081,28,1215666174,2550093
1672749323,205310,true,1213237393,28,1215666174,2428781
1672755707,205310,true,1213237393,28,1215666174,2428781
1672756283,205307,true,1213601401,28,1215666174,2064773
1672757591,205306,true,1213722761,28,1215666174,1943413
1672757891,205305,true,1213844133,28,1215666174,1822041
1672757915,205304,true,1213965517,28,1215666174,1700657
1672759511,205303,true,1214086914,28,1210450293,-3636621
1672760975,205303,true,1214086914,28,1209845249,-4241665
1672761203,205302,true,1214208323,28,1209845249,-4363074
1672761707,205301,true,1214329743,28,1209845249,-4484494
1672762139,205300,true,1214451176,28,1209845249,-4605927
1672763351,205299,true,1214572622,28,1209845249,-4727373
1672763915,205299,true,1214572622,28,1209845249,-4727373
1672768151,205298,true,1214694079,28,1209845249,-4848830
1672770023,205297,true,1214815548,28,1209845249,-4970299
1672772027,205297,true,1214815548,28,1209845249,-4970299
1672773167,205296,true,1214937030,28,1209240508,-5696522
1672773539,205295,true,1215058523,28,1208877808,-6180715
1672777055,205294,true,1215180029,28,1208273551,-6906478
1672778075,205294,true,1215180029,28,1208273551,-6906478
1672778639,205294,true,1215180029,28,1208273551,-6906478
1672779191,205294,true,1215180029,28,1208273551,-6906478
1672779275,205293,true,1215301547,28,1208273551,-7027996
1672779791,205294,true,1215180029,28,1208515217,-6664812
1672781291,205294,true,1215180029,28,1208877808,-6302221
1672783055,205294,true,1215180029,28,1208877808,-6302221
1672786823,205294,true,1215180029,28,1208877808,-6302221
1672787003,205295,true,1215058523,28,1208998696,-6059827
1672787231,205295,true,1215058523,28,1209119596,-5938927
1672788839,205295,true,1215058523,28,1211661288,-3397235
1672789271,205294,true,1215180029,28,1211903632,-3276397
1672789787,205295,true,1215058523,28,1211903632,-3154891
1672790363,205295,true,1215058523,28,1211903632,-3154891
1672791299,205295,true,1215058523,28,1211903632,-3154891
1672792895,205296,true,1214937030,28,1211903632,-3033398
1672793783,205297,true,1214815548,28,1211903632,-2911916
1672794479,205297,true,1214815548,28,1211903632,-2911916
1672794503,205297,true,1214815548,28,1212024823,-2790725
1672794515,205297,true,1214815548,28,1212024823,-2790725
1672794551,205298,true,1214694079,28,1212024823,-2669256
1672794623,205299,true,1214572622,28,1212024823,-2547799
1672794635,205299,true,1214572622,28,1212024823,-2547799
1672794647,205299,true,1214572622,28,1212146025,-2426597
1672794755,205300,true,1214451176,28,1212267240,-2183936
1672794767,205300,true,1214451176,28,1212267240,-2183936
1672794791,205300,true,1214451176,28,1212388466,-2062710
1672794959,205300,true,1214451176,28,1212752219,-1698957
1672794983,205301,true,1214329743,28,1212873495,-1456248
1672795175,205300,true,1214451176,28,1213601401,-849775
1672795187,205300,true,1214451176,28,1213601401,-849775
1672795211,205300,true,1214451176,28,1213722761,-728415
1672795355,205300,true,1214451176,28,1214572622,121446
1672795859,205299,true,1214572622,28,1217490951,2918329
1672795871,205299,true,1214572622,28,1217612700,3040078
1672795943,205298,true,1214694079,28,1218099818,3405739
1672796183,205298,true,1214694079,28,1219684298,4990219
1672798019,205297,true,1214815548,28,1223838074,9022526
1672798043,205297,true,1214815548,28,1223960458,9144910
1672799039,205296,true,1214937030,28,1224327683,9390653
1672799723,205296,true,1214937030,28,1224695018,9757988
1672800335,205294,true,1215180029,28,1226288077,11108048
1672801067,205294,true,1215180029,28,1228128797,12948768
1672801391,205293,true,1215301547,28,1228988746,13687199
1672801631,205292,true,1215423077,28,1229849296,14426219
1672801643,205291,true,1215544620,28,1229972281,14427661
1672801679,205289,true,1215787741,28,1230341309,14553568
1672801691,205287,true,1216030911,28,1230464343,14433432
1672801703,205284,true,1216395756,28,1230587390,14191634
1672802663,205281,true,1216760712,28,1241587948,24827236
1672802711,205280,true,1216882388,28,1242084657,25202269
1672802783,205278,true,1217125776,28,1242954377,25828601
1672804235,205274,true,1217612700,28,1249809117,32196417
1672804895,205272,true,1217856234,28,1249684149,31827915
1672804907,205270,true,1218099818,28,1249809117,31709299
1672804919,205269,true,1218221628,28,1249809117,31587489
1672805123,205265,true,1218708989,28,1249809117,31100128
1672806383,205262,true,1219074639,28,1250559190,31484551
1672806851,205261,true,1219196546,28,1250684246,31487700
1672807955,205259,true,1219440398,28,1250684246,31243848
1672810127,205255,true,1219928247,28,1250684246,30755999
1672811555,205252,true,1220294262,28,1250684246,30389984
1672814111,205251,true,1220416292,28,1250434147,30017855
1672818599,205249,true,1220660387,28,1250434147,29773760
1672818851,205245,true,1221148724,28,1250559190,29410466
1672820567,205242,true,1221515106,28,1250559190,29044084
1672820639,205241,true,1221637257,28,1250809314,29172057
1672820651,205239,true,1221881597,28,1250934395,29052798
1672820735,205235,true,1222370423,28,1251059489,28689066
1672820759,205230,true,1222981730,28,1251184595,28202865
1672820771,205229,true,1223104028,28,1251184595,28080567
1672820819,205227,true,1223348661,28,1251309713,27961052
1672820855,205224,true,1223715703,28,1251309713,27594010
1672820915,205219,true,1224327683,28,1251434844,27107161
1672821263,205218,true,1224450116,28,1251685143,27235027
1672821299,205217,true,1224572561,28,1251810312,27237751
1672822859,205213,true,1225062463,28,1252185893,27123430
1672826075,205209,true,1225552562,28,1252060687,26508125
1672826099,205208,true,1225675117,28,1252060687,26385570
1672834031,205206,true,1225920264,28,1252060687,26140423
1672834391,205203,true,1226288077,28,1252060687,25772610
1672835675,205198,true,1226901344,28,1252060687,25159343
1672837703,205197,true,1227024034,28,1252060687,25036653
1672838375,205196,true,1227146736,28,1252060687,24913951
1672838663,205192,true,1227637669,28,1252060687,24423018
1672841471,205188,true,1228128797,28,1252060687,23931890
1672842167,205187,true,1228251610,28,1252060687,23809077
1672842587,205185,true,1228497273,28,1252060687,23563414
1672844423,205181,true,1228988746,28,1252060687,23071941
1672844459,205177,true,1229480415,28,1252060687,22580272
1672844879,205176,true,1229603363,28,1251685143,22081780
1672844903,205175,true,1229726323,28,1251685143,21958820
1672844951,205171,true,1230218288,28,1251559987,21341699
1672845095,205167,true,1230710449,28,1251309713,20599264
1672845107,205166,true,1230833520,28,1251309713,20476193
1672845119,205165,true,1230956603,28,1251309713,20353110
1672846511,205162,true,1231325927,28,1247686352,16360425
1672846523,205158,true,1231818531,28,1247686352,15867821
1672846595,205157,true,1231941713,28,1247686352,15744639
1672847123,205155,true,1232188114,28,1247811121,15623007
1672847159,205151,true,1232681063,28,1247935902,15254839
1672847195,205147,true,1233174209,28,1247935902,14761693
1672847207,205146,true,1233297527,28,1247935902,14638375
1672847543,205143,true,1233667553,28,1248684851,15017298
1672847567,205139,true,1234161094,28,1248809719,14648625
1672847843,205134,true,1234778298,28,1249809117,15030819
1672852835,205133,true,1234901776,28,1253814711,18912935
1672852955,205130,true,1235272283,28,1253814711,18542428
1672853039,205126,true,1235766466,28,1253814711,18048245
1672853507,205121,true,1236384473,28,1254818114,18433641
1672853591,205120,true,1236508112,28,1255069090,18560978
1672853627,205116,true,1237002789,28,1255320117,18317328
1672853723,205112,true,1237497664,28,1255947902,18450238
1672853903,205105,true,1238364173,28,1257204416,18840243
1672854539,205103,true,1238611858,28,1261612120,23000262
1672854551,205099,true,1239107377,28,1261738281,22630904
1672854563,205095,true,1239603094,28,1261738281,22135187
1672854863,205088,true,1240471077,28,1263632214,23161137
1672854911,205086,true,1240719184,28,1263884953,23165769
1672854923,205083,true,1241091436,28,1263884953,22793517
1672855031,205079,true,1241587948,28,1264390583,22802635
1672855175,205072,true,1242457320,28,1264896415,22439095
1672855199,205071,true,1242581566,28,1265022904,22441338
1672855259,205068,true,1242954377,28,1265149407,22195030
1672855271,205064,true,1243451634,28,1265275922,21824288
1672855295,205057,true,1244322311,28,1265275922,20953611
1672855307,205056,true,1244446743,28,1265275922,20829179
1672855847,205053,true,1244820115,28,1264137742,19317627
1672857551,205049,true,1245318117,28,1261359835,16041718
1672858199,205043,true,1246065495,28,1261485971,15420476
1672858223,205042,true,1246190102,28,1261485971,15295869
1672858259,205039,true,1246563996,28,1261485971,14921975
1672858295,205035,true,1247062696,28,1261738281,14675585
1672858307,205028,true,1247935902,28,1261738281,13802379
1672858463,205026,true,1248185502,28,1262369276,14183774
1672858487,205023,true,1248559995,28,1262495513,13935518
1672858547,205019,true,1249059494,28,1262748025,13688531
1672858571,205013,true,1249809117,28,1262748025,12938908
1672858607,205011,true,1250059091,28,1262874300,12815209
1672858799,205009,true,1250309116,28,1263379525,13070409
1672858823,205005,true,1250809314,28,1263505863,12696549
1672858907,204999,true,1251559987,28,1263632214,12072227
1672858919,204997,true,1251810312,28,1263758577,11948265
1672858931,204995,true,1252060687,28,1263758577,11697890
1672859183,204993,true,1252311111,28,1263632214,11321103
1672859387,204988,true,1252937392,28,1263505863,10568471
1672859423,204986,true,1253187992,28,1263505863,10317871
1672859567,204984,true,1253438642,28,1263253200,9814558
1672860431,204982,true,1253689342,28,1260351201,6661859
1672860479,204978,true,1254190893,28,1260225179,6034286
1672860539,204976,true,1254441744,28,1259847187,5405443
1672860563,204975,true,1254567188,28,1259847187,5279999
1672860815,204973,true,1254818114,28,1258588032,3769918
1672862195,204969,true,1255320117,28,1255696751,376634
1672863815,204968,true,1255445649,28,1255320117,-125532
1672864583,204967,true,1255571193,28,1255194597,-376596
1672864871,204966,true,1255696751,28,1255069090,-627661
1672865063,204962,true,1256199105,28,1254943596,-1255509
1672866899,204962,true,1256199105,28,1249559193,-6639912
1672867787,204963,true,1256073497,28,1249559193,-6514304
1672868999,204965,true,1255822320,28,1249559193,-6263127
1672869671,204962,true,1256199105,28,1249559193,-6639912
1672871303,204962,true,1256199105,28,1249559193,-6639912
1672871735,204963,true,1256073497,28,1249684149,-6389348
1672872071,204965,true,1255822320,28,1249934098,-5888222
1672872155,204962,true,1256199105,28,1249934098,-6265007
1672872167,204962,true,1256199105,28,1249934098,-6265007
1672872191,204962,true,1256199105,28,1249934098,-6265007
1672875203,204964,true,1255947902,28,1252812111,-3135791
1672875539,204961,true,1256324724,28,1252937392,-3387332
1672876307,204961,true,1256324724,28,1253187992,-3136732
1672876919,204962,true,1256199105,28,1253438642,-2760463
1672877843,204963,true,1256073497,28,1253438642,-2634855
1672877855,204960,true,1256450357,28,1253563986,-2886371
1672878983,204960,true,1256450357,28,1254818114,-1632243
1672882943,204960,true,1256450357,28,1255445649,-1004708
1672885007,204962,true,1256199105,28,1255445649,-753456
1672886903,204959,true,1256576002,28,1255445649,-1130353
1672887203,204959,true,1256576002,28,1255571193,-1004809
1672888187,204959,true,1256576002,28,1255571193,-1004809
1672888379,204961,true,1256324724,28,1255571193,-753531
1672888571,204959,true,1256576002,28,1255571193,-1004809
1672890383,204959,true,1256576002,28,1255571193,-1004809
1672890671,204959,true,1256576002,28,1255571193,-1004809
1672891991,204960,true,1256450357,28,1255571193,-879164
1672892003,204958,true,1256701660,28,1255571193,-1130467
1672893539,204958,true,1256701660,28,1255445649,-1256011
1672897823,204958,true,1256701660,28,1255445649,-1256011
1672900175,204959,true,1256576002,28,1255445649,-1130353
1672900559,204958,true,1256701660,28,1255320117,-1381543
1672900583,204957,true,1256827330,28,1255320117,-1507213
1672902671,204957,true,1256827330,28,1253062686,-3764644
1672902935,204959,true,1256576002,28,1253062686,-3513316
1672903439,204957,true,1256827330,28,1253062686,-3764644
1672903463,204957,true,1256827330,28,1253062686,-3764644
1672903475,204957,true,1256827330,28,1253062686,-3764644
1672903739,204959,true,1256576002,28,1252937392,-3638610
1672903751,204957,true,1256827330,28,1252937392,-3889938
1672903763,204957,true,1256827330,28,1252937392,-3889938
1672906955,204957,true,1256827330,28,1251184595,-5642735
1672908167,204959,true,1256576002,28,1251184595,-5391407
1672908311,204957,true,1256827330,28,1251184595,-5642735
1672912067,204957,true,1256827330,28,1250434147,-6393183
1672912127,204958,true,1256701660,28,1250434147,-6267513
1672913147,204959,true,1256576002,28,1249434249,-7141753
1672914083,204957,true,1256827330,28,1248684851,-8142479
1672914227,204957,true,1256827330,28,1248684851,-8142479
1672919567,204958,true,1256701660,28,1248684851,-8016809
1672919591,204958,true,1256701660,28,1248809719,-7891941
1672919687,204957,true,1256827330,28,1248809719,-8017611
1672919699,204956,true,1256953012,28,1248809719,-8143293
1672919831,204957,true,1256827330,28,1248934600,-7892730
1672919927,204958,true,1256701660,28,1249059494,-7642166
1672920143,204956,true,1256953012,28,1249434249,-7518763
1672924439,204956,true,1256953012,28,1251559987,-5393025
1672927187,204957,true,1256827330,28,1251559987,-5267343
1672927211,204958,true,1256701660,28,1251559987,-5141673
1672929611,204957,true,1256827330,28,1250059091,-6768239
1672929623,204957,true,1256827330,28,1250059091,-6768239
1672929815,204958,true,1256701660,28,1249809117,-6892543
1672931015,204959,true,1256576002,28,1247312121,-9263881
1672931063,204959,true,1256576002,28,1247187403,-9388599
1672931135,204959,true,1256576002,28,1247062696,-9513306
1672931231,204961,true,1256324724,28,1246938003,-9386721
1672931303,204963,true,1256073497,28,1246813321,-9260176
1672931603,204964,true,1255947902,28,1246813321,-9134581
1672931999,204965,true,1255822320,28,1247312121,-8510199
1672932107,204966,true,1255696751,28,1247436853,-8259898
1672935287,204968,true,1255445649,28,1248684851,-6760798
1672944527,204969,true,1255320117,28,1248559995,-6760122
1672946303,204969,true,1255320117,28,1248559995,-6760122
1672946591,204971,true,1255069090,28,1248684851,-6384239
1672947395,204972,true,1254943596,28,1248809719,-6133877
1672947443,204973,true,1254818114,28,1248934600,-5883514
1672947959,204974,true,1254692645,28,1249309318,-5383327
1672948103,204975,true,1254567188,28,1249309318,-5257870
1672948247,204977,true,1254316313,28,1249434249,-4882064
1672953695,204977,true,1254316313,28,1250934395,-3381918
1672955615,204977,true,1254316313,28,1250934395,-3381918
1672957799,204978,true,1254190893,28,1250934395,-3256498
1672958507,204980,true,1253940093,28,1251059489,-2880604
1672961147,204980,true,1253940093,28,1251059489,-2880604
1672962791,204980,true,1253940093,28,1251059489,-2880604
1672964123,204981,true,1253814711,28,1251059489,-2755222
1672965515,204983,true,1253563986,28,1251059489,-2504497
1672966151,204984,true,1253438642,28,1251059489,-2379153
1672967351,204985,true,1253313311,28,1252561586,-751725
1672969043,204986,true,1253187992,28,1253187992,0
1672970663,204987,true,1253062686,28,1253187992,125306
1672970675,204988,true,1252937392,28,1253187992,250600
1672970699,204989,true,1252812111,28,1253187992,375881
1672970795,204990,true,1252686842,28,1253187992,501150
1672977659,204991,true,1252561586,28,1251559987,-1001599
1672981247,204992,true,1252436342,28,1251559987,-876355
1672983575,204993,true,1252311111,28,1251559987,-751124
1672986071,204994,true,1252185893,28,1251559987,-625906
1672986239,204994,true,1252185893,28,1251559987,-625906
1672986443,204995,true,1252060687,28,1251434844,-625843
1672986635,204996,true,1251935493,28,1251309713,-625780
1672989611,204997,true,1251810312,28,1249434249,-2376063
1672993403,204997,true,1251810312,28,1249434249,-2376063
1672993475,204998,true,1251685143,28,1249434249,-2250894
1672996955,204998,true,1251685143,28,1249434249,-2250894
1672997399,204999,true,1251559987,28,1249434249,-2125738
1672998455,204999,true,1251559987,28,1249434249,-2125738
1672998539,204999,true,1251559987,28,1249434249,-2125738
1673000879,205000,true,1251434844,28,1249434249,-2000595
1673002487,205001,true,1251309713,28,1249434249,-1875464
1673002703,205001,true,1251309713,28,1249434249,-1875464
1673002775,205001,true,1251309713,28,1249434249,-1875464
1673003051,205001,true,1251309713,28,1249309318,-2000395
1673003147,205001,true,1251309713,28,1249309318,-2000395
1673003159,205001,true,1251309713,28,1249309318,-2000395
1673003171,205001,true,1251309713,28,1249309318,-2000395
1673003483,205002,true,1251184595,28,1247811121,-3373474
1673003855,205004,true,1250934395,28,1246065495,-4868900
1673004131,205003,true,1251059489,28,1244820115,-6239374
1673005067,205004,true,1250934395,28,1241339667,-9594728
1673005175,205005,true,1250809314,28,1241339667,-9469647
1673008955,205006,true,1250684246,28,1241339667,-9344579
1673009255,205007,true,1250559190,28,1241339667,-9219523
1673011811,205007,true,1250559190,28,1241712106,-8847084
1673011919,205008,true,1250434147,28,1241712106,-8722041
1673012159,205009,true,1250309116,28,1241836278,-8472838
1673012555,205010,true,1250184097,28,1242084657,-8099440
1673012567,205010,true,1250184097,28,1242084657,-8099440
1673012603,205012,true,1249934098,28,1242084657,-7849441
1673012723,205013,true,1249809117,28,1242208866,-7600251
1673012735,205013,true,1249809117,28,1242333087,-7476030
1673012759,205013,true,1249809117,28,1242333087,-7476030
1673012771,205015,true,1249559193,28,1242333087,-7226106
1673013179,205015,true,1249559193,28,1243824706,-5734487
1673013371,205015,true,1249559193,28,1244571188,-4988005
1673013611,205015,true,1249559193,28,1245442649,-4116544
1673017475,205017,true,1249309318,28,1248310320,-998998
1673019143,205017,true,1249309318,28,1248435151,-874167
1673019371,205017,true,1249309318,28,1248435151,-874167
1673019419,205017,true,1249309318,28,1248559995,-749323
1673019455,205019,true,1249059494,28,1248559995,-499499
1673019503,205019,true,1249059494,28,1248559995,-499499
1673019515,205019,true,1249059494,28,1248559995,-499499
1673019659,205019,true,1249059494,28,1248809719,-249775
1673020151,205018,true,1249184400,28,1251559987,2375587
1673020235,205018,true,1249184400,28,1252060687,2876287
1673020703,205018,true,1249184400,28,1254692645,5508245
1673020955,205017,true,1249309318,28,1256450357,7141039
1673021051,205017,true,1249309318,28,1257078708,7769390
1673021123,205016,true,1249434249,28,1257707373,8273124
1673024435,205015,true,1249559193,28,1262369276,12810083
1673024459,205014,true,1249684149,28,1262495513,12811364
1673024495,205014,true,1249684149,28,1262495513,12811364
1673024507,205013,true,1249809117,28,1262495513,12686396
1673028923,205011,true,1250059091,28,1264264156,14205065
1673028959,205010,true,1250184097,28,1264264156,14080059
1673029499,205010,true,1250184097,28,1264390583,14206486
1673029511,205009,true,1250309116,28,1264390583,14081467
1673032619,205007,true,1250559190,28,1265528989,14969799
1673033867,205006,true,1250684246,28,1265528989,14844743
1673034011,205005,true,1250809314,28,1265908686,15099372
1673034023,205004,true,1250934395,28,1265908686,14974291
1673035343,205001,true,1251309713,28,1270855122,19545409
1673036855,204999,true,1251559987,28,1272253762,20693775
1673037083,204998,true,1251685143,28,1272253762,20568619
1673037251,204998,true,1251685143,28,1272253762,20568619
1673037767,204995,true,1252060687,28,1271999349,19938662
1673037887,204993,true,1252311111,28,1271999349,19688238
1673038055,204993,true,1252311111,28,1271872162,19561051
1673038211,204992,true,1252436342,28,1271744987,19308645
1673038295,204990,true,1252686842,28,1271617826,18930984
1673038655,204988,true,1252937392,28,1271109306,18171914
1673038715,204987,true,1253062686,28,1271109306,18046620
1673038847,204987,true,1253062686,28,1270855122,17792436
1673039351,204984,true,1253438642,28,1269838895,16400253
1673048387,204982,true,1253689342,28,1268189260,14499918
1673048675,204981,true,1253814711,28,1268189260,14374549
1673049431,204981,true,1253814711,28,1268189260,14374549
1673049779,204978,true,1254190893,28,1268189260,13998367
1673050979,204976,true,1254441744,28,1268189260,13747516
1673051159,204975,true,1254567188,28,1268316079,13748891
1673051351,204975,true,1254567188,28,1268316079,13748891
1673051459,204972,true,1254943596,28,1268316079,13372483
1673051651,204970,true,1255194597,28,1268316079,13121482
1673052167,204970,true,1255194597,28,1268569754,13375157
1673052311,204969,true,1255320117,28,1268569754,13249637
1673053895,204967,true,1255571193,28,1268823481,13252288
1673058899,204965,true,1255822320,28,1268823481,13001161
1673059919,204964,true,1255947902,28,1268823481,12875579
1673060327,204964,true,1255947902,28,1268823481,12875579
1673060879,204961,true,1256324724,28,1268823481,12498757
1673061011,204960,true,1256450357,28,1268823481,12373124
1673062583,204959,true,1256576002,28,1268696611,12120609
1673062595,204959,true,1256576002,28,1268696611,12120609
1673062715,204956,true,1256953012,28,1268696611,11743599
1673062823,204955,true,1257078708,28,1268569754,11491046
1673063591,204954,true,1257204416,28,1268569754,11365338
1673064479,204954,true,1257204416,28,1268569754,11365338
1673065931,204951,true,1257581615,28,1268569754,10988139
1673066015,204950,true,1257707373,28,1268569754,10862381
1673066195,204949,true,1257833144,28,1268569754,10736610
1673066243,204949,true,1257833144,28,1268569754,10736610
1673066339,204947,true,1258084723,28,1268442910,10358187
1673068955,204946,true,1258210531,28,1266668421,8457890
1673069267,204946,true,1258210531,28,1266668421,8457890
1673071343,204945,true,1258336352,28,1266668421,8332069
1673071355,204943,true,1258588032,28,1266668421,8080389
1673071811,204942,true,1258713891,28,1266541767,7827876
1673075687,204941,true,1258839762,28,1265908686,7068924
1673076395,204941,true,1258839762,28,1265908686,7068924
1673077163,204939,true,1259091543,28,1265908686,6817143
1673079827,204937,true,1259343374,28,1265908686,6565312
1673081807,204937,true,1259343374,28,1265908686,6565312
1673082311,204937,true,1259343374,28,1264769938,5426564
1673085383,204935,true,1259595255,28,1261612120,2016865
1673085839,204934,true,1259721215,28,1261612120,1890905
1673086415,204934,true,1259721215,28,1261738281,2017066
1673086619,204933,true,1259847187,28,1261738281,1891094
1673087387,204931,true,1260099169,28,1261864455,1765286
1673087783,204930,true,1260225179,28,1261990641,1765462
1673087891,204930,true,1260225179,28,1261990641,1765462
1673088683,204930,true,1260225179,28,1261990641,1765462
1673088815,204927,true,1260603284,28,1261990641,1387357
1673088839,204926,true,1260729344,28,1261990641,1261297
1673092355,204927,true,1260603284,28,1261864455,1261171
1673098043,204926,true,1260729344,28,1261864455,1135111
1673098499,204924,true,1260981503,28,1261864455,882952
1673099723,204923,true,1261107601,28,1261864455,756854
1673101403,204921,true,1261359835,28,1261864455,504620
1673104355,204920,true,1261485971,28,1261864455,378484
1673104691,204918,true,1261738281,28,1261864455,126174
1673104907,204917,true,1261864455,28,1261864455,0
1673106659,204915,true,1262116840,28,1261990641,-126199
1673107031,204914,true,1262243052,28,1261990641,-252411
1673109095,204912,true,1262495513,28,1261864455,-631058
1673109203,204911,true,1262621763,28,1261864455,-757308
1673109563,204910,true,1262748025,28,1261864455,-883570
1673109911,204908,true,1263000587,28,1261864455,-1136132
1673112431,204906,true,1263253200,28,1261864455,-1388745
1673115431,204906,true,1263253200,28,1261864455,-1388745
1673115743,204904,true,1263505863,28,1261864455,-1641408
1673120939,204903,true,1263632214,28,1261864455,-1767759
1673121455,204901,true,1263884953,28,1261864455,-2020498
1673121995,204901,true,1263884953,28,1261990641,-1894312
1673126399,204899,true,1264137742,28,1262243052,-1894690
1673130551,204899,true,1264137742,28,1262243052,-1894690
1673133551,204897,true,1264390583,28,1262243052,-2147531
1673133719,204897,true,1264390583,28,1262243052,-2147531
1673134511,204895,true,1264643473,28,1262243052,-2400421
1673134811,204895,true,1264643473,28,1262243052,-2400421
1673134991,204893,true,1264896415,28,1262243052,-2653363
1673138471,204893,true,1264896415,28,1262243052,-2653363
1673139323,204891,true,1265149407,28,1262243052,-2906355
1673147327,204891,true,1265149407,28,1261990641,-3158766
1673147699,204890,true,1265275922,28,1261990641,-3285281
1673150891,204890,true,1265275922,28,1261990641,-3285281
1673154071,204890,true,1265275922,28,1261990641,-3285281
1673157683,204890,true,1265275922,28,1261990641,-3285281
1673159555,204889,true,1265402449,28,1261990641,-3411808
1673161847,204889,true,1265402449,28,1261990641,-3411808
1673162951,204889,true,1265402449,28,1261990641,-3411808
1673163863,204889,true,1265402449,28,1261990641,-3411808
1673164931,204889,true,1265402449,28,1261990641,-3411808
1673167931,204889,true,1265402449,28,1261990641,-3411808
1673169671,204889,true,1265402449,28,1262116840,-3285609
1673171387,204890,true,1265275922,28,1262116840,-3159082
1673172227,204889,true,1265402449,28,1262116840,-3285609
1673173391,204889,true,1265402449,28,1262116840,-3285609
1673174015,204890,true,1265275922,28,1262116840,-3159082
1673174123,204890,true,1265275922,28,1262116840,-3159082
1673175443,204890,true,1265275922,28,1262116840,-3159082
1673176151,204890,true,1265275922,28,1262116840,-3159082
1673179547,204891,true,1265149407,28,1262116840,-3032567
1673180723,204891,true,1265149407,28,1262243052,-2906355
1673181419,204892,true,1265022904,28,1262243052,-2779852
1673182019,204893,true,1264896415,28,1262243052,-2653363
1673182439,204894,true,1264769938,28,1262243052,-2526886
1673183303,204894,true,1264769938,28,1262243052,-2526886
1673188811,204895,true,1264643473,28,1262243052,-2400421
1673189783,204896,true,1264517022,28,1262243052,-2273970
1673190011,204896,true,1264517022,28,1262369276,-2147746
1673190023,204897,true,1264390583,28,1262369276,-2021307
1673191115,204897,true,1264390583,28,1263000587,-1389996
1673192651,204898,true,1264264156,28,1263379525,-884631
1673192675,204898,true,1264264156,28,1263505863,-758293
1673192771,204898,true,1264264156,28,1263505863,-758293
1673192927,204899,true,1264137742,28,1263632214,-505528
1673192939,204899,true,1264137742,28,1263632214,-505528
1673192963,204899,true,1264137742,28,1263758577,-379165
1673193083,204899,true,1264137742,28,1264137742,0
1673193215,204899,true,1264137742,28,1264517022,379280
1673193263,204899,true,1264137742,28,1264643473,505731
1673193551,204899,true,1264137742,28,1265908686,1770944
1673193563,204898,true,1264264156,28,1265908686,1644530
1673193647,204898,true,1264264156,28,1266288497,2024341
1673193659,204898,true,1264264156,28,1266288497,2024341
1673193731,204898,true,1264264156,28,1266668421,2404265
1673193743,204897,true,1264390583,28,1266668421,2277838
1673194307,204897,true,1264390583,28,1269711924,5321341
1673194583,204897,true,1264390583,28,1271109306,6718723
1673194667,204897,true,1264390583,28,1271363540,6972957
1673195207,204896,true,1264517022,28,1272253762,7736740
1673195231,204896,true,1264517022,28,1272253762,7736740
1673195255,204896,true,1264517022,28,1272253762,7736740
1673195315,204896,true,1264517022,28,1272126549,7609527
1673195327,204896,true,1264517022,28,1272126549,7609527
1673195387,204895,true,1264643473,28,1272126549,7483076
1673195771,204896,true,1264517022,28,1271236417,6719395
1673195795,204896,true,1264517022,28,1271109306,6592284
1673195819,204896,true,1264517022,28,1271109306,6592284
1673195831,204896,true,1264517022,28,1270982207,6465185
1673199263,204897,true,1264390583,28,1264896415,505832
1673202239,204897,true,1264390583,28,1264896415,505832
1673206691,204897,true,1264390583,28,1264896415,505832
1673206919,204896,true,1264517022,28,1264896415,379393
1673208815,204897,true,1264390583,28,1264896415,505832
1673208839,204897,true,1264390583,28,1265022904,632321
1673208887,204897,true,1264390583,28,1265022904,632321
1673208911,204897,true,1264390583,28,1265022904,632321
1673209295,204898,true,1264264156,28,1265149407,885251
1673209487,204898,true,1264264156,28,1265275922,1011766
1673210387,204897,true,1264390583,28,1266288497,1897914
1673210423,204897,true,1264390583,28,1266288497,1897914
1673210723,204897,true,1264390583,28,1266668421,2277838
1673211023,204897,true,1264390583,28,1267048460,2657877
1673211155,204897,true,1264390583,28,1267175165,2784582
1673213903,204896,true,1264517022,28,1268569754,4052732
1673214011,204896,true,1264517022,28,1268696611,4179589
1673214347,204895,true,1264643473,28,1268696611,4053138
1673214419,204895,true,1264643473,28,1268823481,4180008
1673214491,204893,true,1264896415,28,1268823481,3927066
1673215751,204894,true,1264769938,28,1268950363,4180425
1673216651,204893,true,1264896415,28,1268823481,3927066
1673219183,204893,true,1264896415,28,1268823481,3927066
1673219255,204892,true,1265022904,28,1268950363,3927459
1673219303,204892,true,1265022904,28,1268950363,3927459
1673219327,204891,true,1265149407,28,1269077258,3927851
1673219351,204890,true,1265275922,28,1269077258,3801336
1673219543,204886,true,1265782108,28,1270855122,5073014
1673221343,204886,true,1265782108,28,1284910991,19128883
1673222231,204885,true,1265908686,28,1284910991,19002305
1673223287,204883,true,1266161881,28,1287740765,21578884
1673223635,204879,true,1266668421,28,1288642454,21974033
1673223947,204878,true,1266795088,28,1289415833,22620745
1673225231,204877,true,1266921768,28,1289415833,22494065
1673225279,204876,true,1267048460,28,1289415833,22367373
1673225891,204871,true,1267682111,28,1289544775,21862664
1673225939,204870,true,1267808879,28,1289544775,21735896
1673225975,204869,true,1267935660,28,1289544775,21609115
1673226071,204868,true,1268062453,28,1289673729,21611276
1673226515,204863,true,1268696611,28,1290189676,21493065
1673226671,204862,true,1268823481,28,1290447727,21624246
1673228363,204861,true,1268950363,28,1291609595,22659232
1673229359,204859,true,1269204166,28,1293807088,24602922
1673229743,204854,true,1269838895,28,1294583567,24744672
1673229887,204853,true,1269965879,28,1294971981,25006102
1673230403,204852,true,1270092876,28,1295490047,25397171
1673230487,204850,true,1270346907,28,1295490047,25143140
1673230595,204845,true,1270982207,28,1295490047,24507840
1673231063,204844,true,1271109306,28,1295749158,24639852
1673231375,204842,true,1271363540,28,1296137922,24774382
1673231435,204840,true,1271617826,28,1296267536,24649710
1673231459,204835,true,1272253762,28,1296267536,24013774
1673231543,204834,true,1272380987,28,1296656455,24275468
1673231939,204831,true,1272762740,28,1298602801,25840061
1673231963,204828,true,1273144607,28,1298732662,25588055
1673232011,204824,true,1273653941,28,1298992421,25338480
1673232047,204822,true,1273908684,28,1299122320,25213636
1673232083,204819,true,1274290895,28,1299382158,25091263
1673232347,204816,true,1274673221,28,1300942274,26269053
1673232887,204811,true,1275310685,28,1304198536,28887851
1673232923,204809,true,1275565760,28,1304459389,28893629
1673233391,204806,true,1275948468,28,1306548090,30599622
1673233667,204804,true,1276203670,28,1307332215,31128545
1673233763,204798,true,1276969584,28,1307593694,30624110
1673233775,204797,true,1277097281,28,1307593694,30496413
1673233799,204793,true,1277608196,28,1307724454,30116258
1673233943,204791,true,1277863731,28,1307986011,30122280
1673233955,204785,true,1278630641,28,1307986011,29355370
1673234039,204784,true,1278758504,28,1308116810,29358306
1673234075,204780,true,1279270084,28,1308247622,28977538
1673234171,204778,true,1279525951,28,1308378447,28852496
1673234399,204772,true,1280293858,28,1308378447,28084589
1673235119,204771,true,1280421888,28,1308640135,28218247
1673235155,204767,true,1280934133,28,1308770999,27836866
1673235431,204765,true,1281190333,28,1308640135,27449802
1673235767,204759,true,1281959239,28,1309425516,27466277
1673235851,204757,true,1282215644,28,1309687414,27471770
1673235863,204753,true,1282728607,28,1309687414,26958807
1673235875,204750,true,1283113464,28,1309818383,26704919
1673235983,204745,true,1283755149,28,1310211367,26456218
1673236031,204742,true,1284140314,28,1310342389,26202075
1673236091,204739,true,1284525595,28,1310604470,26078875
1673236187,204736,true,1284910991,28,1310997691,26086700
1673236199,204730,true,1285682130,28,1310997691,25315561
1673237027,204728,true,1285939280,28,1313490830,27551550
1673237099,204725,true,1286325100,28,1313622179,27297079
1673237255,204722,true,1286711036,28,1314016305,27305269
1673237459,204716,true,1287483256,28,1314147706,26664450
1673237471,204715,true,1287612004,28,1314147706,26535702
1673237531,204711,true,1288127126,28,1314147706,26020580
1673237543,204709,true,1288384765,28,1314147706,25762941
1673237603,204704,true,1289029086,28,1314147706,25118620
1673237615,204702,true,1289286905,28,1314147706,24860801
1673237999,204699,true,1289673729,28,1313622179,23948450
1673238095,204697,true,1289931677,28,1313490830,23559153
1673238359,204693,true,1290447727,28,1313228171,22780444
1673240579,204691,true,1290705829,28,1311784486,21078657
1673241083,204688,true,1291093080,28,1311915665,20822585
1673241827,204686,true,1291351311,28,1311915665,20564354
1673242895,204682,true,1291867929,28,1312046856,20178927
1673242979,204680,true,1292126316,28,1312046856,19920540
1673243135,204677,true,1292513993,28,1312046856,19532863
1673243843,204675,true,1292772508,28,1312046856,19274348
1673244059,204671,true,1293289695,28,1312046856,18757161
1673244071,204669,true,1293548366,28,1312046856,18498490
1673244779,204666,true,1293936469,28,1312046856,18110387
1673244887,204664,true,1294195269,28,1312046856,17851587
1673244899,204659,true,1294842496,28,1311915665,17073169
1673244923,204657,true,1295101478,28,1311915665,16814187
1673245439,204654,true,1295490047,28,1311653321,16163274
1673245691,204652,true,1295749158,28,1311522169,15773011
1673246723,204647,true,1296397162,28,1310866604,14469442
1673247827,204644,true,1296786120,28,1310866604,14080484
1673248955,204642,true,1297045491,28,1310866604,13821113
1673251067,204639,true,1297434643,28,1310866604,13431961
1673253131,204634,true,1298083490,28,1310866604,12783114
1673254043,204632,true,1298343120,28,1310866604,12523484
1673254991,204629,true,1298732662,28,1310866604,12133942
1673255135,204626,true,1299122320,28,1310866604,11744284
1673256167,204622,true,1299642047,28,1310866604,11224557
1673256359,204619,true,1300031979,28,1310866604,10834625
1673256395,204616,true,1300422028,28,1310997691,10575663
1673256695,204614,true,1300682125,28,1311128791,10446666
1673256803,204609,true,1301332596,28,1311128791,9796195
1673256815,204607,true,1301592876,28,1311128791,9535915
1673256971,204604,true,1301983393,28,1311391029,9407636
1673257019,204601,true,1302374027,28,1311391029,9017002
1673257055,204597,true,1302895054,28,1311522169,8627115
1673257067,204594,true,1303285962,28,1311522169,8236207
1673257079,204591,true,1303676987,28,1311522169,7845182
1673257463,204588,true,1304068129,28,1312965565,8897436
1673258807,204583,true,1304720294,28,1317305290,12584996
1673258879,204581,true,1304981251,28,1317437021,12455770
1673259995,204578,true,1305372784,28,1317437021,12064237
1673260019,204575,true,1305764435,28,1317568765,11804330
1673260139,204570,true,1306417448,28,1317568765,11151317
1673260151,204567,true,1306809412,28,1317568765,10759353
1673260247,204564,true,1307201494,28,1317832292,10630798
1673260535,204561,true,1307593694,28,1318359504,10765810
1673260547,204559,true,1307855226,28,1318491340,10636114
1673260559,204557,true,1308116810,28,1318491340,10374530
1673263847,204554,true,1308509284,28,1323113913,14604629
1673263967,204551,true,1308901876,28,1323113913,14212037
1673264963,204549,true,1309163670,28,1323113913,13950243
1673265203,204548,true,1309294586,28,1323113913,13819327
1673265275,204545,true,1309687414,28,1323113913,13426499
1673265311,204542,true,1310080359,28,1323113913,13033554
1673265383,204540,true,1310342389,28,1323113913,12771524
1673265551,204539,true,1310473423,28,1322981615,12508192
1673267279,204536,true,1310866604,28,1321923706,11057102
1673267687,204533,true,1311259903,28,1321791526,10531623
1673267699,204532,true,1311391029,28,1321791526,10400497
1673270135,204531,true,1311522169,28,1319942405,8420236
1673270267,204528,true,1311915665,28,1319942405,8026740
1673270687,204526,true,1312178061,28,1319942405,7764344
1673270723,204524,true,1312440510,28,1319942405,7501895
1673271539,204524,true,1312440510,28,1319942405,7501895
1673271683,204521,true,1312834281,28,1320074400,7240119
1673271707,204519,true,1313096861,28,1320074400,6977539
1673271719,204518,true,1313228171,28,1320074400,6846229
1673272295,204517,true,1313359494,28,1320602509,7243015
1673274695,204515,true,1313622179,28,1320338428,6716249
1673274719,204512,true,1314016305,28,1320470462,6454157
1673274731,204511,true,1314147706,28,1320470462,6322756
1673274767,204511,true,1314147706,28,1320470462,6322756
1673275619,204509,true,1314410549,28,1321659361,7248812
1673275847,204507,true,1314673444,28,1321923706,7250262
1673276039,204506,true,1314804912,28,1322188104,7383192
1673276555,204506,true,1314804912,28,1322849330,8044418
1673276567,204504,true,1315067886,28,1322981615,7913729
1673276579,204502,true,1315330912,28,1322981615,7650703
1673276615,204502,true,1315330912,28,1322981615,7650703
1673276819,204501,true,1315462446,28,1323246224,7783778
1673276831,204500,true,1315593992,28,1323246224,7652232
1673277215,204497,true,1315988709,28,1324437622,8448913
1673277719,204496,true,1316120308,28,1326027822,9907514
1673277803,204495,true,1316251920,28,1326293041,10041121
1673278055,204494,true,1316383546,28,1326956320,10572774
1673278091,204492,true,1316646835,28,1327089016,10442181
1673278775,204491,true,1316778500,28,1327885468,11106968
1673279099,204491,true,1316778500,28,1327487182,10708682
1673279123,204489,true,1317041869,28,1327487182,10445313
1673279243,204487,true,1317305290,28,1327619931,10314641
1673279339,204486,true,1317437021,28,1327619931,10182910
1673279423,204485,true,1317568765,28,1327885468,10316703
1673279435,204483,true,1317832292,28,1327885468,10053176
1673279447,204481,true,1318095871,28,1327885468,9789597
1673279459,204480,true,1318227681,28,1327885468,9657787
1673279579,204478,true,1318491340,28,1328283874,9792534
1673279603,204477,true,1318623189,28,1328416702,9793513
1673279723,204475,true,1318886927,28,1329081043,10194116
1673279927,204474,true,1319018815,28,1330144680,11125865
1673280347,204473,true,1319150717,28,1332540977,13390260
1673280491,204471,true,1319414560,28,1333207381,13792821
1673280563,204469,true,1319678457,28,1333607383,13928926
1673280947,204468,true,1319810424,28,1335876330,16065906
1673281019,204466,true,1320074400,28,1336143519,16069119
1673281139,204465,true,1320206407,28,1336678056,16471649
1673282219,204462,true,1320602509,28,1338550622,17948113
1673282819,204461,true,1320734569,28,1339220032,18485463
1673283455,204460,true,1320866642,28,1339487889,18621247
1673283923,204458,true,1321130829,28,1339487889,18357060
1673284919,204455,true,1321527208,28,1339487889,17960681
1673284979,204454,true,1321659361,28,1339621838,17962477
1673285975,204452,true,1321923706,28,1340023764,18100058
1673288615,204451,true,1322055898,28,1340291783,18235885
1673289599,204448,true,1322452554,28,1340425812,17973258
1673289623,204447,true,1322584800,28,1340425812,17841012
1673289647,204445,true,1322849330,28,1340425812,17576482
1673289659,204443,true,1323113913,28,1340425812,17311899
1673289887,204441,true,1323378549,28,1340291783,16913234
1673289983,204439,true,1323643238,28,1340157767,16514529
1673290007,204437,true,1323907980,28,1340157767,16249787
1673290463,204436,true,1324040371,28,1339755800,15715429
1673290523,204433,true,1324437622,28,1339621838,15184216
1673290931,204432,true,1324570066,28,1338818346,14248280
1673291147,204430,true,1324834993,28,1338550622,13715629
1673291159,204429,true,1324967477,28,1338416781,13449304
1673291183,204427,true,1325232484,28,1338416781,13184297
1673294411,204426,true,1325365007,28,1334274320,8909313
1673294663,204424,true,1325630093,28,1334140906,8510813
1673294675,204423,true,1325762656,28,1334140906,8378250
1673294711,204420,true,1326160425,28,1334140906,7980481
1673294759,204420,true,1326160425,28,1334007505,7847080
1673294783,204419,true,1326293041,28,1334007505,7714464
1673294795,204417,true,1326558313,28,1334007505,7449192
1673294939,204415,true,1326823638,28,1333607383,6783745
1673294999,204415,true,1326823638,28,1333474035,6650397
1673295071,204414,true,1326956320,28,1333340701,6384381
1673295239,204412,true,1327221725,28,1332807498,5585773
1673295263,204410,true,1327487182,28,1332674231,5187049
1673295383,204410,true,1327487182,28,1332274509,4787327
1673295395,204409,true,1327619931,28,1332141295,4521364
1673295419,204408,true,1327752693,28,1332008094,4255401
1673295455,204406,true,1328018257,28,1331874906,3856649
1673296355,204406,true,1328018257,28,1328018257,0
1673296367,204405,true,1328151058,28,1328018257,-132801
1673296379,204404,true,1328283874,28,1327885468,-398406
1673296727,204402,true,1328549544,28,1326690969,-1858575
1673296739,204403,true,1328416702,28,1326558313,-1858389
1673296823,204402,true,1328549544,28,1326293041,-2256503
1673296859,204401,true,1328682399,28,1326293041,-2389358
1673296907,204400,true,1328815267,28,1326160425,-2654842
1673296919,204401,true,1328682399,28,1326027822,-2654577
1673297399,204400,true,1328815267,28,1324967477,-3847790
1673297435,204399,true,1328948148,28,1324967477,-3980671
1673297495,204399,true,1328948148,28,1324834993,-4113155
1673297567,204400,true,1328815267,28,1324570066,-4245201
1673297603,204399,true,1328948148,28,1324437622,-4510526
1673299187,204399,true,1328948148,28,1320602509,-8345639
1673299583,204399,true,1328948148,28,1320470462,-8477686
1673300027,204400,true,1328815267,28,1320734569,-8080698
1673301179,204399,true,1328948148,28,1321130829,-7817319
1673301311,204400,true,1328815267,28,1321130829,-7684438
1673301995,204399,true,1328948148,28,1320998729,-7949419
1673305835,204401,true,1328682399,28,1319810424,-8871975
1673309231,204400,true,1328815267,28,1319414560,-9400707
1673309867,204401,true,1328682399,28,1319414560,-9267839
1673310287,204400,true,1328815267,28,1319414560,-9400707
1673311007,204402,true,1328549544,28,1319678457,-8871087
1673311043,204401,true,1328682399,28,1319678457,-9003942
1673311067,204401,true,1328682399,28,1319678457,-9003942
1673311427,204401,true,1328682399,28,1320338428,-8343971
1673312039,204402,true,1328549544,28,1321527208,-7022336
1673312339,204400,true,1328815267,28,1321923706,-6891561
1673312435,204401,true,1328682399,28,1322055898,-6626501
1673312555,204400,true,1328815267,28,1322320322,-6494945
1673312687,204401,true,1328682399,28,1322584800,-6097599
1673312723,204400,true,1328815267,28,1322584800,-6230467
1673312819,204400,true,1328815267,28,1322849330,-5965937
1673314235,204399,true,1328948148,28,1324834993,-4113155
1673316707,204399,true,1328948148,28,1325099974,-3848174
1673318015,204399,true,1328948148,28,1325099974,-3848174
1673318111,204398,true,1329081043,28,1325099974,-3981069
1673318183,204397,true,1329213951,28,1325099974,-4113977
1673318207,204398,true,1329081043,28,1325099974,-3981069
1673318375,204398,true,1329081043,28,1324834993,-4246050
1673318423,204398,true,1329081043,28,1324834993,-4246050
1673318483,204397,true,1329213951,28,1324702523,-4511428
1673320451,204399,true,1328948148,28,1320734569,-8213579
1673320919,204398,true,1329081043,28,1320734569,-8346474
1673321519,204399,true,1328948148,28,1320734569,-8213579
1673322899,204398,true,1329081043,28,1320734569,-8346474
1673323115,204399,true,1328948148,28,1320734569,-8213579
1673323307,204399,true,1328948148,28,1320866642,-8081506
1673323763,204400,true,1328815267,28,1320998729,-7816538
1673325995,204400,true,1328815267,28,1321659361,-7155906
1673326247,204401,true,1328682399,28,1321791526,-6890873
1673326295,204401,true,1328682399,28,1321923706,-6758693
1673326355,204402,true,1328549544,28,1321923706,-6625838
1673326775,204401,true,1328682399,28,1322452554,-6229845
1673327003,204402,true,1328549544,28,1322717058,-5832486
1673327735,204402,true,1328549544,28,1323907980,-4641564
1673327807,204402,true,1328549544,28,1324040371,-4509173
1673327999,204402,true,1328549544,28,1324305192,-4244352
1673331755,204403,true,1328416702,28,1324570066,-3846636
1673336543,204404,true,1328283874,28,1324570066,-3713808
1673336627,204404,true,1328283874,28,1324570066,-3713808
1673336699,204403,true,1328416702,28,1324570066,-3846636
1673336831,204405,true,1328151058,28,1324570066,-3580992
1673337851,204406,true,1328018257,28,1325365007,-2653250
1673338295,204406,true,1328018257,28,1325762656,-2255601
1673339063,204406,true,1328018257,28,1325895232,-2123025
1673339243,204408,true,1327752693,28,1325895232,-1857461
1673340239,204409,true,1327619931,28,1325895232,-1724699
1673341967,204409,true,1327619931,28,1325895232,-1724699
1673342363,204409,true,1327619931,28,1325895232,-1724699
1673344055,204411,true,1327354447,28,1326425670,-928777
1673344091,204412,true,1327221725,28,1326425670,-796055
1673344979,204412,true,1327221725,28,1327089016,-132709
1673346455,204412,true,1327221725,28,1327487182,265457
1673346563,204414,true,1326956320,28,1327619931,663611
1673346575,204415,true,1326823638,28,1327619931,796293
1673346647,204415,true,1326823638,28,1327752693,929055
1673348663,204415,true,1326823638,28,1330011679,3188041
1673353547,204416,true,1326690969,28,1330011679,3320710
1673353595,204418,true,1326425670,28,1330011679,3586009
1673353967,204418,true,1326425670,28,1329878691,3453021
1673356307,204418,true,1326425670,28,1328682399,2256729
1673356691,204420,true,1326160425,28,1328682399,2521974
1673356979,204421,true,1326027822,28,1328682399,2654577
1673357867,204421,true,1326027822,28,1328682399,2654577
1673357951,204420,true,1326160425,28,1328682399,2521974
1673357975,204422,true,1325895232,28,1328682399,2787167
1673357987,204423,true,1325762656,28,1328682399,2919743
1673358131,204424,true,1325630093,28,1328549544,2919451
1673359163,204424,true,1325630093,28,1326823638,1193545
1673359223,204426,true,1325365007,28,1326690969,1325962
1673359259,204427,true,1325232484,28,1326690969,1458485
1673359283,204427,true,1325232484,28,1326690969,1458485
1673359547,204426,true,1325365007,28,1326558313,1193306
1673359631,204427,true,1325232484,28,1326425670,1193186
1673359643,204428,true,1325099974,28,1326425670,1325696
1673359679,204429,true,1324967477,28,1326425670,1458193
1673359691,204428,true,1325099974,28,1326425670,1325696
1673359715,204429,true,1324967477,28,1326558313,1590836
1673360075,204428,true,1325099974,28,1327619931,2519957
1673360087,204429,true,1324967477,28,1327619931,2652454
1673360459,204428,true,1325099974,28,1328948148,3848174
1673360963,204428,true,1325099974,28,1330676818,5576844
1673361491,204428,true,1325099974,28,1332008094,6908120
1673362103,204428,true,1325099974,28,1332274509,7174535
1673362223,204427,true,1325232484,28,1332274509,7042025
1673362307,204427,true,1325232484,28,1332141295,6908811
1673362331,204427,true,1325232484,28,1332141295,6908811
1673362355,204427,true,1325232484,28,1332141295,6908811
1673362367,204426,true,1325365007,28,1332141295,6776288
1673362715,204426,true,1325365007,28,1331475424,6110417
1673363303,204426,true,1325365007,28,1330410722,5045715
1673363315,204426,true,1325365007,28,1330410722,5045715
1673363327,204425,true,1325497543,28,1330410722,4913179
1673363387,204425,true,1325497543,28,1330277695,4780152
1673363423,204425,true,1325497543,28,1330277695,4780152
1673363459,204425,true,1325497543,28,1330144680,4647137
1673363495,204423,true,1325762656,28,1330144680,4382024
1673363543,204423,true,1325762656,28,1330144680,4382024
1673363555,204423,true,1325762656,28,1330144680,4382024
1673363567,204423,true,1325762656,28,1330144680,4382024
1673363591,204421,true,1326027822,28,1330144680,4116858
1673363819,204420,true,1326160425,28,1330543764,4383339
1673363855,204419,true,1326293041,28,1330676818,4383777
1673363951,204419,true,1326293041,28,1330809886,4516845
1673364707,204416,true,1326690969,28,1333740744,7049775
1673364731,204416,true,1326690969,28,1333874118,7183149
1673364899,204415,true,1326823638,28,1334407747,7584109
1673364911,204415,true,1326823638,28,1334407747,7584109
1673365523,204413,true,1327089016,28,1335075085,7986069
1673365631,204412,true,1327221725,28,1334941590,7719865
1673366183,204411,true,1327354447,28,1333874118,6519671
1673368979,204411,true,1327354447,28,1332940779,5586332
1673369315,204409,true,1327619931,28,1332940779,5320848
1673369435,204409,true,1327619931,28,1332940779,5320848
1673374103,204408,true,1327752693,28,1330809886,3057193
1673374955,204408,true,1327752693,28,1330809886,3057193
1673375003,204407,true,1327885468,28,1330942967,3057499
1673375063,204406,true,1328018257,28,1330942967,2924710
1673375123,204406,true,1328018257,28,1330942967,2924710
1673375507,204405,true,1328151058,28,1331475424,3324366
1673375519,204404,true,1328283874,28,1331475424,3191550
1673375567,204404,true,1328283874,28,1331608571,3324697
1673375651,204403,true,1328416702,28,1331874906,3458204
1673375771,204402,true,1328549544,28,1332141295,3591751
1673376683,204401,true,1328682399,28,1334541188,5858789
1673376743,204401,true,1328682399,28,1334808110,6125711
1673376767,204400,true,1328815267,28,1334808110,5992843
1673376887,204399,true,1328948148,28,1335075085,6126937
1673376947,204398,true,1329081043,28,1335208592,6127549
1673376971,204398,true,1329081043,28,1335342113,6261070
1673377007,204396,true,1329346873,28,1335342113,5995240
1673377175,204395,true,1329479807,28,1335876330,6396523
1673377211,204394,true,1329612755,28,1335876330,6263575
1673377979,204393,true,1329745717,28,1337747773,8002056
1673382155,204391,true,1330011679,28,1340023764,10012085
1673382167,204390,true,1330144680,28,1340023764,9879084
1673382191,204389,true,1330277695,28,1340157767,9880072
1673382347,204387,true,1330543764,28,1340157767,9614003
1673389067,204386,true,1330676818,28,1340827980,10151162
1673389115,204385,true,1330809886,28,1340827980,10018094
1673390567,204384,true,1330942967,28,1340827980,9885013
1673391527,204382,true,1331209168,28,1340693910,9484742
1673391611,204381,true,1331342289,28,1340693910,9351621
1673393759,204380,true,1331475424,28,1339086123,7610699
1673393903,204379,true,1331608571,28,1339086123,7477552
1673393939,204378,true,1331741732,28,1339086123,7344391
1673396435,204377,true,1331874906,28,1338015336,6140430
1673399243,204376,true,1332008094,28,1338015336,6007242
1673400503,204376,true,1332008094,28,1338015336,6007242
1673400695,204375,true,1332141295,28,1338015336,5874041
1673401583,204373,true,1332407736,28,1338015336,5607600
1673403839,204373,true,1332407736,28,1338015336,5607600
1673403863,204372,true,1332540977,28,1338015336,5474359
1673403899,204371,true,1332674231,28,1338015336,5341105
1673403923,204370,true,1332807498,28,1338015336,5207838
1673405963,204370,true,1332807498,28,1335876330,3068832
1673406887,204369,true,1332940779,28,1335342113,2401334
1673406923,204368,true,1333074073,28,1335342113,2268040
1673407283,204368,true,1333074073,28,1335075085,2001012
1673407295,204368,true,1333074073,28,1335075085,2001012
1673407331,204367,true,1333207381,28,1334941590,1734209
1673407343,204366,true,1333340701,28,1334941590,1600889
1673407439,204366,true,1333340701,28,1334674642,1333941
1673407835,204366,true,1333340701,28,1333740744,400043
1673408051,204366,true,1333340701,28,1333340701,0
1673409587,204365,true,1333474035,28,1331342289,-2131746
1673414615,204365,true,1333474035,28,1331342289,-2131746
1673416079,204365,true,1333474035,28,1331475424,-1998611
1673419691,204366,true,1333340701,28,1331475424,-1865277
1673421227,204365,true,1333474035,28,1331475424,-1998611
1673422055,204365,true,1333474035,28,1331475424,-1998611
1673422235,204365,true,1333474035,28,1331475424,-1998611
1673423051,204365,true,1333474035,28,1331608571,-1865464
1673424275,204364,true,1333607383,28,1331741732,-1865651
1673425499,204364,true,1333607383,28,1331874906,-1732477
1673426351,204364,true,1333607383,28,1331874906,-1732477
1673426963,204364,true,1333607383,28,1331874906,-1732477
1673427875,204363,true,1333740744,28,1331874906,-1865838
1673428427,204363,true,1333740744,28,1331874906,-1865838
1673428943,204363,true,1333740744,28,1332008094,-1732650
1673428955,204363,true,1333740744,28,1332008094,-1732650
1673429075,204362,true,1333874118,28,1332008094,-1866024
1673430179,204361,true,1334007505,28,1332674231,-1333274
1673432579,204361,true,1334007505,28,1333340701,-666804
1673432939,204361,true,1334007505,28,1333340701,-666804
1673433311,204360,true,1334140906,28,1333340701,-800205
1673433407,204360,true,1334140906,28,1333340701,-800205
1673433551,204359,true,1334274320,28,1333474035,-800285
1673439983,204359,true,1334274320,28,1334274320,0
1673441507,204359,true,1334274320,28,1334274320,0
1673441903,204359,true,1334274320,28,1334274320,0
1673443079,204359,true,1334274320,28,1334274320,0
1673444987,204359,true,1334274320,28,1334274320,0
1673445287,204358,true,1334407747,28,1334274320,-133427
1673446427,204358,true,1334407747,28,1334140906,-266841
1673446847,204358,true,1334407747,28,1334007505,-400242
1673449907,204358,true,1334407747,28,1332807498,-1600249
1673450099,204358,true,1334407747,28,1332807498,-1600249
1673451335,204358,true,1334407747,28,1332807498,-1600249
1673451371,204358,true,1334407747,28,1332674231,-1733516
1673451383,204358,true,1334407747,28,1332674231,-1733516
1673451515,204357,true,1334541188,28,1332141295,-2399893
1673451983,204359,true,1334274320,28,1330277695,-3996625
1673453519,204359,true,1334274320,28,1325497543,-8776777
1673458991,204359,true,1334274320,28,1325365007,-8909313
1673459027,204358,true,1334407747,28,1325497543,-8910204
1673459279,204360,true,1334140906,28,1325497543,-8643363
1673459627,204360,true,1334140906,28,1325630093,-8510813
1673460215,204360,true,1334140906,28,1325762656,-8378250
1673460275,204359,true,1334274320,28,1325762656,-8511664
1673460347,204361,true,1334007505,28,1325895232,-8112273
1673460371,204362,true,1333874118,28,1325895232,-7978886
1673460383,204362,true,1333874118,28,1325895232,-7978886
1673460431,204361,true,1334007505,28,1326027822,-7979683
1673460503,204363,true,1333740744,28,1326293041,-7447703
1673460515,204363,true,1333740744,28,1326293041,-7447703
1673460575,204363,true,1333740744,28,1326425670,-7315074
1673460587,204362,true,1333874118,28,1326558313,-7315805
1673460635,204364,true,1333607383,28,1326823638,-6783745
1673460683,204364,true,1333607383,28,1327089016,-6518367
1673460695,204362,true,1333874118,28,1327221725,-6652393
1673460707,204362,true,1333874118,28,1327221725,-6652393
1673460719,204363,true,1333740744,28,1327354447,-6386297
1673460779,204362,true,1333874118,28,1327885468,-5988650
1673462339,204360,true,1334140906,28,1340291783,6150877
1673462627,204360,true,1334140906,28,1340827980,6687074
1673463179,204360,true,1334140906,28,1340693910,6553004
1673463251,204359,true,1334274320,28,1340559854,6285534
1673463359,204358,true,1334407747,28,1340559854,6152107
1673464871,204357,true,1334541188,28,1339220032,4678844
1673465663,204358,true,1334407747,28,1339086123,4678376
1673465675,204357,true,1334541188,28,1339220032,4678844
1673465987,204356,true,1334674642,28,1339353954,4679312
1673466143,204356,true,1334674642,28,1339353954,4679312
1673466299,204356,true,1334674642,28,1339487889,4813247
1673467271,204356,true,1334674642,28,1340023764,5349122
1673467379,204355,true,1334808110,28,1340157767,5349657
1673467775,204354,true,1334941590,28,1340425812,5484222
1673468459,204355,true,1334808110,28,1340693910,5885800
1673471327,204355,true,1334808110,28,1340962063,6153953
1673471495,204354,true,1334941590,28,1340962063,6020473
1673471867,204353,true,1335075085,28,1340962063,5886978
1673471915,204354,true,1334941590,28,1340962063,6020473
1673474579,204354,true,1334941590,28,1340962063,6020473
1673474591,204353,true,1335075085,28,1341096159,6021074
1673474603,204353,true,1335075085,28,1341096159,6021074
1673474615,204354,true,1334941590,28,1341096159,6154569
1673474663,204351,true,1335342113,28,1341498528,6156415
1673474771,204350,true,1335475647,28,1342169411,6693764
1673474783,204349,true,1335609195,28,1342169411,6560216
1673474807,204351,true,1335342113,28,1342303628,6961515
1673474819,204348,true,1335742756,28,1342303628,6560872
1673474855,204348,true,1335742756,28,1342437859,6695103
1673474903,204348,true,1335742756,28,1342572102,6829346
1673475083,204349,true,1335609195,28,1342974914,7365719
1673476463,204347,true,1335876330,28,1345797984,9921654
1673476643,204346,true,1336009918,28,1345259799,9249881
1673476667,204346,true,1336009918,28,1345259799,9249881
1673476763,204347,true,1335876330,28,1345394325,9517995
1673476907,204345,true,1336143519,28,1345528864,9385345
1673476967,204344,true,1336277133,28,1345528864,9251731
1673476991,204344,true,1336277133,28,1345528864,9251731
1673477003,204345,true,1336143519,28,1345663417,9519898
1673478071,204341,true,1336678056,28,1350111219,13433163
1673479535,204340,true,1336811724,28,1352814008,16002284
1673479547,204340,true,1336811724,28,1352949290,16137566
1673479583,204341,true,1336678056,28,1352949290,16271234
1673479655,204336,true,1337346529,28,1352949290,15602761
1673479667,204335,true,1337480264,28,1352949290,15469026
1673479679,204335,true,1337480264,28,1353084585,15604321
1673479703,204334,true,1337614012,28,1353355215,15741203
1673479751,204327,true,1338550622,28,1354032028,15481406
1673479763,204325,true,1338818346,28,1354167431,15349085
1673480003,204325,true,1338818346,28,1356607005,17788659
1673480015,204324,true,1338952228,28,1356742666,17790438
1673480027,204316,true,1340023764,28,1357014028,16990264
1673480063,204313,true,1340425812,28,1357692671,17266859
1673480387,204309,true,1340962063,28,1364361357,23399294
1673480411,204308,true,1341096159,28,1364907183,23811024
1673480423,204300,true,1342169411,28,1365180178,23010767
1673480435,204298,true,1342437859,28,1365316696,22878837
1673480447,204294,true,1342974914,28,1365589773,22614859
1673481023,204293,true,1343109212,28,1376833082,33723870
1673481275,204285,true,1344184075,28,1381798365,37614290
1673482235,204283,true,1344452926,28,1388168960,43716034
1673482655,204279,true,1344990787,28,1388168960,43178173
1673482907,204279,true,1344990787,28,1388168960,43178173
1673482967,204271,true,1346067157,28,1388168960,42101803
1673483231,204268,true,1346471017,28,1388168960,41697943
1673483819,204265,true,1346874999,28,1388168960,41293961
1673484239,204264,true,1347009686,28,1388168960,41159274
1673484431,204256,true,1348087671,28,1388307777,40220106
1673484455,204253,true,1348492138,28,1388307777,39815639
1673484503,204250,true,1348896726,28,1388307777,39411051
1673484551,204249,true,1349031616,28,1388307777,39276161
1673484695,204241,true,1350111219,28,1388446607,38335388
1673484755,204238,true,1350516293,28,1388585452,38069159
1673484791,204235,true,1350921488,28,1388585452,37663964
1673484803,204234,true,1351056580,28,1388724311,37667731
1673484863,204226,true,1352137804,28,1388724311,36586507
1673484875,204223,true,1352543486,28,1388863183,36319697
1673484947,204219,true,1353084585,28,1389279884,36195299
1673485019,204216,true,1353490550,28,1390252671,36762121
1673485427,204206,true,1354844650,28,1395545417,40700767
1673485739,204203,true,1355251144,28,1399598169,44347025
1673485775,204198,true,1355928905,28,1400018091,44089186
1673485787,204196,true,1356200105,28,1400158093,43957988
1673485847,204186,true,1357556915,28,1400998398,43441483
1673485859,204183,true,1357964223,28,1401138497,43174274
1673485871,204178,true,1358643341,28,1401278611,42635270
1673485883,204176,true,1358915083,28,1401418739,42503656
1673485907,204166,true,1360274610,28,1401558881,41284271
1673485967,204164,true,1360546679,28,1402259801,41713122
1673486039,204159,true,1361227088,28,1403101367,41874279
1673486051,204155,true,1361771661,28,1403241677,41470016
1673486159,204145,true,1363134045,28,1404224241,41090196
1673486171,204142,true,1363543026,28,1404364663,40821637
1673487143,204138,true,1364088525,28,1407316780,43228255
1673487227,204134,true,1364634243,28,1406894670,42260427
1673487287,204124,true,1365999491,28,1406753994,40754503
1673487311,204122,true,1366272705,28,1406613333,40340628
1673487323,204117,true,1366955978,28,1406613333,39657355
1673487395,204114,true,1367366105,28,1406191433,38825328
1673487803,204104,true,1368734087,28,1404224241,35490154
1673488391,204102,true,1369007847,28,1402961071,33953224
1673488511,204098,true,1369555533,28,1402680521,33124988
1673488967,204095,true,1369966441,28,1401839207,31872766
1673489015,204085,true,1371337024,28,1401699037,30362013
1673489099,204084,true,1371474157,28,1401699037,30224880
1673489279,204080,true,1372022829,28,1401558881,29536052
1673489399,204077,true,1372434477,28,1401558881,29124404
1673490119,204068,true,1373670162,28,1401558881,27888719
1673490383,204066,true,1373944910,28,1401558881,27613971
1673491295,204063,true,1374357135,28,1401558881,27201746
1673491307,204061,true,1374632020,28,1401558881,26926861
1673491367,204052,true,1375869684,28,1401699037,25829353
1673491703,204051,true,1376007271,28,1401699037,25691766
1673491835,204047,true,1376557756,28,1401839207,25281451
1673491847,204045,true,1376833082,28,1401839207,25006125
1673491967,204036,true,1378072727,28,1401979391,23906664
1673492219,204034,true,1378348356,28,1401979391,23631035
1673492267,204030,true,1378899778,28,1401979391,23079613
1673492471,204028,true,1379175571,28,1401979391,22803820
1673492783,204019,true,1380417326,28,1401979391,21562065
1673493335,204018,true,1380555368,28,1402259801,21704433
1673494451,204014,true,1381107673,28,1402540267,21432594
1673494631,204012,true,1381383908,28,1402540267,21156359
1673495495,204003,true,1382627651,28,1402540267,19912616
1673495903,204002,true,1382765914,28,1402540267,19774353
1673500667,203998,true,1383319103,28,1402540267,19221164
1673502395,203996,true,1383595781,28,1402540267,18944486
1673502419,203987,true,1384841515,28,1402540267,17698752
1673502431,203986,true,1384979999,28,1402540267,17560268
1673502467,203982,true,1385534074,28,1402540267,17006193
1673502551,203980,true,1385811195,28,1402540267,16729072
1673502563,203971,true,1387058924,28,1402540267,15481343
1673502575,203970,true,1387197630,28,1402540267,15342637
1673502647,203966,true,1387752592,28,1402400027,14647435
1673502815,203965,true,1387891368,28,1401979391,14088023
1673503091,203959,true,1388724311,28,1401418739,12694428
1673503115,203958,true,1388863183,28,1401418739,12555556
1673503151,203954,true,1389418812,28,1401278611,11859799
1673503211,203953,true,1389557754,28,1401138497,11580743
1673503283,203947,true,1390391697,28,1400858312,10466615
1673504411,203945,true,1390669789,28,1398059535,7389746
1673504855,203941,true,1391226140,28,1397779965,6553825
1673508359,203939,true,1391504399,28,1397640201,6135802
1673508407,203933,true,1392339511,28,1397779965,5440454
1673508479,203931,true,1392617993,28,1397779965,5161972
1673508551,203927,true,1393175123,28,1397779965,4604842
1673510747,203925,true,1393453772,28,1398758704,5304932
1673511419,203919,true,1394290054,28,1398758704,4468650
1673511599,203918,true,1394429483,28,1398758704,4329221
1673511851,203914,true,1394987338,28,1398758704,3771366
1673512571,203912,true,1395266350,28,1398758704,3492354
1673512763,203907,true,1395964122,28,1398758704,2794582
1673512787,203906,true,1396103719,28,1398758704,2654985
1673513159,203902,true,1396662244,28,1398758704,2096460
1673513267,203900,true,1396941590,28,1398758704,1817114
1673513435,203895,true,1397640201,28,1398758704,1118503
1673513555,203894,true,1397779965,28,1398758704,978739
1673519495,203891,true,1398199341,28,1398758704,559363
1673522507,203890,true,1398339161,28,1398758704,419543
1673523035,203889,true,1398478995,28,1398758704,279709
1673524991,203888,true,1398618843,28,1398618843,0
1673526635,203884,true,1399178374,28,1398618843,-559531
1673526671,203883,true,1399318292,28,1398618843,-699449
1673526911,203882,true,1399458224,28,1398618843,-839381
1673526923,203882,true,1399458224,28,1398618843,-839381
1673526971,203882,true,1399458224,28,1398618843,-839381
1673526983,203881,true,1399598169,28,1398618843,-979326
1673527127,203880,true,1399738129,28,1398478995,-1259134
1673527319,203880,true,1399738129,28,1398199341,-1538788
1673527895,203880,true,1399738129,28,1397640201,-2097928
1673528255,203879,true,1399878103,28,1397360715,-2517388
1673528603,203878,true,1400018091,28,1396941590,-3076501
1673528819,203878,true,1400018091,28,1396801910,-3216181
1673530091,203877,true,1400158093,28,1396801910,-3356183
1673530115,203877,true,1400158093,28,1396941590,-3216503
1673530127,203876,true,1400298109,28,1396941590,-3356519
1673530199,203876,true,1400298109,28,1396941590,-3356519
1673530211,203875,true,1400438138,28,1396941590,-3496548
1673530223,203875,true,1400438138,28,1396801910,-3636228
1673530247,203875,true,1400438138,28,1396522592,-3915546
1673530283,203877,true,1400158093,28,1396243329,-3914764
1673530295,203877,true,1400158093,28,1396103719,-4054374
1673530307,203877,true,1400158093,28,1395964122,-4193971
1673530331,203877,true,1400158093,28,1395824540,-4333553
1673530475,203879,true,1399878103,28,1394708383,-5169720
1673530487,203879,true,1399878103,28,1394568926,-5309177
1673530499,203879,true,1399878103,28,1394568926,-5309177
1673530511,203879,true,1399878103,28,1394429483,-5448620
1673530535,203880,true,1399738129,28,1394429483,-5308646
1673530547,203881,true,1399598169,28,1394429483,-5168686
1673530571,203881,true,1399598169,28,1394429483,-5168686
1673530583,203883,true,1399318292,28,1394429483,-4888809
1673530607,203883,true,1399318292,28,1394429483,-4888809
1673530655,203884,true,1399178374,28,1394568926,-4609448
1673530679,203884,true,1399178374,28,1394568926,-4609448
1673530703,203885,true,1399038470,28,1394708383,-4330087
1673530763,203886,true,1398898580,28,1394708383,-4190197
1673530787,203887,true,1398758704,28,1394708383,-4050321
1673530823,203887,true,1398758704,28,1394708383,-4050321
1673530847,203888,true,1398618843,28,1394568926,-4049917
1673531075,203890,true,1398339161,28,1394011237,-4327924
1673531123,203891,true,1398199341,28,1393871850,-4327491
1673531135,203891,true,1398199341,28,1393732477,-4466864
1673531219,203893,true,1397919743,28,1393453772,-4465971
1673531267,203894,true,1397779965,28,1393314441,-4465524
1673531279,203895,true,1397640201,28,1393175123,-4465078
1673531291,203895,true,1397640201,28,1393175123,-4465078
1673531303,203896,true,1397500451,28,1393175123,-4325328
1673531591,203897,true,1397360715,28,1392896530,-4464185
1673531615,203897,true,1397360715,28,1392896530,-4464185
1673531675,203897,true,1397360715,28,1392896530,-4464185
1673531687,203898,true,1397220993,28,1393035820,-4185173
1673531735,203898,true,1397220993,28,1393175123,-4045870
1673531759,203897,true,1397360715,28,1393175123,-4185592
1673532227,203897,true,1397360715,28,1396801910,-558805
1673532239,203897,true,1397360715,28,1396941590,-419125
1673532287,203897,true,1397360715,28,1397500451,139736
1673532335,203896,true,1397500451,28,1397919743,419292
1673532695,203896,true,1397500451,28,1399318292,1817841
1673532815,203896,true,1397500451,28,1400158093,2657642
1673532863,203896,true,1397500451,28,1400438138,2937687
1673532875,203896,true,1397500451,28,1400438138,2937687
1673532983,203895,true,1397640201,28,1401278611,3638410
1673532995,203896,true,1397500451,28,1401278611,3778160
1673533031,203896,true,1397500451,28,1401558881,4058430
1673533055,203896,true,1397500451,28,1401699037,4198586
1673533067,203896,true,1397500451,28,1401699037,4198586
1673533223,203897,true,1397360715,28,1401979391,4618676
1673533235,203897,true,1397360715,28,1401979391,4618676
1673533739,203898,true,1397220993,28,1400438138,3217145
1673533943,203898,true,1397220993,28,1399318292,2097299
1673533955,203899,true,1397081285,28,1399178374,2097089
1673533967,203899,true,1397081285,28,1399178374,2097089
1673533979,203900,true,1396941590,28,1399038470,2096880
1673534087,203901,true,1396801910,28,1398199341,1397431
1673534147,203903,true,1396522592,28,1397640201,1117609
1673534195,203903,true,1396522592,28,1397220993,698401
1673534207,203904,true,1396382953,28,1397081285,698332
1673534483,203905,true,1396243329,28,1394290054,-1953275
1673534495,203907,true,1395964122,28,1394290054,-1674068
1673534507,203907,true,1395964122,28,1394150639,-1813483
1673534531,203908,true,1395824540,28,1393871850,-1952690
1673534543,203909,true,1395684971,28,1393732477,-1952494
1673534555,203911,true,1395405876,28,1393593118,-1812758
1673534567,203912,true,1395266350,28,1393453772,-1812578
1673534603,203913,true,1395126837,28,1392896530,-2230307
1673534807,203915,true,1394847853,28,1389974663,-4873190
1673534903,203917,true,1394568926,28,1388863183,-5705743
1673535563,203917,true,1394568926,28,1382627651,-11941275
1673535671,203918,true,1394429483,28,1381660199,-12769284
1673535683,203920,true,1394150639,28,1381522046,-12628593
1673535707,203922,true,1393871850,28,1381383908,-12487942
1673535731,203922,true,1393871850,28,1381245783,-12626067
1673535899,203923,true,1393732477,28,1380279298,-13453179
1673536043,203925,true,1393453772,28,1379589365,-13864407
1673536163,203926,true,1393314441,28,1379175571,-14138870
1673536271,203927,true,1393175123,28,1378761901,-14413222
1673536295,203927,true,1393175123,28,1378624039,-14551084
1673536343,203929,true,1392896530,28,1378624039,-14272491
1673536367,203931,true,1392617993,28,1378624039,-13993954
1673536379,203931,true,1392617993,28,1378624039,-13993954
1673536487,203931,true,1392617993,28,1378899778,-13718215
1673536547,203933,true,1392339511,28,1379175571,-13163940
1673536607,203935,true,1392061085,28,1379451420,-12609665
1673538059,203935,true,1392061085,28,1384287717,-7773368
1673539055,203935,true,1392061085,28,1384564588,-7496497
1673539895,203937,true,1391782714,28,1384841515,-6941199
1673540375,203938,true,1391643550,28,1384979999,-6663551
1673541515,203938,true,1391643550,28,1385118497,-6525053
1673542307,203939,true,1391504399,28,1385118497,-6385902
1673543171,203940,true,1391365263,28,1385118497,-6246766
1673543291,203942,true,1391087032,28,1385257009,-5830023
1673543303,203942,true,1391087032,28,1385257009,-5830023
1673543879,203942,true,1391087032,28,1385257009,-5830023
1673543891,203944,true,1390808856,28,1385257009,-5551847
1673543903,203945,true,1390669789,28,1385257009,-5412780
1673543915,203945,true,1390669789,28,1385257009,-5412780
1673543927,203945,true,1390669789,28,1385257009,-5412780
1673544479,203946,true,1390530736,28,1386642890,-3887846
1673544503,203947,true,1390391697,28,1386642890,-3748807
1673544527,203947,true,1390391697,28,1386781554,-3610143
1673544551,203947,true,1390391697,28,1386920232,-3471465
1673544563,203948,true,1390252671,28,1386920232,-3332439
1673544575,203948,true,1390252671,28,1386920232,-3332439
1673544599,203948,true,1390252671,28,1387058924,-3193747
1673544635,203947,true,1390391697,28,1387336350,-3055347
1673544695,203948,true,1390252671,28,1387752592,-2500079
1673544863,203948,true,1390252671,28,1388863183,-1389488
1673544911,203948,true,1390252671,28,1389140970,-1111701
1673544959,203947,true,1390391697,28,1389557754,-833943
1673544983,203947,true,1390391697,28,1389696709,-694988
1673544995,203947,true,1390391697,28,1389835679,-556018
1673545019,203943,true,1390947937,28,1389974663,-973274
1673545055,203942,true,1391087032,28,1390391697,-695335
1673545067,203941,true,1391226140,28,1390669789,-556351
1673545079,203940,true,1391365263,28,1390808856,-556407
1673545127,203935,true,1392061085,28,1391782714,-278371
1673545199,203932,true,1392478745,28,1393314441,835696
1673545271,203930,true,1392757254,28,1394987338,2230084
1673545331,203929,true,1392896530,28,1396382953,3486423
1673545427,203925,true,1393453772,28,1398618843,5165071
1673545439,203923,true,1393732477,28,1398898580,5166103
1673545463,203922,true,1393871850,28,1399318292,5446442
1673545583,203922,true,1393871850,28,1401839207,7967357
1673545775,203919,true,1394290054,28,1405629097,11339043
1673546219,203917,true,1394568926,28,1413946405,19377479
1673546243,203916,true,1394708383,28,1414370631,19662248
1673546255,203916,true,1394708383,28,1414512068,19803685
1673546327,203913,true,1395126837,28,1415927217,20800380
1673546351,203910,true,1395545417,28,1416352038,20806621
1673546363,203909,true,1395684971,28,1416635322,20950351
1673546387,203909,true,1395684971,28,1417060356,21375385
1673546447,203905,true,1396243329,28,1418052595,21809266
1673546459,203901,true,1396801910,28,1418336220,21534310
1673546783,203900,true,1396941590,28,1423735881,26794291
1673546795,203900,true,1396941590,28,1424020642,27079052
1673546843,203895,true,1397640201,28,1424590336,26950135
1673546855,203892,true,1398059535,28,1424732795,26673260
1673547011,203891,true,1398199341,28,1425017756,26818415
1673547035,203891,true,1398199341,28,1425017756,26818415
1673547311,203887,true,1398758704,28,1424732795,25974091
1673547371,203884,true,1399178374,28,1424875268,25696894
1673547551,203884,true,1399178374,28,1425017756,25839382
1673547707,203884,true,1399178374,28,1425160257,25981883
1673547971,203881,true,1399598169,28,1425872980,26274811
1673547995,203878,true,1400018091,28,1425872980,25854889
1673548019,203878,true,1400018091,28,1425872980,25854889
1673548031,203878,true,1400018091,28,1425872980,25854889
1673548055,203875,true,1400438138,28,1426015567,25577429
1673548067,203872,true,1400858312,28,1426015567,25157255
1673548103,203873,true,1400718240,28,1425872980,25154740
1673548115,203873,true,1400718240,28,1425872980,25154740
1673548139,203870,true,1401138497,28,1425872980,24734483
1673548175,203868,true,1401418739,28,1425872980,24454241
1673548211,203868,true,1401418739,28,1425730407,24311668
1673548223,203868,true,1401418739,28,1425587848,24169109
1673548235,203865,true,1401839207,28,1425587848,23748641
1673548247,203863,true,1402119589,28,1425587848,23468259
1673548283,203863,true,1402119589,28,1425445304,23325715
1673548307,203863,true,1402119589,28,1425302773,23183184
1673548787,203861,true,1402400027,28,1422597404,20197377
1673548907,203857,true,1402961071,28,1422028508,19067437
1673549027,203858,true,1402820789,28,1421601984,18781195
1673549123,203857,true,1402961071,28,1421175589,18214518
1673549255,203855,true,1403241677,28,1420607261,17365584
1673549327,203851,true,1403803058,28,1420465214,16662156
1673549675,203850,true,1403943438,28,1419187435,15243997
1673549687,203849,true,1404083833,28,1419187435,15103602
1673549819,203847,true,1404364663,28,1418761764,14397101
1673551247,203843,true,1404926494,28,1421033486,16106992
1673552231,203842,true,1405066986,28,1421175589,16108603
1673552303,203841,true,1405207493,28,1421175589,15968096
1673552315,203838,true,1405629097,28,1421317707,15688610
1673552327,203834,true,1406191433,28,1421317707,15126274
1673552339,203832,true,1406472686,28,1421317707,14845021
1673552639,203830,true,1406753994,28,1421886319,15132325
1673552867,203827,true,1407176063,28,1422455159,15279096
1673552879,203823,true,1407739017,28,1422455159,14716142
1673552915,203820,true,1408161381,28,1422597404,14436023
1673552987,203818,true,1408443028,28,1423024226,14581198
1673552999,203814,true,1409006490,28,1423166529,14160039
1673553023,203810,true,1409570177,28,1423166529,13596352
1673553143,203807,true,1409993090,28,1423593521,13600431
1673553155,203805,true,1410275103,28,1423735881,13460778
1673553347,203802,true,1410698228,28,1424305460,13607232
1673553407,203798,true,1411262591,28,1424447891,13185300
1673553899,203795,true,1411686013,28,1425872980,14186967
1673554763,203793,true,1411968364,28,1427014078,15045714
1673555087,203790,true,1412391997,28,1426728718,14336721
1673555279,203786,true,1412957038,28,1426871391,13914353
1673555327,203783,true,1413380968,28,1426871391,13490423
1673555351,203781,true,1413663658,28,1426871391,13207733
1673555399,203778,true,1414087800,28,1426871391,12783591
1673555411,203774,true,1414653520,28,1427014078,12360558
1673555459,203772,true,1414936465,28,1427014078,12077613
1673556383,203769,true,1415360988,28,1429013197,13652209
1673556407,203766,true,1415785639,28,1429013197,13227558
1673556587,203762,true,1416352038,28,1429299013,12946975
1673557211,203760,true,1416635322,28,1430299823,13664501
1673557235,203758,true,1416918664,28,1430299823,13381159
1673557259,203755,true,1417343782,28,1430299823,12956041
1673557739,203751,true,1417910804,28,1431015116,13104312
1673557907,203748,true,1418336220,28,1431158217,12821997
1673557919,203746,true,1418619902,28,1431301333,12681431
1673557931,203743,true,1419045530,28,1431301333,12255803
1673557955,203739,true,1419613233,28,1431301333,11688100
1673558183,203737,true,1419897170,28,1431015116,11117946
1673558195,203735,true,1420181164,28,1431015116,10833952
1673558267,203732,true,1420607261,28,1430872029,10264768
1673558399,203728,true,1421175589,28,1430728956,9553367
1673558603,203727,true,1421317707,28,1430585897,9268190
1673558735,203725,true,1421601984,28,1430442853,8840869
1673558975,203722,true,1422028508,28,1430156807,8128299
1673559839,203718,true,1422597404,28,1427727727,5130323
1673560187,203718,true,1422597404,28,1427584969,4987565
1673560439,203716,true,1422881938,28,1427584969,4703031
1673560619,203713,true,1423308845,28,1427584969,4276124
1673561483,203710,true,1423735881,28,1427584969,3849088
1673561495,203710,true,1423735881,28,1427584969,3849088
1673561507,203708,true,1424020642,28,1427584969,3564327
1673561519,203706,true,1424305460,28,1427584969,3279509
1673561579,203703,true,1424732795,28,1427442225,2709430
1673562167,203703,true,1424732795,28,1426443415,1710620
1673562287,203702,true,1424875268,28,1426158169,1282901
1673562299,203699,true,1425302773,28,1426158169,855396
1673562647,203698,true,1425445304,28,1425160257,-285047
1673562731,203699,true,1425302773,28,1424875268,-427505
1673562803,203698,true,1425445304,28,1424732795,-712509
1673563547,203698,true,1425445304,28,1422170710,-3274594
1673566019,203698,true,1425445304,28,1422170710,-3274594
1673566139,203699,true,1425302773,28,1422170710,-3132063
1673566187,203699,true,1425302773,28,1422170710,-3132063
1673566247,203699,true,1425302773,28,1422170710,-3132063
1673566367,203699,true,1425302773,28,1422028508,-3274265
1673566379,203701,true,1425017756,28,1422028508,-2989248
1673567771,203700,true,1425160257,28,1420323182,-4837075
1673568119,203700,true,1425160257,28,1420039160,-5121097
1673568335,203700,true,1425160257,28,1419897170,-5263087
1673568431,203701,true,1425017756,28,1419897170,-5120586
1673568467,203701,true,1425017756,28,1419897170,-5120586
1673568503,203701,true,1425017756,28,1419897170,-5120586
1673568563,203701,true,1425017756,28,1419755195,-5262561
1673568683,203703,true,1424732795,28,1419613233,-5119562
1673568803,203703,true,1424732795,28,1419471286,-5261509
1673568839,203703,true,1424732795,28,1419471286,-5261509
1673568863,203704,true,1424590336,28,1419471286,-5119050
1673569007,203706,true,1424305460,28,1419187435,-5118025
1673569139,203705,true,1424447891,28,1419045530,-5402361
1673569319,203705,true,1424447891,28,1418619902,-5827989
1673569931,203706,true,1424305460,28,1417627265,-6678195
1673569991,203708,true,1424020642,28,1417485516,-6535126
1673570099,203708,true,1424020642,28,1417202062,-6818580
1673570111,203708,true,1424020642,28,1417202062,-6818580
1673570183,203709,true,1423878254,28,1416918664,-6959590
1673570387,203711,true,1423593521,28,1416210417,-7383104
1673570399,203711,true,1423593521,28,1416210417,-7383104
1673570435,203711,true,1423593521,28,1416068810,-7524711
1673570459,203712,true,1423451176,28,1415927217,-7523959
1673570651,203715,true,1423024226,28,1415077958,-7946268
1673570699,203715,true,1423024226,28,1414936465,-8087761
1673571779,203715,true,1423024226,28,1409429234,-13594992
1673572403,203717,true,1422739664,28,1407879791,-14859873
1673572571,203719,true,1422455159,28,1407739017,-14716142
1673573507,203719,true,1422455159,28,1407598258,-14856901
1673573615,203719,true,1422455159,28,1407598258,-14856901
1673573627,203721,true,1422170710,28,1407598258,-14572452
1673573771,203723,true,1421886319,28,1407457512,-14428807
1673575667,203723,true,1421886319,28,1405348014,-16538305
1673576411,203723,true,1421886319,28,1405348014,-16538305
1673579387,203724,true,1421744145,28,1405348014,-16396131
1673579399,203726,true,1421459838,28,1405488548,-15971290
1673579423,203726,true,1421459838,28,1405488548,-15971290
1673579747,203726,true,1421459838,28,1405629097,-15830741
1673580287,203727,true,1421317707,28,1406050828,-15266879
1673580323,203729,true,1421033486,28,1406050828,-14982658
1673580779,203729,true,1421033486,28,1406472686,-14560800
1673580803,203729,true,1421033486,28,1406472686,-14560800
1673580815,203730,true,1420891397,28,1406613333,-14278064
1673580827,203732,true,1420607261,28,1406613333,-13993928
1673580947,203731,true,1420749322,28,1406894670,-13854652
1673580959,203731,true,1420749322,28,1407035359,-13713963
1673581823,203732,true,1420607261,28,1409147390,-11459871
1673582411,203735,true,1420181164,28,1410416130,-9765034
1673582519,203734,true,1420323182,28,1410698228,-9624954
1673582531,203734,true,1420323182,28,1410698228,-9624954
1673583815,203735,true,1420181164,28,1411262591,-8918573
1673585951,203737,true,1419897170,28,1411403718,-8493452
1673586191,203737,true,1419897170,28,1411403718,-8493452
1673589083,203738,true,1419755195,28,1411403718,-8351477
1673589287,203738,true,1419755195,28,1411403718,-8351477
1673589419,203741,true,1419329353,28,1411403718,-7925635
1673589767,203741,true,1419329353,28,1411262591,-8066762
1673589899,203742,true,1419187435,28,1411262591,-7924844
1673590115,203743,true,1419045530,28,1411121479,-7924051
1673590367,203745,true,1418761764,28,1410698228,-8063536
1673592647,203746,true,1418619902,28,1408583872,-10036030
1673592659,203747,true,1418478054,28,1408583872,-9894182
1673592695,203748,true,1418336220,28,1408583872,-9752348
1673592767,203750,true,1418052595,28,1408583872,-9468723
1673595095,203751,true,1417910804,28,1408583872,-9326932
1673596787,203751,true,1417910804,28,1408583872,-9326932
1673597819,203752,true,1417769027,28,1408583872,-9185155
1673598119,203755,true,1417343782,28,1408583872,-8759910
1673598167,203755,true,1417343782,28,1408583872,-8759910
1673598803,203756,true,1417202062,28,1408583872,-8618190
1673599919,203757,true,1417060356,28,1408583872,-8476484
1673601083,203760,true,1416635322,28,1408583872,-8051450
1673601143,203761,true,1416493673,28,1408583872,-7909801
1673601731,203762,true,1416352038,28,1408583872,-7768166
1673602607,203763,true,1416210417,28,1408583872,-7626545
1673602667,203765,true,1415927217,28,1408583872,-7343345
1673605103,203766,true,1415785639,28,1408583872,-7201767
1673605163,203767,true,1415644074,28,1408724730,-6919344
1673605223,203768,true,1415502524,28,1408724730,-6777794
1673606015,203771,true,1415077958,28,1409570177,-5507781
1673606027,203772,true,1414936465,28,1409570177,-5366288
1673606495,203773,true,1414794985,28,1409711134,-5083851
1673606567,203774,true,1414653520,28,1409711134,-4942386
1673606579,203776,true,1414370631,28,1409711134,-4659497
1673606603,203777,true,1414229208,28,1409711134,-4518074
1673606663,203778,true,1414087800,28,1409852105,-4235695
1673606747,203778,true,1414087800,28,1409993090,-4094710
1673606951,203780,true,1413805025,28,1410416130,-3388895
1673606963,203781,true,1413663658,28,1410416130,-3247528
1673609543,203781,true,1413663658,28,1414229208,565550
1673609975,203782,true,1413522306,28,1413946405,424099
1673610515,203784,true,1413239644,28,1413380968,141324
1673612603,203784,true,1413239644,28,1411968364,-1271280
1673612891,203785,true,1413098334,28,1411968364,-1129970
1673613791,203786,true,1412957038,28,1411403718,-1553320
1673613803,203788,true,1412674489,28,1411403718,-1270771
1673614247,203789,true,1412533236,28,1410839297,-1693939
1673614271,203789,true,1412533236,28,1410839297,-1693939
1673614403,203790,true,1412391997,28,1410557172,-1834825
1673614535,203792,true,1412109561,28,1410275103,-1834458
1673618063,203793,true,1411968364,28,1406894670,-5073694
1673618423,203793,true,1411968364,28,1406894670,-5073694
1673618855,203794,true,1411827181,28,1406894670,-4932511
1673619047,203796,true,1411544858,28,1406894670,-4650188
1673620631,203797,true,1411403718,28,1406894670,-4509048
1673620751,203797,true,1411403718,28,1406753994,-4649724
1673621003,203798,true,1411262591,28,1406753994,-4508597
1673621303,203799,true,1411121479,28,1406753994,-4367485
1673621315,203801,true,1410839297,28,1406894670,-3944627
1673621423,203801,true,1410839297,28,1406894670,-3944627
1673621435,203801,true,1410839297,28,1406894670,-3944627
1673621459,203803,true,1410557172,28,1406894670,-3662502
1673621483,203804,true,1410416130,28,1406894670,-3521460
1673621495,203804,true,1410416130,28,1406894670,-3521460
1673621507,203804,true,1410416130,28,1406894670,-3521460
1673622131,203805,true,1410275103,28,1408161381,-2113722
1673622743,203806,true,1410134089,28,1409429234,-704855
1673622923,203806,true,1410134089,28,1409993090,-140999
1673623223,203806,true,1410134089,28,1410698228,564139
1673623463,203807,true,1409993090,28,1410980381,987291
1673623475,203808,true,1409852105,28,1410980381,1128276
1673623655,203808,true,1409852105,28,1411403718,1551613
1673623763,203807,true,1409993090,28,1411827181,1834091
1673623787,203807,true,1409993090,28,1411968364,1975274
1673623799,203808,true,1409852105,28,1411968364,2116259
1673623835,203807,true,1409993090,28,1412250772,2257682
1673624363,203807,true,1409993090,28,1414512068,4518978
1673624495,203807,true,1409993090,28,1415219466,5226376
1673624795,203807,true,1409993090,28,1416635322,6642232
1673625179,203806,true,1410134089,28,1418336220,8202131
1673626151,203806,true,1410134089,28,1419613233,9479144
1673626163,203805,true,1410275103,28,1419613233,9338130
1673626247,203806,true,1410134089,28,1419471286,9337197
1673626343,203805,true,1410275103,28,1419329353,9054250
1673626427,203804,true,1410416130,28,1419187435,8771305
1673626511,203803,true,1410557172,28,1419045530,8488358
1673626523,203804,true,1410416130,28,1419045530,8629400
1673626547,203803,true,1410557172,28,1418903640,8346468
1673626559,203802,true,1410698228,28,1418903640,8205412
1673626655,203802,true,1410698228,28,1418478054,7779826
1673627639,203803,true,1410557172,28,1414370631,3813459
1673628611,203802,true,1410698228,28,1411827181,1128953
1673628779,203801,true,1410839297,28,1411827181,987884
1673630171,203801,true,1410839297,28,1411827181,987884
1673630195,203801,true,1410839297,28,1411827181,987884
1673630495,203800,true,1410980381,28,1412109561,1129180
1673630555,203800,true,1410980381,28,1412250772,1270391
1673630567,203799,true,1411121479,28,1412250772,1129293
1673630579,203799,true,1411121479,28,1412391997,1270518
1673630591,203797,true,1411403718,28,1412391997,988279
1673630603,203797,true,1411403718,28,1412391997,988279
1673630687,203795,true,1411686013,28,1412815757,1129744
1673630951,203796,true,1411544858,28,1414087800,2542942
1673631095,203794,true,1411827181,28,1414794985,2967804
1673631743,203793,true,1411968364,28,1417769027,5800663
1673631755,203792,true,1412109561,28,1417769027,5659466
1673631779,203793,true,1411968364,28,1417910804,5942440
1673631791,203791,true,1412250772,28,1418052595,5801823
1673631803,203791,true,1412250772,28,1418052595,5801823
1673631815,203790,true,1412391997,28,1418052595,5660598
1673632943,203791,true,1412250772,28,1418478054,6227282
1673633003,203790,true,1412391997,28,1418336220,5944223
1673633027,203790,true,1412391997,28,1418336220,5944223
1673633615,203788,true,1412674489,28,1418619902,5945413
1673633639,203789,true,1412533236,28,1418619902,6086666
1673633735,203787,true,1412815757,28,1418761764,5946007
1673634131,203787,true,1412815757,28,1419471286,6655529
1673634767,203786,true,1412957038,28,1420607261,7650223
1673635079,203787,true,1412815757,28,1420607261,7791504
1673635235,203785,true,1413098334,28,1420607261,7508927
1673635331,203785,true,1413098334,28,1420607261,7508927
1673635631,203783,true,1413380968,28,1420607261,7226293
1673636483,203784,true,1413239644,28,1420607261,7367617
1673636615,203782,true,1413522306,28,1420607261,7084955
1673638091,203782,true,1413522306,28,1419755195,6232889
1673638847,203781,true,1413663658,28,1419471286,5807628
1673639399,203781,true,1413663658,28,1419471286,5807628
1673641919,203779,true,1413946405,28,1419471286,5524881
1673642327,203779,true,1413946405,28,1419613233,5666828
1673642387,203778,true,1414087800,28,1419613233,5525433
1673642819,203778,true,1414087800,28,1420323182,6235382
1673643359,203776,true,1414370631,28,1421317707,6947076
1673643395,203776,true,1414370631,28,1421317707,6947076
1673643455,203774,true,1414653520,28,1421601984,6948464
1673645027,203774,true,1414653520,28,1424590336,9936816
1673645063,203772,true,1414936465,28,1424732795,9796330
1673645111,203772,true,1414936465,28,1424732795,9796330
1673645123,203770,true,1415219466,28,1424732795,9513329
1673645147,203770,true,1415219466,28,1424875268,9655802
1673645207,203767,true,1415644074,28,1425017756,9373682
1673645219,203766,true,1415785639,28,1425160257,9374618
1673645231,203765,true,1415927217,28,1425160257,9233040
1673645243,203765,true,1415927217,28,1425160257,9233040
1673645759,203762,true,1416352038,28,1427156779,10804741
1673645771,203761,true,1416493673,28,1427156779,10663106
1673645783,203759,true,1416776986,28,1427156779,10379793
1673645819,203759,true,1416776986,28,1427442225,10665239
1673645831,203755,true,1417343782,28,1427442225,10098443
1673645855,203755,true,1417343782,28,1427727727,10383945
1673645867,203753,true,1417627265,28,1427870500,10243235
1673645903,203752,true,1417769027,28,1428156089,10387062
1673645927,203748,true,1418336220,28,1428441734,10105514
1673645939,203747,true,1418478054,28,1428584578,10106524
1673646371,203744,true,1418903640,28,1434310074,15406434
1673646395,203743,true,1419045530,28,1434596950,15551420
1673646407,203739,true,1419613233,28,1434740410,15127177
1673646959,203738,true,1419755195,28,1443229973,23474778
1673646971,203734,true,1420323182,28,1443374296,23051114
1673647031,203732,true,1420607261,28,1444096128,23488867
1673648147,203728,true,1421175589,28,1455403554,34227965
1673648303,203726,true,1421459838,28,1455840219,34380381
1673648735,203722,true,1422028508,28,1456859613,34831105
1673648903,203720,true,1422312927,28,1457005298,34692371
1673648915,203715,true,1423024226,28,1457150999,34126773
1673649035,203713,true,1423308845,28,1457150999,33842154
1673649539,203709,true,1423878254,28,1457879720,34001466
1673650103,203707,true,1424163044,28,1458754667,34591623
1673650127,203702,true,1424875268,28,1458900542,34025274
1673650139,203700,true,1425160257,28,1458900542,33740285
1673650151,203696,true,1425730407,28,1458900542,33170135
1673650175,203694,true,1426015567,28,1458900542,32884975
1673650187,203690,true,1426586059,28,1458900542,32314483
1673650247,203688,true,1426871391,28,1458900542,32029151
1673650259,203684,true,1427442225,28,1458754667,31312442
1673650319,203682,true,1427727727,28,1458754667,31026940
1673650463,203678,true,1428298904,28,1458462960,30164056
1673650883,203676,true,1428584578,28,1457733947,29149369
1673651927,203673,true,1429013197,28,1454385179,25371982
1673651951,203671,true,1429299013,28,1454239755,24940742
1673652011,203667,true,1429870819,28,1454239755,24368936
1673652023,203666,true,1430013806,28,1454094345,24080539
1673652083,203663,true,1430442853,28,1453948950,23506097
1673652095,203661,true,1430728956,28,1453948950,23219994
1673654387,203658,true,1431158217,28,1447710704,16552487
1673654675,203657,true,1431301333,28,1447855475,16554142
1673654687,203655,true,1431587608,28,1447855475,16267867
1673654783,203653,true,1431873940,28,1447855475,15981535
1673654795,203651,true,1432160329,28,1447855475,15695146
1673654807,203650,true,1432303545,28,1447855475,15551930
1673654843,203647,true,1432733279,28,1448000260,15266981
1673654891,203646,true,1432876552,28,1448000260,15123708
1673655119,203643,true,1433306458,28,1448579547,15273089
1673655131,203642,true,1433449789,28,1448579547,15129758
1673655155,203639,true,1433879867,28,1448724405,14844538
1673655167,203637,true,1434166657,28,1448869278,14702621
1673655515,203633,true,1434740410,28,1450899014,16158604
1673655527,203631,true,1435027372,28,1450899014,15871642
1673655839,203628,true,1435457923,28,1453658204,18200281
1673655863,203626,true,1435745029,28,1453948950,18203921
1673655887,203621,true,1436463045,28,1454094345,17631300
1673655899,203619,true,1436750352,28,1454239755,17489403
1673655911,203615,true,1437325139,28,1454385179,17060040
1673655935,203612,true,1437756379,28,1454821538,17065159
1673655947,203607,true,1438475401,28,1454967020,16491619
1673656127,203604,true,1438906987,28,1457588188,18681201
1673656139,203599,true,1439626585,28,1457733947,18107362
1673656223,203596,true,1440058516,28,1459192337,19133821
1673656343,203591,true,1440778689,28,1461090426,20311737
1673656547,203588,true,1441210966,28,1464454633,23243667
1673656571,203584,true,1441787537,28,1464747538,22960001
1673656583,203581,true,1442220116,28,1465040502,22820386
1673656643,203576,true,1442941371,28,1466066338,23124967
1673656667,203572,true,1443518634,28,1466506202,22987568
1673656679,203568,true,1444096128,28,1466799518,22703390
1673656691,203565,true,1444529400,28,1467092893,22563493
1673656703,203558,true,1445540874,28,1467386326,21845452
1673656727,203553,true,1446263789,28,1468120166,21856377
1673656739,203547,true,1447131764,28,1468560646,21428882
1673656751,203542,true,1447855475,28,1469148159,21292684
1673656763,203533,true,1449159066,28,1469735906,20576840
1673656787,203524,true,1450463831,28,1470912106,20448275
1673656811,203518,true,1451334327,28,1472089248,20754921
1673656823,203512,true,1452205345,28,1472678172,20472827
1673656859,203502,true,1453658204,28,1474593803,20935599
1673656871,203493,true,1454967020,28,1475331247,20364227
1673656883,203485,true,1456131401,28,1476069060,19937659
1673656895,203479,true,1457005298,28,1476807242,19801944
1673656907,203469,true,1458462960,28,1477545794,19082834
1673656943,203460,true,1459776101,28,1479467756,19691655
1673656955,203453,true,1460798251,28,1480059632,19261381
1673656967,203447,true,1461674949,28,1480799810,19124861
1673657003,203436,true,1463283596,28,1482874278,19590682
1673657015,203426,true,1464747538,28,1483615863,18868325
1673657027,203418,true,1465919747,28,1484357819,18438072
1673657051,203412,true,1466799518,28,1485694276,18894758
1673657063,203401,true,1468413805,28,1486288643,17874838
1673657075,203392,true,1469735906,28,1487031936,17296030
1673657087,203385,true,1470765030,28,1487626838,16861808
1673657099,203379,true,1471647709,28,1488370800,16723091
1673657111,203368,true,1473267332,28,1488966238,15698906
1673657123,203359,true,1474593803,28,1489561913,14968110
1673657135,203352,true,1475626328,28,1490157828,14531500
1673657147,203346,true,1476511925,28,1490903055,14391130
1673657159,203336,true,1477989102,28,1491499506,13510404
1673657171,203327,true,1479319824,28,1492096195,12776371
1673657183,203321,true,1480207638,28,1492693123,12485485
1673657195,203316,true,1480947890,28,1493290290,12342400
1673657267,203306,true,1482429504,28,1496878311,14448807
1673657279,203297,true,1483764225,28,1497477153,13712928
1673657303,203291,true,1484654706,28,1498525701,13870995
1673657327,203288,true,1485100147,28,1499574984,14474837
1673657351,203279,true,1486437272,28,1500625001,14187729
1673657363,203271,true,1487626838,28,1501075234,13448396
1673657399,203266,true,1488370800,28,1502576985,14206185
1673657411,203262,true,1488966238,28,1503027803,14061565
1673657483,203254,true,1490157828,28,1505886127,15728299
1673657495,203246,true,1491350371,28,1506337938,14987567
1673657603,203240,true,1492245405,28,1510712440,18467035
1673657627,203237,true,1492693123,28,1511770256,19077133
1673657639,203229,true,1493887696,28,1512223832,18336136
1673658011,203221,true,1495083225,28,1526810355,31727130
1673658083,203215,true,1495980499,28,1529408010,33427511
1673658203,203212,true,1496429338,28,1533696139,37266801
1673658215,203206,true,1497327420,28,1534156293,36828873
1673658299,203197,true,1498675554,28,1537381245,38705691
1673658323,203193,true,1499275114,28,1538150090,38874976
1673658335,203190,true,1499724941,28,1538765442,39040501
1673658455,203182,true,1500925141,28,1543234115,42308974
1673658479,203175,true,1501976104,28,1544005886,42029782
1673658491,203170,true,1502727242,28,1544314703,41587461
1673658503,203167,true,1503178106,28,1544623581,41445475
1673658707,203160,true,1504230646,28,1545396048,41165402
1673658719,203153,true,1505283924,28,1545396048,40112124
1673658803,203148,true,1506036716,28,1544932522,38895806
1673659127,203145,true,1506488572,28,1544314703,37826131
1673659139,203138,true,1507543431,28,1544469134,36925703
1673659151,203131,true,1508599028,28,1544469134,35870106
1673659163,203127,true,1509202558,28,1544623581,35421023
1673659175,203123,true,1509806329,28,1544778044,34971715
1673659187,203116,true,1510863511,28,1544932522,34069011
1673659415,203108,true,1512072625,28,1547096833,35024208
1673659427,203104,true,1512677545,28,1547251543,34573998
1673659523,203101,true,1513131393,28,1547870537,34739144
1673659655,203094,true,1514190903,28,1548489778,34298875
1673659667,203086,true,1515402680,28,1548489778,33087098
1673659679,203082,true,1516008932,28,1548489778,32480846
1673659703,203078,true,1516615426,28,1548489778,31874352
1673659787,203072,true,1517525623,28,1548644627,31119004
1673659859,203064,true,1518740069,28,1548644627,29904558
1673659871,203060,true,1519347656,28,1548644627,29296971
1673659883,203057,true,1519803506,28,1548644627,28841121
1673659931,203051,true,1520715616,28,1548799491,28083875
1673660003,203043,true,1521932614,28,1548799491,26866877
1673660123,203038,true,1522693733,28,1548799491,26105758
1673660231,203035,true,1523150587,28,1548644627,25494040
1673660327,203028,true,1524217112,28,1548489778,24272666
1673660495,203020,true,1525436912,28,1548180126,22743214
1673660507,203015,true,1526199783,28,1548180126,21980343
1673661035,203011,true,1526810355,28,1547715765,20905410
1673661107,203004,true,1527879443,28,1547406268,19526825
1673661383,202996,true,1529102174,28,1546787461,17685287
1673661443,202991,true,1529866878,28,1546632797,16765919
1673661587,202988,true,1530325884,28,1546787461,16461577
1673661599,202981,true,1531397434,28,1546787461,15390027
1673661611,202973,true,1532622981,28,1546787461,14164480
1673661719,202968,true,1533389445,28,1547251543,13862098
1673661731,202965,true,1533849508,28,1547251543,13402035
1673661767,202959,true,1534770048,28,1547406268,12636220
1673661815,202951,true,1535998294,28,1547715765,11717471
1673661995,202947,true,1536612785,28,1548489778,11876993
1673662007,202943,true,1537227523,28,1548644627,11417104
1673662283,202938,true,1537996290,28,1549729003,11732713
1673662355,202930,true,1539227118,28,1549883976,10656858
1673662415,202926,true,1539842901,28,1550038965,10196064
1673662487,202923,true,1540304900,28,1550348988,10044088
1673662763,202918,true,1541075207,28,1551434558,10359351
1673662871,202911,true,1542154283,28,1551900035,9745752
1673662955,202907,true,1542771237,28,1552210430,9439193
1673662967,202904,true,1543234115,28,1552210430,8976315
1673663075,202899,true,1544005886,28,1552676140,8670254
1673663783,202893,true,1544932522,28,1555006785,10074263
1673663819,202889,true,1545550587,28,1555006785,9456198
1673663915,202886,true,1546014299,28,1555162286,9147987
1673665259,202881,true,1546787461,28,1556718148,9930687
1673665943,202875,true,1547715765,28,1556873820,9158055
1673665955,202872,true,1548180126,28,1556873820,8693694
1673666459,202869,true,1548644627,28,1555628881,6984254
1673666915,202867,true,1548954371,28,1554384938,5430567
1673667323,202862,true,1549729003,28,1553452633,3723630
1673668871,202860,true,1550038965,28,1552210430,2171465
1673668955,202860,true,1550038965,28,1552210430,2171465
1673668967,202859,true,1550193968,28,1552365651,2171683
1673669171,202859,true,1550193968,28,1552365651,2171683
1673669807,202858,true,1550348988,28,1552831407,2482419
1673669867,202857,true,1550504023,28,1552831407,2327384
1673669879,202858,true,1550348988,28,1552831407,2482419
1673671823,202857,true,1550504023,28,1554695830,4191807
1673672315,202857,true,1550504023,28,1554695830,4191807
1673673059,202858,true,1550348988,28,1554695830,4346842
1673673071,202859,true,1550193968,28,1554695830,4501862
1673673095,202858,true,1550348988,28,1554695830,4346842
1673673143,202858,true,1550348988,28,1554695830,4346842
1673673167,202859,true,1550193968,28,1554540376,4346408
1673673215,202861,true,1549883976,28,1554384938,4500962
1673673263,202862,true,1549729003,28,1554074107,4345104
1673673299,202862,true,1549729003,28,1553918716,4189713
1673674607,202863,true,1549574046,28,1548180126,-1393920
1673675483,202865,true,1549264177,28,1546632797,-2631380
1673675579,202865,true,1549264177,28,1546632797,-2631380
1673675603,202865,true,1549264177,28,1546632797,-2631380
1673675999,202866,true,1549109267,28,1546632797,-2476470
1673676875,202868,true,1548799491,28,1546323517,-2475974
1673676899,202868,true,1548799491,28,1546323517,-2475974
1673677151,202867,true,1548954371,28,1546168900,-2785471
1673677163,202868,true,1548799491,28,1546168900,-2630591
1673677223,202870,true,1548489778,28,1546168900,-2320878
1673677247,202869,true,1548644627,28,1546323517,-2321110
1673677823,202868,true,1548799491,28,1546478149,-2321342
1673678219,202869,true,1548644627,28,1546787461,-1857166
1673678651,202870,true,1548489778,28,1547096833,-1392945
1673678675,202869,true,1548644627,28,1547096833,-1547794
1673678699,202868,true,1548799491,28,1547096833,-1702658
1673678735,202868,true,1548799491,28,1547096833,-1702658
1673678771,202868,true,1548799491,28,1547096833,-1702658
1673678795,202867,true,1548954371,28,1547251543,-1702828
1673678831,202866,true,1549109267,28,1547251543,-1857724
1673678843,202865,true,1549264177,28,1547251543,-2012634
1673678915,202865,true,1549264177,28,1547406268,-1857909
1673678999,202864,true,1549419104,28,1547561009,-1858095
1673679011,202862,true,1549729003,28,1547561009,-2167994
1673679347,202862,true,1549729003,28,1548334944,-1394059
1673679395,202862,true,1549729003,28,1548334944,-1394059
1673679467,202862,true,1549729003,28,1548644627,-1084376
1673679611,202860,true,1550038965,28,1548954371,-1084594
1673679683,202860,true,1550038965,28,1549264177,-774788
1673680259,202859,true,1550193968,28,1551744860,1550892
1673680955,202859,true,1550193968,28,1553763339,3569371
1673681063,202857,true,1550504023,28,1554074107,3570084
1673681087,202857,true,1550504023,28,1554074107,3570084
1673681147,202857,true,1550504023,28,1554229515,3725492
1673681903,202857,true,1550504023,28,1554540376,4036353
1673682023,202856,true,1550659073,28,1554540376,3881303
1673682803,202856,true,1550659073,28,1554384938,3725865
1673682875,202856,true,1550659073,28,1554384938,3725865
1673683283,202856,true,1550659073,28,1554384938,3725865
1673683475,202855,true,1550814139,28,1554384938,3570799
1673684483,202855,true,1550814139,28,1554384938,3570799
1673684507,202855,true,1550814139,28,1554384938,3570799
1673684795,202854,true,1550969220,28,1554695830,3726610
1673684951,202853,true,1551124317,28,1555162286,4037969
1673685347,202853,true,1551124317,28,1556095616,4971299
1673685767,202853,true,1551124317,28,1557029507,5905190
1673686331,202853,true,1551124317,28,1559054861,7930544
1673686715,202852,true,1551279430,28,1559678576,8399146
1673687111,202852,true,1551279430,28,1560770679,9491249
1673687327,202851,true,1551434558,28,1561395081,9960523
1673687375,202851,true,1551434558,28,1561551220,10116662
1673687387,202849,true,1551744860,28,1561551220,9806360
1673687399,202849,true,1551744860,28,1561551220,9806360
1673687411,202848,true,1551900035,28,1561551220,9651185
1673687423,202847,true,1552055225,28,1561551220,9495995
1673687447,202846,true,1552210430,28,1561551220,9340790
1673687459,202845,true,1552365651,28,1561551220,9185569
1673687567,202845,true,1552365651,28,1561395081,9029430
1673687591,202844,true,1552520888,28,1561395081,8874193
1673687663,202843,true,1552676140,28,1561082848,8406708
1673687807,202843,true,1552676140,28,1560458571,7782431
1673687819,202842,true,1552831407,28,1560302541,7471134
1673687831,202842,true,1552831407,28,1560302541,7471134
1673687843,202842,true,1552831407,28,1560146526,7315119
1673687855,202842,true,1552831407,28,1560146526,7315119
1673687867,202842,true,1552831407,28,1559990527,7159120
1673687879,202843,true,1552676140,28,1559834544,7158404
1673687891,202843,true,1552676140,28,1559834544,7158404
1673687999,202844,true,1552520888,28,1558587238,6066350
1673688011,202844,true,1552520888,28,1558431394,5910506
1673688023,202845,true,1552365651,28,1558275567,5909916
1673688083,202846,true,1552210430,28,1557185210,4974780
1673688095,202848,true,1551900035,28,1556873820,4973785
1673688107,202849,true,1551744860,28,1556562492,4817632
1673688167,202851,true,1551434558,28,1555162286,3727728
1673688179,202853,true,1551124317,28,1554851300,3726983
1673688203,202856,true,1550659073,28,1554384938,3725865
1673688227,202857,true,1550504023,28,1553763339,3259316
1673688359,202859,true,1550193968,28,1550814139,620171
1673688371,202861,true,1549883976,28,1550659073,775097
1673688395,202864,true,1549419104,28,1550038965,619861
1673688443,202865,true,1549264177,28,1549109267,-154910
1673688551,202866,true,1549109267,28,1546942139,-2167128
1673688575,202868,true,1548799491,28,1546478149,-2321342
1673688647,202871,true,1548334944,28,1544932522,-3402422
1673688671,202872,true,1548180126,28,1544469134,-3710992
1673688707,202872,true,1548180126,28,1543697131,-4482995
1673688719,202875,true,1547715765,28,1543542777,-4172988
1673688755,202878,true,1547251543,28,1542771237,-4480306
1673688767,202879,true,1547096833,28,1542462729,-4634104
1673689283,202881,true,1546787461,28,1530478917,-16308544
1673689391,202883,true,1546478149,28,1528185034,-18293115
1673689487,202886,true,1546014299,28,1526352403,-19661896
1673689499,202887,true,1545859713,28,1526199783,-19659930
1673689535,202889,true,1545550587,28,1525436912,-20113675
1673689607,202891,true,1545241523,28,1524064705,-21176818
1673690135,202894,true,1544778044,28,1520107482,-24670562
1673690207,202896,true,1544469134,28,1519803506,-24665628
1673690219,202897,true,1544314703,28,1519803506,-24511197
1673690351,202900,true,1543851501,28,1519195736,-24655765
1673690399,202903,true,1543388438,28,1518891943,-24496495
1673690783,202904,true,1543234115,28,1517980926,-25253189
1673691143,202905,true,1543079807,28,1517677376,-25402431
1673691731,202908,true,1542616976,28,1518284538,-24332438
1673691767,202911,true,1542154283,28,1518436366,-23717917
1673691827,202912,true,1542000083,28,1518436366,-23563717
1673691839,202914,true,1541691729,28,1518436366,-23255363
1673691875,202917,true,1541229314,28,1518436366,-22792948
1673691887,202919,true,1540921115,28,1518436366,-22484749
1673691899,202920,true,1540767038,28,1518284538,-22482500
1673691923,202922,true,1540458931,28,1518284538,-22174393
1673692583,202925,true,1539996885,28,1516160533,-23836352
1673692631,202927,true,1539688932,28,1516008932,-23680000
1673692847,202928,true,1539534979,28,1515554220,-23980759
1673693003,202930,true,1539227118,28,1515099645,-24127473
1673693015,202932,true,1538919319,28,1515099645,-23819674
1673693123,202935,true,1538457735,28,1514948150,-23509585
1673693363,202935,true,1538457735,28,1514645206,-23812529
1673693387,202937,true,1538150090,28,1514645206,-23504884
1673693411,202939,true,1537842506,28,1514645206,-23197300
1673694191,202941,true,1537534984,28,1516615426,-20919558
1673694215,202942,true,1537381245,28,1516615426,-20765819
1673694263,202943,true,1537227523,28,1516918765,-20308758
1673694299,202946,true,1536766447,28,1517070457,-19695990
1673694311,202947,true,1536612785,28,1517070457,-19542328
1673694323,202948,true,1536459139,28,1517222164,-19236975
1673694455,202949,true,1536305509,28,1518132724,-18172785
1673694503,202951,true,1535998294,28,1518284538,-17713756
1673694635,202953,true,1535691140,28,1519043832,-16647308
1673694659,202953,true,1535691140,28,1519195736,-16495404
1673694803,202954,true,1535537587,28,1520259492,-15278095
1673694827,202956,true,1535230525,28,1520411518,-14819007
1673694839,202957,true,1535077017,28,1520563559,-14513458
1673694851,202958,true,1534923525,28,1520563559,-14359966
1673694875,202959,true,1534770048,28,1520867687,-13902361
1673696183,202960,true,1534616586,28,1529713907,-4902679
1673696423,202962,true,1534309709,28,1530631965,-3677744
1673697551,202963,true,1534156293,28,1530785028,-3371265
1673697743,202963,true,1534156293,28,1530631965,-3524328
1673698475,202965,true,1533849508,28,1530478917,-3370591
1673698487,202967,true,1533542784,28,1530478917,-3063867
1673698535,202968,true,1533389445,28,1530478917,-2910528
1673698931,202969,true,1533236122,28,1529560951,-3675171
1673698943,202972,true,1532776243,28,1529560951,-3215292
1673698967,202974,true,1532469734,28,1529408010,-3061724
1673699015,202975,true,1532316502,28,1529408010,-2908492
1673699207,202975,true,1532316502,28,1529102174,-3214328
1673699351,202978,true,1531856899,28,1528949279,-2907620
1673699411,202980,true,1531550574,28,1528949279,-2601295
1673699495,202981,true,1531397434,28,1528949279,-2448155
1673699519,202981,true,1531397434,28,1528796400,-2601034
1673699531,202984,true,1530938106,28,1528949279,-1988827
1673699543,202985,true,1530785028,28,1528949279,-1835749
1673699579,202985,true,1530785028,28,1529102174,-1682854
1673699627,202985,true,1530785028,28,1529408010,-1377018
1673700035,202987,true,1530478917,28,1531856899,1377982
1673701103,202989,true,1530172867,28,1539842901,9670034
1673701511,202989,true,1530172867,28,1541383437,11210570
1673701895,202989,true,1530172867,28,1541383437,11210570
1673701907,202991,true,1529866878,28,1541383437,11516559
1673701955,202993,true,1529560951,28,1541383437,11822486
1673702435,202994,true,1529408010,28,1540921115,11513105
1673702459,202994,true,1529408010,28,1540767038,11359028
1673702951,202997,true,1528949279,28,1539688932,10739653
1673703503,202999,true,1528643535,28,1538457735,9814200
1673703539,203000,true,1528490686,28,1538303905,9813219
1673703563,203000,true,1528490686,28,1538150090,9659404
1673703971,203002,true,1528185034,28,1537073815,8888781
1673704139,203005,true,1527726670,28,1536612785,8886115
1673704679,203005,true,1527726670,28,1535691140,7964470
1673705039,203005,true,1527726670,28,1535230525,7503855
1673706803,203007,true,1527421171,28,1534923525,7502354
1673706875,203009,true,1527115732,28,1535077017,7961285
1673707043,203009,true,1527115732,28,1535691140,8575408
1673707079,203009,true,1527115732,28,1535691140,8575408
1673707091,203010,true,1526963036,28,1535691140,8728104
1673707103,203012,true,1526657689,28,1535691140,9033451
1673707115,203012,true,1526657689,28,1535691140,9033451
1673707127,203012,true,1526657689,28,1535691140,9033451
1673707343,203015,true,1526199783,28,1534002893,7803110
1673707355,203016,true,1526047179,28,1533849508,7802329
1673707367,203016,true,1526047179,28,1533696139,7648960
1673707523,203017,true,1525894589,28,1532010085,6115496
1673707727,203020,true,1525436912,28,1529866878,4429966
1673707787,203019,true,1525589456,28,1529255084,3665628
1673707823,203019,true,1525589456,28,1528949279,3359823
1673707907,203018,true,1525742015,28,1528185034,2443019
1673708135,203020,true,1525436912,28,1526352403,915491
1673708471,203019,true,1525589456,28,1523455232,-2134224
1673709623,203018,true,1525742015,28,1521019774,-4722241
1673709695,203018,true,1525742015,28,1521171876,-4570139
1673710247,203019,true,1525589456,28,1521476126,-4113330
1673710415,203019,true,1525589456,28,1521476126,-4113330
1673710559,203018,true,1525742015,28,1521628273,-4113742
1673710667,203019,true,1525589456,28,1521628273,-3961183
1673710679,203020,true,1525436912,28,1521628273,-3808639
1673710703,203020,true,1525436912,28,1521780436,-3656476
1673711435,203019,true,1525589456,28,1522389240,-3200216
1673711663,203020,true,1525436912,28,1522541479,-2895433
1673712083,203021,true,1525284384,28,1522846002,-2438382
1673712623,203020,true,1525436912,28,1522998287,-2438625
1673712803,203020,true,1525436912,28,1522998287,-2438625
1673713127,203019,true,1525589456,28,1522998287,-2591169
1673713295,203020,true,1525436912,28,1522998287,-2438625
1673713355,203020,true,1525436912,28,1522998287,-2438625
1673713379,203019,true,1525589456,28,1522998287,-2591169
1673713391,203018,true,1525742015,28,1522998287,-2743728
1673713427,203019,true,1525589456,28,1522998287,-2591169
1673713451,203017,true,1525894589,28,1523150587,-2744002
1673713463,203017,true,1525894589,28,1523150587,-2744002
1673716607,203015,true,1526199783,28,1528032231,1832448
1673716847,203016,true,1526047179,28,1528185034,2137855
1673717231,203015,true,1526199783,28,1528490686,2290903
1673717555,203014,true,1526352403,28,1528643535,2291132
1673717807,203013,true,1526505039,28,1528949279,2444240
1673717819,203014,true,1526352403,28,1528949279,2596876
1673718119,203012,true,1526657689,28,1529713907,3056218
1673719079,203011,true,1526810355,28,1531703729,4893374
1673719895,203010,true,1526963036,28,1532316502,5353466
1673720567,203010,true,1526963036,28,1532163286,5200250
1673720747,203008,true,1527268444,28,1532163286,4894842
1673720843,203007,true,1527421171,28,1532163286,4742115
1673720891,203005,true,1527726670,28,1532163286,4436616
1673722031,203006,true,1527573913,28,1530785028,3211115
1673722271,203004,true,1527879443,28,1530631965,2752522
1673722307,203003,true,1528032231,28,1530631965,2599734
1673722391,203001,true,1528337852,28,1530478917,2141065
1673722475,203002,true,1528185034,28,1530478917,2293883
1673722883,203001,true,1528337852,28,1530325884,1988032
1673724539,202999,true,1528643535,28,1531703729,3060194
1673724575,202998,true,1528796400,28,1531703729,2907329
1673724923,202999,true,1528643535,28,1531703729,3060194
1673725787,202997,true,1528949279,28,1531550574,2601295
1673726003,202996,true,1529102174,28,1531703729,2601555
1673726351,202995,true,1529255084,28,1531856899,2601815
1673726723,202996,true,1529102174,28,1532010085,2907911
1673727059,202995,true,1529255084,28,1532163286,2908202
1673727587,202994,true,1529408010,28,1532316502,2908492
1673728607,202993,true,1529560951,28,1532010085,2449134
1673729303,202994,true,1529408010,28,1531856899,2448889
1673730047,202993,true,1529560951,28,1531856899,2295948
1673730407,202992,true,1529713907,28,1532010085,2296178
1673730647,202992,true,1529713907,28,1532010085,2296178
1673730683,202993,true,1529560951,28,1532010085,2449134
1673730719,202992,true,1529713907,28,1532010085,2296178
1673731811,202991,true,1529866878,28,1533542784,3675906
1673732327,202990,true,1530019865,28,1534156293,4136428
1673732411,202992,true,1529713907,28,1534309709,4595802
1673732447,202991,true,1529866878,28,1534309709,4442831
1673734055,202990,true,1530019865,28,1535230525,5210660
1673734391,202989,true,1530172867,28,1535384048,5211181
1673734547,202991,true,1529866878,28,1535384048,5517170
1673734559,202990,true,1530019865,28,1535384048,5364183
1673735819,202988,true,1530325884,28,1537073815,6747931
1673736563,202986,true,1530631965,28,1543079807,12447842
1673736575,202987,true,1530478917,28,1543234115,12755198
1673737151,202986,true,1530631965,28,1546478149,15846184
1673738195,202983,true,1531091200,28,1548954371,17863171
1673738699,202981,true,1531397434,28,1549109267,17711833
1673738927,202982,true,1531244309,28,1549264177,18019868
1673738939,202981,true,1531397434,28,1549264177,17866743
1673739107,202978,true,1531856899,28,1549419104,17562205
1673739419,202976,true,1532163286,28,1549419104,17255818
1673739431,202977,true,1532010085,28,1549574046,17563961
1673739455,202977,true,1532010085,28,1549574046,17563961
1673739467,202974,true,1532469734,28,1549574046,17104312
1673739491,202974,true,1532469734,28,1549574046,17104312
1673739623,202975,true,1532316502,28,1549729003,17412501
1673739839,202974,true,1532469734,28,1550193968,17724234
1673741063,202972,true,1532776243,28,1552055225,19278982
1673741075,202971,true,1532929521,28,1552055225,19125704
1673741819,202973,true,1532622981,28,1551279430,18656449
1673741843,202972,true,1532776243,28,1551279430,18503187
1673741855,202970,true,1533082813,28,1551124317,18041504
1673741927,202969,true,1533236122,28,1551124317,17888195
1673741939,202970,true,1533082813,28,1550969220,17886407
1673742623,202970,true,1533082813,28,1549264177,16181364
1673742635,202967,true,1533542784,28,1549109267,15566483
1673742695,202966,true,1533696139,28,1548954371,15258232
1673742719,202968,true,1533389445,28,1548799491,15410046
1673742755,202968,true,1533389445,28,1548334944,14945499
1673742767,202966,true,1533696139,28,1548180126,14483987
1673742779,202966,true,1533696139,28,1548025324,14329185
1673742803,202969,true,1533236122,28,1547715765,14479643
1673742815,202970,true,1533082813,28,1547561009,14478196
1673743703,202969,true,1533236122,28,1533696139,460017
1673743775,202970,true,1533082813,28,1532622981,-459832
1673743823,202973,true,1532622981,28,1532010085,-612896
1673744135,202974,true,1532469734,28,1528185034,-4284700
1673744171,202972,true,1532776243,28,1527879443,-4896800
1673744183,202971,true,1532929521,28,1527726670,-5202851
1673745011,202972,true,1532776243,28,1525436912,-7339331
1673745023,202972,true,1532776243,28,1525436912,-7339331
1673745095,202971,true,1532929521,28,1525589456,-7340065
1673747795,202970,true,1533082813,28,1524826890,-8255923
1673747819,202970,true,1533082813,28,1524979373,-8103440
1673748143,202970,true,1533082813,28,1524979373,-8103440
1673748167,202968,true,1533389445,28,1524979373,-8410072
1673748203,202968,true,1533389445,28,1524979373,-8410072
1673748227,202968,true,1533389445,28,1524979373,-8410072
1673748551,202969,true,1533236122,28,1525436912,-7799210
1673750027,202967,true,1533542784,28,1526963036,-6579748
1673750279,202966,true,1533696139,28,1526963036,-6733103
1673750303,202967,true,1533542784,28,1526963036,-6579748
1673750363,202967,true,1533542784,28,1526963036,-6579748
1673751875,202966,true,1533696139,28,1525436912,-8259227
1673752067,202965,true,1533849508,28,1525284384,-8565124
1673752907,202966,true,1533696139,28,1525131871,-8564268
1673752967,202967,true,1533542784,28,1524979373,-8563411
1673754683,202966,true,1533696139,28,1521628273,-12067866
1673754719,202965,true,1533849508,28,1521628273,-12221235
1673755295,202966,true,1533696139,28,1522541479,-11154660
1673755307,202967,true,1533542784,28,1522541479,-11001305
1673755667,202966,true,1533696139,28,1523150587,-10545552
1673757347,202965,true,1533849508,28,1524064705,-9784803
1673757491,202966,true,1533696139,28,1524217112,-9479027
1673757659,202967,true,1533542784,28,1524217112,-9325672
1673757671,202966,true,1533696139,28,1524217112,-9479027
1673759639,202965,true,1533849508,28,1524369534,-9479974
1673759651,202966,true,1533696139,28,1524369534,-9326605
1673760239,202967,true,1533542784,28,1524369534,-9173250
1673760287,202966,true,1533696139,28,1524521970,-9174169
1673760359,202966,true,1533696139,28,1524521970,-9174169
1673760599,202967,true,1533542784,28,1524521970,-9020814
1673760779,202968,true,1533389445,28,1524674423,-8715022
1673760983,202967,true,1533542784,28,1524674423,-8868361
1673761943,202967,true,1533542784,28,1525436912,-8105872
1673764235,202968,true,1533389445,28,1525894589,-7494856
1673766287,202969,true,1533236122,28,1526047179,-7188943
1673766311,202968,true,1533389445,28,1526047179,-7342266
1673769755,202968,true,1533389445,28,1525131871,-8257574
1673771015,202969,true,1533236122,28,1526047179,-7188943
1673771507,202970,true,1533082813,28,1526199783,-6883030
1673774435,202970,true,1533082813,28,1524826890,-8255923
1673775695,202970,true,1533082813,28,1524826890,-8255923
1673776595,202971,true,1532929521,28,1524826890,-8102631
1673776631,202972,true,1532776243,28,1524979373,-7796870
1673776655,202971,true,1532929521,28,1524979373,-7950148
1673776679,202971,true,1532929521,28,1524979373,-7950148
1673776799,202971,true,1532929521,28,1525131871,-7797650
1673777207,202972,true,1532776243,28,1525894589,-6881654
1673778227,202972,true,1532776243,28,1527879443,-4896800
1673779511,202972,true,1532776243,28,1528337852,-4438391
1673780747,202972,true,1532776243,28,1528337852,-4438391
1673780831,202973,true,1532622981,28,1528337852,-4285129
1673780903,202972,true,1532776243,28,1528337852,-4438391
1673782103,202973,true,1532622981,28,1528337852,-4285129
1673782175,202973,true,1532622981,28,1528490686,-4132295
1673783711,202974,true,1532469734,28,1530172867,-2296867
1673783771,202973,true,1532622981,28,1530172867,-2450114
1673783963,202973,true,1532622981,28,1530172867,-2450114
1673784023,202973,true,1532622981,28,1530172867,-2450114
1673784119,202974,true,1532469734,28,1530172867,-2296867
1673784143,202974,true,1532469734,28,1530172867,-2296867
1673785871,202973,true,1532622981,28,1533082813,459832
1673785883,202973,true,1532622981,28,1533082813,459832
1673786039,202974,true,1532469734,28,1532622981,153247
1673786399,202974,true,1532469734,28,1531397434,-1072300
1673786495,202974,true,1532469734,28,1531091200,-1378534
1673786699,202975,true,1532316502,28,1530478917,-1837585
1673786795,202976,true,1532163286,28,1530172867,-1990419
1673787083,202976,true,1532163286,28,1529560951,-2602335
1673789639,202975,true,1532316502,28,1531397434,-919068
1673789927,202976,true,1532163286,28,1531550574,-612712
1673790083,202977,true,1532010085,28,1531703729,-306356
1673790107,202977,true,1532010085,28,1531703729,-306356
1673790119,202978,true,1531856899,28,1531703729,-153170
1673790131,202978,true,1531856899,28,1531703729,-153170
1673790959,202979,true,1531703729,28,1533236122,1532393
1673791007,202980,true,1531550574,28,1533236122,1685548
1673791259,202981,true,1531397434,28,1533696139,2298705
1673792411,202981,true,1531397434,28,1534770048,3372614
1673792627,202982,true,1531244309,28,1534770048,3525739
1673794151,202984,true,1530938106,28,1534770048,3831942
1673794163,202984,true,1530938106,28,1534923525,3985419
1673794259,202985,true,1530785028,28,1534923525,4138497
1673794739,202985,true,1530785028,28,1535691140,4906112
1673794763,202987,true,1530478917,28,1535844709,5365792
1673795435,202988,true,1530325884,28,1536920123,6594239
1673795495,202988,true,1530325884,28,1537073815,6747931
1673795855,202988,true,1530325884,28,1538765442,8439558
1673795891,202990,true,1530019865,28,1539073211,9053346
1673795951,202990,true,1530019865,28,1539227118,9207253
1673796647,202990,true,1530019865,28,1541537576,11517711
1673796731,202990,true,1530019865,28,1541691729,11671864
1673797091,202991,true,1529866878,28,1542925514,13058636
1673797151,202991,true,1529866878,28,1543079807,13212929
1673797367,202991,true,1529866878,28,1543542777,13675899
1673797415,202991,true,1529866878,28,1543697131,13830253
1673797427,202992,true,1529713907,28,1543697131,13983224
1673797451,202992,true,1529713907,28,1543697131,13983224
1673797595,202991,true,1529866878,28,1544160287,14293409
1673797643,202989,true,1530172867,28,1544314703,14141836
1673797835,202989,true,1530172867,28,1545241523,15068656
1673797907,202988,true,1530325884,28,1545550587,15224703
1673797931,202986,true,1530631965,28,1545705142,15073177
1673797943,202984,true,1530938106,28,1545705142,14767036
1673798051,202982,true,1531244309,28,1546323517,15079208
1673798087,202981,true,1531397434,28,1546632797,15235363
1673798339,202978,true,1531856899,28,1548334944,16478045
1673798687,202976,true,1532163286,28,1550659073,18495787
1673798699,202975,true,1532316502,28,1550659073,18342571
1673799395,202973,true,1532622981,28,1556251226,23628245
1673799407,202971,true,1532929521,28,1556251226,23321705
1673799419,202969,true,1533236122,28,1556406851,23170729
1673799443,202968,true,1533389445,28,1556406851,23017406
1673799467,202966,true,1533696139,28,1556562492,22866353
1673799503,202964,true,1534002893,28,1556562492,22559599
1673799563,202962,true,1534309709,28,1556562492,22252783
1673799575,202961,true,1534463140,28,1556562492,22099352
1673799623,202960,true,1534616586,28,1556562492,21945906
1673800043,202958,true,1534923525,28,1555784444,20860919
1673800127,202957,true,1535077017,28,1555473334,20396317
1673800355,202956,true,1535230525,28,1554851300,19620775
1673800439,202954,true,1535537587,28,1554540376,19002789
1673800487,202953,true,1535691140,28,1554384938,18693798
1673800535,202951,true,1535998294,28,1554074107,18075813
1673800667,202950,true,1536151894,28,1553141989,16990095
1673800883,202949,true,1536305509,28,1551744860,15439351
1673801435,202948,true,1536459139,28,1549109267,12650128
1673803331,202946,true,1536766447,28,1548025324,11258877
1673803343,202945,true,1536920123,28,1548180126,11260003
1673803391,202943,true,1537227523,28,1548180126,10952603
1673803403,202942,true,1537381245,28,1548180126,10798881
1673803607,202939,true,1537842506,28,1548644627,10802121
1673803619,202938,true,1537996290,28,1548644627,10648337
1673803631,202937,true,1538150090,28,1548644627,10494537
1673803667,202935,true,1538457735,28,1548799491,10341756
1673803691,202932,true,1538919319,28,1548954371,10035052
1673803787,202930,true,1539227118,28,1549574046,10346928
1673803895,202928,true,1539534979,28,1550504023,10969044
1673803907,202926,true,1539842901,28,1550504023,10661122
1673803931,202924,true,1540150885,28,1550659073,10508188
1673804927,202922,true,1540458931,28,1556251226,15792295
1673804939,202920,true,1540767038,28,1556251226,15484188
1673804951,202919,true,1540921115,28,1556251226,15330111
1673804975,202916,true,1541383437,28,1556406851,15023414
1673805803,202916,true,1541383437,28,1555784444,14401007
1673805839,202914,true,1541691729,28,1555784444,14092715
1673805875,202912,true,1542000083,28,1555628881,13628798
1673805887,202910,true,1542308498,28,1555473334,13164836
1673805899,202910,true,1542308498,28,1555317802,13009304
1673806571,202911,true,1542154283,28,1548180126,6025843
1673806775,202909,true,1542462729,28,1546168900,3706171
1673806823,202906,true,1542925514,28,1545859713,2934199
1673807087,202907,true,1542771237,28,1543851501,1080264
1673807411,202907,true,1542771237,28,1541537576,-1233661
1673807735,202906,true,1542925514,28,1539688932,-3236582
1673807927,202903,true,1543388438,28,1540304900,-3083538
1673808107,202903,true,1543388438,28,1540767038,-2621400
1673808203,202903,true,1543388438,28,1541075207,-2313231
1673808455,202902,true,1543542777,28,1541845898,-1696879
1673810015,202899,true,1544005886,28,1545859713,1853827
1673810147,202899,true,1544005886,28,1546014299,2008413
1673810183,202899,true,1544005886,28,1546014299,2008413
1673810195,202897,true,1544314703,28,1546168900,1854197
1673810207,202894,true,1544778044,28,1546168900,1390856
1673811695,202893,true,1544932522,28,1551124317,6191795
1673813087,202894,true,1544778044,28,1552055225,7277181
1673814083,202892,true,1545087015,28,1552055225,6968210
1673820635,202889,true,1545550587,28,1551900035,6349448
1673820647,202888,true,1545705142,28,1551900035,6194893
1673820767,202889,true,1545550587,28,1551744860,6194273
1673821259,202887,true,1545859713,28,1550814139,4954426
1673822615,202885,true,1546168900,28,1548025324,1856424
1673822783,202884,true,1546323517,28,1548025324,1701807
1673822795,202885,true,1546168900,28,1548025324,1856424
1673822831,202883,true,1546478149,28,1548025324,1547175
1673822843,202881,true,1546787461,28,1548025324,1237863
1673822963,202880,true,1546942139,28,1548025324,1083185
1673823239,202880,true,1546942139,28,1548489778,1547639
1673823263,202878,true,1547251543,28,1548489778,1238235
1673823275,202876,true,1547561009,28,1548644627,1083618
1673823287,202874,true,1547870537,28,1548644627,774090
1673823299,202874,true,1547870537,28,1548644627,774090
1673823395,202872,true,1548180126,28,1549109267,929141
1673823659,202870,true,1548489778,28,1550348988,1859210
1673823875,202869,true,1548644627,28,1551279430,2634803
1673824127,202869,true,1548644627,28,1552520888,3876261
1673824655,202867,true,1548954371,28,1555006785,6052414
1673825015,202865,true,1549264177,28,1556251226,6987049
1673825447,202864,true,1549419104,28,1556562492,7143388
1673825495,202864,true,1549419104,28,1556562492,7143388
1673825519,202862,true,1549729003,28,1556562492,6833489
1673825675,202860,true,1550038965,28,1556406851,6367886
1673825687,202859,true,1550193968,28,1556406851,6212883
1673826155,202859,true,1550193968,28,1555628881,5434913
1673827787,202858,true,1550348988,28,1553918716,3569728
1673828435,202856,true,1550659073,28,1553918716,3259643
1673828447,202855,true,1550814139,28,1553918716,3104577
1673828483,202856,true,1550659073,28,1553918716,3259643
1673828495,202854,true,1550969220,28,1553918716,2949496
1673829563,202854,true,1550969220,28,1549419104,-1550116
1673830211,202854,true,1550969220,28,1546787461,-4181759
1673830379,202855,true,1550814139,28,1546632797,-4181342
1673830391,202853,true,1551124317,28,1546632797,-4491520
1673830403,202853,true,1551124317,28,1546632797,-4491520
1673830451,202853,true,1551124317,28,1546787461,-4336856
1673830463,202853,true,1551124317,28,1546787461,-4336856
1673830487,202852,true,1551279430,28,1546942139,-4337291
1673830511,202852,true,1551279430,28,1546942139,-4337291
1673830559,202851,true,1551434558,28,1547096833,-4337725
1673830991,202851,true,1551434558,28,1549419104,-2015454
1673831039,202850,true,1551589701,28,1549729003,-1860698
1673831063,202850,true,1551589701,28,1549729003,-1860698
1673831183,202849,true,1551744860,28,1550348988,-1395872
1673831243,202850,true,1551589701,28,1550814139,-775562
1673831255,202849,true,1551744860,28,1550814139,-930721
1673831267,202849,true,1551744860,28,1550969220,-775640
1673831615,202847,true,1552055225,28,1554851300,2796075
1673831639,202847,true,1552055225,28,1555162286,3107061
1673831735,202846,true,1552210430,28,1556406851,4196421
1673832071,202846,true,1552210430,28,1561238957,9028527
1673832083,202843,true,1552676140,28,1561395081,8718941
1673832131,202843,true,1552676140,28,1562019732,9343592
1673832191,202843,true,1552676140,28,1562644634,9968494
1673832203,202844,true,1552520888,28,1562800898,10280010
1673832347,202841,true,1552986691,28,1563895187,10908496
1673832899,202842,true,1552831407,28,1566555937,13724530
1673833031,202841,true,1552986691,28,1567025951,14039260
1673833295,202841,true,1552986691,28,1566869264,13882573
1673833727,202839,true,1553297303,28,1565459786,12162483
1673833763,202839,true,1553297303,28,1565303256,12005953
1673833823,202838,true,1553452633,28,1565146741,11694108
1673834171,202838,true,1553452633,28,1564833759,11381126
1673834711,202835,true,1553918716,28,1565459786,11541070
1673834939,202835,true,1553918716,28,1565772894,11854178
1673835551,202834,true,1554074107,28,1566399297,12325190
1673835563,202834,true,1554074107,28,1566399297,12325190
1673835671,202831,true,1554540376,28,1566555937,12015561
1673835695,202831,true,1554540376,28,1566555937,12015561
1673835707,202829,true,1554851300,28,1566555937,11704637
1673835803,202829,true,1554851300,28,1566712593,11861293
1673835827,202826,true,1555317802,28,1566869264,11551462
1673835851,202826,true,1555317802,28,1567025951,11708149
1673835863,202824,true,1555628881,28,1567025951,11397070
1673836115,202823,true,1555784444,28,1568750541,12966097
1673836343,202819,true,1556406851,28,1570948220,14541369
1673836715,202819,true,1556406851,28,1574093103,17686252
1673836763,202817,true,1556718148,28,1574565379,17847231
1673837171,202817,true,1556718148,28,1578033062,21314914
1673837183,202814,true,1557185210,28,1578033062,20847852
1673837207,202814,true,1557185210,28,1578190865,21005655
1673837351,202813,true,1557340929,28,1579138017,21797088
1673837483,202813,true,1557340929,28,1579927744,22586815
1673838083,202810,true,1557808178,28,1579769767,21961589
1673838203,202810,true,1557808178,28,1579295930,21487752
1673838335,202809,true,1557963959,28,1578980119,21016160
1673838371,202809,true,1557963959,28,1578822236,20858277
1673838383,202804,true,1558743096,28,1578822236,20079140
1673838407,202804,true,1558743096,28,1578822236,20079140
1673838419,202804,true,1558743096,28,1578664370,19921274
1673838431,202804,true,1558743096,28,1578664370,19921274
1673838443,202799,true,1559522624,28,1578506519,18983895
1673838683,202797,true,1559834544,28,1577244282,17409738
1673840507,202796,true,1559990527,28,1570477030,10486503
1673840591,202797,true,1559834544,28,1570477030,10642486
1673841203,202792,true,1560614617,28,1570162982,9548365
1673842859,202790,true,1560926756,28,1569378136,8451380
1673843363,202790,true,1560926756,28,1569378136,8451380
1673843879,202790,true,1560926756,28,1569378136,8451380
1673845079,202785,true,1561707375,28,1569378136,7670761
1673845247,202784,true,1561863546,28,1569378136,7514590
1673845499,202784,true,1561863546,28,1569535074,7671528
1673845739,202785,true,1561707375,28,1569535074,7827699
1673845991,202780,true,1562488385,28,1569535074,7046689
1673846531,202779,true,1562644634,28,1570162982,7518348
1673847635,202778,true,1562800898,28,1571419552,8618654
1673847875,202779,true,1562644634,28,1571576694,8932060
1673847923,202775,true,1563269786,28,1571576694,8306908
1673848355,202774,true,1563426112,28,1571576694,8150582
1673848511,202774,true,1563426112,28,1571576694,8150582
1673848523,202775,true,1563269786,28,1571576694,8306908
1673848703,202771,true,1563895187,28,1571733852,7838665
1673848751,202769,true,1564207982,28,1571733852,7525870
1673849219,202769,true,1564207982,28,1572205419,7997437
1673851775,202769,true,1564207982,28,1573778332,9570350
1673852315,202765,true,1564833759,28,1573778332,8944573
1673852435,202763,true,1565146741,28,1573778332,8631591
1673852555,202763,true,1565146741,28,1573778332,8631591
1673852795,202763,true,1565146741,28,1573620970,8474229
1673852915,202760,true,1565616332,28,1573463624,7847292
1673853263,202758,true,1565929471,28,1573148978,7219507
1673853383,202758,true,1565929471,28,1572834395,6904924
1673853911,202758,true,1565929471,28,1571419552,5490081
1673854979,202755,true,1566399297,28,1569221214,2821917
1673856407,202755,true,1566399297,28,1569064307,2665010
1673856527,202755,true,1566399297,28,1569064307,2665010
1673856551,202755,true,1566399297,28,1568907417,2508120
1673856563,202753,true,1566712593,28,1568907417,2194824
1673856575,202753,true,1566712593,28,1568750541,2037948
1673856599,202757,true,1566086064,28,1568280010,2193946
1673856707,202760,true,1565616332,28,1566242673,626341
1673856731,202757,true,1566086064,28,1565772894,-313170
1673856743,202758,true,1565929471,28,1565616332,-313139
1673857043,202761,true,1565459786,28,1560302541,-5157245
1673857211,202764,true,1564990242,28,1557496663,-7493579
1673857355,202761,true,1565459786,28,1555162286,-10297500
1673857439,202761,true,1565459786,28,1553918716,-11541070
1673857703,202764,true,1564990242,28,1550038965,-14951277
1673858027,202767,true,1564520839,28,1545241523,-19279316
1673858747,202764,true,1564990242,28,1541383437,-23606805
1673859455,202764,true,1564990242,28,1542000083,-22990159
1673859587,202767,true,1564520839,28,1541845898,-22674941
1673859599,202768,true,1564364403,28,1541845898,-22518505
1673859983,202765,true,1564833759,28,1541845898,-22987861
1673861663,202765,true,1564833759,28,1541537576,-23296183
1673863307,202768,true,1564364403,28,1541537576,-22826827
1673863343,202769,true,1564207982,28,1541537576,-22670406
1673863403,202766,true,1564677291,28,1541537576,-23139715
1673863595,202767,true,1564520839,28,1541691729,-22829110
1673863631,202770,true,1564051577,28,1541691729,-22359848
1673863655,202771,true,1563895187,28,1541691729,-22203458
1673863667,202769,true,1564207982,28,1541691729,-22516253
1673863907,202770,true,1564051577,28,1542000083,-22051494
1673864015,202773,true,1563582455,28,1542308498,-21273957
1673864039,202774,true,1563426112,28,1542308498,-21117614
1673864063,202771,true,1563895187,28,1542308498,-21586689
1673864087,202772,true,1563738813,28,1542462729,-21276084
1673864147,202775,true,1563269786,28,1542616976,-20652810
1673864255,202776,true,1563113474,28,1542925514,-20187960
1673868371,202775,true,1563269786,28,1547715765,-15554021
1673868503,202777,true,1562957178,28,1547715765,-15241413
1673869583,202780,true,1562488385,28,1546014299,-16474086
1673870783,202781,true,1562332152,28,1544932522,-17399630
1673871023,202782,true,1562175934,28,1544932522,-17243412
1673871647,202783,true,1562019732,28,1544932522,-17087210
1673873963,202786,true,1561551220,28,1544160287,-17390933
1673873975,202787,true,1561395081,28,1544160287,-17234794
1673874407,202787,true,1561395081,28,1544005886,-17389195
1673875355,202788,true,1561238957,28,1543542777,-17696180
1673875379,202791,true,1560770679,28,1543542777,-17227902
1673875751,202792,true,1560614617,28,1543388438,-17226179
1673878007,202791,true,1560770679,28,1543388438,-17382241
1673878643,202792,true,1560614617,28,1543388438,-17226179
1673878703,202796,true,1559990527,28,1543388438,-16602089
1673878859,202797,true,1559834544,28,1542925514,-16909030
1673878871,202797,true,1559834544,28,1542925514,-16909030
1673878907,202799,true,1559522624,28,1542771237,-16751387
1673879003,202802,true,1559054861,28,1542616976,-16437885
1673879027,202803,true,1558898971,28,1542616976,-16281995
1673879075,202803,true,1558898971,28,1542462729,-16436242
1673879099,202805,true,1558587238,28,1542462729,-16124509
1673879171,202808,true,1558119755,28,1542462729,-15657026
1673879207,202809,true,1557963959,28,1542462729,-15501230
1673879387,202809,true,1557963959,28,1542462729,-15501230
1673879495,202811,true,1557652412,28,1542462729,-15189683
1673879795,202814,true,1557185210,28,1542616976,-14568234
1673881607,202817,true,1556718148,28,1544160287,-12557861
1673881619,202818,true,1556562492,28,1544160287,-12402205
1673881643,202820,true,1556251226,28,1544160287,-12090939
1673881667,202823,true,1555784444,28,1544160287,-11624157
1673881751,202826,true,1555317802,28,1544005886,-11311916
1673881835,202827,true,1555162286,28,1543851501,-11310785
1673881847,202829,true,1554851300,28,1543851501,-10999799
1673881871,202832,true,1554384938,28,1543851501,-10533437
1673881967,202835,true,1553918716,28,1543542777,-10375939
1673882039,202836,true,1553763339,28,1543388438,-10374901
1673882051,202838,true,1553452633,28,1543234115,-10218518
1673882087,202841,true,1552986691,28,1543079807,-9906884
1673882099,202844,true,1552520888,28,1542925514,-9595374
1673882243,202847,true,1552055225,28,1541537576,-10517649
1673882267,202849,true,1551744860,28,1541383437,-10361423
1673882615,202851,true,1551434558,28,1538919319,-12515239
1673882627,202855,true,1550814139,28,1538919319,-11894820
1673882651,202856,true,1550659073,28,1538765442,-11893631
1673882663,202858,true,1550348988,28,1538611581,-11737407
1673882675,202859,true,1550193968,28,1538611581,-11582387
1673882687,202862,true,1549729003,28,1538611581,-11117422
1673883083,202863,true,1549574046,28,1537996290,-11577756
1673883107,202864,true,1549419104,28,1537996290,-11422814
1673883371,202866,true,1549109267,28,1537842506,-11266761
1673883383,202869,true,1548644627,28,1537842506,-10802121
1673884019,202868,true,1548799491,28,1541075207,-7724284
1673885075,202869,true,1548644627,28,1547251543,-1393084
1673885087,202871,true,1548334944,28,1547406268,-928676
1673885099,202874,true,1547870537,28,1547406268,-464269
1673885111,202873,true,1548025324,28,1547561009,-464315
1673885123,202873,true,1548025324,28,1547561009,-464315
1673885327,202875,true,1547715765,28,1548180126,464361
1673885399,202878,true,1547251543,28,1548334944,1083401
1673885627,202878,true,1547251543,28,1548954371,1702828
1673885675,202878,true,1547251543,28,1548954371,1702828
1673885783,202880,true,1546942139,28,1549419104,2476965
1673886299,202883,true,1546478149,28,1551124317,4646168
1673886347,202882,true,1546632797,28,1551279430,4646633
1673886503,202882,true,1546632797,28,1551744860,5112063
1673886719,202884,true,1546323517,28,1552520888,6197371
1673886803,202887,true,1545859713,28,1552831407,6971694
1673887271,202887,true,1545859713,28,1553763339,7903626
1673887583,202887,true,1545859713,28,1554074107,8214394
1673887823,202889,true,1545550587,28,1553918716,8368129
1673887835,202892,true,1545087015,28,1553763339,8676324
1673888099,202891,true,1545241523,28,1553452633,8211110
1673888591,202891,true,1545241523,28,1552831407,7589884
1673888639,202893,true,1544932522,28,1552831407,7898885
1673888675,202896,true,1544469134,28,1552676140,8207006
1673888915,202895,true,1544623581,28,1552365651,7742070
1673889659,202895,true,1544623581,28,1551744860,7121279
1673890295,202897,true,1544314703,28,1552986691,8671988
1673890787,202899,true,1544005886,28,1553607978,9602092
1673891003,202899,true,1544005886,28,1554229515,10223629
1673891663,202897,true,1544314703,28,1555940022,11625319
1673891711,202895,true,1544623581,28,1556095616,11472035
1673892059,202895,true,1544623581,28,1556562492,11938911
1673892167,202894,true,1544778044,28,1556718148,11940104
1673894267,202892,true,1545087015,28,1557808178,12721163
1673894291,202890,true,1545396048,28,1557963959,12567911
1673894483,202890,true,1545396048,28,1557963959,12567911
1673894495,202889,true,1545550587,28,1557963959,12413372
1673894663,202887,true,1545859713,28,1558275567,12415854
1673895263,202886,true,1546014299,28,1559054861,13040562
1673895275,202886,true,1546014299,28,1559054861,13040562
1673895323,202885,true,1546168900,28,1559054861,12885961
1673895335,202883,true,1546478149,28,1559210766,12732617
1673895371,202881,true,1546787461,28,1559366687,12579226
1673895407,202881,true,1546787461,28,1559522624,12735163
1673895431,202879,true,1547096833,28,1559678576,12581743
1673895611,202877,true,1547406268,28,1560770679,13364411
1673895731,202875,true,1547715765,28,1561707375,13991610
1673895755,202874,true,1547870537,28,1561863546,13993009
1673895863,202873,true,1548025324,28,1562644634,14619310
1673895887,202870,true,1548489778,28,1562957178,14467400
1673895899,202868,true,1548799491,28,1562957178,14157687
1673895923,202867,true,1548954371,28,1563269786,14315415
1673895995,202864,true,1549419104,28,1564364403,14945299
1673896019,202861,true,1549883976,28,1564833759,14949783
1673896043,202858,true,1550348988,28,1565146741,14797753
1673896151,202857,true,1550504023,28,1567182653,16678630
1673896739,202854,true,1550969220,28,1576771204,25801984
1673897411,202851,true,1551434558,28,1586101183,34666625
1673897711,202849,true,1551744860,28,1588799714,37054854
1673897771,202847,true,1552055225,28,1588958594,36903369
1673897783,202844,true,1552520888,28,1588958594,36437706
1673897915,202841,true,1552986691,28,1589276401,36289710
1673898071,202838,true,1553452633,28,1589594272,36141639
1673898083,202837,true,1553607978,28,1589594272,35986294
1673898191,202833,true,1554229515,28,1589912207,35682692
1673898599,202830,true,1554695830,28,1591025480,36329650
1673898971,202827,true,1555162286,28,1591980334,36818048
1673899139,202826,true,1555317802,28,1592457976,37140174
1673900027,202822,true,1555940022,28,1593573031,37633009
1673900051,202819,true,1556406851,28,1593573031,37166180
1673900087,202816,true,1556873820,28,1593573031,36699211
1673900147,202814,true,1557185210,28,1593573031,36387821
1673900759,202811,true,1557652412,28,1592457976,34805564
1673901287,202808,true,1558119755,28,1591502835,33383080
1673901299,202805,true,1558587238,28,1591502835,32915597
1673901335,202803,true,1558898971,28,1591502835,32603864
1673901383,202800,true,1559366687,28,1591343701,31977014
1673901455,202796,true,1559990527,28,1591343701,31353174
1673902223,202793,true,1560458571,28,1590707322,30248751
1673902499,202792,true,1560614617,28,1590707322,30092705
1673902631,202789,true,1561082848,28,1590866393,29783545
1673902907,202785,true,1561707375,28,1590866393,29159018
1673902919,202782,true,1562175934,28,1590866393,28690459
1673902931,202781,true,1562332152,28,1590866393,28534241
1673903903,202778,true,1562800898,28,1588482001,25681103
1673904083,202775,true,1563269786,28,1587370509,24100723
1673905823,202773,true,1563582455,28,1579295930,15713475
1673906375,202772,true,1563738813,28,1579295930,15557117
1673907359,202770,true,1564051577,28,1579295930,15244353
1673907419,202767,true,1564520839,28,1579453860,14933021
1673907431,202765,true,1564833759,28,1579453860,14620101
1673907467,202763,true,1565146741,28,1579453860,14307119
1673908427,202761,true,1565459786,28,1581508382,16048596
1673909927,202758,true,1565929471,28,1583248912,17319441
1673910251,202756,true,1566242673,28,1583248912,17006239
1673910635,202754,true,1566555937,28,1583090603,16534666
1673912015,202751,true,1567025951,28,1580243745,13217794
1673912171,202748,true,1567496106,28,1580085736,12589630
1673912699,202746,true,1567809620,28,1579611805,11802185
1673912819,202743,true,1568280010,28,1579611805,11331795
1673913335,202740,true,1568750541,28,1579611805,10861264
1673913683,202736,true,1569378136,28,1579611805,10233669
1673913923,202735,true,1569535074,28,1577875275,8340201
1673913935,202733,true,1569848996,28,1577717503,7868507
1673913959,202730,true,1570319998,28,1577559747,7239749
1673914007,202728,true,1570634078,28,1577244282,6610204
1673914031,202727,true,1570791141,28,1577086574,6295433
1673914055,202725,true,1571105315,28,1576928881,5823566
1673914091,202723,true,1571419552,28,1576771204,5351652
1673914103,202722,true,1571576694,28,1576771204,5194510
1673914115,202721,true,1571733852,28,1576613542,4879690
1673914139,202719,true,1572048214,28,1576613542,4565328
1673914223,202717,true,1572362639,28,1576298267,3935628
1673914235,202716,true,1572519876,28,1576298267,3778391
1673914259,202715,true,1572677128,28,1576140653,3463525
1673914283,202713,true,1572991679,28,1576140653,3148974
1673914295,202711,true,1573306293,28,1575983054,2676761
1673914535,202711,true,1573306293,28,1575667905,2361612
1673914559,202709,true,1573620970,28,1575510354,1889384
1673914583,202707,true,1573935710,28,1575510354,1574644
1673914607,202706,true,1574093103,28,1575510354,1417251
1673914823,202705,true,1574250513,28,1575195299,944786
1673915471,202704,true,1574407938,28,1574565379,157441
1673915483,202702,true,1574722835,28,1574565379,-157456
1673915579,202700,true,1575037795,28,1574722835,-314960
1673916563,202700,true,1575037795,28,1573148978,-1888817
1673916731,202700,true,1575037795,28,1572362639,-2675156
1673916743,202698,true,1575352819,28,1572205419,-3147400
1673917955,202697,true,1575510354,28,1568280010,-7230344
1673917979,202697,true,1575510354,28,1568123198,-7387156
1673917991,202697,true,1575510354,28,1568123198,-7387156
1673918003,202695,true,1575825472,28,1567966401,-7859071
1673918039,202696,true,1575667905,28,1567496106,-8171799
1673918063,202698,true,1575352819,28,1567182653,-8170166
1673918159,202697,true,1575510354,28,1566086064,-9424290
1673918171,202695,true,1575825472,28,1566086064,-9739408
1673918183,202697,true,1575510354,28,1565929471,-9580883
1673918207,202698,true,1575352819,28,1565616332,-9736487
1673918219,202698,true,1575352819,28,1565459786,-9893033
1673919539,202695,true,1575825472,28,1554540376,-21285096
1673919623,202697,true,1575510354,28,1553918716,-21591638
1673920079,202699,true,1575195299,28,1552986691,-22208608
1673921027,202698,true,1575352819,28,1553297303,-22055516
1673921051,202696,true,1575667905,28,1553297303,-22370602
1673921903,202698,true,1575352819,28,1553607978,-21744841
1673923583,202699,true,1575195299,28,1553918716,-21276583
1673923655,202699,true,1575195299,28,1554074107,-21121192
1673923703,202697,true,1575510354,28,1554074107,-21436247
1673923955,202699,true,1575195299,28,1554229515,-20965784
1673924039,202700,true,1575037795,28,1554384938,-20652857
1673924147,202700,true,1575037795,28,1554540376,-20497419
1673924363,202698,true,1575352819,28,1554851300,-20501519
1673924387,202699,true,1575195299,28,1555006785,-20188514
1673924579,202701,true,1574880307,28,1555473334,-19406973
1673925407,202701,true,1574880307,28,1557652412,-17227895
1673926475,202700,true,1575037795,28,1558587238,-16450557
1673927123,202701,true,1574880307,28,1558587238,-16293069
1673927147,202703,true,1574565379,28,1558743096,-15822283
1673927171,202704,true,1574407938,28,1558743096,-15664842
1673929223,202702,true,1574722835,28,1561082848,-13639987
1673929271,202704,true,1574407938,28,1561238957,-13168981
1673929283,202706,true,1574093103,28,1561238957,-12854146
1673929319,202706,true,1574093103,28,1561238957,-12854146
1673929355,202704,true,1574407938,28,1561395081,-13012857
1673929943,202707,true,1573935710,28,1563269786,-10665924
1673929979,202710,true,1573463624,28,1563269786,-10193838
1673929991,202711,true,1573306293,28,1563426112,-9880181
1673930639,202708,true,1573778332,28,1567496106,-6282226
1673930879,202711,true,1573306293,28,1568907417,-4398876
1673930903,202713,true,1572991679,28,1569064307,-3927372
1673932175,202714,true,1572834395,28,1571262426,-1571969
1673933015,202712,true,1573148978,28,1570791141,-2357837
1673934347,202715,true,1572677128,28,1570791141,-1885987
1673935907,202718,true,1572205419,28,1570634078,-1571341
1673935943,202719,true,1572048214,28,1570634078,-1414136
1673935967,202717,true,1572362639,28,1570634078,-1728561
1673936147,202720,true,1571891025,28,1570477030,-1413995
1673936699,202723,true,1571419552,28,1569848996,-1570556
1673937359,202725,true,1571105315,28,1569064307,-2041008
1673937851,202723,true,1571419552,28,1568593682,-2825870
1673937863,202726,true,1570948220,28,1568593682,-2354538
1673938547,202729,true,1570477030,28,1567652855,-2824175
1673938559,202731,true,1570162982,28,1567652855,-2510127
1673938571,202729,true,1570477030,28,1567652855,-2824175
1673938595,202731,true,1570162982,28,1567652855,-2510127
1673938931,202735,true,1569535074,28,1566712593,-2822481
1673938943,202737,true,1569221214,28,1566712593,-2508621
1673940023,202735,true,1569535074,28,1564364403,-5170671
1673941151,202737,true,1569221214,28,1563738813,-5482401
1673941259,202741,true,1568593682,28,1563738813,-4854869
1673941631,202743,true,1568280010,28,1563738813,-4541197
1673942375,202741,true,1568593682,28,1563582455,-5011227
1673943431,202744,true,1568123198,28,1563269786,-4853412
1673943587,202748,true,1567496106,28,1563426112,-4069994
1673944643,202749,true,1567339372,28,1564364403,-2974969
1673945795,202747,true,1567652855,28,1564677291,-2975564
1673946155,202749,true,1567339372,28,1564677291,-2662081
1673946191,202752,true,1566869264,28,1564677291,-2191973
1673946275,202753,true,1566712593,28,1564677291,-2035302
1673946311,202751,true,1567025951,28,1564677291,-2348660
1673946371,202752,true,1566869264,28,1564833759,-2035505
1673946983,202755,true,1566399297,28,1565929471,-469826
1673947055,202756,true,1566242673,28,1565929471,-313202
1673947415,202754,true,1566555937,28,1566555937,0
1673947727,202755,true,1566399297,28,1567025951,626654
1673948783,202759,true,1565772894,28,1567025951,1253057
1673949371,202760,true,1565616332,28,1566869264,1252932
1673950319,202757,true,1566086064,28,1566712593,626529
1673951195,202759,true,1565772894,28,1566712593,939699
1673951207,202762,true,1565303256,28,1566712593,1409337
1673951219,202763,true,1565146741,28,1566712593,1565852
1673951351,202760,true,1565616332,28,1566712593,1096261
1673951795,202762,true,1565303256,28,1566086064,782808
1673951807,202765,true,1564833759,28,1566086064,1252305
1673956535,202766,true,1564677291,28,1563426112,-1251179
1673956583,202763,true,1565146741,28,1563582455,-1564286
1673956595,202764,true,1564990242,28,1563582455,-1407787
1673956787,202766,true,1564677291,28,1563738813,-938478
1673957183,202766,true,1564677291,28,1564051577,-625714
1673957267,202764,true,1564990242,28,1564207982,-782260
1673957279,202765,true,1564833759,28,1564207982,-625777
1673957975,202767,true,1564520839,28,1565459786,938947
1673957999,202767,true,1564520839,28,1565459786,938947
1673958035,202765,true,1564833759,28,1565616332,782573
1673958083,202767,true,1564520839,28,1565616332,1095493
1673958107,202768,true,1564364403,28,1565772894,1408491
1673958119,202768,true,1564364403,28,1565772894,1408491
1673958131,202766,true,1564677291,28,1565772894,1095603
1673958143,202768,true,1564364403,28,1565929471,1565068
1673958239,202769,true,1564207982,28,1566242673,2034691
1673958251,202770,true,1564051577,28,1566242673,2191096
1673958263,202768,true,1564364403,28,1566242673,1878270
1673958287,202769,true,1564207982,28,1566399297,2191315
1673958347,202771,true,1563895187,28,1566712593,2817406
1673959487,202771,true,1563895187,28,1571105315,7210128
1673959907,202769,true,1564207982,28,1572519876,8311894
1673959919,202770,true,1564051577,28,1572519876,8468299
1673959931,202771,true,1563895187,28,1572519876,8624689
1673960087,202770,true,1564051577,28,1572519876,8468299
1673961299,202769,true,1564207982,28,1570948220,6740238
1673962139,202770,true,1564051577,28,1570319998,6268421
1673962199,202770,true,1564051577,28,1570319998,6268421
1673962535,202770,true,1564051577,28,1570319998,6268421
1673963063,202768,true,1564364403,28,1570319998,5955595
1673963483,202767,true,1564520839,28,1570319998,5799159
1673964119,202766,true,1564677291,28,1570319998,5642707
1673964407,202765,true,1564833759,28,1570319998,5486239
1673964431,202763,true,1565146741,28,1570477030,5330289
1673964443,202762,true,1565303256,28,1570477030,5173774
1673964455,202761,true,1565459786,28,1570477030,5017244
1673964467,202760,true,1565616332,28,1570477030,4860698
1673964479,202758,true,1565929471,28,1570634078,4704607
1673964743,202755,true,1566399297,28,1572205419,5806122
1673964767,202754,true,1566555937,28,1572519876,5963939
1673964791,202753,true,1566712593,28,1572677128,5964535
1673964923,202751,true,1567025951,28,1573935710,6909759
1673964995,202748,true,1567496106,28,1574722835,7226729
1673965259,202746,true,1567809620,28,1577244282,9434662
1673965355,202745,true,1567966401,28,1578348684,10382283
1673965391,202743,true,1568280010,28,1578664370,10384360
1673965403,202740,true,1568750541,28,1578822236,10071695
1673965415,202739,true,1568907417,28,1578980119,10072702
1673965451,202737,true,1569221214,28,1579453860,10232646
1673965463,202735,true,1569535074,28,1579611805,10076731
1673965487,202731,true,1570162982,28,1579927744,9764762
1673965499,202730,true,1570319998,28,1580085736,9765738
1673965595,202729,true,1570477030,28,1581508382,11031352
1673965619,202726,true,1570948220,28,1581982882,11034662
1673965631,202723,true,1571419552,28,1582141081,10721529
1673965763,202722,true,1571576694,28,1583565577,11988883
1673965823,202721,true,1571733852,28,1584357519,12623667
1673965835,202719,true,1572048214,28,1584357519,12309305
1673966063,202716,true,1572519876,28,1586418420,13898544
1673966099,202717,true,1572362639,28,1586735719,14373080
1673966255,202716,true,1572519876,28,1587529246,15009370
1673966267,202714,true,1572834395,28,1587529246,14694851
1673966303,202713,true,1572991679,28,1587529246,14537567
1673966315,202714,true,1572834395,28,1587370509,14536114
1673966327,202714,true,1572834395,28,1587370509,14536114
1673966339,202713,true,1572991679,28,1587370509,14378830
1673966879,202713,true,1572991679,28,1583090603,10098924
1673966903,202714,true,1572834395,28,1582932309,10097914
1673966915,202713,true,1572991679,28,1582774032,9782353
1673967263,202713,true,1572991679,28,1579769767,6778088
1673967299,202713,true,1572991679,28,1579453860,6462181
1673967323,202713,true,1572991679,28,1579138017,6146338
1673967347,202713,true,1572991679,28,1578822236,5830557
1673967635,202711,true,1573306293,28,1576455897,3149604
1673967659,202711,true,1573306293,28,1576298267,2991974
1673967731,202711,true,1573306293,28,1576140653,2834360
1673967767,202710,true,1573463624,28,1575983054,2519430
1673967815,202709,true,1573620970,28,1575825472,2204502
1673967851,202708,true,1573778332,28,1575667905,1889573
1673967863,202708,true,1573778332,28,1575667905,1889573
1673968379,202707,true,1573935710,28,1578033062,4097352
1673968463,202705,true,1574250513,28,1578506519,4256006
1673968559,202704,true,1574407938,28,1579138017,4730079
1673968751,202703,true,1574565379,28,1580401769,5836390
1673969171,202702,true,1574722835,28,1582299295,7576460
1673969399,202700,true,1575037795,28,1582932309,7894514
1673969531,202700,true,1575037795,28,1583248912,8211117
1673969543,202699,true,1575195299,28,1583248912,8053613
1673969807,202698,true,1575352819,28,1583090603,7737784
1673969927,202696,true,1575667905,28,1582774032,7106127
1673969951,202696,true,1575667905,28,1582774032,7106127
1673969975,202695,true,1575825472,28,1582774032,6948560
1673969999,202695,true,1575825472,28,1582615771,6790299
1673970011,202693,true,1576140653,28,1582615771,6475118
1673970035,202693,true,1576140653,28,1582457525,6316872
1673970047,202692,true,1576298267,28,1582457525,6159258
1673970059,202692,true,1576298267,28,1582299295,6001028
1673970143,202691,true,1576455897,28,1581824700,5368803
1673970215,202691,true,1576455897,28,1581350247,4894350
1673970227,202691,true,1576455897,28,1581350247,4894350
1673970239,202691,true,1576455897,28,1581192128,4736231
1673971319,202691,true,1576455897,28,1572205419,-4250478
1673971451,202691,true,1576455897,28,1571105315,-5350582
1673971499,202690,true,1576613542,28,1570791141,-5822401
1673972051,202690,true,1576613542,28,1568436838,-8176704
1673973131,202690,true,1576613542,28,1569378136,-7235406
1673973779,202690,true,1576613542,28,1569692027,-6921515
1673973791,202690,true,1576613542,28,1569692027,-6921515
1673973803,202690,true,1576613542,28,1569692027,-6921515
1673973839,202689,true,1576771204,28,1569848996,-6922208
1673973851,202689,true,1576771204,28,1569848996,-6922208
1673975999,202688,true,1576928881,28,1573778332,-3150549
1673976347,202687,true,1577086574,28,1573778332,-3308242
1673976527,202687,true,1577086574,28,1573778332,-3308242
1673977151,202686,true,1577244282,28,1573620970,-3623312
1673977475,202685,true,1577402007,28,1573463624,-3938383
1673977847,202685,true,1577402007,28,1573463624,-3938383
1673978327,202685,true,1577402007,28,1573306293,-4095714
1673978363,202684,true,1577559747,28,1573463624,-4096123
1673979515,202683,true,1577717503,28,1575510354,-2207149
1673979779,202683,true,1577717503,28,1576140653,-1576850
1673980319,202683,true,1577717503,28,1577244282,-473221
1673980355,202682,true,1577875275,28,1577244282,-630993
1673980379,202681,true,1578033062,28,1577402007,-631055
1673980391,202681,true,1578033062,28,1577402007,-631055
1673980619,202680,true,1578190865,28,1578190865,0
1673980643,202679,true,1578348684,28,1578190865,-157819
1673980667,202678,true,1578506519,28,1578348684,-157835
1673980763,202678,true,1578506519,28,1578664370,157851
1673980787,202676,true,1578822236,28,1578822236,0
1673980847,202676,true,1578822236,28,1579138017,315781
1673980871,202675,true,1578980119,28,1579295930,315811
1673980883,202675,true,1578980119,28,1579295930,315811
1673980919,202673,true,1579295930,28,1579611805,315875
1673980955,202672,true,1579453860,28,1579927744,473884
1673981315,202671,true,1579611805,28,1582615771,3003966
1673981327,202671,true,1579611805,28,1582774032,3162227
1673981339,202669,true,1579927744,28,1582774032,2846288
1673981387,202668,true,1580085736,28,1583248912,3163176
1673981567,202666,true,1580401769,28,1584674406,4272637
1673981675,202666,true,1580401769,28,1585625448,5223679
1673981747,202664,true,1580717865,28,1586259794,5541929
1673982443,202662,true,1581034025,28,1591661985,10627960
1673982635,202661,true,1581192128,28,1592617221,11425093
1673982863,202661,true,1581192128,28,1593254364,12062236
1673982875,202658,true,1581666533,28,1593254364,11587831
1673982947,202657,true,1581824700,28,1593254364,11429664
1673982971,202656,true,1581982882,28,1593254364,11271482
1673983043,202656,true,1581982882,28,1593413689,11430807
1673983211,202655,true,1582141081,28,1593413689,11272608
1673985959,202655,true,1582141081,28,1590548267,8407186
1673988227,202654,true,1582299295,28,1590548267,8248972
1673988275,202654,true,1582299295,28,1590548267,8248972
1673988563,202653,true,1582457525,28,1590389229,7931704
1673988803,202654,true,1582299295,28,1589912207,7612912
1673988815,202654,true,1582299295,28,1589912207,7612912
1673988863,202655,true,1582141081,28,1589753232,7612151
1673988875,202654,true,1582299295,28,1589753232,7453937
1673988947,202655,true,1582141081,28,1589435329,7294248
1673991155,202655,true,1582141081,28,1583565577,1424496
1673991371,202656,true,1581982882,28,1583565577,1582695
1673991395,202656,true,1581982882,28,1583565577,1582695
1673991479,202657,true,1581824700,28,1583565577,1740877
1673991887,202658,true,1581666533,28,1583248912,1582379
1673991911,202660,true,1581350247,28,1583248912,1898665
1673994035,202659,true,1581508382,28,1581508382,0
1673994911,202661,true,1581192128,28,1581508382,316254
1673995055,202661,true,1581192128,28,1581508382,316254
1673995355,202662,true,1581034025,28,1581192128,158103
1673995559,202662,true,1581034025,28,1581034025,0
1673995595,202663,true,1580875937,28,1581034025,158088
1673995619,202662,true,1581034025,28,1581034025,0
1673996291,202663,true,1580875937,28,1579927744,-948193
1673996447,202663,true,1580875937,28,1579453860,-1422077
1673998415,202664,true,1580717865,28,1575825472,-4892393
1673998571,202663,true,1580875937,28,1575825472,-5050465
1673998943,202663,true,1580875937,28,1575825472,-5050465
1673998967,202663,true,1580875937,28,1575825472,-5050465
1673999003,202663,true,1580875937,28,1575667905,-5208032
1673999291,202662,true,1581034025,28,1575037795,-5996230
1673999303,202663,true,1580875937,28,1574880307,-5995630
1673999903,202663,true,1580875937,28,1573148978,-7726959
1673999963,202664,true,1580717865,28,1572834395,-7883470
1674000059,202663,true,1580875937,28,1572519876,-8356061
1674000227,202664,true,1580717865,28,1571891025,-8826840
1674000923,202665,true,1580559809,28,1569848996,-10710813
1674001343,202666,true,1580401769,28,1569535074,-10866695
1674002255,202666,true,1580401769,28,1569064307,-11337462
1674004043,202666,true,1580401769,28,1570005981,-10395788
1674004091,202667,true,1580243745,28,1570162982,-10080763
1674004103,202668,true,1580085736,28,1570162982,-9922754
1674004151,202668,true,1580085736,28,1570162982,-9922754
1674004211,202669,true,1579927744,28,1570162982,-9764762
1674004463,202670,true,1579769767,28,1570634078,-9135689
1674006383,202671,true,1579611805,28,1572991679,-6620126
1674006983,202670,true,1579769767,28,1572991679,-6778088
1674006995,202672,true,1579453860,28,1573148978,-6304882
1674007019,202672,true,1579453860,28,1573148978,-6304882
1674007199,202673,true,1579295930,28,1573306293,-5989637
1674007211,202672,true,1579453860,28,1573306293,-6147567
1674007247,202673,true,1579295930,28,1573306293,-5989637
1674008747,202673,true,1579295930,28,1577402007,-1893923
1674009023,202673,true,1579295930,28,1577875275,-1420655
1674009503,202673,true,1579295930,28,1577875275,-1420655
1674009515,202674,true,1579138017,28,1577875275,-1262742
1674009563,202673,true,1579295930,28,1577875275,-1420655
1674009815,202674,true,1579138017,28,1577559747,-1578270
1674009827,202673,true,1579295930,28,1577559747,-1736183
1674009863,202674,true,1579138017,28,1577559747,-1578270
1674009971,202673,true,1579295930,28,1577717503,-1578427
1674009983,202672,true,1579453860,28,1577717503,-1736357
1674010283,202671,true,1579611805,28,1578506519,-1105286
1674010295,202672,true,1579453860,28,1578506519,-947341
1674011327,202669,true,1579927744,28,1581666533,1738789
1674011387,202669,true,1579927744,28,1581824700,1896956
1674011399,202668,true,1580085736,28,1581824700,1738964
1674011579,202668,true,1580085736,28,1582774032,2688296
1674011591,202666,true,1580401769,28,1582774032,2372263
1674011819,202665,true,1580559809,28,1583723934,3164125
1674011939,202664,true,1580717865,28,1584040695,3322830
1674012959,202664,true,1580717865,28,1586418420,5700555
1674013151,202662,true,1581034025,28,1586735719,5701694
1674013187,202662,true,1581034025,28,1586894393,5860368
1674013271,202661,true,1581192128,28,1587053082,5860954
1674013283,202661,true,1581192128,28,1587053082,5860954
1674014495,202659,true,1581508382,28,1586894393,5386011
1674014567,202659,true,1581508382,28,1586735719,5227337
1674014591,202658,true,1581666533,28,1586735719,5069186
1674014663,202658,true,1581666533,28,1586735719,5069186
1674014747,202657,true,1581824700,28,1586577061,4752361
1674014879,202656,true,1581982882,28,1586418420,4435538
1674014963,202656,true,1581982882,28,1586259794,4276912
1674014975,202656,true,1581982882,28,1586259794,4276912
1674014999,202655,true,1582141081,28,1586259794,4118713
1674015179,202655,true,1582141081,28,1585942589,3801508
1674015431,202655,true,1582141081,28,1585466902,3325821
1674016547,202655,true,1582141081,28,1583882306,1741225
1674016703,202654,true,1582299295,28,1583882306,1583011
1674017507,202655,true,1582141081,28,1583407237,1266156
1674018755,202655,true,1582141081,28,1582774032,632951
1674018899,202655,true,1582141081,28,1582774032,632951
1674018923,202655,true,1582141081,28,1582774032,632951
1674018995,202655,true,1582141081,28,1582774032,632951
1674020615,202655,true,1582141081,28,1583723934,1582853
1674020771,202655,true,1582141081,28,1583723934,1582853
1674021395,202655,true,1582141081,28,1583723934,1582853
1674021587,202656,true,1581982882,28,1583723934,1741052
1674021755,202656,true,1581982882,28,1583723934,1741052
1674022007,202657,true,1581824700,28,1583723934,1899234
1674025247,202657,true,1581824700,28,1583565577,1740877
1674026675,202658,true,1581666533,28,1583565577,1899044
1674028775,202658,true,1581666533,28,1583565577,1899044
1674029723,202659,true,1581508382,28,1583565577,2057195
1674029747,202659,true,1581508382,28,1583565577,2057195
1674029915,202660,true,1581350247,28,1583565577,2215330
1674029951,202661,true,1581192128,28,1583407237,2215109
1674029975,202662,true,1581034025,28,1583407237,2373212
1674029999,202662,true,1581034025,28,1583407237,2373212
1674030011,202663,true,1580875937,28,1583407237,2531300
1674030191,202664,true,1580717865,28,1582932309,2214444
1674030215,202665,true,1580559809,28,1582774032,2214223
1674030287,202665,true,1580559809,28,1582615771,2055962
1674031319,202666,true,1580401769,28,1579138017,-1263752
1674031439,202667,true,1580243745,28,1578822236,-1421509
1674032843,202667,true,1580243745,28,1578980119,-1263626
1674032855,202667,true,1580243745,28,1578980119,-1263626
1674032867,202668,true,1580085736,28,1578980119,-1105617
1674032891,202669,true,1579927744,28,1578980119,-947625
1674033827,202670,true,1579769767,28,1578664370,-1105397
1674033947,202669,true,1579927744,28,1578506519,-1421225
1674035891,202670,true,1579769767,28,1578033062,-1736705
1674039551,202670,true,1579769767,28,1578033062,-1736705
1674042899,202671,true,1579611805,28,1577402007,-2209798
1674044843,202671,true,1579611805,28,1577402007,-2209798
1674045095,202671,true,1579611805,28,1577402007,-2209798
1674046007,202671,true,1579611805,28,1577402007,-2209798
1674046235,202672,true,1579453860,28,1577559747,-1894113
1674046283,202672,true,1579453860,28,1577559747,-1894113
1674046319,202672,true,1579453860,28,1577559747,-1894113
1674046403,202672,true,1579453860,28,1577559747,-1894113
1674047171,202673,true,1579295930,28,1578033062,-1262868
1674047315,202672,true,1579453860,28,1578190865,-1262995
1674047447,202672,true,1579453860,28,1578190865,-1262995
1674047567,202672,true,1579453860,28,1578348684,-1105176
1674048623,202672,true,1579453860,28,1579611805,157945
1674048635,202672,true,1579453860,28,1579769767,315907
1674048671,202671,true,1579611805,28,1579769767,157962
1674048719,202672,true,1579453860,28,1579927744,473884
1674048827,202671,true,1579611805,28,1580243745,631940
1674049427,202670,true,1579769767,28,1581192128,1422361
1674049511,202670,true,1579769767,28,1581192128,1422361
1674049523,202670,true,1579769767,28,1581192128,1422361
1674049583,202668,true,1580085736,28,1581350247,1264511
1674049607,202668,true,1580085736,28,1581508382,1422646
1674049631,202667,true,1580243745,28,1581508382,1264637
1674049643,202666,true,1580401769,28,1581666533,1264764
1674049931,202664,true,1580717865,28,1583565577,2847712
1674049979,202662,true,1581034025,28,1583882306,2848281
1674049991,202661,true,1581192128,28,1584040695,2848567
1674050771,202661,true,1581192128,28,1589435329,8243201
1674050891,202658,true,1581666533,28,1590230206,8563673
1674050903,202657,true,1581824700,28,1590389229,8564529
1674050939,202656,true,1581982882,28,1590707322,8724440
1674050963,202655,true,1582141081,28,1590866393,8725312
1674050975,202652,true,1582615771,28,1591025480,8409709
1674051011,202651,true,1582774032,28,1591343701,8569669
1674051515,202650,true,1582932309,28,1595965064,13032755
1674051755,202649,true,1583090603,28,1597242283,14151680
1674051803,202646,true,1583565577,28,1597561748,13996171
1674051827,202645,true,1583723934,28,1597561748,13837814
1674051839,202643,true,1584040695,28,1597561748,13521053
1674051851,202642,true,1584199099,28,1597721504,13522405
1674051875,202640,true,1584515954,28,1597721504,13205550
1674052139,202640,true,1584515954,28,1598520524,14004570
1674052655,202639,true,1584674406,28,1599160028,14485622
1674052703,202638,true,1584832873,28,1599160028,14327155
1674052727,202636,true,1585149856,28,1599000128,13850272
1674052739,202636,true,1585149856,28,1599000128,13850272
1674052787,202635,true,1585308371,28,1598840244,13531873
1674052811,202634,true,1585466902,28,1598680376,13213474
1674052895,202632,true,1585784011,28,1598360688,12576677
1674053159,202632,true,1585784011,28,1597242283,11458272
1674053399,202632,true,1585784011,28,1596124661,10340650
1674054119,202632,true,1585784011,28,1593413689,7629678
1674054263,202630,true,1586101183,28,1593254364,7153181
1674054347,202630,true,1586101183,28,1593095054,6993871
1674054359,202630,true,1586101183,28,1593095054,6993871
1674054371,202630,true,1586101183,28,1593095054,6993871
1674054383,202627,true,1586577061,28,1593095054,6517993
1674054455,202628,true,1586418420,28,1592935761,6517341
1674054467,202628,true,1586418420,28,1592935761,6517341
1674054479,202628,true,1586418420,28,1592935761,6517341
1674054503,202625,true,1586894393,28,1592935761,6041368
1674054527,202625,true,1586894393,28,1593095054,6200661
1674054923,202625,true,1586894393,28,1594051150,7156757
1674055223,202625,true,1586894393,28,1594848335,7953942
1674055259,202623,true,1587211787,28,1595007820,7796033
1674055283,202623,true,1587211787,28,1595007820,7796033
1674055619,202623,true,1587211787,28,1595805484,8593697
1674055895,202623,true,1587211787,28,1596284273,9072486
1674055943,202621,true,1587529246,28,1596443901,8914655
1674056003,202621,true,1587529246,28,1596443901,8914655
1674056039,202621,true,1587529246,28,1596443901,8914655
1674056123,202621,true,1587529246,28,1596443901,8914655
1674056147,202619,true,1587846767,28,1596443901,8597134
1674056159,202619,true,1587846767,28,1596443901,8597134
1674056183,202619,true,1587846767,28,1596443901,8597134
1674056195,202619,true,1587846767,28,1596284273,8437506
1674056243,202618,true,1588005552,28,1596124661,8119109
1674056267,202617,true,1588164353,28,1596124661,7960308
1674056279,202618,true,1588005552,28,1596124661,8119109
1674056291,202618,true,1588005552,28,1595965064,7959512
1674056351,202617,true,1588164353,28,1595645919,7481566
1674056375,202617,true,1588164353,28,1595486370,7322017
1674056387,202617,true,1588164353,28,1595326838,7162485
1674056603,202618,true,1588005552,28,1593732388,5726836
1674056663,202617,true,1588164353,28,1593254364,5090011
1674056807,202617,true,1588164353,28,1591980334,3815981
1674056819,202617,true,1588164353,28,1591821152,3656799
1674056831,202618,true,1588005552,28,1591661985,3656433
1674056867,202617,true,1588164353,28,1591343701,3179348
1674056879,202618,true,1588005552,28,1591184582,3179030
1674056891,202618,true,1588005552,28,1591025480,3019928
1674056975,202620,true,1587687999,28,1589912207,2224208
1674057023,202620,true,1587687999,28,1589117490,1429491
1674057059,202620,true,1587687999,28,1588640850,952851
1674057071,202621,true,1587529246,28,1588323169,793923
1674057083,202624,true,1587053082,28,1588164353,1111271
1674057179,202624,true,1587053082,28,1586418420,-634662
1674057203,202625,true,1586894393,28,1585942589,-951804
1674057215,202625,true,1586894393,28,1585625448,-1268945
1674057275,202628,true,1586418420,28,1584040695,-2377725
1674057287,202630,true,1586101183,28,1583723934,-2377249
1674057299,202631,true,1585942589,28,1583407237,-2535352
1674057347,202633,true,1585625448,28,1581824700,-3800748
1674057395,202636,true,1585149856,28,1580401769,-4748087
1674057407,202638,true,1584832873,28,1580085736,-4747137
1674057431,202640,true,1584515954,28,1579295930,-5220024
1674057455,202641,true,1584357519,28,1578664370,-5693149
1674057611,202644,true,1583882306,28,1574407938,-9474368
1674057767,202645,true,1583723934,28,1570162982,-13560952
1674057779,202647,true,1583407237,28,1569848996,-13558241
1674057791,202648,true,1583248912,28,1569535074,-13713838
1674057803,202651,true,1582774032,28,1569221214,-13552818
1674057815,202653,true,1582457525,28,1568907417,-13550108
1674057923,202655,true,1582141081,28,1565772894,-16368187
1674058067,202657,true,1581824700,28,1561863546,-19961154
1674058079,202659,true,1581508382,28,1561551220,-19957162
1674058163,202661,true,1581192128,28,1559366687,-21825441
1674058319,202664,true,1580717865,28,1555628881,-25088984
1674058451,202665,true,1580559809,28,1552210430,-28349379
1674058475,202668,true,1580085736,28,1551744860,-28340876
1674058619,202670,true,1579769767,28,1548180126,-31589641
1674058763,202673,true,1579295930,28,1544932522,-34363408
1674058811,202675,true,1578980119,28,1544005886,-34974233
1674058847,202678,true,1578506519,28,1543234115,-35272404
1674058883,202681,true,1578033062,28,1542462729,-35570333
1674058895,202684,true,1577559747,28,1542308498,-35251249
1674058907,202686,true,1577244282,28,1542000083,-35244199
1674058919,202690,true,1576613542,28,1541845898,-34767644
1674058931,202694,true,1575983054,28,1541383437,-34599617
1674058943,202699,true,1575195299,28,1541075207,-34120092
1674058979,202702,true,1574722835,28,1540150885,-34571950
1674059027,202706,true,1574093103,28,1538919319,-35173784
1674059135,202710,true,1573463624,28,1537227523,-36236101
1674059171,202714,true,1572834395,28,1536766447,-36067948
1674059207,202718,true,1572205419,28,1536151894,-36053525
1674059243,202721,true,1571733852,28,1535691140,-36042712
1674059375,202726,true,1570948220,28,1533849508,-37098712
1674059423,202731,true,1570162982,28,1533082813,-37080169
1674059435,202734,true,1569692027,28,1532929521,-36762506
1674059447,202738,true,1569064307,28,1532622981,-36441326
1674059459,202744,true,1568123198,28,1532469734,-35653464
1674059603,202748,true,1567496106,28,1530172867,-37323239
1674059783,202752,true,1566869264,28,1527726670,-39142594
1674059795,202756,true,1566242673,28,1527573913,-38668760
1674059819,202762,true,1565303256,28,1527268444,-38034812
1674059831,202767,true,1564520839,28,1527115732,-37405107
1674059843,202772,true,1563738813,28,1526810355,-36928458
1674059855,202776,true,1563113474,28,1526657689,-36455785
1674059903,202783,true,1562019732,28,1525894589,-36125143
1674060059,202787,true,1561395081,28,1523607577,-37787504
1674060083,202792,true,1560614617,28,1523302902,-37311715
1674060107,202797,true,1559834544,28,1522998287,-36836257
1674060179,202803,true,1558898971,28,1521932614,-36966357
1674060251,202807,true,1558275567,28,1520867687,-37407880
1674060275,202812,true,1557496663,28,1520411518,-37085145
1674060287,202816,true,1556873820,28,1520259492,-36614328
1674060491,202823,true,1555784444,28,1516918765,-38865679
1674060503,202828,true,1555006785,28,1516767088,-38239697
1674060659,202831,true,1554540376,28,1514645206,-39895170
1674060887,202836,true,1553763339,28,1513736737,-40026602
1674060899,202842,true,1552831407,28,1513736737,-39094670
1674060911,202846,true,1552210430,28,1513736737,-38473693
1674061115,202849,true,1551744860,28,1513736737,-38008123
1674061127,202853,true,1551124317,28,1513736737,-37387580
1674061139,202859,true,1550193968,28,1513736737,-36457231
1674061151,202863,true,1549574046,28,1513736737,-35837309
1674061163,202865,true,1549264177,28,1513736737,-35527440
1674061175,202868,true,1548799491,28,1513888110,-34911381
1674061187,202873,true,1548025324,28,1514039499,-33985825
1674061211,202877,true,1547406268,28,1514190903,-33215365
1674061223,202878,true,1547251543,28,1514342322,-32909221
1674061403,202880,true,1546942139,28,1516767088,-30175051
1674061415,202886,true,1546014299,28,1516918765,-29095534
1674061439,202890,true,1545396048,28,1517373886,-28022162
1674061523,202891,true,1545241523,28,1518436366,-26805157
1674061571,202892,true,1545087015,28,1519195736,-25891279
1674061583,202898,true,1544160287,28,1519347656,-24812631
1674061607,202902,true,1543542777,28,1519803506,-23739271
1674061619,202903,true,1543388438,28,1519955486,-23432952
1674061643,202903,true,1543388438,28,1520411518,-22976920
1674061667,202909,true,1542462729,28,1521019774,-21442955
1674061679,202912,true,1542000083,28,1521171876,-20828207
1674061859,202912,true,1542000083,28,1525436912,-16563171
1674061991,202912,true,1542000083,28,1528490686,-13509397
1674062003,202917,true,1541229314,28,1528796400,-12432914
1674062015,202921,true,1540612977,28,1529102174,-11510803
1674062027,202921,true,1540612977,28,1529408010,-11204967
1674062039,202920,true,1540767038,28,1529713907,-11053131
1674062183,202924,true,1540150885,28,1534002893,-6147992
1674062195,202927,true,1539688932,28,1534309709,-5379223
1674062291,202927,true,1539688932,28,1537073815,-2615117
1674062303,202926,true,1539842901,28,1537381245,-2461656
1674062423,202931,true,1539073211,28,1540458931,1385720
1674062543,202934,true,1538611581,28,1543388438,4776857
1674062555,202934,true,1538611581,28,1543542777,4931196
1674063167,202934,true,1538611581,28,1552365651,13754070
1674064415,202938,true,1537996290,28,1549883976,11887686
1674064427,202942,true,1537381245,28,1549883976,12502731
1674064439,202942,true,1537381245,28,1549883976,12502731
1674064451,202941,true,1537534984,28,1549883976,12348992
1674064511,202946,true,1536766447,28,1549729003,12962556
1674064859,202950,true,1536151894,28,1548644627,12492733
1674064871,202949,true,1536305509,28,1548644627,12339118
1674064895,202948,true,1536459139,28,1548644627,12185488
1674065099,202953,true,1535691140,28,1547870537,12179397
1674066107,202956,true,1535230525,28,1544469134,9238609
1674066131,202956,true,1535230525,28,1544469134,9238609
1674066143,202954,true,1535537587,28,1544469134,8931547
1674066227,202958,true,1534923525,28,1544160287,9236762
1674066263,202960,true,1534616586,28,1544160287,9543701
1674066419,202959,true,1534770048,28,1544469134,9699086
1674066431,202956,true,1535230525,28,1544469134,9238609
1674066443,202959,true,1534770048,28,1544469134,9699086
1674066455,202961,true,1534463140,28,1544469134,10005994
1674066467,202959,true,1534770048,28,1544469134,9699086
1674067031,202955,true,1535384048,28,1546323517,10939469
1674067067,202957,true,1535077017,28,1546323517,11246500
1674067367,202959,true,1534770048,28,1546323517,11553469
1674067463,202958,true,1534923525,28,1546168900,11245375
1674067835,202955,true,1535384048,28,1545550587,10166539
1674068663,202958,true,1534923525,28,1542462729,7539204
1674070103,202961,true,1534463140,28,1540921115,6457975
1674070115,202959,true,1534770048,28,1541075207,6305159
1674070175,202957,true,1535077017,28,1541075207,5998190
1674070355,202959,true,1534770048,28,1541383437,6613389
1674071663,202960,true,1534616586,28,1543542777,8926191
1674073295,202958,true,1534923525,28,1544005886,9082361
1674073319,202956,true,1535230525,28,1544005886,8775361
1674073367,202958,true,1534923525,28,1544005886,9082361
1674073415,202959,true,1534770048,28,1544005886,9235838
1674073643,202958,true,1534923525,28,1543851501,8927976
1674073883,202955,true,1535384048,28,1543542777,8158729
1674073979,202957,true,1535077017,28,1543079807,8002790
1674074003,202958,true,1534923525,28,1543079807,8156282
1674074051,202957,true,1535077017,28,1542771237,7694220
1674074267,202955,true,1535384048,28,1541845898,6461850
1674074303,202957,true,1535077017,28,1541537576,6460559
1674074315,202958,true,1534923525,28,1541537576,6614051
1674074387,202956,true,1535230525,28,1540921115,5690590
1674074699,202955,true,1535384048,28,1537996290,2612242
1674074711,202956,true,1535230525,28,1537842506,2611981
1674074723,202956,true,1535230525,28,1537842506,2611981
1674074735,202953,true,1535691140,28,1537688737,1997597
1674074747,202952,true,1535844709,28,1537534984,1690275
1674074771,202954,true,1535537587,28,1537381245,1843658
1674074927,202953,true,1535691140,28,1535691140,0
1674074939,202951,true,1535998294,28,1535537587,-460707
1674074951,202951,true,1535998294,28,1535384048,-614246
1674074963,202952,true,1535844709,28,1535384048,-460661
1674075299,202953,true,1535691140,28,1531244309,-4446831
1674076187,202950,true,1536151894,28,1523455232,-12696662
1674076211,202950,true,1536151894,28,1523302902,-12848992
1674076511,202951,true,1535998294,28,1522541479,-13456815
1674076523,202952,true,1535844709,28,1522541479,-13303230
1674076535,202949,true,1536305509,28,1522541479,-13764030
1674076547,202949,true,1536305509,28,1522541479,-13764030
1674076583,202950,true,1536151894,28,1522541479,-13610415
1674076595,202950,true,1536151894,28,1522541479,-13610415
1674076691,202947,true,1536612785,28,1522541479,-14071306
1674077303,202946,true,1536766447,28,1524064705,-12701742
1674077771,202946,true,1536766447,28,1525284384,-11482063
1674077783,202947,true,1536612785,28,1525284384,-11328401
1674077795,202943,true,1537227523,28,1525284384,-11943139
1674077939,202943,true,1537227523,28,1525742015,-11485508
1674079751,202943,true,1537227523,28,1527726670,-9500853
1674079847,202943,true,1537227523,28,1527726670,-9500853
1674079907,202940,true,1537688737,28,1527726670,-9962067
1674079931,202939,true,1537842506,28,1527726670,-10115836
1674079991,202939,true,1537842506,28,1527573913,-10268593
1674080315,202939,true,1537842506,28,1527115732,-10726774
1674080771,202936,true,1538303905,28,1525742015,-12561890
1674081131,202936,true,1538303905,28,1524674423,-13629482
1674082079,202936,true,1538303905,28,1522846002,-15457903
1674082091,202936,true,1538303905,28,1522846002,-15457903
1674082103,202934,true,1538611581,28,1522846002,-15765579
1674082115,202934,true,1538611581,28,1522846002,-15765579
1674082355,202934,true,1538611581,28,1523302902,-15308679
1674082631,202935,true,1538457735,28,1523759938,-14697797
1674082679,202934,true,1538611581,28,1523912314,-14699267
1674082871,202935,true,1538457735,28,1524369534,-14088201
1674082883,202935,true,1538457735,28,1524369534,-14088201
1674083171,202936,true,1538303905,28,1525131871,-13172034
1674085019,202936,true,1538303905,28,1528337852,-9966053
1674085055,202938,true,1537996290,28,1528337852,-9658438
1674085283,202938,true,1537996290,28,1528032231,-9964059
1674085295,202939,true,1537842506,28,1528032231,-9810275
1674085475,202940,true,1537688737,28,1527573913,-10114824
1674085823,202942,true,1537381245,28,1526657689,-10723556
1674085835,202943,true,1537227523,28,1526657689,-10569834
1674085967,202944,true,1537073815,28,1525894589,-11179226
1674086003,202945,true,1536920123,28,1525589456,-11330667
1674086015,202949,true,1536305509,28,1525436912,-10868597
1674086039,202950,true,1536151894,28,1525284384,-10867510
1674086051,202953,true,1535691140,28,1525131871,-10559269
1674086411,202955,true,1535384048,28,1522084807,-13299241
1674086783,202959,true,1534770048,28,1518891943,-15878105
1674086975,202960,true,1534616586,28,1517525623,-17090963
1674087011,202962,true,1534309709,28,1517222164,-17087545
1674087191,202965,true,1533849508,28,1516160533,-17688975
1674087431,202969,true,1533236122,28,1514948150,-18287972
1674087443,202971,true,1532929521,28,1514948150,-17981371
1674087455,202973,true,1532622981,28,1514796670,-17826311
1674087515,202975,true,1532316502,28,1514493756,-17822746
1674087551,202980,true,1531550574,28,1514342322,-17208252
1674088235,202981,true,1531397434,28,1514796670,-16600764
1674088403,202983,true,1531091200,28,1514948150,-16143050
1674088559,202984,true,1530938106,28,1515251155,-15686951
1674088643,202988,true,1530325884,28,1515402680,-14923204
1674088679,202989,true,1530172867,28,1515554220,-14618647
1674088763,202990,true,1530019865,28,1515705776,-14314089
1674088775,202992,true,1529713907,28,1515705776,-14008131
1674088799,202995,true,1529255084,28,1515857346,-13397738
1674089867,202995,true,1529255084,28,1517677376,-11577708
1674091367,202997,true,1528949279,28,1518436366,-10512913
1674091487,202998,true,1528796400,28,1518588210,-10208190
1674091583,203002,true,1528185034,28,1518588210,-9596824
1674091667,203001,true,1528337852,28,1518588210,-9749642
1674092375,203002,true,1528185034,28,1518891943,-9293091
1674092555,203004,true,1527879443,28,1519195736,-8683707
1674093503,203007,true,1527421171,28,1520715616,-6705555
1674094331,203007,true,1527421171,28,1521323993,-6097178
1674094343,203008,true,1527268444,28,1521323993,-5944451
1674094463,203009,true,1527115732,28,1521171876,-5943856
1674095615,203013,true,1526505039,28,1519499591,-7005448
1674095807,203013,true,1526505039,28,1519347656,-7157383
1674095879,203015,true,1526199783,28,1519347656,-6852127
1674095915,203016,true,1526047179,28,1519347656,-6699523
1674097499,203020,true,1525436912,28,1521323993,-4112919
1674098531,203020,true,1525436912,28,1521780436,-3656476
1674098687,203021,true,1525284384,28,1521932614,-3351770
1674099011,203022,true,1525131871,28,1522237016,-2894855
1674101315,203024,true,1524826890,28,1523759938,-1066952
1674101759,203024,true,1524826890,28,1523759938,-1066952
1674102275,203025,true,1524674423,28,1523912314,-762109
1674102323,203026,true,1524521970,28,1524064705,-457265
1674102443,203028,true,1524217112,28,1524064705,-152407
1674102671,203028,true,1524217112,28,1524369534,152422
1674102719,203029,true,1524064705,28,1524521970,457265
1674102731,203030,true,1523912314,28,1524521970,609656
1674103295,203032,true,1523607577,28,1525589456,1981879
1674105599,203032,true,1523607577,28,1527421171,3813594
1674106139,203033,true,1523455232,28,1527421171,3965939
1674106439,203034,true,1523302902,28,1527421171,4118269
1674110771,203036,true,1522998287,28,1527421171,4422884
1674111239,203035,true,1523150587,28,1527421171,4270584
1674112163,203036,true,1522998287,28,1527421171,4422884
1674118499,203037,true,1522846002,28,1527573913,4727911
1674118583,203038,true,1522693733,28,1527573913,4880180
1674118787,203037,true,1522846002,28,1527573913,4727911
1674119567,203038,true,1522693733,28,1527573913,4880180
1674120023,203038,true,1522693733,28,1527573913,4880180
1674120707,203038,true,1522693733,28,1527573913,4880180
1674120731,203037,true,1522846002,28,1527573913,4727911
1674120827,203038,true,1522693733,28,1527573913,4880180
1674120863,203038,true,1522693733,28,1527573913,4880180
1674122711,203038,true,1522693733,28,1524217112,1523379
1674122939,203037,true,1522846002,28,1524369534,1523532
1674123659,203038,true,1522693733,28,1524369534,1675801
1674123671,203039,true,1522541479,28,1524369534,1828055
1674123875,203039,true,1522541479,28,1524369534,1828055
1674124007,203037,true,1522846002,28,1524369534,1523532
1674124583,203038,true,1522693733,28,1524369534,1675801
1674126779,203038,true,1522693733,28,1524369534,1675801
1674127079,203038,true,1522693733,28,1524369534,1675801
1674127403,203037,true,1522846002,28,1524064705,1218703
1674127439,203037,true,1522846002,28,1524064705,1218703
1674128027,203038,true,1522693733,28,1522998287,304554
1674128699,203039,true,1522541479,28,1521780436,-761043
1674129035,203038,true,1522693733,28,1521323993,-1369740
1674129371,203038,true,1522693733,28,1521171876,-1521857
1674129551,203039,true,1522541479,28,1521019774,-1521705
1674130571,203040,true,1522389240,28,1520867687,-1521553
1674131555,203039,true,1522541479,28,1521019774,-1521705
1674132503,203039,true,1522541479,28,1521019774,-1521705
1674132551,203041,true,1522237016,28,1521019774,-1217242
1674132623,203041,true,1522237016,28,1521019774,-1217242
1674132707,203041,true,1522237016,28,1520867687,-1369329
1674132875,203041,true,1522237016,28,1520715616,-1521400
1674134195,203043,true,1521932614,28,1518588210,-3344404
1674134279,203043,true,1521932614,28,1518436366,-3496248
1674134951,203043,true,1521932614,28,1518132724,-3799890
1674134963,203043,true,1521932614,28,1518132724,-3799890
1674134987,203044,true,1521780436,28,1518132724,-3647712
1674137771,203044,true,1521780436,28,1522389240,608804
1674138659,203043,true,1521932614,28,1522389240,456626
1674138803,203043,true,1521932614,28,1522541479,608865
1674138815,203044,true,1521780436,28,1522541479,761043
1674139175,203044,true,1521780436,28,1523150587,1370151
1674139187,203043,true,1521932614,28,1523150587,1217973
1674139211,203043,true,1521932614,28,1523150587,1217973
1674139283,203044,true,1521780436,28,1523607577,1827141
1674139343,203042,true,1522084807,28,1524064705,1979898
1674139523,203041,true,1522237016,28,1525131871,2894855
1674139571,203041,true,1522237016,28,1525436912,3199896
1674139655,203043,true,1521932614,28,1525894589,3961975
1674139823,203041,true,1522237016,28,1526810355,4573339
1674140771,203040,true,1522389240,28,1531244309,8855069
1674140783,203040,true,1522389240,28,1531397434,9008194
1674140831,203041,true,1522237016,28,1531550574,9313558
1674140843,203040,true,1522389240,28,1531703729,9314489
1674140855,203038,true,1522693733,28,1531703729,9009996
1674140927,203038,true,1522693733,28,1532163286,9469553
1674140939,203038,true,1522693733,28,1532163286,9469553
1674141023,203035,true,1523150587,28,1532622981,9472394
1674141479,203033,true,1523455232,28,1533849508,10394276
1674141503,203032,true,1523607577,28,1533849508,10241931
1674142091,203032,true,1523607577,28,1537381245,13773668
1674142343,203028,true,1524217112,28,1538919319,14702207
1674142571,203026,true,1524521970,28,1540150885,15628915
1674142631,203025,true,1524674423,28,1540304900,15630477
1674143171,203025,true,1524674423,28,1541075207,16400784
1674143183,203022,true,1525131871,28,1541075207,15943336
1674143819,203021,true,1525284384,28,1539534979,14250595
1674143843,203020,true,1525436912,28,1539534979,14098067
1674144275,203020,true,1525436912,28,1538150090,12713178
1674144323,203017,true,1525894589,28,1537996290,12101701
1674144359,203016,true,1526047179,28,1537842506,11795327
1674144395,203015,true,1526199783,28,1537842506,11642723
1674147503,203016,true,1526047179,28,1534923525,8876346
1674147599,203013,true,1526505039,28,1534923525,8418486
1674148643,203011,true,1526810355,28,1534923525,8113170
1674148667,203011,true,1526810355,28,1534923525,8113170
1674148715,203011,true,1526810355,28,1534923525,8113170
1674150107,203009,true,1527115732,28,1536305509,9189777
1674150719,203007,true,1527421171,28,1536459139,9037968
1674150755,203006,true,1527573913,28,1536459139,8885226
1674150767,203007,true,1527421171,28,1536459139,9037968
1674150803,203005,true,1527726670,28,1536305509,8578839
1674150827,203004,true,1527879443,28,1536151894,8272451
1674151415,203004,true,1527879443,28,1533236122,5356679
1674152471,203005,true,1527726670,28,1528796400,1069730
1674152495,203003,true,1528032231,28,1528643535,611304
1674152507,203003,true,1528032231,28,1528643535,611304
1674153443,203002,true,1528185034,28,1529866878,1681844
1674153491,203003,true,1528032231,28,1529866878,1834647
1674153515,203000,true,1528490686,28,1530019865,1529179
1674153587,203000,true,1528490686,28,1530172867,1682181
1674153611,202999,true,1528643535,28,1530325884,1682349
1674153623,202999,true,1528643535,28,1530325884,1682349
1674153671,202997,true,1528949279,28,1530478917,1529638
1674154079,202996,true,1529102174,28,1532316502,3214328
1674155279,202995,true,1529255084,28,1537534984,8279900
1674155723,202996,true,1529102174,28,1538150090,9047916
1674155747,202994,true,1529408010,28,1538150090,8742080
1674155939,202993,true,1529560951,28,1538457735,8896784
1674155963,202992,true,1529713907,28,1538457735,8743828
1674156083,202992,true,1529713907,28,1538611581,8897674
1674156179,202990,true,1530019865,28,1538919319,8899454
1674156287,202989,true,1530172867,28,1539227118,9054251
1674156299,202988,true,1530325884,28,1539227118,8901234
1674156779,202988,true,1530325884,28,1540767038,10441154
1674156827,202986,true,1530631965,28,1541075207,10443242
1674156839,202985,true,1530785028,28,1541075207,10290179
1674157535,202984,true,1530938106,28,1544005886,13067780
1674157559,202983,true,1531091200,28,1544160287,13069087
1674157571,202981,true,1531397434,28,1544160287,12762853
1674157607,202981,true,1531397434,28,1544314703,12917269
1674157631,202979,true,1531703729,28,1544469134,12765405
1674157643,202979,true,1531703729,28,1544469134,12765405
1674158351,202976,true,1532163286,28,1547251543,15088257
1674158483,202976,true,1532163286,28,1547715765,15552479
1674158531,202974,true,1532469734,28,1547870537,15400803
1674158639,202973,true,1532622981,28,1548180126,15557145
1674158651,202971,true,1532929521,28,1548180126,15250605
1674159647,202969,true,1533236122,28,1552520888,19284766
1674159659,202968,true,1533389445,28,1552520888,19131443
1674160019,202967,true,1533542784,28,1553763339,20220555
1674160031,202964,true,1534002893,28,1553763339,19760446
1674161603,202962,true,1534309709,28,1558275567,23965858
1674162275,202960,true,1534616586,28,1558587238,23970652
1674162659,202959,true,1534770048,28,1558898971,24128923
1674162695,202956,true,1535230525,28,1558898971,23668446
1674162707,202954,true,1535537587,28,1558898971,23361384
1674162719,202952,true,1535844709,28,1558898971,23054262
1674162731,202951,true,1535998294,28,1558898971,22900677
1674162743,202948,true,1536459139,28,1558898971,22439832
1674162875,202946,true,1536766447,28,1558743096,21976649
1674163919,202945,true,1536920123,28,1557029507,20109384
1674164603,202943,true,1537227523,28,1555628881,18401358
1674164663,202940,true,1537688737,28,1555628881,17940144
1674164735,202938,true,1537996290,28,1555628881,17632591
1674164747,202937,true,1538150090,28,1555473334,17323244
1674164831,202936,true,1538303905,28,1555317802,17013897
1674164975,202933,true,1538765442,28,1555006785,16241343
1674165023,202931,true,1539073211,28,1554851300,15778089
1674165335,202930,true,1539227118,28,1554074107,14846989
1674165359,202929,true,1539381041,28,1554074107,14693066
1674165611,202926,true,1539842901,28,1553297303,13454402
1674167483,202924,true,1540150885,28,1549264177,9113292
1674167951,202923,true,1540304900,28,1549264177,8959277
1674167987,202922,true,1540458931,28,1549264177,8805246
1674168335,202919,true,1540921115,28,1549264177,8343062
1674169271,202917,true,1541229314,28,1549264177,8034863
1674169307,202916,true,1541383437,28,1549264177,7880740
1674170111,202914,true,1541691729,28,1549109267,7417538
1674171791,202912,true,1542000083,28,1549109267,7109184
1674172571,202911,true,1542154283,28,1549109267,6954984
1674172583,202909,true,1542462729,28,1549264177,6801448
1674174467,202908,true,1542616976,28,1550659073,8042097
1674175331,202906,true,1542925514,28,1550659073,7733559
1674178055,202905,true,1543079807,28,1550659073,7579266
1674178067,202904,true,1543234115,28,1550814139,7580024
1674178211,202902,true,1543542777,28,1550969220,7426443
1674180095,202902,true,1543542777,28,1553452633,9909856
1674180119,202900,true,1543851501,28,1553607978,9756477
1674180263,202899,true,1544005886,28,1553607978,9602092
1674181211,202898,true,1544160287,28,1554229515,10069228
1674181751,202896,true,1544469134,28,1555006785,10537651
1674181823,202894,true,1544778044,28,1555162286,10384242
1674181883,202893,true,1544932522,28,1555317802,10385280
1674182579,202892,true,1545087015,28,1557029507,11942492
1674183575,202890,true,1545396048,28,1559054861,13658813
1674183599,202889,true,1545550587,28,1559054861,13504274
1674183611,202888,true,1545705142,28,1559054861,13349719
1674184451,202886,true,1546014299,28,1558743096,12728797
1674184715,202885,true,1546168900,28,1558587238,12418338
1674184763,202884,true,1546323517,28,1558587238,12263721
1674184799,202883,true,1546478149,28,1558587238,12109089
1674184847,202882,true,1546632797,28,1558431394,11798597
1674185039,202881,true,1546787461,28,1558119755,11332294
1674185147,202881,true,1546787461,28,1557963959,11176498
1674185207,202880,true,1546942139,28,1557808178,10866039
1674186083,202879,true,1547096833,28,1556718148,9621315
1674187259,202878,true,1547251543,28,1555940022,8688479
1674188603,202877,true,1547406268,28,1555940022,8533754
1674189851,202876,true,1547561009,28,1555784444,8223435
1674189887,202874,true,1547870537,28,1555784444,7913907
1674189911,202873,true,1548025324,28,1555784444,7759120
1674189959,202872,true,1548180126,28,1555784444,7604318
1674190391,202872,true,1548180126,28,1555317802,7137676
1674190451,202870,true,1548489778,28,1555317802,6828024
1674190511,202869,true,1548644627,28,1555162286,6517659
1674190715,202868,true,1548799491,28,1554695830,5896339
1674190823,202868,true,1548799491,28,1554384938,5585447
1674190931,202866,true,1549109267,28,1554074107,4964840
1674190943,202866,true,1549109267,28,1554074107,4964840
1674192767,202865,true,1549264177,28,1549729003,464826
1674194675,202865,true,1549264177,28,1549729003,464826
1674195155,202863,true,1549574046,28,1549574046,0
1674195383,202862,true,1549729003,28,1549574046,-154957
1674195563,202861,true,1549883976,28,1549419104,-464872
1674195971,202860,true,1550038965,28,1549264177,-774788
1674198971,202858,true,1550348988,28,1548489778,-1859210
1674200699,202858,true,1550348988,28,1547715765,-2633223
1674200711,202856,true,1550659073,28,1547715765,-2943308
1674204839,202856,true,1550659073,28,1548489778,-2169295
1674205439,202854,true,1550969220,28,1548489778,-2479442
1674206843,202854,true,1550969220,28,1548489778,-2479442
1674206867,202852,true,1551279430,28,1548489778,-2789652
1674207203,202852,true,1551279430,28,1548489778,-2789652
1674207263,202851,true,1551434558,28,1548644627,-2789931
1674207311,202850,true,1551589701,28,1548644627,-2945074
1674207323,202849,true,1551744860,28,1548644627,-3100233
1674207335,202849,true,1551744860,28,1548644627,-3100233
1674207383,202848,true,1551900035,28,1548644627,-3255408
1674207395,202847,true,1552055225,28,1548644627,-3410598
1674209195,202846,true,1552210430,28,1550969220,-1241210
1674211379,202847,true,1552055225,28,1550969220,-1086005
1674211655,202846,true,1552210430,28,1550969220,-1241210
1674216515,202845,true,1552365651,28,1550969220,-1396431
1674218111,202844,true,1552520888,28,1550969220,-1551668
1674218375,202844,true,1552520888,28,1551124317,-1396571
1674218531,202844,true,1552520888,28,1551279430,-1241458
1674218543,202844,true,1552520888,28,1551279430,-1241458
1674218639,202842,true,1552831407,28,1551279430,-1551977
1674218759,202843,true,1552676140,28,1551434558,-1241582
1674218879,202842,true,1552831407,28,1551589701,-1241706
1674219179,202842,true,1552831407,28,1551900035,-931372
1674219203,202841,true,1552986691,28,1552055225,-931466
1674219251,202841,true,1552986691,28,1552055225,-931466
1674219371,202841,true,1552986691,28,1552365651,-621040
1674219491,202841,true,1552986691,28,1552676140,-310551
1674219899,202839,true,1553297303,28,1553763339,466036
1674220007,202840,true,1553141989,28,1553918716,776727
1674220031,202840,true,1553141989,28,1554074107,932118
1674220067,202839,true,1553297303,28,1554229515,932212
1674220103,202839,true,1553297303,28,1554384938,1087635
1674220319,202839,true,1553297303,28,1555006785,1709482
1674221099,202839,true,1553297303,28,1557029507,3732204
1674224519,202839,true,1553297303,28,1557185210,3887907
1674224567,202839,true,1553297303,28,1557185210,3887907
1674224783,202839,true,1553297303,28,1557340929,4043626
1674225179,202839,true,1553297303,28,1557340929,4043626
1674225731,202839,true,1553297303,28,1557185210,3887907
1674225743,202839,true,1553297303,28,1557185210,3887907
1674226931,202839,true,1553297303,28,1560614617,7317314
1674227075,202839,true,1553297303,28,1561082848,7785545
1674227231,202838,true,1553452633,28,1561551220,8098587
1674227807,202838,true,1553452633,28,1562957178,9504545
1674227819,202837,true,1553607978,28,1562957178,9349200
1674228131,202837,true,1553607978,28,1563113474,9505496
1674228287,202836,true,1553763339,28,1563269786,9506447
1674228611,202836,true,1553763339,28,1563738813,9975474
1674231695,202835,true,1553918716,28,1564677291,10758575
1674232307,202834,true,1554074107,28,1564833759,10759652
1674232319,202833,true,1554229515,28,1564833759,10604244
1674232547,202833,true,1554229515,28,1565929471,11699956
1674232571,202832,true,1554384938,28,1566242673,11857735
1674232631,202829,true,1554851300,28,1566869264,12017964
1674233519,202826,true,1555317802,28,1576613542,21295740
1674233531,202825,true,1555473334,28,1576771204,21297870
1674233639,202824,true,1555628881,28,1578190865,22561984
1674233663,202821,true,1556095616,28,1578348684,22253068
1674233687,202818,true,1556562492,28,1578664370,22101878
1674233699,202816,true,1556873820,28,1578822236,21948416
1674234815,202815,true,1557029507,28,1587211787,30182280
1674235703,202812,true,1557496663,28,1588323169,30826506
1674237263,202809,true,1557963959,28,1588323169,30359210
1674237683,202807,true,1558275567,28,1589117490,30841923
1674237695,202806,true,1558431394,28,1589117490,30686096
1674237755,202803,true,1558898971,28,1589276401,30377430
1674238355,202799,true,1559522624,28,1591025480,31502856
1674238931,202798,true,1559678576,28,1592457976,32779400
1674238991,202796,true,1559990527,28,1592617221,32626694
1674239027,202793,true,1560458571,28,1592776483,32317912
1674239123,202790,true,1560926756,28,1592776483,31849727
1674239303,202789,true,1561082848,28,1592935761,31852913
1674239423,202787,true,1561395081,28,1592935761,31540680
1674240311,202785,true,1561707375,28,1590866393,29159018
1674241739,202782,true,1562175934,28,1589435329,27259395
1674243575,202781,true,1562332152,28,1590548267,28216115
1674243635,202779,true,1562644634,28,1590548267,27903633
1674243683,202778,true,1562800898,28,1590707322,27906424
1674243803,202775,true,1563269786,28,1590707322,27437536
1674243851,202774,true,1563426112,28,1590707322,27281210
1674243863,202772,true,1563738813,28,1590707322,26968509
1674243899,202770,true,1564051577,28,1590866393,26814816
1674244595,202767,true,1564520839,28,1592139532,27618693
1674244643,202766,true,1564677291,28,1592139532,27462241
1674244739,202764,true,1564990242,28,1592457976,27467734
1674244751,202762,true,1565303256,28,1592457976,27154720
1674244799,202758,true,1565929471,28,1592617221,26687750
1674244811,202757,true,1566086064,28,1592617221,26531157
1674244823,202755,true,1566399297,28,1592617221,26217924
1674244871,202752,true,1566869264,28,1592935761,26066497
1674244895,202748,true,1567496106,28,1593095054,25598948
1674244907,202747,true,1567652855,28,1593095054,25442199
1674244919,202745,true,1567966401,28,1593254364,25287963
1674245087,202742,true,1568436838,28,1594369976,25933138
1674245111,202737,true,1569221214,28,1594529413,25308199
1674245123,202736,true,1569378136,28,1594529413,25151277
1674245135,202734,true,1569692027,28,1594688866,24996839
1674245159,202729,true,1570477030,28,1595167321,24690291
1674245183,202723,true,1571419552,28,1595645919,24226367
1674245303,202720,true,1571891025,28,1598041064,26150039
1674245951,202717,true,1572362639,28,1609748860,37386221
1674245963,202712,true,1573148978,28,1609909835,36760857
1674245987,202706,true,1574093103,28,1610392856,36299753
1674246059,202703,true,1574565379,28,1612003974,37438595
1674246347,202699,true,1575195299,28,1618302749,43107450
1674246383,202693,true,1576140653,28,1619112062,42971409
1674246407,202687,true,1577086574,28,1619597844,42511270
1674246419,202684,true,1577559747,28,1619759804,42200057
1674246455,202680,true,1578190865,28,1620569846,42378981
1674246467,202675,true,1578980119,28,1620731903,41751784
1674246479,202669,true,1579927744,28,1621056066,41128322
1674246491,202665,true,1580559809,28,1621218171,40658362
1674246695,202662,true,1581034025,28,1624788599,43754574
1674246755,202657,true,1581824700,28,1625763716,43939016
1674247031,202651,true,1582774032,28,1628366889,45592857
1674247055,202647,true,1583407237,28,1628366889,44959652
1674247127,202644,true,1583882306,28,1628692579,44810273
1674247139,202639,true,1584674406,28,1628692579,44018173
1674247175,202632,true,1585784011,28,1628855448,43071437
1674247643,202628,true,1586418420,28,1631626719,45208299
1674247883,202624,true,1587053082,28,1632769200,45716118
1674247907,202619,true,1587846767,28,1632769200,44922433
1674248099,202613,true,1588799714,28,1633259080,44459366
1674248279,202609,true,1589435329,28,1634075873,44640544
1674248423,202605,true,1590071198,28,1634893074,44821876
1674248519,202600,true,1590866393,28,1635383591,44517198
1674248711,202593,true,1591980334,28,1636528703,44548369
1674248723,202589,true,1592617221,28,1636692356,44075135
1674248735,202585,true,1593254364,28,1636692356,43437992
1674248771,202580,true,1594051150,28,1637019711,42968561
1674248891,202572,true,1595326838,28,1638165969,42839131
1674248927,202568,true,1595965064,28,1638329785,42364721
1674249059,202564,true,1596603546,28,1638985215,42381669
1674249071,202559,true,1597402007,28,1639149114,41747107
1674249131,202552,true,1598520524,28,1639313029,40792505
1674250631,202548,true,1599160028,28,1641773720,42613692
1674251195,202545,true,1599639824,28,1641117175,41477351
1674251483,202540,true,1600439804,28,1641117175,40677371
1674252143,202532,true,1601720604,28,1641117175,39396571
1674252443,202529,true,1602201169,28,1641117175,38916006
1674252695,202525,true,1602842145,28,1641117175,38275030
1674253211,202521,true,1603483378,28,1641117175,37633797
1674253223,202513,true,1604766614,28,1641117175,36350561
1674253343,202510,true,1605248092,28,1642266302,37018210
1674253427,202506,true,1605890288,28,1642923307,37033019
1674253535,202499,true,1607014748,28,1643909307,36894559
1674253559,202491,true,1608300810,28,1644238106,35937296
1674253631,202488,true,1608783348,28,1644731426,35948078
1674253655,202484,true,1609426958,28,1645060389,35633431
1674253679,202477,true,1610553895,28,1645224895,34671000
1674253691,202469,true,1611842789,28,1645224895,33382106
1674253775,202466,true,1612326391,28,1645718512,33392121
1674253979,202463,true,1612810137,28,1646870861,34060724
1674254147,202456,true,1613939443,28,1647859230,33919787
1674254855,202450,true,1614908049,28,1651818644,36910595
1674255011,202447,true,1615392569,28,1652644718,37252149
1674255143,202444,true,1615877236,28,1652149024,36271788
1674256715,202437,true,1617008689,28,1650827899,33819210
1674256751,202430,true,1618140935,28,1650992982,32852047
1674256847,202428,true,1618464579,28,1651158081,32693502
1674257255,202424,true,1619112062,28,1652149024,33036962
1674257423,202417,true,1620245781,28,1652644718,32398937
1674257459,202410,true,1621380293,28,1652809983,31429690
1674258263,202407,true,1621866756,28,1655290934,33424178
1674258611,202405,true,1622191145,28,1656284357,34093212
1674258695,202399,true,1623164703,28,1656449985,33285282
1674258719,202394,true,1623976448,28,1656449985,32473537
1674259583,202391,true,1624463690,28,1657278376,32814686
1674259595,202389,true,1624788599,28,1657278376,32489777
1674259631,202383,true,1625763716,28,1657278376,31514660
1674259679,202378,true,1626576760,28,1657444104,30867344
1674259715,202375,true,1627064782,28,1657609848,30545066
1674259823,202372,true,1627552950,28,1658604663,31051713
1674259835,202366,true,1628529726,28,1658604663,30074937
1674259871,202360,true,1629507088,28,1658936400,29429312
1674259883,202357,true,1629995989,28,1658936400,28940411
1674259895,202354,true,1630485037,28,1659102294,28617257
1674259907,202348,true,1631463573,28,1659102294,27638721
1674259931,202344,true,1632116256,28,1659268204,27151948
1674259943,202341,true,1632605940,28,1659268204,26662264
1674259955,202338,true,1633095770,28,1659268204,26172434
1674260267,202333,true,1633912482,28,1659766034,25853552
1674260303,202329,true,1634566145,28,1659766034,25199889
1674261179,202326,true,1635056564,28,1660430040,25373476
1674261239,202324,true,1635383591,28,1660430040,25046449
1674261251,202318,true,1636365067,28,1660430040,24064973
1674262391,202314,true,1637019711,28,1659766034,22746323
1674262751,202311,true,1637510866,28,1660098004,22587138
1674262763,202308,true,1638002168,28,1660098004,22095836
1674263363,202303,true,1638821333,28,1660098004,21276671
1674263399,202299,true,1639476960,28,1660098004,20621044
1674263615,202296,true,1639968852,28,1659766034,19797182
1674263711,202293,true,1640460892,28,1659600074,19139182
1674264851,202288,true,1641281287,28,1658272992,16991705
1674265271,202285,true,1641773720,28,1657941387,16167667
1674265727,202282,true,1642266302,28,1657941387,15675085
1674265907,202279,true,1642759031,28,1657941387,15182356
1674265979,202274,true,1643580575,28,1657941387,14360812
1674266015,202271,true,1644073698,28,1657941387,13867689
1674266387,202268,true,1644566970,28,1657609848,13042878
1674266507,202266,true,1644895899,28,1657609848,12713949
1674266759,202261,true,1645718512,28,1657444104,11725592
1674266987,202258,true,1646212277,28,1657112665,10900388
1674267131,202256,true,1646541536,28,1657112665,10571129
1674267335,202254,true,1646870861,28,1656781292,9910431
1674267599,202250,true,1647529708,28,1656615630,9085922
1674267827,202247,true,1648024016,28,1656449985,8425969
1674268103,202244,true,1648518473,28,1656449985,7931512
1674269327,202242,true,1648848193,28,1656118745,7270552
1674269339,202240,true,1649177979,28,1656118745,6940766
1674269363,202239,true,1649342897,28,1656118745,6775848
1674269375,202237,true,1649672782,28,1656118745,6445963
1674269387,202236,true,1649837749,28,1656118745,6280996
1674271079,202235,true,1650002733,28,1649837749,-164984
1674271643,202233,true,1650332750,28,1649507831,-824919
1674272255,202232,true,1650497783,28,1649507831,-989952
1674273467,202233,true,1650332750,28,1649342897,-989853
1674274247,202231,true,1650662833,28,1649342897,-1319936
1674275135,202230,true,1650827899,28,1649342897,-1485002
1674275471,202229,true,1650992982,28,1649507831,-1485151
1674275879,202229,true,1650992982,28,1649672782,-1320200
1674276059,202227,true,1651323197,28,1649672782,-1650415
1674277391,202226,true,1651488330,28,1650497783,-990547
1674278363,202224,true,1651818644,28,1650662833,-1155811
1674278843,202224,true,1651818644,28,1650662833,-1155811
1674278939,202222,true,1652149024,28,1650662833,-1486191
1674279131,202221,true,1652314239,28,1650662833,-1651406
1674279479,202220,true,1652479470,28,1650497783,-1981687
1674280667,202219,true,1652644718,28,1650332750,-2311968
1674281099,202218,true,1652809983,28,1650332750,-2477233
1674281687,202217,true,1652975264,28,1650002733,-2972531
1674281807,202216,true,1653140561,28,1650002733,-3137828
1674282071,202216,true,1653140561,28,1650002733,-3137828
1674283427,202215,true,1653305875,28,1649507831,-3798044
1674283739,202214,true,1653471206,28,1649837749,-3633457
1674284099,202214,true,1653471206,28,1650002733,-3468473
1674284675,202214,true,1653471206,28,1650497783,-2973423
1674285575,202212,true,1653801917,28,1650827899,-2974018
1674285875,202211,true,1653967297,28,1650827899,-3139398
1674286463,202211,true,1653967297,28,1650992982,-2974315
1674286751,202212,true,1653801917,28,1650992982,-2808935
1674286763,202210,true,1654132694,28,1650992982,-3139712
1674286859,202210,true,1654132694,28,1650992982,-3139712
1674286871,202210,true,1654132694,28,1650992982,-3139712
1674287231,202210,true,1654132694,28,1650992982,-3139712
1674288287,202208,true,1654463537,28,1650992982,-3470555
1674289235,202209,true,1654298107,28,1650827899,-3470208
1674289955,202208,true,1654463537,28,1650827899,-3635638
1674290135,202208,true,1654463537,28,1650827899,-3635638
1674290219,202206,true,1654794446,28,1650827899,-3966547
1674290543,202206,true,1654794446,28,1650827899,-3966547
1674291347,202206,true,1654794446,28,1650827899,-3966547
1674291803,202206,true,1654794446,28,1650827899,-3966547
1674292187,202204,true,1655125421,28,1650827899,-4297522
1674292895,202204,true,1655125421,28,1650827899,-4297522
1674292907,202204,true,1655125421,28,1650827899,-4297522
1674293111,202205,true,1654959925,28,1650827899,-4132026
1674294143,202206,true,1654794446,28,1650662833,-4131613
1674294503,202206,true,1654794446,28,1651158081,-3636365
1674294947,202205,true,1654959925,28,1651818644,-3141281
1674294959,202206,true,1654794446,28,1651818644,-2975802
1674295043,202206,true,1654794446,28,1651983826,-2810620
1674295067,202206,true,1654794446,28,1652149024,-2645422
1674295091,202205,true,1654959925,28,1652149024,-2810901
1674295115,202205,true,1654959925,28,1652149024,-2810901
1674295127,202205,true,1654959925,28,1652314239,-2645686
1674295139,202205,true,1654959925,28,1652314239,-2645686
1674295223,202204,true,1655125421,28,1652644718,-2480703
1674295319,202204,true,1655125421,28,1652975264,-2150157
1674295331,202204,true,1655125421,28,1652975264,-2150157
1674295379,202204,true,1655125421,28,1653305875,-1819546
1674295403,202202,true,1655456463,28,1653305875,-2150588
1674295487,202202,true,1655456463,28,1653967297,-1489166
1674295499,202203,true,1655290934,28,1653967297,-1323637
1674295811,202202,true,1655456463,28,1656284357,827894
1674295835,202200,true,1655787571,28,1656615630,828059
1674295883,202200,true,1655787571,28,1656946970,1159399
1674295895,202201,true,1655622009,28,1656946970,1324961
1674295907,202200,true,1655787571,28,1657112665,1325094
1674295931,202199,true,1655953150,28,1657278376,1325226
1674295943,202198,true,1656118745,28,1657444104,1325359
1674295955,202199,true,1655953150,28,1657609848,1656698
1674295967,202198,true,1656118745,28,1657609848,1491103
1674295979,202197,true,1656284357,28,1657775609,1491252
1674295991,202197,true,1656284357,28,1657941387,1657030
1674296003,202198,true,1656118745,28,1658107181,1988436
1674296111,202197,true,1656284357,28,1659268204,2983847
1674296183,202196,true,1656449985,28,1660264014,3814029
1674296339,202196,true,1656449985,28,1662091218,5641233
1674296411,202197,true,1656284357,28,1662922430,6638073
1674296519,202195,true,1656615630,28,1664086825,7471195
1674296723,202194,true,1656781292,28,1666584703,9803411
1674296747,202194,true,1656781292,28,1666918036,10136744
1674296759,202194,true,1656781292,28,1666918036,10136744
1674296771,202192,true,1657112665,28,1667084728,9972063
1674296783,202192,true,1657112665,28,1667084728,9972063
1674296795,202194,true,1656781292,28,1667084728,10303436
1674296807,202195,true,1656615630,28,1666918036,10302406
1674296855,202197,true,1656284357,28,1666251436,9967079
1674297023,202198,true,1656118745,28,1664419659,8300914
1674297035,202199,true,1655953150,28,1664253233,8300083
1674297047,202200,true,1655787571,28,1664086825,8299254
1674297083,202202,true,1655456463,28,1663421356,7964893
1674297095,202204,true,1655125421,28,1663255031,8129610
1674297119,202206,true,1654794446,28,1662756154,7961708
1674297155,202207,true,1654628983,28,1662257427,7628444
1674297167,202209,true,1654298107,28,1661925025,7626918
1674297179,202211,true,1653967297,28,1661758849,7791552
1674297203,202212,true,1653801917,28,1661426547,7624630
1674297215,202212,true,1653801917,28,1661260421,7458504
1674297419,202214,true,1653471206,28,1657941387,4470181
1674297467,202215,true,1653305875,28,1657112665,3806790
1674297479,202217,true,1652975264,28,1656946970,3971706
1674297491,202217,true,1652975264,28,1656781292,3806028
1674297599,202218,true,1652809983,28,1655290934,2480951
1674297815,202219,true,1652644718,28,1651818644,-826074
1674297983,202220,true,1652479470,28,1648518473,-3960997
1674298043,202221,true,1652314239,28,1647364971,-4949268
1674298331,202222,true,1652149024,28,1641773720,-10375304
1674298343,202223,true,1651983826,28,1641609559,-10374267
1674299567,202224,true,1651818644,28,1639476960,-12341684
1674300491,202225,true,1651653478,28,1639149114,-12504364
1674300575,202225,true,1651653478,28,1639149114,-12504364
1674300671,202227,true,1651323197,28,1639149114,-12174083
1674300683,202227,true,1651323197,28,1639149114,-12174083
1674300695,202227,true,1651323197,28,1639149114,-12174083
1674300767,202227,true,1651323197,28,1639149114,-12174083
1674300779,202229,true,1650992982,28,1639149114,-11843868
1674300839,202229,true,1650992982,28,1639313029,-11679953
1674300983,202228,true,1651158081,28,1639476960,-11681121
1674301139,202229,true,1650992982,28,1639640908,-11352074
1674301247,202230,true,1650827899,28,1639804872,-11023027
1674301367,202230,true,1650827899,28,1639968852,-10859047
1674301403,202230,true,1650827899,28,1640132849,-10695050
1674301511,202231,true,1650662833,28,1640296863,-10365970
1674301583,202232,true,1650497783,28,1640624938,-9872845
1674302771,202231,true,1650662833,28,1644073698,-6589135
1674302843,202231,true,1650662833,28,1644073698,-6589135
1674302879,202232,true,1650497783,28,1644238106,-6259677
1674302951,202233,true,1650332750,28,1644402529,-5930221
1674302963,202232,true,1650497783,28,1644402529,-6095254
1674302999,202232,true,1650497783,28,1644566970,-5930813
1674303995,202232,true,1650497783,28,1647200251,-3297532
1674304007,202233,true,1650332750,28,1647364971,-2967779
1674304043,202233,true,1650332750,28,1647364971,-2967779
1674304127,202232,true,1650497783,28,1647694461,-2803322
1674304247,202232,true,1650497783,28,1648188818,-2308965
1674304859,202233,true,1650332750,28,1650167733,-165017
1674305003,202232,true,1650497783,28,1650332750,-165033
1674305291,202232,true,1650497783,28,1650827899,330116
1674305435,202232,true,1650497783,28,1650992982,495199
1674305543,202233,true,1650332750,28,1651158081,825331
1674305579,202232,true,1650497783,28,1651323197,825414
1674305687,202232,true,1650497783,28,1651488330,990547
1674305699,202231,true,1650662833,28,1651488330,825497
1674305807,202233,true,1650332750,28,1651653478,1320728
1674305891,202232,true,1650497783,28,1651818644,1320861
1674305915,202231,true,1650662833,28,1651818644,1155811
1674305927,202231,true,1650662833,28,1651818644,1155811
1674305939,202232,true,1650497783,28,1651818644,1320861
1674307475,202231,true,1650662833,28,1655290934,4628101
1674308003,202230,true,1650827899,28,1655622009,4794110
1674308015,202230,true,1650827899,28,1655622009,4794110
1674308027,202231,true,1650662833,28,1655622009,4959176
1674309467,202230,true,1650827899,28,1652809983,1982084
1674310043,202230,true,1650827899,28,1651983826,1155927
1674313235,202230,true,1650827899,28,1651983826,1155927
1674314255,202231,true,1650662833,28,1651983826,1320993
1674314267,202230,true,1650827899,28,1652149024,1321125
1674314339,202230,true,1650827899,28,1652314239,1486340
1674314495,202229,true,1650992982,28,1652975264,1982282
1674314675,202229,true,1650992982,28,1653967297,2974315
1674315227,202228,true,1651158081,28,1656615630,5457549
1674315239,202228,true,1651158081,28,1656615630,5457549
1674315251,202228,true,1651158081,28,1656615630,5457549
1674316535,202227,true,1651323197,28,1662091218,10768021
1674316583,202226,true,1651488330,28,1662091218,10602888
1674316679,202227,true,1651323197,28,1662091218,10768021
1674316691,202226,true,1651488330,28,1662091218,10602888
1674316703,202226,true,1651488330,28,1662091218,10602888
1674316739,202226,true,1651488330,28,1661925025,10436695
1674316787,202227,true,1651323197,28,1661758849,10435652
1674317447,202228,true,1651158081,28,1657444104,6286023
1674317483,202228,true,1651158081,28,1657112665,5954584
1674317507,202228,true,1651158081,28,1656946970,5788889
1674317891,202230,true,1650827899,28,1654628983,3801084
1674318011,202230,true,1650827899,28,1653801917,2974018
1674318047,202231,true,1650662833,28,1653636553,2973720
1674318971,202231,true,1650662833,28,1652314239,1651406
1674319103,202232,true,1650497783,28,1652644718,2146935
1674319403,202233,true,1650332750,28,1653305875,2973125
1674319415,202233,true,1650332750,28,1653471206,3138456
1674319595,202234,true,1650167733,28,1653801917,3634184
1674319943,202235,true,1650002733,28,1654628983,4626250
1674319991,202236,true,1649837749,28,1654794446,4956697
1674320027,202236,true,1649837749,28,1654794446,4956697
1674321779,202236,true,1649837749,28,1657609848,7772099
1674323351,202238,true,1649507831,28,1657609848,8102017
1674323615,202239,true,1649342897,28,1657609848,8266951
1674323627,202240,true,1649177979,28,1657609848,8431869
1674324083,202240,true,1649177979,28,1656946970,7768991
1674325703,202242,true,1648848193,28,1654794446,5946253
1674325715,202243,true,1648683325,28,1654794446,6111121
1674327275,202244,true,1648518473,28,1654628983,6110510
1674327323,202244,true,1648518473,28,1654794446,6275973
1674327335,202246,true,1648188818,28,1654794446,6605628
1674327407,202247,true,1648024016,28,1654794446,6770430
1674327623,202247,true,1648024016,28,1655125421,7101405
1674327683,202245,true,1648353637,28,1655290934,6937297
1674327719,202246,true,1648188818,28,1655290934,7102116
1674327887,202243,true,1648683325,28,1655787571,7104246
1674328031,202242,true,1648848193,28,1656118745,7270552
1674328079,202240,true,1649177979,28,1656284357,7106378
1674328103,202240,true,1649177979,28,1656449985,7272006
1674328115,202237,true,1649672782,28,1656449985,6777203
1674328163,202234,true,1650167733,28,1656615630,6447897
1674329339,202232,true,1650497783,28,1661925025,11427242
1674330047,202233,true,1650332750,28,1663088722,12755972
1674330395,202230,true,1650827899,28,1662922430,12094531
1674332207,202227,true,1651323197,28,1663920433,12597236
1674332555,202225,true,1651653478,28,1663920433,12266955
1674333059,202226,true,1651488330,28,1663754057,12265727
1674333491,202224,true,1651818644,28,1663421356,11602712
1674333551,202221,true,1652314239,28,1663088722,10774483
1674333563,202219,true,1652644718,28,1663088722,10444004
1674334031,202221,true,1652314239,28,1660762143,8447904
1674334547,202220,true,1652479470,28,1658272992,5793522
1674334787,202217,true,1652975264,28,1657278376,4303112
1674337019,202216,true,1653140561,28,1655125421,1984860
1674337031,202217,true,1652975264,28,1655290934,2315670
1674337103,202216,true,1653140561,28,1655290934,2150373
1674337595,202214,true,1653471206,28,1655456463,1985257
1674337607,202212,true,1653801917,28,1655456463,1654546
1674338399,202213,true,1653636553,28,1656118745,2482192
1674339863,202212,true,1653801917,28,1658770523,4968606
1674339875,202210,true,1654132694,28,1658770523,4637829
1674339887,202208,true,1654463537,28,1658770523,4306986
1674339911,202209,true,1654298107,28,1658770523,4472416
1674340007,202209,true,1654298107,28,1658770523,4472416
1674340055,202206,true,1654794446,28,1658770523,3976077
1674340235,202205,true,1654959925,28,1658438819,3478894
1674340463,202206,true,1654794446,28,1657775609,2981163
1674340523,202206,true,1654794446,28,1657609848,2815402
1674341303,202204,true,1655125421,28,1655456463,331042
1674341987,202202,true,1655456463,28,1653636553,-1819910
1674341999,202204,true,1655125421,28,1653636553,-1488868
1674342035,202204,true,1655125421,28,1653140561,-1984860
1674342071,202202,true,1655456463,28,1652809983,-2646480
1674342083,202204,true,1655125421,28,1652644718,-2480703
1674342095,202206,true,1654794446,28,1652479470,-2314976
1674342107,202205,true,1654959925,28,1652314239,-2645686
1674342119,202204,true,1655125421,28,1652314239,-2811182
1674342143,202206,true,1654794446,28,1651983826,-2810620
1674342251,202208,true,1654463537,28,1651158081,-3305456
1674342323,202208,true,1654463537,28,1650497783,-3965754
1674342755,202206,true,1654794446,28,1647035548,-7758898
1674342839,202208,true,1654463537,28,1646376898,-8086639
1674343223,202210,true,1654132694,28,1643416233,-10716461
1674343319,202210,true,1654132694,28,1642759031,-11373663
1674343331,202208,true,1654463537,28,1642594771,-11868766
1674343355,202211,true,1653967297,28,1642430528,-11536769
1674343391,202213,true,1653636553,28,1641937898,-11698655
1674343403,202214,true,1653471206,28,1641937898,-11533308
1674343415,202212,true,1653801917,28,1641773720,-12028197
1674343427,202214,true,1653471206,28,1641609559,-11861647
1674343463,202217,true,1652975264,28,1641117175,-11858089
1674343499,202219,true,1652644718,28,1640624938,-12019780
1674343679,202217,true,1652975264,28,1638002168,-14973096
1674343763,202220,true,1652479470,28,1636528703,-15950767
1674343775,202223,true,1651983826,28,1636365067,-15618759
1674343907,202225,true,1651653478,28,1635383591,-16269887
1674343943,202224,true,1651818644,28,1635056564,-16762080
1674343979,202227,true,1651323197,28,1634893074,-16430123
1674343991,202230,true,1650827899,28,1634729601,-16098298
1674344051,202231,true,1650662833,28,1634402704,-16260129
1674345359,202230,true,1650827899,28,1627064782,-23763117
1674345767,202233,true,1650332750,28,1627715705,-22617045
1674346307,202236,true,1649837749,28,1627390211,-22447538
1674346343,202237,true,1649672782,28,1627227488,-22445294
1674346355,202235,true,1650002733,28,1627227488,-22775245
1674346451,202238,true,1649507831,28,1627227488,-22280343
1674346463,202241,true,1649013078,28,1627227488,-21785590
1674347111,202242,true,1648848193,28,1627552950,-21295243
1674347159,202242,true,1648848193,28,1627552950,-21295243
1674347231,202245,true,1648353637,28,1627715705,-20637932
1674347279,202248,true,1647859230,28,1627715705,-20143525
1674347303,202249,true,1647694461,28,1627715705,-19978756
1674347387,202249,true,1647694461,28,1627878477,-19815984
1674349067,202252,true,1647200251,28,1631789882,-15410369
1674349763,202255,true,1646706190,28,1631789882,-14916308
1674349799,202255,true,1646706190,28,1631789882,-14916308
1674349835,202255,true,1646706190,28,1631789882,-14916308
1674349895,202258,true,1646212277,28,1631789882,-14422395
1674351539,202260,true,1645883084,28,1628366889,-17516195
1674351863,202260,true,1645883084,28,1628204069,-17679015
1674351887,202260,true,1645883084,28,1628204069,-17679015
1674351983,202263,true,1645389418,28,1627878477,-17510941
1674353003,202266,true,1644895899,28,1623976448,-20919451
1674354539,202267,true,1644731426,28,1621542431,-23188995
1674354779,202267,true,1644731426,28,1621542431,-23188995
1674354911,202269,true,1644402529,28,1621542431,-22860098
1674355475,202273,true,1643744933,28,1621542431,-22202502
1674355487,202274,true,1643580575,28,1621542431,-22038144
1674355499,202274,true,1643580575,28,1621542431,-22038144
1674355535,202277,true,1643087599,28,1621380293,-21707306
1674356147,202283,true,1642102092,28,1617817355,-24284737
1674356183,202284,true,1641937898,28,1617655590,-24282308
1674356303,202284,true,1641937898,28,1617008689,-24929209
1674356459,202287,true,1641445415,28,1616200427,-25244988
1674356531,202293,true,1640460892,28,1615877236,-24583656
1674356639,202293,true,1640460892,28,1615392569,-25068323
1674356951,202293,true,1640460892,28,1613939443,-26521449
1674357263,202296,true,1639968852,28,1612810137,-27158715
1674357311,202302,true,1638985215,28,1612810137,-26175078
1674358043,202302,true,1638985215,28,1614262247,-24722968
1674358055,202302,true,1638985215,28,1614423673,-24561542
1674358091,202305,true,1638493618,28,1614423673,-24069945
1674358451,202310,true,1637674617,28,1615231046,-22443571
1674358475,202310,true,1637674617,28,1615231046,-22443571
1674358511,202311,true,1637510866,28,1615392569,-22118297
1674360419,202314,true,1637019711,28,1617979137,-19040574
1674361379,202319,true,1636201447,28,1618140935,-18060512
1674361451,202319,true,1636201447,28,1618140935,-18060512
1674361475,202320,true,1636037843,28,1618140935,-17896908
1674362039,202322,true,1635710684,28,1618626426,-17084258
1674362075,202328,true,1634729601,28,1618626426,-16103175
1674362087,202328,true,1634729601,28,1618626426,-16103175
1674362147,202329,true,1634566145,28,1618788288,-15777857
1674362327,202332,true,1634075873,28,1619112062,-14963811
1674362543,202337,true,1633259080,28,1619435901,-13823179
1674362579,202337,true,1633259080,28,1619597844,-13661236
1674362675,202338,true,1633095770,28,1619759804,-13335966
1674363983,202340,true,1632769200,28,1622677851,-10091349
1674364103,202345,true,1631953061,28,1622840119,-9112942
1674364307,202346,true,1631789882,28,1623164703,-8625179
1674364499,202346,true,1631789882,28,1623327020,-8462862
1674364583,202349,true,1631300442,28,1623489353,-7811089
1674364727,202353,true,1630648085,28,1623651701,-6996384
1674366575,202352,true,1630811150,28,1625601155,-5209995
1674366599,202353,true,1630648085,28,1625601155,-5046930
1674367919,202355,true,1630322005,28,1625601155,-4720850
1674368831,202359,true,1629670039,28,1625438612,-4231427
1674369479,202359,true,1629670039,28,1625601155,-4068884
1674369887,202359,true,1629670039,28,1625763716,-3906323
1674370199,202362,true,1629181236,28,1625926292,-3254944
1674370235,202366,true,1628529726,28,1625926292,-2603434
1674373091,202366,true,1628529726,28,1626576760,-1952966
1674374675,202366,true,1628529726,28,1626576760,-1952966
1674377447,202369,true,1628041265,28,1626414119,-1627146
1674377579,202373,true,1627390211,28,1626576760,-813451
1674378119,202372,true,1627552950,28,1626576760,-976190
1674378203,202373,true,1627390211,28,1626576760,-813451
1674378335,202375,true,1627064782,28,1626576760,-488022
1674378467,202379,true,1626414119,28,1626739418,325299
1674379139,202378,true,1626576760,28,1627064782,488022
1674380783,202379,true,1626414119,28,1627227488,813369
1674386387,202381,true,1626088885,28,1627227488,1138603
1674387071,202385,true,1625438612,28,1627064782,1626170
1674387551,202384,true,1625601155,28,1626576760,975605
1674390359,202384,true,1625601155,28,1625438612,-162543
1674391799,202383,true,1625763716,28,1625438612,-325104
1674391883,202387,true,1625113573,28,1625601155,487582
1674391979,202386,true,1625276084,28,1625601155,325071
1674392267,202386,true,1625276084,28,1625763716,487632
1674392303,202385,true,1625438612,28,1625763716,325104
1674392315,202389,true,1624788599,28,1625763716,975117
1674392327,202389,true,1624788599,28,1625926292,1137693
1674392339,202389,true,1624788599,28,1625926292,1137693
1674392591,202387,true,1625113573,28,1626576760,1463187
1674392603,202391,true,1624463690,28,1626576760,2113070
1674392615,202391,true,1624463690,28,1626576760,2113070
1674392651,202391,true,1624463690,28,1626739418,2275728
1674394967,202389,true,1624788599,28,1632932477,8143878
1674395411,202392,true,1624301260,28,1632932477,8631217
1674396575,202391,true,1624463690,28,1632932477,8468787
1674397715,202391,true,1624463690,28,1632932477,8468787
1674397751,202389,true,1624788599,28,1633095770,8307171
1674398111,202392,true,1624301260,28,1633259080,8957820
1674398891,202391,true,1624463690,28,1633585748,9122058
1674399107,202390,true,1624626136,28,1633749107,9122971
1674399203,202387,true,1625113573,28,1633912482,8798909
1674399215,202390,true,1624626136,28,1633912482,9286346
1674399227,202388,true,1624951078,28,1633912482,8961404
1674399239,202387,true,1625113573,28,1633912482,8798909
1674399287,202384,true,1625601155,28,1634075873,8474718
1674399335,202387,true,1625113573,28,1634239280,9125707
1674399551,202386,true,1625276084,28,1635056564,9780480
1674399767,202385,true,1625438612,28,1635874255,10435643
1674399779,202382,true,1625926292,28,1635874255,9947963
1674399803,202384,true,1625601155,28,1635874255,10273100
1674399911,202383,true,1625763716,28,1636365067,10601351
1674400007,202381,true,1626088885,28,1636856025,10767140
1674400019,202378,true,1626576760,28,1636856025,10279265
1674400103,202381,true,1626088885,28,1637510866,11421981
1674400331,202379,true,1626414119,28,1638821333,12407214
1674400355,202378,true,1626576760,28,1638985215,12408455
1674400583,202375,true,1627064782,28,1640460892,13396110
1674400679,202377,true,1626739418,28,1640953080,14213662
1674400955,202375,true,1627064782,28,1643251908,16187126
1674400967,202374,true,1627227488,28,1643251908,16024420
1674400979,202371,true,1627715705,28,1643416233,15700528
1674401015,202374,true,1627227488,28,1643416233,16188745
1674401027,202374,true,1627227488,28,1643416233,16188745
1674401075,202373,true,1627390211,28,1643251908,15861697
1674401087,202371,true,1627715705,28,1643251908,15536203
1674401183,202373,true,1627390211,28,1642594771,15204560
1674401435,202373,true,1627390211,28,1641281287,13891076
1674401471,202373,true,1627390211,28,1641117175,13726964
1674401483,202370,true,1627878477,28,1641117175,13238698
1674401519,202372,true,1627552950,28,1640789001,13236051
1674401627,202371,true,1627715705,28,1640296863,12581158
1674401687,202371,true,1627715705,28,1639968852,12253147
1674401711,202368,true,1628204069,28,1639804872,11600803
1674401987,202369,true,1628041265,28,1638002168,9960903
1674402083,202369,true,1628041265,28,1637347131,9305866
1674402239,202368,true,1628204069,28,1636365067,8160998
1674402407,202365,true,1628692579,28,1635056564,6363985
1674402419,202365,true,1628692579,28,1635056564,6363985
1674402431,202364,true,1628855448,28,1634893074,6037626
1674402455,202364,true,1628855448,28,1634893074,6037626
1674402467,202360,true,1629507088,28,1634729601,5222513
1674402563,202360,true,1629507088,28,1634075873,4568785
1674402623,202359,true,1629670039,28,1633749107,4079068
1674402671,202359,true,1629670039,28,1633422406,3752367
1674403115,202355,true,1630322005,28,1633585748,3263743
1674403559,202355,true,1630322005,28,1634893074,4571069
1674403583,202354,true,1630485037,28,1635056564,4571527
1674404063,202354,true,1630485037,28,1636037843,5552806
1674404543,202351,true,1630974231,28,1635710684,4736453
1674404747,202351,true,1630974231,28,1635383591,4409360
1674404915,202350,true,1631137329,28,1635056564,3919235
1674405251,202350,true,1631137329,28,1634566145,3428816
1674405383,202347,true,1631626719,28,1634402704,2775985
1674405911,202347,true,1631626719,28,1633912482,2285763
1674405983,202347,true,1631626719,28,1633912482,2285763
1674406043,202347,true,1631626719,28,1633912482,2285763
1674406259,202344,true,1632116256,28,1634239280,2123024
1674407195,202343,true,1632279467,28,1635383591,3104124
1674407243,202343,true,1632279467,28,1635547130,3267663
1674407291,202343,true,1632279467,28,1635547130,3267663
1674407303,202341,true,1632605940,28,1635710684,3104744
1674407315,202340,true,1632769200,28,1635710684,2941484
1674407855,202339,true,1632932477,28,1637347131,4414654
1674408179,202339,true,1632932477,28,1638657468,5724991
1674408407,202336,true,1633422406,28,1639968852,6546446
1674408431,202336,true,1633422406,28,1640132849,6710443
1674408479,202334,true,1633749107,28,1640460892,6711785
1674408551,202334,true,1633749107,28,1640953080,7203973
1674408611,202331,true,1634239280,28,1641281287,7042007
1674408635,202330,true,1634402704,28,1641445415,7042711
1674408647,202329,true,1634566145,28,1641609559,7043414
1674408659,202328,true,1634729601,28,1641609559,6879958
1674408671,202326,true,1635056564,28,1641773720,6717156
1674408695,202324,true,1635383591,28,1642102092,6718501
1674409331,202322,true,1635710684,28,1649672782,13962098
1674410051,202321,true,1635874255,28,1656449985,20575730
1674411779,202318,true,1636365067,28,1658936400,22571333
1674412223,202317,true,1636528703,28,1658936400,22407697
1674412391,202315,true,1636856025,28,1658936400,22080375
1674412499,202314,true,1637019711,28,1658936400,21916689
1674412523,202311,true,1637510866,28,1658936400,21425534
1674412535,202310,true,1637674617,28,1658936400,21261783
1674412583,202308,true,1638002168,28,1658770523,20768355
1674412811,202308,true,1638002168,28,1658107181,20105013
1674412847,202306,true,1638329785,28,1657941387,19611602
1674413699,202304,true,1638657468,28,1654794446,16136978
1674413927,202303,true,1638821333,28,1653801917,14980584
1674414035,202303,true,1638821333,28,1653305875,14484542
1674414059,202300,true,1639313029,28,1653305875,13992846
1674414083,202299,true,1639476960,28,1653140561,13663601
1674414455,202298,true,1639640908,28,1651653478,12012570
1674414587,202298,true,1639640908,28,1651323197,11682289
1674414743,202295,true,1640132849,28,1650992982,10860133
1674414899,202294,true,1640296863,28,1650497783,10200920
1674416135,202293,true,1640460892,28,1647200251,6739359
1674416183,202293,true,1640460892,28,1647035548,6574656
1674416447,202291,true,1640789001,28,1646706190,5917189
1674416483,202290,true,1640953080,28,1646541536,5588456
1674417431,202289,true,1641117175,28,1646047672,4930497
1674417443,202289,true,1641117175,28,1646047672,4930497
1674417455,202287,true,1641445415,28,1646047672,4602257
1674417563,202286,true,1641609559,28,1645553957,3944398
1674417671,202287,true,1641445415,28,1645060389,3614974
1674417683,202287,true,1641445415,28,1644895899,3450484
1674417863,202286,true,1641609559,28,1643909307,2299748
1674417875,202286,true,1641609559,28,1643909307,2299748
1674417947,202286,true,1641609559,28,1643416233,1806674
1674417959,202287,true,1641445415,28,1643251908,1806493
1674417983,202286,true,1641609559,28,1643087599,1478040
1674417995,202286,true,1641609559,28,1642923307,1313748
1674418031,202288,true,1641281287,28,1642594771,1313484
1674419327,202289,true,1641117175,28,1628041265,-13075910
1674419843,202288,true,1641281287,28,1625113573,-16167714
1674419855,202288,true,1641281287,28,1625113573,-16167714
1674419867,202290,true,1640953080,28,1625113573,-15839507
1674419879,202291,true,1640789001,28,1625113573,-15675428
1674420023,202292,true,1640624938,28,1624788599,-15836339
1674420755,202292,true,1640624938,28,1622515600,-18109338
1674420791,202294,true,1640296863,28,1622353364,-17943499
1674420803,202295,true,1640132849,28,1622191145,-17941704
1674420815,202296,true,1639968852,28,1622191145,-17777707
1674420827,202297,true,1639804872,28,1622028942,-17775930
1674420851,202300,true,1639313029,28,1621866756,-17446273
1674420863,202302,true,1638985215,28,1621866756,-17118459
1674421367,202303,true,1638821333,28,1618302749,-20518584
1674421391,202304,true,1638657468,28,1618140935,-20516533
1674421991,202307,true,1638165969,28,1614423673,-23742296
1674422291,202309,true,1637838385,28,1612971418,-24866967
1674422627,202310,true,1637674617,28,1611520469,-26154148
1674422639,202311,true,1637510866,28,1611520469,-25990397
1674422663,202315,true,1636856025,28,1611520469,-25335556
1674422675,202317,true,1636528703,28,1611520469,-25008234
1674422699,202318,true,1636365067,28,1611520469,-24844598
1674422795,202318,true,1636365067,28,1611681621,-24683446
1674423071,202320,true,1636037843,28,1612003974,-24033869
1674423083,202321,true,1635874255,28,1612003974,-23870281
1674423095,202322,true,1635710684,28,1612165174,-23545510
1674423119,202322,true,1635710684,28,1612165174,-23545510
1674423167,202323,true,1635547130,28,1612326391,-23220739
1674423179,202324,true,1635383591,28,1612326391,-23057200
1674423323,202324,true,1635383591,28,1612971418,-22412173
1674423815,202324,true,1635383591,28,1615715664,-19667927
1674423851,202326,true,1635056564,28,1615877236,-19179328
1674423899,202326,true,1635056564,28,1616038823,-19017741
1674424175,202327,true,1634893074,28,1617817355,-17075719
1674424331,202326,true,1635056564,28,1618626426,-16430138
1674424355,202328,true,1634729601,28,1618788288,-15941313
1674424415,202329,true,1634566145,28,1619273973,-15292172
1674424427,202329,true,1634566145,28,1619273973,-15292172
1674424487,202328,true,1634729601,28,1619597844,-15131757
1674424547,202330,true,1634402704,28,1619921780,-14480924
1674424631,202331,true,1634239280,28,1620407805,-13831475
1674427079,202331,true,1634239280,28,1625276084,-8963196
1674428591,202330,true,1634402704,28,1625276084,-9126620
1674428603,202332,true,1634075873,28,1625438612,-8637261
1674428675,202333,true,1633912482,28,1625438612,-8473870
1674428783,202333,true,1633912482,28,1625438612,-8473870
1674429803,202333,true,1633912482,28,1626414119,-7498363
1674429971,202334,true,1633749107,28,1626576760,-7172347
1674430847,202335,true,1633585748,28,1626902092,-6683656
1674430871,202335,true,1633585748,28,1627064782,-6520966
1674432515,202334,true,1633749107,28,1627715705,-6033402
1674433151,202336,true,1633422406,28,1627878477,-5543929
1674433283,202336,true,1633422406,28,1627878477,-5543929
1674433295,202336,true,1633422406,28,1627878477,-5543929
1674433331,202335,true,1633585748,28,1627878477,-5707271
1674433367,202337,true,1633259080,28,1627878477,-5380603
1674433451,202337,true,1633259080,28,1628041265,-5217815
1674433559,202337,true,1633259080,28,1628041265,-5217815
1674433595,202337,true,1633259080,28,1628204069,-5055011
1674433907,202338,true,1633095770,28,1628692579,-4403191
1674433991,202339,true,1632932477,28,1628855448,-4077029
1674434171,202339,true,1632932477,28,1629181236,-3751241
1674434183,202338,true,1633095770,28,1629181236,-3914534
1674434279,202340,true,1632769200,28,1629507088,-3262112
1674434291,202341,true,1632605940,28,1629507088,-3098852
1674434375,202341,true,1632605940,28,1629670039,-2935901
1674434399,202340,true,1632769200,28,1629833006,-2936194
1674434423,202343,true,1632279467,28,1629833006,-2446461
1674434591,202344,true,1632116256,28,1630322005,-1794251
1674435011,202344,true,1632116256,28,1631626719,-489537
1674436151,202344,true,1632116256,28,1633749107,1632851
1674436175,202346,true,1631789882,28,1633749107,1959225
1674436187,202347,true,1631626719,28,1633749107,2122388
1674436211,202348,true,1631463573,28,1633749107,2285534
1674436511,202348,true,1631463573,28,1634402704,2939131
1674440339,202351,true,1630974231,28,1636856025,5881794
1674440783,202352,true,1630811150,28,1636856025,6044875
1674442667,202352,true,1630811150,28,1636856025,6044875
1674442907,202352,true,1630811150,28,1636856025,6044875
1674443699,202355,true,1630322005,28,1637347131,7025126
1674443939,202357,true,1629995989,28,1637510866,7514877
1674444863,202357,true,1629995989,28,1638165969,8169980
1674444875,202357,true,1629995989,28,1638165969,8169980
1674444899,202360,true,1629507088,28,1638165969,8658881
1674444995,202360,true,1629507088,28,1638002168,8495080
1674446927,202361,true,1629344154,28,1634566145,5221991
1674447287,202361,true,1629344154,28,1634566145,5221991
1674447623,202363,true,1629018334,28,1634566145,5547811
1674447899,202364,true,1628855448,28,1634566145,5710697
1674449015,202365,true,1628692579,28,1634566145,5873566
1674450371,202364,true,1628855448,28,1634402704,5547256
1674451727,202367,true,1628366889,28,1634402704,6035815
1674452783,202367,true,1628366889,28,1634402704,6035815
1674456191,202368,true,1628204069,28,1634402704,6198635
1674457043,202367,true,1628366889,28,1634402704,6035815
1674458315,202370,true,1627878477,28,1634402704,6524227
1674458495,202370,true,1627878477,28,1634402704,6524227
1674458627,202371,true,1627715705,28,1634402704,6686999
1674458771,202370,true,1627878477,28,1634402704,6524227
1674458783,202372,true,1627552950,28,1634402704,6849754
1674459635,202372,true,1627552950,28,1634075873,6522923
1674461687,202373,true,1627390211,28,1633422406,6032195
1674461903,202373,true,1627390211,28,1633422406,6032195
1674461915,202373,true,1627390211,28,1633585748,6195537
1674462551,202374,true,1627227488,28,1633749107,6521619
1674462563,202374,true,1627227488,28,1633749107,6521619
1674463583,202374,true,1627227488,28,1631137329,3909841
1674466103,202375,true,1627064782,28,1629018334,1953552
1674466151,202375,true,1627064782,28,1629181236,2116454
1674466403,202375,true,1627064782,28,1629181236,2116454
1674466451,202375,true,1627064782,28,1629181236,2116454
1674466523,202374,true,1627227488,28,1629181236,1953748
1674466655,202374,true,1627227488,28,1629181236,1953748
1674467891,202374,true,1627227488,28,1629995989,2768501
1674467951,202374,true,1627227488,28,1629995989,2768501
1674468227,202373,true,1627390211,28,1630158989,2768778
1674468251,202373,true,1627390211,28,1630158989,2768778
1674468719,202372,true,1627552950,28,1630322005,2769055
1674468731,202371,true,1627715705,28,1630322005,2606300
1674468743,202371,true,1627715705,28,1630485037,2769332
1674469379,202370,true,1627878477,28,1631626719,3748242
1674469463,202369,true,1628041265,28,1631789882,3748617
1674469475,202367,true,1628366889,28,1631953061,3586172
1674469763,202366,true,1628529726,28,1632605940,4076214
1674469811,202366,true,1628529726,28,1632769200,4239474
1674471467,202364,true,1628855448,28,1634729601,5874153
1674471515,202362,true,1629181236,28,1634893074,5711838
1674477083,202361,true,1629344154,28,1635383591,6039437
1674479351,202360,true,1629507088,28,1635383591,5876503
1674479531,202359,true,1629670039,28,1635383591,5713552
1674479543,202357,true,1629995989,28,1635383591,5387602
1674479711,202356,true,1630158989,28,1635220069,5061080
1674481691,202356,true,1630158989,28,1632605940,2446951
1674481895,202354,true,1630485037,28,1632442695,1957658
1674481907,202353,true,1630648085,28,1632279467,1631382
1674481919,202352,true,1630811150,28,1632279467,1468317
1674482735,202354,true,1630485037,28,1626739418,-3745619
1674483263,202353,true,1630648085,28,1623164703,-7483382
1674483347,202352,true,1630811150,28,1622515600,-8295550
1674483443,202351,true,1630974231,28,1621866756,-9107475
1674484355,202353,true,1630648085,28,1619921780,-10726305
1674485027,202353,true,1630648085,28,1619759804,-10888281
1674485207,202352,true,1630811150,28,1619759804,-11051346
1674485243,202351,true,1630974231,28,1619759804,-11214427
1674485255,202353,true,1630648085,28,1619759804,-10888281
1674485279,202353,true,1630648085,28,1619759804,-10888281
1674485291,202352,true,1630811150,28,1619759804,-11051346
1674485303,202351,true,1630974231,28,1619759804,-11214427
1674485339,202353,true,1630648085,28,1619921780,-10726305
1674485351,202353,true,1630648085,28,1619921780,-10726305
1674485363,202352,true,1630811150,28,1619921780,-10889370
1674485375,202351,true,1630974231,28,1620083772,-10890459
1674485387,202353,true,1630648085,28,1620083772,-10564313
1674485411,202352,true,1630811150,28,1620245781,-10565369
1674485423,202351,true,1630974231,28,1620245781,-10728450
1674485459,202350,true,1631137329,28,1620569846,-10567483
1674485471,202351,true,1630974231,28,1620731903,-10242328
1674485483,202350,true,1631137329,28,1620731903,-10405426
1674485495,202349,true,1631300442,28,1620893976,-10406466
1674485531,202347,true,1631626719,28,1621380293,-10246426
1674485879,202347,true,1631626719,28,1625926292,-5700427
1674485891,202347,true,1631626719,28,1626088885,-5537834
1674485903,202345,true,1631953061,28,1626251493,-5701568
1674485939,202343,true,1632279467,28,1626414119,-5865348
1674485951,202346,true,1631789882,28,1626414119,-5375763
1674485963,202346,true,1631789882,28,1626414119,-5375763
1674485975,202346,true,1631789882,28,1626414119,-5375763
1674486035,202348,true,1631463573,28,1625763716,-5699857
1674486047,202352,true,1630811150,28,1625601155,-5209995
1674486071,202353,true,1630648085,28,1625438612,-5209473
1674486107,202353,true,1630648085,28,1625113573,-5534512
1674486119,202354,true,1630485037,28,1624951078,-5533959
1674486167,202358,true,1629833006,28,1624626136,-5206870
1674486179,202358,true,1629833006,28,1624463690,-5369316
1674486191,202358,true,1629833006,28,1624463690,-5369316
1674486203,202360,true,1629507088,28,1624301260,-5205828
1674486215,202363,true,1629018334,28,1624301260,-4717074
1674486779,202363,true,1629018334,28,1621380293,-7638041
1674486827,202363,true,1629018334,28,1621218171,-7800163
1674486839,202365,true,1628692579,28,1621218171,-7474408
1674486851,202368,true,1628204069,28,1621056066,-7148003
1674486863,202368,true,1628204069,28,1621056066,-7148003
1674486947,202367,true,1628366889,28,1620731903,-7634986
1674486983,202369,true,1628041265,28,1620569846,-7471419
1674486995,202372,true,1627552950,28,1620569846,-6983104
1674487043,202372,true,1627552950,28,1620407805,-7145145
1674487499,202372,true,1627552950,28,1615554109,-11998841
1674487511,202374,true,1627227488,28,1615231046,-11996442
1674487523,202377,true,1626739418,28,1615069539,-11669879
1674487763,202377,true,1626739418,28,1612326391,-14413027
1674487883,202376,true,1626902092,28,1613455358,-13446734
1674487895,202378,true,1626576760,28,1613616703,-12960057
1674488387,202381,true,1626088885,28,1616685336,-9403549
1674488903,202381,true,1626088885,28,1619112062,-6976823
1674488963,202380,true,1626251493,28,1619273973,-6977520
1674489107,202382,true,1625926292,28,1619921780,-6004512
1674491183,202384,true,1625601155,28,1622191145,-3410010
1674491243,202383,true,1625763716,28,1622191145,-3572571
1674491375,202383,true,1625763716,28,1622028942,-3734774
1674491447,202385,true,1625438612,28,1621866756,-3571856
1674492035,202388,true,1624951078,28,1620245781,-4705297
1674492083,202387,true,1625113573,28,1620245781,-4867792
1674493895,202386,true,1625276084,28,1617493840,-7782244
1674494567,202388,true,1624951078,28,1617655590,-7295488
1674495527,202392,true,1624301260,28,1617655590,-6645670
1674496403,202391,true,1624463690,28,1617493840,-6969850
1674496415,202390,true,1624626136,28,1617655590,-6970546
1674496439,202392,true,1624301260,28,1617655590,-6645670
1674496499,202395,true,1623814067,28,1617655590,-6158477
1674496691,202394,true,1623976448,28,1617979137,-5997311
1674496739,202393,true,1624138846,28,1618140935,-5997911
1674496751,202395,true,1623814067,28,1618140935,-5673132
1674496763,202398,true,1623327020,28,1618140935,-5186085
1674496787,202396,true,1623651701,28,1618302749,-5348952
1674496835,202395,true,1623814067,28,1618464579,-5349488
1674496871,202397,true,1623489353,28,1618626426,-4862927
1674496991,202400,true,1623002403,28,1619112062,-3890341
1674497003,202398,true,1623327020,28,1619112062,-4214958
1674497171,202396,true,1623651701,28,1619921780,-3729921
1674497195,202398,true,1623327020,28,1620083772,-3243248
1674497219,202401,true,1622840119,28,1620245781,-2594338
1674497363,202399,true,1623164703,28,1621056066,-2108637
1674498071,202397,true,1623489353,28,1625113573,1624220
1674498143,202398,true,1623327020,28,1625601155,2274135
1674498155,202401,true,1622840119,28,1625763716,2923597
1674498383,202399,true,1623164703,28,1627064782,3900079
1674498743,202397,true,1623489353,28,1628529726,5040373
1674498803,202398,true,1623327020,28,1628692579,5365559
1674498815,202401,true,1622840119,28,1628692579,5852460
1674498887,202399,true,1623164703,28,1629018334,5853631
1674498911,202397,true,1623489353,28,1629018334,5528981
1674498923,202398,true,1623327020,28,1629018334,5691314
1674498935,202401,true,1622840119,28,1629181236,6341117
1674498971,202399,true,1623164703,28,1629344154,6179451
1674498995,202396,true,1623651701,28,1629344154,5692453
1674499007,202398,true,1623327020,28,1629507088,6180068
1674499199,202401,true,1622840119,28,1630322005,7481886
1674499247,202399,true,1623164703,28,1630485037,7320334
1674499403,202396,true,1623651701,28,1631300442,7648741
1674500375,202398,true,1623327020,28,1635056564,11729544
1674500483,202401,true,1622840119,28,1635220069,12379950
1674500507,202399,true,1623164703,28,1635220069,12055366
1674500543,202396,true,1623651701,28,1635220069,11568368
1674502655,202400,true,1623002403,28,1625763716,2761313
1674502679,202402,true,1622677851,28,1625763716,3085865
1674502691,202400,true,1623002403,28,1625763716,2761313
1674502871,202398,true,1623327020,28,1625438612,2111592
1674502907,202402,true,1622677851,28,1625276084,2598233
1674502943,202402,true,1622677851,28,1625113573,2435722
1674502955,202400,true,1623002403,28,1625113573,2111170
1674503183,202398,true,1623327020,28,1624301260,974240
1674503195,202402,true,1622677851,28,1624301260,1623409
1674503231,202403,true,1622515600,28,1623976448,1460848
1674503255,202400,true,1623002403,28,1623976448,974045
1674503279,202398,true,1623327020,28,1623814067,487047
1674503291,202403,true,1622515600,28,1623814067,1298467
1674503435,202403,true,1622515600,28,1622840119,324519
1674503459,202401,true,1622840119,28,1622840119,0
1674504551,202399,true,1623164703,28,1617332107,-5832596
1674504719,202404,true,1622353364,28,1617170390,-5182974
1674504791,202405,true,1622191145,28,1617170390,-5020755
1674504815,202403,true,1622515600,28,1617170390,-5345210
1674505055,202400,true,1623002403,28,1617332107,-5670296
1674505067,202405,true,1622191145,28,1617332107,-4859038
1674505139,202406,true,1622028942,28,1617493840,-4535102
1674505283,202405,true,1622191145,28,1617979137,-4212008
1674506207,202402,true,1622677851,28,1621056066,-1621785
1674506603,202407,true,1621866756,28,1621866756,0
1674506663,202409,true,1621542431,28,1621866756,324325
1674506687,202407,true,1621866756,28,1622028942,162186
1674506711,202405,true,1622191145,28,1622028942,-162203
1674507155,202411,true,1621218171,28,1622515600,1297429
1674507227,202413,true,1620893976,28,1622515600,1621624
1674507251,202412,true,1621056066,28,1622515600,1459534
1674507335,202410,true,1621380293,28,1622677851,1297558
1674507371,202415,true,1620569846,28,1622677851,2108005
1674507395,202415,true,1620569846,28,1622677851,2108005
1674507419,202413,true,1620893976,28,1622677851,1783875
1674507431,202410,true,1621380293,28,1622840119,1459826
1674507527,202411,true,1621218171,28,1623002403,1784232
1674507563,202410,true,1621380293,28,1623164703,1784410
1674507587,202407,true,1621866756,28,1623164703,1297947
1674507599,202404,true,1622353364,28,1623327020,973656
1674507623,202405,true,1622191145,28,1623327020,1135875
1674508859,202404,true,1622353364,28,1629018334,6664970
1674510059,202401,true,1622840119,28,1630648085,7807966
1674512279,202398,true,1623327020,28,1630648085,7321065
1674514427,202400,true,1623002403,28,1630648085,7645682
1674517835,202399,true,1623164703,28,1628855448,5690745
1674517943,202397,true,1623489353,28,1628855448,5366095
1674518843,202394,true,1623976448,28,1628855448,4879000
1674518855,202396,true,1623651701,28,1628855448,5203747
1674520391,202395,true,1623814067,28,1628041265,4227198
1674520403,202393,true,1624138846,28,1628041265,3902419
1674520451,202391,true,1624463690,28,1628041265,3577575
1674522323,202392,true,1624301260,28,1629344154,5042894
1674522347,202392,true,1624301260,28,1629507088,5205828
1674523211,202390,true,1624626136,28,1629507088,4880952
1674525095,202388,true,1624951078,28,1629670039,4718961
1674525143,202389,true,1624788599,28,1629833006,5044407
1674525227,202389,true,1624788599,28,1629833006,5044407
1674525239,202387,true,1625113573,28,1629833006,4719433
1674525587,202385,true,1625438612,28,1630485037,5046425
1674525635,202386,true,1625276084,28,1630485037,5208953
1674525743,202386,true,1625276084,28,1630811150,5535066
1674526043,202384,true,1625601155,28,1631789882,6188727
1674526655,202382,true,1625926292,28,1633585748,7659456
1674526811,202383,true,1625763716,28,1634075873,8312157
1674526835,202383,true,1625763716,28,1634239280,8475564
1674526955,202381,true,1626088885,28,1634566145,8477260
1674528083,202378,true,1626576760,28,1637183413,10606653
1674528851,202379,true,1626414119,28,1638165969,11751850
1674532871,202378,true,1626576760,28,1638165969,11589209
1674533111,202377,true,1626739418,28,1638165969,11426551
1674533219,202374,true,1627227488,28,1638165969,10938481
1674536855,202375,true,1627064782,28,1638165969,11101187
1674537287,202374,true,1627227488,28,1638165969,10938481
1674537959,202372,true,1627552950,28,1638165969,10613019
1674538907,202369,true,1628041265,28,1637838385,9797120
1674540191,202370,true,1627878477,28,1637510866,9632389
1674540383,202370,true,1627878477,28,1637510866,9632389
1674540563,202368,true,1628204069,28,1637510866,9306797
1674541151,202365,true,1628692579,28,1637510866,8818287
1674542087,202367,true,1628366889,28,1637510866,9143977
1674544391,202366,true,1628529726,28,1637510866,8981140
1674545471,202365,true,1628692579,28,1637510866,8818287
1674546755,202362,true,1629181236,28,1637510866,8329630
1674547355,202364,true,1628855448,28,1637510866,8655418
1674547403,202363,true,1629018334,28,1637510866,8492532
1674547907,202362,true,1629181236,28,1637510866,8329630
1674548699,202360,true,1629507088,28,1637510866,8003778
1674548795,202361,true,1629344154,28,1637510866,8166712
1674551039,202361,true,1629344154,28,1637510866,8166712
1674551063,202360,true,1629507088,28,1637510866,8003778
1674551075,202358,true,1629833006,28,1637510866,7677860
1674552095,202360,true,1629507088,28,1631626719,2119631
1674552683,202361,true,1629344154,28,1628204069,-1140085
1674552911,202360,true,1629507088,28,1627064782,-2442306
1674552959,202358,true,1629833006,28,1627064782,-2768224
1674552983,202361,true,1629344154,28,1627064782,-2279372
1674553031,202362,true,1629181236,28,1627064782,-2116454
1674553043,202361,true,1629344154,28,1627064782,-2279372
1674553055,202360,true,1629507088,28,1627064782,-2442306
1674553067,202362,true,1629181236,28,1626902092,-2279144
1674553079,202364,true,1628855448,28,1626902092,-1953356
1674554735,202364,true,1628855448,28,1620731903,-8123545
1674555599,202363,true,1629018334,28,1620245781,-8772553
1674556415,202365,true,1628692579,28,1620245781,-8446798
1674557387,202367,true,1628366889,28,1621866756,-6500133
1674557399,202367,true,1628366889,28,1621866756,-6500133
1674557927,202366,true,1628529726,28,1622840119,-5689607
1674559919,202368,true,1628204069,28,1623164703,-5039366
1674563291,202370,true,1627878477,28,1623164703,-4713774
1674563351,202370,true,1627878477,28,1623327020,-4551457
1674563375,202369,true,1628041265,28,1623327020,-4714245
1674563387,202369,true,1628041265,28,1623327020,-4714245
1674563399,202370,true,1627878477,28,1623327020,-4551457
1674563411,202370,true,1627878477,28,1623327020,-4551457
1674563615,202369,true,1628041265,28,1623651701,-4389564
1674563627,202368,true,1628204069,28,1623651701,-4552368
1674563759,202369,true,1628041265,28,1623976448,-4064817
1674564035,202369,true,1628041265,28,1624463690,-3577575
1674564659,202367,true,1628366889,28,1625926292,-2440597
1674565799,202366,true,1628529726,28,1627064782,-1464944
1674566111,202367,true,1628366889,28,1627064782,-1302107
1674567443,202367,true,1628366889,28,1627064782,-1302107
1674567563,202365,true,1628692579,28,1627064782,-1627797
1674567575,202364,true,1628855448,28,1627064782,-1790666
1674567671,202365,true,1628692579,28,1626902092,-1790487
1674567695,202365,true,1628692579,28,1626739418,-1953161
1674567707,202363,true,1629018334,28,1626739418,-2278916
1674567743,202363,true,1629018334,28,1626576760,-2441574
1674568907,202364,true,1628855448,28,1621380293,-7475155
1674568919,202365,true,1628692579,28,1621380293,-7312286
1674570359,202363,true,1629018334,28,1618140935,-10877399
1674570671,202363,true,1629018334,28,1617817355,-11200979
1674570695,202365,true,1628692579,28,1617655590,-11036989
1674570791,202366,true,1628529726,28,1617332107,-11197619
1674570815,202365,true,1628692579,28,1617170390,-11522189
1674571643,202366,true,1628529726,28,1614262247,-14267479
1674571955,202367,true,1628366889,28,1613294028,-15072861
1674571991,202368,true,1628204069,28,1613132715,-15071354
1674572003,202367,true,1628366889,28,1613132715,-15234174
1674572015,202368,true,1628204069,28,1613132715,-15071354
1674572087,202369,true,1628041265,28,1612971418,-15069847
1674572327,202369,true,1628041265,28,1612971418,-15069847
1674572735,202369,true,1628041265,28,1613616703,-14424562
1674572747,202369,true,1628041265,28,1613616703,-14424562
1674573347,202371,true,1627715705,28,1614262247,-13453458
1674573911,202372,true,1627552950,28,1614908049,-12644901
1674574331,202371,true,1627715705,28,1614423673,-13292032
1674575255,202372,true,1627552950,28,1614746574,-12806376
1674575291,202374,true,1627227488,28,1614746574,-12480914
1674575699,202374,true,1627227488,28,1614908049,-12319439
1674575723,202374,true,1627227488,28,1614908049,-12319439
1674576911,202375,true,1627064782,28,1616200427,-10864355
1674576935,202377,true,1626739418,28,1616200427,-10538991
1674577727,202377,true,1626739418,28,1616523683,-10215735
1674579707,202377,true,1626739418,28,1616847004,-9892414
1674579731,202378,true,1626576760,28,1616847004,-9729756
1674579755,202380,true,1626251493,28,1616847004,-9404489
1674579803,202380,true,1626251493,28,1616847004,-9404489
1674579923,202380,true,1626251493,28,1616685336,-9566157
1674579995,202381,true,1626088885,28,1616523683,-9565202
1674581123,202384,true,1625601155,28,1613132715,-12468440
1674581543,202384,true,1625601155,28,1612003974,-13597181
1674582143,202384,true,1625601155,28,1612003974,-13597181
1674583319,202385,true,1625438612,28,1612487623,-12950989
1674583499,202387,true,1625113573,28,1612648872,-12464701
1674583967,202388,true,1624951078,28,1612810137,-12140941
1674584015,202387,true,1625113573,28,1612810137,-12303436
1674584027,202389,true,1624788599,28,1612810137,-11978462
1674584039,202391,true,1624463690,28,1612810137,-11653553
1674584063,202391,true,1624463690,28,1612810137,-11653553
1674584291,202391,true,1624463690,28,1613294028,-11169662
1674584303,202392,true,1624301260,28,1613294028,-11007232
1674584423,202395,true,1623814067,28,1613778065,-10036002
1674584555,202395,true,1623814067,28,1614262247,-9551820
1674584819,202395,true,1623814067,28,1615069539,-8744528
1674585167,202396,true,1623651701,28,1616362047,-7289654
1674585407,202398,true,1623327020,28,1617170390,-6156630
1674588287,202398,true,1623327020,28,1618950167,-4376853
1674589415,202399,true,1623164703,28,1618950167,-4214536
1674590651,202400,true,1623002403,28,1619273973,-3728430
1674592775,202402,true,1622677851,28,1619759804,-2918047
1674592787,202402,true,1622677851,28,1619759804,-2918047
1674592799,202403,true,1622515600,28,1619759804,-2755796
1674592823,202404,true,1622353364,28,1619759804,-2593560
1674592907,202407,true,1621866756,28,1619597844,-2268912
1674592979,202407,true,1621866756,28,1619597844,-2268912
1674593015,202407,true,1621866756,28,1619435901,-2430855
1674593027,202409,true,1621542431,28,1619435901,-2106530
1674593123,202412,true,1621056066,28,1619112062,-1944004
1674594107,202412,true,1621056066,28,1615554109,-5501957
1674594167,202413,true,1620893976,28,1615392569,-5501407
1674594179,202414,true,1620731903,28,1615392569,-5339334
1674594599,202417,true,1620245781,28,1614585115,-5660666
1674595979,202417,true,1620245781,28,1616200427,-4045354
1674596579,202417,true,1620245781,28,1616200427,-4045354
1674596687,202419,true,1619921780,28,1616200427,-3721353
1674596903,202422,true,1619435901,28,1616200427,-3235474
1674596915,202422,true,1619435901,28,1616200427,-3235474
1674597203,202422,true,1619435901,28,1615877236,-3558665
1674597215,202424,true,1619112062,28,1615877236,-3234826
1674597239,202427,true,1618626426,28,1615715664,-2910762
1674597251,202427,true,1618626426,28,1615715664,-2910762
1674597263,202429,true,1618302749,28,1615554109,-2748640
1674597275,202430,true,1618140935,28,1615554109,-2586826
1674598367,202433,true,1617655590,28,1604124868,-13530722
1674598427,202434,true,1617493840,28,1603483378,-14010462
1674598619,202435,true,1617332107,28,1601240184,-16091923
1674599183,202437,true,1617008689,28,1596443901,-20564788
1674599207,202440,true,1616523683,28,1596443901,-20079782
1674599219,202440,true,1616523683,28,1596443901,-20079782
1674599267,202442,true,1616200427,28,1595805484,-20394943
1674599279,202446,true,1615554109,28,1595645919,-19908190
1674599303,202451,true,1614746574,28,1595326838,-19419736
1674599327,202451,true,1614746574,28,1594848335,-19898239
1674599339,202455,true,1614100837,28,1594529413,-19571424
1674599351,202459,true,1613455358,28,1594210555,-19244803
1674599363,202466,true,1612326391,28,1593891761,-18434630
1674599375,202468,true,1612003974,28,1593573031,-18430943
1674599399,202471,true,1611520469,28,1592776483,-18743986
1674599423,202477,true,1610553895,28,1592139532,-18414363
1674599435,202483,true,1609587901,28,1591821152,-17766749
1674599459,202485,true,1609266032,28,1591184582,-18081450
1674599495,202488,true,1608783348,28,1590230206,-18553142
1674599543,202493,true,1607979198,28,1588958594,-19020604
1674599555,202499,true,1607014748,28,1588799714,-18215034
1674599567,202501,true,1606693393,28,1588482001,-18211392
1674599591,202504,true,1606211482,28,1587846767,-18364715
1674599627,202508,true,1605569158,28,1587211787,-18357371
1674599651,202514,true,1604606153,28,1586577061,-18029092
1674599855,202515,true,1604445709,28,1582615771,-21829938
1674600155,202519,true,1603804091,28,1576613542,-27190549
1674600167,202523,true,1603162730,28,1576455897,-26706833
1674600251,202529,true,1602201169,28,1574880307,-27320862
1674600671,202530,true,1602040964,28,1567652855,-34388109
1674600899,202533,true,1601560448,28,1563895187,-37665261
1674601067,202537,true,1600919984,28,1561551220,-39368764
1674601175,202543,true,1599959768,28,1561863546,-38096222
1674601247,202543,true,1599959768,28,1562488385,-37471383
1674601667,202546,true,1599479876,28,1563738813,-35741063
1674601799,202550,true,1598840244,28,1563895187,-34945057
1674601811,202555,true,1598041064,28,1563895187,-34145877
1674602255,202556,true,1597881276,28,1563738813,-34142463
1674602267,202559,true,1597402007,28,1563738813,-33663194
1674602315,202562,true,1596922883,28,1563582455,-33340428
1674602327,202568,true,1595965064,28,1563582455,-32382609
1674602339,202569,true,1595805484,28,1563582455,-32223029
1674602351,202571,true,1595486370,28,1563426112,-32060258
1674602363,202575,true,1594848335,28,1563426112,-31422223
1674602399,202580,true,1594051150,28,1563269786,-30781364
1674602411,202582,true,1593732388,28,1563113474,-30618914
1674602435,202584,true,1593413689,28,1563113474,-30300215
1674602459,202588,true,1592776483,28,1562800898,-29975585
1674602507,202594,true,1591821152,28,1562488385,-29332767
1674602819,202596,true,1591502835,28,1560146526,-31356309
1674603035,202599,true,1591025480,28,1558431394,-32594086
1674603071,202603,true,1590389229,28,1558275567,-32113662
1674603923,202609,true,1589435329,28,1552986691,-36448638
1674603983,202610,true,1589276401,28,1552676140,-36600261
1674604007,202613,true,1588799714,28,1552520888,-36278826
1674604079,202617,true,1588164353,28,1552210430,-35953923
1674604379,202623,true,1587211787,28,1551589701,-35622086
1674604511,202625,true,1586894393,28,1551589701,-35304692
1674604523,202628,true,1586418420,28,1551589701,-34828719
1674604535,202632,true,1585784011,28,1551589701,-34194310
1674604571,202638,true,1584832873,28,1551589701,-33243172
1674604631,202640,true,1584515954,28,1551589701,-32926253
1674604907,202642,true,1584199099,28,1551744860,-32454239
1674604991,202646,true,1583565577,28,1551744860,-31820717
1674605003,202653,true,1582457525,28,1551744860,-30712665
1674605771,202654,true,1582299295,28,1552520888,-29778407
1674605951,202656,true,1581982882,28,1552676140,-29306742
1674605987,202660,true,1581350247,28,1552831407,-28518840
1674606035,202666,true,1580401769,28,1552831407,-27570362
1674606071,202667,true,1580243745,28,1552831407,-27412338
1674606083,202670,true,1579769767,28,1552831407,-26938360
1674606107,202674,true,1579138017,28,1552831407,-26306610
1674606131,202680,true,1578190865,28,1552831407,-25359458
1674606179,202682,true,1577875275,28,1552831407,-25043868
1674606719,202684,true,1577559747,28,1551589701,-25970046
1674607055,202688,true,1576928881,28,1550504023,-26424858
1674607115,202694,true,1575983054,28,1550193968,-25789086
1674607139,202697,true,1575510354,28,1550193968,-25316386
1674607151,202700,true,1575037795,28,1550038965,-24998830
1674607175,202704,true,1574407938,28,1550038965,-24368973
1674607223,202710,true,1573463624,28,1549883976,-23579648
1674608603,202712,true,1573148978,28,1550348988,-22799990
1674608615,202715,true,1572677128,28,1550348988,-22328140
1674608675,202719,true,1572048214,28,1550348988,-21699226
1674608807,202725,true,1571105315,28,1550504023,-20601292
1674608903,202728,true,1570634078,28,1550504023,-20130055
1674608915,202731,true,1570162982,28,1550504023,-19658959
1674609203,202735,true,1569535074,28,1549729003,-19806071
1674609215,202741,true,1568593682,28,1549729003,-18864679
1674609695,202745,true,1567966401,28,1547096833,-20869568
1674609719,202748,true,1567496106,28,1546942139,-20553967
1674609767,202753,true,1566712593,28,1546632797,-20079796
1674609887,202759,true,1565772894,28,1545705142,-20067752
1674609935,202763,true,1565146741,28,1545241523,-19905218
1674609959,202766,true,1564677291,28,1545087015,-19590276
1674609971,202772,true,1563738813,28,1544932522,-18806291
1674610031,202778,true,1562800898,28,1544005886,-18795012
1674610055,202782,true,1562175934,28,1543697131,-18478803
1674610127,202786,true,1561551220,28,1542771237,-18779983
1674610163,202791,true,1560770679,28,1542308498,-18462181
1674610283,202798,true,1559678576,28,1540612977,-19065599
1674610319,202803,true,1558898971,28,1540150885,-18748086
1674610331,202806,true,1558431394,28,1539996885,-18434509
1674610343,202811,true,1557652412,28,1539842901,-17809511
1674610571,202818,true,1556562492,28,1537381245,-19181247
1674610643,202822,true,1555940022,28,1536612785,-19327237
1674610751,202826,true,1555317802,28,1535537587,-19780215
1674610775,202831,true,1554540376,28,1535384048,-19156328
1674610955,202837,true,1553607978,28,1533849508,-19758470
1674611111,202841,true,1552986691,28,1532929521,-20057170
1674611219,202843,true,1552676140,28,1532316502,-20359638
1674611375,202847,true,1552055225,28,1532010085,-20045140
1674611627,202851,true,1551434558,28,1531856899,-19577659
1674613067,202855,true,1550814139,28,1538150090,-12664049
1674614375,202857,true,1550504023,28,1537996290,-12507733
1674614567,202861,true,1549883976,28,1538150090,-11733886
1674614915,202864,true,1549419104,28,1538150090,-11269014
1674615527,202868,true,1548799491,28,1538303905,-10495586
1674616283,202869,true,1548644627,28,1538457735,-10186892
1674616655,202871,true,1548334944,28,1538611581,-9723363
1674616691,202872,true,1548180126,28,1538611581,-9568545
1674616703,202875,true,1547715765,28,1538611581,-9104184
1674616739,202875,true,1547715765,28,1538611581,-9104184
1674616763,202876,true,1547561009,28,1538611581,-8949428
1674616799,202876,true,1547561009,28,1538611581,-8949428
1674616811,202877,true,1547406268,28,1538765442,-8640826
1674617231,202877,true,1547406268,28,1539688932,-7717336
1674617699,202876,true,1547561009,28,1540612977,-6948032
1674618371,202877,true,1547406268,28,1542154283,-5251985
1674619499,202878,true,1547251543,28,1542462729,-4788814
1674619667,202878,true,1547251543,28,1542616976,-4634567
1674619823,202879,true,1547096833,28,1542616976,-4479857
1674619907,202879,true,1547096833,28,1542616976,-4479857
1674620831,202881,true,1546787461,28,1543542777,-3244684
1674620963,202881,true,1546787461,28,1543697131,-3090330
1674621023,202882,true,1546632797,28,1543697131,-2935666
1674621443,202882,true,1546632797,28,1544160287,-2472510
1674623615,202884,true,1546323517,28,1544778044,-1545473
1674624071,202885,true,1546168900,28,1544778044,-1390856
1674624443,202886,true,1546014299,28,1544778044,-1236255
1674624527,202886,true,1546014299,28,1544778044,-1236255
1674624575,202889,true,1545550587,28,1544932522,-618065
1674624611,202889,true,1545550587,28,1544932522,-618065
1674624671,202890,true,1545396048,28,1544932522,-463526
1674628187,202890,true,1545396048,28,1546168900,772852
1674628247,202893,true,1544932522,28,1546323517,1390995
1674628271,202893,true,1544932522,28,1546323517,1390995
1674628319,202894,true,1544778044,28,1546323517,1545473
1674628379,202894,true,1544778044,28,1546323517,1545473
1674628463,202896,true,1544469134,28,1546323517,1854383
1674628667,202897,true,1544314703,28,1546632797,2318094
1674628727,202897,true,1544314703,28,1546632797,2318094
1674628763,202898,true,1544160287,28,1546787461,2627174
1674628931,202899,true,1544005886,28,1547096833,3090947
1674629159,202898,true,1544160287,28,1547870537,3710250
1674629603,202898,true,1544160287,28,1549264177,5103890
1674629687,202898,true,1544160287,28,1549574046,5413759
1674630383,202899,true,1544005886,28,1551744860,7738974
1674630515,202899,true,1544005886,28,1552055225,8049339
1674630575,202899,true,1544005886,28,1552210430,8204544
1674630635,202898,true,1544160287,28,1552210430,8050143
1674630695,202899,true,1544005886,28,1552365651,8359765
1674630767,202898,true,1544160287,28,1552520888,8360601
1674631655,202898,true,1544160287,28,1553918716,9758429
1674632555,202898,true,1544160287,28,1554851300,10691013
1674634343,202898,true,1544160287,28,1554851300,10691013
1674637427,202898,true,1544160287,28,1554851300,10691013
1674637463,202897,true,1544314703,28,1554851300,10536597
1674637607,202897,true,1544314703,28,1554851300,10536597
1674637679,202897,true,1544314703,28,1554851300,10536597
1674637751,202897,true,1544314703,28,1554851300,10536597
1674637787,202896,true,1544469134,28,1554851300,10382166
1674637979,202896,true,1544469134,28,1554695830,10226696
1674638015,202897,true,1544314703,28,1554695830,10381127
1674638291,202896,true,1544469134,28,1554229515,9760381
1674638315,202896,true,1544469134,28,1554074107,9604973
1674638327,202896,true,1544469134,28,1554074107,9604973
1674638351,202897,true,1544314703,28,1554074107,9759404
1674638423,202898,true,1544160287,28,1553763339,9603052
1674638771,202898,true,1544160287,28,1552055225,7894938
1674638843,202897,true,1544314703,28,1551744860,7430157
1674639383,202899,true,1544005886,28,1549264177,5258291
1674639695,202899,true,1544005886,28,1548025324,4019438
1674641507,202899,true,1544005886,28,1547406268,3400382
1674641879,202898,true,1544160287,28,1547406268,3245981
1674641891,202899,true,1544005886,28,1547406268,3400382
1674641927,202899,true,1544005886,28,1547406268,3400382
1674641951,202899,true,1544005886,28,1547406268,3400382
1674645395,202899,true,1544005886,28,1545396048,1390162
1674645587,202899,true,1544005886,28,1545396048,1390162
1674646091,202900,true,1543851501,28,1545396048,1544547
1674648431,202900,true,1543851501,28,1545396048,1544547
1674648455,202900,true,1543851501,28,1545550587,1699086
1674648467,202901,true,1543697131,28,1545550587,1853456
1674648623,202901,true,1543697131,28,1545705142,2008011
1674648731,202900,true,1543851501,28,1545705142,1853641
1674648755,202900,true,1543851501,28,1545859713,2008212
1674648779,202901,true,1543697131,28,1545859713,2162582
1674648911,202901,true,1543697131,28,1546168900,2471769
1674650207,202900,true,1543851501,28,1549419104,5567603
1674650231,202900,true,1543851501,28,1549419104,5567603
1674650243,202899,true,1544005886,28,1549419104,5413218
1674650411,202899,true,1544005886,28,1550038965,6033079
1674650423,202897,true,1544314703,28,1550038965,5724262
1674650435,202897,true,1544314703,28,1550038965,5724262
1674650447,202896,true,1544469134,28,1550193968,5724834
1674650543,202894,true,1544778044,28,1550659073,5881029
1674650567,202892,true,1545087015,28,1550814139,5727124
1674650891,202890,true,1545396048,28,1552365651,6969603
1674650963,202889,true,1545550587,28,1552676140,7125553
1674651767,202887,true,1545859713,28,1556406851,10547138
1674651779,202885,true,1546168900,28,1556406851,10237951
1674651791,202883,true,1546478149,28,1556562492,10084343
1674651827,202882,true,1546632797,28,1556718148,10085351
1674652163,202879,true,1547096833,28,1558587238,11490405
1674653339,202877,true,1547406268,28,1561238957,13832689
1674653591,202875,true,1547715765,28,1561707375,13991610
1674653843,202874,true,1547870537,28,1561707375,13836838
1674654131,202872,true,1548180126,28,1561707375,13527249
1674654479,202869,true,1548644627,28,1561707375,13062748
1674654623,202868,true,1548799491,28,1561707375,12907884
1674654635,202867,true,1548954371,28,1561707375,12753004
1674654671,202865,true,1549264177,28,1561707375,12443198
1674654707,202863,true,1549574046,28,1561707375,12133329
1674654779,202863,true,1549574046,28,1561551220,11977174
1674654995,202862,true,1549729003,28,1561238957,11509954
1674655499,202860,true,1550038965,28,1560302541,10263576
1674655511,202858,true,1550348988,28,1560302541,9953553
1674655523,202858,true,1550348988,28,1560302541,9953553
1674655583,202857,true,1550504023,28,1560146526,9642503
1674656747,202856,true,1550659073,28,1556562492,5903419
1674656807,202854,true,1550969220,28,1556406851,5437631
1674656855,202854,true,1550969220,28,1556251226,5282006
1674656987,202853,true,1551124317,28,1555940022,4815705
1674656999,202853,true,1551124317,28,1555784444,4660127
1674657023,202851,true,1551434558,28,1555784444,4349886
1674657047,202851,true,1551434558,28,1555628881,4194323
1674657071,202851,true,1551434558,28,1555473334,4038776
1674657155,202851,true,1551434558,28,1555162286,3727728
1674657179,202850,true,1551589701,28,1555006785,3417084
1674657215,202850,true,1551589701,28,1554695830,3106129
1674657347,202850,true,1551589701,28,1553918716,2329015
1674657359,202850,true,1551589701,28,1553763339,2173638
1674658043,202849,true,1551744860,28,1549264177,-2480683
1674658223,202849,true,1551744860,28,1548180126,-3564734
1674658283,202850,true,1551589701,28,1547870537,-3719164
1674658499,202850,true,1551589701,28,1546478149,-5111552
1674658511,202849,true,1551744860,28,1546478149,-5266711
1674658667,202849,true,1551744860,28,1545705142,-6039718
1674658679,202850,true,1551589701,28,1545550587,-6039114
1674658703,202850,true,1551589701,28,1545550587,-6039114
1674658763,202849,true,1551744860,28,1545241523,-6503337
1674658799,202850,true,1551589701,28,1544932522,-6657179
1674658835,202850,true,1551589701,28,1544778044,-6811657
1674658943,202851,true,1551434558,28,1544160287,-7274271
1674658955,202850,true,1551589701,28,1544005886,-7583815
1674658967,202851,true,1551434558,28,1543851501,-7583057
1674659087,202853,true,1551124317,28,1542771237,-8353080
1674659123,202854,true,1550969220,28,1542462729,-8506491
1674659135,202854,true,1550969220,28,1542462729,-8506491
1674659147,202855,true,1550814139,28,1542308498,-8505641
1674659171,202856,true,1550659073,28,1542154283,-8504790
1674659195,202857,true,1550504023,28,1542154283,-8349740
1674659339,202856,true,1550659073,28,1541691729,-8967344
1674660683,202857,true,1550504023,28,1537227523,-13276500
1674661451,202859,true,1550193968,28,1538611581,-11582387
1674661631,202860,true,1550038965,28,1538765442,-11273523
1674661643,202859,true,1550193968,28,1538765442,-11428526
1674662291,202860,true,1550038965,28,1539534979,-10503986
1674662315,202862,true,1549729003,28,1539534979,-10194024
1674662351,202863,true,1549574046,28,1539534979,-10039067
1674662699,202862,true,1549729003,28,1539996885,-9732118
1674662735,202863,true,1549574046,28,1540150885,-9423161
1674663167,202864,true,1549419104,28,1540612977,-8806127
1674663179,202866,true,1549109267,28,1540767038,-8342229
1674663287,202865,true,1549264177,28,1540921115,-8343062
1674663299,202866,true,1549109267,28,1540921115,-8188152
1674663587,202867,true,1548954371,28,1541691729,-7262642
1674663599,202868,true,1548799491,28,1541691729,-7107762
1674663659,202868,true,1548799491,28,1541845898,-6953593
1674663683,202868,true,1548799491,28,1541845898,-6953593
1674663743,202869,true,1548644627,28,1542154283,-6490344
1674663767,202870,true,1548489778,28,1542154283,-6335495
1674666503,202869,true,1548644627,28,1547251543,-1393084
1674666515,202870,true,1548489778,28,1547406268,-1083510
1674666719,202870,true,1548489778,28,1547561009,-928769
1674670307,202871,true,1548334944,28,1548799491,464547
1674670367,202870,true,1548489778,28,1548954371,464593
1674670943,202870,true,1548489778,28,1549109267,619489
1674671747,202871,true,1548334944,28,1549419104,1084160
1674672683,202871,true,1548334944,28,1549419104,1084160
1674672815,202869,true,1548644627,28,1549574046,929419
1674672923,202870,true,1548489778,28,1549574046,1084268
1674673163,202870,true,1548489778,28,1549729003,1239225
1674673211,202870,true,1548489778,28,1549729003,1239225
1674673223,202869,true,1548644627,28,1549729003,1084376
1674673247,202869,true,1548644627,28,1549729003,1084376
1674674003,202869,true,1548644627,28,1550969220,2324593
1674674039,202869,true,1548644627,28,1551124317,2479690
1674674063,202867,true,1548954371,28,1551124317,2169946
1674674135,202867,true,1548954371,28,1551279430,2325059
1674674255,202867,true,1548954371,28,1551434558,2480187
1674674303,202867,true,1548954371,28,1551589701,2635330
1674674327,202866,true,1549109267,28,1551589701,2480434
1674674375,202866,true,1549109267,28,1551744860,2635593
1674674459,202865,true,1549264177,28,1552055225,2791048
1674675635,202865,true,1549264177,28,1554074107,4809930
1674675815,202864,true,1549419104,28,1554384938,4965834
1674675995,202864,true,1549419104,28,1554695830,5276726
1674676343,202864,true,1549419104,28,1555006785,5587681
1674676535,202864,true,1549419104,28,1555317802,5898698
1674676823,202862,true,1549729003,28,1555628881,5899878
1674676835,202862,true,1549729003,28,1555784444,6055441
1674676883,202862,true,1549729003,28,1555784444,6055441
1674676907,202862,true,1549729003,28,1555940022,6211019
1674676931,202861,true,1549883976,28,1555940022,6056046
1674676943,202861,true,1549883976,28,1555940022,6056046
1674676955,202860,true,1550038965,28,1556095616,6056651
1674676991,202860,true,1550038965,28,1556251226,6212261
1674677015,202859,true,1550193968,28,1556562492,6368524
1674677027,202859,true,1550193968,28,1556562492,6368524
1674677051,202858,true,1550348988,28,1556873820,6524832
1674677087,202858,true,1550348988,28,1557185210,6836222
1674677099,202856,true,1550659073,28,1557185210,6526137
1674677123,202856,true,1550659073,28,1557496663,6837590
1674677231,202854,true,1550969220,28,1558743096,7773876
1674677267,202854,true,1550969220,28,1559210766,8241546
1674677291,202853,true,1551124317,28,1559522624,8398307
1674677903,202852,true,1551279430,28,1567496106,16216676
1674679079,202851,true,1551434558,28,1578506519,27071961
1674679271,202851,true,1551434558,28,1578033062,26598504
1674679619,202849,true,1551744860,28,1577402007,25657147
1674680123,202848,true,1551900035,28,1576613542,24713507
1674680135,202848,true,1551900035,28,1576455897,24555862
1674680291,202847,true,1552055225,28,1576455897,24400672
1674680687,202846,true,1552210430,28,1576298267,24087837
1674680855,202844,true,1552520888,28,1576298267,23777379
1674680939,202843,true,1552676140,28,1576298267,23622127
1674680951,202843,true,1552676140,28,1576298267,23622127
1674680963,202841,true,1552986691,28,1576298267,23311576
1674680975,202840,true,1553141989,28,1576455897,23313908
1674680987,202839,true,1553297303,28,1576455897,23158594
1674681311,202837,true,1553607978,28,1577875275,24267297
1674681407,202835,true,1553918716,28,1578348684,24429968
1674681611,202834,true,1554074107,28,1579138017,25063910
1674682055,202832,true,1554384938,28,1580559809,26174871
1674682091,202830,true,1554695830,28,1580559809,25863979
1674682115,202828,true,1555006785,28,1580717865,25711080
1674682139,202827,true,1555162286,28,1580717865,25555579
1674682163,202825,true,1555473334,28,1580875937,25402603
1674682235,202822,true,1555940022,28,1581192128,25252106
1674682259,202820,true,1556251226,28,1581350247,25099021
1674682271,202819,true,1556406851,28,1581350247,24943396
1674682331,202816,true,1556873820,28,1581824700,24950880
1674682355,202813,true,1557340929,28,1581982882,24641953
1674682367,202810,true,1557808178,28,1581982882,24174704
1674682379,202808,true,1558119755,28,1582141081,24021326
1674682403,202805,true,1558587238,28,1582299295,23712057
1674682415,202802,true,1559054861,28,1582457525,23402664
1674682535,202799,true,1559522624,28,1583565577,24042953
1674682547,202797,true,1559834544,28,1583723934,23889390
1674682559,202794,true,1560302541,28,1583882306,23579765
1674682583,202790,true,1560926756,28,1584040695,23113939
1674682595,202787,true,1561395081,28,1584199099,22804018
1674682787,202783,true,1562019732,28,1587053082,25033350
1674682799,202780,true,1562488385,28,1587211787,24723402
1674683723,202775,true,1563269786,28,1600279776,37009990
1674683735,202771,true,1563895187,28,1600599848,36704661
1674683759,202768,true,1564364403,28,1600919984,36555581
1674683771,202763,true,1565146741,28,1601080076,35933335
1674683783,202757,true,1566086064,28,1601400308,35314244
1674683795,202753,true,1566712593,28,1601560448,34847855
1674683831,202748,true,1567496106,28,1602361389,34865283
1674683999,202744,true,1568123198,28,1605569158,37445960
1674684023,202738,true,1569064307,28,1606050877,36986570
1674684071,202734,true,1569692027,28,1606854063,37162036
1674684083,202730,true,1570319998,28,1607175450,36855452
1674684095,202725,true,1571105315,28,1607336167,36230852
1674684107,202720,true,1571891025,28,1607496901,35605876
1674684119,202716,true,1572519876,28,1607818416,35298540
1674684203,202711,true,1573306293,28,1609266032,35959739
1674684227,202707,true,1573935710,28,1609587901,35652191
1674684251,202701,true,1574880307,28,1610070826,35190519
1674684263,202697,true,1575510354,28,1610231833,34721479
1674684335,202692,true,1576298267,28,1611520469,35222202
1674684383,202688,true,1576928881,28,1612326391,35397510
1674684395,202682,true,1577875275,28,1612487623,34612348
1674684407,202678,true,1578506519,28,1612648872,34142353
1674684419,202673,true,1579295930,28,1612810137,33514207
1674684443,202668,true,1580085736,28,1613132715,33046979
1674684479,202662,true,1581034025,28,1613778065,32744040
1674684503,202658,true,1581666533,28,1614262247,32595714
1674684599,202652,true,1582615771,28,1615877236,33261465
1674684611,202648,true,1583248912,28,1616038823,32789911
1674684635,202642,true,1584199099,28,1616362047,32162948
1674684695,202639,true,1584674406,28,1616685336,32010930
1674684719,202635,true,1585308371,28,1617008689,31700318
1674684731,202631,true,1585942589,28,1617008689,31066100
1674684827,202625,true,1586894393,28,1617817355,30922962
1674684863,202622,true,1587370509,28,1618140935,30770426
1674684887,202619,true,1587846767,28,1618302749,30455982
1674685091,202614,true,1588640850,28,1619759804,31118954
1674685103,202609,true,1589435329,28,1619759804,30324475
1674685727,202607,true,1589753232,28,1622191145,32437913
1674685847,202603,true,1590389229,28,1622353364,31964135
1674685919,202599,true,1591025480,28,1622353364,31327884
1674685991,202593,true,1591980334,28,1622515600,30535266
1674686015,202590,true,1592457976,28,1622515600,30057624
1674686027,202587,true,1592935761,28,1622515600,29579839
1674686039,202583,true,1593573031,28,1622515600,28942569
1674686063,202577,true,1594529413,28,1622515600,27986187
1674686639,202575,true,1594848335,28,1620245781,25397446
1674686663,202571,true,1595486370,28,1620245781,24759411
1674686783,202567,true,1596124661,28,1620245781,24121120
1674686843,202562,true,1596922883,28,1620245781,23322898
1674686855,202560,true,1597242283,28,1620245781,23003498
1674686867,202556,true,1597881276,28,1620245781,22364505
1674686879,202553,true,1598360688,28,1620083772,21723084
1674686891,202548,true,1599160028,28,1620083772,20923744
1674686903,202547,true,1599319944,28,1619921780,20601836
1674686927,202545,true,1599639824,28,1619597844,19958020
1674686939,202543,true,1599959768,28,1619435901,19476133
1674686951,202540,true,1600439804,28,1619273973,18834169
1674686963,202539,true,1600599848,28,1619112062,18512214
1674686987,202537,true,1600919984,28,1618788288,17868304
1674686999,202535,true,1601240184,28,1618626426,17386242
1674687047,202531,true,1601880776,28,1617979137,16098361
1674687143,202531,true,1601880776,28,1616847004,14966228
1674687371,202530,true,1602040964,28,1613455358,11414394
1674687395,202528,true,1602361389,28,1612971418,10610029
1674687647,202526,true,1602681877,28,1607657650,4975773
1674687671,202526,true,1602681877,28,1607175450,4493573
1674687683,202526,true,1602681877,28,1606854063,4172186
1674687731,202525,true,1602842145,28,1605890288,3048143
1674687743,202523,true,1603162730,28,1605569158,2406428
1674687767,202523,true,1603162730,28,1605087583,1924853
1674687779,202524,true,1603002429,28,1604766614,1764185
1674687803,202522,true,1603323046,28,1604285280,962234
1674687827,202521,true,1603483378,28,1603643727,160349
1674687875,202521,true,1603483378,28,1602681877,-801501
1674687983,202522,true,1603323046,28,1600599848,-2723198
1674688355,202520,true,1603643727,28,1593573031,-10070696
1674688751,202519,true,1603804091,28,1587211787,-16592304
1674688763,202519,true,1603804091,28,1587053082,-16751009
1674688931,202519,true,1603804091,28,1586577061,-17227030
1674688967,202518,true,1603964471,28,1586577061,-17387410
1674688979,202516,true,1604285280,28,1586577061,-17708219
1674688991,202516,true,1604285280,28,1586577061,-17708219
1674689003,202517,true,1604124868,28,1586577061,-17547807
1674689111,202514,true,1604606153,28,1586577061,-18029092
1674689171,202513,true,1604766614,28,1586735719,-18030895
1674689183,202513,true,1604766614,28,1586735719,-18030895
1674689459,202513,true,1604766614,28,1588799714,-15966900
1674689483,202511,true,1605087583,28,1589117490,-15970093
1674689519,202510,true,1605248092,28,1589435329,-15812763
1674689579,202510,true,1605248092,28,1589912207,-15335885
1674689723,202509,true,1605408617,28,1590866393,-14542224
1674689747,202507,true,1605729715,28,1591025480,-14704235
1674689759,202506,true,1605890288,28,1591184582,-14705706
1674689795,202506,true,1605890288,28,1591343701,-14546587
1674689939,202505,true,1606050877,28,1592617221,-13433656
1674690059,202503,true,1606372103,28,1593732388,-12639715
1674690083,202502,true,1606532740,28,1593891761,-12640979
1674690095,202502,true,1606532740,28,1594051150,-12481590
1674690131,202501,true,1606693393,28,1594369976,-12323417
1674690143,202499,true,1607014748,28,1594529413,-12485335
1674690155,202498,true,1607175450,28,1594688866,-12486584
1674690167,202498,true,1607175450,28,1594848335,-12327115
1674690179,202497,true,1607336167,28,1595007820,-12328347
1674690215,202495,true,1607657650,28,1595486370,-12171280
1674690491,202493,true,1607979198,28,1600119764,-7859434
1674690587,202493,true,1607979198,28,1601880776,-6098422
1674690611,202492,true,1608139996,28,1602361389,-5778607
1674690947,202490,true,1608461640,28,1607496901,-964739
1674690959,202488,true,1608783348,28,1607657650,-1125698
1674690983,202488,true,1608783348,28,1607979198,-804150
1674691151,202488,true,1608783348,28,1610070826,1287478
1674691163,202487,true,1608944227,28,1610070826,1126599
1674691199,202485,true,1609266032,28,1610553895,1287863
1674691259,202486,true,1609105121,28,1611198213,2093092
1674691619,202486,true,1609105121,28,1615069539,5964418
1674691727,202484,true,1609426958,28,1616038823,6611865
1674692219,202484,true,1609426958,28,1617817355,8390397
1674692867,202485,true,1609266032,28,1617332107,8066075
1674692879,202486,true,1609105121,28,1617332107,8226986
1674692939,202485,true,1609266032,28,1617332107,8066075
1674693059,202484,true,1609426958,28,1617170390,7743432
1674693863,202486,true,1609105121,28,1616038823,6933702
1674693875,202487,true,1608944227,28,1616038823,7094596
1674693899,202486,true,1609105121,28,1616038823,6933702
1674693935,202485,true,1609266032,28,1616038823,6772791
1674694115,202487,true,1608944227,28,1616200427,7256200
1674694139,202488,true,1608783348,28,1616200427,7417079
1674694175,202487,true,1608944227,28,1616200427,7256200
1674694199,202486,true,1609105121,28,1616200427,7095306
1674694259,202488,true,1608783348,28,1616362047,7578699
1674694355,202489,true,1608622486,28,1616523683,7901197
1674694367,202488,true,1608783348,28,1616523683,7740335
1674694379,202488,true,1608783348,28,1616523683,7740335
1674694439,202489,true,1608622486,28,1616685336,8062850
1674694451,202490,true,1608461640,28,1616847004,8385364
1674694463,202490,true,1608461640,28,1616847004,8385364
1674694535,202490,true,1608461640,28,1617170390,8708750
1674694595,202491,true,1608300810,28,1617493840,9193030
1674696023,202492,true,1608139996,28,1625763716,17623720
1674696383,202492,true,1608139996,28,1626414119,18274123
1674696527,202492,true,1608139996,28,1626414119,18274123
1674697271,202492,true,1608139996,28,1625763716,17623720
1674697667,202492,true,1608139996,28,1625438612,17298616
1674697691,202491,true,1608300810,28,1625438612,17137802
1674697775,202491,true,1608300810,28,1625276084,16975274
1674697991,202491,true,1608300810,28,1624788599,16487789
1674698015,202492,true,1608139996,28,1624626136,16486140
1674698495,202491,true,1608300810,28,1623489353,15188543
1674698555,202491,true,1608300810,28,1623327020,15026210
1674698591,202491,true,1608300810,28,1623164703,14863893
1674700499,202492,true,1608139996,28,1619921780,11781784
1674700679,202491,true,1608300810,28,1619759804,11458994
1674701135,202491,true,1608300810,28,1619273973,10973163
1674701171,202492,true,1608139996,28,1619273973,11133977
1674701183,202493,true,1607979198,28,1619273973,11294775
1674701243,202492,true,1608139996,28,1619112062,10972066
1674702299,202493,true,1607979198,28,1616523683,8544485
1674702347,202493,true,1607979198,28,1616523683,8544485
1674704147,202494,true,1607818416,28,1615554109,7735693
1674707267,202494,true,1607818416,28,1615554109,7735693
1674707567,202494,true,1607818416,28,1615554109,7735693
1674712751,202494,true,1607818416,28,1615554109,7735693
1674713351,202495,true,1607657650,28,1615715664,8058014
1674713387,202495,true,1607657650,28,1615715664,8058014
1674713519,202494,true,1607818416,28,1615877236,8058820
1674713579,202493,true,1607979198,28,1615877236,7898038
1674713939,202492,true,1608139996,28,1616200427,8060431
1674714179,202490,true,1608461640,28,1616523683,8062043
1674714191,202489,true,1608622486,28,1616523683,7901197
1674714455,202488,true,1608783348,28,1615231046,6447698
1674715235,202488,true,1608783348,28,1610714951,1931603
1674715535,202487,true,1608944227,28,1608944227,0
1674715595,202486,true,1609105121,28,1608622486,-482635
1674715643,202485,true,1609266032,28,1608300810,-965222
1674715667,202485,true,1609266032,28,1608139996,-1126036
1674715691,202484,true,1609426958,28,1608139996,-1286962
1674715859,202481,true,1609909835,28,1607175450,-2734385
1674715883,202481,true,1609909835,28,1607175450,-2734385
1674721883,202479,true,1610231833,28,1608783348,-1448485
1674722015,202478,true,1610392856,28,1608783348,-1609508
1674722291,202476,true,1610714951,28,1608622486,-2092465
1674722303,202475,true,1610876022,28,1608622486,-2253536
1674723419,202474,true,1611037110,28,1608139996,-2897114
1674725435,202473,true,1611198213,28,1607979198,-3219015
1674725723,202470,true,1611681621,28,1607979198,-3702423
1674725735,202470,true,1611681621,28,1607979198,-3702423
1674728711,202469,true,1611842789,28,1606050877,-5791912
1674729647,202468,true,1612003974,28,1606050877,-5953097
1674729659,202466,true,1612326391,28,1606050877,-6275514
1674730079,202465,true,1612487623,28,1606050877,-6436746
1674730463,202465,true,1612487623,28,1604927091,-7560532
1674731279,202465,true,1612487623,28,1602201169,-10286454
1674732755,202463,true,1612810137,28,1600119764,-12690373
1674733811,202463,true,1612810137,28,1600279776,-12530361
1674734351,202463,true,1612810137,28,1600439804,-12370333
1674734855,202463,true,1612810137,28,1600599848,-12210289
1674734963,202461,true,1613132715,28,1600599848,-12532867
1674735815,202461,true,1613132715,28,1600919984,-12212731
1674735827,202462,true,1612971418,28,1600919984,-12051434
1674735839,202462,true,1612971418,28,1600919984,-12051434
1674735863,202460,true,1613294028,28,1600919984,-12374044
1674735899,202460,true,1613294028,28,1601080076,-12213952
1674735935,202460,true,1613294028,28,1601080076,-12213952
1674735971,202461,true,1613132715,28,1601080076,-12052639
1674735983,202459,true,1613455358,28,1601240184,-12215174
1674736043,202459,true,1613455358,28,1601240184,-12215174
1674736199,202460,true,1613294028,28,1601720604,-11573424
1674736271,202460,true,1613294028,28,1601880776,-11413252
1674736307,202459,true,1613455358,28,1601880776,-11574582
1674736319,202458,true,1613616703,28,1601880776,-11735927
1674736331,202459,true,1613455358,28,1602040964,-11414394
1674736343,202460,true,1613294028,28,1602040964,-11253064
1674736355,202458,true,1613616703,28,1602040964,-11575739
1674736391,202458,true,1613616703,28,1602361389,-11255314
1674736439,202459,true,1613455358,28,1602681877,-10773481
1674737435,202459,true,1613455358,28,1608622486,-4832872
1674738023,202459,true,1613455358,28,1611520469,-1934889
1674738107,202459,true,1613455358,28,1611842789,-1612569
1674738131,202460,true,1613294028,28,1611842789,-1451239
1674738155,202461,true,1613132715,28,1612003974,-1128741
1674738179,202461,true,1613132715,28,1612003974,-1128741
1674739079,202460,true,1613294028,28,1612971418,-322610
1674739811,202461,true,1613132715,28,1613778065,645350
1674739823,202462,true,1612971418,28,1613778065,806647
1674739847,202462,true,1612971418,28,1613778065,806647
1674740051,202461,true,1613132715,28,1612810137,-322578
1674740075,202464,true,1612648872,28,1612810137,161265
1674740255,202464,true,1612648872,28,1612326391,-322481
1674740303,202464,true,1612648872,28,1612165174,-483698
1674740327,202463,true,1612810137,28,1612165174,-644963
1674740411,202465,true,1612487623,28,1612003974,-483649
1674741467,202465,true,1612487623,28,1610714951,-1772672
1674741575,202465,true,1612487623,28,1610553895,-1933728
1674741611,202464,true,1612648872,28,1610553895,-2094977
1674741659,202466,true,1612326391,28,1610714951,-1611440
1674741695,202466,true,1612326391,28,1610876022,-1450369
1674741755,202465,true,1612487623,28,1611198213,-1289410
1674741815,202464,true,1612648872,28,1611520469,-1128403
1674741827,202467,true,1612165174,28,1611520469,-644705
1674742487,202467,true,1612165174,28,1613294028,1128854
1674743459,202466,true,1612326391,28,1615069539,2743148
1674743507,202465,true,1612487623,28,1615069539,2581916
1674743531,202468,true,1612003974,28,1615069539,3065565
1674744107,202468,true,1612003974,28,1615554109,3550135
1674744215,202467,true,1612165174,28,1615554109,3388935
1674744227,202466,true,1612326391,28,1615554109,3227718
1674744239,202469,true,1611842789,28,1615554109,3711320
1674744251,202469,true,1611842789,28,1615554109,3711320
1674744263,202469,true,1611842789,28,1615554109,3711320
1674744275,202469,true,1611842789,28,1615554109,3711320
1674744599,202473,true,1611198213,28,1614262247,3064034
1674744623,202473,true,1611198213,28,1614262247,3064034
1674744671,202473,true,1611198213,28,1613939443,2741230
1674744695,202473,true,1611198213,28,1613778065,2579852
1674745463,202478,true,1610392856,28,1608622486,-1770370
1674745499,202478,true,1610392856,28,1608300810,-2092046
1674745511,202478,true,1610392856,28,1608300810,-2092046
1674745547,202478,true,1610392856,28,1608139996,-2252860
1674745559,202482,true,1609748860,28,1607979198,-1769662
1674746159,202481,true,1609909835,28,1605087583,-4822252
1674746171,202481,true,1609909835,28,1605087583,-4822252
1674746195,202481,true,1609909835,28,1605087583,-4822252
1674746207,202485,true,1609266032,28,1605087583,-4178449
1674746279,202484,true,1609426958,28,1605087583,-4339375
1674746315,202484,true,1609426958,28,1605087583,-4339375
1674746327,202484,true,1609426958,28,1605087583,-4339375
1674746363,202487,true,1608944227,28,1605087583,-3856644
1674746399,202486,true,1609105121,28,1605087583,-4017538
1674746411,202485,true,1609266032,28,1605087583,-4178449
1674747611,202485,true,1609266032,28,1609748860,482828
1674747623,202488,true,1608783348,28,1609748860,965512
1674747959,202487,true,1608944227,28,1610392856,1448629
1674748043,202486,true,1609105121,28,1610231833,1126712
1674748067,202486,true,1609105121,28,1610231833,1126712
1674748079,202490,true,1608461640,28,1610231833,1770193
1674748103,202489,true,1608622486,28,1610231833,1609347
1674748115,202488,true,1608783348,28,1610231833,1448485
1674748163,202489,true,1608622486,28,1610070826,1448340
1674748223,202492,true,1608139996,28,1609909835,1769839
1674748463,202492,true,1608139996,28,1609105121,965125
1674748475,202491,true,1608300810,28,1608944227,643417
1674748487,202491,true,1608300810,28,1608944227,643417
1674748499,202493,true,1607979198,28,1608944227,965029
1674748511,202493,true,1607979198,28,1608783348,804150
1674748523,202492,true,1608139996,28,1608783348,643352
1674749255,202494,true,1607818416,28,1600439804,-7378612
1674749327,202497,true,1607336167,28,1599639824,-7696343
1674749363,202496,true,1607496901,28,1599319944,-8176957
1674750659,202497,true,1607336167,28,1587529246,-19806921
1674750719,202499,true,1607014748,28,1587370509,-19644239
1674750791,202501,true,1606693393,28,1587370509,-19322884
1674751415,202501,true,1606693393,28,1587370509,-19322884
1674751451,202501,true,1606693393,28,1587370509,-19322884
1674751463,202503,true,1606372103,28,1587370509,-19001594
1674751631,202506,true,1605890288,28,1587846767,-18043521
1674751715,202505,true,1606050877,28,1588005552,-18045325
1674751775,202505,true,1606050877,28,1588164353,-17886524
1674751847,202507,true,1605729715,28,1588323169,-17406546
1674752699,202509,true,1605408617,28,1590389229,-15019388
1674752711,202508,true,1605569158,28,1590389229,-15179929
1674752723,202509,true,1605408617,28,1590548267,-14860350
1674752819,202510,true,1605248092,28,1590707322,-14540770
1674752855,202512,true,1604927091,28,1590707322,-14219769
1674752879,202511,true,1605087583,28,1590707322,-14380261
1674753011,202510,true,1605248092,28,1591025480,-14222612
1674753047,202512,true,1604927091,28,1591184582,-13742509
1674753947,202514,true,1604606153,28,1592617221,-11988932
1674754679,202512,true,1604927091,28,1593413689,-11513402
1674757631,202512,true,1604927091,28,1593413689,-11513402
1674757667,202514,true,1604606153,28,1593573031,-11033122
1674757679,202515,true,1604445709,28,1593573031,-10872678
1674757811,202514,true,1604606153,28,1594051150,-10555003
1674757907,202513,true,1604766614,28,1594369976,-10396638
1674757919,202514,true,1604606153,28,1594369976,-10236177
1674758123,202516,true,1604285280,28,1595326838,-8958442
1674758291,202514,true,1604606153,28,1596124661,-8481492
1674759047,202513,true,1604766614,28,1599959768,-4806846
1674759875,202515,true,1604445709,28,1602521625,-1924084
1674760655,202516,true,1604285280,28,1602681877,-1603403
1674761267,202515,true,1604445709,28,1602361389,-2084320
1674761675,202513,true,1604766614,28,1602201169,-2565445
1674762371,202515,true,1604445709,28,1602040964,-2404745
1674764219,202517,true,1604124868,28,1602521625,-1603243
1674764915,202516,true,1604285280,28,1602521625,-1763655
1674765083,202515,true,1604445709,28,1602681877,-1763832
1674765119,202517,true,1604124868,28,1602681877,-1442991
1674765143,202519,true,1603804091,28,1602681877,-1122214
1674765155,202518,true,1603964471,28,1602681877,-1282594
1674765263,202516,true,1604285280,28,1602842145,-1443135
1674765299,202518,true,1603964471,28,1603002429,-962042
1674767483,202520,true,1603643727,28,1606050877,2407150
1674767495,202519,true,1603804091,28,1606050877,2246786
1674767603,202517,true,1604124868,28,1606050877,1926009
1674767675,202520,true,1603643727,28,1605890288,2246561
1674767687,202522,true,1603323046,28,1605890288,2567242
1674767699,202521,true,1603483378,28,1605890288,2406910
1674767783,202520,true,1603643727,28,1605569158,1925431
1674767807,202522,true,1603323046,28,1605569158,2246112
1674769067,202524,true,1603002429,28,1600919984,-2082445
1674769835,202523,true,1603162730,28,1599479876,-3682854
1674770771,202522,true,1603323046,28,1599479876,-3843170
1674770831,202525,true,1602842145,28,1599639824,-3202321
1674770879,202526,true,1602681877,28,1599639824,-3042053
1674771851,202525,true,1602842145,28,1602361389,-480756
1674773987,202523,true,1603162730,28,1604606153,1443423
1674774167,202526,true,1602681877,28,1604606153,1924276
1674774755,202528,true,1602361389,28,1604445709,2084320
1674774827,202527,true,1602521625,28,1604285280,1763655
1674774959,202526,true,1602681877,28,1604285280,1603403
1674778259,202528,true,1602361389,28,1603323046,961657
1674778739,202530,true,1602040964,28,1603323046,1282082
1674778763,202529,true,1602201169,28,1603323046,1121877
1674778775,202528,true,1602361389,28,1603323046,961657
1674778787,202531,true,1601880776,28,1603323046,1442270
1674779003,202533,true,1601560448,28,1603002429,1441981
1674779063,202533,true,1601560448,28,1602842145,1281697
1674779075,202532,true,1601720604,28,1602842145,1121541
1674779147,202535,true,1601240184,28,1602681877,1441693
1674780767,202537,true,1600919984,28,1597721504,-3198480
1674780791,202537,true,1600919984,28,1597721504,-3198480
1674780851,202535,true,1601240184,28,1597721504,-3518680
1674780875,202538,true,1600759908,28,1597561748,-3198160
1674780887,202540,true,1600439804,28,1597561748,-2878056
1674780899,202540,true,1600439804,28,1597561748,-2878056
1674780935,202538,true,1600759908,28,1597402007,-3357901
1674782531,202542,true,1600119764,28,1592139532,-7980232
1674782795,202543,true,1599959768,28,1591025480,-8934288
1674782843,202542,true,1600119764,28,1590866393,-9253371
1674783227,202541,true,1600279776,28,1589912207,-10367569
1674783407,202545,true,1599639824,28,1589435329,-10204495
1674783419,202547,true,1599319944,28,1589276401,-10043543
1674783431,202547,true,1599319944,28,1589117490,-10202454
1674783443,202546,true,1599479876,28,1588958594,-10521282
1674783503,202554,true,1598200868,28,1588005552,-10195316
1674783515,202556,true,1597881276,28,1587846767,-10034509
1674783539,202557,true,1597721504,28,1587370509,-10350995
1674783791,202557,true,1597721504,28,1582932309,-14789195
1674783803,202565,true,1596443901,28,1582774032,-13669869
1674783839,202567,true,1596124661,28,1582141081,-13983580
1674784151,202568,true,1595965064,28,1576928881,-19036183
1674784175,202568,true,1595965064,28,1576613542,-19351522
1674784187,202576,true,1594688866,28,1576455897,-18232969
1674784787,202578,true,1594369976,28,1568123198,-26246778
1674785555,202579,true,1594210555,28,1562644634,-31565921
1674785627,202579,true,1594210555,28,1562800898,-31409657
1674785663,202587,true,1592935761,28,1562800898,-30134863
1674785903,202589,true,1592617221,28,1562957178,-29660043
1674785915,202588,true,1592776483,28,1562957178,-29819305
1674785951,202588,true,1592776483,28,1562957178,-29819305
1674785987,202596,true,1591502835,28,1562957178,-28545657
1674786035,202598,true,1591184582,28,1562957178,-28227404
1674786059,202598,true,1591184582,28,1562957178,-28227404
1674786083,202598,true,1591184582,28,1563113474,-28071108
1674786143,202605,true,1590071198,28,1563113474,-26957724
1674786743,202607,true,1589753232,28,1563582455,-26170777
1674786767,202606,true,1589912207,28,1563738813,-26173394
1674786779,202606,true,1589912207,28,1563738813,-26173394
1674786947,202611,true,1589117490,28,1564051577,-25065913
1674787067,202612,true,1588958594,28,1564364403,-24594191
1674787427,202611,true,1589117490,28,1565616332,-23501158
1674787631,202610,true,1589276401,28,1566242673,-23033728
1674788519,202615,true,1588482001,28,1568123198,-20358803
1674790451,202616,true,1588323169,28,1568436838,-19886331
1674791063,202615,true,1588482001,28,1568436838,-20045163
1674791495,202615,true,1588482001,28,1568436838,-20045163
1674791603,202620,true,1587687999,28,1568436838,-19251161
1674792131,202621,true,1587529246,28,1568436838,-19092408
1674792539,202620,true,1587687999,28,1568436838,-19251161
1674792863,202620,true,1587687999,28,1568436838,-19251161
1674792995,202625,true,1586894393,28,1568436838,-18457555
1674794375,202626,true,1586735719,28,1567966401,-18769318
1674794555,202626,true,1586735719,28,1567966401,-18769318
1674794891,202625,true,1586894393,28,1567809620,-19084773
1674797111,202630,true,1586101183,28,1567809620,-18291563
1674798047,202632,true,1585784011,28,1567809620,-17974391
1674798119,202631,true,1585942589,28,1567966401,-17976188
1674798167,202631,true,1585942589,28,1567966401,-17976188
1674798239,202636,true,1585149856,28,1568123198,-17026658
1674798335,202637,true,1584991357,28,1568436838,-16554519
1674798611,202636,true,1585149856,28,1569064307,-16085549
1674798767,202635,true,1585308371,28,1569692027,-15616344
1674798791,202640,true,1584515954,28,1569692027,-14823927
1674798803,202641,true,1584357519,28,1569848996,-14508523
1674798827,202640,true,1584515954,28,1569848996,-14666958
1674798851,202641,true,1584357519,28,1570005981,-14351538
1674798863,202646,true,1583565577,28,1570162982,-13402595
1674798875,202646,true,1583565577,28,1570162982,-13402595
1674799163,202644,true,1583882306,28,1572991679,-10890627
1674799691,202645,true,1583723934,28,1577875275,-5848659
1674799703,202650,true,1582932309,28,1578033062,-4899247
1674799799,202650,true,1582932309,28,1578822236,-4110073
1674800495,202648,true,1583248912,28,1583248912,0
1674802523,202649,true,1583090603,28,1583090603,0
1674804707,202654,true,1582299295,28,1583090603,791308
1674805187,202655,true,1582141081,28,1583090603,949522
1674805883,202653,true,1582457525,28,1583090603,633078
1674806915,202653,true,1582457525,28,1583090603,633078
1674808667,202658,true,1581666533,28,1583090603,1424070
1674809975,202659,true,1581508382,28,1583090603,1582221
1674810047,202657,true,1581824700,28,1583090603,1265903
1674810191,202658,true,1581666533,28,1583090603,1424070
1674810239,202663,true,1580875937,28,1583090603,2214666
1674810263,202664,true,1580717865,28,1583090603,2372738
1674811103,202662,true,1581034025,28,1583090603,2056578
1674811679,202663,true,1580875937,28,1582932309,2056372
1674811691,202668,true,1580085736,28,1582932309,2846573
1674811703,202669,true,1579927744,28,1582932309,3004565
1674811727,202667,true,1580243745,28,1582932309,2688564
1674811739,202668,true,1580085736,28,1582932309,2846573
1674811763,202673,true,1579295930,28,1582932309,3636379
1674811775,202673,true,1579295930,28,1582932309,3636379
1674811943,202671,true,1579611805,28,1582615771,3003966
1674812183,202672,true,1579453860,28,1582457525,3003665
1674812699,202677,true,1578664370,28,1581982882,3318512
1674814955,202677,true,1578664370,28,1581192128,2527758
1674815951,202676,true,1578822236,28,1581192128,2369892
1674816779,202677,true,1578664370,28,1581192128,2527758
1674817691,202682,true,1577875275,28,1580401769,2526494
1674818147,202682,true,1577875275,28,1580085736,2210461
1674818207,202681,true,1578033062,28,1579927744,1894682
1674818531,202682,true,1577875275,28,1579453860,1578585
1674822851,202688,true,1576928881,28,1578190865,1261984
1674823811,202688,true,1576928881,28,1578190865,1261984
1674824843,202687,true,1577086574,28,1578190865,1104291
1674825899,202688,true,1576928881,28,1578190865,1261984
1674826163,202693,true,1576140653,28,1577875275,1734622
1674826175,202693,true,1576140653,28,1577875275,1734622
1674826199,202692,true,1576298267,28,1577875275,1577008
1674826307,202694,true,1575983054,28,1577402007,1418953
1674826319,202699,true,1575195299,28,1577402007,2206708
1674826331,202699,true,1575195299,28,1577402007,2206708
1674826343,202698,true,1575352819,28,1577402007,2049188
1674826355,202699,true,1575195299,28,1577402007,2206708
1674826391,202704,true,1574407938,28,1577402007,2994069
1674826427,202703,true,1574565379,28,1577402007,2836628
1674827243,202701,true,1574880307,28,1577717503,2837196
1674827255,202703,true,1574565379,28,1577717503,3152124
1674827267,202707,true,1573935710,28,1577717503,3781793
1674827375,202706,true,1574093103,28,1577559747,3466644
1674827399,202705,true,1574250513,28,1577559747,3309234
1674827831,202706,true,1574093103,28,1576771204,2678101
1674829271,202710,true,1573463624,28,1574093103,629479
1674829307,202709,true,1573620970,28,1574093103,472133
1674829331,202707,true,1573935710,28,1574093103,157393
1674829427,202708,true,1573778332,28,1574093103,314771
1674829451,202709,true,1573620970,28,1574093103,472133
1674829463,202707,true,1573935710,28,1573935710,0
1674829535,202705,true,1574250513,28,1573935710,-314803
1674830567,202706,true,1574093103,28,1571105315,-2987788
1674830591,202706,true,1574093103,28,1571105315,-2987788
1674830891,202705,true,1574250513,28,1570477030,-3773483
1674830903,202703,true,1574565379,28,1570319998,-4245381
1674830915,202704,true,1574407938,28,1570319998,-4087940
1674830927,202704,true,1574407938,28,1570319998,-4087940
1674830939,202702,true,1574722835,28,1570319998,-4402837
1674830951,202701,true,1574880307,28,1570319998,-4560309
1674830963,202701,true,1574880307,28,1570319998,-4560309
1674830987,202701,true,1574880307,28,1570477030,-4403277
1674831011,202699,true,1575195299,28,1570477030,-4718269
1674831059,202698,true,1575352819,28,1570634078,-4718741
1674831071,202698,true,1575352819,28,1570634078,-4718741
1674831083,202698,true,1575352819,28,1570634078,-4718741
1674831143,202696,true,1575667905,28,1570791141,-4876764
1674831167,202694,true,1575983054,28,1570948220,-5034834
1674831179,202694,true,1575983054,28,1571105315,-4877739
1674831215,202694,true,1575983054,28,1571262426,-4720628
1674831275,202692,true,1576298267,28,1571576694,-4721573
1674831563,202690,true,1576613542,28,1573935710,-2677832
1674832079,202690,true,1576613542,28,1577875275,1261733
1674832103,202690,true,1576613542,28,1578033062,1419520
1674832115,202688,true,1576928881,28,1578190865,1261984
1674832547,202686,true,1577244282,28,1581824700,4580418
1674832655,202686,true,1577244282,28,1582774032,5529750
1674834023,202686,true,1577244282,28,1585942589,8698307
1674834155,202684,true,1577559747,28,1585942589,8382842
1674834167,202682,true,1577875275,28,1585942589,8067314
1674834323,202682,true,1577875275,28,1586259794,8384519
1674834431,202682,true,1577875275,28,1586577061,8701786
1674834455,202679,true,1578348684,28,1586577061,8228377
1674834491,202677,true,1578664370,28,1586577061,7912691
1674834563,202678,true,1578506519,28,1586577061,8070542
1674834623,202678,true,1578506519,28,1586577061,8070542
1674834635,202675,true,1578980119,28,1586577061,7596942
1674834839,202674,true,1579138017,28,1586259794,7121777
1674834863,202674,true,1579138017,28,1586259794,7121777
1674834887,202674,true,1579138017,28,1586259794,7121777
1674834911,202672,true,1579453860,28,1586101183,6647323
1674834935,202670,true,1579769767,28,1586101183,6331416
1674836507,202671,true,1579611805,28,1580401769,789964
1674836579,202671,true,1579611805,28,1580243745,631940
1674836591,202670,true,1579769767,28,1580243745,473978
1674836831,202669,true,1579927744,28,1580559809,632065
1674836855,202669,true,1579927744,28,1580559809,632065
1674837755,202669,true,1579927744,28,1582932309,3004565
1674837779,202667,true,1580243745,28,1582932309,2688564
1674838751,202666,true,1580401769,28,1585784011,5382242
1674838799,202667,true,1580243745,28,1585942589,5698844
1674839759,202666,true,1580401769,28,1587687999,7286230
1674839771,202665,true,1580559809,28,1587687999,7128190
1674839783,202665,true,1580559809,28,1587687999,7128190
1674841799,202665,true,1580559809,28,1591980334,11420525
1674841871,202665,true,1580559809,28,1592139532,11579723
1674841883,202663,true,1580875937,28,1592139532,11263595
1674841943,202663,true,1580875937,28,1592139532,11263595
1674841967,202663,true,1580875937,28,1592139532,11263595
1674842003,202662,true,1581034025,28,1592298746,11264721
1674842015,202661,true,1581192128,28,1592298746,11106618
1674842027,202660,true,1581350247,28,1592457976,11107729
1674842039,202659,true,1581508382,28,1592457976,10949594
1674842831,202657,true,1581824700,28,1598680376,16855676
1674842939,202655,true,1582141081,28,1599479876,17338795
1674843035,202655,true,1582141081,28,1600119764,17978683
1674843551,202654,true,1582299295,28,1603483378,21184083
1674843599,202652,true,1582615771,28,1603804091,21188320
1674844235,202651,true,1582774032,28,1604445709,21671677
1674846443,202650,true,1582932309,28,1603643727,20711418
1674847535,202650,true,1582932309,28,1603643727,20711418
1674847595,202648,true,1583248912,28,1603643727,20394815
1674848615,202646,true,1583565577,28,1603643727,20078150
1674848675,202645,true,1583723934,28,1603804091,20080157
1674848783,202645,true,1583723934,28,1603804091,20080157
1674848843,202643,true,1584040695,28,1603804091,19763396
1674848855,202641,true,1584357519,28,1603804091,19446572
1674849107,202640,true,1584515954,28,1604124868,19608914
1674849143,202640,true,1584515954,28,1604124868,19608914
1674849347,202637,true,1584991357,28,1604766614,19775257
1674849719,202635,true,1585308371,28,1605890288,20581917
1674849779,202634,true,1585466902,28,1606211482,20744580
1674849815,202633,true,1585625448,28,1606372103,20746655
1674850007,202630,true,1586101183,28,1607496901,21395718
1674850019,202628,true,1586418420,28,1607657650,21239230
1674850091,202626,true,1586735719,28,1607979198,21243479
1674850139,202625,true,1586894393,28,1608300810,21406417
1674850451,202622,true,1587370509,28,1610553895,23183386
1674850475,202619,true,1587846767,28,1610714951,22868184
1674850487,202618,true,1588005552,28,1610876022,22870470
1674850655,202617,true,1588164353,28,1611681621,23517268
1674852383,202614,true,1588640850,28,1612971418,24330568
1674852395,202611,true,1589117490,28,1612971418,23853928
1674852431,202610,true,1589276401,28,1612648872,23372471
1674852695,202609,true,1589435329,28,1611359333,21924004
1674852875,202607,true,1589753232,28,1610392856,20639624
1674852887,202604,true,1590230206,28,1610392856,20162650
1674853031,202603,true,1590389229,28,1609426958,19037729
1674853043,202602,true,1590548267,28,1609426958,18878691
1674853079,202601,true,1590707322,28,1609105121,18397799
1674853103,202599,true,1591025480,28,1608944227,17918747
1674853967,202598,true,1591184582,28,1602040964,10856382
1674854363,202598,true,1591184582,28,1599799788,8615206
1674854555,202597,true,1591343701,28,1599319944,7976243
1674854723,202595,true,1591661985,28,1598840244,7178259
1674855263,202593,true,1591980334,28,1599000128,7019794
1674855299,202592,true,1592139532,28,1599000128,6860596
1674855527,202591,true,1592298746,28,1599160028,6861282
1674855779,202589,true,1592617221,28,1599479876,6862655
1674856787,202587,true,1592935761,28,1600599848,7664087
1674857375,202586,true,1593095054,28,1600919984,7824930
1674857387,202585,true,1593254364,28,1600919984,7665620
1674857423,202582,true,1593732388,28,1600919984,7187596
1674857435,202581,true,1593891761,28,1600919984,7028223
1674858167,202581,true,1593891761,28,1597402007,3510246
1674859739,202580,true,1594051150,28,1592457976,-1593174
1674860159,202577,true,1594529413,28,1592457976,-2071437
1674861155,202576,true,1594688866,28,1592457976,-2230890
1674861443,202576,true,1594688866,28,1592617221,-2071645
1674862067,202575,true,1594848335,28,1592935761,-1912574
1674862163,202573,true,1595167321,28,1592935761,-2231560
1674862523,202571,true,1595486370,28,1593254364,-2232006
1674862559,202572,true,1595326838,28,1593254364,-2072474
1674862787,202571,true,1595486370,28,1593573031,-1913339
1674864323,202569,true,1595805484,28,1594688866,-1116618
1674864503,202567,true,1596124661,28,1594688866,-1435795
1674865667,202568,true,1595965064,28,1594848335,-1116729
1674865703,202567,true,1596124661,28,1594848335,-1276326
1674865739,202565,true,1596443901,28,1594848335,-1595566
1674865847,202564,true,1596603546,28,1595167321,-1436225
1674866255,202564,true,1596603546,28,1595805484,-798062
1674866315,202563,true,1596763206,28,1595965064,-798142
1674866351,202562,true,1596922883,28,1596124661,-798222
1674866483,202560,true,1597242283,28,1596443901,-798382
1674866651,202560,true,1597242283,28,1596922883,-319400
1674866663,202559,true,1597402007,28,1596922883,-479124
1674866687,202558,true,1597561748,28,1597082575,-479173
1674868859,202557,true,1597721504,28,1601400308,3678804
1674869579,202557,true,1597721504,28,1601400308,3678804
1674870263,202556,true,1597881276,28,1601080076,3198800
1674871259,202554,true,1598200868,28,1600439804,2238936
1674871907,202553,true,1598360688,28,1600119764,1759076
1674872207,202554,true,1598200868,28,1600119764,1918896
1674872543,202553,true,1598360688,28,1599799788,1439100
1674872843,202552,true,1598520524,28,1599479876,959352
1674872891,202551,true,1598680376,28,1599319944,639568
1674874307,202551,true,1598680376,28,1597561748,-1118628
1674877211,202551,true,1598680376,28,1597242283,-1438093
1674877439,202550,true,1598840244,28,1597242283,-1597961
1674877475,202548,true,1599160028,28,1597242283,-1917745
1674879383,202548,true,1599160028,28,1597242283,-1917745
1674882131,202548,true,1599160028,28,1597881276,-1278752
1674882779,202546,true,1599479876,28,1597881276,-1598600
1674883163,202545,true,1599639824,28,1598041064,-1598760
1674883751,202544,true,1599799788,28,1598360688,-1439100
1674883859,202543,true,1599959768,28,1598520524,-1439244
1674884279,202542,true,1600119764,28,1598680376,-1439388
1674884555,202541,true,1600279776,28,1598840244,-1439532
1674884963,202541,true,1600279776,28,1598840244,-1439532
1674885107,202540,true,1600439804,28,1598840244,-1599560
1674885419,202539,true,1600599848,28,1598680376,-1919472
1674887147,202538,true,1600759908,28,1598680376,-2079532
1674887255,202538,true,1600759908,28,1598680376,-2079532
1674888095,202538,true,1600759908,28,1598360688,-2399220
1674888515,202537,true,1600919984,28,1598200868,-2719116
1674890111,202536,true,1601080076,28,1597881276,-3198800
1674890819,202536,true,1601080076,28,1597881276,-3198800
1674890903,202536,true,1601080076,28,1597881276,-3198800
1674890927,202535,true,1601240184,28,1597881276,-3358908
1674890975,202534,true,1601400308,28,1597881276,-3519032
1674891083,202536,true,1601080076,28,1597721504,-3358572
1674891131,202536,true,1601080076,28,1597721504,-3358572
1674891143,202535,true,1601240184,28,1597561748,-3678436
1674891239,202535,true,1601240184,28,1597402007,-3838177
1674892799,202537,true,1600919984,28,1592457976,-8462008
1674892823,202539,true,1600599848,28,1592457976,-8141872
1674893771,202538,true,1600759908,28,1592298746,-8461162
1674893795,202538,true,1600759908,28,1592298746,-8461162
1674894863,202540,true,1600439804,28,1592298746,-8141058
1674895823,202542,true,1600119764,28,1592298746,-7821018
1674897851,202541,true,1600279776,28,1592298746,-7981030
1674899723,202541,true,1600279776,28,1592298746,-7981030
1674901367,202543,true,1599959768,28,1592298746,-7661022
1674901439,202545,true,1599639824,28,1592139532,-7500292
1674901919,202544,true,1599799788,28,1590389229,-9410559
1674902687,202544,true,1599799788,28,1587529246,-12270542
1674904667,202547,true,1599319944,28,1585466902,-13853042
1674906215,202549,true,1599000128,28,1585466902,-13533226
1674906383,202548,true,1599160028,28,1585466902,-13693126
1674907151,202548,true,1599160028,28,1585466902,-13693126
1674907391,202551,true,1598680376,28,1585466902,-13213474
1674908003,202553,true,1598360688,28,1585466902,-12893786
1674908363,202553,true,1598360688,28,1585466902,-12893786
1674908567,202554,true,1598200868,28,1585466902,-12733966
1674908747,202557,true,1597721504,28,1585466902,-12254602
1674911063,202559,true,1597402007,28,1585466902,-11935105
1674911075,202559,true,1597402007,28,1585466902,-11935105
1674911123,202560,true,1597242283,28,1585466902,-11775381
1674911135,202563,true,1596763206,28,1585466902,-11296304
1674911267,202567,true,1596124661,28,1584991357,-11133304
1674911471,202568,true,1595965064,28,1583882306,-12082758
1674911483,202569,true,1595805484,28,1583882306,-11923178
1674911819,202572,true,1595326838,28,1581508382,-13818456
1674911831,202576,true,1594688866,28,1581508382,-13180484
1674911843,202577,true,1594529413,28,1581350247,-13179166
1674911903,202578,true,1594369976,28,1580875937,-13494039
1674911963,202581,true,1593891761,28,1580401769,-13489992
1674912371,202583,true,1593573031,28,1576928881,-16644150
1674913271,202585,true,1593254364,28,1569848996,-23405368
1674913295,202586,true,1593095054,28,1569848996,-23246058
1674913343,202589,true,1592617221,28,1569692027,-22925194
1674913583,202591,true,1592298746,28,1569064307,-23234439
1674913595,202592,true,1592139532,28,1568907417,-23232115
1674913631,202592,true,1592139532,28,1568907417,-23232115
1674913679,202596,true,1591502835,28,1568907417,-22595418
1674913967,202597,true,1591343701,28,1568907417,-22436284
1674914039,202598,true,1591184582,28,1568907417,-22277165
1674914099,202599,true,1591025480,28,1568907417,-22118063
1674916439,202602,true,1590548267,28,1572205419,-18342848
1674916499,202603,true,1590389229,28,1572205419,-18183810
1674918791,202605,true,1590071198,28,1572205419,-17865779
1674918815,202605,true,1590071198,28,1572362639,-17708559
1674919103,202608,true,1589594272,28,1572677128,-16917144
1674919343,202610,true,1589276401,28,1572991679,-16284722
1674919355,202610,true,1589276401,28,1573148978,-16127423
1674920843,202611,true,1589117490,28,1575510354,-13607136
1674924251,202612,true,1588958594,28,1576140653,-12817941
1674925487,202614,true,1588640850,28,1576298267,-12342583
1674926999,202614,true,1588640850,28,1576298267,-12342583
1674928655,202615,true,1588482001,28,1576298267,-12183734
1674931487,202616,true,1588323169,28,1576298267,-12024902
1674931547,202617,true,1588164353,28,1576298267,-11866086
1674935771,202618,true,1588005552,28,1575983054,-12022498
1674938099,202619,true,1587846767,28,1575983054,-11863713
1674938111,202620,true,1587687999,28,1575983054,-11704945
1674938123,202621,true,1587529246,28,1575983054,-11546192
1674938171,202622,true,1587370509,28,1575983054,-11387455
1674938255,202624,true,1587053082,28,1575825472,-11227610
1674938687,202625,true,1586894393,28,1574722835,-12171558
1674939347,202627,true,1586577061,28,1572991679,-13585382
1674939407,202627,true,1586577061,28,1572834395,-13742666
1674939431,202629,true,1586259794,28,1572677128,-13582666
1674939455,202631,true,1585942589,28,1572677128,-13265461
1674939575,202633,true,1585625448,28,1572048214,-13577234
1674939587,202634,true,1585466902,28,1572048214,-13418688
1674939611,202636,true,1585149856,28,1571891025,-13258831
1674939623,202638,true,1584832873,28,1571891025,-12941848
1674940403,202641,true,1584357519,28,1567809620,-16547899
1674940439,202642,true,1584199099,28,1567652855,-16546244
1674940523,202644,true,1583882306,28,1567339372,-16542934
1674943499,202646,true,1583565577,28,1565146741,-18418836
1674944711,202649,true,1583090603,28,1565146741,-17943862
1674948023,202650,true,1582932309,28,1564677291,-18255018
1674948155,202652,true,1582615771,28,1564833759,-17782012
1674948575,202654,true,1582299295,28,1564833759,-17465536
1674949031,202657,true,1581824700,28,1564990242,-16834458
1674949427,202658,true,1581666533,28,1565303256,-16363277
1674950135,202660,true,1581350247,28,1565772894,-15577353
1674950171,202662,true,1581034025,28,1565772894,-15261131
1674950183,202664,true,1580717865,28,1565772894,-14944971
1674950303,202665,true,1580559809,28,1566086064,-14473745
1674951959,202666,true,1580401769,28,1569378136,-11023633
1674952271,202668,true,1580085736,28,1569378136,-10707600
1674952355,202671,true,1579611805,28,1569535074,-10076731
1674952379,202671,true,1579611805,28,1569535074,-10076731
1674952391,202672,true,1579453860,28,1569535074,-9918786
1674952499,202674,true,1579138017,28,1569692027,-9445990
1674952511,202677,true,1578664370,28,1569848996,-8815374
1674952523,202677,true,1578664370,28,1569848996,-8815374
1674952547,202678,true,1578506519,28,1569848996,-8657523
1674952559,202679,true,1578348684,28,1570005981,-8342703
1674952571,202682,true,1577875275,28,1570005981,-7869294
1674952583,202682,true,1577875275,28,1570005981,-7869294
1674952739,202682,true,1577875275,28,1570948220,-6927055
1674952763,202684,true,1577559747,28,1571105315,-6454432
1674953459,202686,true,1577244282,28,1575510354,-1733928
1674953627,202686,true,1577244282,28,1576613542,-630740
1674953663,202686,true,1577244282,28,1576928881,-315401
1674954239,202687,true,1577086574,28,1581034025,3947451
1674954251,202689,true,1576771204,28,1581192128,4420924
1674954275,202689,true,1576771204,28,1581350247,4579043
1674954323,202689,true,1576771204,28,1581666533,4895329
1674954335,202689,true,1576771204,28,1581824700,5053496
1674954371,202691,true,1576455897,28,1581982882,5526985
1674954383,202691,true,1576455897,28,1582141081,5685184
1674954395,202690,true,1576613542,28,1582299295,5685753
1674954407,202689,true,1576771204,28,1582299295,5528091
1674954431,202690,true,1576613542,28,1582615771,6002229
1674954467,202689,true,1576771204,28,1583090603,6319399
1674954491,202688,true,1576928881,28,1583248912,6320031
1674954791,202687,true,1577086574,28,1587211787,10125213
1674955055,202687,true,1577086574,28,1590548267,13461693
1674955067,202687,true,1577086574,28,1590707322,13620748
1674955103,202686,true,1577244282,28,1591184582,13940300
1674955127,202684,true,1577559747,28,1591661985,14102238
1674955211,202684,true,1577559747,28,1592935761,15376014
1674955223,202683,true,1577717503,28,1593254364,15536861
1674955247,202681,true,1578033062,28,1593573031,15539969
1674955463,202678,true,1578506519,28,1597561748,19055229
1674955475,202677,true,1578664370,28,1597721504,19057134
1674955499,202676,true,1578822236,28,1598041064,19218828
1674956171,202675,true,1578980119,28,1608461640,29481521
1674956291,202672,true,1579453860,28,1609266032,29812172
1674957179,202671,true,1579611805,28,1612165174,32553369
1674957191,202670,true,1579769767,28,1612165174,32395407
1674957203,202669,true,1579927744,28,1612165174,32237430
1674957227,202666,true,1580401769,28,1612165174,31763405
1674957251,202666,true,1580401769,28,1612003974,31602205
1674957275,202665,true,1580559809,28,1612003974,31444165
1674957419,202664,true,1580717865,28,1611681621,30963756
1674957959,202661,true,1581192128,28,1610392856,29200728
1674957971,202660,true,1581350247,28,1610392856,29042609
1674957983,202659,true,1581508382,28,1610231833,28723451
1674958055,202657,true,1581824700,28,1609909835,28085135
1674958091,202655,true,1582141081,28,1609748860,27607779
1674958103,202654,true,1582299295,28,1609587901,27288606
1674958115,202652,true,1582615771,28,1609426958,26811187
1674958163,202652,true,1582615771,28,1608944227,26328456
1674958883,202651,true,1582774032,28,1599639824,16865792
1674959183,202649,true,1583090603,28,1596284273,13193670
1674959627,202648,true,1583248912,28,1592139532,8890620
1674960851,202647,true,1583407237,28,1590866393,7459156
1674964691,202646,true,1583565577,28,1590707322,7141745
1674964811,202644,true,1583882306,28,1590866393,6984087
1674964967,202643,true,1584040695,28,1590866393,6825698
1674965015,202642,true,1584199099,28,1590866393,6667294
1674966767,202641,true,1584357519,28,1591343701,6986182
1674967343,202639,true,1584674406,28,1591343701,6669295
1674967355,202638,true,1584832873,28,1591502835,6669962
1674967679,202637,true,1584991357,28,1591502835,6511478
1674967691,202636,true,1585149856,28,1591502835,6352979
1674967715,202635,true,1585308371,28,1591661985,6353614
1674967907,202633,true,1585625448,28,1591821152,6195704
1674968099,202633,true,1585625448,28,1592139532,6514084
1674968915,202631,true,1585942589,28,1593573031,7630442
1674972983,202630,true,1586101183,28,1594688866,8587683
1674973655,202629,true,1586259794,28,1594688866,8429072
1674973943,202628,true,1586418420,28,1594688866,8270446
1674977531,202627,true,1586577061,28,1594688866,8111805
1674977939,202626,true,1586735719,28,1594529413,7793694
1674980723,202624,true,1587053082,28,1593732388,6679306
1674984515,202624,true,1587053082,28,1593732388,6679306
1674984527,202623,true,1587211787,28,1593891761,6679974
1674984539,202622,true,1587370509,28,1593891761,6521252
1674984551,202620,true,1587687999,28,1593891761,6203762
1674984803,202619,true,1587846767,28,1594369976,6523209
1674985019,202618,true,1588005552,28,1594848335,6842783
1674985031,202617,true,1588164353,28,1595007820,6843467
1674985103,202615,true,1588482001,28,1595167321,6685320
1674986483,202613,true,1588799714,28,1599479876,10680162
1674986735,202612,true,1588958594,28,1599799788,10841194
1674986747,202610,true,1589276401,28,1599799788,10523387
1674986759,202609,true,1589435329,28,1599799788,10364459
1674986783,202607,true,1589753232,28,1599959768,10206536
1674986891,202604,true,1590230206,28,1600279776,10049570
1674987011,202602,true,1590548267,28,1600759908,10211641
1674987659,202600,true,1590866393,28,1603483378,12616985
1674987671,202598,true,1591184582,28,1603483378,12298796
1674987683,202595,true,1591661985,28,1603483378,11821393
1674989903,202592,true,1592139532,28,1609748860,17609328
1674990263,202590,true,1592457976,28,1609748860,17290884
1674990299,202588,true,1592776483,28,1609909835,17133352
1674991379,202586,true,1593095054,28,1605408617,12313563
1674991391,202583,true,1593573031,28,1605408617,11835586
1674991787,202582,true,1593732388,28,1603964471,10232083
1674992183,202579,true,1594210555,28,1602842145,8631590
1674992243,202577,true,1594529413,28,1602842145,8312732
1674993251,202574,true,1595007820,28,1604285280,9277460
1674993887,202573,true,1595167321,28,1605248092,10080771
1674995627,202570,true,1595645919,28,1606211482,10565563
1674996563,202568,true,1595965064,28,1606211482,10246418
1674996611,202565,true,1596443901,28,1606372103,9928202
1674996647,202564,true,1596603546,28,1606372103,9768557
1674996695,202562,true,1596922883,28,1606372103,9449220
1674996731,202559,true,1597402007,28,1606372103,8970096
1674996755,202556,true,1597881276,28,1606372103,8490827
1674996791,202555,true,1598041064,28,1606532740,8491676
1674997007,202553,true,1598360688,28,1606854063,8493375
1674997499,202551,true,1598680376,28,1607818416,9138040
1674997739,202548,true,1599160028,28,1608300810,9140782
1674997763,202547,true,1599319944,28,1608300810,8980866
1674997787,202545,true,1599639824,28,1608461640,8821816
1674997799,202543,true,1599959768,28,1608461640,8501872
1674997811,202540,true,1600439804,28,1608461640,8021836
1674997823,202539,true,1600599848,28,1608622486,8022638
1674998315,202536,true,1601080076,28,1612003974,10923898
1674998339,202534,true,1601400308,28,1612165174,10764866
1674999479,202532,true,1601720604,28,1618464579,16743975
1674999563,202530,true,1602040964,28,1618788288,16747324
1675000727,202528,true,1602361389,28,1618302749,15941360
1675001975,202526,true,1602681877,28,1617493840,14811963
1675001987,202524,true,1603002429,28,1617493840,14491411
1675002011,202522,true,1603323046,28,1617332107,14009061
1675002179,202520,true,1603643727,28,1617008689,13364962
1675002407,202520,true,1603643727,28,1616200427,12556700
1675003367,202518,true,1603964471,28,1612810137,8845666
1675003547,202517,true,1604124868,28,1612165174,8040306
1675003739,202516,true,1604285280,28,1611520469,7235189
1675004483,202516,true,1604285280,28,1610876022,6590742
1675005419,202515,true,1604445709,28,1611359333,6913624
1675005551,202515,true,1604445709,28,1611359333,6913624
1675008635,202513,true,1604766614,28,1611681621,6915007
1675010027,202515,true,1604445709,28,1611681621,7235912
1675010879,202513,true,1604766614,28,1611359333,6592719
1675010891,202513,true,1604766614,28,1611359333,6592719
1675010903,202512,true,1604927091,28,1611359333,6432242
1675011503,202513,true,1604766614,28,1612003974,7237360
1675011623,202512,true,1604927091,28,1612003974,7076883
1675012907,202512,true,1604927091,28,1613616703,8689612
1675013891,202511,true,1605087583,28,1613616703,8529120
1675014515,202513,true,1604766614,28,1613616703,8850089
1675014527,202512,true,1604927091,28,1613778065,8850974
1675014563,202512,true,1604927091,28,1613778065,8850974
1675014887,202510,true,1605248092,28,1614262247,9014155
1675017203,202512,true,1604927091,28,1616200427,11273336
1675017503,202511,true,1605087583,28,1616523683,11436100
1675017515,202511,true,1605087583,28,1616523683,11436100
1675017551,202509,true,1605408617,28,1616685336,11276719
1675017611,202510,true,1605248092,28,1616847004,11598912
1675017683,202509,true,1605408617,28,1617008689,11600072
1675017695,202509,true,1605408617,28,1617008689,11600072
1675017719,202507,true,1605729715,28,1617008689,11278974
1675017767,202507,true,1605729715,28,1617332107,11602392
1675017779,202506,true,1605890288,28,1617332107,11441819
1675017923,202505,true,1606050877,28,1617979137,11928260
1675018151,202503,true,1606372103,28,1619112062,12739959
1675018199,202502,true,1606532740,28,1619435901,12903161
1675018343,202500,true,1606854063,28,1620245781,13391718
1675018379,202499,true,1607014748,28,1620407805,13393057
1675019159,202496,true,1607496901,28,1625601155,18104254
1675019255,202494,true,1607818416,28,1626251493,18433077
1675019279,202492,true,1608139996,28,1626414119,18274123
1675019303,202491,true,1608300810,28,1626576760,18275950
1675019363,202486,true,1609105121,28,1627064782,17959661
1675019447,202484,true,1609426958,28,1627715705,18288747
1675019507,202482,true,1609748860,28,1628204069,18455209
1675019687,202481,true,1609909835,28,1629181236,19271401
1675019699,202477,true,1610553895,28,1629344154,18790259
1675019711,202475,true,1610876022,28,1629344154,18468132
1675019783,202472,true,1611359333,28,1630158989,18799656
1675019795,202470,true,1611681621,28,1630322005,18640384
1675019819,202465,true,1612487623,28,1630485037,17997414
1675019939,202463,true,1612810137,28,1631953061,19142924
1675020011,202460,true,1613294028,28,1632769200,19475172
1675020263,202458,true,1613616703,28,1635383591,21766888
1675020419,202454,true,1614262247,28,1637019711,22757464
1675020563,202451,true,1614746574,28,1638493618,23747044
1675020635,202449,true,1615069539,28,1639313029,24243490
1675020659,202446,true,1615554109,28,1639476960,23922851
1675020671,202442,true,1616200427,28,1639640908,23440481
1675020683,202439,true,1616685336,28,1639804872,23119536
1675020695,202437,true,1617008689,28,1639968852,22960163
1675020779,202433,true,1617655590,28,1641281287,23625697
1675021103,202428,true,1618464579,28,1646047672,27583093
1675021199,202426,true,1618788288,28,1647200251,28411963
1675021667,202423,true,1619273973,28,1651653478,32379505
1675021763,202419,true,1619921780,28,1652149024,32227244
1675022531,202416,true,1620407805,28,1655622009,35214204
1675022555,202413,true,1620893976,28,1655456463,34562487
1675022567,202410,true,1621380293,28,1655456463,34076170
1675022579,202407,true,1621866756,28,1655290934,33424178
1675022927,202405,true,1622191145,28,1653636553,31445408
1675024499,202403,true,1622515600,28,1647035548,24519948
1675025171,202400,true,1623002403,28,1647200251,24197848
1675025207,202397,true,1623489353,28,1647200251,23710898
1675025243,202395,true,1623814067,28,1647200251,23386184
1675025279,202394,true,1623976448,28,1647035548,23059100
1675025375,202391,true,1624463690,28,1647035548,22571858
1675025459,202388,true,1624951078,28,1646870861,21919783
1675025627,202387,true,1625113573,28,1646541536,21427963
1675025663,202385,true,1625438612,28,1646541536,21102924
1675025675,202384,true,1625601155,28,1646376898,20775743
1675026923,202383,true,1625763716,28,1636856025,11092309
1675027031,202381,true,1626088885,28,1636201447,10112562
1675027055,202380,true,1626251493,28,1636037843,9786350
1675027355,202377,true,1626739418,28,1634239280,7499862
1675027739,202376,true,1626902092,28,1633749107,6847015
1675027775,202374,true,1627227488,28,1633912482,6684994
1675027871,202373,true,1627390211,28,1633912482,6522271
1675027919,202371,true,1627715705,28,1634075873,6360168
1675027931,202369,true,1628041265,28,1634075873,6034608
1675028039,202368,true,1628204069,28,1634402704,6198635
1675028159,202366,true,1628529726,28,1634729601,6199875
1675028303,202363,true,1629018334,28,1635220069,6201735
1675028603,202362,true,1629181236,28,1636201447,7020211
1675028615,202360,true,1629507088,28,1636201447,6694359
1675028651,202359,true,1629670039,28,1636365067,6695028
1675028687,202356,true,1630158989,28,1636528703,6369714
1675028699,202355,true,1630322005,28,1636528703,6206698
1675028795,202353,true,1630648085,28,1637019711,6371626
1675029551,202351,true,1630974231,28,1640460892,9486661
1675030175,202349,true,1631300442,28,1641937898,10637456
1675031087,202347,true,1631626719,28,1642266302,10639583
1675033019,202346,true,1631789882,28,1642266302,10476420
1675033403,202344,true,1632116256,28,1642430528,10314272
1675033739,202343,true,1632279467,28,1642594771,10315304
1675033751,202341,true,1632605940,28,1642759031,10153091
1675033763,202341,true,1632605940,28,1642759031,10153091
1675034135,202338,true,1633095770,28,1643909307,10813537
1675034207,202336,true,1633422406,28,1644238106,10815700
1675035131,202335,true,1633585748,28,1647529708,13943960
1675035143,202334,true,1633749107,28,1647529708,13780601
1675035179,202332,true,1634075873,28,1647529708,13453835
1675035203,202329,true,1634566145,28,1647694461,13128316
1675036031,202328,true,1634729601,28,1647859230,13129629
1675036859,202328,true,1634729601,28,1647035548,12305947
1675036919,202324,true,1635383591,28,1646870861,11487270
1675037891,202322,true,1635710684,28,1646870861,11160177
1675037903,202320,true,1636037843,28,1646870861,10833018
1675037915,202320,true,1636037843,28,1646870861,10833018
1675037939,202316,true,1636692356,28,1646870861,10178505
1675037963,202314,true,1637019711,28,1646870861,9851150
1675037975,202313,true,1637183413,28,1646870861,9687448
1675039127,202313,true,1637183413,28,1643580575,6397162
1675040531,202310,true,1637674617,28,1641773720,4099103
1675041335,202308,true,1638002168,28,1642102092,4099924
1675041551,202307,true,1638165969,28,1642266302,4100333
1675041563,202306,true,1638329785,28,1642266302,3936517
1675041635,202303,true,1638821333,28,1642266302,3444969
1675041647,202302,true,1638985215,28,1642266302,3281087
1675041743,202301,true,1639149114,28,1642102092,2952978
1675044383,202301,true,1639149114,28,1639640908,491794
1675044491,202297,true,1639804872,28,1639640908,-163964
1675044551,202296,true,1639968852,28,1639640908,-327944
1675044695,202295,true,1640132849,28,1639476960,-655889
1675044707,202295,true,1640132849,28,1639476960,-655889
1675045571,202293,true,1640460892,28,1638329785,-2131107
1675046291,202291,true,1640789001,28,1637347131,-3441870
1675047563,202290,true,1640953080,28,1637183413,-3769667
1675048487,202291,true,1640789001,28,1637183413,-3605588
1675048715,202288,true,1641281287,28,1637183413,-4097874
1675049387,202287,true,1641445415,28,1637183413,-4262002
1675051043,202287,true,1641445415,28,1637183413,-4262002
1675051727,202287,true,1641445415,28,1637183413,-4262002
1675053635,202285,true,1641773720,28,1637019711,-4754009
1675054463,202284,true,1641937898,28,1637019711,-4918187
1675054595,202284,true,1641937898,28,1637019711,-4918187
1675055147,202284,true,1641937898,28,1637019711,-4918187
1675055159,202283,true,1642102092,28,1637019711,-5082381
1675055171,202282,true,1642266302,28,1637019711,-5246591
1675056167,202281,true,1642430528,28,1637019711,-5410817
1675056371,202282,true,1642266302,28,1637019711,-5246591
1675056791,202281,true,1642430528,28,1637019711,-5410817
1675060835,202280,true,1642594771,28,1636856025,-5738746
1675060847,202280,true,1642594771,28,1636856025,-5738746
1675060859,202281,true,1642430528,28,1636856025,-5574503
1675060883,202280,true,1642594771,28,1636856025,-5738746
1675060955,202280,true,1642594771,28,1636692356,-5902415
1675061063,202280,true,1642594771,28,1636365067,-6229704
1675061975,202282,true,1642266302,28,1633912482,-8353820
1675062767,202281,true,1642430528,28,1631953061,-10477467
1675063079,202281,true,1642430528,28,1631953061,-10477467
1675063211,202283,true,1642102092,28,1631953061,-10149031
1675063355,202285,true,1641773720,28,1631953061,-9820659
1675063391,202283,true,1642102092,28,1631953061,-10149031
1675063403,202284,true,1641937898,28,1631953061,-9984837
1675063811,202286,true,1641609559,28,1631137329,-10472230
1675063823,202288,true,1641281287,28,1630974231,-10307056
1675067135,202287,true,1641445415,28,1628041265,-13404150
1675067147,202289,true,1641117175,28,1628041265,-13075910
1675067171,202290,true,1640953080,28,1628041265,-12911815
1675067351,202293,true,1640460892,28,1627715705,-12745187
1675067363,202293,true,1640460892,28,1627715705,-12745187
1675067699,202294,true,1640296863,28,1626739418,-13557445
1675068431,202297,true,1639804872,28,1624301260,-15503612
1675068527,202300,true,1639313029,28,1623976448,-15336581
1675068647,202300,true,1639313029,28,1623489353,-15823676
1675069391,202302,true,1638985215,28,1622191145,-16794070
1675069415,202305,true,1638493618,28,1622028942,-16464676
1675069427,202307,true,1638165969,28,1622028942,-16137027
1675069463,202307,true,1638165969,28,1621866756,-16299213
1675069511,202311,true,1637510866,28,1621542431,-15968435
1675069559,202314,true,1637019711,28,1621380293,-15639418
1675069619,202315,true,1636856025,28,1621056066,-15799959
1675069631,202315,true,1636856025,28,1620893976,-15962049
1675069655,202318,true,1636365067,28,1620731903,-15633164
1675069679,202322,true,1635710684,28,1620569846,-15140838
1675069751,202323,true,1635547130,28,1620083772,-15463358
1675069763,202323,true,1635547130,28,1620083772,-15463358
1675069775,202326,true,1635056564,28,1619921780,-15134784
1675069787,202330,true,1634402704,28,1619759804,-14642900
1675069799,202331,true,1634239280,28,1619759804,-14479476
1675070075,202332,true,1634075873,28,1617170390,-16905483
1675070111,202335,true,1633585748,28,1616847004,-16738744
1675070123,202336,true,1633422406,28,1616685336,-16737070
1675070135,202338,true,1633095770,28,1616523683,-16572087
1675070279,202339,true,1632932477,28,1614423673,-18508804
1675070303,202343,true,1632279467,28,1614100837,-18178630
1675070411,202344,true,1632116256,28,1612648872,-19467384
1675070567,202346,true,1631789882,28,1610553895,-21235987
1675071263,202348,true,1631463573,28,1601400308,-30063265
1675071491,202351,true,1630974231,28,1599639824,-31334407
1675071503,202353,true,1630648085,28,1599479876,-31168209
1675071539,202355,true,1630322005,28,1599319944,-31002061
1675071551,202357,true,1629995989,28,1599160028,-30835961
1675071563,202360,true,1629507088,28,1599160028,-30347060
1675071611,202363,true,1629018334,28,1598840244,-30178090
1675071743,202365,true,1628692579,28,1597881276,-30811303
1675071995,202367,true,1628366889,28,1596603546,-31763343
1675072007,202371,true,1627715705,28,1596603546,-31112159
1675072031,202373,true,1627390211,28,1596603546,-30786665
1675072355,202375,true,1627064782,28,1595645919,-31418863
1675072379,202378,true,1626576760,28,1595645919,-30930841
1675072391,202382,true,1625926292,28,1595486370,-30439922
1675072463,202384,true,1625601155,28,1595167321,-30433834
1675072547,202387,true,1625113573,28,1594848335,-30265238
1675072559,202389,true,1624788599,28,1594848335,-29940264
1675072583,202393,true,1624138846,28,1594688866,-29449980
1675072619,202396,true,1623651701,28,1594369976,-29281725
1675073615,202399,true,1623164703,28,1589117490,-34047213
1675073639,202403,true,1622515600,28,1588958594,-33557006
1675073675,202407,true,1621866756,28,1588958594,-32908162
1675073699,202410,true,1621380293,28,1588799714,-32580579
1675073963,202413,true,1620893976,28,1588164353,-32729623
1675073987,202416,true,1620407805,28,1588164353,-32243452
1675074095,202420,true,1619759804,28,1588005552,-31754252
1675074119,202422,true,1619435901,28,1588005552,-31430349
1675074671,202425,true,1618950167,28,1588640850,-30309317
1675074755,202428,true,1618464579,28,1588799714,-29664865
1675075151,202432,true,1617817355,28,1589594272,-28223083
1675075859,202435,true,1617332107,28,1590707322,-26624785
1675075871,202438,true,1616847004,28,1590707322,-26139682
1675075895,202441,true,1616362047,28,1590707322,-25654725
1675075931,202444,true,1615877236,28,1590707322,-25169914
1675075979,202447,true,1615392569,28,1590548267,-24844302
1675076147,202450,true,1614908049,28,1589753232,-25154817
1675076339,202454,true,1614262247,28,1588958594,-25303653
1675076963,202457,true,1613778065,28,1586101183,-27676882
1675078271,202460,true,1613294028,28,1582457525,-30836503
1675079063,202463,true,1612810137,28,1582615771,-30194366
1675079075,202467,true,1612165174,28,1582615771,-29549403
1675079159,202471,true,1611520469,28,1582615771,-28904698
1675080059,202473,true,1611198213,28,1583248912,-27949301
1675080071,202476,true,1610714951,28,1583248912,-27466039
1675082375,202480,true,1610070826,28,1580717865,-29352961
1675082435,202483,true,1609587901,28,1580717865,-28870036
1675082447,202486,true,1609105121,28,1580717865,-28387256
1675082471,202489,true,1608622486,28,1580717865,-27904621
1675082951,202494,true,1607818416,28,1578822236,-28996180
1675084151,202498,true,1607175450,28,1574407938,-32767512
1675084487,202500,true,1606854063,28,1574250513,-32603550
1675084667,202503,true,1606372103,28,1574407938,-31964165
1675084679,202508,true,1605569158,28,1574407938,-31161220
1675084691,202511,true,1605087583,28,1574407938,-30679645
1675085015,202514,true,1604606153,28,1574722835,-29883318
1675085075,202516,true,1604285280,28,1574880307,-29404973
1675085159,202521,true,1603483378,28,1574880307,-28603071
1675086839,202525,true,1602842145,28,1576928881,-25913264
1675087643,202527,true,1602521625,28,1576928881,-25592744
1675087919,202530,true,1602040964,28,1576928881,-25112083
1675087931,202534,true,1601400308,28,1577086574,-24313734
1675087955,202538,true,1600759908,28,1577086574,-23673334
1675087967,202540,true,1600439804,28,1577086574,-23353230
1675087979,202543,true,1599959768,28,1577086574,-22873194
1675088099,202547,true,1599319944,28,1577244282,-22075662
1675088195,202551,true,1598680376,28,1577559747,-21120629
1675088783,202553,true,1598360688,28,1579138017,-19222671
1675088807,202555,true,1598041064,28,1579295930,-18745134
1675089095,202559,true,1597402007,28,1580085736,-17316271
1675089131,202562,true,1596922883,28,1580243745,-16679138
1675089203,202564,true,1596603546,28,1580559809,-16043737
1675089875,202566,true,1596284273,28,1583090603,-13193670
1675089911,202570,true,1595645919,28,1583090603,-12555316
1675090079,202572,true,1595326838,28,1583407237,-11919601
1675090091,202574,true,1595007820,28,1583565577,-11442243
1675090103,202576,true,1594688866,28,1583565577,-11123289
1675090151,202580,true,1594051150,28,1583723934,-10327216
1675090211,202582,true,1593732388,28,1583882306,-9850082
1675090295,202583,true,1593573031,28,1584199099,-9373932
1675090427,202585,true,1593254364,28,1584674406,-8579958
1675090583,202589,true,1592617221,28,1585308371,-7308850
1675090595,202591,true,1592298746,28,1585308371,-6990375
1675090727,202592,true,1592139532,28,1585942589,-6196943
1675090775,202593,true,1591980334,28,1586101183,-5879151
1675090787,202596,true,1591502835,28,1586259794,-5243041
1675090799,202598,true,1591184582,28,1586259794,-4924788
1675090931,202599,true,1591025480,28,1586894393,-4131087
1675090943,202600,true,1590866393,28,1587053082,-3813311
1675091651,202603,true,1590389229,28,1590071198,-318031
1675092347,202605,true,1590071198,28,1591821152,1749954
1675092371,202606,true,1589912207,28,1591821152,1908945
1675092455,202607,true,1589753232,28,1591821152,2067920
1675092551,202610,true,1589276401,28,1591980334,2703933
1675092719,202610,true,1589276401,28,1591821152,2544751
1675092731,202611,true,1589117490,28,1591821152,2703662
1675092767,202612,true,1588958594,28,1591821152,2862558
1675092791,202615,true,1588482001,28,1591821152,3339151
1675092815,202615,true,1588482001,28,1591821152,3339151
1675093019,202616,true,1588323169,28,1591343701,3020532
1675093067,202616,true,1588323169,28,1591184582,2861413
1675093235,202620,true,1587687999,28,1590707322,3019323
1675093271,202620,true,1587687999,28,1590548267,2860268
1675093283,202621,true,1587529246,28,1590548267,3019021
1675093295,202621,true,1587529246,28,1590389229,2859983
1675093331,202624,true,1587053082,28,1590230206,3177124
1675093343,202625,true,1586894393,28,1590230206,3335813
1675093391,202626,true,1586735719,28,1589912207,3176488
1675093403,202626,true,1586735719,28,1589753232,3017513
1675094375,202628,true,1586418420,28,1583090603,-3327817
1675094387,202629,true,1586259794,28,1583090603,-3169191
1675094999,202630,true,1586101183,28,1580243745,-5857438
1675095035,202630,true,1586101183,28,1580085736,-6015447
1675095047,202632,true,1585784011,28,1580085736,-5698275
1675095119,202633,true,1585625448,28,1579927744,-5697704
1675095155,202633,true,1585625448,28,1579927744,-5697704
1675095167,202634,true,1585466902,28,1579927744,-5539158
1675095215,202636,true,1585149856,28,1580085736,-5064120
1675095299,202636,true,1585149856,28,1580243745,-4906111
1675095323,202636,true,1585149856,28,1580401769,-4748087
1675095395,202636,true,1585149856,28,1580559809,-4590047
1675095407,202638,true,1584832873,28,1580559809,-4273064
1675095419,202638,true,1584832873,28,1580559809,-4273064
1675096331,202638,true,1584832873,28,1583882306,-950567
1675096703,202638,true,1584832873,28,1584991357,158484
1675097699,202639,true,1584674406,28,1585942589,1268183
1675097723,202639,true,1584674406,28,1585942589,1268183
1675098047,202639,true,1584674406,28,1585625448,951042
1675099271,202639,true,1584674406,28,1584040695,-633711
1675100663,202641,true,1584357519,28,1583565577,-791942
1675101863,202640,true,1584515954,28,1583565577,-950377
1675101899,202640,true,1584515954,28,1583565577,-950377
1675101995,202640,true,1584515954,28,1583565577,-950377
1675102019,202641,true,1584357519,28,1583565577,-791942
1675102043,202641,true,1584357519,28,1583565577,-791942
1675102223,202641,true,1584357519,28,1583407237,-950282
1675103567,202641,true,1584357519,28,1582615771,-1741748
1675103579,202643,true,1584040695,28,1582615771,-1424924
1675104143,202643,true,1584040695,28,1582141081,-1899614
1675104155,202643,true,1584040695,28,1582141081,-1899614
1675104167,202643,true,1584040695,28,1581982882,-2057813
1675104179,202645,true,1583723934,28,1581982882,-1741052
1675104263,202645,true,1583723934,28,1581824700,-1899234
1675104323,202645,true,1583723934,28,1581824700,-1899234
1675104395,202646,true,1583565577,28,1581666533,-1899044
1675105643,202648,true,1583248912,28,1579295930,-3952982
1675105667,202648,true,1583248912,28,1579295930,-3952982
1675105703,202647,true,1583407237,28,1579295930,-4111307
1675105715,202647,true,1583407237,28,1579138017,-4269220
1675105727,202649,true,1583090603,28,1579138017,-3952586
1675105751,202649,true,1583090603,28,1579138017,-3952586
1675105763,202649,true,1583090603,28,1578980119,-4110484
1675105787,202649,true,1583090603,28,1578980119,-4110484
1675105799,202651,true,1582774032,28,1578822236,-3951796
1675105811,202652,true,1582615771,28,1578664370,-3951401
1675105823,202653,true,1582457525,28,1578506519,-3951006
1675105847,202654,true,1582299295,28,1578190865,-4108430
1675105859,202657,true,1581824700,28,1578033062,-3791638
1675105883,202659,true,1581508382,28,1577559747,-3948635
1675105895,202660,true,1581350247,28,1577244282,-4105965
1675105967,202663,true,1580875937,28,1575667905,-5208032
1675106003,202664,true,1580717865,28,1575037795,-5680070
1675106027,202666,true,1580401769,28,1574565379,-5836390
1675106039,202667,true,1580243745,28,1574250513,-5993232
1675106255,202669,true,1579927744,28,1570319998,-9607746
1675106279,202671,true,1579611805,28,1569848996,-9762809
1675106315,202673,true,1579295930,28,1569221214,-10074716
1675106327,202674,true,1579138017,28,1569064307,-10073710
1675107083,202675,true,1578980119,28,1557652412,-21327707
1675107143,202676,true,1578822236,28,1556718148,-22104088
1675108463,202679,true,1578348684,28,1552520888,-25827796
1675108907,202679,true,1578348684,28,1552676140,-25672544
1675110071,202680,true,1578190865,28,1552676140,-25514725
1675110083,202682,true,1577875275,28,1552676140,-25199135
1675110119,202684,true,1577559747,28,1552676140,-24883607
1675110131,202685,true,1577402007,28,1552676140,-24725867
1675110143,202687,true,1577086574,28,1552676140,-24410434
1675110215,202690,true,1576613542,28,1552210430,-24403112
1675110455,202693,true,1576140653,28,1550814139,-25326514
1675110707,202694,true,1575983054,28,1549574046,-26409008
1675110731,202696,true,1575667905,28,1549419104,-26248801
1675110743,202698,true,1575352819,28,1549419104,-25933715
1675110815,202702,true,1574722835,28,1549109267,-25613568
1675110995,202702,true,1574722835,28,1548334944,-26387891
1675111043,202704,true,1574407938,28,1548180126,-26227812
1675111319,202707,true,1573935710,28,1547096833,-26838877
1675111871,202710,true,1573463624,28,1545241523,-28222101
1675112087,202711,true,1573306293,28,1545550587,-27755706
1675112183,202713,true,1572991679,28,1545859713,-27131966
1675112423,202716,true,1572519876,28,1546478149,-26041727
1675112435,202719,true,1572048214,28,1546478149,-25570065
1675112507,202720,true,1571891025,28,1546787461,-25103564
1675112519,202722,true,1571576694,28,1546787461,-24789233
1675112531,202725,true,1571105315,28,1546787461,-24317854
1675112579,202728,true,1570634078,28,1547096833,-23537245
1675112603,202729,true,1570477030,28,1547096833,-23380197
1675112687,202731,true,1570162982,28,1547561009,-22601973
1675112735,202734,true,1569692027,28,1547715765,-21976262
1675112963,202737,true,1569221214,28,1548644627,-20576587
1675113023,202737,true,1569221214,28,1548954371,-20266843
1675113035,202739,true,1568907417,28,1549109267,-19798150
1675113107,202742,true,1568436838,28,1549419104,-19017734
1675113119,202745,true,1567966401,28,1549419104,-18547297
1675113143,202746,true,1567809620,28,1549574046,-18235574
1675113215,202748,true,1567496106,28,1550038965,-17457141
1675113611,202750,true,1567182653,28,1552055225,-15127428
1675113671,202753,true,1566712593,28,1552365651,-14346942
1675114019,202754,true,1566555937,28,1554074107,-12481830
1675114151,202755,true,1566399297,28,1554695830,-11703467
1675114799,202758,true,1565929471,28,1556406851,-9522620
1675118399,202760,true,1565616332,28,1556718148,-8898184
1675118423,202761,true,1565459786,28,1556718148,-8741638
1675118435,202763,true,1565146741,28,1556718148,-8428593
1675118531,202765,true,1564833759,28,1556406851,-8426908
1675118591,202768,true,1564364403,28,1556251226,-8113177
1675119335,202767,true,1564520839,28,1557652412,-6868427
1675120475,202769,true,1564207982,28,1559834544,-4373438
1675120739,202771,true,1563895187,28,1559834544,-4060643
1675120799,202774,true,1563426112,28,1559990527,-3435585
1675120823,202772,true,1563738813,28,1559990527,-3748286
1675120835,202774,true,1563426112,28,1559990527,-3435585
1675120931,202775,true,1563269786,28,1559990527,-3279259
1675121423,202778,true,1562800898,28,1560614617,-2186281
1675122011,202776,true,1563113474,28,1561551220,-1562254
1675122035,202778,true,1562800898,28,1561551220,-1249678
1675122119,202779,true,1562644634,28,1561707375,-937259
1675122143,202782,true,1562175934,28,1561707375,-468559
1675122191,202780,true,1562488385,28,1561863546,-624839
1675122299,202782,true,1562175934,28,1562019732,-156202
1675124411,202783,true,1562019732,28,1563582455,1562723
1675124495,202786,true,1561551220,28,1563738813,2187593
1675124507,202785,true,1561707375,28,1563738813,2031438
1675125359,202786,true,1561551220,28,1564677291,3126071
1675126223,202788,true,1561238957,28,1565616332,4377375
1675126235,202790,true,1560926756,28,1565616332,4689576
1675126247,202789,true,1561082848,28,1565616332,4533484
1675126307,202791,true,1560770679,28,1565929471,5158792
1675126559,202791,true,1560770679,28,1566399297,5628618
1675127111,202794,true,1560302541,28,1567496106,7193565
1675128815,202793,true,1560458571,28,1569378136,8919565
1675129331,202794,true,1560302541,28,1569064307,8761766
1675129355,202795,true,1560146526,28,1569064307,8917781
1675129463,202797,true,1559834544,28,1569221214,9386670
1675131299,202796,true,1559990527,28,1570319998,10329471
1675131335,202797,true,1559834544,28,1570477030,10642486
1675131383,202798,true,1559678576,28,1570477030,10798454
1675131671,202800,true,1559366687,28,1570634078,11267391
1675133459,202799,true,1559522624,28,1572205419,12682795
1675133687,202800,true,1559366687,28,1572205419,12838732
1675134587,202800,true,1559366687,28,1572205419,12838732
1675135163,202802,true,1559054861,28,1572205419,13150558
1675135175,202801,true,1559210766,28,1572205419,12994653
1675135907,202802,true,1559054861,28,1572205419,13150558
1675136231,202802,true,1559054861,28,1572048214,12993353
1675136435,202804,true,1558743096,28,1572048214,13305118
1675138163,202803,true,1558898971,28,1570791141,11892170
1675141019,202803,true,1558898971,28,1570634078,11735107
1675141175,202804,true,1558743096,28,1570634078,11890982
1675141391,202806,true,1558431394,28,1570634078,12202684
1675141703,202805,true,1558587238,28,1570634078,12046840
1675142003,202805,true,1558587238,28,1570634078,12046840
1675142063,202805,true,1558587238,28,1570634078,12046840
1675144211,202807,true,1558275567,28,1570634078,12358511
1675144583,202806,true,1558431394,28,1570634078,12202684
1675144607,202806,true,1558431394,28,1570634078,12202684
1675144619,202806,true,1558431394,28,1570477030,12045636
1675144631,202807,true,1558275567,28,1570477030,12201463
1675144667,202805,true,1558587238,28,1570477030,11889792
1675145111,202805,true,1558587238,28,1569378136,10790898
1675145183,202804,true,1558743096,28,1569221214,10478118
1675145555,202804,true,1558743096,28,1568280010,9536914
1675145603,202801,true,1559210766,28,1568123198,8912432
1675146071,202800,true,1559366687,28,1567025951,7659264
1675146431,202798,true,1559678576,28,1566399297,6720721
1675147727,202799,true,1559522624,28,1566242673,6720049
1675148579,202796,true,1559990527,28,1566242673,6252146
1675148783,202795,true,1560146526,28,1566399297,6252771
1675150403,202794,true,1560302541,28,1566712593,6410052
1675150583,202794,true,1560302541,28,1566712593,6410052
1675150715,202791,true,1560770679,28,1566869264,6098585
1675150727,202791,true,1560770679,28,1566869264,6098585
1675150895,202790,true,1560926756,28,1567025951,6099195
1675151147,202790,true,1560926756,28,1567182653,6255897
1675151171,202788,true,1561238957,28,1567182653,5943696
1675151183,202788,true,1561238957,28,1567182653,5943696
1675151219,202786,true,1561551220,28,1567339372,5788152
1675151255,202786,true,1561551220,28,1567339372,5788152
1675151291,202783,true,1562019732,28,1567496106,5476374
1675151459,202783,true,1562019732,28,1568123198,6103466
1675151531,202780,true,1562488385,28,1568436838,5948453
1675151639,202779,true,1562644634,28,1568907417,6262783
1675151711,202776,true,1563113474,28,1569221214,6107740
1675151939,202775,true,1563269786,28,1570319998,7050212
1675151951,202773,true,1563582455,28,1570319998,6737543
1675152035,202772,true,1563738813,28,1570791141,7052328
1675152083,202769,true,1564207982,28,1570948220,6740238
1675152095,202768,true,1564364403,28,1571105315,6740912
1675152107,202766,true,1564677291,28,1571105315,6428024
1675152323,202765,true,1564833759,28,1572519876,7686117
1675152983,202762,true,1565303256,28,1576455897,11152641
1675153823,202761,true,1565459786,28,1578664370,13204584
1675153859,202759,true,1565772894,28,1578664370,12891476
1675153883,202758,true,1565929471,28,1578664370,12734899
1675153907,202755,true,1566399297,28,1578664370,12265073
1675153979,202754,true,1566555937,28,1578664370,12108433
1675154063,202752,true,1566869264,28,1578506519,11637255
1675154375,202752,true,1566869264,28,1578190865,11321601
1675154399,202749,true,1567339372,28,1578190865,10851493
1675154459,202749,true,1567339372,28,1578033062,10693690
1675154591,202747,true,1567652855,28,1577875275,10222420
1675154615,202746,true,1567809620,28,1577875275,10065655
1675154807,202744,true,1568123198,28,1577402007,9278809
1675154891,202744,true,1568123198,28,1577244282,9121084
1675154915,202742,true,1568436838,28,1577244282,8807444
1675154927,202742,true,1568436838,28,1577086574,8649736
1675154975,202740,true,1568750541,28,1576928881,8178340
1675157135,202740,true,1568750541,28,1572048214,3297673
1675158587,202738,true,1569064307,28,1572048214,2983907
1675161491,202738,true,1569064307,28,1572048214,2983907
1675162691,202737,true,1569221214,28,1572048214,2827000
1675162703,202737,true,1569221214,28,1572048214,2827000
1675164899,202735,true,1569535074,28,1570791141,1256067
1675166279,202735,true,1569535074,28,1570319998,784924
1675168115,202733,true,1569848996,28,1570162982,313986
1675168331,202733,true,1569848996,28,1570162982,313986
1675168403,202732,true,1570005981,28,1570319998,314017
1675168919,202731,true,1570162982,28,1570319998,157016
1675169819,202731,true,1570162982,28,1570634078,471096
1675170059,202731,true,1570162982,28,1570791141,628159
1675170575,202729,true,1570477030,28,1570948220,471190
1675170683,202728,true,1570634078,28,1570948220,314142
1675170815,202728,true,1570634078,28,1571105315,471237
1675170959,202728,true,1570634078,28,1571105315,471237
1675170983,202727,true,1570791141,28,1571105315,314174
1675171151,202726,true,1570948220,28,1571419552,471332
1675171811,202725,true,1571105315,28,1572677128,1571813
1675171835,202726,true,1570948220,28,1572677128,1728908
1675171931,202724,true,1571262426,28,1573148978,1886552
1675172183,202723,true,1571419552,28,1574250513,2830961
1675172411,202722,true,1571576694,28,1575510354,3933660
1675172459,202722,true,1571576694,28,1575825472,4248778
1675172507,202720,true,1571891025,28,1576140653,4249628
1675173623,202719,true,1572048214,28,1582299295,10251081
1675173683,202717,true,1572362639,28,1582457525,10094886
1675173695,202717,true,1572362639,28,1582615771,10253132
1675173707,202716,true,1572519876,28,1582615771,10095895
1675173719,202714,true,1572834395,28,1582615771,9781376
1675174247,202713,true,1572991679,28,1584040695,11049016
1675174463,202713,true,1572991679,28,1584199099,11207420
1675174583,202713,true,1572991679,28,1584357519,11365840
1675175315,202711,true,1573306293,28,1584515954,11209661
1675179059,202709,true,1573620970,28,1584199099,10578129
1675179299,202710,true,1573463624,28,1584515954,11052330
1675179311,202709,true,1573620970,28,1584515954,10894984
1675179323,202708,true,1573778332,28,1584515954,10737622
1675179371,202706,true,1574093103,28,1584674406,10581303
1675179455,202705,true,1574250513,28,1584832873,10582360
1675179479,202705,true,1574250513,28,1584832873,10582360
1675180991,202703,true,1574565379,28,1590389229,15823850
1675183031,202701,true,1574880307,28,1590707322,15827015
1675183043,202701,true,1574880307,28,1590866393,15986086
1675183079,202701,true,1574880307,28,1590866393,15986086
1675183091,202699,true,1575195299,28,1591025480,15830181
1675183103,202696,true,1575667905,28,1591025480,15357575
1675183475,202695,true,1575825472,28,1592776483,16951011
1675183523,202695,true,1575825472,28,1593095054,17269582
1675183547,202693,true,1576140653,28,1593095054,16954401
1675183595,202690,true,1576613542,28,1593254364,16640822
1675183763,202689,true,1576771204,28,1593891761,17120557
1675184003,202689,true,1576771204,28,1594848335,18077131
1675184015,202686,true,1577244282,28,1594848335,17604053
1675184219,202684,true,1577559747,28,1595486370,17926623
1675184591,202683,true,1577717503,28,1596763206,19045703
1675184735,202683,true,1577717503,28,1597082575,19365072
1675184951,202681,true,1578033062,28,1597242283,19209221
1675185155,202678,true,1578506519,28,1596763206,18256687
1675185167,202677,true,1578664370,28,1596763206,18098836
1675186115,202677,true,1578664370,28,1595167321,16502951
1675188467,202675,true,1578980119,28,1594369976,15389857
1675188707,202672,true,1579453860,28,1594369976,14916116
1675192715,202671,true,1579611805,28,1594369976,14758171
1675192787,202671,true,1579611805,28,1594369976,14758171
1675193087,202669,true,1579927744,28,1594369976,14442232
1675194347,202666,true,1580401769,28,1593732388,13330619
1675194383,202665,true,1580559809,28,1593732388,13172579
1675194779,202665,true,1580559809,28,1593732388,13172579
1675196999,202663,true,1580875937,28,1594529413,13653476
1675197023,202659,true,1581508382,28,1594529413,13021031
1675197155,202659,true,1581508382,28,1594529413,13021031
1675197179,202658,true,1581666533,28,1594529413,12862880
1675197191,202657,true,1581824700,28,1594529413,12704713
1675197239,202654,true,1582299295,28,1594369976,12070681
1675197263,202653,true,1582457525,28,1594210555,11753030
1675197815,202654,true,1582299295,28,1592617221,10317926
1675197971,202652,true,1582615771,28,1591980334,9364563
1675199855,202649,true,1583090603,28,1588799714,5709111
1675199879,202649,true,1583090603,28,1588799714,5709111
1675199891,202649,true,1583090603,28,1588640850,5550247
1675200239,202648,true,1583248912,28,1585625448,2376536
1675200263,202648,true,1583248912,28,1585466902,2217990
1675200275,202648,true,1583248912,28,1585308371,2059459
1675200455,202649,true,1583090603,28,1583882306,791703
1675200935,202648,true,1583248912,28,1580243745,-3005167
1675200983,202648,true,1583248912,28,1579927744,-3321168
1675200995,202648,true,1583248912,28,1579769767,-3479145
1675201019,202649,true,1583090603,28,1579611805,-3478798
1675202363,202648,true,1583248912,28,1574093103,-9155809
1675202879,202648,true,1583248912,28,1573778332,-9470580
1675202939,202649,true,1583090603,28,1573935710,-9154893
1675204031,202649,true,1583090603,28,1574407938,-8682665
1675205291,202649,true,1583090603,28,1574565379,-8525224
1675205315,202649,true,1583090603,28,1574722835,-8367768
1675205327,202650,true,1582932309,28,1574722835,-8209474
1675205351,202650,true,1582932309,28,1574722835,-8209474
1675205363,202649,true,1583090603,28,1574722835,-8367768
1675205471,202648,true,1583248912,28,1575510354,-7738558
1675205483,202648,true,1583248912,28,1575667905,-7581007
1675206059,202647,true,1583407237,28,1581982882,-1424355
1675206071,202646,true,1583565577,28,1582141081,-1424496
1675206083,202644,true,1583882306,28,1582141081,-1741225
1675206095,202644,true,1583882306,28,1582299295,-1583011
1675206215,202644,true,1583882306,28,1583407237,-475069
1675206239,202642,true,1584199099,28,1583565577,-633522
1675206431,202641,true,1584357519,28,1585149856,792337
1675207031,202641,true,1584357519,28,1589594272,5236753
1675207079,202640,true,1584515954,28,1589912207,5396253
1675210283,202639,true,1584674406,28,1586735719,2061313
1675210319,202638,true,1584832873,28,1586735719,1902846
1675211435,202638,true,1584832873,28,1586577061,1744188
1675211459,202637,true,1584991357,28,1586577061,1585704
1675213031,202637,true,1584991357,28,1582932309,-2059048
1675214495,202635,true,1585308371,28,1582299295,-3009076
1675214795,202635,true,1585308371,28,1582299295,-3009076
1675214807,202635,true,1585308371,28,1582299295,-3009076
1675215155,202634,true,1585466902,28,1582299295,-3167607
1675215803,202632,true,1585784011,28,1582299295,-3484716
1675215815,202633,true,1585625448,28,1582457525,-3167923
1675215851,202632,true,1585784011,28,1582457525,-3326486
1675215875,202631,true,1585942589,28,1582457525,-3485064
1675216043,202629,true,1586259794,28,1582615771,-3644023
1675216055,202629,true,1586259794,28,1582615771,-3644023
1675217123,202628,true,1586418420,28,1586101183,-317237
1675217627,202628,true,1586418420,28,1587529246,1110826
1675218215,202626,true,1586735719,28,1588005552,1269833
1675218455,202626,true,1586735719,28,1587846767,1111048
1675218551,202625,true,1586894393,28,1587846767,952374
1675218575,202624,true,1587053082,28,1587846767,793685
1675220039,202623,true,1587211787,28,1587053082,-158705
1675220075,202623,true,1587211787,28,1587053082,-158705
1675221167,202622,true,1587370509,28,1587053082,-317427
1675221623,202622,true,1587370509,28,1587053082,-317427
1675221683,202621,true,1587529246,28,1587053082,-476164
1675221947,202621,true,1587529246,28,1586894393,-634853
1675221959,202620,true,1587687999,28,1586894393,-793606
1675221983,202621,true,1587529246,28,1586894393,-634853
1675221995,202620,true,1587687999,28,1586894393,-793606
1675222271,202621,true,1587529246,28,1586577061,-952185
1675222463,202620,true,1587687999,28,1586259794,-1428205
1675222487,202621,true,1587529246,28,1586259794,-1269452
1675222955,202620,true,1587687999,28,1585466902,-2221097
1675229051,202621,true,1587529246,28,1584040695,-3488551
1675229507,202620,true,1587687999,28,1584040695,-3647304
1675231067,202621,true,1587529246,28,1581508382,-6020864
1675231883,202621,true,1587529246,28,1581034025,-6495221
1675232495,202622,true,1587370509,28,1581034025,-6336484
1675234583,202621,true,1587529246,28,1580875937,-6653309
1675234643,202622,true,1587370509,28,1580875937,-6494572
1675234703,202622,true,1587370509,28,1580875937,-6494572
1675234823,202623,true,1587211787,28,1580717865,-6493922
1675234871,202623,true,1587211787,28,1580717865,-6493922
1675234883,202625,true,1586894393,28,1580559809,-6334584
1675234931,202625,true,1586894393,28,1580401769,-6492624
1675235255,202627,true,1586577061,28,1579295930,-7281131
1675235879,202627,true,1586577061,28,1577244282,-9332779
1675238771,202628,true,1586418420,28,1574722835,-11695585
1675239743,202630,true,1586101183,28,1574722835,-11378348
1675239959,202633,true,1585625448,28,1574722835,-10902613
1675240019,202632,true,1585784011,28,1574722835,-11061176
1675240043,202634,true,1585466902,28,1574722835,-10744067
1675240091,202636,true,1585149856,28,1574722835,-10427021
1675240127,202638,true,1584832873,28,1574722835,-10110038
1675240979,202638,true,1584832873,28,1573463624,-11369249
1675242563,202640,true,1584515954,28,1572362639,-12153315
1675243511,202641,true,1584357519,28,1572048214,-12309305
1675243811,202644,true,1583882306,28,1572048214,-11834092
1675244207,202644,true,1583882306,28,1571891025,-11991281
1675245047,202645,true,1583723934,28,1571733852,-11990082
1675246895,202647,true,1583407237,28,1571733852,-11673385
1675249007,202649,true,1583090603,28,1571733852,-11356751
1675249691,202649,true,1583090603,28,1571891025,-11199578
1675249727,202650,true,1582932309,28,1571891025,-11041284
1675249739,202652,true,1582615771,28,1571891025,-10724746
1675249751,202654,true,1582299295,28,1571891025,-10408270
1675250003,202653,true,1582457525,28,1572205419,-10252106
1675250519,202655,true,1582141081,28,1572677128,-9463953
1675250567,202656,true,1581982882,28,1572834395,-9148487
1675250591,202658,true,1581666533,28,1572834395,-8832138
1675250675,202658,true,1581666533,28,1572991679,-8674854
1675250687,202659,true,1581508382,28,1573148978,-8359404
1675250771,202660,true,1581350247,28,1573306293,-8043954
1675250855,202662,true,1581034025,28,1573620970,-7413055
1675250879,202662,true,1581034025,28,1573778332,-7255693
1675251023,202662,true,1581034025,28,1574250513,-6783512
1675251179,202664,true,1580717865,28,1574880307,-5837558
1675251959,202665,true,1580559809,28,1577402007,-3157802
1675254971,202664,true,1580717865,28,1578980119,-1737746
1675256879,202665,true,1580559809,28,1578980119,-1579690
1675257323,202666,true,1580401769,28,1578980119,-1421650
1675257383,202667,true,1580243745,28,1579138017,-1105728
1675257647,202666,true,1580401769,28,1579453860,-947909
1675257731,202666,true,1580401769,28,1579611805,-789964
1675257935,202664,true,1580717865,28,1580085736,-632129
1675259591,202665,true,1580559809,28,1583565577,3005768
1675262111,202664,true,1580717865,28,1583565577,2847712
1675262747,202664,true,1580717865,28,1583090603,2372738
1675262759,202662,true,1581034025,28,1583090603,2056578
1675263815,202663,true,1580875937,28,1583248912,2372975
1675263863,202662,true,1581034025,28,1583248912,2214887
1675266491,202662,true,1581034025,28,1582615771,1581746
1675266503,202660,true,1581350247,28,1582615771,1265524
1675266539,202661,true,1581192128,28,1582615771,1423643
1675266575,202660,true,1581350247,28,1582615771,1265524
1675266671,202661,true,1581192128,28,1582457525,1265397
1675266803,202659,true,1581508382,28,1582299295,790913
1675266875,202660,true,1581350247,28,1582141081,790834
1675266983,202659,true,1581508382,28,1581824700,316318
1675270451,202661,true,1581192128,28,1577875275,-3316853
1675270859,202660,true,1581350247,28,1577559747,-3790500
1675272479,202662,true,1581034025,28,1576455897,-4578128
1675273631,202663,true,1580875937,28,1576298267,-4577670
1675273679,202664,true,1580717865,28,1576298267,-4419598
1675273691,202664,true,1580717865,28,1576298267,-4419598
1675274699,202666,true,1580401769,28,1574250513,-6151256
1675275179,202667,true,1580243745,28,1573306293,-6937452
1675275311,202668,true,1580085736,28,1573148978,-6936758
1675275767,202668,true,1580085736,28,1572677128,-7408608
1675276115,202670,true,1579769767,28,1572519876,-7249891
1675276127,202670,true,1579769767,28,1572519876,-7249891
1675276151,202672,true,1579453860,28,1572519876,-6933984
1675276163,202672,true,1579453860,28,1572519876,-6933984
1675276175,202673,true,1579295930,28,1572677128,-6618802
1675277255,202672,true,1579453860,28,1576455897,-2997963
1675277927,202673,true,1579295930,28,1579138017,-157913
1675278011,202673,true,1579295930,28,1579295930,0
1675278023,202673,true,1579295930,28,1579295930,0
1675278047,202673,true,1579295930,28,1579138017,-157913
1675278083,202674,true,1579138017,28,1579138017,0
1675278095,202673,true,1579295930,28,1579138017,-157913
1675278131,202674,true,1579138017,28,1579295930,157913
1675278191,202673,true,1579295930,28,1579453860,157930
1675278215,202674,true,1579138017,28,1579453860,315843
1675278227,202674,true,1579138017,28,1579453860,315843
1675278323,202675,true,1578980119,28,1579453860,473741
1675278371,202675,true,1578980119,28,1579453860,473741
1675278383,202675,true,1578980119,28,1579453860,473741
1675278491,202676,true,1578822236,28,1579295930,473694
1675278515,202677,true,1578664370,28,1579138017,473647
1675278527,202677,true,1578664370,28,1579138017,473647
1675279103,202678,true,1578506519,28,1579138017,631498
1675279847,202678,true,1578506519,28,1578822236,315717
1675279859,202679,true,1578348684,28,1578822236,473552
1675279895,202679,true,1578348684,28,1578822236,473552
1675279907,202679,true,1578348684,28,1578822236,473552
1675279919,202680,true,1578190865,28,1578822236,631371
1675279931,202682,true,1577875275,28,1578664370,789095
1675279955,202682,true,1577875275,28,1578506519,631244
1675279967,202683,true,1577717503,28,1578348684,631181
1675279991,202685,true,1577402007,28,1578190865,788858
1675280015,202686,true,1577244282,28,1577875275,630993
1675280123,202687,true,1577086574,28,1576771204,-315370
1675280195,202688,true,1576928881,28,1576455897,-472984
1675280207,202689,true,1576771204,28,1576298267,-472937
1675280219,202690,true,1576613542,28,1576298267,-315275
1675280231,202691,true,1576455897,28,1576298267,-157630
1675280243,202690,true,1576613542,28,1576298267,-315275
1675280255,202691,true,1576455897,28,1576298267,-157630
1675280303,202691,true,1576455897,28,1576298267,-157630
1675280315,202692,true,1576298267,28,1576455897,157630
1675280375,202691,true,1576455897,28,1576455897,0
1675280423,202691,true,1576455897,28,1576613542,157645
1675280435,202691,true,1576455897,28,1576613542,157645
1675280447,202691,true,1576455897,28,1576613542,157645
1675280459,202689,true,1576771204,28,1576771204,0
1675280471,202689,true,1576771204,28,1576771204,0
1675280483,202688,true,1576928881,28,1576928881,0
1675280495,202687,true,1577086574,28,1576928881,-157693
1675280507,202686,true,1577244282,28,1577086574,-157708
1675280531,202685,true,1577402007,28,1577244282,-157725
1675280567,202684,true,1577559747,28,1577559747,0
1675280579,202683,true,1577717503,28,1577559747,-157756
1675280591,202681,true,1578033062,28,1577717503,-315559
1675280615,202681,true,1578033062,28,1577875275,-157787
1675280627,202679,true,1578348684,28,1578033062,-315622
1675280663,202677,true,1578664370,28,1578664370,0
1675280675,202675,true,1578980119,28,1578822236,-157883
1675280867,202673,true,1579295930,28,1581666533,2370603
1675280879,202671,true,1579611805,28,1581982882,2371077
1675280903,202669,true,1579927744,28,1582299295,2371551
1675281107,202666,true,1580401769,28,1586101183,5699414
1675281119,202664,true,1580717865,28,1586418420,5700555
1675281131,202662,true,1581034025,28,1586577061,5543036
1675281155,202660,true,1581350247,28,1587053082,5702835
1675281167,202656,true,1581982882,28,1587370509,5387627
1675281179,202654,true,1582299295,28,1587687999,5388704
1675281215,202652,true,1582615771,28,1588482001,5866230
1675281227,202649,true,1583090603,28,1588799714,5709111
1675281239,202646,true,1583565577,28,1588958594,5393017
1675281263,202644,true,1583882306,28,1589594272,5711966
1675281311,202641,true,1584357519,28,1590866393,6508874
1675281467,202638,true,1584832873,28,1594688866,9855993
1675281503,202635,true,1585308371,28,1595486370,10177999
1675281527,202633,true,1585625448,28,1596124661,10499213
1675281755,202631,true,1585942589,28,1601720604,15778015
1675281767,202629,true,1586259794,28,1602040964,15781170
1675281779,202626,true,1586735719,28,1602521625,15785906
1675282043,202623,true,1587211787,28,1611037110,23825323
1675282055,202621,true,1587529246,28,1611359333,23830087
1675282115,202619,true,1587846767,28,1612810137,24963370
1675282379,202616,true,1588323169,28,1618302749,29979580
1675282391,202613,true,1588799714,28,1618464579,29664865
1675282427,202611,true,1589117490,28,1618950167,29832677
1675282583,202609,true,1589435329,28,1620245781,30810452
1675282679,202607,true,1589753232,28,1620893976,31140744
1675283147,202605,true,1590071198,28,1621866756,31795558
1675283159,202603,true,1590389229,28,1621866756,31477527
1675283183,202601,true,1590707322,28,1621866756,31159434
1675283219,202598,true,1591184582,28,1621866756,30682174
1675283243,202596,true,1591502835,28,1621866756,30363921
1675283291,202594,true,1591821152,28,1621866756,30045604
1675283315,202592,true,1592139532,28,1622028942,29889410
1675283327,202589,true,1592617221,28,1622028942,29411721
1675283411,202586,true,1593095054,28,1622515600,29420546
1675283423,202583,true,1593573031,28,1622515600,28942569
1675283447,202581,true,1593891761,28,1622677851,28786090
1675284515,202577,true,1594529413,28,1630648085,36118672
1675284611,202574,true,1595007820,28,1631626719,36618899
1675284659,202571,true,1595486370,28,1631953061,36466691
1675284671,202568,true,1595965064,28,1632116256,36151192
1675284683,202564,true,1596603546,28,1632116256,35512710
1675284779,202561,true,1597082575,28,1632932477,35849902
1675284923,202558,true,1597561748,28,1633749107,36187359
1675284935,202556,true,1597881276,28,1633912482,36031206
1675285091,202552,true,1598520524,28,1634729601,36209077
1675285319,202549,true,1599000128,28,1634729601,35729473
1675285355,202546,true,1599479876,28,1634566145,35086269
1675285391,202543,true,1599959768,28,1634566145,34606377
1675285523,202538,true,1600759908,28,1634402704,33642796
1675285535,202535,true,1601240184,28,1634402704,33162520
1675285571,202532,true,1601720604,28,1634402704,32682100
1675285595,202529,true,1602201169,28,1634402704,32201535
1675285643,202523,true,1603162730,28,1634566145,31403415
1675285667,202520,true,1603643727,28,1634729601,31085874
1675286075,202517,true,1604124868,28,1636365067,32240199
1675287059,202515,true,1604445709,28,1641609559,37163850
1675287839,202509,true,1605408617,28,1643251908,37843291
1675287947,202506,true,1605890288,28,1643251908,37361620
1675288019,202503,true,1606372103,28,1643251908,36879805
1675288043,202500,true,1606854063,28,1643251908,36397845
1675288151,202495,true,1607657650,28,1643087599,35429949
1675288163,202492,true,1608139996,28,1643087599,34947603
1675288187,202489,true,1608622486,28,1643087599,34465113
1675288259,202487,true,1608944227,28,1642759031,33814804
1675288643,202483,true,1609587901,28,1641773720,32185819
1675288991,202480,true,1610070826,28,1640296863,30226037
1675289003,202477,true,1610553895,28,1640296863,29742968
1675289063,202475,true,1610876022,28,1640132849,29256827
1675289075,202470,true,1611681621,28,1640132849,28451228
1675289615,202466,true,1612326391,28,1639476960,27150569
1675290083,202462,true,1612971418,28,1639804872,26833454
1675290491,202460,true,1613294028,28,1640624938,27330910
1675291475,202456,true,1613939443,28,1642266302,28326859
1675291499,202451,true,1614746574,28,1642266302,27519728
1675292039,202448,true,1615231046,28,1641609559,26378513
1675292615,202446,true,1615554109,28,1640624938,25070829
1675292831,202442,true,1616200427,28,1640460892,24260465
1675292987,202437,true,1617008689,28,1640132849,23124160
1675293719,202434,true,1617493840,28,1639968852,22475012
1675293755,202431,true,1617979137,28,1639968852,21989715
1675293803,202427,true,1618626426,28,1640132849,21506423
1675294199,202421,true,1619597844,28,1640624938,21027094
1675294307,202417,true,1620245781,28,1640789001,20543220
1675297343,202414,true,1620731903,28,1642430528,21698625
1675297427,202409,true,1621542431,28,1642594771,21052340
1675297523,202404,true,1622353364,28,1642923307,20569943
1675297595,202400,true,1623002403,28,1643251908,20249505
1675297907,202396,true,1623651701,28,1644566970,20915269
1675297991,202392,true,1624301260,28,1644895899,20594639
1675298039,202387,true,1625113573,28,1645224895,20111322
1675298183,202383,true,1625763716,28,1645883084,20119368
1675298207,202379,true,1626414119,28,1646047672,19633553
1675298447,202375,true,1627064782,28,1647859230,20794448
1675298459,202370,true,1627878477,28,1647859230,19980753
1675298495,202367,true,1628366889,28,1648518473,20151584
1675298507,202363,true,1629018334,28,1648683325,19664991
1675298579,202354,true,1630485037,28,1650497783,20012746
1675298663,202349,true,1631300442,28,1652479470,21179028
1675298711,202345,true,1631953061,28,1653801917,21848856
1675298831,202341,true,1632605940,28,1656946970,24341030
1675298891,202333,true,1633912482,28,1658604663,24692181
1675299023,202328,true,1634729601,28,1662091218,27361617
1675299071,202324,true,1635383591,28,1663255031,27871440
1675299539,202320,true,1636037843,28,1674268267,38230424
1675299695,202312,true,1637347131,28,1677955527,40608396
1675299719,202307,true,1638165969,28,1678626810,40460841
1675299743,202304,true,1638657468,28,1679130449,40472981
1675299827,202300,true,1639313029,28,1680978416,41665387
1675299995,202293,true,1640460892,28,1684512003,44051111
1675300487,202289,true,1641117175,28,1689910805,48793630
1675300619,202286,true,1641609559,28,1689741831,48132272
1675300643,202283,true,1642102092,28,1689572873,47470781
1675300655,202276,true,1643251908,28,1689572873,46320965
1675301423,202273,true,1643744933,28,1688559484,44814551
1675301435,202269,true,1644402529,28,1688559484,44156955
1675301447,202266,true,1644895899,28,1688390645,43494746
1675301471,202260,true,1645883084,28,1688390645,42507561
1675301483,202257,true,1646376898,28,1688221823,41844925
1675301543,202255,true,1646706190,28,1687884229,41178039
1675301663,202253,true,1647035548,28,1687546703,40511155
1675301831,202247,true,1648024016,28,1686871853,38847837
1675301915,202244,true,1648518473,28,1686534529,38016056
1675302263,202242,true,1648848193,28,1685017407,36169214
1675303667,202240,true,1649177979,28,1680642271,31464292
1675303691,202234,true,1650167733,28,1680474223,30306490
1675303739,202232,true,1650497783,28,1680474223,29976440
1675304543,202230,true,1650827899,28,1679970182,29142283
1675304591,202228,true,1651158081,28,1679970182,28812101
1675304603,202222,true,1652149024,28,1679970182,27821158
1675304651,202220,true,1652479470,28,1679802202,27322732
1675304675,202218,true,1652809983,28,1679802202,26992219
1675304699,202216,true,1653140561,28,1679802202,26661641
1675304723,202210,true,1654132694,28,1679802202,25669508
1675305311,202208,true,1654463537,28,1678291135,23827598
1675305443,202207,true,1654628983,28,1677955527,23326544
1675305455,202204,true,1655125421,28,1677955527,22830106
1675305587,202198,true,1656118745,28,1677452241,21333496
1675305599,202197,true,1656284357,28,1677452241,21167884
1675305623,202195,true,1656615630,28,1677284513,20668883
1675306799,202193,true,1656946970,28,1672762179,15815209
1675306811,202187,true,1657941387,28,1672762179,14820792
1675308059,202186,true,1658107181,28,1671257445,13150264
1675308119,202185,true,1658272992,28,1671257445,12984453
1675308143,202183,true,1658604663,28,1671257445,12652782
1675308323,202177,true,1659600074,28,1671257445,11657371
1675308791,202177,true,1659600074,28,1671090336,11490262
1675308947,202176,true,1659766034,28,1671257445,11491411
1675308983,202174,true,1660098004,28,1671257445,11159441
1675309271,202170,true,1660762143,28,1671424571,10662428
1675309355,202169,true,1660928219,28,1671424571,10496352
1675309475,202168,true,1661094312,28,1671591713,10497401
1675309511,202166,true,1661426547,28,1671591713,10165166
1675309703,202161,true,1662257427,28,1672093241,9835814
1675309895,202160,true,1662423653,28,1672427676,10004023
1675310471,202159,true,1662589895,28,1673598727,11008832
1675311347,202157,true,1662922430,28,1674938075,12015645
1675311407,202152,true,1663754057,28,1674938075,11184018
1675313147,202151,true,1663920433,28,1674603137,10682704
1675314119,202150,true,1664086825,28,1674435694,10348869
1675315319,202148,true,1664419659,28,1674435694,10016035
1675315739,202143,true,1665252035,28,1674435694,9183659
1675315859,202142,true,1665418560,28,1674435694,9017134
1675316699,202141,true,1665585102,28,1674435694,8850592
1675317047,202140,true,1665751660,28,1674435694,8684034
1675317155,202136,true,1666418061,28,1674435694,8017633
1675317467,202135,true,1666584703,28,1674435694,7850991
1675318295,202134,true,1666751361,28,1674435694,7684333
1675318331,202133,true,1666918036,28,1674435694,7517658
1675318343,202129,true,1667584904,28,1674435694,6850790
1675318379,202128,true,1667751662,28,1674435694,6684032
1675318391,202128,true,1667751662,28,1674435694,6684032
1675318559,202127,true,1667918437,28,1674100857,6182420
1675318823,202123,true,1668585705,28,1673598727,5013022
1675318847,202122,true,1668752563,28,1673598727,4846164
1675318859,202121,true,1668919439,28,1673431384,4511945
1675318871,202120,true,1669086331,28,1673431384,4345053
1675319003,202116,true,1669754065,28,1673096748,3342683
1675319039,202115,true,1669921041,28,1673096748,3175707
1675319063,202114,true,1670088033,28,1672929455,2841422
1675319075,202113,true,1670255042,28,1672929455,2674413
1675319087,202109,true,1670923244,28,1672929455,2006211
1675319111,202109,true,1670923244,28,1672762179,1838935
1675319963,202109,true,1670923244,28,1668752563,-2170681
1675321391,202108,true,1671090336,28,1666084827,-5005509
1675321775,202104,true,1671758873,28,1666084827,-5674046
1675322603,202104,true,1671758873,28,1665918236,-5840637
1675322843,202104,true,1671758873,28,1665751660,-6007213
1675322939,202103,true,1671926048,28,1665751660,-6174388
1675325099,202098,true,1672762179,28,1665418560,-7343619
1675325195,202098,true,1672762179,28,1665418560,-7343619
1675326599,202098,true,1672762179,28,1665585102,-7177077
1675327295,202097,true,1672929455,28,1665751660,-7177795
1675327331,202093,true,1673598727,28,1665751660,-7847067
1675327967,202093,true,1673598727,28,1665918236,-7680491
1675328531,202093,true,1673598727,28,1666084827,-7513900
1675328555,202092,true,1673766087,28,1666084827,-7681260
1675328579,202088,true,1674435694,28,1666084827,-8350867
1675328603,202088,true,1674435694,28,1666084827,-8350867
1675328867,202087,true,1674603137,28,1666584703,-8018434
1675330607,202088,true,1674435694,28,1669253239,-5182455
1675331783,202083,true,1675273079,28,1669253239,-6019840
1675331987,202084,true,1675105569,28,1669253239,-5852330
1675332167,202083,true,1675273079,28,1669420165,-5852914
1675334075,202084,true,1675105569,28,1669921041,-5184528
1675334603,202080,true,1675775711,28,1669921041,-5854670
1675334735,202080,true,1675775711,28,1669921041,-5854670
1675334891,202081,true,1675608150,28,1669921041,-5687109
1675335047,202081,true,1675608150,28,1669921041,-5687109
1675338407,202082,true,1675440606,28,1669921041,-5519565
1675338431,202083,true,1675273079,28,1669921041,-5352038
1675339451,202084,true,1675105569,28,1669921041,-5184528
1675341995,202085,true,1674938075,28,1669921041,-5017034
1675342163,202086,true,1674770598,28,1669921041,-4849557
1675342355,202087,true,1674603137,28,1670088033,-4515104
1675342439,202089,true,1674268267,28,1670088033,-4180234
1675342511,202089,true,1674268267,28,1670088033,-4180234
1675342535,202091,true,1673933464,28,1670088033,-3845431
1675342631,202092,true,1673766087,28,1670255042,-3511045
1675342679,202093,true,1673598727,28,1670255042,-3343685
1675342787,202094,true,1673431384,28,1670422067,-3009317
1675342991,202094,true,1673431384,28,1670589109,-2842275
1675343027,202095,true,1673264058,28,1670756168,-2507890
1675343051,202096,true,1673096748,28,1670756168,-2340580
1675343207,202097,true,1672929455,28,1670923244,-2006211
1675343855,202098,true,1672762179,28,1671926048,-836131
1675343987,202098,true,1672762179,28,1672093241,-668938
1675345763,202099,true,1672594919,28,1672594919,0
1675346087,202100,true,1672427676,28,1672594919,167243
1675347551,202101,true,1672260450,28,1672594919,334469
1675347563,202101,true,1672260450,28,1672762179,501729
1675347635,202102,true,1672093241,28,1672762179,668938
1675347671,202103,true,1671926048,28,1672929455,1003407
1675347731,202102,true,1672093241,28,1673096748,1003507
1675347779,202102,true,1672093241,28,1673096748,1003507
1675347899,202103,true,1671926048,28,1673598727,1672679
1675347911,202103,true,1671926048,28,1673598727,1672679
1675348619,202102,true,1672093241,28,1678123323,6030082
1675348643,202102,true,1672093241,28,1678291135,6197894
1675348763,202102,true,1672093241,28,1678962552,6869311
1675349063,202102,true,1672093241,28,1680642271,8549030
1675349087,202101,true,1672260450,28,1680642271,8381821
1675349123,202101,true,1672260450,28,1680810335,8549885
1675349135,202101,true,1672260450,28,1680810335,8549885
1675349147,202102,true,1672093241,28,1680810335,8717094
1675349303,202102,true,1672093241,28,1680810335,8717094
1675349507,202102,true,1672093241,28,1680474223,8380982
1675349555,202102,true,1672093241,28,1680306193,8212952
1675349831,202103,true,1671926048,28,1678626810,6700762
1675349855,202103,true,1671926048,28,1678458964,6532916
1675349867,202103,true,1671926048,28,1678291135,6365087
1675349891,202103,true,1671926048,28,1677955527,6029479
1675349903,202105,true,1671591713,28,1677787749,6196036
1675349927,202105,true,1671591713,28,1677452241,5860528
1675349963,202106,true,1671424571,28,1676949106,5524535
1675350059,202106,true,1671424571,28,1675440606,4016035
1675350191,202108,true,1671090336,28,1673766087,2675751
1675350635,202107,true,1671257445,28,1668418863,-2838582
1675350935,202108,true,1671090336,28,1665085526,-6004810
1675350947,202108,true,1671090336,28,1664919034,-6171302
1675351847,202110,true,1670756168,28,1660762143,-9994025
1675351859,202110,true,1670756168,28,1660928219,-9827949
1675351871,202110,true,1670756168,28,1660928219,-9827949
1675351895,202111,true,1670589109,28,1660928219,-9660890
1675351931,202112,true,1670422067,28,1660928219,-9493848
1675351979,202112,true,1670422067,28,1660928219,-9493848
1675352027,202113,true,1670255042,28,1661094312,-9160730
1675352087,202113,true,1670255042,28,1661260421,-8994621
1675352219,202114,true,1670088033,28,1661426547,-8661486
1675352279,202114,true,1670088033,28,1661592690,-8495343
1675352327,202114,true,1670088033,28,1661758849,-8329184
1675352411,202114,true,1670088033,28,1662091218,-7996815
1675352483,202116,true,1669754065,28,1662257427,-7496638
1675352543,202115,true,1669921041,28,1662589895,-7331146
1675353119,202115,true,1669921041,28,1665751660,-4169381
1675353131,202115,true,1669921041,28,1665918236,-4002805
1675353191,202117,true,1669587107,28,1666251436,-3335671
1675353203,202116,true,1669754065,28,1666418061,-3336004
1675353215,202116,true,1669754065,28,1666584703,-3169362
1675353227,202116,true,1669754065,28,1666584703,-3169362
1675353239,202116,true,1669754065,28,1666751361,-3002704
1675354019,202115,true,1669921041,28,1674435694,4514653
1675354307,202114,true,1670088033,28,1676613767,6525734
1675354391,202114,true,1670088033,28,1676949106,6861073
1675354679,202114,true,1670088033,28,1678458964,8370931
1675355123,202113,true,1670255042,28,1679802202,9547160
1675356419,202113,true,1670255042,28,1679298362,9043320
1675356983,202112,true,1670422067,28,1679298362,8876295
1675357055,202112,true,1670422067,28,1679298362,8876295
1675357223,202111,true,1670589109,28,1679130449,8541340
1675357331,202111,true,1670589109,28,1679130449,8541340
1675359647,202110,true,1670756168,28,1677452241,6696073
1675360571,202111,true,1670589109,28,1677452241,6863132
1675360979,202109,true,1670923244,28,1677619987,6696743
1675361687,202109,true,1670923244,28,1678962552,8039308
1675361699,202108,true,1671090336,28,1678962552,7872216
1675361735,202108,true,1671090336,28,1678962552,7872216
1675361759,202106,true,1671424571,28,1679130449,7705878
1675361771,202104,true,1671758873,28,1679298362,7539489
1675361855,202102,true,1672093241,28,1680474223,8380982
1675361879,202101,true,1672260450,28,1680810335,8549885
1675362143,202097,true,1672929455,28,1685522963,12593508
1675362167,202095,true,1673264058,28,1685860084,12596026
1675362383,202092,true,1673766087,28,1689741831,15975744
1675362395,202091,true,1673933464,28,1689910805,15977341
1675362563,202088,true,1674435694,28,1692447446,18011752
1675362599,202086,true,1674770598,28,1692955231,18184633
1675362611,202084,true,1675105569,28,1693124527,18018958
1675362623,202083,true,1675273079,28,1693293839,18020760
1675362971,202081,true,1675608150,28,1697701911,22093761
1675363439,202079,true,1675943289,28,1703142986,27199697
1675364639,202077,true,1676278494,28,1701781084,25502590
1675364879,202076,true,1676446122,28,1701440779,24994657
1675364891,202074,true,1676781428,28,1701440779,24659351
1675364987,202072,true,1677116801,28,1701270652,24153851
1675365047,202071,true,1677284513,28,1701100542,23816029
1675365059,202070,true,1677452241,28,1701100542,23648301
1675365071,202068,true,1677787749,28,1701100542,23312793
1675365083,202066,true,1678123323,28,1700930449,22807126
1675365095,202065,true,1678291135,28,1700930449,22639314
1675365119,202065,true,1678291135,28,1700930449,22639314
1675365131,202062,true,1678794673,28,1700760373,21965700
1675365143,202061,true,1678962552,28,1700760373,21797821
1675365167,202060,true,1679130449,28,1700590314,21459865
1675365239,202060,true,1679130449,28,1700080239,20949790
1675365263,202058,true,1679466291,28,1699910248,20443957
1675365407,202057,true,1679634238,28,1698890659,19256421
1675365443,202056,true,1679802202,28,1698720787,18918585
1675365551,202057,true,1679634238,28,1697701911,18067673
1675365563,202054,true,1680138179,28,1697701911,17563732
1675365623,202054,true,1680138179,28,1697023000,16884821
1675365635,202053,true,1680306193,28,1696853314,16547121
1675365671,202054,true,1680138179,28,1696513995,16375816
1675365743,202052,true,1680474223,28,1695665992,15191769
1675365755,202052,true,1680474223,28,1695496442,15022219
1675365791,202052,true,1680474223,28,1694987895,14513672
1675365839,202053,true,1680306193,28,1694310070,14003877
1675366427,202052,true,1680474223,28,1685522963,5048740
1675366979,202051,true,1680642271,28,1678626810,-2015461
1675369667,202051,true,1680642271,28,1672260450,-8381821
1675369895,202053,true,1680306193,28,1672427676,-7878517
1675369955,202052,true,1680474223,28,1672427676,-8046547
1675371179,202051,true,1680642271,28,1672427676,-8214595
1675371203,202052,true,1680474223,28,1672427676,-8046547
1675371371,202053,true,1680306193,28,1672594919,-7711274
1675371587,202052,true,1680474223,28,1672929455,-7544768
1675371707,202052,true,1680474223,28,1673096748,-7377475
1675371767,202052,true,1680474223,28,1673264058,-7210165
1675371791,202053,true,1680306193,28,1673264058,-7042135
1675371815,202054,true,1680138179,28,1673431384,-6706795
1675372007,202053,true,1680306193,28,1674435694,-5870499
1675372019,202053,true,1680306193,28,1674435694,-5870499
1675372031,202054,true,1680138179,28,1674435694,-5702485
1675372055,202054,true,1680138179,28,1674603137,-5535042
1675372079,202054,true,1680138179,28,1674603137,-5535042
1675372139,202054,true,1680138179,28,1674603137,-5535042
1675372163,202055,true,1679970182,28,1674603137,-5367045
1675372187,202054,true,1680138179,28,1674603137,-5535042
1675372331,202054,true,1680138179,28,1674435694,-5702485
1675373423,202054,true,1680138179,28,1674100857,-6037322
1675373435,202054,true,1680138179,28,1674100857,-6037322
1675373459,202054,true,1680138179,28,1673933464,-6204715
1675373555,202053,true,1680306193,28,1672929455,-7376738
1675373627,202056,true,1679802202,28,1672260450,-7541752
1675373651,202055,true,1679970182,28,1671926048,-8044134
1675373867,202054,true,1680138179,28,1669420165,-10718014
1675374143,202053,true,1680306193,28,1667751662,-12554531
1675374923,202055,true,1679970182,28,1662922430,-17047752
1675374935,202054,true,1680138179,28,1662922430,-17215749
1675374947,202054,true,1680138179,28,1662756154,-17382025
1675374983,202053,true,1680306193,28,1662589895,-17716298
1675375151,202056,true,1679802202,28,1661094312,-18707890
1675375163,202055,true,1679970182,28,1661094312,-18875870
1675375175,202054,true,1680138179,28,1660928219,-19209960
1675375187,202054,true,1680138179,28,1660762143,-19376036
1675375199,202058,true,1679466291,28,1660596083,-18870208
1675375211,202058,true,1679466291,28,1660430040,-19036251
1675375223,202059,true,1679298362,28,1660098004,-19200358
1675375247,202059,true,1679298362,28,1659766034,-19532328
1675375259,202064,true,1678458964,28,1659600074,-18858890
1675375283,202065,true,1678291135,28,1659268204,-19022931
1675375295,202065,true,1678291135,28,1659102294,-19188841
1675375307,202066,true,1678123323,28,1658936400,-19186923
1675375751,202070,true,1677452241,28,1654298107,-23154134
1675376219,202070,true,1677452241,28,1649177979,-28274262
1675376231,202071,true,1677284513,28,1649013078,-28271435
1675376315,202072,true,1677116801,28,1648188818,-28927983
1675376351,202076,true,1676446122,28,1647859230,-28586892
1675376375,202076,true,1676446122,28,1647529708,-28916414
1675376399,202077,true,1676278494,28,1647364971,-28913523
1675376423,202078,true,1676110883,28,1647035548,-29075335
1675376471,202082,true,1675440606,28,1646706190,-28734416
1675376483,202083,true,1675273079,28,1646706190,-28566889
1675376771,202084,true,1675105569,28,1644731426,-30374143
1675377323,202085,true,1674938075,28,1645224895,-29713180
1675377527,202088,true,1674435694,28,1646047672,-28388022
1675377599,202090,true,1674100857,28,1646376898,-27723959
1675377635,202090,true,1674100857,28,1646541536,-27559321
1675377779,202091,true,1673933464,28,1647364971,-26568493
1675377935,202095,true,1673264058,28,1648188818,-25075240
1675377959,202096,true,1673096748,28,1648353637,-24743111
1675378355,202096,true,1673096748,28,1650332750,-22763998
1675378379,202097,true,1672929455,28,1650332750,-22596705
1675378415,202100,true,1672427676,28,1650497783,-21929893
1675380095,202100,true,1672427676,28,1657112665,-15315011
1675380203,202100,true,1672427676,28,1657278376,-15149300
1675380299,202101,true,1672260450,28,1657278376,-14982074
1675380383,202104,true,1671758873,28,1657112665,-14646208
1675380455,202105,true,1671591713,28,1657112665,-14479048
1675380515,202106,true,1671424571,28,1656946970,-14477601
1675380563,202108,true,1671090336,28,1656946970,-14143366
1675380575,202113,true,1670255042,28,1656946970,-13308072
1675380611,202115,true,1669921041,28,1656781292,-13139749
1675380767,202119,true,1669253239,28,1655622009,-13631230
1675380803,202121,true,1668919439,28,1655456463,-13462976
1675380815,202126,true,1668085229,28,1655290934,-12794295
1675381523,202129,true,1667584904,28,1650827899,-16757005
1675382183,202132,true,1667084728,28,1646541536,-20543192
1675382219,202134,true,1666751361,28,1646376898,-20374463
1675382663,202139,true,1665918236,28,1645224895,-20693341
1675383035,202141,true,1665585102,28,1644895899,-20689203
1675383743,202144,true,1665085526,28,1644238106,-20847420
1675384391,202146,true,1664752559,28,1644238106,-20514453
1675384487,202152,true,1663754057,28,1644238106,-19515951
1675384511,202154,true,1663421356,28,1644238106,-19183250
1675384523,202156,true,1663088722,28,1644238106,-18850616
1675384571,202159,true,1662589895,28,1644073698,-18516197
1675384583,202164,true,1661758849,28,1644073698,-17685151
1675384619,202166,true,1661426547,28,1644073698,-17352849
1675384631,202169,true,1660928219,28,1643909307,-17018912
1675384835,202171,true,1660596083,28,1643251908,-17344175
1675384895,202176,true,1659766034,28,1643087599,-16678435
1675384907,202178,true,1659434131,28,1643087599,-16346532
1675384919,202181,true,1658936400,28,1643087599,-15848801
1675384931,202183,true,1658604663,28,1642923307,-15681356
1675385531,202187,true,1657941387,28,1641937898,-16003489
1675385567,202189,true,1657609848,28,1641937898,-15671950
1675385639,202191,true,1657278376,28,1641773720,-15504656
1675385783,202194,true,1656781292,28,1641609559,-15171733
1675385891,202197,true,1656284357,28,1641445415,-14838942
1675386095,202199,true,1655953150,28,1641281287,-14671863
1675386167,202201,true,1655622009,28,1641117175,-14504834
1675386191,202203,true,1655290934,28,1641117175,-14173759
1675386251,202206,true,1654794446,28,1641117175,-13677271
1675386611,202207,true,1654628983,28,1642102092,-12526891
1675386623,202209,true,1654298107,28,1642102092,-12196015
1675386635,202211,true,1653967297,28,1642102092,-11865205
1675387595,202214,true,1653471206,28,1644238106,-9233100
1675387727,202214,true,1653471206,28,1644566970,-8904236
1675388063,202216,true,1653140561,28,1645060389,-8080172
1675388891,202217,true,1652975264,28,1645553957,-7421307
1675390163,202220,true,1652479470,28,1645883084,-6596386
1675391171,202220,true,1652479470,28,1645883084,-6596386
1675391279,202222,true,1652149024,28,1645883084,-6265940
1675391291,202223,true,1651983826,28,1645883084,-6100742
1675392119,202226,true,1651488330,28,1645224895,-6263435
1675392131,202226,true,1651488330,28,1645224895,-6263435
1675392143,202228,true,1651158081,28,1645224895,-5933186
1675392191,202229,true,1650992982,28,1645060389,-5932593
1675392203,202233,true,1650332750,28,1645060389,-5272361
1675392299,202234,true,1650167733,28,1644566970,-5600763
1675393883,202236,true,1649837749,28,1639476960,-10360789
1675393895,202238,true,1649507831,28,1639476960,-10030871
1675393931,202242,true,1648848193,28,1639313029,-9535164
1675393967,202243,true,1648683325,28,1639149114,-9534211
1675394099,202245,true,1648353637,28,1638985215,-9368422
1675394123,202247,true,1648024016,28,1638985215,-9038801
1675394291,202250,true,1647529708,28,1638657468,-8872240
1675395035,202251,true,1647364971,28,1637510866,-9854105
1675395815,202253,true,1647035548,28,1636201447,-10834101
1675396295,202255,true,1646706190,28,1636201447,-10504743
1675396499,202258,true,1646212277,28,1636201447,-10010830
1675396547,202259,true,1646047672,28,1636201447,-9846225
1675396583,202261,true,1645718512,28,1636201447,-9517065
1675396631,202262,true,1645553957,28,1636365067,-9188890
1675397771,202263,true,1645389418,28,1637347131,-8042287
1675397843,202264,true,1645224895,28,1637347131,-7877764
1675398023,202266,true,1644895899,28,1637674617,-7221282
1675398083,202267,true,1644731426,28,1637838385,-6893041
1675398095,202268,true,1644566970,28,1637838385,-6728585
1675398539,202268,true,1644566970,28,1638329785,-6237185
1675398623,202270,true,1644238106,28,1638493618,-5744488
1675403903,202271,true,1644073698,28,1640460892,-3612806
1675404779,202272,true,1643909307,28,1640460892,-3448415
1675406591,202272,true,1643909307,28,1640624938,-3284369
1675408187,202274,true,1643580575,28,1640624938,-2955637
1675408439,202275,true,1643416233,28,1640624938,-2791295
1675408451,202274,true,1643580575,28,1640789001,-2791574
1675408763,202274,true,1643580575,28,1640953080,-2627495
1675408919,202275,true,1643416233,28,1641117175,-2299058
1675409795,202274,true,1643580575,28,1642266302,-1314273
1675409903,202272,true,1643909307,28,1642266302,-1643005
1675410167,202272,true,1643909307,28,1642430528,-1478779
1675410239,202273,true,1643744933,28,1642430528,-1314405
1675410659,202273,true,1643744933,28,1642102092,-1642841
1675411583,202272,true,1643909307,28,1641117175,-2792132
1675411631,202272,true,1643909307,28,1641117175,-2792132
1675411703,202273,true,1643744933,28,1640953080,-2791853
1675411763,202273,true,1643744933,28,1640953080,-2791853
1675411811,202273,true,1643744933,28,1640953080,-2791853
1675411943,202273,true,1643744933,28,1640624938,-3119995
1675411955,202274,true,1643580575,28,1640624938,-2955637
1675411991,202275,true,1643416233,28,1640624938,-2791295
1675412003,202275,true,1643416233,28,1640624938,-2791295
1675413155,202275,true,1643416233,28,1638002168,-5414065
1675413239,202277,true,1643087599,28,1637674617,-5412982
1675415075,202277,true,1643087599,28,1637019711,-6067888
1675415171,202277,true,1643087599,28,1637183413,-5904186
1675415471,202278,true,1642923307,28,1637183413,-5739894
1675415639,202279,true,1642759031,28,1637183413,-5575618
1675415663,202280,true,1642594771,28,1637183413,-5411358
1675415987,202280,true,1642594771,28,1637347131,-5247640
1675417343,202280,true,1642594771,28,1638493618,-4101153
1675417619,202282,true,1642266302,28,1638657468,-3608834
1675417991,202283,true,1642102092,28,1638821333,-3280759
1675421027,202283,true,1642102092,28,1638985215,-3116877
1675421327,202284,true,1641937898,28,1639149114,-2788784
1675423175,202286,true,1641609559,28,1639968852,-1640707
1675423427,202287,true,1641445415,28,1639968852,-1476563
1675423535,202287,true,1641445415,28,1640132849,-1312566
1675423607,202288,true,1641281287,28,1640132849,-1148438
1675423847,202289,true,1641117175,28,1640460892,-656283
1675424003,202290,true,1640953080,28,1640624938,-328142
1675424435,202290,true,1640953080,28,1641281287,328207
1675424603,202290,true,1640953080,28,1641609559,656479
1675424651,202290,true,1640953080,28,1641773720,820640
1675425143,202290,true,1640953080,28,1642759031,1805951
1675425587,202290,true,1640953080,28,1643580575,2627495
1675425707,202290,true,1640953080,28,1643744933,2791853
1675425743,202291,true,1640789001,28,1643909307,3120306
1675425755,202290,true,1640953080,28,1643909307,2956227
1675425779,202290,true,1640953080,28,1643909307,2956227
1675426355,202289,true,1641117175,28,1646376898,5259723
1675426547,202289,true,1641117175,28,1647035548,5918373
1675428647,202289,true,1641117175,28,1650167733,9050558
1675429019,202288,true,1641281287,28,1650167733,8886446
1675429439,202288,true,1641281287,28,1651653478,10372191
1675430363,202287,true,1641445415,28,1654298107,12852692
1675430483,202287,true,1641445415,28,1654628983,13183568
1675430507,202286,true,1641609559,28,1654628983,13019424
1675430531,202285,true,1641773720,28,1654628983,12855263
1675430603,202285,true,1641773720,28,1654794446,13020726
1675430615,202284,true,1641937898,28,1654794446,12856548
1675430639,202282,true,1642266302,28,1654794446,12528144
1675430879,202282,true,1642266302,28,1654794446,12528144
1675430891,202282,true,1642266302,28,1654794446,12528144
1675430915,202281,true,1642430528,28,1654628983,12198455
1675431011,202280,true,1642594771,28,1654298107,11703336
1675431023,202280,true,1642594771,28,1654298107,11703336
1675431071,202280,true,1642594771,28,1653801917,11207146
1675431131,202280,true,1642594771,28,1653305875,10711104
1675431155,202281,true,1642430528,28,1653140561,10710033
1675431383,202280,true,1642594771,28,1651158081,8563310
1675431395,202281,true,1642430528,28,1650992982,8562454
1675431563,202281,true,1642430528,28,1648848193,6417665
1675431575,202282,true,1642266302,28,1648848193,6581891
1675431599,202283,true,1642102092,28,1648518473,6416381
1675431623,202283,true,1642102092,28,1648353637,6251545
1675431659,202283,true,1642102092,28,1648024016,5921924
1675431695,202283,true,1642102092,28,1647694461,5592369
1675431767,202283,true,1642102092,28,1647200251,5098159
1675431779,202284,true,1641937898,28,1647200251,5262353
1675431827,202283,true,1642102092,28,1646870861,4768769
1675431839,202283,true,1642102092,28,1646870861,4768769
1675431851,202284,true,1641937898,28,1646706190,4768292
1675431971,202284,true,1641937898,28,1645883084,3945186
1675431983,202284,true,1641937898,28,1645718512,3780614
1675432079,202284,true,1641937898,28,1645060389,3122491
1675432091,202284,true,1641937898,28,1644895899,2958001
1675432103,202285,true,1641773720,28,1644895899,3122179
1675432163,202285,true,1641773720,28,1644238106,2464386
1675432175,202285,true,1641773720,28,1644073698,2299978
1675432235,202285,true,1641773720,28,1643580575,1806855
1675432259,202285,true,1641773720,28,1643251908,1478188
1675434983,202285,true,1641773720,28,1634893074,-6880646
1675434995,202286,true,1641609559,28,1635056564,-6552995
1675435079,202286,true,1641609559,28,1635056564,-6552995
1675435103,202286,true,1641609559,28,1635056564,-6552995
1675435175,202285,true,1641773720,28,1635220069,-6553651
1675435235,202285,true,1641773720,28,1635383591,-6390129
1675435271,202285,true,1641773720,28,1635383591,-6390129
1675435295,202285,true,1641773720,28,1635547130,-6226590
1675435307,202285,true,1641773720,28,1635547130,-6226590
1675435331,202284,true,1641937898,28,1635710684,-6227214
1675435343,202284,true,1641937898,28,1635710684,-6227214
1675435379,202284,true,1641937898,28,1635874255,-6063643
1675435391,202283,true,1642102092,28,1636037843,-6064249
1675435427,202282,true,1642266302,28,1636201447,-6064855
1675435439,202282,true,1642266302,28,1636365067,-5901235
1675435559,202281,true,1642430528,28,1637347131,-5083397
1675435583,202280,true,1642594771,28,1637510866,-5083905
1675435595,202280,true,1642594771,28,1637674617,-4920154
1675435631,202279,true,1642759031,28,1638002168,-4756863
1675436807,202277,true,1643087599,28,1653801917,10714318
1675436843,202276,true,1643251908,28,1654298107,11046199
1675436867,202276,true,1643251908,28,1654628983,11377075
1675436975,202275,true,1643416233,28,1655787571,12371338
1675437419,202274,true,1643580575,28,1658272992,14692417
1675437431,202273,true,1643744933,28,1658272992,14528059
1675437443,202273,true,1643744933,28,1658272992,14528059
1675437479,202272,true,1643909307,28,1658272992,14363685
1675437491,202270,true,1644238106,28,1658272992,14034886
1675437503,202269,true,1644402529,28,1658438819,14036290
1675437791,202268,true,1644566970,28,1659268204,14701234
1675437827,202267,true,1644731426,28,1659434131,14702705
1675437863,202265,true,1645060389,28,1659600074,14539685
1675437911,202264,true,1645224895,28,1659766034,14541139
1675437983,202262,true,1645553957,28,1660264014,14710057
1675439831,202261,true,1645718512,28,1669086331,23367819
1675439879,202259,true,1646047672,28,1669086331,23038659
1675440479,202258,true,1646212277,28,1669086331,22874054
1675440563,202256,true,1646541536,28,1669086331,22544795
1675440575,202255,true,1646706190,28,1669086331,22380141
1675441199,202252,true,1647200251,28,1668085229,20884978
1675441655,202252,true,1647200251,28,1667418162,20217911
1675441883,202250,true,1647529708,28,1667084728,19555020
1675441907,202248,true,1647859230,28,1667084728,19225498
1675441931,202246,true,1648188818,28,1666918036,18729218
1675442363,202245,true,1648353637,28,1667251437,18897800
1675442687,202243,true,1648683325,28,1667751662,19068337
1675442771,202241,true,1649013078,28,1667918437,18905359
1675442927,202239,true,1649342897,28,1668085229,18742332
1675442951,202238,true,1649507831,28,1668085229,18577398
1675442975,202236,true,1649837749,28,1668085229,18247480
1675442987,202235,true,1650002733,28,1668085229,18082496
1675442999,202233,true,1650332750,28,1668085229,17752479
1675443023,202232,true,1650497783,28,1668085229,17587446
1675443575,202231,true,1650662833,28,1667251437,16588604
1675443599,202229,true,1650992982,28,1667251437,16258455
1675443623,202228,true,1651158081,28,1667251437,16093356
1675444547,202227,true,1651323197,28,1663587698,12264501
1675445507,202226,true,1651488330,28,1661758849,10270519
1675445723,202225,true,1651653478,28,1661758849,10105371
1675445735,202223,true,1651983826,28,1661758849,9775023
1675445783,202223,true,1651983826,28,1661758849,9775023
1675445819,202222,true,1652149024,28,1661925025,9776001
1675445843,202220,true,1652479470,28,1661925025,9445555
1675445867,202218,true,1652809983,28,1661925025,9115042
1675445903,202218,true,1652809983,28,1662091218,9281235
1675446107,202217,true,1652975264,28,1662756154,9780890
1675446131,202215,true,1653305875,28,1662756154,9450279
1675446143,202213,true,1653636553,28,1662922430,9285877
1675447103,202213,true,1653636553,28,1666918036,13281483
1675447115,202212,true,1653801917,28,1666918036,13116119
1675447187,202211,true,1653967297,28,1667251437,13284140
1675447211,202209,true,1654298107,28,1667251437,12953330
1675447439,202209,true,1654298107,28,1667584904,13286797
1675447451,202208,true,1654463537,28,1667584904,13121367
1675447511,202208,true,1654463537,28,1667751662,13288125
1675447679,202207,true,1654628983,28,1667584904,12955921
1675447703,202208,true,1654463537,28,1667418162,12954625
1675447739,202207,true,1654628983,28,1667251437,12622454
1675447823,202207,true,1654628983,28,1666918036,12289053
1675447835,202206,true,1654794446,28,1666918036,12123590
1675449047,202206,true,1654794446,28,1659766034,4971588
1675449095,202206,true,1654794446,28,1659600074,4805628
1675449179,202205,true,1654959925,28,1659268204,4308279
1675449203,202204,true,1655125421,28,1659102294,3976873
1675451819,202205,true,1654959925,28,1656118745,1158820
1675451855,202205,true,1654959925,28,1656118745,1158820
1675453031,202204,true,1655125421,28,1656118745,993324
1675454447,202202,true,1655456463,28,1655953150,496687
1675454459,202203,true,1655290934,28,1655953150,662216
1675454531,202201,true,1655622009,28,1655953150,331141
1675454543,202200,true,1655787571,28,1655953150,165579
1675454555,202199,true,1655953150,28,1655787571,-165579
1675455215,202200,true,1655787571,28,1652975264,-2812307
1675455251,202199,true,1655953150,28,1652809983,-3143167
1675455287,202197,true,1656284357,28,1652644718,-3639639
1675455443,202196,true,1656449985,28,1651983826,-4466159
1675455479,202198,true,1656118745,28,1651818644,-4300101
1675455527,202197,true,1656284357,28,1651653478,-4630879
1675455575,202196,true,1656449985,28,1651653478,-4796507
1675456271,202194,true,1656781292,28,1649837749,-6943543
1675456415,202196,true,1656449985,28,1650002733,-6447252
1675456511,202195,true,1656615630,28,1650167733,-6447897
1675456823,202194,true,1656781292,28,1650992982,-5788310
1675456835,202192,true,1657112665,28,1651158081,-5954584
1675456847,202194,true,1656781292,28,1651158081,-5623211
1675456895,202193,true,1656946970,28,1651323197,-5623773
1675456931,202191,true,1657278376,28,1651488330,-5790046
1675456943,202189,true,1657609848,28,1651488330,-6121518
1675457411,202191,true,1657278376,28,1653305875,-3972501
1675458887,202189,true,1657609848,28,1656118745,-1491103
1675458947,202187,true,1657941387,28,1656118745,-1822642
1675460015,202185,true,1658272992,28,1656118745,-2154247
1675462043,202186,true,1658107181,28,1656118745,-1988436
1675463603,202184,true,1658438819,28,1656118745,-2320074
1675463639,202183,true,1658604663,28,1656118745,-2485918
1675463663,202180,true,1659102294,28,1656118745,-2983549
1675463711,202182,true,1658770523,28,1656118745,-2651778
1675464311,202179,true,1659268204,28,1657609848,-1658356
1675464791,202178,true,1659434131,28,1659268204,-165927
1675464827,202176,true,1659766034,28,1659434131,-331903
1675464923,202177,true,1659600074,28,1659766034,165960
1675465019,202175,true,1659932011,28,1660098004,165993
1675465031,202173,true,1660264014,28,1660264014,0
1675466795,202171,true,1660596083,28,1664919034,4322951
1675468307,202173,true,1660264014,28,1664919034,4655020
1675468847,202171,true,1660596083,28,1664919034,4322951
1675469831,202170,true,1660762143,28,1664919034,4156891
1675469891,202168,true,1661094312,28,1664919034,3824722
1675470023,202170,true,1660762143,28,1664919034,4156891
1675470899,202168,true,1661094312,28,1664253233,3158921
1675475591,202167,true,1661260421,28,1663754057,2493636
1675475627,202167,true,1661260421,28,1663754057,2493636
1675475819,202169,true,1660928219,28,1663754057,2825838
1675475855,202167,true,1661260421,28,1663754057,2493636
1675476275,202166,true,1661426547,28,1663421356,1994809
1675476659,202166,true,1661426547,28,1662756154,1329607
1675477463,202168,true,1661094312,28,1661426547,332235
1675477487,202166,true,1661426547,28,1661426547,0
1675477631,202165,true,1661592690,28,1660928219,-664471
1675478039,202166,true,1661426547,28,1659766034,-1660513
1675479011,202169,true,1660928219,28,1657609848,-3318371
1675481267,202167,true,1661260421,28,1656615630,-4644791
1675481531,202167,true,1661260421,28,1656615630,-4644791
1675482047,202168,true,1661094312,28,1656615630,-4478682
1675483235,202170,true,1660762143,28,1656615630,-4146513
1675484567,202170,true,1660762143,28,1656615630,-4146513
1675485035,202170,true,1660762143,28,1656615630,-4146513
1675486067,202170,true,1660762143,28,1656449985,-4312158
1675487075,202173,true,1660264014,28,1656118745,-4145269
1675487351,202172,true,1660430040,28,1656118745,-4311295
1675487663,202172,true,1660430040,28,1655953150,-4476890
1675487723,202173,true,1660264014,28,1655953150,-4310864
1675487783,202175,true,1659932011,28,1655953150,-3978861
1675487855,202175,true,1659932011,28,1655787571,-4144440
1675488263,202175,true,1659932011,28,1655125421,-4806590
1675488287,202176,true,1659766034,28,1654959925,-4806109
1675488359,202179,true,1659268204,28,1654794446,-4473758
1675488743,202178,true,1659434131,28,1653967297,-5466834
1675491095,202179,true,1659268204,28,1651488330,-7779874
1675491119,202179,true,1659268204,28,1651488330,-7779874
1675492907,202183,true,1658604663,28,1650827899,-7776764
1675494503,202182,true,1658770523,28,1650827899,-7942624
1675494515,202183,true,1658604663,28,1650992982,-7611681
1675494815,202183,true,1658604663,28,1650992982,-7611681
1675495019,202186,true,1658107181,28,1651158081,-6949100
1675496987,202185,true,1658272992,28,1652314239,-5958753
1675497011,202185,true,1658272992,28,1652479470,-5793522
1675497023,202185,true,1658272992,28,1652479470,-5793522
1675497575,202188,true,1657775609,28,1653140561,-4635048
1675499171,202186,true,1658107181,28,1654794446,-3312735
1675499279,202187,true,1657941387,28,1654794446,-3146941
1675499519,202187,true,1657941387,28,1654794446,-3146941
1675499771,202189,true,1657609848,28,1654794446,-2815402
1675503995,202188,true,1657775609,28,1654794446,-2981163
1675504439,202189,true,1657609848,28,1654794446,-2815402
1675505795,202189,true,1657609848,28,1654794446,-2815402
1675505903,202192,true,1657112665,28,1654959925,-2152740
1675505939,202191,true,1657278376,28,1654959925,-2318451
1675505951,202191,true,1657278376,28,1654959925,-2318451
1675506155,202192,true,1657112665,28,1655125421,-1987244
1675507751,202194,true,1656781292,28,1657278376,497084
1675508639,202193,true,1656946970,28,1657444104,497134
1675509467,202194,true,1656781292,28,1657444104,662812
1675511279,202194,true,1656781292,28,1657609848,828556
1675511759,202196,true,1656449985,28,1657775609,1325624
1675512587,202195,true,1656615630,28,1658107181,1491551
1675512863,202195,true,1656615630,28,1658272992,1657362
1675512875,202195,true,1656615630,28,1658272992,1657362
1675513607,202197,true,1656284357,28,1658604663,2320306
1675514015,202195,true,1656615630,28,1658770523,2154893
1675514255,202196,true,1656449985,28,1658936400,2486415
1675514375,202195,true,1656615630,28,1659102294,2486664
1675514555,202197,true,1656284357,28,1659102294,2817937
1675514999,202195,true,1656615630,28,1659434131,2818501
1675515119,202195,true,1656615630,28,1659600074,2984444
1675515299,202195,true,1656615630,28,1659766034,3150404
1675515347,202196,true,1656449985,28,1659932011,3482026
1675515359,202194,true,1656781292,28,1659932011,3150719
1675515611,202194,true,1656781292,28,1660430040,3648748
1675515623,202194,true,1656781292,28,1660430040,3648748
1675515791,202194,true,1656781292,28,1660762143,3980851
1675515815,202193,true,1656946970,28,1660762143,3815173
1675515827,202193,true,1656946970,28,1660928219,3981249
1675515851,202191,true,1657278376,28,1660928219,3649843
1675515863,202191,true,1657278376,28,1661094312,3815936
1675515935,202188,true,1657775609,28,1661426547,3650938
1675515947,202188,true,1657775609,28,1661426547,3650938
1675515983,202187,true,1657941387,28,1661758849,3817462
1675516055,202186,true,1658107181,28,1662423653,4316472
1675516103,202182,true,1658770523,28,1663088722,4318199
1675516631,202181,true,1658936400,28,1669420165,10483765
1675516643,202180,true,1659102294,28,1669420165,10317871
1675516667,202179,true,1659268204,28,1669754065,10485861
1675516703,202176,true,1659766034,28,1670255042,10489008
1675516763,202174,true,1660098004,28,1671257445,11159441
1675516775,202173,true,1660264014,28,1671424571,11160557
1675516799,202172,true,1660430040,28,1671758873,11328833
1675516991,202168,true,1661094312,28,1674938075,13843763
1675517063,202167,true,1661260421,28,1676110883,14850462
1675517183,202165,true,1661592690,28,1678123323,16530633
1675517663,202164,true,1661758849,28,1685860084,24101235
1675518335,202161,true,1662257427,28,1690248804,27991377
1675518407,202159,true,1662589895,28,1690586871,27996976
1675518431,202158,true,1662756154,28,1690586871,27830717
1675518455,202157,true,1662922430,28,1690755929,27833499
1675519763,202154,true,1663421356,28,1688053018,24631662
1675519907,202152,true,1663754057,28,1687546703,23792646
1675519979,202151,true,1663920433,28,1687377965,23457532
1675520291,202150,true,1664086825,28,1686365893,22279068
1675520303,202149,true,1664253233,28,1686365893,22112660
1675520327,202148,true,1664419659,28,1686365893,21946234
1675520351,202146,true,1664752559,28,1686197273,21444714
1675520495,202146,true,1664752559,28,1685691515,20938956
1675520651,202145,true,1664919034,28,1685017407,20098373
1675520735,202144,true,1665085526,28,1684680454,19594928
1675520795,202143,true,1665252035,28,1684343569,19091534
1675521179,202143,true,1665252035,28,1682491902,17239867
1675521443,202142,true,1665418560,28,1681146514,15727954
1675523243,202141,true,1665585102,28,1678123323,12538221
1675527803,202140,true,1665751660,28,1678123323,12371663
1675527875,202140,true,1665751660,28,1678123323,12371663
1675528451,202139,true,1665918236,28,1678123323,12205087
1675528463,202138,true,1666084827,28,1678123323,12038496
1675528487,202137,true,1666251436,28,1678123323,11871887
1675530011,202137,true,1666251436,28,1680138179,13886743
1675532915,202136,true,1666418061,28,1680474223,14056162
1675534343,202134,true,1666751361,28,1681819073,15067712
1675534667,202133,true,1666918036,28,1681987255,15069219
1675535471,202133,true,1666918036,28,1681650908,14732872
1675535495,202131,true,1667251437,28,1681650908,14399471
1675535543,202130,true,1667418162,28,1681482760,14064598
1675535651,202129,true,1667584904,28,1681314628,13729724
1675538255,202128,true,1667751662,28,1678291135,10539473
1675547399,202127,true,1667918437,28,1678291135,10372698
1675550291,202125,true,1668252038,28,1678291135,10039097
1675550831,202124,true,1668418863,28,1679466291,11047428
1675553591,202123,true,1668585705,28,1681987255,13401550
1675553903,202122,true,1668752563,28,1681987255,13234692
1675553915,202119,true,1669253239,28,1681987255,12734016
1675553963,202119,true,1669253239,28,1681819073,12565834
1675554131,202118,true,1669420165,28,1680978416,11558251
1675554215,202118,true,1669420165,28,1680474223,11054058
1675554227,202116,true,1669754065,28,1680306193,10552128
1675554251,202115,true,1669921041,28,1680138179,10217138
1675554275,202115,true,1669921041,28,1679970182,10049141
1675555715,202116,true,1669754065,28,1666251436,-3502629
1675555739,202114,true,1670088033,28,1666251436,-3836597
1675556627,202113,true,1670255042,28,1665585102,-4669940
1675556987,202113,true,1670255042,28,1665918236,-4336806
1675557815,202113,true,1670255042,28,1666251436,-4003606
1675558451,202110,true,1670756168,28,1666251436,-4504732
1675558571,202109,true,1670923244,28,1666251436,-4671808
1675558583,202109,true,1670923244,28,1666251436,-4671808
1675560395,202110,true,1670756168,28,1664086825,-6669343
1675560563,202108,true,1671090336,28,1664086825,-7003511
1675563887,202107,true,1671257445,28,1664086825,-7170620
1675563923,202107,true,1671257445,28,1664253233,-7004212
1675563971,202107,true,1671257445,28,1664253233,-7004212
1675564007,202105,true,1671591713,28,1664253233,-7338480
1675564163,202104,true,1671758873,28,1664253233,-7505640
1675564211,202104,true,1671758873,28,1664253233,-7505640
1675564343,202105,true,1671591713,28,1664253233,-7338480
1675564691,202103,true,1671926048,28,1664419659,-7506389
1675565123,202102,true,1672093241,28,1664586101,-7507140
1675565555,202102,true,1672093241,28,1664752559,-7340682
1675565783,202103,true,1671926048,28,1664752559,-7173489
1675565987,202101,true,1672260450,28,1664752559,-7507891
1675566035,202100,true,1672427676,28,1664752559,-7675117
1675567739,202100,true,1672427676,28,1662257427,-10170249
1675569791,202102,true,1672093241,28,1661592690,-10500551
1675569971,202099,true,1672594919,28,1661592690,-11002229
1675570091,202099,true,1672594919,28,1661592690,-11002229
1675571147,202099,true,1672594919,28,1661592690,-11002229
1675573931,202101,true,1672260450,28,1661592690,-10667760
1675574075,202098,true,1672762179,28,1661592690,-11169489
1675574675,202098,true,1672762179,28,1661592690,-11169489
1675574843,202099,true,1672594919,28,1661758849,-10836070
1675576619,202100,true,1672427676,28,1662922430,-9505246
1675577003,202097,true,1672929455,28,1662922430,-10007025
1675577123,202097,true,1672929455,28,1663088722,-9840733
1675577339,202098,true,1672762179,28,1663088722,-9673457
1675577375,202099,true,1672594919,28,1663088722,-9506197
1675579079,202096,true,1673096748,28,1663754057,-9342691
1675579127,202096,true,1673096748,28,1663920433,-9176315
1675579139,202097,true,1672929455,28,1663920433,-9009022
1675579151,202098,true,1672762179,28,1663920433,-8841746
1675579199,202095,true,1673264058,28,1663920433,-9343625
1675579451,202094,true,1673431384,28,1664253233,-9178151
1675580351,202095,true,1673264058,28,1665585102,-7678956
1675581035,202097,true,1672929455,28,1666251436,-6678019
1675581407,202094,true,1673431384,28,1666251436,-7179948
1675582139,202093,true,1673598727,28,1666251436,-7347291
1675582331,202095,true,1673264058,28,1666251436,-7012622
1675582871,202096,true,1673096748,28,1666251436,-6845312
1675584479,202093,true,1673598727,28,1666251436,-7347291
1675585883,202093,true,1673598727,28,1666251436,-7347291
1675585907,202094,true,1673431384,28,1666251436,-7179948
1675586387,202096,true,1673096748,28,1666251436,-6845312
1675586483,202094,true,1673431384,28,1666418061,-7013323
1675587215,202093,true,1673598727,28,1667084728,-6513999
1675587707,202096,true,1673096748,28,1667584904,-5511844
1675588583,202098,true,1672762179,28,1668085229,-4676950
1675588595,202097,true,1672929455,28,1668085229,-4844226
1675589699,202096,true,1673096748,28,1668252038,-4844710
1675590059,202098,true,1672762179,28,1668252038,-4510141
1675593467,202101,true,1672260450,28,1668252038,-4008412
1675595543,202101,true,1672260450,28,1668252038,-4008412
1675597199,202100,true,1672427676,28,1668418863,-4008813
1675597787,202103,true,1671926048,28,1668085229,-3840819
1675598123,202106,true,1671424571,28,1667751662,-3672909
1675599935,202105,true,1671591713,28,1665918236,-5673477
1675600115,202105,true,1671591713,28,1665918236,-5673477
1675600691,202108,true,1671090336,28,1665918236,-5172100
1675600991,202111,true,1670589109,28,1665751660,-4837449
1675601075,202111,true,1670589109,28,1665751660,-4837449
1675601399,202111,true,1670589109,28,1665418560,-5170549
1675601411,202113,true,1670255042,28,1665418560,-4836482
1675601423,202116,true,1669754065,28,1665252035,-4502030
1675601471,202116,true,1669754065,28,1665085526,-4668539
1675601507,202117,true,1669587107,28,1664919034,-4668073
1675601543,202119,true,1669253239,28,1664752559,-4500680
1675601591,202122,true,1668752563,28,1664586101,-4166462
1675601675,202122,true,1668752563,28,1664086825,-4665738
1675601687,202123,true,1668585705,28,1663920433,-4665272
1675601699,202125,true,1668252038,28,1663920433,-4331605
1675601747,202127,true,1667918437,28,1663421356,-4497081
1675601759,202128,true,1667751662,28,1663421356,-4330306
1675601783,202129,true,1667584904,28,1663088722,-4496182
1675601831,202131,true,1667251437,28,1662589895,-4661542
1675601891,202135,true,1666584703,28,1661925025,-4659678
1675601903,202135,true,1666584703,28,1661758849,-4825854
1675602323,202136,true,1666418061,28,1657112665,-9305396
1675602659,202138,true,1666084827,28,1653636553,-12448274
1675602695,202141,true,1665585102,28,1653140561,-12444541
1675604087,202142,true,1665418560,28,1645718512,-19700048
1675604123,202143,true,1665252035,28,1645718512,-19533523
1675604231,202146,true,1664752559,28,1645553957,-19198602
1675604243,202149,true,1664253233,28,1645553957,-18699276
1675604315,202149,true,1664253233,28,1645718512,-18534721
1675604339,202150,true,1664086825,28,1645718512,-18368313
1675604435,202153,true,1663587698,28,1645718512,-17869186
1675605563,202156,true,1663088722,28,1647200251,-15888471
1675607411,202157,true,1662922430,28,1647859230,-15063200
1675607603,202157,true,1662922430,28,1648024016,-14898414
1675607627,202160,true,1662423653,28,1648024016,-14399637
1675607795,202163,true,1661925025,28,1648188818,-13736207
1675607819,202163,true,1661925025,28,1648188818,-13736207
1675609451,202163,true,1661925025,28,1650332750,-11592275
1675609463,202166,true,1661426547,28,1650332750,-11093797
1675611671,202169,true,1660928219,28,1652644718,-8283501
1675611815,202169,true,1660928219,28,1652644718,-8283501
1675611827,202170,true,1660762143,28,1652644718,-8117425
1675611863,202171,true,1660596083,28,1652479470,-8116613
1675611899,202174,true,1660098004,28,1652314239,-7783765
1675611935,202175,true,1659932011,28,1652314239,-7617772
1675612931,202175,true,1659932011,28,1648353637,-11578374
1675616327,202177,true,1659600074,28,1643580575,-16019499
1675616351,202178,true,1659434131,28,1643580575,-15853556
1675616855,202179,true,1659268204,28,1643580575,-15687629
1675616867,202180,true,1659102294,28,1643580575,-15521719
1675617443,202182,true,1658770523,28,1642102092,-16668431
1675617455,202184,true,1658438819,28,1642102092,-16336727
1675617527,202185,true,1658272992,28,1641773720,-16499272
1675617623,202186,true,1658107181,28,1641281287,-16825894
1675617767,202189,true,1657609848,28,1640789001,-16820847
1675617815,202190,true,1657444104,28,1640624938,-16819166
1675618547,202191,true,1657278376,28,1638002168,-19276208
1675618559,202192,true,1657112665,28,1638002168,-19110497
1675618631,202194,true,1656781292,28,1637674617,-19106675
1675618655,202196,true,1656449985,28,1637510866,-18939119
1675618799,202198,true,1656118745,28,1636856025,-19262720
1675619099,202199,true,1655953150,28,1635383591,-20569559
1675619111,202202,true,1655456463,28,1635220069,-20236394
1675619183,202203,true,1655290934,28,1634893074,-20397860
1675619435,202206,true,1654794446,28,1633585748,-21208698
1675619447,202207,true,1654628983,28,1633422406,-21206577
1675619459,202210,true,1654132694,28,1633259080,-20873614
1675620035,202212,true,1653801917,28,1628366889,-25435028
1675621031,202215,true,1653305875,28,1621218171,-32087704
1675623515,202217,true,1652975264,28,1619435901,-33539363
1675623743,202219,true,1652644718,28,1619435901,-33208817
1675624007,202221,true,1652314239,28,1619273973,-33040266
1675624043,202225,true,1651653478,28,1619273973,-32379505
1675624139,202226,true,1651488330,28,1619112062,-32376268
1675624535,202229,true,1650992982,28,1618788288,-32204694
1675625327,202231,true,1650662833,28,1618140935,-32521898
1675626215,202234,true,1650167733,28,1617332107,-32835626
1675626827,202236,true,1649837749,28,1617493840,-32343909
1675627283,202238,true,1649507831,28,1617817355,-31690476
1675627967,202241,true,1649013078,28,1618464579,-30548499
1675628615,202244,true,1648518473,28,1618464579,-30053894
1675629275,202246,true,1648188818,28,1618464579,-29724239
1675629551,202248,true,1647859230,28,1618626426,-29232804
1675631243,202250,true,1647529708,28,1619112062,-28417646
1675631255,202254,true,1646870861,28,1619112062,-27758799
1675632167,202256,true,1646541536,28,1618464579,-28076957
1675634339,202258,true,1646212277,28,1617655590,-28556687
1675635023,202260,true,1645883084,28,1617979137,-27903947
1675635035,202264,true,1645224895,28,1617979137,-27245758
1675635047,202266,true,1644895899,28,1618140935,-26754964
1675635059,202268,true,1644566970,28,1618140935,-26426035
1675635119,202270,true,1644238106,28,1618302749,-25935357
1675635167,202273,true,1643744933,28,1618464579,-25280354
1675635179,202275,true,1643416233,28,1618626426,-24789807
1675635767,202277,true,1643087599,28,1621542431,-21545168
1675635791,202279,true,1642759031,28,1621704585,-21054446
1675635995,202282,true,1642266302,28,1622840119,-19426183
1675636007,202284,true,1641937898,28,1622840119,-19097779
1675636031,202285,true,1641773720,28,1623002403,-18771317
1675636079,202287,true,1641445415,28,1623327020,-18118395
1675636103,202290,true,1640953080,28,1623489353,-17463727
1675636127,202292,true,1640624938,28,1623651701,-16973237
1675636475,202293,true,1640460892,28,1626088885,-14372007
1675636499,202295,true,1640132849,28,1626251493,-13881356
1675636511,202298,true,1639640908,28,1626251493,-13389415
1675637027,202300,true,1639313029,28,1629833006,-9480023
1675637291,202301,true,1639149114,28,1630811150,-8337964
1675637303,202302,true,1638985215,28,1630811150,-8174065
1675637471,202305,true,1638493618,28,1631463573,-7030045
1675637927,202307,true,1638165969,28,1633259080,-4906889
1675639775,202308,true,1638002168,28,1634566145,-3436023
1675640063,202310,true,1637674617,28,1634566145,-3108472
1675640123,202313,true,1637183413,28,1634566145,-2617268
1675643087,202314,true,1637019711,28,1632605940,-4413771
1675643207,202315,true,1636856025,28,1632769200,-4086825
1675643219,202317,true,1636528703,28,1632769200,-3759503
1675643231,202320,true,1636037843,28,1632769200,-3268643
1675643279,202321,true,1635874255,28,1632932477,-2941778
1675644143,202321,true,1635874255,28,1634893074,-981181
1675644155,202323,true,1635547130,28,1634893074,-654056
1675647131,202325,true,1635220069,28,1638002168,2782099
1675647191,202326,true,1635056564,28,1638002168,2945604
1675647251,202326,true,1635056564,28,1638002168,2945604
1675647395,202327,true,1634893074,28,1637838385,2945311
1675649615,202330,true,1634402704,28,1635547130,1144426
1675651067,202330,true,1634402704,28,1635220069,817365
1675651703,202330,true,1634402704,28,1635056564,653860
1675651775,202331,true,1634239280,28,1635056564,817284
1675651811,202333,true,1633912482,28,1635056564,1144082
1675652003,202333,true,1633912482,28,1634893074,980592
1675652015,202333,true,1633912482,28,1634893074,980592
1675652039,202334,true,1633749107,28,1634893074,1143967
1675652051,202336,true,1633422406,28,1634893074,1470668
1675652363,202337,true,1633259080,28,1633585748,326668
1675652447,202337,true,1633259080,28,1633259080,0
1675652459,202338,true,1633095770,28,1633259080,163310
1675652471,202340,true,1632769200,28,1633259080,489880
1675652483,202341,true,1632605940,28,1633095770,489830
1675656623,202342,true,1632442695,28,1623976448,-8466247
1675656767,202342,true,1632442695,28,1624138846,-8303849
1675656863,202345,true,1631953061,28,1624138846,-7814215
1675657943,202346,true,1631789882,28,1624788599,-7001283
1675661183,202347,true,1631626719,28,1624951078,-6675641
1675661243,202347,true,1631626719,28,1624951078,-6675641
1675661255,202350,true,1631137329,28,1624951078,-6186251
1675661267,202351,true,1630974231,28,1624951078,-6023153
1675661471,202353,true,1630648085,28,1624138846,-6509239
1675661483,202354,true,1630485037,28,1624138846,-6346191
1675662515,202357,true,1629995989,28,1617979137,-12016852
1675662527,202359,true,1629670039,28,1617817355,-11852684
1675662599,202361,true,1629344154,28,1617493840,-11850314
1675662683,202362,true,1629181236,28,1617008689,-12172547
1675662695,202365,true,1628692579,28,1617008689,-11683890
1675662779,202367,true,1628366889,28,1616523683,-11843206
1675662803,202369,true,1628041265,28,1616362047,-11679218
1675663031,202369,true,1628041265,28,1615392569,-12648696
1675663751,202372,true,1627552950,28,1616038823,-11514127
1675663775,202373,true,1627390211,28,1616038823,-11351388
1675663799,202375,true,1627064782,28,1616038823,-11025959
1675664003,202375,true,1627064782,28,1616523683,-10541099
1675664495,202377,true,1626739418,28,1617655590,-9083828
1675664507,202379,true,1626414119,28,1617655590,-8758529
1675664531,202380,true,1626251493,28,1617655590,-8595903
1675664543,202380,true,1626251493,28,1617655590,-8595903
1675664687,202381,true,1626088885,28,1617979137,-8109748
1675664711,202383,true,1625763716,28,1617979137,-7784579
1675664975,202383,true,1625763716,28,1618626426,-7137290
1675664987,202383,true,1625763716,28,1618788288,-6975428
1675664999,202385,true,1625438612,28,1618788288,-6650324
1675665107,202386,true,1625276084,28,1619112062,-6164022
1675666235,202386,true,1625276084,28,1622515600,-2760484
1675666343,202386,true,1625276084,28,1622840119,-2435965
1675667831,202387,true,1625113573,28,1623164703,-1948870
1675667891,202388,true,1624951078,28,1623327020,-1624058
1675668167,202388,true,1624951078,28,1623327020,-1624058
1675668287,202388,true,1624951078,28,1623489353,-1461725
1675668299,202388,true,1624951078,28,1623489353,-1461725
1675668443,202388,true,1624951078,28,1623814067,-1137011
1675668467,202388,true,1624951078,28,1623814067,-1137011
1675668575,202387,true,1625113573,28,1624138846,-974727
1675668995,202386,true,1625276084,28,1624951078,-325006
1675669007,202387,true,1625113573,28,1624951078,-162495
1675669019,202386,true,1625276084,28,1625113573,-162511
1675669187,202385,true,1625438612,28,1625601155,162543
1675670027,202384,true,1625601155,28,1628204069,2602914
1675670063,202384,true,1625601155,28,1628366889,2765734
1675670183,202384,true,1625601155,28,1628692579,3091424
1675670423,202382,true,1625926292,28,1629181236,3254944
1675670579,202381,true,1626088885,28,1629507088,3418203
1675670711,202381,true,1626088885,28,1629995989,3907104
1675670723,202381,true,1626088885,28,1629995989,3907104
1675672643,202379,true,1626414119,28,1632932477,6518358
1675672727,202378,true,1626576760,28,1632932477,6355717
1675673795,202378,true,1626576760,28,1632932477,6355717
1675674143,202378,true,1626576760,28,1632932477,6355717
1675674311,202376,true,1626902092,28,1632932477,6030385
1675674407,202375,true,1627064782,28,1632932477,5867695
1675676123,202375,true,1627064782,28,1633095770,6030988
1675676723,202374,true,1627227488,28,1633095770,5868282
1675679951,202373,true,1627390211,28,1633095770,5705559
1675680119,202372,true,1627552950,28,1633095770,5542820
1675681007,202372,true,1627552950,28,1632769200,5216250
1675681691,202371,true,1627715705,28,1632442695,4726990
1675681703,202371,true,1627715705,28,1632442695,4726990
1675681727,202370,true,1627878477,28,1632442695,4564218
1675681835,202370,true,1627878477,28,1632279467,4400990
1675682003,202370,true,1627878477,28,1632116256,4237779
1675682735,202370,true,1627878477,28,1630974231,3095754
1675682783,202369,true,1628041265,28,1630811150,2769885
1675682879,202369,true,1628041265,28,1630648085,2606820
1675683203,202370,true,1627878477,28,1629833006,1954529
1675684187,202370,true,1627878477,28,1628366889,488412
1675684427,202369,true,1628041265,28,1628204069,162804
1675684463,202370,true,1627878477,28,1628204069,325592
1675684547,202370,true,1627878477,28,1628204069,325592
1675684595,202370,true,1627878477,28,1628204069,325592
1675684631,202370,true,1627878477,28,1628366889,488412
1675684667,202370,true,1627878477,28,1628366889,488412
1675684679,202371,true,1627715705,28,1628366889,651184
1675684787,202371,true,1627715705,28,1628529726,814021
1675684871,202370,true,1627878477,28,1628692579,814102
1675684883,202371,true,1627715705,28,1628692579,976874
1675686083,202371,true,1627715705,28,1632605940,4890235
1675686095,202371,true,1627715705,28,1632605940,4890235
1675686215,202370,true,1627878477,28,1632932477,5054000
1675686647,202371,true,1627715705,28,1633259080,5543375
1675688855,202371,true,1627715705,28,1632442695,4726990
1675690919,202371,true,1627715705,28,1632442695,4726990
1675692383,202370,true,1627878477,28,1632442695,4564218
1675692527,202371,true,1627715705,28,1632442695,4726990
1675692611,202372,true,1627552950,28,1632442695,4889745
1675692863,202372,true,1627552950,28,1632279467,4726517
1675692911,202372,true,1627552950,28,1632116256,4563306
1675692923,202373,true,1627390211,28,1632116256,4726045
1675693955,202374,true,1627227488,28,1629833006,2605518
1675693967,202374,true,1627227488,28,1629670039,2442551
1675694279,202373,true,1627390211,28,1629181236,1791025
1675695299,202374,true,1627227488,28,1628855448,1627960
1675696883,202376,true,1626902092,28,1629018334,2116242
1675696931,202375,true,1627064782,28,1628855448,1790666
1675696967,202375,true,1627064782,28,1628855448,1790666
1675697579,202375,true,1627064782,28,1627552950,488168
1675697663,202378,true,1626576760,28,1627390211,813451
1675697675,202377,true,1626739418,28,1627390211,650793
1675698719,202376,true,1626902092,28,1625113573,-1788519
1675698743,202376,true,1626902092,28,1625113573,-1788519
1675698767,202378,true,1626576760,28,1625113573,-1463187
1675698791,202378,true,1626576760,28,1625113573,-1463187
1675698803,202377,true,1626739418,28,1625113573,-1625845
1675698827,202376,true,1626902092,28,1625113573,-1788519
1675698863,202377,true,1626739418,28,1625276084,-1463334
1675698887,202377,true,1626739418,28,1625276084,-1463334
1675698899,202376,true,1626902092,28,1625276084,-1626008
1675698923,202375,true,1627064782,28,1625276084,-1788698
1675698935,202377,true,1626739418,28,1625438612,-1300806
1675698983,202376,true,1626902092,28,1625438612,-1463480
1675698995,202375,true,1627064782,28,1625601155,-1463627
1675699007,202374,true,1627227488,28,1625601155,-1626333
1675699019,202374,true,1627227488,28,1625763716,-1463772
1675699067,202372,true,1627552950,28,1626088885,-1464065
1675699091,202369,true,1628041265,28,1626251493,-1789772
1675699103,202368,true,1628204069,28,1626414119,-1789950
1675699223,202368,true,1628204069,28,1627715705,-488364
1675699355,202365,true,1628692579,28,1629181236,488657
1675699391,202363,true,1629018334,28,1629507088,488754
1675699607,202362,true,1629181236,28,1632279467,3098231
1675699619,202361,true,1629344154,28,1632442695,3098541
1675699655,202358,true,1629833006,28,1632932477,3099471
1675699679,202356,true,1630158989,28,1633259080,3100091
1675700171,202354,true,1630485037,28,1640296863,9811826
1675700363,202353,true,1630648085,28,1643087599,12439514
1675700375,202351,true,1630974231,28,1643251908,12277677
1675700507,202349,true,1631300442,28,1645389418,14088976
1675701335,202347,true,1631626719,28,1651983826,20357107
1675701407,202346,true,1631789882,28,1652314239,20524357
1675701467,202343,true,1632279467,28,1652479470,20200003
1675701491,202341,true,1632605940,28,1652479470,19873530
1675701515,202340,true,1632769200,28,1652479470,19710270
1675701527,202339,true,1632932477,28,1652479470,19546993
1675701539,202337,true,1633259080,28,1652479470,19220390
1675701587,202336,true,1633422406,28,1652314239,18891833
1675701599,202334,true,1633749107,28,1652314239,18565132
1675701611,202334,true,1633749107,28,1652314239,18565132
1675701755,202332,true,1634075873,28,1651818644,17742771
1675705031,202331,true,1634239280,28,1645883084,11643804
1675707287,202329,true,1634566145,28,1646870861,12304716
1675708535,202329,true,1634566145,28,1646870861,12304716
1675708655,202327,true,1634893074,28,1646870861,11977787
1675708907,202326,true,1635056564,28,1646870861,11814297
1675710971,202324,true,1635383591,28,1645883084,10499493
1675710983,202324,true,1635383591,28,1646047672,10664081
1675710995,202323,true,1635547130,28,1646047672,10500542
1675711019,202322,true,1635710684,28,1646047672,10336988
1675711151,202320,true,1636037843,28,1646376898,10339055
1675712075,202319,true,1636201447,28,1648518473,12317026
1675712219,202318,true,1636365067,28,1649013078,12648011
1675712303,202317,true,1636528703,28,1649177979,12649276
1675712363,202315,true,1636856025,28,1649177979,12321954
1675712375,202315,true,1636856025,28,1649177979,12321954
1675712519,202314,true,1637019711,28,1649342897,12323186
1675716623,202314,true,1637019711,28,1646212277,9192566
1675719755,202312,true,1637347131,28,1646212277,8865146
1675719983,202312,true,1637347131,28,1646212277,8865146
1675720007,202311,true,1637510866,28,1646212277,8701411
1675720031,202311,true,1637510866,28,1646212277,8701411
1675720115,202309,true,1637838385,28,1646047672,8209287
1675721219,202310,true,1637674617,28,1642923307,5248690
1675721231,202309,true,1637838385,28,1642759031,4920646
1675724483,202310,true,1637674617,28,1636528703,-1145914
1675724543,202308,true,1638002168,28,1636528703,-1473465
1675724555,202309,true,1637838385,28,1636528703,-1309682
1675724675,202308,true,1638002168,28,1636365067,-1637101
1675724711,202309,true,1637838385,28,1636201447,-1636938
1675724747,202308,true,1638002168,28,1636201447,-1800721
1675724771,202309,true,1637838385,28,1636037843,-1800542
1675724795,202308,true,1638002168,28,1636037843,-1964325
1675724903,202310,true,1637674617,28,1635547130,-2127487
1675724939,202309,true,1637838385,28,1635383591,-2454794
1675724951,202310,true,1637674617,28,1635383591,-2291026
1675724975,202309,true,1637838385,28,1635056564,-2781821
1675725035,202312,true,1637347131,28,1634566145,-2780986
1675725047,202311,true,1637510866,28,1634402704,-3108162
1675725083,202312,true,1637347131,28,1634075873,-3271258
1675725095,202311,true,1637510866,28,1633912482,-3598384
1675725563,202314,true,1637019711,28,1628692579,-8327132
1675725623,202313,true,1637183413,28,1627878477,-9304936
1675727075,202315,true,1636856025,28,1611681621,-25174404
1675727207,202315,true,1636856025,28,1611359333,-25496692
1675727219,202318,true,1636365067,28,1611198213,-25166854
1675727243,202318,true,1636365067,28,1611198213,-25166854
1675727291,202320,true,1636037843,28,1611037110,-25000733
1675727327,202319,true,1636201447,28,1611037110,-25164337
1675727411,202322,true,1635710684,28,1610876022,-24834662
1675728659,202322,true,1635710684,28,1612648872,-23061812
1675728887,202324,true,1635383591,28,1613132715,-22250876
1675728923,202323,true,1635547130,28,1613132715,-22414415
1675728935,202327,true,1634893074,28,1613132715,-21760359
1675729079,202326,true,1635056564,28,1613455358,-21601206
1675729175,202328,true,1634729601,28,1613778065,-20951536
1675729835,202327,true,1634893074,28,1615231046,-19662028
1675730135,202330,true,1634402704,28,1615877236,-18525468
1675731047,202329,true,1634566145,28,1617332107,-17234038
1675731767,202331,true,1634239280,28,1617493840,-16745440
1675731803,202330,true,1634402704,28,1617493840,-16908864
1675731923,202333,true,1633912482,28,1617655590,-16256892
1675732463,202332,true,1634075873,28,1618464579,-15611294
1675732583,202333,true,1633912482,28,1618626426,-15286056
1675732655,202332,true,1634075873,28,1618626426,-15449447
1675733039,202335,true,1633585748,28,1619273973,-14311775
1675733051,202334,true,1633749107,28,1619273973,-14475134
1675733147,202335,true,1633585748,28,1619435901,-14149847
1675733231,202334,true,1633749107,28,1619597844,-14151263
1675733339,202337,true,1633259080,28,1619759804,-13499276
1675733387,202335,true,1633585748,28,1619921780,-13663968
1675733399,202336,true,1633422406,28,1619921780,-13500626
1675733891,202334,true,1633749107,28,1621056066,-12693041
1675736135,202337,true,1633259080,28,1622515600,-10743480
1675736219,202336,true,1633422406,28,1622515600,-10906806
1675738187,202336,true,1633422406,28,1621704585,-11717821
1675738223,202335,true,1633585748,28,1621866756,-11718992
1675738235,202338,true,1633095770,28,1621866756,-11229014
1675738319,202337,true,1633259080,28,1621866756,-11392324
1675738403,202337,true,1633259080,28,1622028942,-11230138
1675738415,202336,true,1633422406,28,1622028942,-11393464
1675739051,202339,true,1632932477,28,1623002403,-9930074
1675739423,202338,true,1633095770,28,1623814067,-9281703
1675739795,202338,true,1633095770,28,1624463690,-8632080
1675740215,202337,true,1633259080,28,1624951078,-8308002
1675740263,202340,true,1632769200,28,1624951078,-7818122
1675740395,202339,true,1632932477,28,1624951078,-7981399
1675740419,202340,true,1632769200,28,1624951078,-7818122
1675740431,202340,true,1632769200,28,1625113573,-7655627
1675740527,202343,true,1632279467,28,1625113573,-7165894
1675740575,202342,true,1632442695,28,1625113573,-7329122
1675740611,202343,true,1632279467,28,1625276084,-7003383
1675740779,202344,true,1632116256,28,1625601155,-6515101
1675741079,202347,true,1631626719,28,1626251493,-5375226
1675741139,202346,true,1631789882,28,1626251493,-5538389
1675741163,202347,true,1631626719,28,1626414119,-5212600
1675741199,202348,true,1631463573,28,1626414119,-5049454
1675741655,202351,true,1630974231,28,1627715705,-3258526
1675741739,202351,true,1630974231,28,1628041265,-2932966
1675741871,202352,true,1630811150,28,1628366889,-2444261
1675743851,202352,true,1630811150,28,1630485037,-326113
1675743887,202355,true,1630322005,28,1630648085,326080
1675743899,202355,true,1630322005,28,1630648085,326080
1675744235,202357,true,1629995989,28,1630811150,815161
1675744439,202357,true,1629995989,28,1630974231,978242
1675744547,202360,true,1629507088,28,1630974231,1467143
1675747235,202360,true,1629507088,28,1632932477,3425389
1675749959,202361,true,1629344154,28,1632932477,3588323
1675752371,202361,true,1629344154,28,1632932477,3588323
1675752503,202364,true,1628855448,28,1632932477,4077029
1675752515,202363,true,1629018334,28,1632932477,3914143
1675753787,202364,true,1628855448,28,1632932477,4077029
1675754027,202364,true,1628855448,28,1632932477,4077029
1675761083,202366,true,1628529726,28,1632605940,4076214
1675761107,202366,true,1628529726,28,1632769200,4239474
1675761131,202367,true,1628366889,28,1632769200,4402311
1675761143,202367,true,1628366889,28,1632769200,4402311
1675761155,202369,true,1628041265,28,1632769200,4727935
1675762295,202368,true,1628204069,28,1635874255,7670186
1675763411,202369,true,1628041265,28,1637347131,9305866
1675763723,202369,true,1628041265,28,1637510866,9469601
1675763735,202371,true,1627715705,28,1637510866,9795161
1675764047,202370,true,1627878477,28,1637838385,9959908
1675764971,202371,true,1627715705,28,1638657468,10941763
1675764995,202371,true,1627715705,28,1638657468,10941763
1675765019,202373,true,1627390211,28,1638821333,11431122
1675765031,202373,true,1627390211,28,1638821333,11431122
1675765199,202373,true,1627390211,28,1639313029,11922818
1675765523,202372,true,1627552950,28,1640132849,12579899
1675765715,202374,true,1627227488,28,1640460892,13233404
1675769507,202373,true,1627390211,28,1643251908,15861697
1675771343,202374,true,1627227488,28,1643251908,16024420
1675776263,202373,true,1627390211,28,1643251908,15861697
1675776491,202375,true,1627064782,28,1643251908,16187126
1675776659,202374,true,1627227488,28,1643251908,16024420
1675776671,202373,true,1627390211,28,1643251908,15861697
1675776683,202373,true,1627390211,28,1643251908,15861697
1675776779,202374,true,1627227488,28,1643087599,15860111
1675776839,202373,true,1627390211,28,1643087599,15697388
1675776875,202372,true,1627552950,28,1643087599,15534649
1675779215,202372,true,1627552950,28,1639640908,12087958
1675781939,202372,true,1627552950,28,1639640908,12087958
1675782623,202371,true,1627715705,28,1639640908,11925203
1675782839,202371,true,1627715705,28,1639640908,11925203
1675783115,202370,true,1627878477,28,1639313029,11434552
1675783139,202370,true,1627878477,28,1639313029,11434552
1675783703,202370,true,1627878477,28,1638493618,10615141
1675783751,202369,true,1628041265,28,1638329785,10288520
1675783787,202368,true,1628204069,28,1638165969,9961900
1675783823,202367,true,1628366889,28,1638165969,9799080
1675786295,202367,true,1628366889,28,1632442695,4075806
1675787015,202366,true,1628529726,28,1632442695,3912969
1675787063,202365,true,1628692579,28,1632442695,3750116
1675787615,202364,true,1628855448,28,1631789882,2934434
1675787639,202364,true,1628855448,28,1631789882,2934434
1675787651,202362,true,1629181236,28,1631789882,2608646
1675787663,202361,true,1629344154,28,1631789882,2445728
1675788155,202358,true,1629833006,28,1633422406,3589400
1675788587,202357,true,1629995989,28,1635056564,5060575
1675790579,202356,true,1630158989,28,1638821333,8662344
1675790627,202355,true,1630322005,28,1638821333,8499328
1675790639,202352,true,1630811150,28,1638821333,8010183
1675790723,202352,true,1630811150,28,1638821333,8010183
1675790747,202350,true,1631137329,28,1638821333,7684004
1675790771,202350,true,1631137329,28,1638821333,7684004
1675790807,202347,true,1631626719,28,1638821333,7194614
1675790831,202347,true,1631626719,28,1638657468,7030749
1675790867,202346,true,1631789882,28,1638657468,6867586
1675790927,202345,true,1631953061,28,1638657468,6704407
1675790939,202343,true,1632279467,28,1638493618,6214151
1675790951,202343,true,1632279467,28,1638493618,6214151
1675791719,202342,true,1632442695,28,1636692356,4249661
1675791731,202342,true,1632442695,28,1636692356,4249661
1675791935,202339,true,1632932477,28,1636528703,3596226
1675791959,202339,true,1632932477,28,1636528703,3596226
1675791971,202338,true,1633095770,28,1636528703,3432933
1675791983,202338,true,1633095770,28,1636692356,3596586
1675791995,202334,true,1633749107,28,1636692356,2943249
1675792091,202332,true,1634075873,28,1637510866,3434993
1675792103,202331,true,1634239280,28,1637674617,3435337
1675792139,202330,true,1634402704,28,1638002168,3599464
1675792187,202326,true,1635056564,28,1638493618,3437054
1675792355,202324,true,1635383591,28,1640296863,4913272
1675792379,202323,true,1635547130,28,1640624938,5077808
1675792475,202322,true,1635710684,28,1641937898,6227214
1675792511,202318,true,1636365067,28,1642594771,6229704
1675792559,202315,true,1636856025,28,1643416233,6560208
1675792583,202313,true,1637183413,28,1643744933,6561520
1675792619,202312,true,1637347131,28,1644402529,7055398
1675792691,202308,true,1638002168,28,1645718512,7716344
1675792763,202305,true,1638493618,28,1647035548,8541930
1675792823,202303,true,1638821333,28,1648188818,9367485
1675792835,202302,true,1638985215,28,1648518473,9533258
1675792847,202298,true,1639640908,28,1648683325,9042417
1675792859,202295,true,1640132849,28,1649013078,8880229
1675792871,202293,true,1640460892,28,1649177979,8717087
1675792895,202292,true,1640624938,28,1649672782,9047844
1675793327,202288,true,1641281287,28,1658936400,17655113
1675793351,202285,true,1641773720,28,1659434131,17660411
1675793363,202283,true,1642102092,28,1659600074,17497982
1675793411,202282,true,1642266302,28,1660430040,18163738
1675793759,202279,true,1642759031,28,1666251436,23492405
1675793771,202276,true,1643251908,28,1666418061,23166153
1675793783,202275,true,1643416233,28,1666418061,23001828
1675793843,202274,true,1643580575,28,1666751361,23170786
1675793855,202272,true,1643909307,28,1666751361,22842054
1675793867,202269,true,1644402529,28,1666751361,22348832
1675794275,202268,true,1644566970,28,1666251436,21684466
1675794287,202268,true,1644566970,28,1666084827,21517857
1675794311,202266,true,1644895899,28,1665918236,21022337
1675794335,202263,true,1645389418,28,1665751660,20362242
1675794347,202263,true,1645389418,28,1665585102,20195684
1675794359,202263,true,1645389418,28,1665418560,20029142
1675794443,202262,true,1645553957,28,1664586101,19032144
1675794479,202260,true,1645883084,28,1663920433,18037349
1675794551,202261,true,1645718512,28,1662756154,17037642
1675794611,202261,true,1645718512,28,1661592690,15874178
1675794659,202260,true,1645883084,28,1660762143,14879059
1675795079,202259,true,1646047672,28,1651488330,5440658
1675795271,202260,true,1645883084,28,1647859230,1976146
1675795295,202261,true,1645718512,28,1647364971,1646459
1675795307,202260,true,1645883084,28,1647200251,1317167
1675796447,202259,true,1646047672,28,1635383591,-10664081
1675796519,202260,true,1645883084,28,1635547130,-10335954
1675796567,202260,true,1645883084,28,1635710684,-10172400
1675796579,202259,true,1646047672,28,1635710684,-10336988
1675796591,202258,true,1646212277,28,1635710684,-10501593
1675796723,202258,true,1646212277,28,1636365067,-9847210
1675796831,202258,true,1646212277,28,1636856025,-9356252
1675796843,202258,true,1646212277,28,1637019711,-9192566
1675796855,202257,true,1646376898,28,1637019711,-9357187
1675797035,202256,true,1646541536,28,1638493618,-8047918
1675797047,202255,true,1646706190,28,1638657468,-8048722
1675797071,202255,true,1646706190,28,1638821333,-7884857
1675797131,202254,true,1646870861,28,1639476960,-7393901
1675798415,202253,true,1647035548,28,1649672782,2637234
1675799315,202253,true,1647035548,28,1651983826,4948278
1675800023,202252,true,1647200251,28,1653305875,6105624
1675800611,202251,true,1647364971,28,1654463537,7098566
1675801703,202251,true,1647364971,28,1655456463,8091492
1675801727,202250,true,1647529708,28,1655622009,8092301
1675801739,202250,true,1647529708,28,1655622009,8092301
1675801823,202249,true,1647694461,28,1655787571,8093110
1675801859,202247,true,1648024016,28,1655787571,7763555
1675801967,202246,true,1648188818,28,1656118745,7929927
1675802003,202246,true,1648188818,28,1656118745,7929927
1675802531,202244,true,1648518473,28,1658107181,9588708
1675803143,202243,true,1648683325,28,1660762143,12078818
1675803239,202242,true,1648848193,28,1661094312,12246119
1675803335,202242,true,1648848193,28,1661592690,12744497
1675803995,202240,true,1649177979,28,1663587698,14409719
1675804007,202238,true,1649507831,28,1663587698,14079867
1675804019,202237,true,1649672782,28,1663587698,13914916
1675804031,202236,true,1649837749,28,1663587698,13749949
1675804043,202234,true,1650167733,28,1663587698,13419965
1675805951,202232,true,1650497783,28,1668585705,18087922
1675807583,202230,true,1650827899,28,1668752563,17924664
1675807595,202230,true,1650827899,28,1668752563,17924664
1675810103,202227,true,1651323197,28,1664919034,13595837
1675812275,202225,true,1651653478,28,1666918036,15264558
1675812287,202224,true,1651818644,28,1667084728,15266084
1675812311,202224,true,1651818644,28,1667084728,15266084
1675812479,202220,true,1652479470,28,1667251437,14771967
1675812599,202217,true,1652975264,28,1667584904,14609640
1675812647,202216,true,1653140561,28,1667584904,14444343
1675812719,202215,true,1653305875,28,1667751662,14445787
1675812743,202211,true,1653967297,28,1667751662,13784365
1675812839,202209,true,1654298107,28,1668085229,13787122
1675813775,202207,true,1654628983,28,1670756168,16127185
1675813895,202208,true,1654463537,28,1671090336,16626799
1675814519,202204,true,1655125421,28,1672093241,16967820
1675815911,202201,true,1655622009,28,1672093241,16471232
1675816019,202200,true,1655787571,28,1672260450,16472879
1675816631,202201,true,1655622009,28,1672929455,17307446
1675816643,202197,true,1656284357,28,1672929455,16645098
1675816679,202194,true,1656781292,28,1673096748,16315456
1675816691,202192,true,1657112665,28,1673096748,15984083
1675816739,202192,true,1657112665,28,1673431384,16318719
1675817099,202187,true,1657941387,28,1676110883,18169496
1675817159,202183,true,1658604663,28,1676613767,18009104
1675817555,202181,true,1658936400,28,1679466291,20529891
1675818671,202181,true,1658936400,28,1685185909,26249509
1675818755,202176,true,1659766034,28,1685354427,25588393
1675818767,202172,true,1660430040,28,1685354427,24924387
1675819043,202170,true,1660762143,28,1686534529,25772386
1675819055,202169,true,1660928219,28,1686534529,25606310
1675819067,202164,true,1661758849,28,1686534529,24775680
1675819103,202161,true,1662257427,28,1686703183,24445756
1675819127,202159,true,1662589895,28,1686703183,24113288
1675819259,202159,true,1662589895,28,1687040540,24450645
1675819391,202155,true,1663255031,28,1687377965,24122934
1675820291,202153,true,1663587698,28,1689066103,25478405
1675820627,202152,true,1663754057,28,1689403933,25649876
1675820639,202152,true,1663754057,28,1689403933,25649876
1675820891,202149,true,1664253233,28,1688728340,24475107
1675820903,202147,true,1664586101,28,1688559484,23973383
1675821659,202146,true,1664752559,28,1687546703,22794144
1675822247,202146,true,1664752559,28,1686871853,22119294
1675822319,202145,true,1664919034,28,1686871853,21952819
1675822487,202142,true,1665418560,28,1686534529,21115969
1675822511,202142,true,1665418560,28,1686534529,21115969
1675822739,202143,true,1665252035,28,1686197273,20945238
1675822775,202141,true,1665585102,28,1686197273,20612171
1675822859,202139,true,1665918236,28,1686028670,20110434
1675824275,202139,true,1665918236,28,1683838366,17920130
1675824563,202140,true,1665751660,28,1683838366,18086706
1675824755,202138,true,1666084827,28,1683669999,17585172
1675824767,202136,true,1666418061,28,1683669999,17251938
1675824935,202136,true,1666418061,28,1683669999,17251938
1675824959,202138,true,1666084827,28,1683669999,17585172
1675825559,202136,true,1666418061,28,1682996700,16578639
1675825595,202134,true,1666751361,28,1682996700,16245339
1675825643,202134,true,1666751361,28,1682828417,16077056
1675825883,202134,true,1666751361,28,1682491902,15740541
1675826447,202133,true,1666918036,28,1681650908,14732872
1675829711,202131,true,1667251437,28,1680810335,13558898
1675834175,202131,true,1667251437,28,1680810335,13558898
1675834943,202130,true,1667418162,28,1680474223,13056061
1675835039,202129,true,1667584904,28,1680306193,12721289
1675835159,202126,true,1668085229,28,1679970182,11884953
1675835747,202126,true,1668085229,28,1678962552,10877323
1675837007,202126,true,1668085229,28,1677619987,9534758
1675838519,202124,true,1668418863,28,1677619987,9201124
1675839935,202121,true,1668919439,28,1677619987,8700548
1675840127,202121,true,1668919439,28,1677619987,8700548
1675840211,202119,true,1669253239,28,1677619987,8366748
1675841039,202118,true,1669420165,28,1677619987,8199822
1675844183,202114,true,1670088033,28,1677619987,7531954
1675844627,202113,true,1670255042,28,1677619987,7364945
1675845455,202111,true,1670589109,28,1676781428,6192319
1675845527,202108,true,1671090336,28,1676781428,5691092
1675846211,202105,true,1671591713,28,1675775711,4183998
1675847303,202104,true,1671758873,28,1673933464,2174591
1675847423,202102,true,1672093241,28,1673766087,1672846
1675847507,202100,true,1672427676,28,1673766087,1338411
1675852391,202097,true,1672929455,28,1673264058,334603
1675853411,202096,true,1673096748,28,1673264058,167310
1675854431,202094,true,1673431384,28,1672929455,-501929
1675857047,202092,true,1673766087,28,1672427676,-1338411
1675857791,202090,true,1674100857,28,1672427676,-1673181
1675860743,202090,true,1674100857,28,1672427676,-1673181
1675860815,202088,true,1674435694,28,1672427676,-2008018
1675862999,202086,true,1674770598,28,1672427676,-2342922
1675864727,202084,true,1675105569,28,1672427676,-2677893
1675866791,202085,true,1674938075,28,1672427676,-2510399
1675867463,202083,true,1675273079,28,1672260450,-3012629
1675867475,202081,true,1675608150,28,1672260450,-3347700
1675867487,202080,true,1675775711,28,1672427676,-3348035
1675867931,202080,true,1675775711,28,1673431384,-2344327
1675867943,202078,true,1676110883,28,1673598727,-2512156
1675867955,202076,true,1676446122,28,1673598727,-2847395
1675867967,202075,true,1676613767,28,1673598727,-3015040
1675867991,202076,true,1676446122,28,1673598727,-2847395
1675868003,202073,true,1676949106,28,1673598727,-3350379
1675868051,202072,true,1677116801,28,1673598727,-3518074
1675868087,202072,true,1677116801,28,1673598727,-3518074
1675868567,202073,true,1676949106,28,1672594919,-4354187
1675869011,202071,true,1677284513,28,1671758873,-5525640
1675869143,202071,true,1677284513,28,1671424571,-5859942
1675869275,202071,true,1677284513,28,1671090336,-6194177
1675869299,202072,true,1677116801,28,1670923244,-6193557
1675869311,202071,true,1677284513,28,1670756168,-6528345
1675869323,202070,true,1677452241,28,1670756168,-6696073
1675869515,202071,true,1677284513,28,1669086331,-8198182
1675870319,202073,true,1676949106,28,1664752559,-12196547
1675870343,202071,true,1677284513,28,1664586101,-12698412
1675870415,202071,true,1677284513,28,1664253233,-13031280
1675870427,202072,true,1677116801,28,1664253233,-12863568
1675870547,202075,true,1676613767,28,1663587698,-13026069
1675871183,202073,true,1676949106,28,1660762143,-16186963
1675871543,202073,true,1676949106,28,1659932011,-17017095
1675871651,202074,true,1676781428,28,1659600074,-17181354
1675872047,202076,true,1676446122,28,1658272992,-18173130
1675872071,202075,true,1676613767,28,1658272992,-18340775
1675872407,202076,true,1676446122,28,1657278376,-19167746
1675872479,202077,true,1676278494,28,1656946970,-19331524
1675872563,202080,true,1675775711,28,1656615630,-19160081
1675872587,202079,true,1675943289,28,1656615630,-19327659
1675872719,202080,true,1675775711,28,1655953150,-19822561
1675872731,202081,true,1675608150,28,1655787571,-19820579
1675872851,202085,true,1674938075,28,1655125421,-19812654
1675872923,202083,true,1675273079,28,1654628983,-20644096
1675872947,202085,true,1674938075,28,1654463537,-20474538
1675873031,202087,true,1674603137,28,1653801917,-20801220
1675873091,202090,true,1674100857,28,1653305875,-20794982
1675873127,202090,true,1674100857,28,1653140561,-20960296
1675873211,202091,true,1673933464,28,1652314239,-21619225
1675873223,202094,true,1673431384,28,1652314239,-21117145
1675873235,202097,true,1672929455,28,1652149024,-20780431
1675873307,202098,true,1672762179,28,1651488330,-21273849
1675873511,202101,true,1672260450,28,1649342897,-22917553
1675873523,202104,true,1671758873,28,1649342897,-22415976
1675873571,202107,true,1671257445,28,1648683325,-22574120
1675873595,202108,true,1671090336,28,1648353637,-22736699
1675873715,202112,true,1670422067,28,1646706190,-23715877
1675873751,202115,true,1669921041,28,1646212277,-23708764
1675873787,202119,true,1669253239,28,1645883084,-23370155
1675873811,202121,true,1668919439,28,1645553957,-23365482
1675874339,202125,true,1668252038,28,1639804872,-28447166
1675874351,202127,true,1667918437,28,1639804872,-28113565
1675874363,202131,true,1667251437,28,1639640908,-27610529
1675874387,202133,true,1666918036,28,1639476960,-27441076
1675874807,202135,true,1666584703,28,1637510866,-29073837
1675874963,202138,true,1666084827,28,1637183413,-28901414
1675874999,202142,true,1665418560,28,1637183413,-28235147
1675875095,202143,true,1665252035,28,1637347131,-27904904
1675875335,202145,true,1664919034,28,1637838385,-27080649
1675875419,202148,true,1664419659,28,1638329785,-26089874
1675875431,202151,true,1663920433,28,1638329785,-25590648
1675875455,202152,true,1663754057,28,1638493618,-25260439
1675875467,202155,true,1663255031,28,1638657468,-24597563
1675875491,202156,true,1663088722,28,1638821333,-24267389
1675875803,202159,true,1662589895,28,1641281287,-21308608
1675876895,202160,true,1662423653,28,1647364971,-15058682
1675876931,202162,true,1662091218,28,1647529708,-14561510
1675876967,202164,true,1661758849,28,1647694461,-14064388
1675876979,202167,true,1661260421,28,1647694461,-13565960
1675876991,202168,true,1661094312,28,1647694461,-13399851
1675877015,202169,true,1660928219,28,1647859230,-13068989
1675877027,202171,true,1660596083,28,1648024016,-12572067
1675877063,202173,true,1660264014,28,1648188818,-12075196
1675877207,202174,true,1660098004,28,1649177979,-10920025
1675877447,202175,true,1659932011,28,1650167733,-9764278
1675877495,202176,true,1659766034,28,1650332750,-9433284
1675879655,202179,true,1659268204,28,1654794446,-4473758
1675879703,202179,true,1659268204,28,1654794446,-4473758
1675880447,202181,true,1658936400,28,1654959925,-3976475
1675880615,202182,true,1658770523,28,1654959925,-3810598
1675880855,202185,true,1658272992,28,1654794446,-3478546
1675881575,202185,true,1658272992,28,1653967297,-4305695
1675881587,202187,true,1657941387,28,1653967297,-3974090
1675882127,202188,true,1657775609,28,1652809983,-4965626
1675882247,202190,true,1657444104,28,1652479470,-4964634
1675882271,202191,true,1657278376,28,1652314239,-4964137
1675882331,202192,true,1657112665,28,1652149024,-4963641
1675882415,202194,true,1656781292,28,1651818644,-4962648
1675882475,202197,true,1656284357,28,1651653478,-4630879
1675882487,202197,true,1656284357,28,1651488330,-4796027
1675882511,202199,true,1655953150,28,1651488330,-4464820
1675884143,202201,true,1655622009,28,1645883084,-9738925
1675886795,202204,true,1655125421,28,1645718512,-9406909
1675891043,202204,true,1655125421,28,1643744933,-11380488
1675891763,202206,true,1654794446,28,1643744933,-11049513
1675891799,202208,true,1654463537,28,1643909307,-10554230
1675891931,202210,true,1654132694,28,1643909307,-10223387
1675892003,202211,true,1653967297,28,1643909307,-10057990
1675892051,202212,true,1653801917,28,1643909307,-9892610
1675892087,202214,true,1653471206,28,1644073698,-9397508
1675892099,202216,true,1653140561,28,1644073698,-9066863
1675892339,202217,true,1652975264,28,1644402529,-8572735
1675892351,202218,true,1652809983,28,1644402529,-8407454
1675892543,202220,true,1652479470,28,1644731426,-7748044
1675892807,202222,true,1652149024,28,1645553957,-6595067
1675898111,202221,true,1652314239,28,1651323197,-991042
1675898183,202222,true,1652149024,28,1651488330,-660694
1675898219,202224,true,1651818644,28,1651323197,-495447
1675898375,202226,true,1651488330,28,1651158081,-330249
1675898387,202226,true,1651488330,28,1651158081,-330249
1675899167,202228,true,1651158081,28,1649507831,-1650250
1675899683,202229,true,1650992982,28,1648518473,-2474509
1675899719,202232,true,1650497783,28,1648518473,-1979310
1675899935,202232,true,1650497783,28,1648188818,-2308965
1675900391,202234,true,1650167733,28,1648024016,-2143717
1675904303,202235,true,1650002733,28,1648518473,-1484260
1675904315,202238,true,1649507831,28,1648683325,-824506
1675904351,202238,true,1649507831,28,1648683325,-824506
1675904399,202239,true,1649342897,28,1648683325,-659572
1675904447,202240,true,1649177979,28,1648683325,-494654
1675904495,202242,true,1648848193,28,1648683325,-164868
1675904951,202242,true,1648848193,28,1649342897,494704
1675905791,202243,true,1648683325,28,1650332750,1649425
1675908863,202244,true,1648518473,28,1650992982,2474509
1675909547,202245,true,1648353637,28,1650827899,2474262
1675910639,202245,true,1648353637,28,1650332750,1979113
1675910651,202246,true,1648188818,28,1650167733,1978915
1675911095,202247,true,1648024016,28,1649342897,1318881
1675911119,202248,true,1647859230,28,1649342897,1483667
1675911143,202249,true,1647694461,28,1649342897,1648436
1675911155,202250,true,1647529708,28,1649342897,1813189
1675911323,202250,true,1647529708,28,1648683325,1153617
1675911335,202251,true,1647364971,28,1648683325,1318354
1675911371,202252,true,1647200251,28,1648518473,1318222
1675911407,202253,true,1647035548,28,1648353637,1318089
1675911443,202254,true,1646870861,28,1648188818,1317957
1675911455,202255,true,1646706190,28,1648188818,1482628
1675911539,202255,true,1646706190,28,1647694461,988271
1675911563,202256,true,1646541536,28,1647529708,988172
1675911659,202258,true,1646212277,28,1646870861,658584
1675911683,202258,true,1646212277,28,1646706190,493913
1675911707,202259,true,1646047672,28,1646376898,329226
1675911719,202259,true,1646047672,28,1646376898,329226
1675911743,202262,true,1645553957,28,1646047672,493715
1675911755,202262,true,1645553957,28,1645883084,329127
1675911767,202264,true,1645224895,28,1645718512,493617
1675911887,202264,true,1645224895,28,1644073698,-1151197
1675911911,202266,true,1644895899,28,1643744933,-1150966
1675911935,202267,true,1644731426,28,1643416233,-1315193
1675911947,202268,true,1644566970,28,1643251908,-1315062
1675911983,202269,true,1644402529,28,1642594771,-1807758
1675912019,202271,true,1644073698,28,1641937898,-2135800
1675912055,202272,true,1643909307,28,1641281287,-2628020
1675912295,202273,true,1643744933,28,1636365067,-7379866
1675912355,202274,true,1643580575,28,1635220069,-8360506
1675912367,202277,true,1643087599,28,1635056564,-8031035
1675912451,202277,true,1643087599,28,1633422406,-9665193
1675912463,202278,true,1642923307,28,1633259080,-9664227
1675912667,202278,true,1642923307,28,1629995989,-12927318
1675912787,202280,true,1642594771,28,1628041265,-14553506
1675912883,202280,true,1642594771,28,1626576760,-16018011
1675912907,202281,true,1642430528,28,1626251493,-16179035
1675912943,202281,true,1642430528,28,1625763716,-16666812
1675913171,202283,true,1642102092,28,1623002403,-19099689
1675913339,202283,true,1642102092,28,1621218171,-20883921
1675913459,202284,true,1641937898,28,1620083772,-21854126
1675913507,202285,true,1641773720,28,1619759804,-22013916
1675913543,202287,true,1641445415,28,1619597844,-21847571
1675913675,202288,true,1641281287,28,1619112062,-22169225
1675913711,202289,true,1641117175,28,1618950167,-22167008
1675913723,202290,true,1640953080,28,1618950167,-22002913
1675913963,202292,true,1640624938,28,1619273973,-21350965
1675914107,202293,true,1640460892,28,1619435901,-21024991
1675914167,202294,true,1640296863,28,1619597844,-20699019
1675914311,202295,true,1640132849,28,1619597844,-20535005
1675914323,202298,true,1639640908,28,1619597844,-20043064
1675915163,202299,true,1639476960,28,1618950167,-20526793
1675915403,202301,true,1639149114,28,1618788288,-20360826
1675915475,202302,true,1638985215,28,1618788288,-20196927
1675915487,202305,true,1638493618,28,1618788288,-19705330
1675915535,202306,true,1638329785,28,1618788288,-19541497
1675915559,202308,true,1638002168,28,1618788288,-19213880
1675915967,202309,true,1637838385,28,1618464579,-19373806
1675916027,202313,true,1637183413,28,1618464579,-18718834
1675916051,202314,true,1637019711,28,1618464579,-18555132
1675916123,202316,true,1636692356,28,1618464579,-18227777
1675916219,202317,true,1636528703,28,1618464579,-18064124
1675916243,202320,true,1636037843,28,1618464579,-17573264
1675916459,202321,true,1635874255,28,1618626426,-17247829
1675916591,202323,true,1635547130,28,1618788288,-16758842
1675917263,202325,true,1635220069,28,1619273973,-15946096
1675917275,202328,true,1634729601,28,1619273973,-15455628
1675917863,202329,true,1634566145,28,1620893976,-13672169
1675917947,202330,true,1634402704,28,1621056066,-13346638
1675918019,202331,true,1634239280,28,1621218171,-13021109
1675918067,202334,true,1633749107,28,1621218171,-12530936
1675918763,202335,true,1633585748,28,1621866756,-11718992
1675919219,202337,true,1633259080,28,1622191145,-11067935
1675919723,202338,true,1633095770,28,1622353364,-10742406
1675921331,202340,true,1632769200,28,1622353364,-10415836
1675921439,202341,true,1632605940,28,1622515600,-10090340
1675921451,202342,true,1632442695,28,1622515600,-9927095
1675921571,202343,true,1632279467,28,1622515600,-9763867
1675921595,202345,true,1631953061,28,1622677851,-9275210
1675921739,202345,true,1631953061,28,1622840119,-9112942
1675921967,202347,true,1631626719,28,1623164703,-8462016
1675922363,202347,true,1631626719,28,1623976448,-7650271
1675922795,202349,true,1631300442,28,1624788599,-6511843
1675923251,202349,true,1631300442,28,1625601155,-5699287
1675923323,202351,true,1630974231,28,1625763716,-5210515
1675923467,202351,true,1630974231,28,1625926292,-5047939
1675925183,202353,true,1630648085,28,1626088885,-4559200
1675925291,202353,true,1630648085,28,1626251493,-4396592
1675925303,202355,true,1630322005,28,1626251493,-4070512
1675925339,202356,true,1630158989,28,1626251493,-3907496
1675925351,202358,true,1629833006,28,1626251493,-3581513
1675925423,202358,true,1629833006,28,1626251493,-3581513
1675925435,202360,true,1629507088,28,1626414119,-3092969
1675925459,202361,true,1629344154,28,1626414119,-2930035
1675926311,202362,true,1629181236,28,1629018334,-162902
1675929215,202362,true,1629181236,28,1631789882,2608646
1675929647,202364,true,1628855448,28,1631789882,2934434
1675931387,202364,true,1628855448,28,1631789882,2934434
1675933067,202365,true,1628692579,28,1631953061,3260482
1675933079,202365,true,1628692579,28,1631953061,3260482
1675933403,202367,true,1628366889,28,1631463573,3096684
1675933451,202368,true,1628204069,28,1631300442,3096373
1675933607,202370,true,1627878477,28,1631137329,3258852
1675933643,202370,true,1627878477,28,1630974231,3095754
1675933979,202371,true,1627715705,28,1630648085,2932380
1675934195,202372,true,1627552950,28,1630485037,2932087
1675934219,202374,true,1627227488,28,1630485037,3257549
1675935107,202374,true,1627227488,28,1631137329,3909841
1675935875,202375,true,1627064782,28,1632279467,5214685
1675937375,202376,true,1626902092,28,1632279467,5377375
1675938887,202378,true,1626576760,28,1632279467,5702707
1675940315,202378,true,1626576760,28,1632279467,5702707
1675942523,202379,true,1626414119,28,1632279467,5865348
1675943459,202380,true,1626251493,28,1632116256,5864763
1675943531,202382,true,1625926292,28,1632279467,6353175
1675943759,202381,true,1626088885,28,1632605940,6517055
1675946303,202382,true,1625926292,28,1634402704,8476412
1675946339,202383,true,1625763716,28,1634402704,8638988
1675946783,202384,true,1625601155,28,1633912482,8311327
1675946927,202384,true,1625601155,28,1633912482,8311327
1675946939,202385,true,1625438612,28,1633912482,8473870
1675946951,202385,true,1625438612,28,1633912482,8473870
1675947395,202386,true,1625276084,28,1634402704,9126620
1675948187,202385,true,1625438612,28,1635547130,10108518
1675948451,202386,true,1625276084,28,1636365067,11088983
1675949399,202386,true,1625276084,28,1637838385,12562301
1675949603,202386,true,1625276084,28,1638165969,12889885
1675952819,202385,true,1625438612,28,1638493618,13055006
1675952999,202385,true,1625438612,28,1638657468,13218856
1675953263,202385,true,1625438612,28,1638657468,13218856
1675953275,202384,true,1625601155,28,1638657468,13056313
1675953311,202383,true,1625763716,28,1638657468,12893752
1675953323,202383,true,1625763716,28,1638821333,13057617
1675953779,202382,true,1625926292,28,1639804872,13878580
1675953815,202381,true,1626088885,28,1639968852,13879967
1675953827,202379,true,1626414119,28,1639968852,13554733
1675954823,202379,true,1626414119,28,1641609559,15195440
1675954859,202377,true,1626739418,28,1641773720,15034302
1675954931,202376,true,1626902092,28,1641773720,14871628
1675956311,202374,true,1627227488,28,1641445415,14217927
1675956455,202373,true,1627390211,28,1641281287,13891076
1675956539,202371,true,1627715705,28,1641117175,13401470
1675956911,202370,true,1627878477,28,1640132849,12254372
1675956923,202369,true,1628041265,28,1640132849,12091584
1675957319,202369,true,1628041265,28,1638821333,10780068
1675957331,202367,true,1628366889,28,1638821333,10454444
1675957355,202366,true,1628529726,28,1638657468,10127742
1675957883,202365,true,1628692579,28,1636365067,7672488
1675959599,202366,true,1628529726,28,1633095770,4566044
1675959623,202364,true,1628855448,28,1633095770,4240322
1675959671,202364,true,1628855448,28,1633095770,4240322
1675959707,202363,true,1629018334,28,1633095770,4077436
1675959815,202364,true,1628855448,28,1632932477,4077029
1675959827,202362,true,1629181236,28,1632932477,3751241
1675959911,202362,true,1629181236,28,1632769200,3587964
1675959935,202361,true,1629344154,28,1632769200,3425046
1675960295,202362,true,1629181236,28,1631626719,2445483
1675960319,202361,true,1629344154,28,1631626719,2282565
1675960355,202360,true,1629507088,28,1631463573,1956485
1675960403,202359,true,1629670039,28,1631300442,1630403
1675960475,202360,true,1629507088,28,1630974231,1467143
1675961051,202359,true,1629670039,28,1627552950,-2117089
1675962443,202359,true,1629670039,28,1621704585,-7965454
1675962551,202358,true,1629833006,28,1621704585,-8128421
1675962587,202360,true,1629507088,28,1621704585,-7802503
1675962635,202359,true,1629670039,28,1621704585,-7965454
1675964099,202358,true,1629833006,28,1624626136,-5206870
1675964111,202357,true,1629995989,28,1624626136,-5369853
1675964135,202358,true,1629833006,28,1624626136,-5206870
1675964171,202357,true,1629995989,28,1624626136,-5369853
1675964183,202356,true,1630158989,28,1624626136,-5532853
1675964195,202355,true,1630322005,28,1624626136,-5695869
1675964315,202357,true,1629995989,28,1624626136,-5369853
1675964723,202356,true,1630158989,28,1624138846,-6020143
1675965227,202356,true,1630158989,28,1623002403,-7156586
1675966283,202355,true,1630322005,28,1621542431,-8779574
1675966475,202357,true,1629995989,28,1621704585,-8291404
1675966487,202356,true,1630158989,28,1621704585,-8454404
1675966871,202355,true,1630322005,28,1622028942,-8293063
1675966883,202355,true,1630322005,28,1622028942,-8293063
1675966931,202356,true,1630158989,28,1622191145,-7967844
1675966943,202356,true,1630158989,28,1622191145,-7967844
1675967003,202355,true,1630322005,28,1622353364,-7968641
1675967075,202354,true,1630485037,28,1622515600,-7969437
1675967159,202355,true,1630322005,28,1622677851,-7644154
1675968563,202355,true,1630322005,28,1625926292,-4395713
1675968599,202354,true,1630485037,28,1625926292,-4558745
1675968623,202353,true,1630648085,28,1625926292,-4721793
1675969523,202355,true,1630322005,28,1625438612,-4883393
1675969643,202354,true,1630485037,28,1625276084,-5208953
1675969679,202354,true,1630485037,28,1625276084,-5208953
1675969727,202353,true,1630648085,28,1625113573,-5534512
1675969823,202355,true,1630322005,28,1625113573,-5208432
1675969859,202355,true,1630322005,28,1624951078,-5370927
1675969883,202354,true,1630485037,28,1624951078,-5533959
1675969895,202354,true,1630485037,28,1624788599,-5696438
1675970015,202356,true,1630158989,28,1624463690,-5695299
1675970051,202356,true,1630158989,28,1624301260,-5857729
1675970063,202356,true,1630158989,28,1624301260,-5857729
1675970363,202356,true,1630158989,28,1622677851,-7481138
1675970375,202358,true,1629833006,28,1622677851,-7155155
1675970663,202358,true,1629833006,28,1621056066,-8776940
1675970675,202358,true,1629833006,28,1620893976,-8939030
1675970687,202359,true,1629670039,28,1620731903,-8938136
1675970699,202361,true,1629344154,28,1620569846,-8774308
1675970711,202364,true,1628855448,28,1620407805,-8447643
1675970735,202366,true,1628529726,28,1620083772,-8445954
1675970771,202367,true,1628366889,28,1619435901,-8930988
1675970783,202370,true,1627878477,28,1619112062,-8766415
1675970795,202373,true,1627390211,28,1618950167,-8440044
1675971047,202376,true,1626902092,28,1613294028,-13608064
1675971059,202377,true,1626739418,28,1613132715,-13606703
1675971071,202380,true,1626251493,28,1612810137,-13441356
1675971095,202384,true,1625601155,28,1612165174,-13435981
1675971119,202387,true,1625113573,28,1611520469,-13593104
1675971143,202389,true,1624788599,28,1610714951,-14073648
1675971155,202393,true,1624138846,28,1610392856,-13745990
1675971179,202397,true,1623489353,28,1609587901,-13901452
1675971203,202401,true,1622840119,28,1608783348,-14056771
1675971227,202404,true,1622353364,28,1607979198,-14374166
1675971335,202408,true,1621704585,28,1604445709,-17258876
1675971347,202412,true,1621056066,28,1604124868,-16931198
1675971395,202416,true,1620407805,28,1602681877,-17725928
1675971515,202418,true,1620083772,28,1599160028,-20923744
1675971755,202421,true,1619597844,28,1592457976,-27139868
1675971803,202426,true,1618788288,28,1591184582,-27603706
1675971839,202429,true,1618302749,28,1590230206,-28072543
1675972043,202431,true,1617979137,28,1585308371,-32670766
1675972487,202435,true,1617332107,28,1574722835,-42609272
1675972739,202439,true,1616685336,28,1572519876,-44165460
1675972799,202443,true,1616038823,28,1572048214,-43990609
1675973099,202445,true,1615715664,28,1572519876,-43195788
1675973123,202448,true,1615231046,28,1572677128,-42553918
1675973315,202452,true,1614585115,28,1573148978,-41436137
1675973819,202457,true,1613778065,28,1573463624,-40314441
1675973843,202459,true,1613455358,28,1573463624,-39991734
1675973867,202462,true,1612971418,28,1573463624,-39507794
1675974227,202467,true,1612165174,28,1573463624,-38701550
1675974263,202471,true,1611520469,28,1573463624,-38056845
1675974419,202474,true,1611037110,28,1573463624,-37573486
1675975163,202477,true,1610553895,28,1572048214,-38505681
1675975175,202482,true,1609748860,28,1571891025,-37857835
1675975247,202486,true,1609105121,28,1571891025,-37214096
1675975463,202489,true,1608622486,28,1572048214,-36574272
1675975475,202492,true,1608139996,28,1572048214,-36091782
1675975487,202497,true,1607336167,28,1572048214,-35287953
1675975499,202501,true,1606693393,28,1572048214,-34645179
1675975583,202503,true,1606372103,28,1572205419,-34166684
1675975595,202506,true,1605890288,28,1572205419,-33684869
1675975607,202511,true,1605087583,28,1572362639,-32724944
1675975667,202515,true,1604445709,28,1572677128,-31768581
1675975907,202517,true,1604124868,28,1573935710,-30189158
1675976423,202519,true,1603804091,28,1576613542,-27190549
1675976519,202524,true,1603002429,28,1577086574,-25915855
1675976555,202528,true,1602361389,28,1577402007,-24959382
1675976591,202529,true,1602201169,28,1577559747,-24641422
1675976639,202532,true,1601720604,28,1577717503,-24003101
1675976663,202537,true,1600919984,28,1577717503,-23202481
1675976675,202541,true,1600279776,28,1577875275,-22404501
1675976711,202542,true,1600119764,28,1577875275,-22244489
1675976723,202544,true,1599799788,28,1578033062,-21766726
1675977851,202550,true,1598840244,28,1576455897,-22384347
1675977875,202554,true,1598200868,28,1576298267,-21902601
1675977947,202555,true,1598041064,28,1575825472,-22215592
1675977959,202557,true,1597721504,28,1575825472,-21896032
1675977983,202564,true,1596603546,28,1575667905,-20935641
1675978187,202568,true,1595965064,28,1574250513,-21714551
1675978211,202569,true,1595805484,28,1574093103,-21712381
1675978223,202571,true,1595486370,28,1573935710,-21550660
1675978247,202577,true,1594529413,28,1573620970,-20908443
1675978271,202584,true,1593413689,28,1573148978,-20264711
1675978283,202586,true,1593095054,28,1572834395,-20260659
1675978295,202588,true,1592776483,28,1572677128,-20099355
1675978319,202595,true,1591661985,28,1572048214,-19613771
1675978391,202602,true,1590548267,28,1570477030,-20071237
1675978523,202605,true,1590071198,28,1567496106,-22575092
1675978547,202607,true,1589753232,28,1567025951,-22727281
1675978607,202614,true,1588640850,28,1565929471,-22711379
1675978619,202622,true,1587370509,28,1565772894,-21597615
1675978631,202624,true,1587053082,28,1565459786,-21593296
1675978643,202626,true,1586735719,28,1565303256,-21432463
1675978655,202633,true,1585625448,28,1565146741,-20478707
1675978667,202639,true,1584674406,28,1564990242,-19684164
1675978679,202641,true,1584357519,28,1564833759,-19523760
1675978703,202643,true,1584040695,28,1564364403,-19676292
1675978955,202649,true,1583090603,28,1561238957,-21851646
1675979003,202656,true,1581982882,28,1560458571,-21524311
1675979195,202658,true,1581666533,28,1557496663,-24169870
1675979267,202659,true,1581508382,28,1556406851,-25101531
1675979375,202666,true,1580401769,28,1554540376,-25861393
1675979387,202673,true,1579295930,28,1554384938,-24910992
1675979423,202676,true,1578822236,28,1553607978,-25214258
1675979435,202678,true,1578506519,28,1553452633,-25053886
1675979495,202685,true,1577402007,28,1552210430,-25191577
1675979567,202693,true,1576140653,28,1550659073,-25481580
1675979819,202696,true,1575667905,28,1545241523,-30426382
1675979855,202698,true,1575352819,28,1544469134,-30883685
1675979867,202706,true,1574093103,28,1544160287,-29932816
1675979879,202714,true,1572834395,28,1544005886,-28828509
1675979891,202717,true,1572362639,28,1543697131,-28665508
1675979915,202719,true,1572048214,28,1543388438,-28659776
1675979951,202726,true,1570948220,28,1542616976,-28331244
1675979975,202734,true,1569692027,28,1542154283,-27537744
1675979999,202737,true,1569221214,28,1541845898,-27375316
1675980095,202739,true,1568907417,28,1540921115,-27986302
1675980107,202746,true,1567809620,28,1540921115,-26888505
1675980155,202754,true,1566555937,28,1540921115,-25634822
1675980191,202757,true,1566086064,28,1540767038,-25319026
1675980263,202758,true,1565929471,28,1540767038,-25162433
1675980299,202765,true,1564833759,28,1540767038,-24066721
1675980311,202772,true,1563738813,28,1540612977,-23125836
1675980443,202776,true,1563113474,28,1540304900,-22808574
1675980455,202776,true,1563113474,28,1540304900,-22808574
1675980467,202783,true,1562019732,28,1540304900,-21714832
1675980515,202790,true,1560926756,28,1539996885,-20929871
1675980587,202792,true,1560614617,28,1539534979,-21079638
1675980599,202793,true,1560458571,28,1539381041,-21077530
1675980647,202797,true,1559834544,28,1539227118,-20607426
1675980779,202803,true,1558898971,28,1538457735,-20441236
1675980923,202805,true,1558587238,28,1537842506,-20744732
1675980935,202805,true,1558587238,28,1537842506,-20744732
1675981007,202809,true,1557963959,28,1537688737,-20275222
1675981019,202814,true,1557185210,28,1537688737,-19496473
1675981055,202815,true,1557029507,28,1537688737,-19340770
1675981067,202815,true,1557029507,28,1537688737,-19340770
1675981079,202818,true,1556562492,28,1537688737,-18873755
1675981127,202821,true,1556095616,28,1537688737,-18406879
1675981259,202822,true,1555940022,28,1537996290,-17943732
1675981751,202821,true,1556095616,28,1541075207,-15020409
1675982027,202823,true,1555784444,28,1543234115,-12550329
1675982039,202826,true,1555317802,28,1543388438,-11929364
1675982435,202826,true,1555317802,28,1545859713,-9458089
1675982663,202825,true,1555473334,28,1546942139,-8531195
1675982675,202827,true,1555162286,28,1546942139,-8220147
1675982687,202830,true,1554695830,28,1547096833,-7598997
1675982711,202831,true,1554540376,28,1547096833,-7443543
1675983107,202831,true,1554540376,28,1547715765,-6824611
1675983119,202833,true,1554229515,28,1547715765,-6513750
1675983131,202836,true,1553763339,28,1547715765,-6047574
1675983143,202837,true,1553607978,28,1547561009,-6046969
1675983263,202838,true,1553452633,28,1547251543,-6201090
1675983275,202840,true,1553141989,28,1547251543,-5890446
1675983287,202844,true,1552520888,28,1547251543,-5269345
1675983491,202845,true,1552365651,28,1546014299,-6351352
1675983779,202847,true,1552055225,28,1544005886,-8049339
1675983923,202849,true,1551744860,28,1543079807,-8665053
1675983959,202852,true,1551279430,28,1542925514,-8353916
1675984079,202853,true,1551124317,28,1542154283,-8970034
1675984127,202855,true,1550814139,28,1542000083,-8814056
1675984151,202857,true,1550504023,28,1541845898,-8658125
1675984271,202860,true,1550038965,28,1541383437,-8655528
1675984367,202860,true,1550038965,28,1540921115,-9117850
1675984595,202862,true,1549729003,28,1539996885,-9732118
1675984907,202864,true,1549419104,28,1539227118,-10191986
1675984919,202867,true,1548954371,28,1539227118,-9727253
1675985135,202867,true,1548954371,28,1539534979,-9419392
1675985207,202869,true,1548644627,28,1539842901,-8801726
1675986119,202871,true,1548334944,28,1542308498,-6026446
1675986131,202874,true,1547870537,28,1542308498,-5562039
1675986167,202875,true,1547715765,28,1542462729,-5253036
1675987655,202877,true,1547406268,28,1545087015,-2319253
1675987667,202878,true,1547251543,28,1545087015,-2164528
1675987679,202882,true,1546632797,28,1545087015,-1545782
1675987703,202883,true,1546478149,28,1545241523,-1236626
1675988303,202884,true,1546323517,28,1546787461,463944
1675988915,202886,true,1546014299,28,1548334944,2320645
1675989539,202889,true,1545550587,28,1549574046,4023459
1675989599,202890,true,1545396048,28,1549574046,4177998
1675989611,202891,true,1545241523,28,1549574046,4332523
1675990607,202892,true,1545087015,28,1550038965,4951950
1675991447,202895,true,1544623581,28,1550348988,5725407
1675991615,202897,true,1544314703,28,1550348988,6034285
1675992071,202897,true,1544314703,28,1550348988,6034285
1675992539,202898,true,1544160287,28,1550348988,6188701
1675992563,202901,true,1543697131,28,1550348988,6651857
1675992599,202902,true,1543542777,28,1550348988,6806211
1675992803,202902,true,1543542777,28,1550348988,6806211
1675993391,202902,true,1543542777,28,1550038965,6496188
1675994051,202905,true,1543079807,28,1549729003,6649196
1675996151,202906,true,1542925514,28,1549574046,6648532
1675996175,202907,true,1542771237,28,1549574046,6802809
1675996199,202906,true,1542925514,28,1549574046,6648532
1675996259,202907,true,1542771237,28,1549574046,6802809
1675997495,202907,true,1542771237,28,1548954371,6183134
1675997687,202906,true,1542925514,28,1548954371,6028857
1675997879,202905,true,1543079807,28,1548799491,5719684
1675998659,202905,true,1543079807,28,1548799491,5719684
1675999571,202904,true,1543234115,28,1548954371,5720256
1676000939,202904,true,1543234115,28,1548954371,5720256
1676001035,202903,true,1543388438,28,1548954371,5565933
1676001107,202902,true,1543542777,28,1548954371,5411594
1676001479,202903,true,1543388438,28,1548644627,5256189
1676001743,202902,true,1543542777,28,1548489778,4947001
1676001947,202902,true,1543542777,28,1548180126,4637349
1676001983,202902,true,1543542777,28,1548180126,4637349
1676002067,202902,true,1543542777,28,1547870537,4327760
1676002103,202903,true,1543388438,28,1547870537,4482099
1676002163,202903,true,1543388438,28,1547715765,4327327
1676002223,202903,true,1543388438,28,1547406268,4017830
1676002283,202904,true,1543234115,28,1547251543,4017428
1676002295,202904,true,1543234115,28,1547251543,4017428
1676002691,202905,true,1543079807,28,1544778044,1698237
1676002895,202905,true,1543079807,28,1543697131,617324
1676003015,202905,true,1543079807,28,1543079807,0
1676003483,202905,true,1543079807,28,1541075207,-2004600
1676005535,202905,true,1543079807,28,1540304900,-2774907
1676005559,202904,true,1543234115,28,1540304900,-2929215
1676005871,202903,true,1543388438,28,1540304900,-3083538
1676006711,202903,true,1543388438,28,1540304900,-3083538
1676006819,202903,true,1543388438,28,1540304900,-3083538
1676006867,202902,true,1543542777,28,1540304900,-3237877
1676007191,202902,true,1543542777,28,1539996885,-3545892
1676007503,202902,true,1543542777,28,1539534979,-4007798
1676007563,202902,true,1543542777,28,1539381041,-4161736
1676007611,202902,true,1543542777,28,1539381041,-4161736
1676007623,202901,true,1543697131,28,1539381041,-4316090
1676007671,202902,true,1543542777,28,1539381041,-4161736
1676007863,202901,true,1543697131,28,1539534979,-4162152
1676007887,202901,true,1543697131,28,1539534979,-4162152
1676008019,202900,true,1543851501,28,1539688932,-4162569
1676008415,202900,true,1543851501,28,1539996885,-3854616
1676009399,202900,true,1543851501,28,1542000083,-1851418
1676009819,202899,true,1544005886,28,1542154283,-1851603
1676009855,202899,true,1544005886,28,1542308498,-1697388
1676010695,202899,true,1544005886,28,1542308498,-1697388
1676010731,202898,true,1544160287,28,1542308498,-1851789
1676010755,202898,true,1544160287,28,1542308498,-1851789
1676010875,202898,true,1544160287,28,1542462729,-1697558
1676012579,202898,true,1544160287,28,1544314703,154416
1676012615,202897,true,1544314703,28,1544314703,0
1676014691,202897,true,1544314703,28,1544623581,308878
1676014703,202897,true,1544314703,28,1544623581,308878
1676014727,202897,true,1544314703,28,1544778044,463341
1676014835,202896,true,1544469134,28,1544778044,308910
1676014895,202896,true,1544469134,28,1544778044,308910
1676015051,202896,true,1544469134,28,1544932522,463388
1676015087,202896,true,1544469134,28,1544932522,463388
1676015243,202896,true,1544469134,28,1545087015,617881
1676015495,202895,true,1544623581,28,1545396048,772467
1676015519,202896,true,1544469134,28,1545396048,926914
1676015723,202896,true,1544469134,28,1545859713,1390579
1676017655,202895,true,1544623581,28,1549419104,4795523
1676017775,202895,true,1544623581,28,1549419104,4795523
1676017967,202895,true,1544623581,28,1549419104,4795523
1676018063,202896,true,1544469134,28,1549419104,4949970
1676018435,202894,true,1544778044,28,1550348988,5570944
1676018447,202894,true,1544778044,28,1550504023,5725979
1676018819,202894,true,1544778044,28,1551434558,6656514
1676019551,202894,true,1544778044,28,1553297303,8519259
1676019731,202893,true,1544932522,28,1553763339,8830817
1676019839,202892,true,1545087015,28,1554074107,8987092
1676020571,202892,true,1545087015,28,1554074107,8987092
1676020607,202891,true,1545241523,28,1554074107,8832584
1676021027,202890,true,1545396048,28,1553763339,8367291
1676021591,202889,true,1545550587,28,1553297303,7746716
1676021783,202889,true,1545550587,28,1553141989,7591402
1676022671,202887,true,1545859713,28,1552831407,6971694
1676022683,202886,true,1546014299,28,1552831407,6817108
1676022695,202885,true,1546168900,28,1552831407,6662507
1676022719,202885,true,1546168900,28,1552831407,6662507
1676022935,202884,true,1546323517,28,1552676140,6352623
1676023055,202883,true,1546478149,28,1552520888,6042739
1676023235,202883,true,1546478149,28,1552365651,5887502
1676023619,202883,true,1546478149,28,1552055225,5577076
1676023631,202882,true,1546632797,28,1552055225,5422428
1676023727,202881,true,1546787461,28,1551744860,4957399
1676023751,202881,true,1546787461,28,1551744860,4957399
1676024003,202881,true,1546787461,28,1551124317,4336856
1676024063,202880,true,1546942139,28,1550969220,4027081
1676024291,202879,true,1547096833,28,1550504023,3407190
1676025011,202879,true,1547096833,28,1549109267,2012434
1676025107,202880,true,1546942139,28,1548954371,2012232
1676025407,202879,true,1547096833,28,1548489778,1392945
1676027375,202879,true,1547096833,28,1547251543,154710
1676027495,202879,true,1547096833,28,1547251543,154710
1676027507,202880,true,1546942139,28,1547251543,309404
1676027531,202880,true,1546942139,28,1547251543,309404
1676028395,202880,true,1546942139,28,1546014299,-927840
1676028515,202880,true,1546942139,28,1545705142,-1236997
1676028707,202881,true,1546787461,28,1545396048,-1391413
1676028731,202881,true,1546787461,28,1545241523,-1545938
1676028791,202881,true,1546787461,28,1545087015,-1700446
1676028935,202882,true,1546632797,28,1544778044,-1854753
1676029427,202883,true,1546478149,28,1543388438,-3089711
1676029787,202883,true,1546478149,28,1542771237,-3706912
1676029859,202883,true,1546478149,28,1542616976,-3861173
1676030963,202884,true,1546323517,28,1540304900,-6018617
1676031815,202885,true,1546168900,28,1539073211,-7095689
1676032439,202885,true,1546168900,28,1538611581,-7557319
1676033483,202886,true,1546014299,28,1538303905,-7710394
1676033519,202887,true,1545859713,28,1538303905,-7555808
1676035439,202888,true,1545705142,28,1538150090,-7555052
1676036927,202888,true,1545705142,28,1538150090,-7555052
1676037083,202889,true,1545550587,28,1538150090,-7400497
1676038235,202889,true,1545550587,28,1538150090,-7400497
1676038631,202890,true,1545396048,28,1538150090,-7245958
1676038643,202891,true,1545241523,28,1538303905,-6937618
1676038847,202891,true,1545241523,28,1538303905,-6937618
1676039639,202891,true,1545241523,28,1538919319,-6322204
1676039699,202892,true,1545087015,28,1538919319,-6167696
1676039711,202893,true,1544932522,28,1538919319,-6013203
1676039735,202893,true,1544932522,28,1538919319,-6013203
1676039759,202893,true,1544932522,28,1539073211,-5859311
1676039831,202894,true,1544778044,28,1539227118,-5550926
1676039855,202894,true,1544778044,28,1539227118,-5550926
1676039867,202894,true,1544778044,28,1539227118,-5550926
1676040143,202894,true,1544778044,28,1540612977,-4165067
1676040155,202894,true,1544778044,28,1540612977,-4165067
1676040203,202894,true,1544778044,28,1540767038,-4011006
1676041223,202894,true,1544778044,28,1543388438,-1389606
1676041955,202894,true,1544778044,28,1543542777,-1235267
1676042951,202894,true,1544778044,28,1543388438,-1389606
1676043563,202894,true,1544778044,28,1542925514,-1852530
1676043731,202894,true,1544778044,28,1542771237,-2006807
1676043755,202893,true,1544932522,28,1542616976,-2315546
1676043767,202893,true,1544932522,28,1542616976,-2315546
1676043815,202894,true,1544778044,28,1542308498,-2469546
1676043827,202895,true,1544623581,28,1542308498,-2315083
1676043839,202895,true,1544623581,28,1542154283,-2469298
1676043863,202895,true,1544623581,28,1542000083,-2623498
1676043911,202896,true,1544469134,28,1541691729,-2777405
1676043947,202898,true,1544160287,28,1541229314,-2930973
1676044103,202899,true,1544005886,28,1538765442,-5240444
1676044127,202900,true,1543851501,28,1538303905,-5547596
1676044739,202901,true,1543697131,28,1529408010,-14289121
1676044835,202903,true,1543388438,28,1528185034,-15203404
1676044895,202904,true,1543234115,28,1527421171,-15812944
1676044907,202905,true,1543079807,28,1527268444,-15811363
1676044919,202906,true,1542925514,28,1527115732,-15809782
1676044943,202908,true,1542616976,28,1526810355,-15806621
1676044955,202909,true,1542462729,28,1526657689,-15805040
1676046251,202908,true,1542616976,28,1525589456,-17027520
1676046287,202909,true,1542462729,28,1525894589,-16568140
1676046335,202911,true,1542154283,28,1526047179,-16107104
1676046395,202912,true,1542000083,28,1526505039,-15495044
1676046419,202912,true,1542000083,28,1526505039,-15495044
1676046515,202913,true,1541845898,28,1526963036,-14882862
1676046743,202915,true,1541537576,28,1527879443,-13658133
1676046779,202916,true,1541383437,28,1527879443,-13503994
1676047547,202916,true,1541383437,28,1526047179,-15336258
1676047571,202917,true,1541229314,28,1525894589,-15334725
1676047619,202919,true,1540921115,28,1525742015,-15179100
1676047631,202921,true,1540612977,28,1525742015,-14870962
1676047727,202921,true,1540612977,28,1525284384,-15328593
1676047787,202923,true,1540304900,28,1524979373,-15325527
1676047979,202924,true,1540150885,28,1524674423,-15476462
1676048027,202926,true,1539842901,28,1524521970,-15320931
1676048051,202926,true,1539842901,28,1524521970,-15320931
1676048063,202928,true,1539534979,28,1524369534,-15165445
1676048375,202929,true,1539381041,28,1524064705,-15316336
1676048387,202931,true,1539073211,28,1524064705,-15008506
1676048555,202932,true,1538919319,28,1523759938,-15159381
1676048639,202933,true,1538765442,28,1523912314,-14853128
1676048771,202935,true,1538457735,28,1524064705,-14393030
1676048783,202937,true,1538150090,28,1524064705,-14085385
1676048795,202937,true,1538150090,28,1524064705,-14085385
1676049155,202938,true,1537996290,28,1524674423,-13321867
1676049227,202941,true,1537534984,28,1524826890,-12708094
1676049239,202942,true,1537381245,28,1524826890,-12554355
1676049287,202943,true,1537227523,28,1524826890,-12400633
1676049371,202945,true,1536920123,28,1524979373,-11940750
1676049383,202947,true,1536612785,28,1524979373,-11633412
1676049431,202949,true,1536305509,28,1524979373,-11326136
1676049455,202950,true,1536151894,28,1524979373,-11172521
1676049503,202952,true,1535844709,28,1525131871,-10712838
1676049515,202954,true,1535537587,28,1525131871,-10405716
1676049563,202956,true,1535230525,28,1525131871,-10098654
1676049647,202957,true,1535077017,28,1524979373,-10097644
1676049815,202959,true,1534770048,28,1524674423,-10095625
1676049851,202962,true,1534309709,28,1524674423,-9635286
1676049983,202964,true,1534002893,28,1524369534,-9633359
1676050031,202964,true,1534002893,28,1524217112,-9785781
1676050067,202966,true,1533696139,28,1524217112,-9479027
1676051471,202969,true,1533236122,28,1519043832,-14192290
1676051615,202971,true,1532929521,28,1518740069,-14189452
1676051651,202972,true,1532776243,28,1518740069,-14036174
1676051663,202974,true,1532469734,28,1518740069,-13729665
1676051771,202977,true,1532010085,28,1518740069,-13270016
1676051807,202978,true,1531856899,28,1518740069,-13116830
1676052011,202979,true,1531703729,28,1519043832,-12659897
1676053103,202980,true,1531550574,28,1521323993,-10226581
1676053175,202983,true,1531091200,28,1521476126,-9615074
1676053319,202984,true,1530938106,28,1521932614,-9005492
1676053451,202985,true,1530785028,28,1522237016,-8548012
1676053535,202986,true,1530631965,28,1522541479,-8090486
1676055707,202988,true,1530325884,28,1524369534,-5956350
1676055755,202990,true,1530019865,28,1524521970,-5497895
1676057591,202990,true,1530019865,28,1524826890,-5192975
1676057603,202991,true,1529866878,28,1524979373,-4887505
1676057615,202993,true,1529560951,28,1524979373,-4581578
1676057627,202994,true,1529408010,28,1524979373,-4428637
1676057651,202994,true,1529408010,28,1524979373,-4428637
1676057675,202995,true,1529255084,28,1525131871,-4123213
1676057759,202995,true,1529255084,28,1525436912,-3818172
1676057783,202997,true,1528949279,28,1525589456,-3359823
1676057795,202996,true,1529102174,28,1525742015,-3360159
1676058575,202996,true,1529102174,28,1529713907,611733
1676058695,202997,true,1528949279,28,1530325884,1376605
1676061107,202998,true,1528796400,28,1534002893,5206493
1676062343,202997,true,1528949279,28,1533849508,4900229
1676062367,202997,true,1528949279,28,1533849508,4900229
1676062955,202998,true,1528796400,28,1533696139,4899739
1676063051,202999,true,1528643535,28,1533696139,5052604
1676063183,202998,true,1528796400,28,1533542784,4746384
1676063231,202999,true,1528643535,28,1533389445,4745910
1676063243,203000,true,1528490686,28,1533389445,4898759
1676063267,203001,true,1528337852,28,1533389445,5051593
1676063279,203000,true,1528490686,28,1533389445,4898759
1676063399,203001,true,1528337852,28,1532929521,4591669
1676063435,203002,true,1528185034,28,1532929521,4744487
1676063531,203004,true,1527879443,28,1532469734,4590291
1676063735,203003,true,1528032231,28,1531397434,3365203
1676063759,203004,true,1527879443,28,1531244309,3364866
1676064887,203006,true,1527573913,28,1524064705,-3509208
1676064899,203008,true,1527268444,28,1524064705,-3203739
1676064911,203008,true,1527268444,28,1523912314,-3356130
1676064923,203009,true,1527115732,28,1523759938,-3355794
1676065127,203012,true,1526657689,28,1522084807,-4572882
1676065151,203015,true,1526199783,28,1521932614,-4267169
1676065163,203015,true,1526199783,28,1521780436,-4419347
1676065247,203016,true,1526047179,28,1521171876,-4875303
1676065451,203021,true,1525284384,28,1518436366,-6848018
1676065619,203024,true,1524826890,28,1516463780,-8363110
1676065631,203024,true,1524826890,28,1516312149,-8514741
1676065643,203026,true,1524521970,28,1516160533,-8361437
1676065655,203031,true,1523759938,28,1516008932,-7751006
1676065703,203033,true,1523455232,28,1515554220,-7901012
1676065715,203033,true,1523455232,28,1515554220,-7901012
1676065727,203034,true,1523302902,28,1515402680,-7900222
1676065811,203037,true,1522846002,28,1514796670,-8049332
1676065823,203039,true,1522541479,28,1514645206,-7896273
1676066315,203038,true,1522693733,28,1511770256,-10923477
1676067311,203039,true,1522541479,28,1508749888,-13791591
1676067335,203042,true,1522084807,28,1508749888,-13334919
1676067359,203041,true,1522237016,28,1508900763,-13336253
1676067371,203040,true,1522389240,28,1509051653,-13337587
1676067383,203040,true,1522389240,28,1509051653,-13337587
1676068223,203043,true,1521932614,28,1510108306,-11824308
1676068883,203043,true,1521932614,28,1510259317,-11673297
1676068943,203042,true,1522084807,28,1510259317,-11825490
1676068955,203042,true,1522084807,28,1510259317,-11825490
1676069099,203045,true,1521628273,28,1510410343,-11217930
1676069279,203046,true,1521476126,28,1510561384,-10914742
1676069339,203046,true,1521476126,28,1510561384,-10914742
1676070059,203046,true,1521476126,28,1510863511,-10612615
1676070767,203049,true,1521019774,28,1511165699,-9854075
1676071343,203050,true,1520867687,28,1510863511,-10004176
1676071391,203049,true,1521019774,28,1510863511,-10156263
1676072303,203050,true,1520867687,28,1510561384,-10306303
1676072351,203053,true,1520411518,28,1510561384,-9850134
1676072399,203053,true,1520411518,28,1510712440,-9699078
1676072447,203053,true,1520411518,28,1510712440,-9699078
1676073251,203053,true,1520411518,28,1512223832,-8187686
1676074175,203055,true,1520107482,28,1513585378,-6522104
1676074259,203056,true,1519955486,28,1513585378,-6370108
1676074271,203055,true,1520107482,28,1513585378,-6522104
1676074295,203054,true,1520259492,28,1513585378,-6674114
1676074499,203058,true,1519651541,28,1513585378,-6066163
1676074619,203058,true,1519651541,28,1513585378,-6066163
1676075651,203057,true,1519803506,28,1512828812,-6974694
1676076635,203057,true,1519803506,28,1512677545,-7125961
1676076911,203060,true,1519347656,28,1512677545,-6670111
1676078483,203061,true,1519195736,28,1513282706,-5913030
1676078747,203060,true,1519347656,28,1513434035,-5913621
1676080283,203060,true,1519347656,28,1513888110,-5459546
1676080619,203063,true,1518891943,28,1513888110,-5003833
1676081003,203063,true,1518891943,28,1513736737,-5155206
1676082227,203063,true,1518891943,28,1513131393,-5760550
1676083115,203063,true,1518891943,28,1512980095,-5911848
1676084687,203066,true,1518436366,28,1513131393,-5304973
1676084819,203067,true,1518284538,28,1513282706,-5001832
1676085167,203066,true,1518436366,28,1513282706,-5153660
1676085179,203066,true,1518436366,28,1513282706,-5153660
1676085203,203069,true,1517980926,28,1513434035,-4546891
1676085227,203069,true,1517980926,28,1513434035,-4546891
1676085263,203068,true,1518132724,28,1513434035,-4698689
1676086499,203067,true,1518284538,28,1517525623,-758915
1676086847,203070,true,1517829143,28,1518588210,759067
1676087303,203070,true,1517829143,28,1519043832,1214689
1676088227,203069,true,1517980926,28,1519043832,1062906
1676088611,203067,true,1518284538,28,1519043832,759294
1676088671,203071,true,1517677376,28,1519043832,1366456
1676090039,203070,true,1517829143,28,1519043832,1214689
1676094767,203069,true,1517980926,28,1519043832,1062906
1676098967,203068,true,1518132724,28,1519043832,911108
1676099123,203071,true,1517677376,28,1519043832,1366456
1676101607,203070,true,1517829143,28,1519043832,1214689
1676101763,203069,true,1517980926,28,1519043832,1062906
1676103191,203068,true,1518132724,28,1519043832,911108
1676104523,203071,true,1517677376,28,1519043832,1366456
1676104607,203071,true,1517677376,28,1519195736,1518360
1676104631,203069,true,1517980926,28,1519195736,1214810
1676104655,203068,true,1518132724,28,1519195736,1063012
1676105591,203071,true,1517677376,28,1520563559,2886183
1676105927,203071,true,1517677376,28,1521019774,3342398
1676108627,203070,true,1517829143,28,1521628273,3799130
1676109575,203069,true,1517980926,28,1521628273,3647347
1676112215,203071,true,1517677376,28,1521628273,3950897
1676112263,203071,true,1517677376,28,1521628273,3950897
1676112551,203070,true,1517829143,28,1521628273,3799130
1676113415,203070,true,1517829143,28,1521171876,3342733
1676116931,203072,true,1517525623,28,1520867687,3342064
1676119559,203072,true,1517525623,28,1520867687,3342064
1676120543,203072,true,1517525623,28,1520411518,2885895
1676121851,203072,true,1517525623,28,1519955486,2429863
1676127035,203075,true,1517070457,28,1519955486,2885029
1676127047,203075,true,1517070457,28,1520107482,3037025
1676127527,203075,true,1517070457,28,1520715616,3645159
1676127719,203075,true,1517070457,28,1521171876,4101419
1676127923,203078,true,1516615426,28,1521628273,5012847
1676131859,203078,true,1516615426,28,1524369534,7754108
1676132471,203077,true,1516767088,28,1524369534,7602446
1676132519,203077,true,1516767088,28,1524369534,7602446
1676133311,203080,true,1516312149,28,1524217112,7904963
1676133623,203080,true,1516312149,28,1524064705,7752556
1676133923,203079,true,1516463780,28,1523912314,7448534
1676133947,203079,true,1516463780,28,1523912314,7448534
1676133971,203082,true,1516008932,28,1523912314,7903382
1676134007,203082,true,1516008932,28,1523759938,7751006
1676134139,203081,true,1516160533,28,1523607577,7447044
1676134547,203081,true,1516160533,28,1522998287,6837754
1676134715,203084,true,1515705776,28,1522693733,6987957
1676135723,203083,true,1515857346,28,1521476126,5618780
1676135831,203083,true,1515857346,28,1521323993,5466647
1676136923,203082,true,1516008932,28,1520867687,4858755
1676137091,203084,true,1515705776,28,1520715616,5009840
1676137943,203084,true,1515705776,28,1520259492,4553716
1676138543,203083,true,1515857346,28,1520107482,4250136
1676140235,203082,true,1516008932,28,1519955486,3946554
1676140487,203083,true,1515857346,28,1518740069,2882723
1676140619,203083,true,1515857346,28,1518132724,2275378
1676141567,203083,true,1515857346,28,1513434035,-2423311
1676141591,203083,true,1515857346,28,1513282706,-2574640
1676141627,203082,true,1516008932,28,1513131393,-2877539
1676141903,203081,true,1516160533,28,1511921433,-4239100
1676141975,203081,true,1516160533,28,1511619094,-4541439
1676142203,203081,true,1516160533,28,1511467947,-4692586
1676142467,203080,true,1516312149,28,1511619094,-4693055
1676142587,203080,true,1516312149,28,1511619094,-4693055
1676143835,203079,true,1516463780,28,1512677545,-3786235
1676144255,203079,true,1516463780,28,1512980095,-3483685
1676144507,203078,true,1516615426,28,1513131393,-3484033
1676145143,203078,true,1516615426,28,1513434035,-3181391
1676145275,203078,true,1516615426,28,1513585378,-3030048
1676146631,203078,true,1516615426,28,1514493756,-2121670
1676146919,203077,true,1516767088,28,1514493756,-2273332
1676146931,203077,true,1516767088,28,1514493756,-2273332
1676147207,203077,true,1516767088,28,1514645206,-2121882
1676147279,203077,true,1516767088,28,1514796670,-1970418
1676147303,203076,true,1516918765,28,1514796670,-2122095
1676147315,203076,true,1516918765,28,1514796670,-2122095
1676147471,203075,true,1517070457,28,1515251155,-1819302
1676151407,203075,true,1517070457,28,1519195736,2125279
1676151839,203074,true,1517222164,28,1519195736,1973572
1676151863,203074,true,1517222164,28,1519347656,2125492
1676151875,203073,true,1517373886,28,1519347656,1973770
1676151911,203073,true,1517373886,28,1519347656,1973770
1676151923,203071,true,1517677376,28,1519347656,1670280
1676151971,203071,true,1517677376,28,1519651541,1974165
1676152043,203070,true,1517829143,28,1519955486,2126343
1676152055,203069,true,1517980926,28,1519955486,1974560
1676152379,203067,true,1518284538,28,1522084807,3800269
1676152403,203066,true,1518436366,28,1522389240,3952874
1676152427,203065,true,1518588210,28,1522541479,3953269
1676154263,203065,true,1518588210,28,1532163286,13575076
1676154275,203062,true,1519043832,28,1532316502,13272670
1676154311,203062,true,1519043832,28,1532316502,13272670
1676154671,203060,true,1519347656,28,1532469734,13122078
1676154743,203060,true,1519347656,28,1532622981,13275325
1676154755,203058,true,1519651541,28,1532622981,12971440
1676155091,203057,true,1519803506,28,1533082813,13279307
1676155247,203055,true,1520107482,28,1533236122,13128640
1676155259,203055,true,1520107482,28,1533389445,13281963
1676155391,203052,true,1520563559,28,1533696139,13132580
1676156435,203051,true,1520715616,28,1537842506,17126890
1676156507,203049,true,1521019774,28,1537996290,16976516
1676156591,203049,true,1521019774,28,1538303905,17284131
1676158307,203046,true,1521476126,28,1539534979,18058853
1676160299,203045,true,1521628273,28,1539534979,17906706
1676160527,203043,true,1521932614,28,1539534979,17602365
1676162363,203042,true,1522084807,28,1539534979,17450172
1676163515,203040,true,1522389240,28,1539073211,16683971
1676163659,203038,true,1522693733,28,1538919319,16225586
1676163899,203037,true,1522846002,28,1538611581,15765579
1676166227,203037,true,1522846002,28,1537073815,14227813
1676167475,203035,true,1523150587,28,1537381245,14230658
1676167703,203033,true,1523455232,28,1537381245,13926013
1676167715,203032,true,1523607577,28,1537381245,13773668
1676167787,203032,true,1523607577,28,1537381245,13773668
1676167823,203030,true,1523912314,28,1537381245,13468931
1676167847,203029,true,1524064705,28,1537381245,13316540
1676167955,203028,true,1524217112,28,1537227523,13010411
1676169323,203028,true,1524217112,28,1535844709,11627597
1676169707,203027,true,1524369534,28,1535691140,11321606
1676170739,203025,true,1524674423,28,1535537587,10863164
1676173127,203024,true,1524826890,28,1535537587,10710697
1676174507,203025,true,1524674423,28,1535537587,10863164
1676175455,203023,true,1524979373,28,1535537587,10558214
1676175503,203021,true,1525284384,28,1535537587,10253203
1676175659,203020,true,1525436912,28,1535537587,10100675
1676176331,203021,true,1525284384,28,1535077017,9792633
1676176667,203019,true,1525589456,28,1534770048,9180592
1676188967,203018,true,1525742015,28,1534156293,8414278
1676190287,203017,true,1525894589,28,1534156293,8261704
1676192663,203017,true,1525894589,28,1534156293,8261704
1676193071,203016,true,1526047179,28,1534156293,8109114
1676195711,203015,true,1526199783,28,1534156293,7956510
1676195759,203014,true,1526352403,28,1534309709,7957306
1676195783,203014,true,1526352403,28,1534309709,7957306
1676196611,203013,true,1526505039,28,1534309709,7804670
1676197667,203012,true,1526657689,28,1534309709,7652020
1676201855,203011,true,1526810355,28,1534309709,7499354
1676205623,203011,true,1526810355,28,1534309709,7499354
1676205635,203010,true,1526963036,28,1534309709,7346673
1676205683,203009,true,1527115732,28,1534309709,7193977
1676206367,203008,true,1527268444,28,1533236122,5967678
1676206379,203009,true,1527115732,28,1533236122,6120390
1676206391,203007,true,1527421171,28,1533082813,5661642
1676208899,203007,true,1527421171,28,1527573913,152742
1676209427,203006,true,1527573913,28,1527573913,0
1676212691,203007,true,1527421171,28,1527268444,-152727
1676212751,203007,true,1527421171,28,1527421171,0
1676212763,203006,true,1527573913,28,1527421171,-152742
1676212775,203005,true,1527726670,28,1527421171,-305499
1676212811,203006,true,1527573913,28,1527421171,-152742
1676212835,203005,true,1527726670,28,1527421171,-305499
1676213027,203004,true,1527879443,28,1528032231,152788
1676213447,203003,true,1528032231,28,1529102174,1069943
1676214947,203004,true,1527879443,28,1532163286,4283843
1676215019,203003,true,1528032231,28,1532316502,4284271
1676215031,203002,true,1528185034,28,1532316502,4131468
1676215043,203001,true,1528337852,28,1532316502,3978650
1676216675,203001,true,1528337852,28,1536151894,7814042
1676216735,203000,true,1528490686,28,1536305509,7814823
1676217083,202998,true,1528796400,28,1536459139,7662739
1676218379,202998,true,1528796400,28,1536459139,7662739
1676219687,202997,true,1528949279,28,1536459139,7509860
1676219711,202996,true,1529102174,28,1536612785,7510611
1676219843,202995,true,1529255084,28,1536920123,7665039
1676220047,202993,true,1529560951,28,1537688737,8127786
1676221235,202992,true,1529713907,28,1542000083,12286176
1676222915,202990,true,1530019865,28,1543079807,13059942
1676224523,202989,true,1530172867,28,1543079807,12906940
1676224859,202987,true,1530478917,28,1543079807,12600890
1676228291,202984,true,1530938106,28,1542771237,11833131
1676228639,202983,true,1531091200,28,1542771237,11680037
1676229383,202982,true,1531244309,28,1542771237,11526928
1676229395,202980,true,1531550574,28,1542771237,11220663
1676229407,202977,true,1532010085,28,1542771237,10761152
1676230895,202976,true,1532163286,28,1541229314,9066028
1676232011,202975,true,1532316502,28,1540921115,8604613
1676233727,202973,true,1532622981,28,1540921115,8298134
1676236235,202971,true,1532929521,28,1540921115,7991594
1676236271,202970,true,1533082813,28,1540921115,7838302
1676236283,202968,true,1533389445,28,1540921115,7531670
1676236343,202967,true,1533542784,28,1540921115,7378331
1676236403,202965,true,1533849508,28,1540767038,6917530
1676236415,202964,true,1534002893,28,1540767038,6764145
1676237279,202963,true,1534156293,28,1539227118,5070825
1676237291,202962,true,1534309709,28,1539227118,4917409
1676237303,202960,true,1534616586,28,1539227118,4610532
1676237315,202959,true,1534770048,28,1539227118,4457070
1676237327,202958,true,1534923525,28,1539073211,4149686
1676237351,202958,true,1534923525,28,1539073211,4149686
1676237411,202956,true,1535230525,28,1538765442,3534917
1676237651,202956,true,1535230525,28,1537688737,2458212
1676237663,202955,true,1535384048,28,1537534984,2150936
1676237675,202955,true,1535384048,28,1537534984,2150936
1676237711,202953,true,1535691140,28,1537227523,1536383
1676237723,202954,true,1535537587,28,1537227523,1689936
1676237891,202954,true,1535537587,28,1535998294,460707
1676237903,202954,true,1535537587,28,1535844709,307122
1676237915,202953,true,1535691140,28,1535691140,0
1676237951,202954,true,1535537587,28,1535384048,-153539
1676237963,202956,true,1535230525,28,1535230525,0
1676238035,202957,true,1535077017,28,1534463140,-613877
1676238155,202956,true,1535230525,28,1533082813,-2147712
1676238191,202957,true,1535077017,28,1532776243,-2300774
1676238215,202959,true,1534770048,28,1532469734,-2300314
1676238323,202960,true,1534616586,28,1531397434,-3219152
1676238575,202960,true,1534616586,28,1528643535,-5973051
1676238599,202961,true,1534463140,28,1528337852,-6125288
1676238611,202962,true,1534309709,28,1528185034,-6124675
1676238623,202963,true,1534156293,28,1528032231,-6124062
1676238707,202964,true,1534002893,28,1526963036,-7039857
1676238827,202965,true,1533849508,28,1525589456,-8260052
1676239547,202968,true,1533389445,28,1517373886,-16015559
1676239559,202969,true,1533236122,28,1517222164,-16013958
1676239571,202970,true,1533082813,28,1517222164,-15860649
1676239643,202972,true,1532776243,28,1516463780,-16312463
1676239655,202975,true,1532316502,28,1516312149,-16004353
1676239667,202976,true,1532163286,28,1516160533,-16002753
1676239703,202977,true,1532010085,28,1515857346,-16152739
1676239727,202979,true,1531703729,28,1515554220,-16149509
1676239919,202984,true,1530938106,28,1513282706,-17655400
1676240663,202985,true,1530785028,28,1506036716,-24748312
1676240699,202986,true,1530631965,28,1505735554,-24896411
1676240795,202988,true,1530325884,28,1505133410,-25192474
1676240867,202993,true,1529560951,28,1504681960,-24878991
1676240879,202994,true,1529408010,28,1504681960,-24726050
1676241239,202993,true,1529560951,28,1503328424,-26232527
1676241779,202995,true,1529255084,28,1504080238,-25174846
1676241791,202999,true,1528643535,28,1504230646,-24412889
1676242703,203000,true,1528490686,28,1508448183,-20042503
1676242943,203000,true,1528490686,28,1508749888,-19740798
1676242955,203001,true,1528337852,28,1508900763,-19437089
1676242967,203005,true,1527726670,28,1508900763,-18825907
1676243003,203006,true,1527573913,28,1508900763,-18673150
1676244623,203005,true,1527726670,28,1514190903,-13535767
1676245799,203006,true,1527573913,28,1514190903,-13383010
1676247059,203010,true,1526963036,28,1513888110,-13074926
1676248583,203011,true,1526810355,28,1514493756,-12316599
1676248595,203010,true,1526963036,28,1514493756,-12469280
1676248643,203011,true,1526810355,28,1514493756,-12316599
1676248703,203015,true,1526199783,28,1514493756,-11706027
1676248715,203016,true,1526047179,28,1514493756,-11553423
1676249171,203015,true,1526199783,28,1513434035,-12765748
1676249195,203017,true,1525894589,28,1513434035,-12460554
1676249231,203021,true,1525284384,28,1513434035,-11850349
1676249243,203021,true,1525284384,28,1513434035,-11850349
1676249255,203020,true,1525436912,28,1513434035,-12002877
1676249315,203021,true,1525284384,28,1513434035,-11850349
1676249351,203025,true,1524674423,28,1513434035,-11240388
1676249591,203025,true,1524674423,28,1514039499,-10634924
1676249603,203024,true,1524826890,28,1514039499,-10787391
1676249639,203025,true,1524674423,28,1514190903,-10483520
1676249663,203028,true,1524217112,28,1514190903,-10026209
1676250251,203028,true,1524217112,28,1516615426,-7601686
1676250335,203026,true,1524521970,28,1516918765,-7603205
1676250347,203027,true,1524369534,28,1516918765,-7450769
1676250371,203030,true,1523912314,28,1516918765,-6993549
1676250443,203030,true,1523912314,28,1517222164,-6690150
1676250455,203028,true,1524217112,28,1517222164,-6994948
1676250467,203029,true,1524064705,28,1517222164,-6842541
1676250479,203032,true,1523607577,28,1517222164,-6385413
1676251223,203033,true,1523455232,28,1517677376,-5777856
1676251979,203032,true,1523607577,28,1514190903,-9416674
1676251991,203033,true,1523455232,28,1514190903,-9264329
1676253287,203037,true,1522846002,28,1509957310,-12888692
1676255075,203038,true,1522693733,28,1508900763,-13792970
1676255123,203037,true,1522846002,28,1508900763,-13945239
1676255183,203039,true,1522541479,28,1508900763,-13640716
1676255195,203043,true,1521932614,28,1508900763,-13031851
1676255531,203044,true,1521780436,28,1508448183,-13332253
1676255543,203044,true,1521780436,28,1508448183,-13332253
1676255591,203046,true,1521476126,28,1508146538,-13329588
1676255615,203050,true,1520867687,28,1508146538,-12721149
1676255699,203052,true,1520563559,28,1507995739,-12567820
1676255735,203052,true,1520563559,28,1507844954,-12718605
1676255843,203053,true,1520411518,28,1507694185,-12717333
1676256083,203057,true,1519803506,28,1507392691,-12410815
1676256347,203059,true,1519499591,28,1506940564,-12559027
1676256371,203060,true,1519347656,28,1506940564,-12407092
1676256503,203062,true,1519043832,28,1506789885,-12253947
1676256923,203065,true,1518588210,28,1506337938,-12250272
1676257043,203068,true,1518132724,28,1506488572,-11644152
1676257079,203069,true,1517980926,28,1506488572,-11492354
1676257187,203070,true,1517829143,28,1506639221,-11189922
1676257811,203073,true,1517373886,28,1507694185,-9679701
1676258123,203076,true,1516918765,28,1508146538,-8772227
1676258507,203077,true,1516767088,28,1508599028,-8168060
1676258531,203078,true,1516615426,28,1508599028,-8016398
1676258543,203081,true,1516160533,28,1508599028,-7561505
1676258627,203083,true,1515857346,28,1508900763,-6956583
1676259683,203083,true,1515857346,28,1511921433,-3935913
1676261039,203084,true,1515705776,28,1513585378,-2120398
1676261075,203087,true,1515251155,28,1513736737,-1514418
1676261315,203089,true,1514948150,28,1513736737,-1211413
1676261339,203089,true,1514948150,28,1513736737,-1211413
1676261423,203090,true,1514796670,28,1513888110,-908560
1676261459,203093,true,1514342322,28,1513888110,-454212
1676261687,203095,true,1514039499,28,1514039499,0
1676262083,203094,true,1514190903,28,1514645206,454303
1676262227,203095,true,1514039499,28,1514948150,908651
1676269079,203097,true,1513736737,28,1517829143,4092406
1676272799,203099,true,1513434035,28,1517829143,4395108
1676272811,203098,true,1513585378,28,1517980926,4395548
1676272823,203098,true,1513585378,28,1517980926,4395548
1676272931,203101,true,1513131393,28,1518132724,5001331
1676272943,203102,true,1512980095,28,1518132724,5152629
1676273051,203100,true,1513282706,28,1518284538,5001832
1676273699,203100,true,1513282706,28,1519651541,6368835
1676275271,203102,true,1512980095,28,1521780436,8800341
1676275487,203103,true,1512828812,28,1521780436,8951624
1676275787,203102,true,1512980095,28,1521780436,8800341
1676275955,203101,true,1513131393,28,1521628273,8496880
1676276363,203103,true,1512828812,28,1521323993,8495181
1676276459,203103,true,1512828812,28,1521323993,8495181
1676276483,203102,true,1512980095,28,1521323993,8343898
1676276507,203101,true,1513131393,28,1521323993,8192600
1676276555,203103,true,1512828812,28,1521171876,8343064
1676276567,203103,true,1512828812,28,1521171876,8343064
1676276615,203102,true,1512980095,28,1521171876,8191781
1676276639,203101,true,1513131393,28,1521019774,7888381
1676276771,203103,true,1512828812,28,1520715616,7886804
1676276879,203103,true,1512828812,28,1520563559,7734747
1676276903,203101,true,1513131393,28,1520411518,7280125
1676277239,203101,true,1513131393,28,1519651541,6520148
1676277599,203102,true,1512980095,28,1518740069,5759974
1676277611,203102,true,1512980095,28,1518740069,5759974
1676277671,203100,true,1513282706,28,1518588210,5305504
1676277719,203100,true,1513282706,28,1518436366,5153660
1676277755,203101,true,1513131393,28,1518284538,5153145
1676277767,203101,true,1513131393,28,1518284538,5153145
1676277779,203099,true,1513434035,28,1518132724,4698689
1676277899,203098,true,1513585378,28,1517525623,3940245
1676279303,203099,true,1513434035,28,1511467947,-1966088
1676279327,203099,true,1513434035,28,1511467947,-1966088
1676279339,203097,true,1513736737,28,1511316815,-2419922
1676279351,203096,true,1513888110,28,1511316815,-2571295
1676279507,203097,true,1513736737,28,1510561384,-3175353
1676279567,203098,true,1513585378,28,1510259317,-3326061
1676279651,203097,true,1513736737,28,1510108306,-3628431
1676279663,203096,true,1513888110,28,1509957310,-3930800
1676279687,203097,true,1513736737,28,1509957310,-3779427
1676279711,203098,true,1513585378,28,1509806329,-3779049
1676279735,203097,true,1513736737,28,1509806329,-3930408
1676279771,203097,true,1513736737,28,1509655364,-4081373
1676279783,203098,true,1513585378,28,1509655364,-3930014
1676279807,203100,true,1513282706,28,1509504413,-3778293
1676279831,203100,true,1513282706,28,1509353478,-3929228
1676279855,203100,true,1513282706,28,1509202558,-4080148
1676279867,203102,true,1512980095,28,1509051653,-3928442
1676279891,203104,true,1512677545,28,1508900763,-3776782
1676279903,203104,true,1512677545,28,1508749888,-3927657
1676279915,203104,true,1512677545,28,1508749888,-3927657
1676279951,203106,true,1512375055,28,1508448183,-3926872
1676279975,203108,true,1512072625,28,1508146538,-3926087
1676279987,203109,true,1511921433,28,1507844954,-4076479
1676280035,203110,true,1511770256,28,1507091258,-4678998
1676280083,203113,true,1511316815,28,1506187320,-5129495
1676280299,203115,true,1511014597,28,1502727242,-8287355
1676280371,203116,true,1510863511,28,1501525601,-9337910
1676280395,203118,true,1510561384,28,1501225341,-9336043
1676280503,203121,true,1510108306,28,1499574984,-10533322
1676280527,203124,true,1509655364,28,1499125201,-10530163
1676280539,203125,true,1509504413,28,1498975304,-10529109
1676280635,203126,true,1509353478,28,1497626900,-11726578
1676280671,203129,true,1508900763,28,1497027999,-11872764
1676280743,203133,true,1508297353,28,1495980499,-12316854
1676280803,203133,true,1508297353,28,1495083225,-13214128
1676280923,203136,true,1507844954,28,1492991677,-14853277
1676281043,203139,true,1507392691,28,1490903055,-16489636
1676281067,203142,true,1506940564,28,1490455874,-16484690
1676281079,203143,true,1506789885,28,1490306843,-16483042
1676281091,203145,true,1506488572,28,1490008827,-16479745
1676281175,203149,true,1505886127,28,1488519637,-17366490
1676281199,203151,true,1505584995,28,1488221978,-17363017
1676281223,203152,true,1505434452,28,1487775600,-17658852
1676281271,203154,true,1505133410,28,1487031936,-18101474
1676281283,203157,true,1504681960,28,1486883247,-17798713
1676281307,203158,true,1504531507,28,1486437272,-18094235
1676281343,203159,true,1504381069,28,1485991430,-18389639
1676281355,203161,true,1504080238,28,1485842845,-18237393
1676281403,203164,true,1503629104,28,1485100147,-18528957
1676281607,203164,true,1503629104,28,1482577747,-21051357
1676281619,203164,true,1503629104,28,1482429504,-21199600
1676281631,203167,true,1503178106,28,1482429504,-20748602
1676281643,203169,true,1502877515,28,1482281276,-20596239
1676281655,203169,true,1502877515,28,1482133063,-20744452
1676281715,203169,true,1502877515,28,1481836681,-21040834
1676281787,203171,true,1502576985,28,1481688512,-20888473
1676281799,203174,true,1502126302,28,1481688512,-20437790
1676281811,203174,true,1502126302,28,1481688512,-20437790
1676281859,203173,true,1502276514,28,1481984864,-20291650
1676282327,203175,true,1501976104,28,1483912601,-18063503
1676282351,203178,true,1501525601,28,1483912601,-17613000
1676282363,203178,true,1501525601,28,1483912601,-17613000
1676282903,203178,true,1501525601,28,1485694276,-15831325
1676283011,203180,true,1501225341,28,1486288643,-14936698
1676283467,203183,true,1500775064,28,1487775600,-12999464
1676283491,203183,true,1500775064,28,1487775600,-12999464
1676283503,203183,true,1500775064,28,1487775600,-12999464
1676283659,203185,true,1500474954,28,1487626838,-12848116
1676283683,203189,true,1499874914,28,1487626838,-12248076
1676283719,203189,true,1499874914,28,1487478090,-12396824
1676283731,203190,true,1499724941,28,1487478090,-12246851
1676283911,203194,true,1499125201,28,1485991430,-13133771
1676283947,203198,true,1498525701,28,1485694276,-12831425
1676283959,203198,true,1498525701,28,1485545721,-12979980
1676283971,203199,true,1498375864,28,1485545721,-12830143
1676283995,203204,true,1497626900,28,1485248657,-12378243
1676284199,203207,true,1497177702,28,1483912601,-13265101
1676284391,203207,true,1497177702,28,1482726005,-14451697
1676284403,203209,true,1496878311,28,1482726005,-14152306
1676284427,203213,true,1496279710,28,1482577747,-13701963
1676284571,203216,true,1495830916,28,1481836681,-13994235
1676284595,203217,true,1495681348,28,1481688512,-13992836
1676284787,203218,true,1495531794,28,1480947890,-14583904
1676285231,203222,true,1494933731,28,1479319824,-15613907
1676285267,203225,true,1494485341,28,1479171907,-15313434
1676285303,203226,true,1494335907,28,1479024005,-15311902
1676285411,203227,true,1494186488,28,1478728244,-15458244
1676285519,203232,true,1493439619,28,1478580386,-14859233
1676285807,203235,true,1492991677,28,1479911641,-13080036
1676286215,203236,true,1492842393,28,1481392219,-11450174
1676286539,203237,true,1492693123,28,1482133063,-10560060
1676287355,203241,true,1492096195,28,1483319184,-8777011
1676287643,203244,true,1491648656,28,1483467516,-8181140
1676287667,203244,true,1491648656,28,1483615863,-8032793
1676287775,203245,true,1491499506,28,1483615863,-7883643
1676287787,203250,true,1490753980,28,1483615863,-7138117
1676287799,203252,true,1490455874,28,1483615863,-6840011
1676287823,203253,true,1490306843,28,1483764225,-6542618
1676287847,203254,true,1490157828,28,1483764225,-6393603
1676287907,203258,true,1489561913,28,1483764225,-5797688
1676287931,203260,true,1489264046,28,1483912601,-5351445
1676288243,203261,true,1489115134,28,1484357819,-4757315
1676288459,203261,true,1489115134,28,1484654706,-4460428
1676288591,203265,true,1488519637,28,1484803171,-3716466
1676288639,203267,true,1488221978,28,1484803171,-3418807
1676288651,203268,true,1488073170,28,1484803171,-3269999
1676288663,203269,true,1487924378,28,1484803171,-3121207
1676288687,203272,true,1487478090,28,1484803171,-2674919
1676289587,203274,true,1487180639,28,1485694276,-1486363
1676290559,203275,true,1487031936,28,1485545721,-1486215
1676290655,203275,true,1487031936,28,1485694276,-1337660
1676290679,203279,true,1486437272,28,1485694276,-742996
1676290691,203280,true,1486288643,28,1485694276,-594367
1676290799,203281,true,1486140029,28,1485694276,-445753
1676290859,203281,true,1486140029,28,1485842845,-297184
1676290979,203284,true,1485694276,28,1486140029,445753
1676291159,203285,true,1485545721,28,1486437272,891551
1676291207,203285,true,1485545721,28,1486585915,1040194
1676292407,203285,true,1485545721,28,1488966238,3420517
1676294063,203288,true,1485100147,28,1489412972,4312825
1676294075,203289,true,1484951652,28,1489412972,4461320
1676294171,203289,true,1484951652,28,1489412972,4461320
1676294183,203289,true,1484951652,28,1489412972,4461320
1676294639,203292,true,1484506255,28,1488966238,4459983
1676295083,203293,true,1484357819,28,1488519637,4161818
1676295107,203293,true,1484357819,28,1488519637,4161818
1676295131,203292,true,1484506255,28,1488519637,4013382
1676296331,203296,true,1483912601,28,1485991430,2078829
1676296367,203296,true,1483912601,28,1485991430,2078829
1676296415,203296,true,1483912601,28,1485842845,1930244
1676296451,203295,true,1484060992,28,1485842845,1781853
1676296511,203299,true,1483467516,28,1485694276,2226760
1676299199,203299,true,1483467516,28,1481984864,-1482652
1676299211,203299,true,1483467516,28,1482133063,-1334453
1676299343,203297,true,1483764225,28,1482133063,-1631162
1676299643,203300,true,1483319184,28,1482577747,-741437
1676299667,203299,true,1483467516,28,1482577747,-889769
1676299871,203298,true,1483615863,28,1482874278,-741585
1676300207,203297,true,1483764225,28,1483467516,-296709
1676300303,203299,true,1483467516,28,1483615863,148347
1676300399,203298,true,1483615863,28,1483764225,148362
1676302139,203297,true,1483764225,28,1486883247,3119022
1676302367,203296,true,1483912601,28,1486883247,2970646
1676303303,203298,true,1483615863,28,1486883247,3267384
1676303327,203298,true,1483615863,28,1486883247,3267384
1676303375,203296,true,1483912601,28,1486883247,2970646
1676303447,203295,true,1484060992,28,1486883247,2822255
1676303615,203297,true,1483764225,28,1486734574,2970349
1676303627,203297,true,1483764225,28,1486734574,2970349
1676303675,203295,true,1484060992,28,1486585915,2524923
1676303699,203294,true,1484209398,28,1486585915,2376517
1676303711,203296,true,1483912601,28,1486585915,2673314
1676304239,203295,true,1484060992,28,1484803171,742179
1676304335,203294,true,1484209398,28,1484506255,296857
1676304383,203293,true,1484357819,28,1484357819,0
1676304419,203295,true,1484060992,28,1484357819,296827
1676304431,203295,true,1484060992,28,1484357819,296827
1676304791,203293,true,1484357819,28,1483467516,-890303
1676305019,203292,true,1484506255,28,1483022565,-1483690
1676305103,203295,true,1484060992,28,1482874278,-1186714
1676305631,203294,true,1484209398,28,1483170867,-1038531
1676305655,203292,true,1484506255,28,1483170867,-1335388
1676305667,203291,true,1484654706,28,1483170867,-1483839
1676305715,203294,true,1484209398,28,1483170867,-1038531
1676305739,203294,true,1484209398,28,1483170867,-1038531
1676305787,203293,true,1484357819,28,1483170867,-1186952
1676305919,203293,true,1484357819,28,1483022565,-1335254
1676305931,203295,true,1484060992,28,1483022565,-1038427
1676306003,203296,true,1483912601,28,1482726005,-1186596
1676306051,203295,true,1484060992,28,1482577747,-1483245
1676306255,203296,true,1483912601,28,1481540358,-2372243
1676306291,203299,true,1483467516,28,1481244094,-2223422
1676306303,203300,true,1483319184,28,1481244094,-2075090
1676306615,203300,true,1483319184,28,1478580386,-4738798
1676306639,203301,true,1483170867,28,1478284714,-4886153
1676306675,203304,true,1482726005,28,1477989102,-4736903
1676306687,203305,true,1482577747,28,1477989102,-4588645
1676306699,203304,true,1482726005,28,1477841318,-4884687
1676306723,203305,true,1482577747,28,1477693548,-4884199
1676306771,203308,true,1482133063,28,1477398054,-4735009
1676306783,203308,true,1482133063,28,1477398054,-4735009
1676306819,203308,true,1482133063,28,1477102619,-5030444
1676306843,203308,true,1482133063,28,1477102619,-5030444
1676306855,203309,true,1481984864,28,1476954923,-5029941
1676306891,203309,true,1481984864,28,1476807242,-5177622
1676306903,203308,true,1482133063,28,1476807242,-5325821
1676306915,203308,true,1482133063,28,1476659576,-5473487
1676306939,203308,true,1482133063,28,1476659576,-5473487
1676308151,203308,true,1482133063,28,1476216667,-5916396
1676308667,203307,true,1482281276,28,1478876117,-3405159
1676308691,203307,true,1482281276,28,1478876117,-3405159
1676309111,203307,true,1482281276,28,1478876117,-3405159
1676309123,203308,true,1482133063,28,1478876117,-3256946
1676309159,203307,true,1482281276,28,1478728244,-3553032
1676309363,203307,true,1482281276,28,1478432543,-3848733
1676309387,203308,true,1482133063,28,1478432543,-3700520
1676309831,203309,true,1481984864,28,1477545794,-4439070
1676310131,203308,true,1482133063,28,1476954923,-5178140
1676310215,203309,true,1481984864,28,1476807242,-5177622
1676310335,203310,true,1481836681,28,1476364289,-5472392
1676310455,203311,true,1481688512,28,1476069060,-5619452
1676310803,203310,true,1481836681,28,1475036225,-6800456
1676310971,203311,true,1481688512,28,1474593803,-7094709
1676310983,203312,true,1481540358,28,1474593803,-6946555
1676311235,203313,true,1481392219,28,1473562000,-7830219
1676311259,203314,true,1481244094,28,1473562000,-7682094
1676311295,203315,true,1481095985,28,1473414658,-7681327
1676311307,203316,true,1480947890,28,1473414658,-7533232
1676311319,203317,true,1480799810,28,1473414658,-7385152
1676311331,203317,true,1480799810,28,1473414658,-7385152
1676311343,203318,true,1480651745,28,1473414658,-7237087
1676311511,203318,true,1480651745,28,1473267332,-7384413
1676311931,203319,true,1480503694,28,1473267332,-7236362
1676312183,203319,true,1480503694,28,1473856727,-6646967
1676312207,203320,true,1480355659,28,1473856727,-6498932
1676312255,203321,true,1480207638,28,1474004113,-6203525
1676312831,203321,true,1480207638,28,1476069060,-4138578
1676312915,203321,true,1480207638,28,1476511925,-3695713
1676313071,203322,true,1480059632,28,1477398054,-2661578
1676313119,203322,true,1480059632,28,1477693548,-2366084
1676313143,203322,true,1480059632,28,1477693548,-2366084
1676313155,203322,true,1480059632,28,1477841318,-2218314
1676313167,203323,true,1479911641,28,1477841318,-2070323
1676313215,203323,true,1479911641,28,1477989102,-1922539
1676313263,203323,true,1479911641,28,1478284714,-1626927
1676314211,203322,true,1480059632,28,1482726005,2666373
1676314283,203323,true,1479911641,28,1483022565,3110924
1676314295,203324,true,1479763664,28,1483022565,3258901
1676314307,203324,true,1479763664,28,1483170867,3407203
1676314331,203323,true,1479911641,28,1483319184,3407543
1676314379,203323,true,1479911641,28,1483467516,3555875
1676314391,203324,true,1479763664,28,1483615863,3852199
1676315495,203323,true,1479911641,28,1488966238,9054597
1676317187,203322,true,1480059632,28,1492991677,12932045
1676317367,203323,true,1479911641,28,1492842393,12930752
1676317691,203323,true,1479911641,28,1492543869,12632228
1676317787,203322,true,1480059632,28,1492394630,12334998
1676318075,203322,true,1480059632,28,1492096195,12036563
1676318843,203322,true,1480059632,28,1491201251,11141619
1676321171,203322,true,1480059632,28,1490753980,10694348
1676321807,203321,true,1480207638,28,1490157828,9950190
1676322023,203320,true,1480355659,28,1489412972,9057313
1676322059,203321,true,1480207638,28,1489412972,9205334
1676322095,203321,true,1480207638,28,1489264046,9056408
1676322107,203320,true,1480355659,28,1489264046,8908387
1676322143,203319,true,1480503694,28,1489264046,8760352
1676322251,203320,true,1480355659,28,1488966238,8610579
1676322611,203320,true,1480355659,28,1488221978,7866319
1676322659,203319,true,1480503694,28,1488073170,7569476
1676323487,203319,true,1480503694,28,1486883247,6379553
1676326871,203319,true,1480503694,28,1486734574,6230880
1676327627,203319,true,1480503694,28,1486734574,6230880
1676327699,203319,true,1480503694,28,1486734574,6230880
1676327747,203319,true,1480503694,28,1486734574,6230880
1676328539,203319,true,1480503694,28,1487180639,6676945
1676328563,203319,true,1480503694,28,1487180639,6676945
1676328575,203319,true,1480503694,28,1487180639,6676945
1676328587,203319,true,1480503694,28,1487180639,6676945
1676328947,203318,true,1480651745,28,1488073170,7421425
1676330015,203317,true,1480799810,28,1491797821,10998011
1676330195,203317,true,1480799810,28,1492543869,11744059
1676330207,203317,true,1480799810,28,1492693123,11893313
1676330519,203316,true,1480947890,28,1493887696,12939806
1676330531,203314,true,1481244094,28,1493887696,12643602
1676330543,203313,true,1481392219,28,1493887696,12495477
1676330579,203313,true,1481392219,28,1494037085,12644866
1676330651,203312,true,1481540358,28,1494335907,12795549
1676330699,203310,true,1481836681,28,1494485341,12648660
1676330747,203309,true,1481984864,28,1494784253,12799389
1676330939,203309,true,1481984864,28,1495681348,13696484
1676330951,203307,true,1482281276,28,1495681348,13400072
1676330963,203306,true,1482429504,28,1495830916,13401412
1676330975,203305,true,1482577747,28,1495830916,13253169
1676331299,203304,true,1482726005,28,1498076233,15350228
1676331383,203302,true,1483022565,28,1498675554,15652989
1676331515,203301,true,1483170867,28,1499574984,16404117
1676331899,203299,true,1483467516,28,1502276514,18808998
1676331935,203298,true,1483615863,28,1502426742,18810879
1676335211,203296,true,1483912601,28,1506488572,22575971
1676335607,203294,true,1484209398,28,1506639221,22429823
1676336363,203292,true,1484506255,28,1506639221,22132966
1676336423,203291,true,1484654706,28,1506639221,21984515
1676336603,203288,true,1485100147,28,1506639221,21539074
1676336939,203286,true,1485397182,28,1506488572,21091390
1676337347,203284,true,1485694276,28,1506187320,20493044
1676337563,203282,true,1485991430,28,1506036716,20045286
1676337575,203279,true,1486437272,28,1506036716,19599444
1676337683,203277,true,1486734574,28,1505886127,19151553
1676337755,203276,true,1486883247,28,1505735554,18852307
1676338067,203274,true,1487180639,28,1504982912,17802273
1676338151,203271,true,1487626838,28,1504681960,17055122
1676338223,203270,true,1487775600,28,1504531507,16755907
1676338295,203268,true,1488073170,28,1504381069,16307899
1676338415,203267,true,1488221978,28,1504080238,15858260
1676338427,203264,true,1488668489,28,1504080238,15411749
1676338439,203263,true,1488817356,28,1504080238,15262882
1676339567,203262,true,1488966238,28,1500775064,11808826
1676339903,203261,true,1489115134,28,1500324921,11209787
1676340491,203259,true,1489412972,28,1499874914,10461942
1676340719,203258,true,1489561913,28,1499874914,10313001
1676340779,203257,true,1489710870,28,1500024901,10314031
1676340803,203256,true,1489859841,28,1500024901,10165060
1676341175,203253,true,1490306843,28,1500174904,9868061
1676341367,203252,true,1490455874,28,1500324921,9869047
1676341823,203252,true,1490455874,28,1500625001,10169127
1676341907,203250,true,1490753980,28,1500775064,10021084
1676342003,203248,true,1491052146,28,1500775064,9722918
1676342387,203246,true,1491350371,28,1501075234,9724863
1676342639,203246,true,1491350371,28,1501075234,9724863
1676344019,203244,true,1491648656,28,1501075234,9426578
1676345063,203242,true,1491947001,28,1501075234,9128233
1676345579,203240,true,1492245405,28,1501075234,8829829
1676345819,203239,true,1492394630,28,1501075234,8680604
1676346971,203238,true,1492543869,28,1501075234,8531365
1676348387,203235,true,1492991677,28,1501075234,8083557
1676351027,203233,true,1493290290,28,1501075234,7784944
1676351627,203232,true,1493439619,28,1501075234,7635615
1676351843,203230,true,1493738322,28,1501075234,7336912
1676352167,203227,true,1494186488,28,1501075234,6888746
1676352443,203226,true,1494335907,28,1501075234,6739327
1676352455,203225,true,1494485341,28,1501075234,6589893
1676353859,203223,true,1494784253,28,1501075234,6290981
1676355335,203221,true,1495083225,28,1501075234,5992009
1676355443,203220,true,1495232733,28,1501225341,5992608
1676355827,203219,true,1495382256,28,1501375464,5993208
1676356319,203217,true,1495681348,28,1501525601,5844253
1676356439,203214,true,1496130097,28,1501525601,5395504
1676357423,203213,true,1496279710,28,1501976104,5696394
1676357975,203213,true,1496279710,28,1501976104,5696394
1676358659,203212,true,1496429338,28,1501976104,5546766
1676359679,203209,true,1496878311,28,1501825922,4947611
1676359823,203208,true,1497027999,28,1501976104,4948105
1676360171,203208,true,1497027999,28,1501976104,4948105
1676360195,203206,true,1497327420,28,1501976104,4648684
1676360411,203204,true,1497626900,28,1502276514,4649614
1676360519,203203,true,1497776663,28,1502426742,4650079
1676360543,203203,true,1497776663,28,1502426742,4650079
1676360567,203202,true,1497926441,28,1502426742,4500301
1676363939,203199,true,1498375864,28,1504381069,6005205
1676364443,203198,true,1498525701,28,1504230646,5704945
1676364863,203198,true,1498525701,28,1503929845,5404144
1676364947,203198,true,1498525701,28,1503929845,5404144
1676365151,203196,true,1498825421,28,1503779467,4954046
1676365187,203195,true,1498975304,28,1503779467,4804163
1676365271,203195,true,1498975304,28,1503629104,4653800
1676366027,203195,true,1498975304,28,1502877515,3902211
1676367251,203193,true,1499275114,28,1502276514,3001400
1676368247,203192,true,1499425041,28,1502276514,2851473
1676368283,203193,true,1499275114,28,1502276514,3001400
1676368295,203192,true,1499425041,28,1502426742,3001701
1676368307,203190,true,1499724941,28,1502426742,2701801
1676368319,203190,true,1499724941,28,1502426742,2701801
1676368331,203190,true,1499724941,28,1502426742,2701801
1676368343,203189,true,1499874914,28,1502426742,2551828
1676368403,203185,true,1500474954,28,1502877515,2402561
1676368919,203183,true,1500775064,28,1506789885,6014821
1676369027,203183,true,1500775064,28,1507543431,6768367
1676369051,203182,true,1500925141,28,1507694185,6769044
1676369171,203178,true,1501525601,28,1508599028,7073427
1676369279,203176,true,1501825922,28,1509353478,7527556
1676369303,203176,true,1501825922,28,1509504413,7678491
1676369327,203175,true,1501976104,28,1509655364,7679260
1676369795,203172,true,1502426742,28,1512980095,10553353
1676371955,203170,true,1502727242,28,1515099645,12372403
1676372099,203169,true,1502877515,28,1515099645,12222130
1676372939,203168,true,1503027803,28,1514493756,11465953
1676373143,203165,true,1503478756,28,1514342322,10863566
1676373155,203163,true,1503779467,28,1514342322,10562855
1676373179,203163,true,1503779467,28,1514190903,10411436
1676373251,203162,true,1503929845,28,1514039499,10109654
1676379251,203160,true,1504230646,28,1510863511,6632865
1676379923,203159,true,1504381069,28,1510863511,6482442
1676379959,203159,true,1504381069,28,1510863511,6482442
1676379983,203158,true,1504531507,28,1511014597,6483090
1676380319,203156,true,1504832429,28,1511165699,6333270
1676380415,203155,true,1504982912,28,1511165699,6182787
1676380535,203155,true,1504982912,28,1511316815,6333903
1676380919,203154,true,1505133410,28,1511619094,6485684
1676380931,203153,true,1505283924,28,1511619094,6335170
1676380943,203152,true,1505434452,28,1511619094,6184642
1676380955,203152,true,1505434452,28,1511770256,6335804
1676381195,203151,true,1505584995,28,1512375055,6790060
1676381351,203149,true,1505886127,28,1512828812,6942685
1676381375,203148,true,1506036716,28,1512828812,6792096
1676381423,203148,true,1506036716,28,1513131393,7094677
1676381435,203148,true,1506036716,28,1513131393,7094677
1676381495,203148,true,1506036716,28,1512828812,6792096
1676381531,203148,true,1506036716,28,1512677545,6640829
1676381543,203149,true,1505886127,28,1512677545,6791418
1676381567,203148,true,1506036716,28,1512677545,6640829
1676381591,203147,true,1506187320,28,1512828812,6641492
1676381615,203146,true,1506337938,28,1512980095,6642157
1676381627,203146,true,1506337938,28,1512980095,6642157
1676381687,203145,true,1506488572,28,1513282706,6794134
1676381711,203144,true,1506639221,28,1513282706,6643485
1676381891,203143,true,1506789885,28,1514039499,7249614
1676381903,203143,true,1506789885,28,1514039499,7249614
1676381915,203143,true,1506789885,28,1514039499,7249614
1676382011,203142,true,1506940564,28,1513888110,6947546
1676382047,203142,true,1506940564,28,1513888110,6947546
1676382071,203142,true,1506940564,28,1513888110,6947546
1676382083,203141,true,1507091258,28,1513888110,6796852
1676382143,203141,true,1507091258,28,1513585378,6494120
1676382155,203141,true,1507091258,28,1513585378,6494120
1676382251,203141,true,1507091258,28,1513282706,6191448
1676382359,203140,true,1507241967,28,1512980095,5738128
1676382383,203140,true,1507241967,28,1512980095,5738128
1676382491,203139,true,1507392691,28,1512677545,5284854
1676382503,203139,true,1507392691,28,1512677545,5284854
1676382515,203138,true,1507543431,28,1512677545,5134114
1676382647,203137,true,1507694185,28,1512677545,4983360
1676382791,203136,true,1507844954,28,1512526292,4681338
1676383403,203135,true,1507995739,28,1514039499,6043760
1676383475,203134,true,1508146538,28,1513888110,5741572
1676383487,203133,true,1508297353,28,1513888110,5590757
1676383547,203132,true,1508448183,28,1513736737,5288554
1676383559,203132,true,1508448183,28,1513736737,5288554
1676383595,203131,true,1508599028,28,1513585378,4986350
1676383607,203130,true,1508749888,28,1513585378,4835490
1676383631,203129,true,1508900763,28,1513434035,4533272
1676383667,203129,true,1508900763,28,1513434035,4533272
1676383763,203128,true,1509051653,28,1513282706,4231053
1676383775,203127,true,1509202558,28,1513282706,4080148
1676383799,203127,true,1509202558,28,1513282706,4080148
1676384891,203127,true,1509202558,28,1511467947,2265389
1676384927,203126,true,1509353478,28,1511316815,1963337
1676384963,203126,true,1509353478,28,1511014597,1661119
1676384975,203125,true,1509504413,28,1511014597,1510184
1676385011,203126,true,1509353478,28,1510712440,1358962
1676385071,203125,true,1509504413,28,1510259317,754904
1676385095,203125,true,1509504413,28,1510108306,603893
1676385131,203125,true,1509504413,28,1509655364,150951
1676385227,203126,true,1509353478,28,1508900763,-452715
1676385275,203125,true,1509504413,28,1508448183,-1056230
1676385299,203125,true,1509504413,28,1508297353,-1207060
1676385323,203124,true,1509655364,28,1508146538,-1508826
1676385431,203125,true,1509504413,28,1507543431,-1960982
1676385695,203124,true,1509655364,28,1506940564,-2714800
1676385707,203124,true,1509655364,28,1506940564,-2714800
1676385719,203123,true,1509806329,28,1506940564,-2865765
1676385839,203124,true,1509655364,28,1506940564,-2714800
1676385911,203122,true,1509957310,28,1506940564,-3016746
1676385959,203122,true,1509957310,28,1506940564,-3016746
1676385983,203122,true,1509957310,28,1507091258,-2866052
1676386007,203122,true,1509957310,28,1507091258,-2866052
1676386019,203120,true,1510259317,28,1507091258,-3168059
1676386031,203120,true,1510259317,28,1507091258,-3168059
1676386055,203119,true,1510410343,28,1507241967,-3168376
1676386115,203119,true,1510410343,28,1507392691,-3017652
1676386127,203117,true,1510712440,28,1507543431,-3169009
1676386151,203117,true,1510712440,28,1507694185,-3018255
1676386175,203116,true,1510863511,28,1507844954,-3018557
1676386187,203116,true,1510863511,28,1507844954,-3018557
1676386199,203114,true,1511165699,28,1507995739,-3169960
1676386211,203113,true,1511316815,28,1507995739,-3321076
1676386247,203110,true,1511770256,28,1508599028,-3171228
1676386259,203109,true,1511921433,28,1508749888,-3171545
1676386439,203105,true,1512526292,28,1512223832,-302460
1676386451,203103,true,1512828812,28,1512375055,-453757
1676386475,203100,true,1513282706,28,1512980095,-302611
1676386535,203099,true,1513434035,28,1514039499,605464
1676386559,203095,true,1514039499,28,1514493756,454257
1676386583,203093,true,1514342322,28,1515099645,757323
1676386643,203090,true,1514796670,28,1516463780,1667110
1676386691,203088,true,1515099645,28,1517677376,2577731
1676386727,203084,true,1515705776,28,1518588210,2882434
1676386763,203083,true,1515857346,28,1519651541,3794195
1676387063,203080,true,1516312149,28,1528643535,12331386
1676387447,203078,true,1516615426,28,1539688932,23073506
1676387459,203074,true,1517222164,28,1540150885,22928721
1676387483,203074,true,1517222164,28,1540767038,23544874
1676387519,203071,true,1517677376,28,1541845898,24168522
1676387531,203068,true,1518132724,28,1542154283,24021559
1676387567,203064,true,1518740069,28,1543234115,24494046
1676387615,203063,true,1518891943,28,1544623581,25731638
1676388479,203060,true,1519347656,28,1559210766,39863110
1676388503,203058,true,1519651541,28,1559210766,39559225
1676388539,203053,true,1520411518,28,1559366687,38955169
1676388575,203053,true,1520411518,28,1559366687,38955169
1676388587,203049,true,1521019774,28,1559366687,38346913
1676388599,203047,true,1521323993,28,1559366687,38042694
1676388731,203043,true,1521932614,28,1559210766,37278152
1676388743,203042,true,1522084807,28,1559210766,37125959
1676388767,203039,true,1522541479,28,1559054861,36513382
1676388971,203037,true,1522846002,28,1558431394,35585392
1676388983,203034,true,1523302902,28,1558275567,34972665
1676389055,203033,true,1523455232,28,1557963959,34508727
1676389127,203030,true,1523912314,28,1557652412,33740098
1676389151,203029,true,1524064705,28,1557496663,33431958
1676389163,203025,true,1524674423,28,1557340929,32666506
1676389211,203025,true,1524674423,28,1557029507,32355084
1676389235,203023,true,1524979373,28,1556873820,31894447
1676389247,203022,true,1525131871,28,1556718148,31586277
1676389319,203019,true,1525589456,28,1555940022,30350566
1676389763,203020,true,1525436912,28,1550659073,25222161
1676389775,203017,true,1525894589,28,1550504023,24609434
1676389787,203016,true,1526047179,28,1550348988,24301809
1676390471,203014,true,1526352403,28,1543851501,17499098
1676390483,203012,true,1526657689,28,1543851501,17193812
1676390495,203009,true,1527115732,28,1543697131,16581399
1676390543,203007,true,1527421171,28,1543542777,16121606
1676390567,203003,true,1528032231,28,1543542777,15510546
1676390639,203003,true,1528032231,28,1543388438,15356207
1676390699,203002,true,1528185034,28,1543388438,15203404
1676390723,203000,true,1528490686,28,1543388438,14897752
1676390843,202997,true,1528949279,28,1543234115,14284836
1676390975,202997,true,1528949279,28,1543388438,14439159
1676392007,202995,true,1529255084,28,1547715765,18460681
1676392031,202993,true,1529560951,28,1547715765,18154814
1676392139,202990,true,1530019865,28,1547870537,17850672
1676392151,202989,true,1530172867,28,1547870537,17697670
1676392211,202986,true,1530631965,28,1548025324,17393359
1676392223,202985,true,1530785028,28,1548025324,17240296
1676392259,202981,true,1531397434,28,1548025324,16627890
1676392295,202980,true,1531550574,28,1548025324,16474750
1676392811,202978,true,1531856899,28,1546168900,14312001
1676392955,202976,true,1532163286,28,1545550587,13387301
1676393339,202973,true,1532622981,28,1544005886,11382905
1676393363,202972,true,1532776243,28,1543851501,11075258
1676393627,202970,true,1533082813,28,1542616976,9534163
1676393747,202969,true,1533236122,28,1542154283,8918161
1676393771,202966,true,1533696139,28,1542000083,8303944
1676394275,202965,true,1533849508,28,1540767038,6917530
1676394359,202964,true,1534002893,28,1540767038,6764145
1676394371,202963,true,1534156293,28,1540767038,6610745
1676395739,202960,true,1534616586,28,1541383437,6766851
1676396039,202959,true,1534770048,28,1541691729,6921681
1676396051,202958,true,1534923525,28,1541691729,6768204
1676396087,202957,true,1535077017,28,1541845898,6768881
1676396111,202954,true,1535537587,28,1541845898,6308311
1676396123,202953,true,1535691140,28,1541845898,6154758
1676397743,202950,true,1536151894,28,1545705142,9553248
1676397815,202949,true,1536305509,28,1545859713,9554204
1676397851,202946,true,1536766447,28,1545859713,9093266
1676397923,202945,true,1536920123,28,1546168900,9248777
1676398355,202942,true,1537381245,28,1546942139,9560894
1676398859,202940,true,1537688737,28,1548025324,10336587
1676399507,202936,true,1538303905,28,1549264177,10960272
1676400239,202935,true,1538457735,28,1549419104,10961369
1676401223,202932,true,1538919319,28,1549574046,10654727
1676402351,202930,true,1539227118,28,1549729003,10501885
1676402363,202926,true,1539842901,28,1549729003,9886102
1676402399,202924,true,1540150885,28,1549729003,9578118
1676402507,202921,true,1540612977,28,1549883976,9270999
1676402519,202919,true,1540921115,28,1549883976,8962861
1676402699,202914,true,1541691729,28,1549883976,8192247
1676402771,202913,true,1541845898,28,1550038965,8193067
1676402867,202910,true,1542308498,28,1550038965,7730467
1676402891,202908,true,1542616976,28,1550038965,7421989
1676402951,202904,true,1543234115,28,1550193968,6959853
1676402999,202902,true,1543542777,28,1550348988,6806211
1676403407,202898,true,1544160287,28,1551589701,7429414
1676403455,202896,true,1544469134,28,1551900035,7430901
1676403467,202893,true,1544932522,28,1551900035,6967513
1676403503,202891,true,1545241523,28,1552055225,6813702
1676403515,202887,true,1545859713,28,1552055225,6195512
1676403527,202885,true,1546168900,28,1552210430,6041530
1676403551,202882,true,1546632797,28,1552210430,5577633
1676403563,202881,true,1546787461,28,1552365651,5578190
1676404127,202877,true,1547406268,28,1554851300,7445032
1676404139,202876,true,1547561009,28,1554851300,7290291
1676404151,202872,true,1548180126,28,1555006785,6826659
1676404175,202871,true,1548334944,28,1555162286,6827342
1676404187,202867,true,1548954371,28,1555162286,6207915
1676404199,202866,true,1549109267,28,1555162286,6053019
1676406647,202863,true,1549574046,28,1559990527,10416481
1676407151,202862,true,1549729003,28,1559990527,10261524
1676408675,202860,true,1550038965,28,1560146526,10107561
1676408711,202860,true,1550038965,28,1560146526,10107561
1676408735,202859,true,1550193968,28,1560146526,9952558
1676408807,202858,true,1550348988,28,1559990527,9641539
1676408819,202857,true,1550504023,28,1559990527,9486504
1676408891,202857,true,1550504023,28,1559834544,9330521
1676408915,202856,true,1550659073,28,1559834544,9175471
1676408939,202855,true,1550814139,28,1559678576,8864437
1676409179,202855,true,1550814139,28,1559054861,8240722
1676411471,202856,true,1550659073,28,1554695830,4036757
1676411507,202855,true,1550814139,28,1554695830,3881691
1676412899,202855,true,1550814139,28,1554695830,3881691
1676414375,202856,true,1550659073,28,1554851300,4192227
1676415059,202856,true,1550659073,28,1554851300,4192227
1676415107,202856,true,1550659073,28,1554851300,4192227
1676415827,202856,true,1550659073,28,1554851300,4192227
1676415923,202856,true,1550659073,28,1555006785,4347712
1676416055,202857,true,1550504023,28,1555006785,4502762
1676416139,202857,true,1550504023,28,1555006785,4502762
1676416199,202857,true,1550504023,28,1555006785,4502762
1676416235,202857,true,1550504023,28,1555006785,4502762
1676416247,202859,true,1550193968,28,1555006785,4812817
1676416355,202858,true,1550348988,28,1555162286,4813298
1676417627,202858,true,1550348988,28,1557029507,6680519
1676419139,202858,true,1550348988,28,1557496663,7147675
1676419511,202859,true,1550193968,28,1557652412,7458444
1676419883,202858,true,1550348988,28,1557652412,7303424
1676419895,202857,true,1550504023,28,1557652412,7148389
1676420027,202857,true,1550504023,28,1557496663,6992640
1676420159,202858,true,1550348988,28,1557340929,6991941
1676420507,202856,true,1550659073,28,1556873820,6214747
1676420591,202856,true,1550659073,28,1556873820,6214747
1676421059,202856,true,1550659073,28,1556095616,5436543
1676421287,202856,true,1550659073,28,1555784444,5125371
1676421311,202855,true,1550814139,28,1555628881,4814742
1676421971,202854,true,1550969220,28,1554540376,3571156
1676422295,202854,true,1550969220,28,1554229515,3260295
1676422319,202854,true,1550969220,28,1554229515,3260295
1676423471,202852,true,1551279430,28,1553297303,2017873
1676423687,202851,true,1551434558,28,1553297303,1862745
1676424179,202851,true,1551434558,28,1553297303,1862745
1676426303,202851,true,1551434558,28,1553141989,1707431
1676427143,202849,true,1551744860,28,1553141989,1397129
1676427911,202849,true,1551744860,28,1552831407,1086547
1676428211,202848,true,1551900035,28,1552676140,776105
1676428415,202849,true,1551744860,28,1552676140,931280
1676428727,202848,true,1551900035,28,1552520888,620853
1676429195,202848,true,1551900035,28,1552365651,465616
1676429207,202847,true,1552055225,28,1552365651,310426
1676429255,202848,true,1551900035,28,1552365651,465616
1676429315,202847,true,1552055225,28,1552365651,310426
1676429375,202847,true,1552055225,28,1552210430,155205
1676429399,202847,true,1552055225,28,1552210430,155205
1676429459,202847,true,1552055225,28,1552055225,0
1676429651,202847,true,1552055225,28,1551589701,-465524
1676429699,202847,true,1552055225,28,1551589701,-465524
1676430131,202846,true,1552210430,28,1550504023,-1706407
1676431427,202847,true,1552055225,28,1548180126,-3875099
1676431883,202846,true,1552210430,28,1548180126,-4030304
1676433707,202846,true,1552210430,28,1548334944,-3875486
1676435663,202845,true,1552365651,28,1548334944,-4030707
1676435879,202845,true,1552365651,28,1548334944,-4030707
1676435927,202845,true,1552365651,28,1548334944,-4030707
1676440079,202844,true,1552520888,28,1548180126,-4340762
1676442227,202843,true,1552676140,28,1548334944,-4341196
1676442371,202844,true,1552520888,28,1548489778,-4031110
1676442563,202843,true,1552676140,28,1548489778,-4186362
1676445359,202842,true,1552831407,28,1548799491,-4031916
1676446163,202841,true,1552986691,28,1548799491,-4187200
1676446187,202842,true,1552831407,28,1548799491,-4031916
1676447099,202841,true,1552986691,28,1548799491,-4187200
1676448395,202841,true,1552986691,28,1548799491,-4187200
1676449043,202840,true,1553141989,28,1547870537,-5271452
1676449643,202840,true,1553141989,28,1546942139,-6199850
1676452151,202840,true,1553141989,28,1546168900,-6973089
1676453699,202840,true,1553141989,28,1546168900,-6973089
1676453723,202840,true,1553141989,28,1546168900,-6973089
1676454419,202840,true,1553141989,28,1546168900,-6973089
1676455115,202840,true,1553141989,28,1546323517,-6818472
1676455127,202840,true,1553141989,28,1546323517,-6818472
1676455955,202840,true,1553141989,28,1546787461,-6354528
1676456591,202841,true,1552986691,28,1547096833,-5889858
1676456603,202841,true,1552986691,28,1547096833,-5889858
1676456627,202841,true,1552986691,28,1547096833,-5889858
1676457227,202841,true,1552986691,28,1547406268,-5580423
1676457311,202841,true,1552986691,28,1547406268,-5580423
1676457407,202841,true,1552986691,28,1547406268,-5580423
1676457467,202841,true,1552986691,28,1547561009,-5425682
1676457515,202841,true,1552986691,28,1547561009,-5425682
1676457539,202841,true,1552986691,28,1547561009,-5425682
1676458235,202841,true,1552986691,28,1549109267,-3877424
1676458343,202841,true,1552986691,28,1549264177,-3722514
1676458415,202841,true,1552986691,28,1549419104,-3567587
1676458451,202841,true,1552986691,28,1549574046,-3412645
1676458463,202841,true,1552986691,28,1549574046,-3412645
1676458475,202841,true,1552986691,28,1549729003,-3257688
1676459351,202841,true,1552986691,28,1553452633,465942
1676460683,202841,true,1552986691,28,1555784444,2797753
1676460695,202841,true,1552986691,28,1555940022,2953331
1676461187,202841,true,1552986691,28,1556251226,3264535
1676461199,202841,true,1552986691,28,1556251226,3264535
1676461223,202841,true,1552986691,28,1556406851,3420160
1676461235,202841,true,1552986691,28,1556406851,3420160
1676461247,202840,true,1553141989,28,1556562492,3420503
1676461967,202838,true,1553452633,28,1562644634,9192001
1676462639,202838,true,1553452633,28,1568436838,14984205
1676462915,202838,true,1553452633,28,1570791141,17338508
1676463047,202837,true,1553607978,28,1571733852,18125874
1676463059,202835,true,1553918716,28,1571733852,17815136
1676463119,202835,true,1553918716,28,1572048214,18129498
1676463155,202834,true,1554074107,28,1572362639,18288532
1676463839,202832,true,1554384938,28,1577086574,22701636
1676464367,202829,true,1554851300,28,1581508382,26657082
1676465507,202829,true,1554851300,28,1587053082,32201782
1676466827,202828,true,1555006785,28,1587529246,32522461
1676466851,202825,true,1555473334,28,1587529246,32055912
1676466875,202823,true,1555784444,28,1587529246,31744802
1676466887,202822,true,1555940022,28,1587529246,31589224
1676466995,202822,true,1555940022,28,1587370509,31430487
1676467235,202819,true,1556406851,28,1587053082,30646231
1676467811,202816,true,1556873820,28,1586259794,29385974
1676468639,202816,true,1556873820,28,1582141081,25267261
1676469035,202816,true,1556873820,28,1580717865,23844045
1676470499,202813,true,1557340929,28,1578822236,21481307
1676470859,202810,true,1557808178,28,1578822236,21014058
1676470895,202810,true,1557808178,28,1578822236,21014058
1676470943,202810,true,1557808178,28,1578822236,21014058
1676471015,202808,true,1558119755,28,1578664370,20544615
1676472527,202806,true,1558431394,28,1576455897,18024503
1676472719,202805,true,1558587238,28,1576298267,17711029
1676472863,202805,true,1558587238,28,1576298267,17711029
1676474279,202803,true,1558898971,28,1574565379,15666408
1676474375,202801,true,1559210766,28,1574565379,15354613
1676474447,202801,true,1559210766,28,1574407938,15197172
1676474567,202801,true,1559210766,28,1574250513,15039747
1676474651,202799,true,1559522624,28,1574250513,14727889
1676474747,202797,true,1559834544,28,1574250513,14415969
1676474771,202797,true,1559834544,28,1574250513,14415969
1676474783,202797,true,1559834544,28,1574250513,14415969
1676474879,202796,true,1559990527,28,1574093103,14102576
1676474903,202794,true,1560302541,28,1574093103,13790562
1676474939,202793,true,1560458571,28,1574093103,13634532
1676475059,202793,true,1560458571,28,1574250513,13791942
1676475071,202791,true,1560770679,28,1574250513,13479834
1676475143,202789,true,1561082848,28,1574250513,13167665
1676475179,202789,true,1561082848,28,1574250513,13167665
1676475191,202788,true,1561238957,28,1574407938,13168981
1676475623,202786,true,1561551220,28,1574880307,13329087
1676475659,202784,true,1561863546,28,1575037795,13174249
1676475707,202783,true,1562019732,28,1575037795,13018063
1676476235,202783,true,1562019732,28,1575825472,13805740
1676476271,202781,true,1562332152,28,1575825472,13493320
1676476451,202779,true,1562644634,28,1576140653,13496019
1676476523,202778,true,1562800898,28,1576140653,13339755
1676476535,202778,true,1562800898,28,1576140653,13339755
1676476619,202775,true,1563269786,28,1576455897,13186111
1676476643,202773,true,1563582455,28,1576455897,12873442
1676476967,202772,true,1563738813,28,1577086574,13347761
1676477159,202772,true,1563738813,28,1577402007,13663194
1676477267,202769,true,1564207982,28,1577559747,13351765
1676477279,202767,true,1564520839,28,1577559747,13038908
1676477363,202766,true,1564677291,28,1577717503,13040212
1676477423,202765,true,1564833759,28,1577717503,12883744
1676477459,202763,true,1565146741,28,1577875275,12728534
1676477471,202760,true,1565616332,28,1577875275,12258943
1676477495,202759,true,1565772894,28,1578033062,12260168
1676477555,202758,true,1565929471,28,1578190865,12261394
1676477783,202755,true,1566399297,28,1579138017,12738720
1676477903,202752,true,1566869264,28,1579769767,12900503
1676478095,202751,true,1567025951,28,1580401769,13375818
1676478203,202749,true,1567339372,28,1580875937,13536565
1676478215,202747,true,1567652855,28,1580875937,13223082
1676478707,202744,true,1568123198,28,1582141081,14017883
1676478887,202743,true,1568280010,28,1582615771,14335761
1676478911,202742,true,1568436838,28,1582615771,14178933
1676479043,202739,true,1568907417,28,1582932309,14024892
1676479223,202736,true,1569378136,28,1583090603,13712467
1676479415,202735,true,1569535074,28,1582932309,13397235
1676480471,202734,true,1569692027,28,1581824700,12132673
1676480615,202731,true,1570162982,28,1581666533,11503551
1676480807,202729,true,1570477030,28,1581350247,10873217
1676485583,202728,true,1570634078,28,1578980119,8346041
1676485607,202727,true,1570791141,28,1579138017,8346876
1676485631,202724,true,1571262426,28,1579138017,7875591
1676485667,202722,true,1571576694,28,1579138017,7561323
1676485775,202721,true,1571733852,28,1579295930,7562078
1676486255,202719,true,1572048214,28,1579927744,7879530
1676486639,202716,true,1572519876,28,1580559809,8039933
1676486675,202714,true,1572834395,28,1580717865,7883470
1676486723,202713,true,1572991679,28,1580875937,7884258
1676486735,202711,true,1573306293,28,1580875937,7569644
1676486747,202708,true,1573778332,28,1580875937,7097605
1676487935,202704,true,1574407938,28,1588005552,13597614
1676488235,202703,true,1574565379,28,1589435329,14869950
1676488283,202701,true,1574880307,28,1589753232,14872925
1676488319,202698,true,1575352819,28,1589912207,14559388
1676488343,202694,true,1575983054,28,1590071198,14088144
1676488391,202692,true,1576298267,28,1590389229,14090962
1676488415,202691,true,1576455897,28,1590548267,14092370
1676488451,202687,true,1577086574,28,1590707322,13620748
1676488463,202683,true,1577717503,28,1590866393,13148890
1676488475,202682,true,1577875275,28,1590866393,12991118
1676488487,202680,true,1578190865,28,1591025480,12834615
1676488535,202676,true,1578822236,28,1591502835,12680599
1676488583,202671,true,1579611805,28,1591980334,12368529
1676488619,202670,true,1579769767,28,1592298746,12528979
1676488811,202668,true,1580085736,28,1594051150,13965414
1676488847,202663,true,1580875937,28,1594369976,13494039
1676489387,202660,true,1581350247,28,1599639824,18289577
1676489399,202658,true,1581666533,28,1599799788,18133255
1676489411,202656,true,1581982882,28,1599959768,17976886
1676489435,202651,true,1582774032,28,1600279776,17505744
1676489459,202646,true,1583565577,28,1600759908,17194331
1676489471,202644,true,1583882306,28,1600919984,17037678
1676490707,202641,true,1584357519,28,1619597844,35240325
1676490983,202638,true,1584832873,28,1622028942,37196069
1676491211,202634,true,1585466902,28,1623976448,38509546
1676491727,202632,true,1585784011,28,1624626136,38842125
1676491751,202629,true,1586259794,28,1624626136,38366342
1676491763,202626,true,1586735719,28,1624626136,37890417
1676491859,202622,true,1587370509,28,1625113573,37743064
1676491943,202619,true,1587846767,28,1625438612,37591845
1676492423,202616,true,1588323169,28,1628041265,39718096
1676492435,202615,true,1588482001,28,1628204069,39722068
1676492447,202611,true,1589117490,28,1628204069,39086579
1676492471,202609,true,1589435329,28,1628529726,39094397
1676493071,202603,true,1590389229,28,1635547130,45157901
1676493083,202602,true,1590548267,28,1635710684,45162417
1676493095,202598,true,1591184582,28,1635874255,44689673
1676493107,202596,true,1591502835,28,1636037843,44535008
1676493131,202589,true,1592617221,28,1636528703,43911482
1676493143,202587,true,1592935761,28,1636692356,43756595
1676493167,202582,true,1593732388,28,1637183413,43451025
1676493263,202578,true,1594369976,28,1639149114,44779138
1676493275,202571,true,1595486370,28,1639476960,43990590
1676493299,202568,true,1595965064,28,1639968852,44003788
1676493311,202563,true,1596763206,28,1640296863,43533657
1676493323,202558,true,1597561748,28,1640789001,43227253
1676493371,202550,true,1598840244,28,1641937898,43097654
1676493383,202547,true,1599319944,28,1642266302,42946358
1676493407,202542,true,1600119764,28,1642923307,42803543
1676493419,202537,true,1600919984,28,1643087599,42167615
1676493455,202530,true,1602040964,28,1643909307,41868343
1676493503,202527,true,1602521625,28,1645060389,42538764
1676493539,202522,true,1603323046,28,1645718512,42395466
1676493599,202517,true,1604124868,28,1646870861,42745993
1676494259,202510,true,1605248092,28,1657941387,52693295
1676494787,202507,true,1605729715,28,1663421356,57691641
1676494811,202503,true,1606372103,28,1663587698,57215595
1676494847,202497,true,1607336167,28,1663920433,56584266
1676494907,202490,true,1608461640,28,1664419659,55958019
1676495447,202488,true,1608783348,28,1663754057,54970709
1676495459,202483,true,1609587901,28,1663754057,54166156
1676495987,202477,true,1610553895,28,1663587698,53033803
1676495999,202471,true,1611520469,28,1663587698,52067229
1676496023,202468,true,1612003974,28,1663587698,51583724
1676496047,202463,true,1612810137,28,1663754057,50943920
1676496155,202457,true,1613778065,28,1663920433,50142368
1676496371,202450,true,1614908049,28,1664419659,49511610
1676496407,202448,true,1615231046,28,1664586101,49355055
1676496671,202443,true,1616038823,28,1665085526,49046703
1676496719,202437,true,1617008689,28,1665252035,48243346
1676496899,202430,true,1618140935,28,1665918236,47777301
1676496959,202428,true,1618464579,28,1666084827,47620248
1676497031,202422,true,1619435901,28,1666418061,46982160
1676497043,202417,true,1620245781,28,1666418061,46172280
1676497055,202410,true,1621380293,28,1666418061,45037768
1676497139,202408,true,1621704585,28,1666584703,44880118
1676497295,202403,true,1622515600,28,1666918036,44402436
1676497403,202397,true,1623489353,28,1667251437,43762084
1676497679,202390,true,1624626136,28,1667751662,43125526
1676497907,202388,true,1624951078,28,1667918437,42967359
1676497919,202383,true,1625763716,28,1667918437,42154721
1676498471,202378,true,1626576760,28,1667751662,41174902
1676498531,202371,true,1627715705,28,1667584904,39869199
1676498555,202369,true,1628041265,28,1667584904,39543639
1676499191,202364,true,1628855448,28,1666918036,38062588
1676499239,202359,true,1629670039,28,1666751361,37081322
1676499455,202352,true,1630811150,28,1666751361,35940211
1676499587,202351,true,1630974231,28,1666751361,35777130
1676499779,202346,true,1631789882,28,1667251437,35461555
1676499791,202340,true,1632769200,28,1667251437,34482237
1676501603,202334,true,1633749107,28,1669086331,35337224
1676503103,202332,true,1634075873,28,1669253239,35177366
1676504039,202327,true,1634893074,28,1669253239,34360165
1676504447,202321,true,1635874255,28,1669253239,33378984
1676504771,202315,true,1636856025,28,1669253239,32397214
1676505443,202313,true,1637183413,28,1670422067,33238654
1676505527,202307,true,1638165969,28,1670589109,32423140
1676505743,202301,true,1639149114,28,1671257445,32108331
1676505803,202295,true,1640132849,28,1671591713,31458864
1676505815,202292,true,1640624938,28,1671591713,30966775
1676505851,202287,true,1641445415,28,1671758873,30313458
1676506295,202280,true,1642594771,28,1673933464,31338693
1676506307,202273,true,1643744933,28,1673933464,30188531
1676506319,202271,true,1644073698,28,1674100857,30027159
1676506343,202265,true,1645060389,28,1674268267,29207878
1676506355,202258,true,1646212277,28,1674435694,28223417
1676506523,202250,true,1647529708,28,1676110883,28581175
1676506571,202247,true,1648024016,28,1676781428,28757412
1676506583,202242,true,1648848193,28,1676781428,27933235
1676506607,202234,true,1650167733,28,1677116801,26949068
1676506667,202226,true,1651488330,28,1677955527,26467197
1676506739,202223,true,1651983826,28,1678794673,26810847
1676506763,202219,true,1652644718,28,1679130449,26485731
1676506775,202211,true,1653967297,28,1679298362,25331065
1676506787,202202,true,1655456463,28,1679634238,24177775
1676506931,202199,true,1655953150,28,1682155454,26202304
1676506943,202194,true,1656781292,28,1682323669,25542377
1676506955,202187,true,1657941387,28,1682491902,24550515
1676507027,202178,true,1659434131,28,1684006750,24572619
1676507111,202174,true,1660098004,28,1685691515,25593511
1676507243,202169,true,1660928219,28,1688053018,27124799
1676507255,202163,true,1661925025,28,1688390645,26465620
1676507327,202154,true,1663421356,28,1689572873,26151517
1676507339,202151,true,1663920433,28,1689910805,25990372
1676507387,202148,true,1664419659,28,1690586871,26167212
1676507423,202141,true,1665585102,28,1691094097,25508995
1676507447,202134,true,1666751361,28,1691432333,24680972
1676507495,202131,true,1667251437,28,1692109007,24857570
1676507507,202128,true,1667751662,28,1692278218,24526556
1676507579,202122,true,1668752563,28,1693124527,24371964
1676507603,202114,true,1670088033,28,1693463169,23375136
1676507699,202112,true,1670422067,28,1694479501,24057434
1676507711,202111,true,1670589109,28,1694479501,23890392
1676507879,202105,true,1671591713,28,1696174743,24583030
1676507903,202099,true,1672594919,28,1696344360,23749441
1676507915,202097,true,1672929455,28,1696513995,23584540
1676507927,202095,true,1673264058,28,1696513995,23249937
1676507939,202090,true,1674100857,28,1696683646,22582789
1676508539,202085,true,1674938075,28,1697023000,22084925
1676508743,202083,true,1675273079,28,1694987895,19714816
1676508947,202083,true,1675273079,28,1691939813,16666734
1676508983,202079,true,1675943289,28,1691432333,15489044
1676508995,202075,true,1676613767,28,1691263207,14649440
1676509175,202073,true,1676949106,28,1689235009,12285903
1676509403,202072,true,1677116801,28,1687040540,9923739
1676509415,202068,true,1677787749,28,1687040540,9252791
1676509487,202066,true,1678123323,28,1686534529,8411206
1676509511,202064,true,1678458964,28,1686534529,8075565
1676511479,202063,true,1678626810,28,1688053018,9426208
1676511623,202059,true,1679298362,28,1688053018,8754656
1676512619,202059,true,1679298362,28,1688053018,8754656
1676512763,202057,true,1679634238,28,1688053018,8418780
1676512775,202056,true,1679802202,28,1688053018,8250816
1676512811,202053,true,1680306193,28,1688053018,7746825
1676512883,202053,true,1680306193,28,1688053018,7746825
1676512895,202052,true,1680474223,28,1688221823,7747600
1676512979,202051,true,1680642271,28,1688390645,7748374
1676513063,202049,true,1680978416,28,1688559484,7581068
1676513447,202048,true,1681146514,28,1690079796,8933282
1676513927,202047,true,1681314628,28,1692109007,10794379
1676514203,202046,true,1681482760,28,1693463169,11980409
1676514599,202044,true,1681819073,28,1695496442,13677369
1676515151,202042,true,1682155454,28,1696513995,14358541
1676516459,202041,true,1682323669,28,1697023000,14699331
1676517035,202039,true,1682660151,28,1697023000,14362849
1676517083,202037,true,1682996700,28,1697023000,14026300
1676517311,202035,true,1683333316,28,1697192702,13859386
1676517503,202033,true,1683669999,28,1697192702,13522703
1676517659,202032,true,1683838366,28,1697192702,13354336
1676518331,202030,true,1684175151,28,1697023000,12847849
1676519675,202029,true,1684343569,28,1696344360,12000791
1676519735,202026,true,1684848922,28,1696344360,11495438
1676519843,202025,true,1685017407,28,1696344360,11326953
1676520131,202023,true,1685354427,28,1696344360,10989933
1676520143,202022,true,1685522963,28,1696344360,10821397
1676520227,202020,true,1685860084,28,1696344360,10484276
1676520299,202018,true,1686197273,28,1696174743,9977470
1676520311,202017,true,1686365893,28,1696174743,9808850
1676520335,202016,true,1686534529,28,1696174743,9640214
1676520347,202014,true,1686871853,28,1696174743,9302890
1676520395,202012,true,1687209244,28,1696174743,8965499
1676520419,202011,true,1687377965,28,1696174743,8796778
1676520851,202010,true,1687546703,28,1695326910,7780207
1676521343,202009,true,1687715458,28,1694310070,6594612
1676522375,202008,true,1687884229,28,1692447446,4563217
1676522531,202007,true,1688053018,28,1692278218,4225200
1676525339,202006,true,1688221823,28,1691939813,3717990
1676525423,202004,true,1688559484,28,1692109007,3549523
1676527931,202002,true,1688897213,28,1692447446,3550233
1676528051,202001,true,1689066103,28,1692447446,3381343
1676530355,202000,true,1689235009,28,1692447446,3212437
1676530763,201998,true,1689572873,28,1692616691,3043818
1676530775,201997,true,1689741831,28,1692616691,2874860
1676530859,201996,true,1689910805,28,1692616691,2705886
1676530991,201995,true,1690079796,28,1692447446,2367650
1676531147,201993,true,1690417829,28,1691939813,1521984
1676531231,201992,true,1690586871,28,1691601476,1014605
1676531819,201992,true,1690586871,28,1687715458,-2871413
1676532659,201992,true,1690586871,28,1681987255,-8599616
1676535467,201991,true,1690755929,28,1679802202,-10953727
1676536895,201990,true,1690925005,28,1680978416,-9946589
1676537171,201990,true,1690925005,28,1681146514,-9778491
1676538239,201989,true,1691094097,28,1681146514,-9947583
1676539547,201988,true,1691263207,28,1681146514,-10116693
1676540435,201987,true,1691432333,28,1681146514,-10285819
1676540531,201987,true,1691432333,28,1681314628,-10117705
1676541215,201987,true,1691432333,28,1681314628,-10117705
1676541227,201986,true,1691601476,28,1681314628,-10286848
1676541239,201985,true,1691770636,28,1681314628,-10456008
1676541503,201985,true,1691770636,28,1681819073,-9951563
1676541755,201985,true,1691770636,28,1682155454,-9615182
1676542067,201984,true,1691939813,28,1682828417,-9111396
1676542319,201983,true,1692109007,28,1683333316,-8775691
1676542331,201984,true,1691939813,28,1683333316,-8606497
1676542343,201983,true,1692109007,28,1683333316,-8775691
1676542367,201982,true,1692278218,28,1683501649,-8776569
1676543327,201981,true,1692447446,28,1686028670,-6418776
1676543603,201983,true,1692109007,28,1686534529,-5574478
1676544155,201983,true,1692109007,28,1687209244,-4899763
1676544227,201982,true,1692278218,28,1687209244,-5068974
1676545391,201982,true,1692278218,28,1687209244,-5068974
1676545919,201983,true,1692109007,28,1687209244,-4899763
1676546075,201984,true,1691939813,28,1687209244,-4730569
1676546111,201984,true,1691939813,28,1687209244,-4730569
1676546447,201984,true,1691939813,28,1687040540,-4899273
1676547947,201985,true,1691770636,28,1686028670,-5741966
1676547995,201987,true,1691432333,28,1686028670,-5403663
1676548199,201988,true,1691263207,28,1686028670,-5234537
1676548775,201987,true,1691432333,28,1685860084,-5572249
1676548811,201989,true,1691094097,28,1685860084,-5234013
1676549219,201991,true,1690755929,28,1685691515,-5064414
1676549423,201993,true,1690417829,28,1685522963,-4894866
1676549687,201992,true,1690586871,28,1685522963,-5063908
1676550203,201994,true,1690248804,28,1685354427,-4894377
1676550467,201996,true,1689910805,28,1685354427,-4556378
1676551511,201997,true,1689741831,28,1685354427,-4387404
1676553455,201996,true,1689910805,28,1685354427,-4556378
1676554187,201998,true,1689572873,28,1685354427,-4218446
1676554355,201999,true,1689403933,28,1685354427,-4049506
1676554511,202000,true,1689235009,28,1685354427,-3880582
1676554523,201999,true,1689403933,28,1685354427,-4049506
1676554535,202001,true,1689066103,28,1685354427,-3711676
1676554595,202002,true,1688897213,28,1685522963,-3374250
1676554643,202002,true,1688897213,28,1685691515,-3205698
1676554679,202001,true,1689066103,28,1685691515,-3374588
1676554715,202002,true,1688897213,28,1685691515,-3205698
1676554931,202003,true,1688728340,28,1685860084,-2868256
1676555123,202003,true,1688728340,28,1686028670,-2699670
1676555147,202003,true,1688728340,28,1685860084,-2868256
1676555291,202004,true,1688559484,28,1685691515,-2867969
1676555303,202004,true,1688559484,28,1685691515,-2867969
1676555315,202005,true,1688390645,28,1685691515,-2699130
1676555951,202004,true,1688559484,28,1682323669,-6235815
1676555963,202006,true,1688221823,28,1682155454,-6066369
1676555987,202006,true,1688221823,28,1682155454,-6066369
1676556263,202006,true,1688221823,28,1680474223,-7747600
1676556335,202006,true,1688221823,28,1679970182,-8251641
1676556467,202008,true,1687884229,28,1678794673,-9089556
1676556587,202008,true,1687884229,28,1677955527,-9928702
1676556683,202008,true,1687884229,28,1677284513,-10599716
1676556695,202009,true,1687715458,28,1677116801,-10598657
1676557871,202010,true,1687546703,28,1675440606,-12106097
1676558111,202010,true,1687546703,28,1675608150,-11938553
1676558123,202011,true,1687377965,28,1675608150,-11769815
1676558159,202012,true,1687209244,28,1675608150,-11601094
1676558435,202014,true,1686871853,28,1675273079,-11598774
1676558483,202014,true,1686871853,28,1675273079,-11598774
1676558555,202015,true,1686703183,28,1675105569,-11597614
1676558963,202016,true,1686534529,28,1674100857,-12433672
1676559083,202018,true,1686197273,28,1673933464,-12263809
1676559131,202019,true,1686028670,28,1673766087,-12262583
1676559143,202019,true,1686028670,28,1673766087,-12262583
1676559155,202021,true,1685691515,28,1673766087,-11925428
1676559275,202022,true,1685522963,28,1673766087,-11756876
1676559299,202023,true,1685354427,28,1673766087,-11588340
1676559551,202024,true,1685185909,28,1673766087,-11419822
1676560031,202025,true,1685017407,28,1674268267,-10749140
1676560055,202026,true,1684848922,28,1674435694,-10413228
1676560271,202027,true,1684680454,28,1675273079,-9407375
1676560283,202028,true,1684512003,28,1675273079,-9238924
1676560295,202029,true,1684343569,28,1675273079,-9070490
1676560355,202030,true,1684175151,28,1675608150,-8567001
1676560427,202030,true,1684175151,28,1675943289,-8231862
1676560487,202031,true,1684006750,28,1676446122,-7560628
1676560847,202032,true,1683838366,28,1678458964,-5379402
1676560859,202033,true,1683669999,28,1678626810,-5043189
1676560871,202033,true,1683669999,28,1678626810,-5043189
1676560883,202034,true,1683501649,28,1678794673,-4706976
1676561663,202033,true,1683669999,28,1684175151,505152
1676562011,202034,true,1683501649,28,1686365893,2864244
1676562155,202035,true,1683333316,28,1687377965,4044649
1676562167,202035,true,1683333316,28,1687377965,4044649
1676562179,202034,true,1683501649,28,1687377965,3876316
1676562203,202035,true,1683333316,28,1687715458,4382142
1676562215,202034,true,1683501649,28,1687884229,4382580
1676562251,202033,true,1683669999,28,1688221823,4551824
1676562299,202032,true,1683838366,28,1688728340,4889974
1676562311,202032,true,1683838366,28,1688897213,5058847
1676562467,202030,true,1684175151,28,1691432333,7257182
1676562539,202029,true,1684343569,28,1692616691,8273122
1676562599,202028,true,1684512003,28,1693632515,9120512
1676562683,202028,true,1684512003,28,1695326910,10814907
1676562707,202025,true,1685017407,28,1695665992,10648585
1676562731,202024,true,1685185909,28,1696174743,10988834
1676562839,202022,true,1685522963,28,1698041468,12518505
1676562851,202022,true,1685522963,28,1698211272,12688309
1676562875,202019,true,1686028670,28,1698720787,12692117
1676562947,202017,true,1686365893,28,1700080239,13714346
1676563199,202015,true,1686703183,28,1704846896,18143713
1676563271,202014,true,1686871853,28,1706381872,19510019
1676563283,202010,true,1687546703,28,1706552510,19005807
1676563319,202008,true,1687884229,28,1707405957,19521728
1676563343,202005,true,1688390645,28,1707918230,19527585
1676563391,202004,true,1688559484,28,1708943237,20383753
1676563403,202000,true,1689235009,28,1709285043,20050034
1676563427,201998,true,1689572873,28,1709797879,20225006
1676563451,201995,true,1690079796,28,1710481901,20402105
1676563475,201993,true,1690417829,28,1711166197,20748368
1676563499,201989,true,1691094097,28,1711679598,20585501
1676563511,201986,true,1691601476,28,1712021951,20420475
1676563535,201983,true,1692109007,28,1712706862,20597855
1676563547,201981,true,1692447446,28,1713049421,20601975
1676563583,201978,true,1692955231,28,1713906117,20950886
1676563595,201976,true,1693293839,28,1714248915,20955076
1676563655,201973,true,1693801878,28,1715792357,21990479
1676563667,201971,true,1694140655,28,1716135532,21994877
1676563679,201968,true,1694648948,28,1716307146,21658198
1676563739,201968,true,1694648948,28,1716993772,22344824
1676563751,201967,true,1694818413,28,1716993772,22175359
1676563763,201966,true,1694987895,28,1717165471,22177576
1676563835,201965,true,1695157394,28,1717508921,22351527
1676563859,201965,true,1695157394,28,1717508921,22351527
1676564003,201965,true,1695157394,28,1718024225,22866831
1676564015,201964,true,1695326910,28,1718196028,22869118
1676564063,201962,true,1695665992,28,1718196028,22530036
1676564099,201962,true,1695665992,28,1718196028,22530036
1676564135,201960,true,1696005142,28,1718196028,22190886
1676564147,201959,true,1696174743,28,1718196028,22021285
1676564159,201958,true,1696344360,28,1718024225,21679865
1676564171,201958,true,1696344360,28,1718024225,21679865
1676564195,201957,true,1696513995,28,1717852440,21338445
1676564267,201957,true,1696513995,28,1717337187,20823192
1676564375,201955,true,1696853314,28,1716307146,19453832
1676564387,201956,true,1696683646,28,1716307146,19623500
1676564399,201954,true,1697023000,28,1716135532,19112532
1676564411,201954,true,1697023000,28,1716135532,19112532
1676564423,201951,true,1697532158,28,1715963936,18431778
1676564663,201951,true,1697532158,28,1714591782,17059624
1676564723,201949,true,1697871681,28,1714077507,16205826
1676564735,201949,true,1697871681,28,1714077507,16205826
1676565047,201946,true,1698381093,28,1711166197,12785104
1676565059,201946,true,1698381093,28,1710995097,12614004
1676565083,201945,true,1698550932,28,1710824015,12273083
1676565179,201943,true,1698890659,28,1710310870,11420211
1676565191,201940,true,1699400377,28,1710139856,10739479
1676565203,201940,true,1699400377,28,1710139856,10739479
1676565239,201939,true,1699570317,28,1709797879,10227562
1676565371,201936,true,1700080239,28,1708943237,8862998
1676565431,201933,true,1700590314,28,1708601500,8011186
1676565767,201933,true,1700590314,28,1711508447,10918133
1676566211,201931,true,1700930449,28,1715963936,15033487
1676566919,201929,true,1701270652,28,1720431023,19160371
1676567051,201925,true,1701951263,28,1720431023,18479760
1676567099,201925,true,1701951263,28,1720258997,18307734
1676567135,201922,true,1702461899,28,1720258997,17797098
1676567147,201920,true,1702802408,28,1720258997,17456589
1676567927,201917,true,1703313300,28,1718024225,14710925
1676567951,201917,true,1703313300,28,1718024225,14710925
1676567963,201914,true,1703824345,28,1717852440,14028095
1676568083,201911,true,1704335544,28,1717508921,13173377
1676568275,201908,true,1704846896,28,1716650424,11803528
1676568803,201909,true,1704676428,28,1713906117,9229689
1676568851,201906,true,1705187882,28,1713563387,8375505
1676568875,201904,true,1705528937,28,1713563387,8034450
1676568911,201901,true,1706040646,28,1713392048,7351402
1676569127,201901,true,1706040646,28,1713392048,7351402
1676569151,201898,true,1706552510,28,1713392048,6839538
1676569955,201895,true,1707064527,28,1714420340,7355813
1676571755,201891,true,1707747455,28,1717337187,9589732
1676571791,201891,true,1707747455,28,1717337187,9589732
1676571839,201888,true,1708259830,28,1717508921,9249091
1676573339,201885,true,1708772360,28,1716993772,8221412
1676573399,201882,true,1709285043,28,1716993772,7708729
1676573435,201882,true,1709285043,28,1716993772,7708729
1676574239,201879,true,1709797879,28,1717337187,7539308
1676574491,201876,true,1710310870,28,1717508921,7198051
1676575271,201873,true,1710824015,28,1718024225,7200210
1676575307,201873,true,1710824015,28,1718024225,7200210
1676575319,201870,true,1711337313,28,1718024225,6686912
1676575355,201868,true,1711679598,28,1717852440,6172842
1676576003,201866,true,1712021951,28,1716135532,4113581
1676576135,201865,true,1712193153,28,1715792357,3599204
1676576507,201863,true,1712535609,28,1714763241,2227632
1676577179,201860,true,1713049421,28,1712878133,-171288
1676577287,201859,true,1713220726,28,1712878133,-342593
1676577431,201859,true,1713220726,28,1712878133,-342593
1676577851,201857,true,1713563387,28,1712706862,-856525
1676577911,201854,true,1714077507,28,1712706862,-1370645
1676577923,201853,true,1714248915,28,1712706862,-1542053
1676577935,201853,true,1714248915,28,1712706862,-1542053
1676577971,201852,true,1714420340,28,1712535609,-1884731
1676578115,201850,true,1714763241,28,1712193153,-2570088
1676578127,201849,true,1714934718,28,1712193153,-2741565
1676578307,201848,true,1715106211,28,1711850766,-3255445
1676578511,201848,true,1715106211,28,1711508447,-3597764
1676578571,201846,true,1715449250,28,1711337313,-4111937
1676578607,201846,true,1715449250,28,1711337313,-4111937
1676578631,201847,true,1715277722,28,1711166197,-4111525
1676578655,201847,true,1715277722,28,1711166197,-4111525
1676578667,201846,true,1715449250,28,1711166197,-4283053
1676578787,201847,true,1715277722,28,1710310870,-4966852
1676578799,201848,true,1715106211,28,1710310870,-4795341
1676578907,201849,true,1714934718,28,1709626917,-5307801
1676578943,201848,true,1715106211,28,1709285043,-5821168
1676578967,201851,true,1714591782,28,1709114131,-5477651
1676579099,201852,true,1714420340,28,1708089022,-6331318
1676579243,201853,true,1714248915,28,1706893837,-7355078
1676579255,201853,true,1714248915,28,1706723165,-7525750
1676579279,201856,true,1713734743,28,1706381872,-7352871
1676579303,201858,true,1713392048,28,1706211250,-7180798
1676579639,201862,true,1712706862,28,1700590314,-12116548
1676579747,201862,true,1712706862,28,1699060548,-13646314
1676579759,201864,true,1712364372,28,1698890659,-13473713
1676579771,201866,true,1712021951,28,1698720787,-13301164
1676579783,201870,true,1711337313,28,1698550932,-12786381
1676579795,201870,true,1711337313,28,1698381093,-12956220
1676580815,201872,true,1710995097,28,1688559484,-22435613
1676581139,201875,true,1710481901,28,1687546703,-22935198
1676581163,201879,true,1709797879,28,1687715458,-22082421
1676581187,201880,true,1709626917,28,1687715458,-21911459
1676581199,201882,true,1709285043,28,1687715458,-21569585
1676581403,201885,true,1708772360,28,1688053018,-20719342
1676581511,201890,true,1707918230,28,1688053018,-19865212
1676581535,201890,true,1707918230,28,1688053018,-19865212
1676581607,201893,true,1707405957,28,1688053018,-19352939
1676581619,201896,true,1706893837,28,1687884229,-19009608
1676581631,201901,true,1706040646,28,1687884229,-18156417
1676581643,201901,true,1706040646,28,1687884229,-18156417
1676581655,201903,true,1705699489,28,1687884229,-17815260
1676581703,201905,true,1705358401,28,1687546703,-17811698
1676581715,201908,true,1704846896,28,1687546703,-17300193
1676581835,201907,true,1705017380,28,1686871853,-18145527
1676582027,201909,true,1704676428,28,1685691515,-18984913
1676582759,201909,true,1704676428,28,1681650908,-23025520
1676583107,201912,true,1704165127,28,1679970182,-24194945
1676583131,201911,true,1704335544,28,1679802202,-24533342
1676583239,201913,true,1703994728,28,1679130449,-24864279
1676583251,201914,true,1703824345,28,1679130449,-24693896
1676583455,201918,true,1703142986,28,1678458964,-24684022
1676583503,201918,true,1703142986,28,1678458964,-24684022
1676583827,201919,true,1702972689,28,1678458964,-24513725
1676584295,201920,true,1702802408,28,1678458964,-24343444
1676584427,201923,true,1702291670,28,1678458964,-23832706
1676585663,201922,true,1702461899,28,1681314628,-21147271
1676585831,201923,true,1702291670,28,1681650908,-20640762
1676586035,201923,true,1702291670,28,1681987255,-20304415
1676586083,201926,true,1701781084,28,1681987255,-19793829
1676586095,201925,true,1701951263,28,1681987255,-19964008
1676586131,201928,true,1701440779,28,1681987255,-19453524
1676586215,201929,true,1701270652,28,1681987255,-19283397
1676586563,201933,true,1700590314,28,1681146514,-19443800
1676586599,201932,true,1700760373,28,1680978416,-19781957
1676586611,201934,true,1700420272,28,1680978416,-19441856
1676586659,201936,true,1700080239,28,1680810335,-19269904
1676586671,201940,true,1699400377,28,1680642271,-18758106
1676586695,201940,true,1699400377,28,1680474223,-18926154
1676586719,201943,true,1698890659,28,1680306193,-18584466
1676586827,201947,true,1698211272,28,1678962552,-19248720
1676586887,201952,true,1697362421,28,1678123323,-19239098
1676586899,201953,true,1697192702,28,1677955527,-19237175
1676587031,201957,true,1696513995,28,1676110883,-20403112
1676587055,201960,true,1696005142,28,1675775711,-20229431
1676587091,201965,true,1695157394,28,1675273079,-19884315
1676587139,201967,true,1694818413,28,1674435694,-20382719
1676587151,201971,true,1694140655,28,1674268267,-19872388
1676587163,201975,true,1693463169,28,1673933464,-19529705
1676587211,201980,true,1692616691,28,1673096748,-19519943
1676587367,201982,true,1692278218,28,1670088033,-22190185
1676587427,201985,true,1691770636,28,1668919439,-22851197
1676587451,201989,true,1691094097,28,1668585705,-22508392
1676587463,201994,true,1690248804,28,1668418863,-21829941
1676588255,201995,true,1690079796,28,1656781292,-33298504
1676588279,201998,true,1689572873,28,1656449985,-33122888
1676588327,202001,true,1689066103,28,1655787571,-33278532
1676588423,202007,true,1688053018,28,1654463537,-33589481
1676588783,202008,true,1687884229,28,1651983826,-35900403
1676588831,202011,true,1687377965,28,1651818644,-35559321
1676588843,202015,true,1686703183,28,1651653478,-35049705
1676589095,202020,true,1685860084,28,1651818644,-34041440
1676589203,202022,true,1685522963,28,1651983826,-33539137
1676589323,202025,true,1685017407,28,1651983826,-33033581
1676590487,202029,true,1684343569,28,1651323197,-33020372
1676590535,202034,true,1683501649,28,1651323197,-32178452
1676590559,202036,true,1683164999,28,1651323197,-31841802
1676590583,202039,true,1682660151,28,1651323197,-31336954
1676590823,202043,true,1681987255,28,1651158081,-30829174
1676590943,202049,true,1680978416,28,1650992982,-29985434
1676590955,202050,true,1680810335,28,1650992982,-29817353
1676590967,202053,true,1680306193,28,1650992982,-29313211
1676591267,202059,true,1679298362,28,1650002733,-29295629
1676591279,202064,true,1678458964,28,1649837749,-28621215
1676591351,202066,true,1678123323,28,1649507831,-28615492
1676591483,202068,true,1677787749,28,1648848193,-28939556
1676591531,202074,true,1676781428,28,1648683325,-28098103
1676591579,202079,true,1675943289,28,1648353637,-27589652
1676591615,202081,true,1675608150,28,1648188818,-27419332
1676591699,202084,true,1675105569,28,1647529708,-27575861
1676591771,202089,true,1674268267,28,1647035548,-27232719
1676592131,202095,true,1673264058,28,1644566970,-28697088
1676592143,202096,true,1673096748,28,1644566970,-28529778
1676592203,202099,true,1672594919,28,1644073698,-28521221
1676592335,202105,true,1671591713,28,1642923307,-28668406
1676592347,202111,true,1670589109,28,1642759031,-27830078
1676592371,202112,true,1670422067,28,1642594771,-27827296
1676592407,202115,true,1669921041,28,1642430528,-27490513
1676592419,202120,true,1669086331,28,1642430528,-26655803
1676592623,202126,true,1668085229,28,1641445415,-26639814
1676593103,202127,true,1667918437,28,1640132849,-27785588
1676593223,202129,true,1667584904,28,1639968852,-27616052
1676593307,202135,true,1666584703,28,1639968852,-26615851
1676593523,202140,true,1665751660,28,1640132849,-25618811
1676593619,202140,true,1665751660,28,1640296863,-25454797
1676593955,202142,true,1665418560,28,1641281287,-24137273
1676593991,202147,true,1664586101,28,1641445415,-23140686
1676594027,202152,true,1663754057,28,1641773720,-21980337
1676594039,202152,true,1663754057,28,1641773720,-21980337
1676594363,202153,true,1663587698,28,1643251908,-20335790
1676594411,202158,true,1662756154,28,1643580575,-19175579
1676594711,202163,true,1661925025,28,1645060389,-16864636
1676594759,202163,true,1661925025,28,1645224895,-16700130
1676594855,202163,true,1661925025,28,1645883084,-16041941
1676596271,202168,true,1661094312,28,1651158081,-9936231
1676596283,202170,true,1660762143,28,1651158081,-9604062
1676596319,202170,true,1660762143,28,1651323197,-9438946
1676596331,202170,true,1660762143,28,1651323197,-9438946
1676596751,202174,true,1660098004,28,1651818644,-8279360
1676596775,202176,true,1659766034,28,1651983826,-7782208
1676596787,202177,true,1659600074,28,1651983826,-7616248
1676596823,202178,true,1659434131,28,1651983826,-7450305
1676597759,202181,true,1658936400,28,1654132694,-4803706
1676599067,202183,true,1658604663,28,1655456463,-3148200
1676599151,202184,true,1658438819,28,1655456463,-2982356
1676599163,202185,true,1658272992,28,1655456463,-2816529
1676599223,202188,true,1657775609,28,1655622009,-2153600
1676599499,202189,true,1657609848,28,1656284357,-1325491
1676599595,202190,true,1657444104,28,1656449985,-994119
1676599619,202190,true,1657444104,28,1656615630,-828474
1676600459,202193,true,1656946970,28,1658936400,1989430
1676600819,202194,true,1656781292,28,1659932011,3150719
1676604467,202194,true,1656781292,28,1660430040,3648748
1676604563,202195,true,1656615630,28,1660596083,3980453
1676604623,202197,true,1656284357,28,1660596083,4311726
1676604647,202198,true,1656118745,28,1660596083,4477338
1676604731,202198,true,1656118745,28,1660762143,4643398
1676604743,202198,true,1656118745,28,1660762143,4643398
1676604815,202201,true,1655622009,28,1660928219,5306210
1676606495,202202,true,1655456463,28,1664253233,8796770
1676606807,202201,true,1655622009,28,1664253233,8631224
1676607851,202201,true,1655622009,28,1664253233,8631224
1676607911,202203,true,1655290934,28,1664253233,8962299
1676608571,202204,true,1655125421,28,1663920433,8795012
1676608643,202204,true,1655125421,28,1663754057,8628636
1676608655,202204,true,1655125421,28,1663754057,8628636
1676608703,202207,true,1654628983,28,1663754057,9125074
1676608715,202208,true,1654463537,28,1663754057,9290520
1676609051,202208,true,1654463537,28,1662922430,8458893
1676609411,202209,true,1654298107,28,1662091218,7793111
1676609627,202211,true,1653967297,28,1661592690,7625393
1676609735,202212,true,1653801917,28,1661426547,7624630
1676609927,202213,true,1653636553,28,1661094312,7457759
1676610815,202213,true,1653636553,28,1660098004,6461451
1676613167,202216,true,1653140561,28,1659600074,6459513
1676613227,202216,true,1653140561,28,1659600074,6459513
1676613323,202217,true,1652975264,28,1659600074,6624810
1676614991,202217,true,1652975264,28,1659600074,6624810
1676616911,202219,true,1652644718,28,1659434131,6789413
1676619059,202220,true,1652479470,28,1659434131,6954661
1676620007,202220,true,1652479470,28,1659434131,6954661
1676620631,202220,true,1652479470,28,1659600074,7120604
1676620715,202220,true,1652479470,28,1659600074,7120604
1676620883,202220,true,1652479470,28,1659434131,6954661
1676620943,202220,true,1652479470,28,1659434131,6954661
1676620967,202220,true,1652479470,28,1659268204,6788734
1676622683,202220,true,1652479470,28,1656284357,3804887
1676624363,202220,true,1652479470,28,1655953150,3473680
1676624375,202220,true,1652479470,28,1655953150,3473680
1676624387,202219,true,1652644718,28,1655953150,3308432
1676624435,202220,true,1652479470,28,1655953150,3473680
1676624447,202218,true,1652809983,28,1655953150,3143167
1676624459,202217,true,1652975264,28,1656118745,3143481
1676624483,202217,true,1652975264,28,1656118745,3143481
1676624495,202217,true,1652975264,28,1656284357,3309093
1676624675,202215,true,1653305875,28,1657112665,3806790
1676624807,202215,true,1653305875,28,1657941387,4635512
1676627735,202214,true,1653471206,28,1666418061,12946855
1676628671,202214,true,1653471206,28,1666251436,12780230
1676636027,202212,true,1653801917,28,1666084827,12282910
1676636651,202211,true,1653967297,28,1666251436,12284139
1676636699,202210,true,1654132694,28,1666251436,12118742
1676637227,202210,true,1654132694,28,1666251436,12118742
1676637467,202209,true,1654298107,28,1666251436,11953329
1676639207,202208,true,1654463537,28,1666084827,11621290
1676639747,202207,true,1654628983,28,1666251436,11622453
1676640143,202207,true,1654628983,28,1666251436,11622453
1676640155,202205,true,1654959925,28,1666251436,11291511
1676640323,202205,true,1654959925,28,1666084827,11124902
1676641643,202205,true,1654959925,28,1663088722,8128797
1676641703,202204,true,1655125421,28,1663088722,7963301
1676642651,202203,true,1655290934,28,1662257427,6966493
1676642687,202202,true,1655456463,28,1662257427,6800964
1676643539,202202,true,1655456463,28,1662257427,6800964
1676643551,202201,true,1655622009,28,1662423653,6801644
1676643575,202199,true,1655953150,28,1662423653,6470503
1676643683,202198,true,1656118745,28,1662423653,6304908
1676643719,202197,true,1656284357,28,1662589895,6305538
1676644415,202196,true,1656449985,28,1663920433,7470448
1676644427,202194,true,1656781292,28,1663920433,7139141
1676644451,202193,true,1656946970,28,1664086825,7139855
1676644463,202192,true,1657112665,28,1664086825,6974160
1676644511,202189,true,1657609848,28,1664419659,6809811
1676644571,202187,true,1657941387,28,1664752559,6811172
1676644583,202186,true,1658107181,28,1664752559,6645378
1676644607,202184,true,1658438819,28,1664919034,6480215
1676644799,202181,true,1658936400,28,1666584703,7648303
1676644895,202178,true,1659434131,28,1667418162,7984031
1676645015,202177,true,1659600074,28,1668418863,8818789
1676645183,202176,true,1659766034,28,1669921041,10155007
1676645195,202173,true,1660264014,28,1670088033,9824019
1676645243,202170,true,1660762143,28,1670422067,9659924
1676645255,202169,true,1660928219,28,1670422067,9493848
1676645279,202168,true,1661094312,28,1670589109,9494797
1676645375,202166,true,1661426547,28,1670923244,9496697
1676645423,202164,true,1661758849,28,1670923244,9164395
1676645435,202164,true,1661758849,28,1670923244,9164395
1676645447,202163,true,1661925025,28,1670923244,8998219
1676645687,202163,true,1661925025,28,1669587107,7662082
1676645711,202161,true,1662257427,28,1669420165,7162738
1676645975,202162,true,1662091218,28,1667584904,5493686
1676646023,202162,true,1662091218,28,1667251437,5160219
1676646035,202162,true,1662091218,28,1667251437,5160219
1676646071,202160,true,1662423653,28,1666918036,4494383
1676646083,202160,true,1662423653,28,1666918036,4494383
1676646215,202160,true,1662423653,28,1666418061,3994408
1676646239,202160,true,1662423653,28,1666251436,3827783
1676646251,202159,true,1662589895,28,1666251436,3661541
1676646263,202159,true,1662589895,28,1666084827,3494932
1676646287,202158,true,1662756154,28,1666084827,3328673
1676646431,202159,true,1662589895,28,1665085526,2495631
1676646695,202157,true,1662922430,28,1662756154,-166276
1676646755,202157,true,1662922430,28,1662257427,-665003
1676646779,202156,true,1663088722,28,1662091218,-997504
1676646803,202157,true,1662922430,28,1661758849,-1163581
1676646827,202155,true,1663255031,28,1661592690,-1662341
1676647175,202154,true,1663421356,28,1660098004,-3323352
1676647211,202154,true,1663421356,28,1660264014,-3157342
1676647223,202155,true,1663255031,28,1660264014,-2991017
1676647691,202153,true,1663587698,28,1664253233,665535
1676647715,202152,true,1663754057,28,1664586101,832044
1676648171,202152,true,1663754057,28,1667918437,4164380
1676648303,202152,true,1663754057,28,1668585705,4831648
1676648339,202151,true,1663920433,28,1668752563,4832130
1676648375,202150,true,1664086825,28,1668919439,4832614
1676648447,202149,true,1664253233,28,1669253239,5000006
1676648495,202150,true,1664086825,28,1669420165,5333340
1676648507,202148,true,1664419659,28,1669587107,5167448
1676648531,202148,true,1664419659,28,1669754065,5334406
1676648651,202147,true,1664586101,28,1670422067,5835966
1676649515,202148,true,1664419659,28,1673431384,9011725
1676650103,202146,true,1664752559,28,1674770598,10018039
1676650115,202145,true,1664919034,28,1674770598,9851564
1676650151,202145,true,1664919034,28,1674938075,10019041
1676650559,202145,true,1664919034,28,1676278494,11359460
1676650775,202143,true,1665252035,28,1676781428,11529393
1676650811,202142,true,1665418560,28,1676949106,11530546
1676650823,202141,true,1665585102,28,1676949106,11364004
1676650847,202141,true,1665585102,28,1676949106,11364004
1676650859,202140,true,1665751660,28,1676949106,11197446
1676650883,202139,true,1665918236,28,1676949106,11030870
1676650895,202138,true,1666084827,28,1676949106,10864279
1676650919,202138,true,1666084827,28,1676949106,10864279
1676651087,202137,true,1666251436,28,1676781428,10529992
1676651327,202136,true,1666418061,28,1676278494,9860433
1676651351,202135,true,1666584703,28,1676278494,9693791
1676651363,202136,true,1666418061,28,1676278494,9860433
1676651603,202134,true,1666751361,28,1675608150,8856789
1676651615,202134,true,1666751361,28,1675608150,8856789
1676651675,202133,true,1666918036,28,1675273079,8355043
1676652107,202134,true,1666751361,28,1673096748,6345387
1676652191,202132,true,1667084728,28,1672594919,5510191
1676652263,202132,true,1667084728,28,1672260450,5175722
1676652299,202131,true,1667251437,28,1671926048,4674611
1676652311,202132,true,1667084728,28,1671926048,4841320
1676652335,202130,true,1667418162,28,1671758873,4340711
1676652371,202129,true,1667584904,28,1671591713,4006809
1676652467,202128,true,1667751662,28,1671257445,3505783
1676652503,202128,true,1667751662,28,1671257445,3505783
1676652527,202127,true,1667918437,28,1671090336,3171899
1676652875,202126,true,1668085229,28,1670923244,2838015
1676652923,202124,true,1668418863,28,1670923244,2504381
1676653415,202124,true,1668418863,28,1671591713,3172850
1676653547,202123,true,1668585705,28,1671926048,3340343
1676653595,202123,true,1668585705,28,1672093241,3507536
1676653655,202121,true,1668919439,28,1672427676,3508237
1676653715,202121,true,1668919439,28,1672762179,3842740
1676653739,202121,true,1668919439,28,1672929455,4010016
1676653751,202120,true,1669086331,28,1673096748,4010417
1676653823,202117,true,1669587107,28,1674100857,4513750
1676653883,202116,true,1669754065,28,1674938075,5184010
1676653895,202115,true,1669921041,28,1675105569,5184528
1676653907,202114,true,1670088033,28,1675273079,5185046
1676653919,202112,true,1670422067,28,1675440606,5018539
1676654135,202110,true,1670756168,28,1678794673,8038505
1676654231,202108,true,1671090336,28,1680306193,9215857
1676654243,202107,true,1671257445,28,1680642271,9384826
1676654255,202105,true,1671591713,28,1680810335,9218622
1676654327,202102,true,1672093241,28,1681819073,9725832
1676655167,202101,true,1672260450,28,1693801878,21541428
1676655239,202100,true,1672427676,28,1694818413,22390737
1676656343,202097,true,1672929455,28,1699570317,26640862
1676656355,202094,true,1673431384,28,1699570317,26138933
1676656379,202093,true,1673598727,28,1699400377,25801650
1676656475,202092,true,1673766087,28,1699230454,25464367
1676656547,202090,true,1674100857,28,1699230454,25129597
1676656751,202087,true,1674603137,28,1698720787,24117650
1676656763,202086,true,1674770598,28,1698720787,23950189
1676656835,202085,true,1674938075,28,1698381093,23443018
1676656991,202083,true,1675273079,28,1697871681,22598602
1676657003,202081,true,1675608150,28,1697871681,22263531
1676657435,202081,true,1675608150,28,1696005142,20396992
1676657579,202080,true,1675775711,28,1695496442,19720731
1676658119,202077,true,1676278494,28,1694479501,18201007
1676658239,202076,true,1676446122,28,1694310070,17863948
1676658803,202076,true,1676446122,28,1694310070,17863948
1676658815,202075,true,1676613767,28,1694310070,17696303
1676661611,202073,true,1676949106,28,1692278218,15329112
1676661875,202073,true,1676949106,28,1692278218,15329112
1676661923,202073,true,1676949106,28,1692278218,15329112
1676662475,202072,true,1677116801,28,1693124527,16007726
1676662583,202070,true,1677452241,28,1693293839,15841598
1676662619,202069,true,1677619987,28,1693463169,15843182
1676662691,202069,true,1677619987,28,1693632515,16012528
1676662703,202068,true,1677787749,28,1693632515,15844766
1676662727,202065,true,1678291135,28,1693632515,15341380
1676662775,202064,true,1678458964,28,1693801878,15342914
1676662787,202063,true,1678626810,28,1693801878,15175068
1676663135,202061,true,1678962552,28,1695496442,16533890
1676663147,202058,true,1679466291,28,1695496442,16030151
1676663267,202055,true,1679970182,28,1696174743,16204561
1676663291,202053,true,1680306193,28,1696344360,16038167
1676663471,202051,true,1680642271,28,1697532158,16889887
1676663495,202048,true,1681146514,28,1697532158,16385644
1676663591,202044,true,1681819073,28,1698211272,16392199
1676664071,202042,true,1682155454,28,1701100542,18945088
1676664371,202040,true,1682491902,28,1702802408,20310506
1676664395,202038,true,1682828417,28,1702972689,20144272
1676664407,202034,true,1683501649,28,1702972689,19471040
1676664419,202032,true,1683838366,28,1703142986,19304620
1676664455,202029,true,1684343569,28,1703313300,18969731
1676664527,202027,true,1684680454,28,1703824345,19143891
1676664551,202024,true,1685185909,28,1703994728,18808819
1676664587,202022,true,1685522963,28,1704335544,18812581
1676664791,202019,true,1686028670,28,1705870059,19841389
1676664851,202016,true,1686534529,28,1706381872,19847343
1676664911,202013,true,1687040540,28,1706893837,19853297
1676665943,202011,true,1687377965,28,1713906117,26528152
1676666003,202008,true,1687884229,28,1714248915,26364686
1676666315,202006,true,1688221823,28,1715792357,27570534
1676666375,202002,true,1688897213,28,1715963936,27066723
1676666387,202001,true,1689066103,28,1715963936,26897833
1676666411,201999,true,1689403933,28,1715963936,26560003
1676666591,201997,true,1689741831,28,1715792357,26050526
1676666615,201993,true,1690417829,28,1715792357,25374528
1676666687,201992,true,1690586871,28,1715620794,25033923
1676668691,201990,true,1690925005,28,1710824015,19899010
1676668763,201988,true,1691263207,28,1710824015,19560808
1676668787,201985,true,1691770636,28,1710824015,19053379
1676670575,201984,true,1691939813,28,1708089022,16149209
1676670815,201982,true,1692278218,28,1707918230,15640012
1676670827,201981,true,1692447446,28,1707918230,15470784
1676670851,201978,true,1692955231,28,1707747455,14792224
1676671031,201978,true,1692955231,28,1707235233,14280002
1676671127,201976,true,1693293839,28,1707064527,13770688
1676671163,201975,true,1693463169,28,1706893837,13430668
1676671175,201973,true,1693801878,28,1706893837,13091959
1676671199,201973,true,1693801878,28,1706723165,12921287
1676671247,201972,true,1693971258,28,1706552510,12581252
1676671283,201971,true,1694140655,28,1706381872,12241217
1676671307,201968,true,1694648948,28,1706211250,11562302
1676671343,201969,true,1694479501,28,1705870059,11390558
1676671355,201968,true,1694648948,28,1705870059,11221111
1676671391,201967,true,1694818413,28,1705528937,10710524
1676671415,201964,true,1695326910,28,1705358401,10031491
1676671427,201965,true,1695157394,28,1705187882,10030488
1676671511,201964,true,1695326910,28,1704335544,9008634
1676671523,201964,true,1695326910,28,1704165127,8838217
1676671535,201961,true,1695835559,28,1703994728,8159169
1676671691,201961,true,1695835559,28,1702121458,6285899
1676671715,201961,true,1695835559,28,1701610923,5775364
1676671751,201960,true,1696005142,28,1701100542,5095400
1676671967,201959,true,1696174743,28,1697532158,1357415
1676672267,201959,true,1696174743,28,1692278218,-3896525
1676672279,201959,true,1696174743,28,1692109007,-4065736
1676672327,201959,true,1696174743,28,1691263207,-4911536
1676672375,201957,true,1696513995,28,1690586871,-5927124
1676672435,201957,true,1696513995,28,1689741831,-6772164
1676672615,201957,true,1696513995,28,1687040540,-9473455
1676672747,201957,true,1696513995,28,1685522963,-10991032
1676673011,201955,true,1696853314,28,1682491902,-14361412
1676673035,201955,true,1696853314,28,1682155454,-14697860
1676673071,201955,true,1696853314,28,1681987255,-14866059
1676673107,201955,true,1696853314,28,1681819073,-15034241
1676673131,201953,true,1697192702,28,1681650908,-15541794
1676673383,201952,true,1697362421,28,1681650908,-15711513
1676673563,201952,true,1697362421,28,1682323669,-15038752
1676673575,201952,true,1697362421,28,1682323669,-15038752
1676673599,201950,true,1697701911,28,1682491902,-15210009
1676673611,201950,true,1697701911,28,1682660151,-15041760
1676674727,201949,true,1697871681,28,1691432333,-6439348
1676674739,201950,true,1697701911,28,1691601476,-6100435
1676674787,201949,true,1697871681,28,1691939813,-5931868
1676674907,201949,true,1697871681,28,1692955231,-4916450
1676674991,201948,true,1698041468,28,1693293839,-4747629
1676675315,201949,true,1697871681,28,1694987895,-2883786
1676675639,201949,true,1697871681,28,1695835559,-2036122
1676675795,201949,true,1697871681,28,1696344360,-1527321
1676675867,201948,true,1698041468,28,1696513995,-1527473
1676676083,201949,true,1697871681,28,1697023000,-848681
1676676611,201949,true,1697871681,28,1698211272,339591
1676677595,201949,true,1697871681,28,1698211272,339591
1676677715,201948,true,1698041468,28,1698211272,169804
1676678207,201949,true,1697871681,28,1698211272,339591
1676680043,201950,true,1697701911,28,1695326910,-2375001
1676680055,201950,true,1697701911,28,1695496442,-2205469
1676684687,201949,true,1697871681,28,1697871681,0
1676685527,201949,true,1697871681,28,1697871681,0
1676685563,201949,true,1697871681,28,1698041468,169787
1676685599,201950,true,1697701911,28,1698041468,339557
1676685887,201948,true,1698041468,28,1698041468,0
1676686079,201948,true,1698041468,28,1698211272,169804
1676687519,201948,true,1698041468,28,1698720787,679319
1676687819,201948,true,1698041468,28,1698890659,849191
1676688659,201947,true,1698211272,28,1698890659,679387
1676689283,201947,true,1698211272,28,1698890659,679387
1676689883,201947,true,1698211272,28,1698890659,679387
1676690855,201948,true,1698041468,28,1698890659,849191
1676691275,201946,true,1698381093,28,1698890659,509566
1676691347,201946,true,1698381093,28,1698890659,509566
1676692739,201946,true,1698381093,28,1698890659,509566
1676692859,201946,true,1698381093,28,1698890659,509566
1676693243,201945,true,1698550932,28,1698890659,339727
1676693255,201945,true,1698550932,28,1699060548,509616
1676693483,201945,true,1698550932,28,1699060548,509616
1676693723,201945,true,1698550932,28,1699060548,509616
1676694323,201944,true,1698720787,28,1699230454,509667
1676694755,201944,true,1698720787,28,1699230454,509667
1676696027,201945,true,1698550932,28,1699230454,679522
1676699399,201945,true,1698550932,28,1699230454,679522
1676702495,201944,true,1698720787,28,1699060548,339761
1676703335,201945,true,1698550932,28,1699060548,509616
1676703683,201945,true,1698550932,28,1699230454,679522
1676706347,201946,true,1698381093,28,1697362421,-1018672
1676706839,201945,true,1698550932,28,1697192702,-1358230
1676706863,201946,true,1698381093,28,1697192702,-1188391
1676707127,201946,true,1698381093,28,1696683646,-1697447
1676707211,201947,true,1698211272,28,1696513995,-1697277
1676711387,201948,true,1698041468,28,1692616691,-5424777
1676712227,201948,true,1698041468,28,1692616691,-5424777
1676713607,201949,true,1697871681,28,1692616691,-5254990
1676714663,201950,true,1697701911,28,1692785953,-4915958
1676714735,201951,true,1697532158,28,1692785953,-4746205
1676716175,201952,true,1697362421,28,1692785953,-4576468
1676716403,201953,true,1697192702,28,1692785953,-4406749
1676717855,201954,true,1697023000,28,1692785953,-4237047
1676718035,201955,true,1696853314,28,1692785953,-4067361
1676720327,201956,true,1696683646,28,1691939813,-4743833
1676722679,201957,true,1696513995,28,1691939813,-4574182
1676723687,201959,true,1696174743,28,1691939813,-4234930
1676724491,201960,true,1696005142,28,1692109007,-3896135
1676724503,201961,true,1695835559,28,1692109007,-3726552
1676724683,201962,true,1695665992,28,1692278218,-3387774
1676725043,201964,true,1695326910,28,1692785953,-2540957
1676725199,201965,true,1695157394,28,1693124527,-2032867
1676726447,201965,true,1695157394,28,1695835559,678165
1676726675,201966,true,1694987895,28,1696174743,1186848
1676732051,201967,true,1694818413,28,1696174743,1356330
1676739167,201968,true,1694648948,28,1696174743,1525795
1676739851,201968,true,1694648948,28,1696174743,1525795
1676740835,201969,true,1694479501,28,1696174743,1695242
1676742443,201970,true,1694310070,28,1696174743,1864673
1676742611,201970,true,1694310070,28,1696005142,1695072
1676742635,201971,true,1694140655,28,1696005142,1864487
1676742935,201971,true,1694140655,28,1696005142,1864487
1676743931,201972,true,1693971258,28,1696005142,2033884
1676743979,201972,true,1693971258,28,1696005142,2033884
1676743991,201972,true,1693971258,28,1696005142,2033884
1676744003,201973,true,1693801878,28,1696174743,2372865
1676744471,201971,true,1694140655,28,1698720787,4580132
1676744519,201971,true,1694140655,28,1698890659,4750004
1676745215,201971,true,1694140655,28,1702121458,7980803
1676745251,201971,true,1694140655,28,1702291670,8151015
1676745347,201970,true,1694310070,28,1702802408,8492338
1676745359,201969,true,1694479501,28,1702802408,8322907
1676745371,201969,true,1694479501,28,1702802408,8322907
1676745383,201970,true,1694310070,28,1702802408,8492338
1676745395,201968,true,1694648948,28,1702802408,8153460
1676745443,201967,true,1694818413,28,1702802408,7983995
1676745467,201967,true,1694818413,28,1702802408,7983995
1676745479,201968,true,1694648948,28,1702802408,8153460
1676746523,201967,true,1694818413,28,1697701911,2883498
1676749403,201965,true,1695157394,28,1693632515,-1524879
1676749463,201965,true,1695157394,28,1693801878,-1355516
1676749475,201965,true,1695157394,28,1693632515,-1524879
1676749931,201963,true,1695496442,28,1692785953,-2710489
1676750831,201963,true,1695496442,28,1690925005,-4571437
1676752547,201963,true,1695496442,28,1686703183,-8793259
1676752619,201963,true,1695496442,28,1686703183,-8793259
1676753531,201962,true,1695665992,28,1686534529,-9131463
1676754587,201961,true,1695835559,28,1686365893,-9469666
1676756891,201962,true,1695665992,28,1686365893,-9300099
1676757551,201962,true,1695665992,28,1686365893,-9300099
1676757947,201961,true,1695835559,28,1686365893,-9469666
1676759363,201961,true,1695835559,28,1686365893,-9469666
1676761823,201961,true,1695835559,28,1686703183,-9132376
1676762267,201961,true,1695835559,28,1686871853,-8963706
1676763407,201961,true,1695835559,28,1687377965,-8457594
1676764487,201961,true,1695835559,28,1687377965,-8457594
1676764523,201961,true,1695835559,28,1687377965,-8457594
1676765591,201962,true,1695665992,28,1688390645,-7275347
1676766203,201962,true,1695665992,28,1688897213,-6768779
1676766251,201962,true,1695665992,28,1689066103,-6599889
1676766335,201962,true,1695665992,28,1689066103,-6599889
1676766383,201963,true,1695496442,28,1689066103,-6430339
1676766395,201962,true,1695665992,28,1689066103,-6599889
1676766503,201963,true,1695496442,28,1689235009,-6261433
1676766515,201964,true,1695326910,28,1689235009,-6091901
1676766551,201964,true,1695326910,28,1689403933,-5922977
1676767031,201964,true,1695326910,28,1690417829,-4909081
1676767067,201965,true,1695157394,28,1690586871,-4570523
1676767163,201965,true,1695157394,28,1690755929,-4401465
1676767235,201965,true,1695157394,28,1690925005,-4232389
1676767259,201965,true,1695157394,28,1691094097,-4063297
1676767475,201965,true,1695157394,28,1691601476,-3555918
1676767511,201966,true,1694987895,28,1691770636,-3217259
1676767583,201966,true,1694987895,28,1691939813,-3048082
1676767595,201965,true,1695157394,28,1691939813,-3217581
1676767607,201966,true,1694987895,28,1691939813,-3048082
1676768003,201966,true,1694987895,28,1693293839,-1694056
1676768411,201966,true,1694987895,28,1694140655,-847240
1676768471,201966,true,1694987895,28,1694310070,-677825
1676768507,201967,true,1694818413,28,1694310070,-508343
1676769635,201967,true,1694818413,28,1695326910,508497
1676772131,201967,true,1694818413,28,1695496442,678029
1676772779,201966,true,1694987895,28,1695665992,678097
1676774123,201967,true,1694818413,28,1695835559,1017146
1676775491,201968,true,1694648948,28,1695835559,1186611
1676777387,201968,true,1694648948,28,1695835559,1186611
1676777735,201967,true,1694818413,28,1695835559,1017146
1676778455,201968,true,1694648948,28,1695835559,1186611
1676782235,201968,true,1694648948,28,1695665992,1017044
1676783603,201968,true,1694648948,28,1695835559,1186611
1676783891,201968,true,1694648948,28,1696005142,1356194
1676784071,201969,true,1694479501,28,1696005142,1525641
1676784083,201969,true,1694479501,28,1696005142,1525641
1676784095,201969,true,1694479501,28,1696005142,1525641
1676784203,201968,true,1694648948,28,1696174743,1525795
1676784323,201969,true,1694479501,28,1696513995,2034494
1676784551,201969,true,1694479501,28,1697532158,3052657
1676784599,201968,true,1694648948,28,1697701911,3052963
1676785367,201967,true,1694818413,28,1701610923,6792510
1676785655,201967,true,1694818413,28,1702972689,8154276
1676785715,201967,true,1694818413,28,1703142986,8324573
1676785775,201967,true,1694818413,28,1703483632,8665219
1676785787,201966,true,1694987895,28,1703483632,8495737
1676788943,201966,true,1694987895,28,1702121458,7133563
1676789183,201966,true,1694987895,28,1702121458,7133563
1676789207,201966,true,1694987895,28,1702121458,7133563
1676789387,201964,true,1695326910,28,1701951263,6624353
1676789687,201965,true,1695157394,28,1701610923,6453529
1676791379,201965,true,1695157394,28,1699740274,4582880
1676791415,201965,true,1695157394,28,1699740274,4582880
1676791463,201963,true,1695496442,28,1699570317,4073875
1676791511,201963,true,1695496442,28,1699570317,4073875
1676791523,201964,true,1695326910,28,1699570317,4243407
1676791547,201963,true,1695496442,28,1699570317,4073875
1676791595,201962,true,1695665992,28,1699570317,3904325
1676792135,201962,true,1695665992,28,1699060548,3394556
1676792735,201962,true,1695665992,28,1698550932,2884940
1676792879,201962,true,1695665992,28,1698381093,2715101
1676796743,201961,true,1695835559,28,1697192702,1357143
1676797043,201961,true,1695835559,28,1697192702,1357143
1676797451,201961,true,1695835559,28,1697192702,1357143
1676798255,201961,true,1695835559,28,1696683646,848087
1676799167,201960,true,1696005142,28,1696005142,0
1676799467,201961,true,1695835559,28,1695835559,0
1676799911,201961,true,1695835559,28,1696005142,169583
1676800331,201961,true,1695835559,28,1696005142,169583
1676803235,201960,true,1696005142,28,1695835559,-169583
1676806235,201961,true,1695835559,28,1695835559,0
1676806343,201961,true,1695835559,28,1696005142,169583
1676807147,201961,true,1695835559,28,1696005142,169583
1676808623,201960,true,1696005142,28,1696005142,0
1676809583,201961,true,1695835559,28,1696005142,169583
1676809931,201961,true,1695835559,28,1696005142,169583
1676810219,201961,true,1695835559,28,1696005142,169583
1676810855,201960,true,1696005142,28,1696005142,0
1676811767,201961,true,1695835559,28,1695835559,0
1676813783,201961,true,1695835559,28,1695835559,0
1676816459,201961,true,1695835559,28,1695835559,0
1676816495,201962,true,1695665992,28,1696005142,339150
1676816519,201963,true,1695496442,28,1696005142,508700
1676816579,201963,true,1695496442,28,1696005142,508700
1676817023,201963,true,1695496442,28,1696513995,1017553
1676817047,201963,true,1695496442,28,1696513995,1017553
1676817119,201964,true,1695326910,28,1696683646,1356736
1676818031,201964,true,1695326910,28,1698550932,3224022
1676818667,201963,true,1695496442,28,1700080239,4583797
1676819075,201963,true,1695496442,28,1700930449,5434007
1676819171,201964,true,1695326910,28,1701100542,5773632
1676819183,201963,true,1695496442,28,1701100542,5604100
1676819195,201962,true,1695665992,28,1701100542,5434550
1676819231,201961,true,1695835559,28,1701270652,5435093
1676819843,201961,true,1695835559,28,1703994728,8159169
1676819867,201960,true,1696005142,28,1704165127,8159985
1676819915,201959,true,1696174743,28,1704335544,8160801
1676819927,201958,true,1696344360,28,1704335544,7991184
1676820035,201956,true,1696683646,28,1705017380,8333734
1676820095,201955,true,1696853314,28,1705528937,8675623
1676820107,201954,true,1697023000,28,1705699489,8676489
1676820287,201952,true,1697362421,28,1707235233,9872812
1676820299,201950,true,1697701911,28,1707235233,9533322
1676820335,201949,true,1697871681,28,1707576697,9705016
1676820347,201947,true,1698211272,28,1707576697,9365425
1676820599,201948,true,1698041468,28,1708089022,10047554
1676820767,201946,true,1698381093,28,1708259830,9878737
1676820791,201945,true,1698550932,28,1708259830,9708898
1676820899,201943,true,1698890659,28,1708601500,9710841
1676821007,201944,true,1698720787,28,1708601500,9880713
1676821151,201942,true,1699060548,28,1708601500,9540952
1676821187,201941,true,1699230454,28,1708601500,9371046
1676821979,201939,true,1699570317,28,1707918230,8347913
1676822495,201939,true,1699570317,28,1708259830,8689513
1676822711,201937,true,1699910248,28,1708943237,9032989
1676822963,201937,true,1699910248,28,1709455971,9545723
1676823227,201935,true,1700250247,28,1709626917,9376670
1676823251,201935,true,1700250247,28,1709626917,9376670
1676823287,201933,true,1700590314,28,1709797879,9207565
1676823311,201932,true,1700760373,28,1709968859,9208486
1676823335,201930,true,1701100542,28,1710139856,9039314
1676823359,201930,true,1701100542,28,1710139856,9039314
1676824427,201928,true,1701440779,28,1715963936,14523157
1676824451,201927,true,1701610923,28,1716135532,14524609
1676824475,201924,true,1702121458,28,1716135532,14014074
1676824499,201925,true,1701951263,28,1716307146,14355883
1676824559,201923,true,1702291670,28,1716478776,14187106
1676824571,201922,true,1702461899,28,1716478776,14016877
1676824583,201920,true,1702802408,28,1716478776,13676368
1676824595,201920,true,1702802408,28,1716478776,13676368
1676824691,201920,true,1702802408,28,1716478776,13676368
1676824715,201919,true,1702972689,28,1716478776,13506087
1676824955,201917,true,1703313300,28,1716307146,12993846
1676825411,201917,true,1703313300,28,1714248915,10935615
1676825423,201917,true,1703313300,28,1714248915,10935615
1676825435,201916,true,1703483632,28,1714248915,10765283
1676825471,201914,true,1703824345,28,1713906117,10081772
1676825483,201915,true,1703653980,28,1713906117,10252137
1676825495,201914,true,1703824345,28,1713734743,9910398
1676825531,201914,true,1703824345,28,1713392048,9567703
1676825543,201913,true,1703994728,28,1713220726,9225998
1676825555,201914,true,1703824345,28,1713049421,9225076
1676825591,201914,true,1703824345,28,1712706862,8882517
1676825927,201914,true,1703824345,28,1708430656,4606311
1676826131,201913,true,1703994728,28,1705870059,1875331
1676826143,201914,true,1703824345,28,1705699489,1875144
1676826167,201914,true,1703824345,28,1705358401,1534056
1676826455,201914,true,1703824345,28,1702632145,-1192200
1676826467,201912,true,1704165127,28,1702461899,-1703228
1676826515,201914,true,1703824345,28,1702121458,-1702887
1676826539,201914,true,1703824345,28,1701951263,-1873082
1676826551,201915,true,1703653980,28,1701781084,-1872896
1676826587,201914,true,1703824345,28,1701440779,-2383566
1676826947,201917,true,1703313300,28,1697871681,-5441619
1676827355,201917,true,1703313300,28,1693971258,-9342042
1676827715,201918,true,1703142986,28,1692955231,-10187755
1676828771,201917,true,1703313300,28,1690755929,-12557371
1676828855,201920,true,1702802408,28,1690755929,-12046479
1676829119,201920,true,1702802408,28,1690755929,-12046479
1676829131,201921,true,1702632145,28,1690755929,-11876216
1676829455,201920,true,1702802408,28,1690417829,-12384579
1676829467,201922,true,1702461899,28,1690417829,-12044070
1676829491,201922,true,1702461899,28,1690417829,-12044070
1676829503,201923,true,1702291670,28,1690248804,-12042866
1676830019,201923,true,1702291670,28,1687884229,-14407441
1676830595,201926,true,1701781084,28,1684680454,-17100630
1676830619,201926,true,1701781084,28,1684680454,-17100630
1676830799,201927,true,1701610923,28,1683838366,-17772557
1676833187,201927,true,1701610923,28,1682828417,-18782506
1676833775,201929,true,1701270652,28,1682996700,-18273952
1676833787,201929,true,1701270652,28,1682996700,-18273952
1676833991,201930,true,1701100542,28,1683164999,-17935543
1676834003,201930,true,1701100542,28,1683164999,-17935543
1676834183,201932,true,1700760373,28,1683164999,-17595374
1676834915,201932,true,1700760373,28,1683838366,-16922007
1676834987,201933,true,1700590314,28,1683838366,-16751948
1676835215,201933,true,1700590314,28,1684175151,-16415163
1676835275,201935,true,1700250247,28,1684175151,-16075096
1676836979,201934,true,1700420272,28,1685185909,-15234363
1676836991,201935,true,1700250247,28,1685185909,-15064338
1676837003,201935,true,1700250247,28,1685185909,-15064338
1676837075,201937,true,1699910248,28,1685185909,-14724339
1676837219,201937,true,1699910248,28,1685017407,-14892841
1676837843,201939,true,1699570317,28,1682323669,-17246648
1676837879,201938,true,1699740274,28,1682155454,-17584820
1676837891,201941,true,1699230454,28,1682155454,-17075000
1676837951,201941,true,1699230454,28,1681819073,-17411381
1676837987,201943,true,1698890659,28,1681650908,-17239751
1676838491,201943,true,1698890659,28,1678291135,-20599524
1676838599,201945,true,1698550932,28,1677619987,-20930945
1676839139,201946,true,1698381093,28,1674938075,-23443018
1676839199,201948,true,1698041468,28,1674770598,-23270870
1676839511,201948,true,1698041468,28,1674100857,-23940611
1676839571,201950,true,1697701911,28,1674100857,-23601054
1676839583,201950,true,1697701911,28,1673933464,-23768447
1676839607,201952,true,1697362421,28,1673933464,-23428957
1676839655,201953,true,1697192702,28,1673933464,-23259238
1676839799,201954,true,1697023000,28,1674100857,-22922143
1676840039,201955,true,1696853314,28,1674770598,-22082716
1676840051,201957,true,1696513995,28,1674938075,-21575920
1676840063,201957,true,1696513995,28,1674938075,-21575920
1676840123,201959,true,1696174743,28,1675105569,-21069174
1676840159,201959,true,1696174743,28,1675273079,-20901664
1676840639,201961,true,1695835559,28,1677619987,-18215572
1676843159,201961,true,1695835559,28,1682155454,-13680105
1676843903,201964,true,1695326910,28,1682155454,-13171456
1676844131,201964,true,1695326910,28,1682155454,-13171456
1676844251,201966,true,1694987895,28,1682155454,-12832441
1676844611,201967,true,1694818413,28,1682155454,-12662959
1676844671,201969,true,1694479501,28,1682323669,-12155832
1676844743,201971,true,1694140655,28,1682323669,-11816986
1676844887,201973,true,1693801878,28,1682323669,-11478209
1676845259,201973,true,1693801878,28,1682660151,-11141727
1676845475,201976,true,1693293839,28,1682828417,-10465422
1676845967,201977,true,1693124527,28,1683333316,-9791211
1676846207,201979,true,1692785953,28,1683501649,-9284304
1676848331,201980,true,1692616691,28,1683669999,-8946692
1676850467,201981,true,1692447446,28,1683164999,-9282447
1676851379,201982,true,1692278218,28,1683164999,-9113219
1676851775,201984,true,1691939813,28,1683164999,-8774814
1676852363,201985,true,1691770636,28,1683164999,-8605637
1676852387,201985,true,1691770636,28,1683164999,-8605637
1676854415,201987,true,1691432333,28,1683164999,-8267334
1676854547,201989,true,1691094097,28,1683164999,-7929098
1676854571,201990,true,1690925005,28,1683164999,-7760006
1676854607,201991,true,1690755929,28,1683164999,-7590930
1676855195,201993,true,1690417829,28,1682155454,-8262375
1676855363,201995,true,1690079796,28,1681819073,-8260723
1676855399,201996,true,1689910805,28,1681650908,-8259897
1676855411,201997,true,1689741831,28,1681650908,-8090923
1676855447,202000,true,1689235009,28,1681650908,-7584101
1676855459,202002,true,1688897213,28,1681482760,-7414453
1676855543,202005,true,1688390645,28,1681146514,-7244131
1676855555,202006,true,1688221823,28,1681146514,-7075309
1676855579,202009,true,1687715458,28,1680978416,-6737042
1676855591,202011,true,1687377965,28,1680978416,-6399549
1676855651,202015,true,1686703183,28,1680474223,-6228960
1676855675,202016,true,1686534529,28,1680138179,-6396350
1676855699,202019,true,1686028670,28,1679802202,-6226468
1676855711,202022,true,1685522963,28,1679634238,-5888725
1676855831,202027,true,1684680454,28,1677955527,-6724927
1676856731,202028,true,1684512003,28,1665751660,-18760343
1676856767,202031,true,1684006750,28,1665418560,-18588190
1676856791,202033,true,1683669999,28,1665085526,-18584473
1676856803,202038,true,1682828417,28,1664919034,-17909383
1676856839,202039,true,1682660151,28,1664419659,-18240492
1676856863,202041,true,1682323669,28,1664253233,-18070436
1676857091,202044,true,1681819073,28,1661758849,-20060224
1676857103,202048,true,1681146514,28,1661758849,-19387665
1676857163,202049,true,1680978416,28,1661094312,-19884104
1676857175,202051,true,1680642271,28,1660928219,-19714052
1676857367,202053,true,1680306193,28,1659434131,-20872062
1676857379,202056,true,1679802202,28,1659268204,-20533998
1676857403,202057,true,1679634238,28,1659268204,-20366034
1676857463,202059,true,1679298362,28,1659102294,-20196068
1676857499,202060,true,1679130449,28,1659102294,-20028155
1676857679,202063,true,1678626810,28,1659600074,-19026736
1676857703,202064,true,1678458964,28,1659766034,-18692930
1676857763,202066,true,1678123323,28,1659932011,-18191312
1676857775,202067,true,1677955527,28,1659932011,-18023516
1676857799,202071,true,1677284513,28,1660098004,-17186509
1676857811,202071,true,1677284513,28,1660098004,-17186509
1676857835,202072,true,1677116801,28,1660264014,-16852787
1676857859,202073,true,1676949106,28,1660430040,-16519066
1676858003,202076,true,1676446122,28,1661260421,-15185701
1676859035,202076,true,1676446122,28,1666751361,-9694761
1676859275,202077,true,1676278494,28,1667584904,-8693590
1676859299,202078,true,1676110883,28,1667751662,-8359221
1676859395,202081,true,1675608150,28,1668085229,-7522921
1676859587,202080,true,1675775711,28,1668919439,-6856272
1676859635,202081,true,1675608150,28,1669086331,-6521819
1676860367,202082,true,1675440606,28,1670923244,-4517362
1676861615,202084,true,1675105569,28,1673096748,-2008821
1676861675,202084,true,1675105569,28,1673096748,-2008821
1676861795,202085,true,1674938075,28,1673264058,-1674017
1676861807,202085,true,1674938075,28,1673264058,-1674017
1676862107,202086,true,1674770598,28,1673598727,-1171871
1676862239,202085,true,1674938075,28,1673766087,-1171988
1676862323,202086,true,1674770598,28,1673933464,-837134
1676862551,202086,true,1674770598,28,1674268267,-502331
1676863727,202087,true,1674603137,28,1675943289,1340152
1676863811,202087,true,1674603137,28,1675943289,1340152
1676863823,202087,true,1674603137,28,1675943289,1340152
1676863895,202088,true,1674435694,28,1676110883,1675189
1676864015,202089,true,1674268267,28,1676446122,2177855
1676864831,202088,true,1674435694,28,1678123323,3687629
1676865095,202088,true,1674435694,28,1678626810,4191116
1676865215,202089,true,1674268267,28,1678962552,4694285
1676865227,202090,true,1674100857,28,1678962552,4861695
1676865263,202089,true,1674268267,28,1679130449,4862182
1676866475,202089,true,1674268267,28,1681482760,7214493
1676866523,202089,true,1674268267,28,1681650908,7382641
1676866535,202090,true,1674100857,28,1681650908,7550051
1676866571,202089,true,1674268267,28,1681819073,7550806
1676866583,202089,true,1674268267,28,1681819073,7550806
1676866931,202087,true,1674603137,28,1683669999,9066862
1676871671,202088,true,1674435694,28,1689066103,14630409
1676873303,202087,true,1674603137,28,1689066103,14462966
1676873855,202086,true,1674770598,28,1689235009,14464411
1676875919,202084,true,1675105569,28,1689403933,14298364
1676876135,202085,true,1674938075,28,1689403933,14465858
1676876147,202084,true,1675105569,28,1689572873,14467304
1676876279,202083,true,1675273079,28,1689572873,14299794
1676876459,202081,true,1675608150,28,1689741831,14133681
1676877191,202081,true,1675608150,28,1690417829,14809679
1676878907,202080,true,1675775711,28,1692447446,16671735
1676879363,202079,true,1675943289,28,1692785953,16842664
1676879807,202077,true,1676278494,28,1692955231,16676737
1676880371,202077,true,1676278494,28,1693293839,17015345
1676881043,202076,true,1676446122,28,1693632515,17186393
1676883419,202076,true,1676446122,28,1694140655,17694533
1676885927,202074,true,1676781428,28,1694140655,17359227
1676886107,202074,true,1676781428,28,1694310070,17528642
1676886131,202073,true,1676949106,28,1694310070,17360964
1676886143,202073,true,1676949106,28,1694310070,17360964
1676886155,202071,true,1677284513,28,1694310070,17025557
1676886215,202070,true,1677452241,28,1694648948,17196707
1676886239,202069,true,1677619987,28,1694818413,17198426
1676886323,202068,true,1677787749,28,1695326910,17539161
1676886335,202066,true,1678123323,28,1695496442,17373119
1676886491,202065,true,1678291135,28,1696853314,18562179
1676886503,202063,true,1678626810,28,1696853314,18226504
1676886575,202062,true,1678794673,28,1697532158,18737485
1676886719,202060,true,1679130449,28,1698890659,19760210
1676886791,202059,true,1679298362,28,1699570317,20271955
1676886935,202057,true,1679634238,28,1701100542,21466304
1676886983,202056,true,1679802202,28,1701440779,21638577
1676888027,202054,true,1680138179,28,1711508447,31370268
1676890319,202053,true,1680306193,28,1712364372,32058179
1676891759,202051,true,1680642271,28,1712364372,31722101
1676893103,202050,true,1680810335,28,1712364372,31554037
1676893703,202048,true,1681146514,28,1712364372,31217858
1676893871,202046,true,1681482760,28,1712535609,31052849
1676893931,202045,true,1681650908,28,1712535609,30884701
1676893955,202044,true,1681819073,28,1712535609,30716536
1676894027,202042,true,1682155454,28,1712535609,30380155
1676894075,202040,true,1682491902,28,1712535609,30043707
1676894183,202039,true,1682660151,28,1712535609,29875458
1676894867,202037,true,1682996700,28,1713220726,30224026
1676894963,202035,true,1683333316,28,1713392048,30058732
1676895131,202033,true,1683669999,28,1713563387,29893388
1676895263,202032,true,1683838366,28,1713563387,29725021
1676895335,202030,true,1684175151,28,1713734743,29559592
1676896019,202027,true,1684680454,28,1714077507,29397053
1676896379,202025,true,1685017407,28,1713906117,28888710
1676896451,202024,true,1685185909,28,1713906117,28720208
1676896607,202022,true,1685522963,28,1713906117,28383154
1676896943,202019,true,1686028670,28,1713734743,27706073
1676897315,202016,true,1686534529,28,1713220726,26686197
1676897327,202014,true,1686871853,28,1713220726,26348873
1676897375,202012,true,1687209244,28,1713220726,26011482
1676897507,202009,true,1687715458,28,1712706862,24991404
1676897519,202006,true,1688221823,28,1712706862,24485039
1676897747,202004,true,1688559484,28,1711850766,23291282
1676898323,202001,true,1689066103,28,1709968859,20902756
1676898611,201998,true,1689572873,28,1708943237,19370364
1676899007,201995,true,1690079796,28,1709285043,19205247
1676899019,201993,true,1690417829,28,1709285043,18867214
1676899715,201990,true,1690925005,28,1710652949,19727944
1676899835,201987,true,1691432333,28,1710995097,19562764
1676900435,201984,true,1691939813,28,1712364372,20424559
1676900447,201982,true,1692278218,28,1712364372,20086154
1676900459,201979,true,1692785953,28,1712364372,19578419
1676900663,201977,true,1693124527,28,1712021951,18897424
1676900891,201973,true,1693801878,28,1711679598,17877720
1676900987,201972,true,1693971258,28,1711508447,17537189
1676901119,201969,true,1694479501,28,1711337313,16857812
1676902691,201967,true,1694818413,28,1706552510,11734097
1676903507,201964,true,1695326910,28,1705870059,10543149
1676904095,201963,true,1695496442,28,1706040646,10544204
1676904143,201960,true,1696005142,28,1706040646,10035504
1676904155,201958,true,1696344360,28,1706040646,9696286
1676904179,201955,true,1696853314,28,1706211250,9357936
1676904275,201953,true,1697192702,28,1706381872,9189170
1676904335,201950,true,1697701911,28,1706552510,8850599
1676904347,201949,true,1697871681,28,1706552510,8680829
1676904611,201947,true,1698211272,28,1706723165,8511893
1676905031,201945,true,1698550932,28,1706893837,8342905
1676905271,201942,true,1699060548,28,1707235233,8174685
1676905331,201941,true,1699230454,28,1707235233,8004779
1676909075,201938,true,1699740274,28,1709797879,10057605
1676909207,201936,true,1700080239,28,1709797879,9717640
1676909231,201934,true,1700420272,28,1709797879,9377607
1676909243,201933,true,1700590314,28,1709797879,9207565
1676909255,201930,true,1701100542,28,1709797879,8697337
1676909387,201929,true,1701270652,28,1709455971,8185319
1676909423,201927,true,1701610923,28,1709285043,7674120
1676909459,201926,true,1701781084,28,1709114131,7333047
1676909999,201924,true,1702121458,28,1707405957,5284499
1676910023,201923,true,1702291670,28,1707235233,4943563
1676910047,201921,true,1702632145,28,1707064527,4432382
1676910203,201921,true,1702632145,28,1706211250,3579105
1676910215,201919,true,1702972689,28,1706040646,3067957
1676910227,201918,true,1703142986,28,1706040646,2897660
1676911127,201917,true,1703313300,28,1699400377,-3912923
1676911151,201916,true,1703483632,28,1699230454,-4253178
1676911163,201916,true,1703483632,28,1699060548,-4423084
1676911763,201915,true,1703653980,28,1696005142,-7648838
1676911835,201914,true,1703824345,28,1695665992,-8158353
1676911847,201913,true,1703994728,28,1695496442,-8498286
1676911943,201913,true,1703994728,28,1695496442,-8498286
1676911967,201912,true,1704165127,28,1695326910,-8838217
1676911979,201911,true,1704335544,28,1695326910,-9008634
1676912003,201910,true,1704505977,28,1695326910,-9179067
1676915303,201909,true,1704676428,28,1699910248,-4766180
1676916803,201908,true,1704846896,28,1699910248,-4936648
1676916851,201908,true,1704846896,28,1699910248,-4936648
1676916911,201908,true,1704846896,28,1699910248,-4936648
1676917355,201907,true,1705017380,28,1699400377,-5617003
1676917571,201906,true,1705187882,28,1699230454,-5957428
1676918063,201906,true,1705187882,28,1698550932,-6636950
1676919275,201906,true,1705187882,28,1697362421,-7825461
1676920271,201905,true,1705358401,28,1697023000,-8335401
1676920379,201904,true,1705528937,28,1697192702,-8336235
1676920703,201904,true,1705528937,28,1697362421,-8166516
1676920787,201905,true,1705358401,28,1697362421,-7995980
1676922035,201903,true,1705699489,28,1698041468,-7658021
1676922323,201903,true,1705699489,28,1698211272,-7488217
1676922347,201903,true,1705699489,28,1698211272,-7488217
1676922467,201904,true,1705528937,28,1698211272,-7317665
1676922791,201902,true,1705870059,28,1698550932,-7319127
1676922863,201902,true,1705870059,28,1698720787,-7149272
1676922959,201902,true,1705870059,28,1698890659,-6979400
1676922995,201902,true,1705870059,28,1698890659,-6979400
1676923055,201901,true,1706040646,28,1699060548,-6980098
1676923151,201900,true,1706211250,28,1699230454,-6980796
1676923163,201900,true,1706211250,28,1699400377,-6810873
1676923187,201901,true,1706040646,28,1699400377,-6640269
1676923199,201900,true,1706211250,28,1699400377,-6810873
1676923259,201900,true,1706211250,28,1699740274,-6470976
1676926475,201900,true,1706211250,28,1706211250,0
1676926559,201900,true,1706211250,28,1706211250,0
1676931383,201901,true,1706040646,28,1704505977,-1534669
1676931647,201900,true,1706211250,28,1704505977,-1705273
1676931695,201901,true,1706040646,28,1704505977,-1534669
1676932175,201902,true,1705870059,28,1704165127,-1704932
1676933027,201902,true,1705870059,28,1703142986,-2727073
1676933315,201902,true,1705870059,28,1702632145,-3237914
1676933759,201903,true,1705699489,28,1701951263,-3748226
1676933771,201904,true,1705528937,28,1701951263,-3577674
1676933987,201905,true,1705358401,28,1701440779,-3917622
1676934023,201905,true,1705358401,28,1701440779,-3917622
1676936699,201906,true,1705187882,28,1698041468,-7146414
1676936795,201907,true,1705017380,28,1698211272,-6806108
1676937575,201908,true,1704846896,28,1698381093,-6465803
1676937647,201908,true,1704846896,28,1698381093,-6465803
1676937683,201908,true,1704846896,28,1698381093,-6465803
1676939759,201910,true,1704505977,28,1700080239,-4425738
1676939807,201911,true,1704335544,28,1700250247,-4085297
1676939903,201911,true,1704335544,28,1700250247,-4085297
1676939927,201911,true,1704335544,28,1700250247,-4085297
1676939987,201912,true,1704165127,28,1700420272,-3744855
1676940047,201913,true,1703994728,28,1700420272,-3574456
1676940239,201913,true,1703994728,28,1700930449,-3064279
1676940383,201914,true,1703824345,28,1701270652,-2553693
1676941307,201914,true,1703824345,28,1703824345,0
1676942507,201915,true,1703653980,28,1705187882,1533902
1676942711,201915,true,1703653980,28,1705187882,1533902
1676944007,201915,true,1703653980,28,1705187882,1533902
1676944895,201916,true,1703483632,28,1705187882,1704250
1676946743,201917,true,1703313300,28,1705187882,1874582
1676946755,201916,true,1703483632,28,1705187882,1704250
1676946779,201917,true,1703313300,28,1705358401,2045101
1676946791,201917,true,1703313300,28,1705358401,2045101
1676946827,201917,true,1703313300,28,1705358401,2045101
1676946839,201916,true,1703483632,28,1705358401,1874769
1676946851,201917,true,1703313300,28,1705358401,2045101
1676947031,201917,true,1703313300,28,1705870059,2556759
1676947079,201917,true,1703313300,28,1706040646,2727346
1676947103,201916,true,1703483632,28,1706040646,2557014
1676947127,201917,true,1703313300,28,1706211250,2897950
1676948435,201917,true,1703313300,28,1710652949,7339649
1676948447,201917,true,1703313300,28,1710652949,7339649
1676948459,201916,true,1703483632,28,1710652949,7169317
1676948483,201917,true,1703313300,28,1710824015,7510715
1676948519,201917,true,1703313300,28,1710824015,7510715
1676948531,201917,true,1703313300,28,1710824015,7510715
1676948567,201917,true,1703313300,28,1710824015,7510715
1676948591,201918,true,1703142986,28,1710824015,7681029
1676949059,201918,true,1703142986,28,1709455971,6312985
1676949203,201918,true,1703142986,28,1708943237,5800251
1676951291,201917,true,1703313300,28,1707405957,4092657
1676951699,201918,true,1703142986,28,1707576697,4433711
1676951951,201918,true,1703142986,28,1707576697,4433711
1676952023,201918,true,1703142986,28,1707576697,4433711
1676952047,201917,true,1703313300,28,1707576697,4263397
1676952155,201918,true,1703142986,28,1707576697,4433711
1676952455,201918,true,1703142986,28,1707235233,4092247
1676952515,201918,true,1703142986,28,1707235233,4092247
1676952539,201918,true,1703142986,28,1707235233,4092247
1676952839,201918,true,1703142986,28,1706723165,3580179
1676953007,201919,true,1702972689,28,1706381872,3409183
1676953031,201919,true,1702972689,28,1706381872,3409183
1676953139,201919,true,1702972689,28,1706040646,3067957
1676953607,201920,true,1702802408,28,1704505977,1703569
1676954279,201920,true,1702802408,28,1702802408,0
1676954327,201920,true,1702802408,28,1702632145,-170263
1676954711,201920,true,1702802408,28,1702121458,-680950
1676954879,201921,true,1702632145,28,1701781084,-851061
1676954903,201921,true,1702632145,28,1701781084,-851061
1676955023,201921,true,1702632145,28,1701781084,-851061
1676956019,201920,true,1702802408,28,1701100542,-1701866
1676956427,201921,true,1702632145,28,1700930449,-1701696
1676956439,201922,true,1702461899,28,1700930449,-1531450
1676956523,201921,true,1702632145,28,1700760373,-1871772
1676958299,201920,true,1702802408,28,1699910248,-2892160
1676962451,201921,true,1702632145,28,1699910248,-2721897
1676962547,201921,true,1702632145,28,1700080239,-2551906
1676962559,201920,true,1702802408,28,1700080239,-2722169
1676962607,201919,true,1702972689,28,1700250247,-2722442
1676962655,201919,true,1702972689,28,1700250247,-2722442
1676964695,201919,true,1702972689,28,1703824345,851656
1676964887,201918,true,1703142986,28,1703824345,681359
1676966147,201917,true,1703313300,28,1703824345,511045
1676966687,201917,true,1703313300,28,1703653980,340680
1676967107,201917,true,1703313300,28,1703653980,340680
1676967923,201917,true,1703313300,28,1703653980,340680
1676967947,201917,true,1703313300,28,1703824345,511045
1676968007,201917,true,1703313300,28,1703824345,511045
1676968151,201916,true,1703483632,28,1703994728,511096
1676968211,201916,true,1703483632,28,1704165127,681495
1676968235,201915,true,1703653980,28,1704165127,511147
1676968571,201915,true,1703653980,28,1704505977,851997
1676968583,201915,true,1703653980,28,1704676428,1022448
1676968691,201914,true,1703824345,28,1704676428,852083
1676968703,201913,true,1703994728,28,1704676428,681700
1676968715,201913,true,1703994728,28,1704676428,681700
1676968727,201913,true,1703994728,28,1704676428,681700
1676968763,201913,true,1703994728,28,1704676428,681700
1676968775,201912,true,1704165127,28,1704505977,340850
1676968799,201913,true,1703994728,28,1704505977,511249
1676968895,201913,true,1703994728,28,1704165127,170399
1676968919,201914,true,1703824345,28,1703994728,170383
1676968955,201913,true,1703994728,28,1703824345,-170383
1676968991,201914,true,1703824345,28,1703483632,-340713
1676969159,201915,true,1703653980,28,1702461899,-1192081
1676969171,201916,true,1703483632,28,1702291670,-1191962
1676969183,201915,true,1703653980,28,1702121458,-1532522
1676969207,201917,true,1703313300,28,1701951263,-1362037
1676969231,201918,true,1703142986,28,1701610923,-1532063
1676969243,201920,true,1702802408,28,1701440779,-1361629
1676969363,201921,true,1702632145,28,1699910248,-2721897
1676969375,201922,true,1702461899,28,1699740274,-2721625
1676969435,201924,true,1702121458,28,1698890659,-3230799
1676969447,201925,true,1701951263,28,1698720787,-3230476
1676969663,201926,true,1701781084,28,1695665992,-6115092
1676970323,201928,true,1701440779,28,1685354427,-16086352
1676970671,201930,true,1701100542,28,1680810335,-20290207
1676970839,201930,true,1701100542,28,1679298362,-21802180
1676971919,201932,true,1700760373,28,1677619987,-23140386
1676971943,201933,true,1700590314,28,1677619987,-22970327
1676972003,201935,true,1700250247,28,1677619987,-22630260
1676972051,201935,true,1700250247,28,1677619987,-22630260
1676972111,201936,true,1700080239,28,1677787749,-22292490
1676972147,201937,true,1699910248,28,1677787749,-22122499
1676977559,201938,true,1699740274,28,1681819073,-17921201
1676978015,201939,true,1699570317,28,1681819073,-17751244
1676978123,201939,true,1699570317,28,1681819073,-17751244
1676979611,201940,true,1699400377,28,1680810335,-18590042
1676979623,201942,true,1699060548,28,1680810335,-18250213
1676980199,201943,true,1698890659,28,1680138179,-18752480
1676980319,201944,true,1698720787,28,1679970182,-18750605
1676980439,201945,true,1698550932,28,1679802202,-18748730
1676980451,201947,true,1698211272,28,1679802202,-18409070
1676980595,201948,true,1698041468,28,1679466291,-18575177
1676980619,201949,true,1697871681,28,1679298362,-18573319
1676980655,201951,true,1697532158,28,1679298362,-18233796
1676981219,201954,true,1697023000,28,1676781428,-20241572
1676981723,201955,true,1696853314,28,1674435694,-22417620
1676981867,201956,true,1696683646,28,1673766087,-22917559
1676981999,201958,true,1696344360,28,1673096748,-23247612
1676982671,201961,true,1695835559,28,1671257445,-24578114
1676982683,201962,true,1695665992,28,1671257445,-24408547
1676982719,201963,true,1695496442,28,1671257445,-24238997
1676982731,201965,true,1695157394,28,1671257445,-23899949
1676982839,201968,true,1694648948,28,1671257445,-23391503
1676982851,201970,true,1694310070,28,1671257445,-23052625
1676982887,201971,true,1694140655,28,1671257445,-22883210
1676983235,201972,true,1693971258,28,1671591713,-22379545
1676983271,201975,true,1693463169,28,1671758873,-21704296
1676985035,201977,true,1693124527,28,1674268267,-18856260
1676987807,201978,true,1692955231,28,1674268267,-18686964
1676987867,201980,true,1692616691,28,1674268267,-18348424
1676988443,201983,true,1692109007,28,1672427676,-19681331
1676988695,201985,true,1691770636,28,1671758873,-20011763
1676988755,201987,true,1691432333,28,1671591713,-19840620
1676989019,201989,true,1691094097,28,1670923244,-20170853
1676989067,201992,true,1690586871,28,1670923244,-19663627
1676989151,201993,true,1690417829,28,1670756168,-19661661
1676989223,201995,true,1690079796,28,1670589109,-19490687
1676989415,201996,true,1689910805,28,1670422067,-19488738
1676989715,201999,true,1689403933,28,1670255042,-19148891
1676989991,202000,true,1689235009,28,1670923244,-18311765
1676990027,202002,true,1688897213,28,1671090336,-17806877
1676990075,202003,true,1688728340,28,1671257445,-17470895
1676990087,202006,true,1688221823,28,1671257445,-16964378
1676990099,202007,true,1688053018,28,1671257445,-16795573
1676990483,202009,true,1687715458,28,1673264058,-14451400
1676990591,202010,true,1687546703,28,1673766087,-13780616
1676991179,202012,true,1687209244,28,1676446122,-10763122
1676991791,202013,true,1687040540,28,1678458964,-8581576
1676992271,202014,true,1686871853,28,1678626810,-8245043
1676992283,202015,true,1686703183,28,1678626810,-8076373
1676992343,202017,true,1686365893,28,1678626810,-7739083
1676992391,202018,true,1686197273,28,1678458964,-7738309
1676992403,202020,true,1685860084,28,1678458964,-7401120
1676992439,202021,true,1685691515,28,1678291135,-7400380
1676992451,202023,true,1685354427,28,1678291135,-7063292
1676992463,202025,true,1685017407,28,1678291135,-6726272
1676992523,202027,true,1684680454,28,1677955527,-6724927
1676992535,202027,true,1684680454,28,1677955527,-6724927
1676992547,202030,true,1684175151,28,1677955527,-6219624
1676992619,202031,true,1684006750,28,1677452241,-6554509
1676992667,202034,true,1683501649,28,1677116801,-6384848
1676992679,202034,true,1683501649,28,1677116801,-6384848
1676992835,202037,true,1682996700,28,1675943289,-7053411
1676992895,202039,true,1682660151,28,1675440606,-7219545
1676992919,202041,true,1682323669,28,1675105569,-7218100
1676993471,202042,true,1682155454,28,1670589109,-11566345
1676993567,202045,true,1681650908,28,1669754065,-11896843
1676993603,202047,true,1681314628,28,1669420165,-11894463
1676993627,202049,true,1680978416,28,1669253239,-11725177
1676993711,202050,true,1680810335,28,1668752563,-12057772
1676993723,202052,true,1680474223,28,1668752563,-11721660
1676993819,202054,true,1680138179,28,1668252038,-11886141
1676994203,202056,true,1679802202,28,1666751361,-13050841
1676995835,202057,true,1679634238,28,1671424571,-8209667
1676996219,202059,true,1679298362,28,1671257445,-8040917
1676996915,202061,true,1678962552,28,1670255042,-8707510
1676997131,202063,true,1678626810,28,1669921041,-8705769
1676997191,202064,true,1678458964,28,1669754065,-8704899
1676997215,202067,true,1677955527,28,1669754065,-8201462
1676997227,202069,true,1677619987,28,1669754065,-7865922
1676997263,202071,true,1677284513,28,1669587107,-7697406
1676997311,202073,true,1676949106,28,1669420165,-7528941
1676997359,202076,true,1676446122,28,1669253239,-7192883
1676998139,202078,true,1676110883,28,1665918236,-10192647
1676998223,202080,true,1675775711,28,1665585102,-10190609
1676999963,202082,true,1675440606,28,1662589895,-12850711
1676999999,202085,true,1674938075,28,1662589895,-12348180
1677000623,202087,true,1674603137,28,1662756154,-11846983
1677000911,202089,true,1674268267,28,1662756154,-11512113
1677001079,202090,true,1674100857,28,1662756154,-11344703
1677001367,202092,true,1673766087,28,1662922430,-10843657
1677001427,202094,true,1673431384,28,1662922430,-10508954
1677001475,202096,true,1673096748,28,1662922430,-10174318
1677001487,202096,true,1673096748,28,1662922430,-10174318
1677001679,202098,true,1672762179,28,1663088722,-9673457
1677001691,202100,true,1672427676,28,1663088722,-9338954
1677001859,202101,true,1672260450,28,1663421356,-8839094
1677001871,202102,true,1672093241,28,1663421356,-8671885
1677002039,202102,true,1672093241,28,1663754057,-8339184
1677002051,202103,true,1671926048,28,1663920433,-8005615
1677002063,202104,true,1671758873,28,1663920433,-7838440
1677002219,202104,true,1671758873,28,1664419659,-7339214
1677002255,202104,true,1671758873,28,1664586101,-7172772
1677002291,202106,true,1671424571,28,1664752559,-6672012
1677002315,202106,true,1671424571,28,1664919034,-6505537
1677002411,202106,true,1671424571,28,1665418560,-6006011
1677002471,202106,true,1671424571,28,1665751660,-5672911
1677002555,202107,true,1671257445,28,1666251436,-5006009
1677002603,202107,true,1671257445,28,1666418061,-4839384
1677002627,202107,true,1671257445,28,1666584703,-4672742
1677002663,202106,true,1671424571,28,1666918036,-4506535
1677002687,202107,true,1671257445,28,1667084728,-4172717
1677002699,202108,true,1671090336,28,1667251437,-3838899
1677002723,202107,true,1671257445,28,1667418162,-3839283
1677004583,202107,true,1671257445,28,1681146514,9889069
1677004595,202107,true,1671257445,28,1681146514,9889069
1677004859,202108,true,1671090336,28,1680978416,9888080
1677007343,202108,true,1671090336,28,1678123323,7032987
1677007751,202107,true,1671257445,28,1677787749,6530304
1677008483,202108,true,1671090336,28,1677116801,6026465
1677008495,202108,true,1671090336,28,1677116801,6026465
1677008531,202108,true,1671090336,28,1676949106,5858770
1677010127,202108,true,1671090336,28,1673264058,2173722
1677010871,202109,true,1670923244,28,1672929455,2006211
1677011063,202109,true,1670923244,28,1672929455,2006211
1677011231,202109,true,1670923244,28,1672929455,2006211
1677011255,202108,true,1671090336,28,1672929455,1839119
1677011363,202109,true,1670923244,28,1672762179,1838935
1677012587,202110,true,1670756168,28,1670255042,-501126
1677013067,202109,true,1670923244,28,1669253239,-1670005
1677014039,202109,true,1670923244,28,1669086331,-1836913
1677014051,202109,true,1670923244,28,1669086331,-1836913
1677014183,202110,true,1670756168,28,1668919439,-1836729
1677014195,202110,true,1670756168,28,1668919439,-1836729
1677014207,202110,true,1670756168,28,1668919439,-1836729
1677014231,202111,true,1670589109,28,1668752563,-1836546
1677014279,202112,true,1670422067,28,1668585705,-1836362
1677014363,202112,true,1670422067,28,1668252038,-2170029
1677014459,202112,true,1670422067,28,1667918437,-2503630
1677014471,202113,true,1670255042,28,1667918437,-2336605
1677014483,202115,true,1669921041,28,1667918437,-2002604
1677014519,202115,true,1669921041,28,1667584904,-2336137
1677014531,202115,true,1669921041,28,1667584904,-2336137
1677014543,202116,true,1669754065,28,1667418162,-2335903
1677014639,202119,true,1669253239,28,1666251436,-3001803
1677014675,202119,true,1669253239,28,1665918236,-3335003
1677014711,202120,true,1669086331,28,1665418560,-3667771
1677014735,202121,true,1668919439,28,1665085526,-3833913
1677014783,202124,true,1668418863,28,1664419659,-3999204
1677015155,202126,true,1668085229,28,1658604663,-9480566
1677015167,202127,true,1667918437,28,1658438819,-9479618
1677015371,202128,true,1667751662,28,1655456463,-12295199
1677015563,202131,true,1667251437,28,1652479470,-14771967
1677015611,202132,true,1667084728,28,1651818644,-15266084
1677015707,202133,true,1666918036,28,1650497783,-16420253
1677015731,202135,true,1666584703,28,1650167733,-16416970
1677016739,202138,true,1666084827,28,1644238106,-21846721
1677016871,202139,true,1665918236,28,1644566970,-21351266
1677016907,202140,true,1665751660,28,1644566970,-21184690
1677017219,202142,true,1665418560,28,1643744933,-21673627
1677017231,202146,true,1664752559,28,1643744933,-21007626
1677017243,202148,true,1664419659,28,1643744933,-20674726
1677017267,202149,true,1664253233,28,1643580575,-20672658
1677017327,202150,true,1664086825,28,1643580575,-20506250
1677017351,202154,true,1663421356,28,1643580575,-19840781
1677018347,202155,true,1663255031,28,1642266302,-20988729
1677018479,202156,true,1663088722,28,1642102092,-20986630
1677018515,202157,true,1662922430,28,1642102092,-20820338
1677018623,202160,true,1662423653,28,1641937898,-20485755
1677019055,202161,true,1662257427,28,1643416233,-18841194
1677019079,202162,true,1662091218,28,1643416233,-18674985
1677019127,202162,true,1662091218,28,1643416233,-18674985
1677019223,202165,true,1661592690,28,1643744933,-17847757
1677019235,202166,true,1661426547,28,1643744933,-17681614
1677019319,202166,true,1661426547,28,1643909307,-17517240
1677019583,202166,true,1661426547,28,1644566970,-16859577
1677019631,202169,true,1660928219,28,1644566970,-16361249
1677019655,202169,true,1660928219,28,1644731426,-16196793
1677019703,202169,true,1660928219,28,1644895899,-16032320
1677020015,202169,true,1660928219,28,1646047672,-14880547
1677020399,202172,true,1660430040,28,1647529708,-12900332
1677020807,202173,true,1660264014,28,1648848193,-11415821
1677021107,202173,true,1660264014,28,1649672782,-10591232
1677021443,202173,true,1660264014,28,1650167733,-10096281
1677022979,202176,true,1659766034,28,1650662833,-9103201
1677023495,202177,true,1659600074,28,1650827899,-8772175
1677023543,202177,true,1659600074,28,1650827899,-8772175
1677023579,202177,true,1659600074,28,1650827899,-8772175
1677023651,202180,true,1659102294,28,1650992982,-8109312
1677023939,202180,true,1659102294,28,1651323197,-7779097
1677023951,202181,true,1658936400,28,1651488330,-7448070
1677023975,202181,true,1658936400,28,1651488330,-7448070
1677023987,202183,true,1658604663,28,1651488330,-7116333
1677024335,202183,true,1658604663,28,1652479470,-6125193
1677024347,202183,true,1658604663,28,1652479470,-6125193
1677024431,202182,true,1658770523,28,1652644718,-6125805
1677024455,202184,true,1658438819,28,1652809983,-5628836
1677024467,202184,true,1658438819,28,1652809983,-5628836
1677024515,202184,true,1658438819,28,1652975264,-5463555
1677024539,202183,true,1658604663,28,1653140561,-5464102
1677024551,202186,true,1658107181,28,1653140561,-4966620
1677024563,202185,true,1658272992,28,1653140561,-5132431
1677024671,202185,true,1658272992,28,1653636553,-4636439
1677024695,202184,true,1658438819,28,1653801917,-4636902
1677024851,202186,true,1658107181,28,1654628983,-3478198
1677024899,202186,true,1658107181,28,1654959925,-3147256
1677024911,202186,true,1658107181,28,1654959925,-3147256
1677026711,202185,true,1658272992,28,1662091218,3818226
1677026723,202187,true,1657941387,28,1662091218,4149831
1677026771,202187,true,1657941387,28,1662091218,4149831
1677026807,202187,true,1657941387,28,1662091218,4149831
1677026891,202186,true,1658107181,28,1661925025,3817844
1677026915,202188,true,1657775609,28,1661925025,4149416
1677027143,202189,true,1657609848,28,1661426547,3816699
1677029879,202189,true,1657609848,28,1657444104,-165744
1677029963,202188,true,1657775609,28,1657444104,-331505
1677029987,202191,true,1657278376,28,1657444104,165728
1677029999,202192,true,1657112665,28,1657444104,331439
1677030047,202192,true,1657112665,28,1657444104,331439
1677030419,202193,true,1656946970,28,1656615630,-331340
1677030431,202195,true,1656615630,28,1656449985,-165645
1677030527,202196,true,1656449985,28,1656118745,-331240
1677030779,202197,true,1656284357,28,1655290934,-993423
1677030827,202198,true,1656118745,28,1655125421,-993324
1677030839,202201,true,1655622009,28,1655125421,-496588
1677030851,202202,true,1655456463,28,1654959925,-496538
1677030899,202204,true,1655125421,28,1654794446,-330975
1677030923,202205,true,1654959925,28,1654628983,-330942
1677030935,202208,true,1654463537,28,1654463537,0
1677030971,202209,true,1654298107,28,1654298107,0
1677031007,202211,true,1653967297,28,1653967297,0
1677031043,202212,true,1653801917,28,1653636553,-165364
1677031055,202215,true,1653305875,28,1653636553,330678
1677031163,202216,true,1653140561,28,1652644718,-495843
1677031343,202218,true,1652809983,28,1650992982,-1817001
1677031367,202219,true,1652644718,28,1650827899,-1816819
1677031379,202222,true,1652149024,28,1650662833,-1486191
1677031391,202223,true,1651983826,28,1650497783,-1486043
1677031415,202225,true,1651653478,28,1650332750,-1320728
1677031607,202226,true,1651488330,28,1648188818,-3299512
1677031679,202229,true,1650992982,28,1647364971,-3628011
1677031883,202230,true,1650827899,28,1645389418,-5438481
1677032303,202232,true,1650497783,28,1641609559,-8888224
1677032651,202233,true,1650332750,28,1638985215,-11347535
1677032675,202236,true,1649837749,28,1638985215,-10852534
1677032843,202237,true,1649672782,28,1638493618,-11179164
1677033155,202238,true,1649507831,28,1638165969,-11341862
1677033167,202239,true,1649342897,28,1638002168,-11340729
1677033371,202241,true,1649013078,28,1637019711,-11993367
1677033407,202243,true,1648683325,28,1636856025,-11827300
1677033491,202245,true,1648353637,28,1636528703,-11824934
1677033515,202246,true,1648188818,28,1636365067,-11823751
1677033527,202248,true,1647859230,28,1636365067,-11494163
1677033575,202249,true,1647694461,28,1636201447,-11493014
1677033635,202251,true,1647364971,28,1636201447,-11163524
1677033695,202252,true,1647200251,28,1636037843,-11162408
1677033743,202252,true,1647200251,28,1635874255,-11325996
1677033755,202252,true,1647200251,28,1635874255,-11325996
1677033791,202254,true,1646870861,28,1635874255,-10996606
1677033911,202254,true,1646870861,28,1635874255,-10996606
1677033923,202254,true,1646870861,28,1635874255,-10996606
1677034031,202254,true,1646870861,28,1635874255,-10996606
1677034055,202255,true,1646706190,28,1635874255,-10831935
1677034223,202255,true,1646706190,28,1636201447,-10504743
1677034295,202255,true,1646706190,28,1636201447,-10504743
1677034607,202254,true,1646870861,28,1636528703,-10342158
1677034619,202256,true,1646541536,28,1636528703,-10012833
1677034859,202255,true,1646706190,28,1636692356,-10013834
1677034907,202256,true,1646541536,28,1636692356,-9849180
1677035099,202255,true,1646706190,28,1637674617,-9031573
1677035183,202257,true,1646376898,28,1638329785,-8047113
1677035267,202256,true,1646541536,28,1638821333,-7720203
1677035339,202255,true,1646706190,28,1639313029,-7393161
1677036083,202254,true,1646870861,28,1642266302,-4604559
1677037223,202255,true,1646706190,28,1643909307,-2796883
1677037991,202255,true,1646706190,28,1643909307,-2796883
1677038075,202255,true,1646706190,28,1644073698,-2632492
1677038099,202253,true,1647035548,28,1644073698,-2961850
1677038123,202255,true,1646706190,28,1644073698,-2632492
1677038603,202254,true,1646870861,28,1644731426,-2139435
1677038963,202254,true,1646870861,28,1645389418,-1481443
1677040595,202253,true,1647035548,28,1646870861,-164687
1677040655,202254,true,1646870861,28,1646870861,0
1677040667,202254,true,1646870861,28,1646870861,0
1677040715,202253,true,1647035548,28,1646870861,-164687
1677040931,202253,true,1647035548,28,1646706190,-329358
1677040943,202254,true,1646870861,28,1646706190,-164671
1677040955,202254,true,1646870861,28,1646706190,-164671
1677040967,202254,true,1646870861,28,1646706190,-164671
1677041363,202254,true,1646870861,28,1646047672,-823189
1677043283,202255,true,1646706190,28,1643087599,-3618591
1677043499,202255,true,1646706190,28,1643087599,-3618591
1677043547,202255,true,1646706190,28,1643087599,-3618591
1677044003,202255,true,1646706190,28,1643087599,-3618591
1677044207,202257,true,1646376898,28,1642923307,-3453591
1677044387,202257,true,1646376898,28,1642923307,-3453591
1677044495,202257,true,1646376898,28,1642923307,-3453591
1677044507,202257,true,1646376898,28,1642923307,-3453591
1677044615,202259,true,1646047672,28,1642759031,-3288641
1677047219,202259,true,1646047672,28,1641609559,-4438113
1677047375,202259,true,1646047672,28,1641609559,-4438113
1677047519,202259,true,1646047672,28,1641609559,-4438113
1677047603,202261,true,1645718512,28,1641609559,-4108953
1677048119,202262,true,1645553957,28,1641117175,-4436782
1677048299,202262,true,1645553957,28,1640953080,-4600877
1677048491,202263,true,1645389418,28,1640624938,-4764480
1677049043,202265,true,1645060389,28,1639640908,-5419481
1677049091,202265,true,1645060389,28,1639640908,-5419481
1677049115,202266,true,1644895899,28,1639640908,-5254991
1677050567,202267,true,1644731426,28,1637510866,-7220560
1677050579,202269,true,1644402529,28,1637510866,-6891663
1677050603,202270,true,1644238106,28,1637510866,-6727240
1677050711,202270,true,1644238106,28,1637510866,-6727240
1677051323,202271,true,1644073698,28,1638002168,-6071530
1677051563,202273,true,1643744933,28,1638165969,-5578964
1677052115,202274,true,1643580575,28,1638657468,-4923107
1677052271,202275,true,1643416233,28,1638821333,-4594900
1677053003,202275,true,1643416233,28,1639476960,-3939273
1677053063,202278,true,1642923307,28,1639476960,-3446347
1677053171,202279,true,1642759031,28,1639640908,-3118123
1677054035,202279,true,1642759031,28,1640132849,-2626182
1677054047,202280,true,1642594771,28,1640132849,-2461922
1677054335,202283,true,1642102092,28,1640132849,-1969243
1677054695,202283,true,1642102092,28,1640132849,-1969243
1677054791,202284,true,1641937898,28,1640132849,-1805049
1677054803,202284,true,1641937898,28,1639968852,-1969046
1677054851,202287,true,1641445415,28,1639968852,-1476563
1677054863,202287,true,1641445415,28,1639968852,-1476563
1677054911,202288,true,1641281287,28,1639804872,-1476415
1677055019,202289,true,1641117175,28,1639640908,-1476267
1677055043,202291,true,1640789001,28,1639476960,-1312041
1677055055,202291,true,1640789001,28,1639476960,-1312041
1677055091,202292,true,1640624938,28,1639313029,-1311909
1677055103,202293,true,1640460892,28,1639313029,-1147863
1677055139,202295,true,1640132849,28,1639149114,-983735
1677055571,202296,true,1639968852,28,1636856025,-3112827
1677057635,202296,true,1639968852,28,1630811150,-9157702
1677057815,202297,true,1639804872,28,1631137329,-8667543
1677057935,202299,true,1639476960,28,1631300442,-8176518
1677058163,202299,true,1639476960,28,1631626719,-7850241
1677058211,202299,true,1639476960,28,1631626719,-7850241
1677058223,202300,true,1639313029,28,1631626719,-7686310
1677058391,202301,true,1639149114,28,1631953061,-7196053
1677058847,202301,true,1639149114,28,1632932477,-6216637
1677058967,202301,true,1639149114,28,1633259080,-5890034
1677059015,202301,true,1639149114,28,1633422406,-5726708
1677059219,202303,true,1638821333,28,1633912482,-4908851
1677059363,202302,true,1638985215,28,1634402704,-4582511
1677059387,202302,true,1638985215,28,1634566145,-4419070
1677059507,202303,true,1638821333,28,1634893074,-3928259
1677059639,202304,true,1638657468,28,1635220069,-3437399
1677059831,202302,true,1638985215,28,1635874255,-3110960
1677061115,202302,true,1638985215,28,1638493618,-491597
1677061403,202302,true,1638985215,28,1638657468,-327747
1677062435,202303,true,1638821333,28,1638657468,-163865
1677062447,202302,true,1638985215,28,1638821333,-163882
1677062483,202302,true,1638985215,28,1638821333,-163882
1677062507,202302,true,1638985215,28,1638821333,-163882
1677062771,202303,true,1638821333,28,1639149114,327781
1677062783,202302,true,1638985215,28,1639149114,163899
1677063407,202301,true,1639149114,28,1639968852,819738
1677064235,202301,true,1639149114,28,1641117175,1968061
1677064511,202300,true,1639313029,28,1641117175,1804146
1677064847,202299,true,1639476960,28,1641117175,1640215
1677064943,202299,true,1639476960,28,1641117175,1640215
1677067295,202299,true,1639476960,28,1640953080,1476120
1677067607,202299,true,1639476960,28,1641117175,1640215
1677067691,202298,true,1639640908,28,1641117175,1476267
1677067859,202297,true,1639804872,28,1641281287,1476415
1677067871,202297,true,1639804872,28,1641281287,1476415
1677067967,202297,true,1639804872,28,1641281287,1476415
1677068327,202296,true,1639968852,28,1641773720,1804868
1677068471,202296,true,1639968852,28,1642102092,2133240
1677068531,202295,true,1640132849,28,1642266302,2133453
1677068651,202295,true,1640132849,28,1642430528,2297679
1677070163,202295,true,1640132849,28,1645224895,5092046
1677070871,202294,true,1640296863,28,1645389418,5092555
1677071315,202294,true,1640296863,28,1645389418,5092555
1677072935,202294,true,1640296863,28,1645553957,5257094
1677073139,202294,true,1640296863,28,1645553957,5257094
1677074267,202293,true,1640460892,28,1645553957,5093065
1677074687,202293,true,1640460892,28,1645553957,5093065
1677074723,202293,true,1640460892,28,1645553957,5093065
1677074735,202293,true,1640460892,28,1645389418,4928526
1677074771,202292,true,1640624938,28,1645389418,4764480
1677075359,202295,true,1640132849,28,1642594771,2461922
1677075407,202295,true,1640132849,28,1642266302,2133453
1677075635,202294,true,1640296863,28,1641117175,820312
1677075671,202294,true,1640296863,28,1640953080,656217
1677075911,202297,true,1639804872,28,1639313029,-491843
1677076475,202297,true,1639804872,28,1635547130,-4257742
1677076847,202297,true,1639804872,28,1634402704,-5402168
1677077207,202297,true,1639804872,28,1633749107,-6055765
1677077279,202300,true,1639313029,28,1633585748,-5727281
1677077291,202300,true,1639313029,28,1633585748,-5727281
1677077423,202300,true,1639313029,28,1633422406,-5890623
1677077963,202300,true,1639313029,28,1633585748,-5727281
1677077999,202302,true,1638985215,28,1633585748,-5399467
1677078011,202302,true,1638985215,28,1633585748,-5399467
1677078143,202303,true,1638821333,28,1633422406,-5398927
1677078155,202302,true,1638985215,28,1633422406,-5562809
1677078167,202305,true,1638493618,28,1633422406,-5071212
1677078239,202305,true,1638493618,28,1633259080,-5234538
1677078299,202306,true,1638329785,28,1633095770,-5234015
1677078743,202306,true,1638329785,28,1631137329,-7192456
1677078755,202308,true,1638002168,28,1631137329,-6864839
1677078983,202309,true,1637838385,28,1629833006,-8005379
1677078995,202310,true,1637674617,28,1629833006,-7841611
1677079043,202311,true,1637510866,28,1629344154,-8166712
1677079127,202313,true,1637183413,28,1628692579,-8490834
1677079175,202314,true,1637019711,28,1628204069,-8815642
1677079223,202315,true,1636856025,28,1627715705,-9140320
1677079235,202316,true,1636692356,28,1627552950,-9139406
1677079643,202319,true,1636201447,28,1623002403,-13199044
1677079667,202320,true,1636037843,28,1622840119,-13197724
1677079955,202321,true,1635874255,28,1619921780,-15952475
1677079979,202322,true,1635710684,28,1619759804,-15950880
1677079991,202324,true,1635383591,28,1619597844,-15785747
1677080075,202326,true,1635056564,28,1618950167,-16106397
1677080747,202326,true,1635056564,28,1614585115,-20471449
1677082535,202327,true,1634893074,28,1613939443,-20953631
1677082583,202330,true,1634402704,28,1613939443,-20463261
1677082655,202331,true,1634239280,28,1613939443,-20299837
1677083375,202332,true,1634075873,28,1612971418,-21104455
1677083387,202333,true,1633912482,28,1612971418,-20941064
1677084563,202336,true,1633422406,28,1610231833,-23190573
1677084587,202337,true,1633259080,28,1610231833,-23027247
1677084875,202338,true,1633095770,28,1609266032,-23829738
1677084911,202339,true,1632932477,28,1609105121,-23827356
1677085355,202344,true,1632116256,28,1607014748,-25101508
1677085427,202345,true,1631953061,28,1606693393,-25259668
1677085451,202347,true,1631626719,28,1606532740,-25093979
1677085547,202348,true,1631463573,28,1606211482,-25252091
1677085739,202352,true,1630811150,28,1605729715,-25081435
1677085775,202353,true,1630648085,28,1605569158,-25078927
1677086219,202354,true,1630485037,28,1604445709,-26039328
1677086315,202356,true,1630158989,28,1604285280,-25873709
1677086483,202359,true,1629670039,28,1603964471,-25705568
1677086627,202361,true,1629344154,28,1604124868,-25219286
1677086675,202362,true,1629181236,28,1604124868,-25056368
1677086735,202362,true,1629181236,28,1604285280,-24895956
1677086867,202366,true,1628529726,28,1604606153,-23923573
1677087023,202367,true,1628366889,28,1605248092,-23118797
1677087551,202368,true,1628204069,28,1606693393,-21510676
1677087647,202368,true,1628204069,28,1606854063,-21350006
1677089567,202371,true,1627715705,28,1608461640,-19254065
1677090443,202372,true,1627552950,28,1608783348,-18769602
1677090455,202373,true,1627390211,28,1608944227,-18445984
1677090467,202373,true,1627390211,28,1608944227,-18445984
1677090563,202376,true,1626902092,28,1609105121,-17796971
1677090611,202376,true,1626902092,28,1609105121,-17796971
1677090623,202377,true,1626739418,28,1609105121,-17634297
1677090647,202378,true,1626576760,28,1609266032,-17310728
1677090707,202381,true,1626088885,28,1609266032,-16822853
1677091679,202381,true,1626088885,28,1611359333,-14729552
1677092507,202382,true,1625926292,28,1613132715,-12793577
1677092651,202383,true,1625763716,28,1613132715,-12631001
1677092663,202386,true,1625276084,28,1613132715,-12143369
1677092675,202386,true,1625276084,28,1613132715,-12143369
1677092699,202387,true,1625113573,28,1613294028,-11819545
1677092759,202387,true,1625113573,28,1613455358,-11658215
1677092771,202390,true,1624626136,28,1613455358,-11170778
1677092807,202390,true,1624626136,28,1613616703,-11009433
1677093119,202390,true,1624626136,28,1616038823,-8587313
1677093155,202390,true,1624626136,28,1616200427,-8425709
1677093203,202393,true,1624138846,28,1616523683,-7615163
1677093347,202393,true,1624138846,28,1617332107,-6806739
1677093383,202393,true,1624138846,28,1617493840,-6645006
1677093623,202394,true,1623976448,28,1618464579,-5511869
1677093671,202397,true,1623489353,28,1618626426,-4862927
1677094343,202397,true,1623489353,28,1621542431,-1946922
1677094379,202397,true,1623489353,28,1621704585,-1784768
1677094391,202398,true,1623327020,28,1621704585,-1622435
1677094415,202401,true,1622840119,28,1621866756,-973363
1677094955,202402,true,1622677851,28,1620083772,-2594079
1677095327,202403,true,1622515600,28,1619112062,-3403538
1677095387,202403,true,1622515600,28,1618950167,-3565433
1677095399,202406,true,1622028942,28,1618950167,-3078775
1677096215,202407,true,1621866756,28,1618302749,-3564007
1677096923,202407,true,1621866756,28,1619112062,-2754694
1677097895,202408,true,1621704585,28,1619273973,-2430612
1677098183,202411,true,1621218171,28,1619112062,-2106109
1677098231,202412,true,1621056066,28,1618950167,-2105899
1677098279,202413,true,1620893976,28,1618950167,-1943809
1677099743,202414,true,1620731903,28,1615877236,-4854667
1677099767,202417,true,1620245781,28,1615877236,-4368545
1677099779,202418,true,1620083772,28,1615877236,-4206536
1677099803,202419,true,1619921780,28,1615877236,-4044544
1677102023,202420,true,1619759804,28,1617170390,-2589414
1677103823,202423,true,1619273973,28,1617170390,-2103583
1677103871,202425,true,1618950167,28,1617332107,-1618060
1677103883,202425,true,1618950167,28,1617332107,-1618060
1677104339,202426,true,1618788288,28,1617655590,-1132698
1677104387,202429,true,1618302749,28,1617655590,-647159
1677104483,202430,true,1618140935,28,1617979137,-161798
1677104687,202431,true,1617979137,28,1618302749,323612
1677104831,202431,true,1617979137,28,1618788288,809151
1677105491,202433,true,1617655590,28,1620569846,2914256
1677105503,202434,true,1617493840,28,1620569846,3076006
1677105599,202434,true,1617493840,28,1620893976,3400136
1677105647,202435,true,1617332107,28,1621218171,3886064
1677106451,202435,true,1617332107,28,1623976448,6644341
1677106607,202435,true,1617332107,28,1624463690,7131583
1677106775,202436,true,1617170390,28,1624788599,7618209
1677106787,202436,true,1617170390,28,1624788599,7618209
1677106799,202436,true,1617170390,28,1624951078,7780688
1677106895,202437,true,1617008689,28,1625276084,8267395
1677106931,202436,true,1617170390,28,1625438612,8268222
1677106955,202437,true,1617008689,28,1625601155,8592466
1677106967,202437,true,1617008689,28,1625763716,8755027
1677107003,202437,true,1617008689,28,1625926292,8917603
1677107051,202436,true,1617170390,28,1626414119,9243729
1677107099,202436,true,1617170390,28,1626739418,9569028
1677107111,202436,true,1617170390,28,1626902092,9731702
1677107231,202435,true,1617332107,28,1628041265,10709158
1677107243,202434,true,1617493840,28,1628041265,10547425
1677107255,202433,true,1617655590,28,1628204069,10548479
1677107855,202433,true,1617655590,28,1633095770,15440180
1677107879,202432,true,1617817355,28,1633259080,15441725
1677108011,202431,true,1617979137,28,1634402704,16423567
1677110207,202429,true,1618302749,28,1640953080,22650331
1677110591,202429,true,1618302749,28,1641117175,22814426
1677110723,202427,true,1618626426,28,1641281287,22654861
1677110819,202425,true,1618950167,28,1641281287,22331120
1677112139,202424,true,1619112062,28,1641773720,22661658
1677112379,202423,true,1619273973,28,1642102092,22828119
1677112403,202421,true,1619597844,28,1642102092,22504248
1677112523,202419,true,1619921780,28,1642266302,22344522
1677112967,202418,true,1620083772,28,1642430528,22346756
1677113207,202416,true,1620407805,28,1642430528,22022723
1677116687,202415,true,1620569846,28,1642594771,22024925
1677117971,202413,true,1620893976,28,1642430528,21536552
1677118055,202411,true,1621218171,28,1642430528,21212357
1677118067,202410,true,1621380293,28,1642430528,21050235
1677118235,202408,true,1621704585,28,1642594771,20890186
1677118703,202406,true,1622028942,28,1642923307,20894365
1677118859,202404,true,1622353364,28,1643087599,20734235
1677118871,202403,true,1622515600,28,1643251908,20736308
1677118883,202401,true,1622840119,28,1643251908,20411789
1677119339,202398,true,1623327020,28,1644402529,21075509
1677119411,202396,true,1623651701,28,1644566970,20915269
1677119543,202393,true,1624138846,28,1644895899,20757053
1677119603,202391,true,1624463690,28,1645060389,20596699
1677119699,202388,true,1624951078,28,1645553957,20602879
1677119723,202386,true,1625276084,28,1645553957,20277873
1677119795,202383,true,1625763716,28,1645883084,20119368
1677119807,202381,true,1626088885,28,1646047672,19958787
1677119843,202377,true,1626739418,28,1646212277,19472859
1677119867,202375,true,1627064782,28,1646376898,19312116
1677119879,202372,true,1627552950,28,1646541536,18988586
1677119891,202370,true,1627878477,28,1646706190,18827713
1677119951,202366,true,1628529726,28,1647200251,18670525
1677119963,202363,true,1629018334,28,1647200251,18181917
1677119987,202360,true,1629507088,28,1647529708,18022620
1677120035,202358,true,1629833006,28,1648024016,18191010
1677120095,202353,true,1630648085,28,1648848193,18200108
1677120203,202350,true,1631137329,28,1650497783,19360454
1677120251,202347,true,1631626719,28,1651323197,19696478
1677120263,202345,true,1631953061,28,1651488330,19535269
1677120299,202340,true,1632769200,28,1651983826,19214626
1677120347,202336,true,1633422406,28,1652644718,19222312
1677121295,202333,true,1633912482,28,1666251436,32338954
1677121355,202332,true,1634075873,28,1667084728,33008855
1677121391,202326,true,1635056564,28,1667584904,32528340
1677121847,202323,true,1635547130,28,1672260450,36713320
1677122819,202320,true,1636037843,28,1673933464,37895621
1677122831,202318,true,1636365067,28,1673933464,37568397
1677123659,202313,true,1637183413,28,1674268267,37084854
1677123803,202310,true,1637674617,28,1674268267,36593650
1677124091,202307,true,1638165969,28,1674268267,36102298
1677124115,202305,true,1638493618,28,1674268267,35774649
1677124127,202300,true,1639313029,28,1674268267,34955238
1677124703,202298,true,1639640908,28,1673766087,34125179
1677124739,202295,true,1640132849,28,1673766087,33633238
1677125303,202294,true,1640296863,28,1672929455,32632592
1677126143,202290,true,1640953080,28,1671758873,30805793
1677126731,202288,true,1641281287,28,1671591713,30310426
1677128867,202285,true,1641773720,28,1671591713,29817993
1677130403,202283,true,1642102092,28,1671591713,29489621
1677130511,202279,true,1642759031,28,1671591713,28832682
1677130583,202277,true,1643087599,28,1671591713,28504114
1677130595,202274,true,1643580575,28,1671591713,28011138
1677131123,202273,true,1643744933,28,1670756168,27011235
1677131459,202269,true,1644402529,28,1670255042,25852513
1677132491,202267,true,1644731426,28,1668418863,23687437
1677134243,202264,true,1645224895,28,1668085229,22860334
1677134315,202262,true,1645553957,28,1668085229,22531272
1677134375,202258,true,1646212277,28,1668085229,21872952
1677134423,202256,true,1646541536,28,1668085229,21543693
1677134483,202253,true,1647035548,28,1667918437,20882889
1677135503,202252,true,1647200251,28,1665918236,18717985
1677137927,202248,true,1647859230,28,1664253233,16394003
1677138959,202246,true,1648188818,28,1664253233,16064415
1677139979,202243,true,1648683325,28,1664253233,15569908
1677140135,202242,true,1648848193,28,1664586101,15737908
1677140567,202238,true,1649507831,28,1665418560,15910729
1677140603,202235,true,1650002733,28,1665418560,15415827
1677141263,202232,true,1650497783,28,1667084728,16586945
1677141683,202230,true,1650827899,28,1668085229,17257330
1677146723,202226,true,1651488330,28,1668585705,17097375
1677146783,202224,true,1651818644,28,1668585705,16767061
1677146819,202221,true,1652314239,28,1668585705,16271466
1677146891,202219,true,1652644718,28,1668585705,15940987
1677146927,202215,true,1653305875,28,1668585705,15279830
1677147863,202213,true,1653636553,28,1667251437,13614884
1677148247,202210,true,1654132694,28,1666584703,12452009
1677151367,202209,true,1654298107,28,1665918236,11620129
1677151379,202205,true,1654959925,28,1665918236,10958311
1677151391,202204,true,1655125421,28,1665918236,10792815
1677151415,202201,true,1655622009,28,1665918236,10296227
1677151439,202200,true,1655787571,28,1665751660,9964089
1677151451,202197,true,1656284357,28,1665751660,9467303
1677151571,202196,true,1656449985,28,1665085526,8635541
1677151595,202194,true,1656781292,28,1664919034,8137742
1677151679,202194,true,1656781292,28,1664253233,7471941
1677151739,202191,true,1657278376,28,1663587698,6309322
1677151751,202191,true,1657278376,28,1663587698,6309322
1677151787,202189,true,1657609848,28,1663088722,5478874
1677151811,202190,true,1657444104,28,1662922430,5478326
1677151907,202188,true,1657775609,28,1661592690,3817081
1677151919,202188,true,1657775609,28,1661426547,3650938
1677152183,202187,true,1657941387,28,1657775609,-165778
1677152303,202188,true,1657775609,28,1655953150,-1822459
1677152567,202187,true,1657941387,28,1651818644,-6122743
1677153911,202187,true,1657941387,28,1638002168,-19939219
1677153923,202186,true,1658107181,28,1637838385,-20268796
1677153983,202188,true,1657775609,28,1637838385,-19937224
1677154007,202187,true,1657941387,28,1637674617,-20266770
1677154079,202188,true,1657775609,28,1637510866,-20264743
1677154703,202188,true,1657775609,28,1636365067,-21410542
1677154727,202189,true,1657609848,28,1636365067,-21244781
1677154751,202188,true,1657775609,28,1636365067,-21410542
1677154763,202189,true,1657609848,28,1636365067,-21244781
1677154775,202189,true,1657609848,28,1636365067,-21244781
1677154787,202191,true,1657278376,28,1636365067,-20913309
1677154979,202189,true,1657609848,28,1636201447,-21408401
1677155015,202190,true,1657444104,28,1636201447,-21242657
1677155027,202190,true,1657444104,28,1636201447,-21242657
1677156575,202191,true,1657278376,28,1639476960,-17801416
1677156587,202190,true,1657444104,28,1639640908,-17803196
1677156611,202191,true,1657278376,28,1639640908,-17637468
1677156659,202190,true,1657444104,28,1639804872,-17639232
1677156743,202191,true,1657278376,28,1639968852,-17309524
1677156767,202190,true,1657444104,28,1640132849,-17311255
1677156803,202191,true,1657278376,28,1640132849,-17145527
1677156815,202190,true,1657444104,28,1640296863,-17147241
1677156911,202191,true,1657278376,28,1640624938,-16653438
1677156935,202190,true,1657444104,28,1640624938,-16819166
1677156971,202191,true,1657278376,28,1640789001,-16489375
1677157967,202190,true,1657444104,28,1644238106,-13205998
1677158003,202190,true,1657444104,28,1644402529,-13041575
1677158039,202190,true,1657444104,28,1644566970,-12877134
1677158051,202191,true,1657278376,28,1644731426,-12546950
1677158063,202189,true,1657609848,28,1644731426,-12878422
1677158075,202189,true,1657609848,28,1644895899,-12713949
1677158087,202188,true,1657775609,28,1644895899,-12879710
1677158123,202189,true,1657609848,28,1645224895,-12384953
1677158231,202188,true,1657775609,28,1646376898,-11398711
1677158267,202188,true,1657775609,28,1646706190,-11069419
1677158291,202187,true,1657941387,28,1646870861,-11070526
1677158303,202189,true,1657609848,28,1647035548,-10574300
1677158339,202187,true,1657941387,28,1647529708,-10411679
1677158351,202187,true,1657941387,28,1647694461,-10246926
1677158363,202187,true,1657941387,28,1647859230,-10082157
1677159047,202187,true,1657941387,28,1655953150,-1988237
1677159191,202186,true,1658107181,28,1657278376,-828805
1677159791,202187,true,1657941387,28,1662922430,4981043
1677160055,202187,true,1657941387,28,1663920433,5979046
1677160091,202188,true,1657775609,28,1664086825,6311216
1677160199,202188,true,1657775609,28,1663920433,6144824
1677160259,202189,true,1657609848,28,1663754057,6144209
1677160295,202189,true,1657609848,28,1663587698,5977850
1677160307,202191,true,1657278376,28,1663587698,6309322
1677160331,202190,true,1657444104,28,1663421356,5977252
1677160343,202191,true,1657278376,28,1663421356,6142980
1677160355,202192,true,1657112665,28,1663255031,6142366
1677160403,202194,true,1656781292,28,1662922430,6141138
1677160427,202194,true,1656781292,28,1662756154,5974862
1677160451,202196,true,1656449985,28,1662589895,6139910
1677160643,202197,true,1656284357,28,1661094312,4809955
1677160871,202199,true,1655953150,28,1659434131,3480981
1677160883,202199,true,1655953150,28,1659434131,3480981
1677161411,202200,true,1655787571,28,1656946970,1159399
1677161435,202201,true,1655622009,28,1656781292,1159283
1677161459,202203,true,1655290934,28,1656781292,1490358
1677161507,202203,true,1655290934,28,1656615630,1324696
1677161795,202203,true,1655290934,28,1656284357,993423
1677161819,202204,true,1655125421,28,1656284357,1158936
1677161927,202205,true,1654959925,28,1656449985,1490060
1677161975,202205,true,1654959925,28,1656449985,1490060
1677161999,202205,true,1654959925,28,1656615630,1655705
1677163031,202205,true,1654959925,28,1662922430,7962505
1677163043,202207,true,1654628983,28,1662922430,8293447
1677163103,202206,true,1654794446,28,1663255031,8460585
1677163115,202205,true,1654959925,28,1663421356,8461431
1677163175,202207,true,1654628983,28,1663587698,8958715
1677163187,202208,true,1654463537,28,1663587698,9124161
1677163655,202208,true,1654463537,28,1663587698,9124161
1677163691,202207,true,1654628983,28,1663587698,8958715
1677164567,202208,true,1654463537,28,1662922430,8458893
1677164615,202209,true,1654298107,28,1662756154,8458047
1677164663,202209,true,1654298107,28,1662756154,8458047
1677164711,202207,true,1654628983,28,1662589895,7960912
1677164735,202209,true,1654298107,28,1662423653,8125546
1677164795,202210,true,1654132694,28,1662257427,8124733
1677164819,202210,true,1654132694,28,1662091218,7958524
1677164831,202209,true,1654298107,28,1662091218,7793111
1677164879,202210,true,1654132694,28,1661925025,7792331
1677165983,202213,true,1653636553,28,1656118745,2482192
1677166043,202213,true,1653636553,28,1655787571,2151018
1677166055,202212,true,1653801917,28,1655787571,1985654
1677166463,202213,true,1653636553,28,1653967297,330744
1677166511,202216,true,1653140561,28,1653967297,826736
1677167279,202216,true,1653140561,28,1655290934,2150373
1677168539,202215,true,1653305875,28,1656946970,3641095
1677168611,202216,true,1653140561,28,1656946970,3806409
1677169175,202218,true,1652809983,28,1656781292,3971309
1677169187,202218,true,1652809983,28,1656781292,3971309
1677171479,202217,true,1652975264,28,1654298107,1322843
1677171503,202218,true,1652809983,28,1654298107,1488124
1677171515,202220,true,1652479470,28,1654298107,1818637
1677172199,202220,true,1652479470,28,1653636553,1157083
1677173723,202219,true,1652644718,28,1652314239,-330479
1677173831,202220,true,1652479470,28,1652479470,0
1677173903,202221,true,1652314239,28,1652479470,165231
1677173915,202221,true,1652314239,28,1652644718,330479
1677174299,202219,true,1652644718,28,1653140561,495843
1677174311,202220,true,1652479470,28,1653140561,661091
1677174455,202220,true,1652479470,28,1653471206,991736
1677174767,202220,true,1652479470,28,1654298107,1818637
1677174791,202217,true,1652975264,28,1654298107,1322843
1677174803,202217,true,1652975264,28,1654298107,1322843
1677174815,202218,true,1652809983,28,1654298107,1488124
1677174827,202217,true,1652975264,28,1654298107,1322843
1677175295,202216,true,1653140561,28,1652149024,-991537
1677175511,202216,true,1653140561,28,1651323197,-1817364
1677175523,202216,true,1653140561,28,1651158081,-1982480
1677175535,202216,true,1653140561,28,1651158081,-1982480
1677176615,202215,true,1653305875,28,1643416233,-9889642
1677178199,202215,true,1653305875,28,1642430528,-10875347
1677178307,202215,true,1653305875,28,1642594771,-10711104
1677179471,202214,true,1653471206,28,1643251908,-10219298
1677179495,202213,true,1653636553,28,1643251908,-10384645
1677179519,202213,true,1653636553,28,1643416233,-10220320
1677179567,202213,true,1653636553,28,1643416233,-10220320
1677179723,202212,true,1653801917,28,1643909307,-9892610
1677179807,202211,true,1653967297,28,1644073698,-9893599
1677179843,202210,true,1654132694,28,1644238106,-9894588
1677180023,202210,true,1654132694,28,1645060389,-9072305
1677180047,202209,true,1654298107,28,1645224895,-9073212
1677180059,202208,true,1654463537,28,1645224895,-9238642
1677180923,202208,true,1654463537,28,1649177979,-5285558
1677180971,202207,true,1654628983,28,1649507831,-5121152
1677181019,202206,true,1654794446,28,1649672782,-5121664
1677182699,202206,true,1654794446,28,1652479470,-2314976
1677183287,202206,true,1654794446,28,1652644718,-2149728
1677183311,202205,true,1654959925,28,1652809983,-2149942
1677183479,202204,true,1655125421,28,1652809983,-2315438
1677184283,202204,true,1655125421,28,1653140561,-1984860
1677188087,202204,true,1655125421,28,1653471206,-1654215
1677189011,202204,true,1655125421,28,1653471206,-1654215
1677189035,202203,true,1655290934,28,1653471206,-1819728
1677189263,202203,true,1655290934,28,1653471206,-1819728
1677189323,202202,true,1655456463,28,1653471206,-1985257
1677189503,202202,true,1655456463,28,1653305875,-2150588
1677189587,202202,true,1655456463,28,1653140561,-2315902
1677189791,202203,true,1655290934,28,1652809983,-2480951
1677189851,202203,true,1655290934,28,1652644718,-2646216
1677189923,202203,true,1655290934,28,1652479470,-2811464
1677190379,202204,true,1655125421,28,1650827899,-4297522
1677190403,202205,true,1654959925,28,1650662833,-4297092
1677190427,202205,true,1654959925,28,1650662833,-4297092
1677190439,202206,true,1654794446,28,1650497783,-4296663
1677190463,202207,true,1654628983,28,1650497783,-4131200
1677192707,202208,true,1654463537,28,1644731426,-9732111
1677193619,202209,true,1654298107,28,1644731426,-9566681
1677195743,202210,true,1654132694,28,1645060389,-9072305
1677196103,202211,true,1653967297,28,1645224895,-8742402
1677196163,202212,true,1653801917,28,1645224895,-8577022
1677196403,202213,true,1653636553,28,1645389418,-8247135
1677196463,202214,true,1653471206,28,1645389418,-8081788
1677197063,202215,true,1653305875,28,1645883084,-7422791
1677197111,202216,true,1653140561,28,1646047672,-7092889
1677197243,202216,true,1653140561,28,1646212277,-6928284
1677197255,202217,true,1652975264,28,1646212277,-6762987
1677197303,202217,true,1652975264,28,1646376898,-6598366
1677197459,202218,true,1652809983,28,1646706190,-6103793
1677197495,202218,true,1652809983,28,1646706190,-6103793
1677197531,202218,true,1652809983,28,1646870861,-5939122
1677197567,202218,true,1652809983,28,1646870861,-5939122
1677197963,202219,true,1652644718,28,1648024016,-4620702
1677197975,202218,true,1652809983,28,1648024016,-4785967
1677198011,202219,true,1652644718,28,1648024016,-4620702
1677198023,202219,true,1652644718,28,1648188818,-4455900
1677199259,202219,true,1652644718,28,1652314239,-330479
1677199571,202218,true,1652809983,28,1652644718,-165265
1677200687,202219,true,1652644718,28,1652149024,-495694
1677200891,202219,true,1652644718,28,1652149024,-495694
1677200915,202221,true,1652314239,28,1652149024,-165215
1677200975,202220,true,1652479470,28,1652149024,-330446
1677201023,202221,true,1652314239,28,1652314239,0
1677201479,202220,true,1652479470,28,1653636553,1157083
1677203939,202222,true,1652149024,28,1659268204,7119180
1677203975,202222,true,1652149024,28,1659268204,7119180
1677204227,202222,true,1652149024,28,1659268204,7119180
1677204263,202222,true,1652149024,28,1659102294,6953270
1677205799,202223,true,1651983826,28,1656946970,4963144
1677206867,202223,true,1651983826,28,1656615630,4631804
1677206879,202223,true,1651983826,28,1656615630,4631804
1677206891,202223,true,1651983826,28,1656615630,4631804
1677206975,202224,true,1651818644,28,1656615630,4796986
1677207023,202225,true,1651653478,28,1656449985,4796507
1677207035,202225,true,1651653478,28,1656449985,4796507
1677207131,202225,true,1651653478,28,1656284357,4630879
1677207143,202226,true,1651488330,28,1656284357,4796027
1677207515,202226,true,1651488330,28,1655290934,3802604
1677207827,202227,true,1651323197,28,1654628983,3305786
1677210347,202227,true,1651323197,28,1649507831,-1815366
1677210899,202228,true,1651158081,28,1649672782,-1485299
1677211043,202228,true,1651158081,28,1649672782,-1485299
1677212351,202228,true,1651158081,28,1649672782,-1485299
1677214415,202227,true,1651323197,28,1649507831,-1815366
1677215231,202229,true,1650992982,28,1649507831,-1485151
1677215303,202229,true,1650992982,28,1649507831,-1485151
1677215339,202229,true,1650992982,28,1649507831,-1485151
1677215483,202229,true,1650992982,28,1649507831,-1485151
1677215867,202231,true,1650662833,28,1649177979,-1484854
1677215987,202231,true,1650662833,28,1649177979,-1484854
1677216023,202231,true,1650662833,28,1649013078,-1649755
1677218831,202231,true,1650662833,28,1647529708,-3133125
1677219863,202232,true,1650497783,28,1647694461,-2803322
1677220283,202232,true,1650497783,28,1647694461,-2803322
1677221639,202232,true,1650497783,28,1647694461,-2803322
1677224147,202232,true,1650497783,28,1648024016,-2473767
1677224591,202233,true,1650332750,28,1648024016,-2308734
1677224663,202233,true,1650332750,28,1648188818,-2143932
1677224987,202233,true,1650332750,28,1648353637,-1979113
1677225011,202233,true,1650332750,28,1648353637,-1979113
1677225083,202234,true,1650167733,28,1648353637,-1814096
1677225095,202234,true,1650167733,28,1648518473,-1649260
1677225263,202234,true,1650167733,28,1648683325,-1484408
1677227579,202234,true,1650167733,28,1651653478,1485745
1677233483,202235,true,1650002733,28,1652479470,2476737
1677233819,202235,true,1650002733,28,1652314239,2311506
1677233867,202235,true,1650002733,28,1652314239,2311506
1677233951,202234,true,1650167733,28,1652314239,2146506
1677234011,202234,true,1650167733,28,1652149024,1981291
1677234551,202234,true,1650167733,28,1651158081,990348
1677234815,202234,true,1650167733,28,1650662833,495100
1677236495,202233,true,1650332750,28,1649177979,-1154771
1677241091,202232,true,1650497783,28,1649177979,-1319804
1677243167,202233,true,1650332750,28,1649672782,-659968
1677243371,202232,true,1650497783,28,1649672782,-825001
1677243503,202231,true,1650662833,28,1649672782,-990051
1677243563,202231,true,1650662833,28,1649672782,-990051
1677243575,202232,true,1650497783,28,1649672782,-825001
1677243683,202231,true,1650662833,28,1649672782,-990051
1677243695,202231,true,1650662833,28,1649672782,-990051
1677243743,202230,true,1650827899,28,1649672782,-1155117
1677243791,202231,true,1650662833,28,1649672782,-990051
1677243803,202231,true,1650662833,28,1649672782,-990051
1677243935,202231,true,1650662833,28,1649507831,-1155002
1677244139,202231,true,1650662833,28,1649342897,-1319936
1677244151,202232,true,1650497783,28,1649342897,-1154886
1677244211,202232,true,1650497783,28,1649342897,-1154886
1677244235,202232,true,1650497783,28,1649342897,-1154886
1677244271,202232,true,1650497783,28,1649177979,-1319804
1677244487,202233,true,1650332750,28,1648848193,-1484557
1677245195,202233,true,1650332750,28,1647364971,-2967779
1677245411,202233,true,1650332750,28,1647035548,-3297202
1677245435,202233,true,1650332750,28,1647035548,-3297202
1677245579,202235,true,1650002733,28,1646212277,-3790456
1677245711,202235,true,1650002733,28,1645718512,-4284221
1677245771,202236,true,1649837749,28,1645389418,-4448331
1677245867,202236,true,1649837749,28,1644895899,-4941850
1677246215,202238,true,1649507831,28,1643087599,-6420232
1677246827,202239,true,1649342897,28,1640296863,-9046034
1677247607,202239,true,1649342897,28,1638002168,-11340729
1677247655,202239,true,1649342897,28,1638002168,-11340729
1677247835,202241,true,1649013078,28,1637838385,-11174693
1677247871,202241,true,1649013078,28,1637674617,-11338461
1677247895,202242,true,1648848193,28,1637674617,-11173576
1677249311,202242,true,1648848193,28,1635220069,-13628124
1677249599,202244,true,1648518473,28,1634893074,-13625399
1677250079,202244,true,1648518473,28,1635056564,-13461909
1677251423,202244,true,1648518473,28,1635710684,-12807789
1677251435,202244,true,1648518473,28,1635710684,-12807789
1677251471,202246,true,1648188818,28,1635710684,-12478134
1677251615,202246,true,1648188818,28,1635383591,-12805227
1677251627,202247,true,1648024016,28,1635383591,-12640425
1677251747,202247,true,1648024016,28,1635056564,-12967452
1677251771,202249,true,1647694461,28,1634893074,-12801387
1677251819,202249,true,1647694461,28,1634729601,-12964860
1677251831,202251,true,1647364971,28,1634566145,-12798826
1677252635,202252,true,1647200251,28,1629670039,-17530212
1677252659,202254,true,1646870861,28,1629507088,-17363773
1677252863,202254,true,1646870861,28,1628041265,-18829596
1677253103,202256,true,1646541536,28,1626088885,-20452651
1677253139,202258,true,1646212277,28,1625763716,-20448561
1677253187,202259,true,1646047672,28,1625438612,-20609060
1677253199,202260,true,1645883084,28,1625276084,-20607000
1677253211,202262,true,1645553957,28,1625113573,-20440384
1677253223,202264,true,1645224895,28,1624951078,-20273817
1677253235,202267,true,1644731426,28,1624788599,-19942827
1677253355,202268,true,1644566970,28,1623651701,-20915269
1677253463,202271,true,1644073698,28,1622028942,-22044756
1677253691,202274,true,1643580575,28,1619112062,-24468513
1677253715,202277,true,1643087599,28,1618788288,-24299311
1677253751,202279,true,1642759031,28,1618464579,-24294452
1677253787,202282,true,1642266302,28,1617979137,-24287165
1677254171,202284,true,1641937898,28,1614262247,-27675651
1677254363,202287,true,1641445415,28,1612326391,-29119024
1677254399,202289,true,1641117175,28,1612003974,-29113201
1677254471,202293,true,1640460892,28,1611359333,-29101559
1677254483,202296,true,1639968852,28,1611198213,-28770639
1677254495,202299,true,1639476960,28,1611037110,-28439850
1677254507,202301,true,1639149114,28,1610876022,-28273092
1677254519,202305,true,1638493618,28,1610714951,-27778667
1677254603,202309,true,1637838385,28,1609426958,-28411427
1677254627,202312,true,1637347131,28,1608944227,-28402904
1677254699,202316,true,1636692356,28,1607496901,-29195455
1677254723,202320,true,1636037843,28,1607014748,-29023095
1677254831,202326,true,1635056564,28,1604445709,-30610855
1677254843,202328,true,1634729601,28,1604124868,-30604733
1677254903,202332,true,1634075873,28,1602842145,-31233728
1677254927,202336,true,1633422406,28,1602361389,-31061017
1677254939,202341,true,1632605940,28,1602201169,-30404771
1677254975,202343,true,1632279467,28,1601560448,-30719019
1677254987,202346,true,1631789882,28,1601400308,-30389574
1677255407,202350,true,1631137329,28,1596763206,-34374123
1677255443,202355,true,1630322005,28,1596443901,-33878104
1677255491,202357,true,1629995989,28,1595965064,-34030925
1677255719,202360,true,1629507088,28,1593732388,-35774700
1677255731,202363,true,1629018334,28,1593732388,-35285946
1677255791,202368,true,1628204069,28,1592935761,-35268308
1677256427,202371,true,1627715705,28,1586735719,-40979986
1677256559,202374,true,1627227488,28,1586894393,-40333095
1677256595,202377,true,1626739418,28,1587053082,-39686336
1677256607,202382,true,1625926292,28,1587053082,-38873210
1677256643,202384,true,1625601155,28,1587211787,-38389368
1677256655,202387,true,1625113573,28,1587370509,-37743064
1677256703,202390,true,1624626136,28,1587529246,-37096890
1677256715,202395,true,1623814067,28,1587529246,-36284821
1677256943,202397,true,1623489353,28,1587846767,-35642586
1677256967,202400,true,1623002403,28,1588005552,-34996851
1677257255,202402,true,1622677851,28,1588482001,-34195850
1677257291,202407,true,1621866756,28,1588640850,-33225906
1677257315,202409,true,1621542431,28,1588640850,-32901581
1677257339,202412,true,1621056066,28,1588640850,-32415216
1677257483,202414,true,1620731903,28,1589117490,-31614413
1677257519,202419,true,1619921780,28,1589117490,-30804290
1677258455,202421,true,1619597844,28,1593732388,-25865456
1677258827,202424,true,1619112062,28,1594529413,-24582649
1677258851,202427,true,1618626426,28,1594529413,-24097013
1677258947,202432,true,1617817355,28,1594529413,-23287942
1677259271,202434,true,1617493840,28,1594848335,-22645505
1677259523,202437,true,1617008689,28,1594848335,-22160354
1677260495,202440,true,1616523683,28,1594688866,-21834817
1677260771,202445,true,1615715664,28,1594529413,-21186251
1677260999,202446,true,1615554109,28,1594529413,-21024696
1677261047,202449,true,1615069539,28,1594529413,-20540126
1677261239,202452,true,1614585115,28,1594529413,-20055702
1677263087,202457,true,1613778065,28,1593573031,-20205034
1677264179,202458,true,1613616703,28,1593573031,-20043672
1677264443,202461,true,1613132715,28,1593573031,-19559684
1677264563,202464,true,1612648872,28,1593732388,-18916484
1677264719,202469,true,1611842789,28,1593732388,-18110401
1677265223,202470,true,1611681621,28,1594210555,-17471066
1677265499,202473,true,1611198213,28,1594529413,-16668800
1677267083,202476,true,1610714951,28,1595326838,-15388113
1677267383,202481,true,1609909835,28,1595326838,-14582997
1677267395,202482,true,1609748860,28,1595326838,-14422022
1677267419,202485,true,1609266032,28,1595326838,-13939194
1677267443,202488,true,1608783348,28,1595326838,-13456510
1677267455,202493,true,1607979198,28,1595326838,-12652360
1677267551,202494,true,1607818416,28,1595167321,-12651095
1677267575,202497,true,1607336167,28,1595167321,-12168846
1677267587,202500,true,1606854063,28,1595167321,-11686742
1677268139,202504,true,1606211482,28,1595645919,-10565563
1677268259,202505,true,1606050877,28,1595805484,-10245393
1677268271,202508,true,1605569158,28,1595805484,-9763674
1677268307,202511,true,1605087583,28,1595965064,-9122519
1677268367,202515,true,1604445709,28,1595965064,-8480645
1677268391,202515,true,1604445709,28,1596124661,-8321048
1677268463,202517,true,1604124868,28,1596284273,-7840595
1677268475,202520,true,1603643727,28,1596443901,-7199826
1677268511,202523,true,1603162730,28,1596603546,-6559184
1677268655,202523,true,1603162730,28,1597242283,-5920447
1677268691,202525,true,1602842145,28,1597402007,-5440138
1677268751,202527,true,1602521625,28,1597881276,-4640349
1677268763,202531,true,1601880776,28,1597881276,-3999500
1677268811,202530,true,1602040964,28,1598200868,-3840096
1677268847,202532,true,1601720604,28,1598360688,-3359916
1677268859,202533,true,1601560448,28,1598520524,-3039924
1677268931,202536,true,1601080076,28,1599000128,-2079948
1677268943,202536,true,1601080076,28,1599160028,-1920048
1677268955,202537,true,1600919984,28,1599319944,-1600040
1677268979,202539,true,1600599848,28,1599479876,-1119972
1677268991,202541,true,1600279776,28,1599639824,-639952
1677269015,202540,true,1600439804,28,1599959768,-480036
1677269027,202542,true,1600119764,28,1600119764,0
1677269051,202542,true,1600119764,28,1600439804,320040
1677269315,202544,true,1599799788,28,1603804091,4004303
1677269879,202543,true,1599959768,28,1610553895,10594127
1677270323,202544,true,1599799788,28,1615231046,15431258
1677271055,202544,true,1599799788,28,1617979137,18179349
1677271379,202546,true,1599479876,28,1617332107,17852231
1677271391,202545,true,1599639824,28,1617332107,17692283
1677271547,202546,true,1599479876,28,1616847004,17367128
1677273047,202547,true,1599319944,28,1612810137,13490193
1677273131,202548,true,1599160028,28,1612648872,13488844
1677273611,202547,true,1599319944,28,1612165174,12845230
1677273719,202548,true,1599160028,28,1612165174,13005146
1677273779,202549,true,1599000128,28,1612003974,13003846
1677273791,202550,true,1598840244,28,1612003974,13163730
1677274115,202548,true,1599160028,28,1611520469,12360441
1677274163,202549,true,1599000128,28,1611359333,12359205
1677275051,202549,true,1599000128,28,1610070826,11070698
1677275075,202549,true,1599000128,28,1609909835,10909707
1677275147,202548,true,1599160028,28,1609909835,10749807
1677275207,202548,true,1599160028,28,1609909835,10749807
1677275255,202548,true,1599160028,28,1609748860,10588832
1677275315,202549,true,1599000128,28,1609587901,10587773
1677275543,202548,true,1599160028,28,1609105121,9945093
1677275579,202548,true,1599160028,28,1609105121,9945093
1677275723,202548,true,1599160028,28,1608783348,9623320
1677276227,202549,true,1599000128,28,1607818416,8818288
1677276263,202547,true,1599319944,28,1607818416,8498472
1677278303,202547,true,1599319944,28,1605408617,6088673
1677278315,202547,true,1599319944,28,1605408617,6088673
1677278339,202547,true,1599319944,28,1605408617,6088673
1677278363,202545,true,1599639824,28,1605408617,5768793
1677278375,202545,true,1599639824,28,1605408617,5768793
1677278387,202544,true,1599799788,28,1605408617,5608829
1677279359,202543,true,1599959768,28,1601880776,1921008
1677279911,202541,true,1600279776,28,1600439804,160028
1677280091,202541,true,1600279776,28,1599959768,-320008
1677280199,202540,true,1600439804,28,1599959768,-480036
1677280307,202539,true,1600599848,28,1600119764,-480084
1677280355,202537,true,1600919984,28,1600119764,-800220
1677280379,202537,true,1600919984,28,1600119764,-800220
1677280487,202537,true,1600919984,28,1600439804,-480180
1677280811,202536,true,1601080076,28,1601400308,320232
1677281063,202534,true,1601400308,28,1602201169,800861
1677281543,202534,true,1601400308,28,1603483378,2083070
1677281603,202533,true,1601560448,28,1603643727,2083279
1677281639,202532,true,1601720604,28,1603804091,2083487
1677282623,202529,true,1602201169,28,1605890288,3689119
1677285491,202529,true,1602201169,28,1607014748,4813579
1677288143,202529,true,1602201169,28,1607014748,4813579
1677290555,202527,true,1602521625,28,1607014748,4493123
1677291731,202525,true,1602842145,28,1607014748,4172603
1677291875,202525,true,1602842145,28,1607014748,4172603
1677291923,202524,true,1603002429,28,1607014748,4012319
1677291947,202523,true,1603162730,28,1607014748,3852018
1677291959,202521,true,1603483378,28,1607014748,3531370
1677291971,202521,true,1603483378,28,1607014748,3531370
1677291995,202522,true,1603323046,28,1606854063,3531017
1677292043,202521,true,1603483378,28,1606854063,3370685
1677292619,202519,true,1603804091,28,1604927091,1123000
1677292667,202519,true,1603804091,28,1604766614,962523
1677292763,202520,true,1603643727,28,1604445709,801982
1677293135,202519,true,1603804091,28,1603162730,-641361
1677293255,202518,true,1603964471,28,1602681877,-1282594
1677294287,202518,true,1603964471,28,1599319944,-4644527
1677296543,202519,true,1603804091,28,1598200868,-5603223
1677299327,202518,true,1603964471,28,1598041064,-5923407
1677300071,202517,true,1604124868,28,1598041064,-6083804
1677304727,202518,true,1603964471,28,1598520524,-5443947
1677305159,202518,true,1603964471,28,1598520524,-5443947
1677311027,202517,true,1604124868,28,1598360688,-5764180
1677311807,202517,true,1604124868,28,1598360688,-5764180
1677311891,202517,true,1604124868,28,1598520524,-5604344
1677312131,202517,true,1604124868,28,1598680376,-5444492
1677312371,202516,true,1604285280,28,1598840244,-5445036
1677312395,202515,true,1604445709,28,1598840244,-5605465
1677312431,202515,true,1604445709,28,1599000128,-5445581
1677312479,202516,true,1604285280,28,1599000128,-5285152
1677312491,202515,true,1604445709,28,1599000128,-5445581
1677312899,202514,true,1604606153,28,1599639824,-4966329
1677313295,202514,true,1604606153,28,1600279776,-4326377
1677313463,202514,true,1604606153,28,1600759908,-3846245
1677313799,202513,true,1604766614,28,1601400308,-3366306
1677314795,202512,true,1604927091,28,1602521625,-2405466
1677318347,202512,true,1604927091,28,1602842145,-2084946
1677319331,202513,true,1604766614,28,1602842145,-1924469
1677321407,202511,true,1605087583,28,1602842145,-2245438
1677321659,202510,true,1605248092,28,1602842145,-2405947
1677321755,202510,true,1605248092,28,1602842145,-2405947
1677321803,202511,true,1605087583,28,1602842145,-2245438
1677322907,202510,true,1605248092,28,1602201169,-3046923
1677324167,202509,true,1605408617,28,1601720604,-3688013
1677328019,202509,true,1605408617,28,1601720604,-3688013
1677328739,202510,true,1605248092,28,1601720604,-3527488
1677328799,202509,true,1605408617,28,1601720604,-3688013
1677328919,202508,true,1605569158,28,1601560448,-4008710
1677329123,202509,true,1605408617,28,1601400308,-4008309
1677329159,202510,true,1605248092,28,1601400308,-3847784
1677329291,202509,true,1605408617,28,1601240184,-4168433
1677331811,202509,true,1605408617,28,1598840244,-6568373
1677332843,202510,true,1605248092,28,1598840244,-6407848
1677334379,202511,true,1605087583,28,1598840244,-6247339
1677334631,202511,true,1605087583,28,1598840244,-6247339
1677334883,202511,true,1605087583,28,1598840244,-6247339
1677336767,202512,true,1604927091,28,1598840244,-6086847
1677339407,202513,true,1604766614,28,1598840244,-5926370
1677340847,202513,true,1604766614,28,1598840244,-5926370
1677341771,202513,true,1604766614,28,1598680376,-6086238
1677342143,202514,true,1604606153,28,1598680376,-5925777
1677343811,202515,true,1604445709,28,1598520524,-5925185
1677346799,202516,true,1604285280,28,1598520524,-5764756
1677347015,202517,true,1604124868,28,1598520524,-5604344
1677347063,202518,true,1603964471,28,1598520524,-5443947
1677347303,202519,true,1603804091,28,1598520524,-5283567
1677347603,202520,true,1603643727,28,1598520524,-5123203
1677349403,202521,true,1603483378,28,1598520524,-4962854
1677349943,202522,true,1603323046,28,1598520524,-4802522
1677350051,202524,true,1603002429,28,1598200868,-4801561
1677350243,202525,true,1602842145,28,1597561748,-5280397
1677350327,202526,true,1602681877,28,1597402007,-5279870
1677350375,202527,true,1602521625,28,1597242283,-5279342
1677350387,202528,true,1602361389,28,1597242283,-5119106
1677350399,202529,true,1602201169,28,1597242283,-4958886
1677350543,202530,true,1602040964,28,1596603546,-5437418
1677351011,202532,true,1601720604,28,1594688866,-7031738
1677351203,202533,true,1601560448,28,1594051150,-7509298
1677351587,202534,true,1601400308,28,1592298746,-9101562
1677351671,202535,true,1601240184,28,1591980334,-9259850
1677352151,202536,true,1601080076,28,1590866393,-10213683
1677352979,202537,true,1600919984,28,1590230206,-10689778
1677352991,202538,true,1600759908,28,1590230206,-10529702
1677353075,202539,true,1600599848,28,1590230206,-10369642
1677353243,202541,true,1600279776,28,1590071198,-10208578
1677353303,202541,true,1600279776,28,1590071198,-10208578
1677353327,202542,true,1600119764,28,1590071198,-10048566
1677353351,202543,true,1599959768,28,1589912207,-10047561
1677353375,202545,true,1599639824,28,1589912207,-9727617
1677353399,202546,true,1599479876,28,1589753232,-9726644
1677353507,202547,true,1599319944,28,1589276401,-10043543
1677353651,202548,true,1599160028,28,1588799714,-10360314
1677353663,202550,true,1598840244,28,1588640850,-10199394
1677355523,202551,true,1598680376,28,1581350247,-17330129
1677356615,202553,true,1598360688,28,1581666533,-16694155
1677357899,202554,true,1598200868,28,1580875937,-17324931
1677357911,202555,true,1598041064,28,1580717865,-17323199
1677357935,202556,true,1597881276,28,1580559809,-17321467
1677357959,202557,true,1597721504,28,1580401769,-17319735
1677358079,202561,true,1597082575,28,1579138017,-17944558
1677358235,202563,true,1596763206,28,1577717503,-19045703
1677358247,202564,true,1596603546,28,1577559747,-19043799
1677358283,202565,true,1596443901,28,1577244282,-19199619
1677358295,202569,true,1595805484,28,1577244282,-18561202
1677358343,202571,true,1595486370,28,1576928881,-18557489
1677358367,202572,true,1595326838,28,1576771204,-18555634
1677358883,202573,true,1595167321,28,1573620970,-21546351
1677358991,202577,true,1594529413,28,1572991679,-21537734
1677359051,202578,true,1594369976,28,1572677128,-21692848
1677360035,202580,true,1594051150,28,1570319998,-23731152
1677360083,202580,true,1594051150,28,1570477030,-23574120
1677360143,202585,true,1593254364,28,1570477030,-22777334
1677360695,202587,true,1592935761,28,1570477030,-22458731
1677360827,202588,true,1592776483,28,1570319998,-22456485
1677362183,202589,true,1592617221,28,1569692027,-22925194
1677362351,202594,true,1591821152,28,1569692027,-22129125
1677362375,202595,true,1591661985,28,1569848996,-21812989
1677362423,202596,true,1591502835,28,1569848996,-21653839
1677362663,202597,true,1591343701,28,1570162982,-21180719
1677363335,202601,true,1590707322,28,1571419552,-19287770
1677363443,202602,true,1590548267,28,1571576694,-18971573
1677363503,202603,true,1590389229,28,1571733852,-18655377
1677363623,202604,true,1590230206,28,1572048214,-18181992
1677363791,202607,true,1589753232,28,1572519876,-17233356
1677363803,202608,true,1589594272,28,1572519876,-17074396
1677363827,202609,true,1589435329,28,1572677128,-16758201
1677363839,202610,true,1589276401,28,1572677128,-16599273
1677363875,202613,true,1588799714,28,1572834395,-15965319
1677363887,202613,true,1588799714,28,1572834395,-15965319
1677364187,202614,true,1588640850,28,1574565379,-14075471
1677364331,202613,true,1588799714,28,1575510354,-13289360
1677364967,202616,true,1588323169,28,1579138017,-9185152
1677365015,202617,true,1588164353,28,1579453860,-8710493
1677365615,202617,true,1588164353,28,1582932309,-5232044
1677365627,202617,true,1588164353,28,1582932309,-5232044
1677365639,202619,true,1587846767,28,1583090603,-4756164
1677365651,202620,true,1587687999,28,1583090603,-4597396
1677365663,202620,true,1587687999,28,1583248912,-4439087
1677365783,202619,true,1587846767,28,1583723934,-4122833
1677365855,202622,true,1587370509,28,1584040695,-3329814
1677366131,202623,true,1587211787,28,1585149856,-2061931
1677367103,202622,true,1587370509,28,1587687999,317490
1677367259,202622,true,1587370509,28,1588005552,635043
1677367487,202625,true,1586894393,28,1588640850,1746457
1677367763,202625,true,1586894393,28,1589276401,2382008
1677367835,202625,true,1586894393,28,1589276401,2382008
1677368255,202624,true,1587053082,28,1590389229,3336147
1677369191,202627,true,1586577061,28,1592298746,5721685
1677376019,202628,true,1586418420,28,1592457976,6039556
1677376031,202627,true,1586577061,28,1592457976,5880915
1677379499,202627,true,1586577061,28,1592298746,5721685
1677379547,202629,true,1586259794,28,1592457976,6198182
1677379667,202630,true,1586101183,28,1592617221,6516038
1677379763,202629,true,1586259794,28,1592776483,6516689
1677379847,202628,true,1586418420,28,1592935761,6517341
1677379931,202631,true,1585942589,28,1593095054,7152465
1677379955,202631,true,1585942589,28,1593254364,7311775
1677380147,202630,true,1586101183,28,1593891761,7790578
1677380303,202629,true,1586259794,28,1594369976,8110182
1677380339,202631,true,1585942589,28,1594529413,8586824
1677381887,202632,true,1585784011,28,1599639824,13855813
1677382355,202631,true,1585942589,28,1599799788,13857199
1677382391,202629,true,1586259794,28,1599799788,13539994
1677382451,202631,true,1585942589,28,1599799788,13857199
1677382463,202631,true,1585942589,28,1599799788,13857199
1677382499,202630,true,1586101183,28,1599799788,13698605
1677383759,202628,true,1586418420,28,1601400308,14981888
1677383867,202630,true,1586101183,28,1601560448,15459265
1677384191,202631,true,1585942589,28,1602040964,16098375
1677384251,202629,true,1586259794,28,1602040964,15781170
1677387719,202628,true,1586418420,28,1602040964,15622544
1677389039,202630,true,1586101183,28,1602040964,15939781
1677389711,202630,true,1586101183,28,1599959768,13858585
1677390527,202629,true,1586259794,28,1597721504,11461710
1677392279,202628,true,1586418420,28,1597242283,10823863
1677393059,202630,true,1586101183,28,1597242283,11141100
1677394283,202630,true,1586101183,28,1597242283,11141100
1677395735,202629,true,1586259794,28,1597242283,10982489
1677397559,202628,true,1586418420,28,1597242283,10823863
1677397607,202630,true,1586101183,28,1597402007,11300824
1677398927,202631,true,1585942589,28,1598041064,12098475
1677401003,202629,true,1586259794,28,1598200868,11941074
1677401183,202628,true,1586418420,28,1598840244,12421824
1677401435,202630,true,1586101183,28,1599799788,13698605
1677412175,202628,true,1586418420,28,1605087583,18669163
1677413639,202627,true,1586577061,28,1605087583,18510522
1677413687,202625,true,1586894393,28,1605087583,18193190
1677415175,202627,true,1586577061,28,1605087583,18510522
1677415511,202625,true,1586894393,28,1604927091,18032698
1677415667,202624,true,1587053082,28,1604766614,17713532
1677415703,202622,true,1587370509,28,1604766614,17396105
1677416135,202624,true,1587053082,28,1604445709,17392627
1677416159,202622,true,1587370509,28,1604445709,17075200
1677416183,202621,true,1587529246,28,1604285280,16756034
1677416243,202619,true,1587846767,28,1604285280,16438513
1677416267,202621,true,1587529246,28,1604285280,16756034
1677416399,202619,true,1587846767,28,1603964471,16117704
1677416999,202618,true,1588005552,28,1603002429,14996877
1677417083,202616,true,1588323169,28,1602842145,14518976
1677417527,202618,true,1588005552,28,1601720604,13715052
1677417803,202616,true,1588323169,28,1601080076,12756907
1677418991,202615,true,1588482001,28,1599160028,10678027
1677419663,202613,true,1588799714,28,1599319944,10520230
1677420407,202615,true,1588482001,28,1599479876,10997875
1677420647,202613,true,1588799714,28,1599639824,10840110
1677420659,202611,true,1589117490,28,1599639824,10522334
1677420671,202609,true,1589435329,28,1599639824,10204495
1677420815,202610,true,1589276401,28,1599799788,10523387
1677420899,202608,true,1589594272,28,1599959768,10365496
1677420911,202606,true,1589912207,28,1600119764,10207557
1677420923,202603,true,1590389229,28,1600119764,9730535
1677422075,202600,true,1590866393,28,1606854063,15987670
1677422147,202598,true,1591184582,28,1607336167,16151585
1677422183,202596,true,1591502835,28,1607496901,15994066
1677425603,202594,true,1591821152,28,1607818416,15997264
1677425711,202591,true,1592298746,28,1607818416,15519670
1677426983,202589,true,1592617221,28,1607496901,14879680
1677427043,202587,true,1592935761,28,1607336167,14400406
1677428039,202585,true,1593254364,28,1607175450,13921086
1677428543,202582,true,1593732388,28,1607175450,13443062
1677428783,202580,true,1594051150,28,1607175450,13124300
1677429239,202579,true,1594210555,28,1607175450,12964895
1677429599,202577,true,1594529413,28,1607014748,12485335
1677430295,202574,true,1595007820,28,1606854063,11846243
1677434423,202573,true,1595167321,28,1603483378,8316057
1677434471,202571,true,1595486370,28,1603643727,8157357
1677435083,202569,true,1595805484,28,1603804091,7998607
1677435107,202567,true,1596124661,28,1603804091,7679430
1677435263,202565,true,1596443901,28,1604124868,7680967
1677435299,202563,true,1596763206,28,1604124868,7361662
1677435479,202561,true,1597082575,28,1604445709,7363134
1677435803,202559,true,1597402007,28,1605087583,7685576
1677435887,202557,true,1597721504,28,1605248092,7526588
1677436715,202555,true,1598041064,28,1606693393,8652329
1677436727,202554,true,1598200868,28,1606693393,8492525
1677436739,202552,true,1598520524,28,1606693393,8172869
1677436751,202550,true,1598840244,28,1606693393,7853149
1677436763,202548,true,1599160028,28,1606854063,7694035
1677436787,202546,true,1599479876,28,1606854063,7374187
1677436859,202544,true,1599799788,28,1607175450,7375662
1677436871,202542,true,1600119764,28,1607175450,7055686
1677436931,202540,true,1600439804,28,1607496901,7057097
1677436943,202539,true,1600599848,28,1607496901,6897053
1677437015,202537,true,1600919984,28,1607979198,7059214
1677437039,202535,true,1601240184,28,1607979198,6739014
1677437075,202533,true,1601560448,28,1608300810,6740362
1677437087,202532,true,1601720604,28,1608300810,6580206
1677437111,202529,true,1602201169,28,1608461640,6260471
1677437123,202528,true,1602361389,28,1608622486,6261097
1677437147,202526,true,1602681877,28,1608783348,6101471
1677437171,202524,true,1603002429,28,1608944227,5941798
1677437243,202522,true,1603323046,28,1609587901,6264855
1677437603,202520,true,1603643727,28,1612971418,9327691
1677437615,202518,true,1603964471,28,1613132715,9168244
1677437663,202516,true,1604285280,28,1613616703,9331423
1677437723,202514,true,1604606153,28,1614262247,9656094
1677437831,202511,true,1605087583,28,1615554109,10466526
1677438131,202510,true,1605248092,28,1618950167,13702075
1677438443,202508,true,1605569158,28,1622515600,16946442
1677439163,202506,true,1605890288,28,1627064782,21174494
1677439175,202504,true,1606211482,28,1627064782,20853300
1677439235,202502,true,1606532740,28,1627227488,20694748
1677439283,202501,true,1606693393,28,1627390211,20696818
1677439319,202498,true,1607175450,28,1627552950,20377500
1677439403,202495,true,1607657650,28,1627878477,20220827
1677439511,202493,true,1607979198,28,1628204069,20224871
1677442259,202493,true,1607979198,28,1631300442,23321244
1677442835,202490,true,1608461640,28,1631463573,23001933
1677442847,202487,true,1608944227,28,1631463573,22519346
1677443399,202486,true,1609105121,28,1631463573,22358452
1677443591,202485,true,1609266032,28,1631626719,22360687
1677443603,202483,true,1609587901,28,1631626719,22038818
1677443615,202480,true,1610070826,28,1631626719,21555893
1677443639,202478,true,1610392856,28,1631789882,21397026
1677443651,202477,true,1610553895,28,1631789882,21235987
1677444275,202473,true,1611198213,28,1636692356,25494143
1677444287,202470,true,1611681621,28,1636856025,25174404
1677444467,202469,true,1611842789,28,1638165969,26323180
1677445355,202467,true,1612165174,28,1645060389,32895215
1677445367,202463,true,1612810137,28,1645060389,32250252
1677445379,202461,true,1613132715,28,1645224895,32092180
1677446171,202459,true,1613455358,28,1644731426,31276068
1677446219,202458,true,1613616703,28,1644566970,30950267
1677448571,202454,true,1614262247,28,1643744933,29482686
1677449819,202452,true,1614585115,28,1643744933,29159818
1677449927,202450,true,1614908049,28,1643744933,28836884
1677449963,202448,true,1615231046,28,1643580575,28349529
1677450011,202444,true,1615877236,28,1643580575,27703339
1677450023,202442,true,1616200427,28,1643580575,27380148
1677450155,202440,true,1616523683,28,1643416233,26892550
1677450239,202438,true,1616847004,28,1643087599,26240595
1677450263,202434,true,1617493840,28,1643087599,25593759
1677450275,202432,true,1617817355,28,1643087599,25270244
1677450287,202431,true,1617979137,28,1643087599,25108462
1677450371,202430,true,1618140935,28,1642759031,24618096
1677450443,202426,true,1618788288,28,1642430528,23642240
1677450467,202425,true,1618950167,28,1642266302,23316135
1677450527,202424,true,1619112062,28,1641937898,22825836
1677450539,202423,true,1619273973,28,1641937898,22663925
1677450551,202419,true,1619921780,28,1641937898,22016118
1677450659,202419,true,1619921780,28,1641117175,21195395
1677450719,202418,true,1620083772,28,1640789001,20705229
1677450743,202417,true,1620245781,28,1640624938,20379157
1677451055,202414,true,1620731903,28,1637838385,17106482
1677451439,202413,true,1620893976,28,1634402704,13508728
1677451451,202413,true,1620893976,28,1634239280,13345304
1677451475,202412,true,1621056066,28,1634075873,13019807
1677451967,202408,true,1621704585,28,1630648085,8943500
1677452123,202407,true,1621866756,28,1629833006,7966250
1677452579,202407,true,1621866756,28,1629018334,7151578
1677452603,202406,true,1622028942,28,1629181236,7152294
1677452675,202401,true,1622840119,28,1629344154,6504035
1677452711,202401,true,1622840119,28,1629344154,6504035
1677452723,202399,true,1623164703,28,1629507088,6342385
1677452735,202398,true,1623327020,28,1629507088,6180068
1677452747,202394,true,1623976448,28,1629507088,5530640
1677453599,202392,true,1624301260,28,1633912482,9611222
1677455243,202391,true,1624463690,28,1638165969,13702279
1677455483,202390,true,1624626136,28,1638165969,13539833
1677456899,202386,true,1625276084,28,1638165969,12889885
1677459215,202384,true,1625601155,28,1638329785,12728630
1677459995,202383,true,1625763716,28,1638329785,12566069
1677460163,202382,true,1625926292,28,1638329785,12403493
1677460499,202379,true,1626414119,28,1638002168,11588049
1677462107,202378,true,1626576760,28,1636201447,9624687
1677462263,202377,true,1626739418,28,1636201447,9462029
1677462515,202376,true,1626902092,28,1636201447,9299355
1677462575,202373,true,1627390211,28,1636365067,8974856
1677462875,202372,true,1627552950,28,1636365067,8812117
1677462923,202371,true,1627715705,28,1636365067,8649362
1677463031,202369,true,1628041265,28,1636528703,8487438
1677463043,202367,true,1628366889,28,1636528703,8161814
1677463079,202365,true,1628692579,28,1636528703,7836124
1677463127,202364,true,1628855448,28,1636692356,7836908
1677463211,202362,true,1629181236,28,1636692356,7511120
1677463247,202359,true,1629670039,28,1636856025,7185986
1677463355,202358,true,1629833006,28,1637019711,7186705
1677463367,202356,true,1630158989,28,1637019711,6860722
1677463379,202354,true,1630485037,28,1637019711,6534674
1677463427,202351,true,1630974231,28,1637183413,6209182
1677463463,202349,true,1631300442,28,1637347131,6046689
1677463487,202348,true,1631463573,28,1637347131,5883558
1677463511,202347,true,1631626719,28,1637510866,5884147
1677463535,202343,true,1632279467,28,1637674617,5395150
1677465383,202341,true,1632605940,28,1645060389,12454449
1677465611,202340,true,1632769200,28,1645224895,12455695
1677465779,202338,true,1633095770,28,1645224895,12129125
1677467783,202335,true,1633585748,28,1644566970,10981222
1677468323,202333,true,1633912482,28,1644566970,10654488
1677470939,202332,true,1634075873,28,1644566970,10491097
1677471107,202331,true,1634239280,28,1644566970,10327690
1677471143,202328,true,1634729601,28,1644566970,9837369
1677471239,202325,true,1635220069,28,1644566970,9346901
1677471311,202325,true,1635220069,28,1644566970,9346901
1677471335,202324,true,1635383591,28,1644402529,9018938
1677472871,202322,true,1635710684,28,1642266302,6555618
1677472895,202320,true,1636037843,28,1642266302,6228459
1677473147,202319,true,1636201447,28,1641937898,5736451
1677473207,202318,true,1636365067,28,1641773720,5408653
1677473447,202317,true,1636528703,28,1641609559,5080856
1677473567,202315,true,1636856025,28,1641609559,4753534
1677474011,202315,true,1636856025,28,1641281287,4425262
1677475199,202314,true,1637019711,28,1640624938,3605227
1677475595,202313,true,1637183413,28,1640460892,3277479
1677475703,202311,true,1637510866,28,1640460892,2950026
1677476471,202311,true,1637510866,28,1640132849,2621983
1677476951,202310,true,1637674617,28,1639968852,2294235
1677476999,202309,true,1637838385,28,1639968852,2130467
1677477035,202308,true,1638002168,28,1639968852,1966684
1677477047,202308,true,1638002168,28,1639804872,1802704
1677477563,202308,true,1638002168,28,1638821333,819165
1677480347,202307,true,1638165969,28,1636365067,-1800902
1677483287,202306,true,1638329785,28,1636365067,-1964718
1677484223,202306,true,1638329785,28,1636528703,-1801082
1677485471,202306,true,1638329785,28,1636528703,-1801082
1677487271,202306,true,1638329785,28,1636528703,-1801082
1677488003,202305,true,1638493618,28,1636528703,-1964915
1677488099,202305,true,1638493618,28,1636528703,-1964915
1677488207,202305,true,1638493618,28,1636528703,-1964915
1677488927,202305,true,1638493618,28,1636528703,-1964915
1677489083,202304,true,1638657468,28,1636528703,-2128765
1677489791,202304,true,1638657468,28,1636528703,-2128765
1677490043,202304,true,1638657468,28,1636528703,-2128765
1677490127,202304,true,1638657468,28,1636528703,-2128765
1677493571,202303,true,1638821333,28,1636528703,-2292630
1677493991,202303,true,1638821333,28,1636528703,-2292630
1677494075,202305,true,1638493618,28,1636528703,-1964915
1677495155,202305,true,1638493618,28,1636528703,-1964915
1677497879,202304,true,1638657468,28,1636365067,-2292401
1677497891,202305,true,1638493618,28,1636528703,-1964915
1677498143,202306,true,1638329785,28,1636528703,-1801082
1677498167,202307,true,1638165969,28,1636528703,-1637266
1677498515,202306,true,1638329785,28,1636856025,-1473760
1677498575,202307,true,1638165969,28,1636856025,-1309944
1677498611,202308,true,1638002168,28,1636856025,-1146143
1677499055,202309,true,1637838385,28,1637347131,-491254
1677500303,202307,true,1638165969,28,1638329785,163816
1677500411,202308,true,1638002168,28,1638329785,327617
1677500459,202309,true,1637838385,28,1638329785,491400
1677502223,202310,true,1637674617,28,1638329785,655168
1677502415,202308,true,1638002168,28,1638493618,491450
1677503171,202308,true,1638002168,28,1638657468,655300
1677503219,202309,true,1637838385,28,1638657468,819083
1677503555,202310,true,1637674617,28,1638821333,1146716
1677503567,202308,true,1638002168,28,1638821333,819165
1677503783,202308,true,1638002168,28,1639149114,1146946
1677503795,202309,true,1637838385,28,1639149114,1310729
1677503831,202309,true,1637838385,28,1639313029,1474644
1677503927,202307,true,1638165969,28,1639476960,1310991
1677503939,202307,true,1638165969,28,1639640908,1474939
1677503999,202307,true,1638165969,28,1639804872,1638903
1677504119,202307,true,1638165969,28,1640296863,2130894
1677504131,202305,true,1638493618,28,1640296863,1803245
1677504599,202304,true,1638657468,28,1641937898,3280430
1677504623,202304,true,1638657468,28,1642102092,3444624
1677504635,202303,true,1638821333,28,1642102092,3280759
1677504647,202301,true,1639149114,28,1642266302,3117188
1677504683,202299,true,1639476960,28,1642430528,2953568
1677504695,202299,true,1639476960,28,1642594771,3117811
1677504719,202298,true,1639640908,28,1642759031,3118123
1677504767,202295,true,1640132849,28,1643416233,3283384
1677504995,202293,true,1640460892,28,1645718512,5257620
1677505319,202293,true,1640460892,28,1649342897,8882005
1677506231,202292,true,1640624938,28,1657941387,17316449
1677507731,202289,true,1641117175,28,1660430040,19312865
1677509123,202287,true,1641445415,28,1660430040,18984625
1677509459,202287,true,1641445415,28,1660098004,18652589
1677510911,202286,true,1641609559,28,1658438819,16829260
1677510923,202284,true,1641937898,28,1658438819,16500921
1677511247,202283,true,1642102092,28,1658438819,16336727
1677512183,202283,true,1642102092,28,1658770523,16668431
1677512219,202281,true,1642430528,28,1658770523,16339995
1677512231,202280,true,1642594771,28,1658770523,16175752
1677512291,202278,true,1642923307,28,1658604663,15681356
1677512303,202279,true,1642759031,28,1658604663,15845632
1677512423,202278,true,1642923307,28,1658107181,15183874
1677512519,202276,true,1643251908,28,1657775609,14523701
1677512531,202275,true,1643416233,28,1657775609,14359376
1677512579,202276,true,1643251908,28,1657609848,14357940
1677512591,202275,true,1643416233,28,1657444104,14027871
1677512615,202273,true,1643744933,28,1657278376,13533443
1677514391,202273,true,1643744933,28,1644566970,822037
1677514403,202274,true,1643580575,28,1644566970,986395
1677515543,202274,true,1643580575,28,1640460892,-3119683
1677515567,202273,true,1643744933,28,1640460892,-3284041
1677515591,202273,true,1643744933,28,1640296863,-3448070
1677515603,202274,true,1643580575,28,1640132849,-3447726
1677515627,202275,true,1643416233,28,1639968852,-3447381
1677515639,202274,true,1643580575,28,1639968852,-3611723
1677515663,202275,true,1643416233,28,1639804872,-3611361
1677515903,202276,true,1643251908,28,1637674617,-5577291
1677516011,202278,true,1642923307,28,1636856025,-6067282
1677516023,202277,true,1643087599,28,1636692356,-6395243
1677516035,202278,true,1642923307,28,1636528703,-6394604
1677516047,202279,true,1642759031,28,1636528703,-6230328
1677516059,202280,true,1642594771,28,1636365067,-6229704
1677516071,202280,true,1642594771,28,1636365067,-6229704
1677516155,202281,true,1642430528,28,1635710684,-6719844
1677516359,202282,true,1642266302,28,1635383591,-6882711
1677517751,202282,true,1642266302,28,1635874255,-6392047
1677518159,202282,true,1642266302,28,1636528703,-5737599
1677518219,202283,true,1642102092,28,1636528703,-5573389
1677518495,202283,true,1642102092,28,1636528703,-5573389
1677518531,202284,true,1641937898,28,1636528703,-5409195
1677518543,202283,true,1642102092,28,1636528703,-5573389
1677519815,202285,true,1641773720,28,1634566145,-7207575
1677520067,202285,true,1641773720,28,1634239280,-7534440
1677520319,202286,true,1641609559,28,1633912482,-7697077
1677520823,202285,true,1641773720,28,1633912482,-7861238
1677521471,202286,true,1641609559,28,1633912482,-7697077
1677521567,202287,true,1641445415,28,1633912482,-7532933
1677521687,202287,true,1641445415,28,1633749107,-7696308
1677521975,202287,true,1641445415,28,1633259080,-8186335
1677521999,202288,true,1641281287,28,1633259080,-8022207
1677522011,202289,true,1641117175,28,1633259080,-7858095
1677522059,202290,true,1640953080,28,1632932477,-8020603
1677522191,202290,true,1640953080,28,1632279467,-8673613
1677522239,202292,true,1640624938,28,1631953061,-8671877
1677522335,202293,true,1640460892,28,1631300442,-9160450
1677522347,202293,true,1640460892,28,1631300442,-9160450
1677525155,202294,true,1640296863,28,1621380293,-18916570
1677525227,202296,true,1639968852,28,1621542431,-18426421
1677528167,202296,true,1639968852,28,1622191145,-17777707
1677528203,202296,true,1639968852,28,1622191145,-17777707
1677528311,202297,true,1639804872,28,1621866756,-17938116
1677528335,202299,true,1639476960,28,1621866756,-17610204
1677528371,202300,true,1639313029,28,1621704585,-17608444
1677528671,202301,true,1639149114,28,1620407805,-18741309
1677528743,202302,true,1638985215,28,1620245781,-18739434
1677529787,202304,true,1638657468,28,1616200427,-22457041
1677531107,202305,true,1638493618,28,1615877236,-22616382
1677531119,202306,true,1638329785,28,1615877236,-22452549
1677531227,202307,true,1638165969,28,1615877236,-22288733
1677531251,202308,true,1638002168,28,1615877236,-22124932
1677531431,202309,true,1637838385,28,1616200427,-21637958
1677531659,202310,true,1637674617,28,1616523683,-21150934
1677531683,202311,true,1637510866,28,1616523683,-20987183
1677531755,202312,true,1637347131,28,1616685336,-20661795
1677532235,202313,true,1637183413,28,1617979137,-19204276
1677532295,202313,true,1637183413,28,1618140935,-19042478
1677532331,202314,true,1637019711,28,1618302749,-18716962
1677532499,202316,true,1636692356,28,1618788288,-17904068
1677533051,202316,true,1636692356,28,1620569846,-16122510
1677533111,202317,true,1636528703,28,1620731903,-15796800
1677534095,202318,true,1636365067,28,1622191145,-14173922
1677534131,202319,true,1636201447,28,1622353364,-13848083
1677534299,202319,true,1636201447,28,1622353364,-13848083
1677534383,202320,true,1636037843,28,1622515600,-13522243
1677535667,202321,true,1635874255,28,1623489353,-12384902
1677535679,202322,true,1635710684,28,1623489353,-12221331
1677535739,202322,true,1635710684,28,1623651701,-12058983
1677537839,202323,true,1635547130,28,1626739418,-8807712
1677538403,202323,true,1635547130,28,1626739418,-8807712
1677538427,202325,true,1635220069,28,1626902092,-8317977
1677538451,202325,true,1635220069,28,1626902092,-8317977
1677538463,202325,true,1635220069,28,1626902092,-8317977
1677538523,202326,true,1635056564,28,1626902092,-8154472
1677538571,202327,true,1634893074,28,1627064782,-7828292
1677538583,202327,true,1634893074,28,1627064782,-7828292
1677538691,202328,true,1634729601,28,1627227488,-7502113
1677539807,202328,true,1634729601,28,1629833006,-4896595
1677540983,202330,true,1634402704,28,1630811150,-3591554
1677541115,202330,true,1634402704,28,1630811150,-3591554
1677541187,202331,true,1634239280,28,1630811150,-3428130
1677541535,202331,true,1634239280,28,1630811150,-3428130
1677541655,202333,true,1633912482,28,1630974231,-2938251
1677544715,202333,true,1633912482,28,1630974231,-2938251
1677548795,202334,true,1633749107,28,1630974231,-2774876
1677549647,202334,true,1633749107,28,1630974231,-2774876
1677550355,202337,true,1633259080,28,1630974231,-2284849
1677559043,202337,true,1633259080,28,1630974231,-2284849
1677559511,202339,true,1632932477,28,1630974231,-1958246
1677565703,202340,true,1632769200,28,1629344154,-3425046
1677566339,202343,true,1632279467,28,1629344154,-2935313
1677567287,202344,true,1632116256,28,1629344154,-2772102
1677570023,202345,true,1631953061,28,1629181236,-2771825
1677570407,202347,true,1631626719,28,1629181236,-2445483
1677570431,202350,true,1631137329,28,1629181236,-1956093
1677570467,202351,true,1630974231,28,1629181236,-1792995
1677570527,202352,true,1630811150,28,1629181236,-1629914
1677570647,202353,true,1630648085,28,1629018334,-1629751
1677570923,202356,true,1630158989,28,1628529726,-1629263
1677570995,202358,true,1629833006,28,1628366889,-1466117
1677571271,202359,true,1629670039,28,1627552950,-2117089
1677571295,202361,true,1629344154,28,1627390211,-1953943
1677571391,202364,true,1628855448,28,1627064782,-1790666
1677571403,202365,true,1628692579,28,1626902092,-1790487
1677572735,202367,true,1628366889,28,1619921780,-8445109
1677572783,202368,true,1628204069,28,1619759804,-8444265
1677573299,202371,true,1627715705,28,1618950167,-8765538
1677575507,202372,true,1627552950,28,1619435901,-8117049
1677575543,202374,true,1627227488,28,1619597844,-7629644
1677575651,202375,true,1627064782,28,1619597844,-7466938
1677577571,202377,true,1626739418,28,1620083772,-6655646
1677577991,202377,true,1626739418,28,1620083772,-6655646
1677580511,202378,true,1626576760,28,1620083772,-6492988
1677580859,202380,true,1626251493,28,1620083772,-6167721
1677580967,202381,true,1626088885,28,1620245781,-5843104
1677581063,202381,true,1626088885,28,1620245781,-5843104
1677581171,202381,true,1626088885,28,1620245781,-5843104
1677581303,202382,true,1625926292,28,1620245781,-5680511
1677581351,202383,true,1625763716,28,1620407805,-5355911
1677581483,202383,true,1625763716,28,1620569846,-5193870
1677581495,202383,true,1625763716,28,1620569846,-5193870
1677581807,202384,true,1625601155,28,1621056066,-4545089
1677581819,202384,true,1625601155,28,1621056066,-4545089
1677581903,202384,true,1625601155,28,1621218171,-4382984
1677583607,202385,true,1625438612,28,1623327020,-2111592
1677584087,202385,true,1625438612,28,1623327020,-2111592
1677584255,202386,true,1625276084,28,1623327020,-1949064
1677584279,202386,true,1625276084,28,1623327020,-1949064
1677584291,202387,true,1625113573,28,1623327020,-1786553
1677584375,202388,true,1624951078,28,1623489353,-1461725
1677584507,202389,true,1624788599,28,1623489353,-1299246
1677584519,202389,true,1624788599,28,1623489353,-1299246
1677584543,202390,true,1624626136,28,1623489353,-1136783
1677584771,202391,true,1624463690,28,1623814067,-649623
1677586055,202391,true,1624463690,28,1626414119,1950429
1677586139,202391,true,1624463690,28,1626576760,2113070
1677586271,202391,true,1624463690,28,1626902092,2438402
1677586487,202392,true,1624301260,28,1627227488,2926228
1677586571,202392,true,1624301260,28,1627390211,3088951
1677586595,202392,true,1624301260,28,1627390211,3088951
1677586607,202393,true,1624138846,28,1627390211,3251365
1677586739,202393,true,1624138846,28,1627715705,3576859
1677586751,202392,true,1624301260,28,1627715705,3414445
1677586823,202392,true,1624301260,28,1627715705,3414445
1677586955,202393,true,1624138846,28,1628041265,3902419
1677587015,202392,true,1624301260,28,1628204069,3902809
1677587027,202391,true,1624463690,28,1628204069,3740379
1677587183,202390,true,1624626136,28,1628692579,4066443
1677587351,202391,true,1624463690,28,1629181236,4717546
1677587387,202389,true,1624788599,28,1629344154,4555555
1677589223,202388,true,1624951078,28,1633912482,8961404
1677589235,202388,true,1624951078,28,1634075873,9124795
1677589307,202388,true,1624951078,28,1634075873,9124795
1677591539,202386,true,1625276084,28,1636365067,11088983
1677594779,202385,true,1625438612,28,1636201447,10762835
1677594875,202384,true,1625601155,28,1636201447,10600292
1677594887,202383,true,1625763716,28,1636201447,10437731
1677594899,202381,true,1626088885,28,1636201447,10112562
1677595247,202381,true,1626088885,28,1635874255,9785370
1677595259,202379,true,1626414119,28,1635874255,9460136
1677595355,202379,true,1626414119,28,1635874255,9460136
1677595403,202377,true,1626739418,28,1635874255,9134837
1677595523,202376,true,1626902092,28,1636037843,9135751
1677595559,202375,true,1627064782,28,1636201447,9136665
1677595571,202375,true,1627064782,28,1636201447,9136665
1677595583,202373,true,1627390211,28,1636201447,8811236
1677595691,202371,true,1627715705,28,1636528703,8812998
1677595727,202370,true,1627878477,28,1636692356,8813879
1677595859,202370,true,1627878477,28,1637019711,9141234
1677595871,202368,true,1628204069,28,1637019711,8815642
1677595943,202367,true,1628366889,28,1637183413,8816524
1677596171,202366,true,1628529726,28,1637510866,8981140
1677597071,202366,true,1628529726,28,1639313029,10783303
1677598931,202365,true,1628692579,28,1637674617,8982038
1677599879,202363,true,1629018334,28,1638165969,9147635
1677600095,202363,true,1629018334,28,1638329785,9311451
1677600287,202363,true,1629018334,28,1638329785,9311451
1677600323,202361,true,1629344154,28,1638493618,9149464
1677600371,202360,true,1629507088,28,1638493618,8986530
1677600395,202359,true,1629670039,28,1638493618,8823579
1677600431,202360,true,1629507088,28,1638657468,9150380
1677600455,202358,true,1629833006,28,1638657468,8824462
1677602231,202357,true,1629995989,28,1641937898,11941909
1677602771,202356,true,1630158989,28,1641937898,11778909
1677602783,202356,true,1630158989,28,1641937898,11778909
1677602843,202355,true,1630322005,28,1641937898,11615893
1677602951,202354,true,1630485037,28,1641937898,11452861
1677603035,202354,true,1630485037,28,1641773720,11288683
1677605207,202355,true,1630322005,28,1638002168,7680163
1677605219,202354,true,1630485037,28,1638165969,7680932
1677607127,202352,true,1630811150,28,1639476960,8665810
1677607475,202352,true,1630811150,28,1639640908,8829758
1677607535,202353,true,1630648085,28,1639804872,9156787
1677607679,202352,true,1630811150,28,1639804872,8993722
1677607811,202350,true,1631137329,28,1639968852,8831523
1677608135,202350,true,1631137329,28,1640296863,9159534
1677610475,202350,true,1631137329,28,1641937898,10800569
1677610895,202349,true,1631300442,28,1641937898,10637456
1677612059,202347,true,1631626719,28,1641937898,10311179
1677612155,202347,true,1631626719,28,1641937898,10311179
1677612179,202348,true,1631463573,28,1641773720,10310147
1677612275,202347,true,1631626719,28,1641773720,10147001
1677612371,202345,true,1631953061,28,1641609559,9656498
1677612467,202345,true,1631953061,28,1641445415,9492354
1677612491,202346,true,1631789882,28,1641445415,9655533
1677612503,202345,true,1631953061,28,1641281287,9328226
1677612539,202343,true,1632279467,28,1641281287,9001820
1677612551,202344,true,1632116256,28,1641117175,9000919
1677612563,202344,true,1632116256,28,1641117175,9000919
1677612623,202344,true,1632116256,28,1640789001,8672745
1677612635,202343,true,1632279467,28,1640624938,8345471
1677612647,202343,true,1632279467,28,1640460892,8181425
1677616079,202344,true,1632116256,28,1627390211,-4726045
1677617123,202343,true,1632279467,28,1627390211,-4889256
1677618287,202342,true,1632442695,28,1627552950,-4889745
1677618359,202342,true,1632442695,28,1627552950,-4889745
1677618479,202342,true,1632442695,28,1627227488,-5215207
1677618623,202341,true,1632605940,28,1626902092,-5703848
1677618671,202341,true,1632605940,28,1626902092,-5703848
1677618683,202341,true,1632605940,28,1626739418,-5866522
1677618815,202342,true,1632442695,28,1626088885,-6353810
1677619931,202342,true,1632442695,28,1619921780,-12520915
1677619955,202341,true,1632605940,28,1619759804,-12846136
1677619967,202341,true,1632605940,28,1619597844,-13008096
1677619979,202342,true,1632442695,28,1619597844,-12844851
1677619991,202343,true,1632279467,28,1619435901,-12843566
1677620027,202342,true,1632442695,28,1619273973,-13168722
1677620051,202343,true,1632279467,28,1619112062,-13167405
1677620099,202344,true,1632116256,28,1618626426,-13489830
1677620231,202345,true,1631953061,28,1617332107,-14620954
1677620243,202345,true,1631953061,28,1617332107,-14620954
1677620255,202345,true,1631953061,28,1617170390,-14782671
1677620267,202347,true,1631626719,28,1617008689,-14618030
1677620531,202349,true,1631300442,28,1614423673,-16876769
1677621767,202349,true,1631300442,28,1604606153,-26694289
1677622283,202350,true,1631137329,28,1603162730,-27974599
1677622319,202351,true,1630974231,28,1603162730,-27811501
1677622355,202354,true,1630485037,28,1603162730,-27322307
1677622415,202353,true,1630648085,28,1603323046,-27325039
1677622475,202354,true,1630485037,28,1603323046,-27161991
1677622499,202355,true,1630322005,28,1603323046,-26998959
1677622883,202358,true,1629833006,28,1603964471,-25868535
1677622895,202357,true,1629995989,28,1603964471,-26031518
1677622931,202358,true,1629833006,28,1604124868,-25708138
1677622943,202359,true,1629670039,28,1604124868,-25545171
1677623159,202361,true,1629344154,28,1604606153,-24738001
1677623939,202362,true,1629181236,28,1606693393,-22487843
1677624011,202362,true,1629181236,28,1607014748,-22166488
1677624083,202364,true,1628855448,28,1607175450,-21679998
1677624539,202366,true,1628529726,28,1607979198,-20550528
1677624599,202366,true,1628529726,28,1608139996,-20389730
1677627911,202367,true,1628366889,28,1609105121,-19261768
1677628139,202368,true,1628204069,28,1609105121,-19098948
1677628511,202370,true,1627878477,28,1609105121,-18773356
1677628607,202370,true,1627878477,28,1608944227,-18934250
1677628715,202371,true,1627715705,28,1608944227,-18771478
1677628727,202373,true,1627390211,28,1608944227,-18445984
1677629195,202375,true,1627064782,28,1608461640,-18603142
1677629387,202375,true,1627064782,28,1608300810,-18763972
1677629399,202376,true,1626902092,28,1608300810,-18601282
1677629435,202378,true,1626576760,28,1608139996,-18436764
1677629471,202381,true,1626088885,28,1608139996,-17948889
1677629483,202382,true,1625926292,28,1608139996,-17786296
1677629519,202383,true,1625763716,28,1607979198,-17784518
1677630083,202385,true,1625438612,28,1606532740,-18905872
1677630275,202388,true,1624951078,28,1606211482,-18739596
1677630659,202389,true,1624788599,28,1605569158,-19219441
1677630743,202390,true,1624626136,28,1605408617,-19217519
1677630815,202392,true,1624301260,28,1605248092,-19053168
1677631967,202394,true,1623976448,28,1605890288,-18086160
1677632015,202395,true,1623814067,28,1605890288,-17923779
1677633323,202396,true,1623651701,28,1603162730,-20488971
1677633407,202398,true,1623327020,28,1603002429,-20324591
1677633563,202401,true,1622840119,28,1602681877,-20158242
1677633803,202403,true,1622515600,28,1602201169,-20314431
1677634187,202404,true,1622353364,28,1602521625,-19831739
1677634211,202406,true,1622028942,28,1602521625,-19507317
1677634235,202409,true,1621542431,28,1602521625,-19020806
1677634247,202411,true,1621218171,28,1602521625,-18696546
1677634295,202412,true,1621056066,28,1602681877,-18374189
1677634391,202414,true,1620731903,28,1603002429,-17729474
1677634403,202417,true,1620245781,28,1603002429,-17243352
1677634427,202419,true,1619921780,28,1603002429,-16919351
1677634439,202419,true,1619921780,28,1603162730,-16759050
1677635915,202419,true,1619921780,28,1613132715,-6789065
1677638915,202422,true,1619435901,28,1614585115,-4850786
1677639263,202424,true,1619112062,28,1614746574,-4365488
1677639275,202424,true,1619112062,28,1614746574,-4365488
1677639371,202425,true,1618950167,28,1614746574,-4203593
1677639527,202427,true,1618626426,28,1614908049,-3718377
1677639563,202429,true,1618302749,28,1614908049,-3394700
1677639611,202429,true,1618302749,28,1614908049,-3394700
1677639971,202430,true,1618140935,28,1615554109,-2586826
1677639983,202433,true,1617655590,28,1615554109,-2101481
1677640019,202434,true,1617493840,28,1615554109,-1939731
1677640043,202435,true,1617332107,28,1615715664,-1616443
1677640427,202434,true,1617493840,28,1616847004,-646836
1677640451,202437,true,1617008689,28,1616847004,-161685
1677640463,202439,true,1616685336,28,1617008689,323353
1677640475,202439,true,1616685336,28,1617008689,323353
1677640487,202438,true,1616847004,28,1617008689,161685
1677640511,202441,true,1616362047,28,1617170390,808343
1677640523,202442,true,1616200427,28,1617332107,1131680
1677640535,202442,true,1616200427,28,1617332107,1131680
1677640571,202441,true,1616362047,28,1617655590,1293543
1677640583,202443,true,1616038823,28,1617655590,1616767
1677640631,202445,true,1615715664,28,1618140935,2425271
1677640643,202445,true,1615715664,28,1618302749,2587085
1677641903,202443,true,1616038823,28,1629670039,13631216
1677641975,202445,true,1615715664,28,1630158989,14443325
1677642119,202447,true,1615392569,28,1631300442,15907873
1677642155,202447,true,1615392569,28,1631463573,16071004
1677642179,202445,true,1615715664,28,1631626719,15911055
1677642239,202447,true,1615392569,28,1632116256,16723687
1677642347,202448,true,1615231046,28,1632932477,17701431
1677642371,202448,true,1615231046,28,1632932477,17701431
1677644411,202446,true,1615554109,28,1636037843,20483734
1677644723,202448,true,1615231046,28,1636037843,20806797
1677645047,202448,true,1615231046,28,1636037843,20806797
1677645083,202448,true,1615231046,28,1636201447,20970401
1677646031,202445,true,1615715664,28,1638165969,22450305
1677646103,202446,true,1615554109,28,1638329785,22775676
1677646115,202446,true,1615554109,28,1638329785,22775676
1677646127,202445,true,1615715664,28,1638493618,22777954
1677646151,202442,true,1616200427,28,1638493618,22293191
1677646175,202443,true,1616038823,28,1638657468,22618645
1677646187,202443,true,1616038823,28,1638657468,22618645
1677646211,202442,true,1616200427,28,1638821333,22620906
1677646295,202437,true,1617008689,28,1639476960,22468271
1677646487,202438,true,1616847004,28,1641117175,24270171
1677646499,202437,true,1617008689,28,1641281287,24272598
1677646511,202435,true,1617332107,28,1641445415,24113308
1677646523,202430,true,1618140935,28,1641445415,23304480
1677646679,202430,true,1618140935,28,1643251908,25110973
1677646835,202429,true,1618302749,28,1644895899,26593150
1677646847,202427,true,1618626426,28,1645060389,26433963
1677647519,202422,true,1619435901,28,1651158081,31722180
1677648167,202421,true,1619597844,28,1655622009,36024165
1677648191,202420,true,1619759804,28,1655787571,36027767
1677650843,202419,true,1619921780,28,1653636553,33714773
1677651287,202413,true,1620893976,28,1653636553,32742577
1677651635,202411,true,1621218171,28,1653636553,32418382
1677651767,202410,true,1621380293,28,1653636553,32256260
1677653207,202409,true,1621542431,28,1653471206,31928775
1677655283,202403,true,1622515600,28,1654132694,31617094
1677660899,202400,true,1623002403,28,1653967297,30964894
1677660911,202399,true,1623164703,28,1654132694,30967991
1677660935,202398,true,1623327020,28,1654132694,30805674
1677661043,202392,true,1624301260,28,1654628983,30327723
1677661199,202387,true,1625113573,28,1655456463,30342890
1677661235,202386,true,1625276084,28,1655622009,30345925
1677661355,202385,true,1625438612,28,1656118745,30680133
1677661379,202379,true,1626414119,28,1656284357,29870238
1677661943,202375,true,1627064782,28,1658438819,31374037
1677662567,202374,true,1627227488,28,1660928219,33700731
1677662627,202373,true,1627390211,28,1661094312,33704101
1677662711,202367,true,1628366889,28,1661426547,33059658
1677663119,202364,true,1628855448,28,1660596083,31740635
1677663131,202363,true,1629018334,28,1660596083,31577749
1677663143,202362,true,1629181236,28,1660596083,31414847
1677663155,202356,true,1630158989,28,1660596083,30437094
1677663275,202353,true,1630648085,28,1660264014,29615929
1677663707,202352,true,1630811150,28,1659600074,28788924
1677663779,202351,true,1630974231,28,1659434131,28459900
1677663815,202346,true,1631789882,28,1659268204,27478322
1677665267,202342,true,1632442695,28,1657112665,24669970
1677665375,202341,true,1632605940,28,1656946970,24341030
1677666299,202341,true,1632605940,28,1656615630,24009690
1677669299,202335,true,1633585748,28,1656118745,22532997
1677669587,202332,true,1634075873,28,1656118745,22042872
1677671963,202331,true,1634239280,28,1656118745,21879465
1677672215,202330,true,1634402704,28,1656118745,21716041
1677672239,202324,true,1635383591,28,1656118745,20735154
1677672311,202321,true,1635874255,28,1656118745,20244490
1677674903,202320,true,1636037843,28,1655953150,19915307
1677675527,202319,true,1636201447,28,1655953150,19751703
1677676103,202313,true,1637183413,28,1655953150,18769737
1677676115,202310,true,1637674617,28,1655953150,18278533
1677676187,202308,true,1638002168,28,1655953150,17950982
1677677555,202308,true,1638002168,28,1654794446,16792278
1677677567,202302,true,1638985215,28,1654794446,15809231
1677677615,202299,true,1639476960,28,1654794446,15317486
1677677651,202298,true,1639640908,28,1654794446,15153538
1677677747,202297,true,1639804872,28,1654463537,14658665
1677679679,202292,true,1640624938,28,1651653478,11028540
1677681731,202288,true,1641281287,28,1651653478,10372191
1677681743,202287,true,1641445415,28,1651818644,10373229
1677681995,202286,true,1641609559,28,1652149024,10539465
1677682043,202281,true,1642430528,28,1652149024,9718496
1677682055,202277,true,1643087599,28,1652149024,9061425
1677682067,202276,true,1643251908,28,1652314239,9062331
1677682079,202275,true,1643416233,28,1652314239,8898006
1677682151,202270,true,1644238106,28,1652644718,8406612
1677682163,202266,true,1644895899,28,1652644718,7748819
1677682175,202264,true,1645224895,28,1652809983,7585088
1677682511,202263,true,1645389418,28,1654959925,9570507
1677682739,202259,true,1646047672,28,1656615630,10567958
1677682763,202255,true,1646706190,28,1656615630,9909440
1677682775,202254,true,1646870861,28,1656781292,9910431
1677682787,202253,true,1647035548,28,1656781292,9745744
1677682811,202249,true,1647694461,28,1656946970,9252509
1677683147,202246,true,1648188818,28,1657941387,9752569
1677683195,202245,true,1648353637,28,1657941387,9587750
1677683483,202244,true,1648518473,28,1658438819,9920346
1677683495,202240,true,1649177979,28,1658438819,9260840
1677685151,202237,true,1649672782,28,1654463537,4790755
1677685199,202236,true,1649837749,28,1654463537,4625788
1677685247,202236,true,1649837749,28,1654463537,4625788
1677685259,202233,true,1650332750,28,1654463537,4130787
1677685355,202230,true,1650827899,28,1654463537,3635638
1677685403,202229,true,1650992982,28,1654463537,3470555
1677685415,202228,true,1651158081,28,1654463537,3305456
1677686963,202225,true,1651653478,28,1656284357,4630879
1677687023,202223,true,1651983826,28,1656284357,4300531
1677687071,202222,true,1652149024,28,1656284357,4135333
1677687095,202221,true,1652314239,28,1656118745,3804506
1677687191,202220,true,1652479470,28,1655953150,3473680
1677687239,202218,true,1652809983,28,1655787571,2977588
1677687263,202217,true,1652975264,28,1655622009,2646745
1677687347,202217,true,1652975264,28,1655290934,2315670
1677688871,202216,true,1653140561,28,1649013078,-4127483
1677688919,202214,true,1653471206,28,1648848193,-4623013
1677688955,202214,true,1653471206,28,1649013078,-4458128
1677689015,202213,true,1653636553,28,1649013078,-4623475
1677689039,202212,true,1653801917,28,1649013078,-4788839
1677689087,202210,true,1654132694,28,1649177979,-4954715
1677689255,202210,true,1654132694,28,1649507831,-4624863
1677689327,202210,true,1654132694,28,1649672782,-4459912
1677689339,202208,true,1654463537,28,1649837749,-4625788
1677692771,202206,true,1654794446,28,1654959925,165479
1677692987,202206,true,1654794446,28,1655125421,330975
1677696335,202206,true,1654794446,28,1655290934,496488
1677698003,202205,true,1654959925,28,1655290934,331009
1677700163,202202,true,1655456463,28,1652479470,-2976993
1677700175,202203,true,1655290934,28,1652479470,-2811464
1677700199,202203,true,1655290934,28,1652479470,-2811464
1677700211,202202,true,1655456463,28,1652479470,-2976993
1677700223,202201,true,1655622009,28,1652479470,-3142539
1677700247,202201,true,1655622009,28,1652314239,-3307770
1677700295,202202,true,1655456463,28,1652149024,-3307439
1677700307,202203,true,1655290934,28,1651983826,-3307108
1677700319,202202,true,1655456463,28,1651983826,-3472637
1677700355,202203,true,1655290934,28,1651653478,-3637456
1677700403,202205,true,1654959925,28,1651323197,-3636728
1677701819,202206,true,1654794446,28,1638821333,-15973113
1677701891,202206,true,1654794446,28,1638329785,-16464661
1677701915,202208,true,1654463537,28,1638002168,-16461369
1677703775,202209,true,1654298107,28,1638493618,-15804489
1677704171,202210,true,1654132694,28,1638821333,-15311361
1677705743,202210,true,1654132694,28,1639476960,-14655734
1677705983,202211,true,1653967297,28,1639640908,-14326389
1677706031,202212,true,1653801917,28,1639640908,-14161009
1677706115,202213,true,1653636553,28,1639640908,-13995645
1677706187,202213,true,1653636553,28,1639804872,-13831681
1677706271,202214,true,1653471206,28,1639968852,-13502354
1677706295,202215,true,1653305875,28,1640132849,-13173026
1677706307,202216,true,1653140561,28,1640132849,-13007712
1677706331,202215,true,1653305875,28,1640132849,-13173026
1677706343,202215,true,1653305875,28,1640296863,-13009012
1677706355,202216,true,1653140561,28,1640296863,-12843698
1677706367,202217,true,1652975264,28,1640460892,-12514372
1677706439,202218,true,1652809983,28,1640789001,-12020982
1677706607,202218,true,1652809983,28,1641773720,-11036263
1677706619,202219,true,1652644718,28,1641937898,-10706820
1677706643,202219,true,1652644718,28,1642102092,-10542626
1677706715,202220,true,1652479470,28,1642594771,-9884699
1677706739,202220,true,1652479470,28,1642759031,-9720439
1677706811,202220,true,1652479470,28,1643416233,-9063237
1677708887,202221,true,1652314239,28,1653636553,1322314
1677709523,202221,true,1652314239,28,1653801917,1487678
1677711011,202221,true,1652314239,28,1652975264,661025
1677711971,202222,true,1652149024,28,1652809983,660959
1677713255,202222,true,1652149024,28,1652809983,660959
1677713567,202223,true,1651983826,28,1652809983,826157
1677713627,202222,true,1652149024,28,1652975264,826240
1677713639,202223,true,1651983826,28,1652975264,991438
1677713651,202223,true,1651983826,28,1652975264,991438
1677713663,202223,true,1651983826,28,1652975264,991438
1677713675,202223,true,1651983826,28,1652975264,991438
1677714143,202223,true,1651983826,28,1654298107,2314281
1677714263,202223,true,1651983826,28,1654628983,2645157
1677714359,202223,true,1651983826,28,1654959925,2976099
1677714371,202222,true,1652149024,28,1654959925,2810901
1677714503,202222,true,1652149024,28,1655456463,3307439
1677714671,202222,true,1652149024,28,1656284357,4135333
1677714683,202222,true,1652149024,28,1656284357,4135333
1677714839,202221,true,1652314239,28,1656946970,4632731
1677715307,202221,true,1652314239,28,1659434131,7119892
1677715967,202221,true,1652314239,28,1661260421,8946182
1677716039,202221,true,1652314239,28,1661426547,9112308
1677716291,202220,true,1652479470,28,1662091218,9611748
1677716303,202219,true,1652644718,28,1662091218,9446500
1677716315,202219,true,1652644718,28,1662091218,9446500
1677716327,202219,true,1652644718,28,1662091218,9446500
1677716423,202217,true,1652975264,28,1662589895,9614631
1677716435,202216,true,1653140561,28,1662589895,9449334
1677716459,202215,true,1653305875,28,1662756154,9450279
1677716483,202215,true,1653305875,28,1662922430,9616555
1677716531,202213,true,1653636553,28,1663255031,9618478
1677717299,202211,true,1653967297,28,1667918437,13951140
1677717371,202211,true,1653967297,28,1668252038,14284741
1677717479,202211,true,1653967297,28,1668919439,14952142
1677717539,202209,true,1654298107,28,1669253239,14955132
1677717671,202208,true,1654463537,28,1669754065,15290528
1677718007,202208,true,1654463537,28,1671090336,16626799
1677718091,202209,true,1654298107,28,1671257445,16959338
1677718139,202207,true,1654628983,28,1671424571,16795588
1677718163,202206,true,1654794446,28,1671257445,16462999
1677718175,202207,true,1654628983,28,1671257445,16628462
1677718259,202208,true,1654463537,28,1671090336,16626799
1677718271,202206,true,1654794446,28,1671090336,16295890
1677718511,202206,true,1654794446,28,1670255042,15460596
1677718523,202206,true,1654794446,28,1670255042,15460596
1677718655,202206,true,1654794446,28,1669587107,14792661
1677718763,202204,true,1655125421,28,1669086331,13960910
1677718955,202204,true,1655125421,28,1668085229,12959808
1677719003,202204,true,1655125421,28,1667918437,12793016
1677719039,202204,true,1655125421,28,1667584904,12459483
1677719051,202202,true,1655456463,28,1667584904,12128441
1677720467,202203,true,1655290934,28,1661925025,6634091
1677720527,202203,true,1655290934,28,1661925025,6634091
1677720539,202203,true,1655290934,28,1661758849,6467915
1677720563,202201,true,1655622009,28,1661758849,6136840
1677720635,202202,true,1655456463,28,1661592690,6136227
1677720647,202202,true,1655456463,28,1661592690,6136227
1677721115,202202,true,1655456463,28,1660430040,4973577
1677721127,202201,true,1655622009,28,1660264014,4642005
1677721151,202201,true,1655622009,28,1660264014,4642005
1677721187,202201,true,1655622009,28,1660098004,4475995
1677721199,202201,true,1655622009,28,1660098004,4475995
1677721211,202200,true,1655787571,28,1660098004,4310433
1677721223,202200,true,1655787571,28,1659932011,4144440
1677721235,202200,true,1655787571,28,1659932011,4144440
1677721499,202201,true,1655622009,28,1658272992,2650983
1677722999,202199,true,1655953150,28,1650167733,-5785417
1677724139,202200,true,1655787571,28,1650002733,-5784838
1677726119,202201,true,1655622009,28,1650332750,-5289259
1677726743,202201,true,1655622009,28,1650332750,-5289259
1677727175,202200,true,1655787571,28,1650167733,-5619838
1677727631,202201,true,1655622009,28,1650002733,-5619276
1677729083,202201,true,1655622009,28,1649507831,-6114178
1677731435,202203,true,1655290934,28,1649507831,-5783103
1677732887,202201,true,1655622009,28,1649507831,-6114178
1677734231,202202,true,1655456463,28,1649342897,-6113566
1677736343,202203,true,1655290934,28,1649342897,-5948037
1677736391,202204,true,1655125421,28,1649342897,-5782524
1677736499,202202,true,1655456463,28,1649342897,-6113566
1677736523,202203,true,1655290934,28,1649342897,-5948037
1677736835,202204,true,1655125421,28,1649013078,-6112343
1677736883,202204,true,1655125421,28,1648848193,-6277228
1677737303,202202,true,1655456463,28,1648353637,-7102826
1677737555,202203,true,1655290934,28,1648024016,-7266918
1677737591,202203,true,1655290934,28,1647859230,-7431704
1677739667,202204,true,1655125421,28,1645224895,-9900526
1677744983,202201,true,1655622009,28,1645224895,-10397114
1677746087,202201,true,1655622009,28,1645060389,-10561620
1677746135,202201,true,1655622009,28,1645060389,-10561620
1677746339,202202,true,1655456463,28,1644895899,-10560564
1677746363,202200,true,1655787571,28,1644895899,-10891672
1677746471,202200,true,1655787571,28,1644731426,-11056145
1677747059,202200,true,1655787571,28,1644238106,-11549465
1677749531,202201,true,1655622009,28,1643744933,-11877076
1677751859,202199,true,1655953150,28,1643909307,-12043843
1677752543,202199,true,1655953150,28,1643909307,-12043843
1677754367,202199,true,1655953150,28,1643580575,-12372575
1677754763,202200,true,1655787571,28,1643580575,-12206996
1677756059,202198,true,1656118745,28,1643580575,-12538170
1677758543,202199,true,1655953150,28,1643416233,-12536917
1677760079,202199,true,1655953150,28,1643416233,-12536917
1677760139,202200,true,1655787571,28,1643416233,-12371338
1677760175,202199,true,1655953150,28,1643416233,-12536917
1677760199,202199,true,1655953150,28,1643416233,-12536917
1677760295,202200,true,1655787571,28,1643416233,-12371338
1677760307,202202,true,1655456463,28,1643416233,-12040230
1677760439,202201,true,1655622009,28,1643251908,-12370101
1677760991,202202,true,1655456463,28,1642102092,-13354371
1677761003,202203,true,1655290934,28,1642102092,-13188842
1677761231,202204,true,1655125421,28,1641445415,-13680006
1677761543,202204,true,1655125421,28,1640460892,-14664529
1677761627,202205,true,1654959925,28,1640132849,-14827076
1677762731,202206,true,1654794446,28,1637838385,-16956061
1677762767,202208,true,1654463537,28,1637838385,-16625152
1677762779,202207,true,1654628983,28,1637838385,-16790598
1677764843,202209,true,1654298107,28,1633585748,-20712359
1677765203,202210,true,1654132694,28,1633585748,-20546946
1677765215,202212,true,1653801917,28,1633585748,-20216169
1677765983,202211,true,1653967297,28,1632932477,-21034820
1677766127,202213,true,1653636553,28,1632769200,-20867353
1677766139,202215,true,1653305875,28,1632769200,-20536675
1677766151,202217,true,1652975264,28,1632769200,-20206064
1677766235,202217,true,1652975264,28,1632442695,-20532569
1677766271,202220,true,1652479470,28,1632442695,-20036775
1677766283,202221,true,1652314239,28,1632279467,-20034772
1677766859,202224,true,1651818644,28,1629670039,-22148605
1677766883,202224,true,1651818644,28,1629507088,-22311556
1677767687,202227,true,1651323197,28,1625438612,-25884585
1677767699,202229,true,1650992982,28,1625438612,-25554370
1677769403,202232,true,1650497783,28,1624301260,-26196523
1677769415,202232,true,1650497783,28,1624301260,-26196523
1677769439,202235,true,1650002733,28,1624301260,-25701473
1677773243,202237,true,1649672782,28,1626739418,-22933364
1677777731,202239,true,1649342897,28,1626739418,-22603479
1677779243,202239,true,1649342897,28,1626739418,-22603479
1677780299,202243,true,1648683325,28,1626251493,-22431832
1677780671,202245,true,1648353637,28,1626088885,-22264752
1677782171,202248,true,1647859230,28,1625926292,-21932938
1677782183,202249,true,1647694461,28,1626088885,-21605576
1677782231,202252,true,1647200251,28,1626088885,-21111366
1677782315,202254,true,1646870861,28,1626251493,-20619368
1677783179,202256,true,1646541536,28,1628529726,-18011810
1677783371,202258,true,1646212277,28,1629018334,-17193943
1677783491,202262,true,1645553957,28,1629507088,-16046869
1677783515,202263,true,1645389418,28,1629507088,-15882330
1677783563,202265,true,1645060389,28,1629670039,-15390350
1677783611,202266,true,1644895899,28,1629995989,-14899910
1677783647,202270,true,1644238106,28,1630158989,-14079117
1677783683,202271,true,1644073698,28,1630322005,-13751693
1677783851,202272,true,1643909307,28,1631463573,-12445734
1677784007,202273,true,1643744933,28,1632605940,-11138993
1677784031,202276,true,1643251908,28,1632769200,-10482708
1677784043,202278,true,1642923307,28,1632769200,-10154107
1677784055,202278,true,1642923307,28,1632769200,-10154107
1677784103,202279,true,1642759031,28,1633095770,-9663261
1677784115,202282,true,1642266302,28,1633259080,-9007222
1677784127,202283,true,1642102092,28,1633259080,-8843012
1677785291,202283,true,1642102092,28,1640460892,-1641200
1677785315,202284,true,1641937898,28,1640624938,-1312960
1677785483,202286,true,1641609559,28,1641773720,164161
1677785603,202288,true,1641281287,28,1642266302,985015
1677786143,202287,true,1641445415,28,1643744933,2299518
1677787619,202287,true,1641445415,28,1646541536,5096121
1677789035,202290,true,1640953080,28,1646706190,5753110
1677789467,202291,true,1640789001,28,1646706190,5917189
1677790583,202290,true,1640953080,28,1646870861,5917781
1677792803,202291,true,1640789001,28,1646706190,5917189
1677794399,202292,true,1640624938,28,1646541536,5916598
1677795551,202293,true,1640460892,28,1646047672,5586780
1677796007,202293,true,1640460892,28,1645883084,5422192
1677796067,202293,true,1640460892,28,1645883084,5422192
1677796103,202295,true,1640132849,28,1645883084,5750235
1677796211,202296,true,1639968852,28,1646047672,6078820
1677796283,202294,true,1640296863,28,1646212277,5915414
1677796319,202294,true,1640296863,28,1646212277,5915414
1677796331,202296,true,1639968852,28,1646376898,6408046
1677799079,202296,true,1639968852,28,1652314239,12345387
1677799343,202294,true,1640296863,28,1652479470,12182607
1677799619,202294,true,1640296863,28,1652479470,12182607
1677799667,202296,true,1639968852,28,1652479470,12510618
1677799739,202296,true,1639968852,28,1652314239,12345387
1677800111,202294,true,1640296863,28,1651983826,11686963
1677803291,202294,true,1640296863,28,1649507831,9210968
1677803375,202296,true,1639968852,28,1649507831,9538979
1677803915,202296,true,1639968852,28,1649177979,9209127
1677804011,202294,true,1640296863,28,1649177979,8881116
1677804203,202294,true,1640296863,28,1649013078,8716215
1677804311,202296,true,1639968852,28,1648848193,8879341
1677804467,202296,true,1639968852,28,1648518473,8549621
1677806291,202295,true,1640132849,28,1645553957,5421108
1677806303,202295,true,1640132849,28,1645553957,5421108
1677806339,202297,true,1639804872,28,1645553957,5749085
1677806363,202297,true,1639804872,28,1645389418,5584546
1677806411,202297,true,1639804872,28,1645060389,5255517
1677806447,202298,true,1639640908,28,1644731426,5090518
1677806459,202300,true,1639313029,28,1644566970,5253941
1677806471,202300,true,1639313029,28,1644402529,5089500
1677806483,202301,true,1639149114,28,1644238106,5088992
1677806531,202304,true,1638657468,28,1643416233,4758765
1677806543,202306,true,1638329785,28,1643251908,4922123
1677806555,202307,true,1638165969,28,1643087599,4921630
1677806615,202309,true,1637838385,28,1641773720,3935335
1677806903,202312,true,1637347131,28,1635710684,-1636447
1677806915,202314,true,1637019711,28,1635547130,-1472581
1677806951,202315,true,1636856025,28,1634729601,-2126424
1677806975,202317,true,1636528703,28,1634075873,-2452830
1677806999,202320,true,1636037843,28,1633585748,-2452095
1677807035,202323,true,1635547130,28,1632769200,-2777930
1677807047,202324,true,1635383591,28,1632442695,-2940896
1677807083,202326,true,1635056564,28,1631463573,-3592991
1677807095,202330,true,1634402704,28,1631137329,-3265375
1677807107,202333,true,1633912482,28,1630811150,-3101332
1677807119,202334,true,1633749107,28,1630322005,-3427102
1677807131,202338,true,1633095770,28,1629833006,-3262764
1677807155,202344,true,1632116256,28,1628855448,-3260808
1677807179,202350,true,1631137329,28,1627715705,-3421624
1677807227,202352,true,1630811150,28,1625438612,-5372538
1677807239,202356,true,1630158989,28,1624788599,-5370390
1677807323,202361,true,1629344154,28,1621218171,-8125983
1677807383,202366,true,1628529726,28,1618626426,-9903300
1677807443,202368,true,1628204069,28,1616038823,-12165246
1677807467,202372,true,1627552950,28,1615069539,-12483411
1677807479,202377,true,1626739418,28,1614585115,-12154303
1677807527,202382,true,1625926292,28,1612326391,-13599901
1677807539,202384,true,1625601155,28,1611842789,-13758366
1677807551,202388,true,1624951078,28,1611198213,-13752865
1677807563,202393,true,1624138846,28,1610714951,-13423895
1677807575,202397,true,1623489353,28,1610231833,-13257520
1677807695,202399,true,1623164703,28,1605087583,-18077120
1677807731,202403,true,1622515600,28,1603483378,-19032222
1677807743,202408,true,1621704585,28,1603002429,-18702156
1677807791,202412,true,1621056066,28,1600599848,-20456218
1677807815,202414,true,1620731903,28,1599479876,-21252027
1677807875,202419,true,1619921780,28,1596763206,-23158574
1677808079,202424,true,1619112062,28,1586894393,-32217669
1677808151,202427,true,1618626426,28,1583565577,-35060849
1677808163,202429,true,1618302749,28,1583090603,-35212146
1677808175,202434,true,1617493840,28,1582615771,-34878069
1677808211,202438,true,1616847004,28,1581192128,-35654876
1677808427,202442,true,1616200427,28,1574565379,-41635048
1677808451,202444,true,1615877236,28,1573935710,-41941526
1677808535,202448,true,1615231046,28,1571733852,-43497194
1677808547,202453,true,1614423673,28,1571419552,-43004121
1677808643,202456,true,1613939443,28,1568750541,-45188902
1677808655,202459,true,1613455358,28,1568436838,-45018520
1677808691,202464,true,1612648872,28,1567339372,-45309500
1677808907,202469,true,1611842789,28,1561551220,-50291569
1677808967,202473,true,1611198213,28,1560926756,-50271457
1677808991,202475,true,1610876022,28,1560926756,-49949266
1677809003,202480,true,1610070826,28,1560926756,-49144070
1677809039,202485,true,1609266032,28,1560770679,-48495353
1677809063,202488,true,1608783348,28,1560614617,-48168731
1677809087,202491,true,1608300810,28,1560458571,-47842239
1677809111,202496,true,1607496901,28,1560302541,-47194360
1677809159,202501,true,1606693393,28,1560146526,-46546867
1677809255,202504,true,1606211482,28,1559522624,-46688858
1677809267,202507,true,1605729715,28,1559522624,-46207091
1677809951,202512,true,1604927091,28,1559678576,-45248515
1677809975,202517,true,1604124868,28,1559678576,-44446292
1677810011,202520,true,1603643727,28,1559834544,-43809183
1677810071,202522,true,1603323046,28,1559834544,-43488502
1677810095,202528,true,1602361389,28,1559990527,-42370862
1677810443,202533,true,1601560448,28,1561238957,-40321491
1677810659,202536,true,1601080076,28,1562800898,-38279178
1677811463,202539,true,1600599848,28,1566086064,-34513784
1677812687,202544,true,1599799788,28,1566869264,-32930524
1677812927,202549,true,1599000128,28,1566869264,-32130864
1677813563,202553,true,1598360688,28,1566555937,-31804751
1677813683,202555,true,1598041064,28,1566555937,-31485127
1677815171,202561,true,1597082575,28,1566086064,-30996511
1677817511,202566,true,1596284273,28,1566242673,-30041600
1677818735,202570,true,1595645919,28,1566242673,-29403246
1677819227,202572,true,1595326838,28,1566399297,-28927541
1677819323,202579,true,1594210555,28,1566399297,-27811258
1677819431,202584,true,1593413689,28,1566399297,-27014392
1677819527,202588,true,1592776483,28,1566555937,-26220546
1677819587,202590,true,1592457976,28,1566555937,-25902039
1677819683,202596,true,1591502835,28,1566712593,-24790242
1677819695,202601,true,1590707322,28,1566712593,-23994729
1677819791,202605,true,1590071198,28,1567025951,-23045247
1677819815,202607,true,1589753232,28,1567025951,-22727281
1677819863,202613,true,1588799714,28,1567182653,-21617061
1677819959,202618,true,1588005552,28,1567496106,-20509446
1677823223,202621,true,1587529246,28,1572205419,-15323827
1677823283,202623,true,1587211787,28,1572205419,-15006368
1677823295,202630,true,1586101183,28,1572205419,-13895764
1677823355,202635,true,1585308371,28,1571891025,-13417346
1677823415,202640,true,1584515954,28,1571576694,-12939260
1677823451,202643,true,1584040695,28,1571419552,-12621143
1677823619,202650,true,1582932309,28,1570634078,-12298231
1677823883,202654,true,1582299295,28,1569692027,-12607268
1677824027,202659,true,1581508382,28,1569064307,-12444075
1677824795,202663,true,1580875937,28,1566086064,-14789873
1677824927,202669,true,1579927744,28,1565459786,-14467958
1677825143,202673,true,1579295930,28,1564990242,-14305688
1677825443,202678,true,1578506519,28,1565303256,-13203263
1677827411,202681,true,1578033062,28,1566242673,-11790389
1677827867,202687,true,1577086574,28,1566242673,-10843901
1677829307,202691,true,1576455897,28,1566242673,-10213224
1677829775,202696,true,1575667905,28,1566555937,-9111968
1677829835,202699,true,1575195299,28,1566555937,-8639362
1677834119,202704,true,1574407938,28,1569535074,-4872864
1677834239,202708,true,1573778332,28,1569692027,-4086305
1677834335,202713,true,1572991679,28,1569848996,-3142683
1677834407,202716,true,1572519876,28,1570005981,-2513895
1677836171,202719,true,1572048214,28,1572205419,157205
1677836975,202722,true,1571576694,28,1572048214,471520
1677836987,202726,true,1570948220,28,1572048214,1099994
1677837287,202729,true,1570477030,28,1571891025,1413995
1677837527,202731,true,1570162982,28,1571733852,1570870
1677837551,202733,true,1569848996,28,1571733852,1884856
1677838631,202737,true,1569221214,28,1571262426,2041212
1677839615,202739,true,1568907417,28,1570948220,2040803
1677841175,202740,true,1568750541,28,1570791141,2040600
1677841403,202741,true,1568593682,28,1570791141,2197459
1677842435,202745,true,1567966401,28,1570162982,2196581
1677842447,202747,true,1567652855,28,1570162982,2510127
1677842711,202749,true,1567339372,28,1569848996,2509624
1677843707,202749,true,1567339372,28,1569064307,1724935
1677844811,202753,true,1566712593,28,1568750541,2037948
1677845363,202755,true,1566399297,28,1568750541,2351244
1677846155,202756,true,1566242673,28,1568750541,2507868
1677849611,202757,true,1566086064,28,1567809620,1723556
1677850127,202760,true,1565616332,28,1567809620,2193288
1677850259,202761,true,1565459786,28,1567966401,2506615
1677850355,202760,true,1565616332,28,1567966401,2350069
1677851195,202759,true,1565772894,28,1568280010,2507116
1677851579,202760,true,1565616332,28,1567966401,2350069
1677851807,202760,true,1565616332,28,1567966401,2350069
1677852215,202759,true,1565772894,28,1568280010,2507116
1677852227,202758,true,1565929471,28,1568436838,2507367
1677852251,202759,true,1565772894,28,1568436838,2663944
1677852299,202760,true,1565616332,28,1568593682,2977350
1677852323,202758,true,1565929471,28,1568750541,2821070
1677852575,202757,true,1566086064,28,1569692027,3605963
1677854303,202757,true,1566086064,28,1575667905,9581841
1677855647,202757,true,1566086064,28,1575667905,9581841
1677855671,202755,true,1566399297,28,1575667905,9268608
1677855731,202754,true,1566555937,28,1575667905,9111968
1677855743,202755,true,1566399297,28,1575667905,9268608
1677856475,202757,true,1566086064,28,1572991679,6905615
1677856487,202755,true,1566399297,28,1572991679,6592382
1677858011,202753,true,1566712593,28,1571576694,4864101
1677858119,202754,true,1566555937,28,1571733852,5177915
1677858143,202755,true,1566399297,28,1571733852,5334555
1677858563,202753,true,1566712593,28,1571576694,4864101
1677858839,202751,true,1567025951,28,1571262426,4236475
1677868403,202752,true,1566869264,28,1570005981,3136717
1677868811,202753,true,1566712593,28,1569692027,2979434
1677868823,202750,true,1567182653,28,1569692027,2509374
1677868883,202749,true,1567339372,28,1569378136,2038764
1677868931,202750,true,1567182653,28,1569064307,1881654
1677870875,202753,true,1566712593,28,1558431394,-8281199
1677871211,202750,true,1567182653,28,1558431394,-8751259
1677871307,202749,true,1567339372,28,1558587238,-8752134
1677871919,202750,true,1567182653,28,1558743096,-8439557
1677873023,202753,true,1566712593,28,1558898971,-7813622
1677873071,202750,true,1567182653,28,1558898971,-8283682
1677873095,202748,true,1567496106,28,1558898971,-8597135
1677873179,202749,true,1567339372,28,1559054861,-8284511
1677873191,202751,true,1567025951,28,1559054861,-7971090
1677873227,202748,true,1567496106,28,1559210766,-8285340
1677875879,202746,true,1567809620,28,1563895187,-3914433
1677875915,202747,true,1567652855,28,1563895187,-3757668
1677876311,202750,true,1567182653,28,1563895187,-3287466
1677877103,202747,true,1567652855,28,1563582455,-4070400
1677877487,202745,true,1567966401,28,1563426112,-4540289
1677877751,202747,true,1567652855,28,1563269786,-4383069
1677877799,202749,true,1567339372,28,1563269786,-4069586
1677877811,202746,true,1567809620,28,1563113474,-4696146
1677877871,202745,true,1567966401,28,1563113474,-4852927
1677877895,202747,true,1567652855,28,1562957178,-4695677
1677877907,202750,true,1567182653,28,1562957178,-4225475
1677877919,202748,true,1567496106,28,1562957178,-4538928
1677878027,202747,true,1567652855,28,1562644634,-5008221
1677878423,202749,true,1567339372,28,1561395081,-5944291
1677878567,202752,true,1566869264,28,1560614617,-6254647
1677878591,202750,true,1567182653,28,1560458571,-6724082
1677878663,202749,true,1567339372,28,1559990527,-7348845
1677878675,202752,true,1566869264,28,1559990527,-6878737
1677879179,202755,true,1566399297,28,1557808178,-8591119
1677879215,202752,true,1566869264,28,1557652412,-9216852
1677879227,202752,true,1566869264,28,1557652412,-9216852
1677879251,202755,true,1566399297,28,1557496663,-8902634
1677880091,202757,true,1566086064,28,1556251226,-9834838
1677880139,202754,true,1566555937,28,1556251226,-10304711
1677880151,202754,true,1566555937,28,1556251226,-10304711
1677880499,202757,true,1566086064,28,1556718148,-9367916
1677881147,202759,true,1565772894,28,1556718148,-9054746
1677881207,202757,true,1566086064,28,1556718148,-9367916
1677881903,202756,true,1566242673,28,1556873820,-9368853
1677882707,202759,true,1565772894,28,1557808178,-7964716
1677882719,202762,true,1565303256,28,1557808178,-7495078
1677883235,202760,true,1565616332,28,1558587238,-7029094
1677883295,202759,true,1565772894,28,1558587238,-7185656
1677883607,202762,true,1565303256,28,1559054861,-6248395
1677883775,202765,true,1564833759,28,1559210766,-5622993
1677883835,202763,true,1565146741,28,1559210766,-5935975
1677883847,202762,true,1565303256,28,1559366687,-5936569
1677883871,202763,true,1565146741,28,1559366687,-5780054
1677884195,202765,true,1564833759,28,1560146526,-4687233
1677884471,202763,true,1565146741,28,1560926756,-4219985
1677885059,202762,true,1565303256,28,1562644634,-2658622
1677885083,202764,true,1564990242,28,1562644634,-2345608
1677885215,202765,true,1564833759,28,1563113474,-1720285
1677886067,202763,true,1565146741,28,1565146741,0
1677886247,202762,true,1565303256,28,1565459786,156530
1677886271,202764,true,1564990242,28,1565459786,469544
1677889343,202765,true,1564833759,28,1566242673,1408914
1677889379,202763,true,1565146741,28,1566399297,1252556
1677889403,202762,true,1565303256,28,1566399297,1096041
1677889907,202763,true,1565146741,28,1567182653,2035912
1677889979,202764,true,1564990242,28,1567182653,2192411
1677890543,202763,true,1565146741,28,1568123198,2976457
1677890567,202762,true,1565303256,28,1568280010,2976754
1677890579,202764,true,1564990242,28,1568280010,3289768
1677890915,202764,true,1564990242,28,1569064307,4074065
1677891599,202763,true,1565146741,28,1570005981,4859240
1677891647,202762,true,1565303256,28,1570005981,4702725
1677891983,202764,true,1564990242,28,1570634078,5643836
1677897695,202764,true,1564990242,28,1572205419,7215177
1677899867,202763,true,1565146741,28,1572205419,7058678
1677901511,202762,true,1565303256,28,1572362639,7059383
1677903443,202764,true,1564990242,28,1572362639,7372397
1677907343,202764,true,1564990242,28,1572362639,7372397
1677908183,202763,true,1565146741,28,1572362639,7215898
1677908231,202762,true,1565303256,28,1572362639,7059383
1677908291,202763,true,1565146741,28,1572205419,7058678
1677908303,202764,true,1564990242,28,1572205419,7215177
1677908747,202763,true,1565146741,28,1571105315,5958574
1677912083,202762,true,1565303256,28,1567809620,2506364
1677919547,202763,true,1565146741,28,1567809620,2662879
1677925883,202764,true,1564990242,28,1567809620,2819378
1677931523,202763,true,1565146741,28,1567809620,2662879
1677943115,202762,true,1565303256,28,1567809620,2506364
1677943871,202763,true,1565146741,28,1567809620,2662879
1677944819,202764,true,1564990242,28,1567809620,2819378
1677945071,202763,true,1565146741,28,1567809620,2662879
1677945875,202762,true,1565303256,28,1567496106,2192850
1677947315,202764,true,1564990242,28,1566242673,1252431
1677953231,202764,true,1564990242,28,1565929471,939229
1677953243,202764,true,1564990242,28,1565929471,939229
1677953255,202763,true,1565146741,28,1565929471,782730
1677953279,202764,true,1564990242,28,1565929471,939229
1677955403,202766,true,1564677291,28,1561863546,-2813745
1677958199,202766,true,1564677291,28,1561863546,-2813745
1677960767,202766,true,1564677291,28,1561863546,-2813745
1677960791,202768,true,1564364403,28,1561863546,-2500857
1677960827,202770,true,1564051577,28,1561863546,-2188031
1677960851,202770,true,1564051577,28,1561863546,-2188031
1677961007,202769,true,1564207982,28,1561707375,-2500607
1677962591,202771,true,1563895187,28,1559990527,-3904660
1677962603,202772,true,1563738813,28,1559990527,-3748286
1677962639,202772,true,1563738813,28,1559834544,-3904269
1677962651,202772,true,1563738813,28,1559834544,-3904269
1677962675,202774,true,1563426112,28,1559834544,-3591568
1677962831,202775,true,1563269786,28,1559522624,-3747162
1677962879,202775,true,1563269786,28,1559366687,-3903099
1677964343,202776,true,1563113474,28,1554851300,-8262174
1677965135,202778,true,1562800898,28,1553452633,-9348265
1677965291,202779,true,1562644634,28,1553452633,-9192001
1677966431,202779,true,1562644634,28,1553297303,-9347331
1677966443,202780,true,1562488385,28,1553297303,-9191082
1677966731,202781,true,1562332152,28,1553763339,-8568813
1677968567,202780,true,1562488385,28,1555317802,-7170583
1677968579,202780,true,1562488385,28,1555473334,-7015051
1677968591,202780,true,1562488385,28,1555473334,-7015051
1677968603,202782,true,1562175934,28,1555473334,-6702600
1677968627,202780,true,1562488385,28,1555473334,-7015051
1677968639,202780,true,1562488385,28,1555473334,-7015051
1677968651,202780,true,1562488385,28,1555473334,-7015051
1677968735,202781,true,1562332152,28,1555940022,-6392130
1677969587,202779,true,1562644634,28,1559834544,-2810090
1677970007,202779,true,1562644634,28,1561707375,-937259
1677973151,202780,true,1562488385,28,1563582455,1094070
1677973715,202781,true,1562332152,28,1563582455,1250303
1677974651,202780,true,1562488385,28,1563582455,1094070
1677976463,202779,true,1562644634,28,1563738813,1094179
1677977891,202780,true,1562488385,28,1564833759,2345374
1677978035,202781,true,1562332152,28,1564990242,2658090
1677978551,202779,true,1562644634,28,1565616332,2971698
1677978563,202779,true,1562644634,28,1565616332,2971698
1677978575,202779,true,1562644634,28,1565616332,2971698
1677978611,202779,true,1562644634,28,1565772894,3128260
1677978875,202777,true,1562957178,28,1566555937,3598759
1677978899,202776,true,1563113474,28,1566712593,3599119
1677978983,202776,true,1563113474,28,1567025951,3912477
1677979007,202776,true,1563113474,28,1567182653,4069179
1677979031,202773,true,1563582455,28,1567339372,3756917
1677979055,202772,true,1563738813,28,1567496106,3757293
1677979115,202771,true,1563895187,28,1567966401,4071214
1677979175,202770,true,1564051577,28,1568593682,4542105
1677979955,202767,true,1564520839,28,1576140653,11619814
1677980459,202766,true,1564677291,28,1580717865,16040574
1677983015,202765,true,1564833759,28,1583407237,18573478
1677983039,202764,true,1564990242,28,1583407237,18416995
1677983195,202761,true,1565459786,28,1583407237,17947451
1677983207,202760,true,1565616332,28,1583407237,17790905
1677983315,202759,true,1565772894,28,1583248912,17476018
1677983327,202758,true,1565929471,28,1583248912,17319441
1677983579,202755,true,1566399297,28,1582615771,16216474
1677983591,202755,true,1566399297,28,1582615771,16216474
1677983603,202754,true,1566555937,28,1582615771,16059834
1677983651,202753,true,1566712593,28,1582299295,15586702
1677983687,202752,true,1566869264,28,1582141081,15271817
1677983699,202751,true,1567025951,28,1582141081,15115130
1677983711,202751,true,1567025951,28,1581982882,14956931
1677983723,202750,true,1567182653,28,1581824700,14642047
1677983735,202749,true,1567339372,28,1581824700,14485328
1677983747,202749,true,1567339372,28,1581666533,14327161
1677983771,202750,true,1567182653,28,1581350247,14167594
1677983783,202750,true,1567182653,28,1581192128,14009475
1677984191,202750,true,1567182653,28,1575667905,8485252
1677984263,202750,true,1567182653,28,1574722835,7540182
1677984443,202751,true,1567025951,28,1572362639,5336688
1677984467,202751,true,1567025951,28,1572205419,5179468
1677985187,202751,true,1567025951,28,1564207982,-2817969
1677985355,202751,true,1567025951,28,1562488385,-4537566
1677985403,202751,true,1567025951,28,1562175934,-4850017
1677985427,202752,true,1566869264,28,1562019732,-4849532
1677985691,202751,true,1567025951,28,1562019732,-5006219
1677985811,202751,true,1567025951,28,1562332152,-4693799
1677986123,202752,true,1566869264,28,1563269786,-3599478
1677986243,202752,true,1566869264,28,1563582455,-3286809
1677989231,202752,true,1566869264,28,1565146741,-1722523
1677989843,202752,true,1566869264,28,1565459786,-1409478
1677990131,202753,true,1566712593,28,1565616332,-1096261
1677991511,202753,true,1566712593,28,1566242673,-469920
1677991619,202753,true,1566712593,28,1566869264,156671
1677994787,202752,true,1566869264,28,1574565379,7696115
1677994811,202752,true,1566869264,28,1574565379,7696115
1677995903,202752,true,1566869264,28,1574407938,7538674
1678000691,202752,true,1566869264,28,1573778332,6909068
1678001255,202752,true,1566869264,28,1573778332,6909068
1678002815,202752,true,1566869264,28,1573620970,6751706
1678003499,202752,true,1566869264,28,1573463624,6594360
1678005527,202752,true,1566869264,28,1572834395,5965131
1678005647,202751,true,1567025951,28,1572834395,5808444
1678005743,202752,true,1566869264,28,1572834395,5965131
1678005995,202752,true,1566869264,28,1572677128,5807864
1678006235,202752,true,1566869264,28,1572362639,5493375
1678006523,202751,true,1567025951,28,1572048214,5022263
1678006619,202751,true,1567025951,28,1571891025,4865074
1678007075,202751,true,1567025951,28,1571105315,4079364
1678011239,202752,true,1566869264,28,1569378136,2508872
1678011275,202750,true,1567182653,28,1569378136,2195483
1678012319,202751,true,1567025951,28,1569378136,2352185
1678013231,202751,true,1567025951,28,1569378136,2352185
1678014203,202751,true,1567025951,28,1569378136,2352185
1678015067,202750,true,1567182653,28,1569378136,2195483
1678017395,202750,true,1567182653,28,1569378136,2195483
1678020311,202750,true,1567182653,28,1569535074,2352421
1678020455,202751,true,1567025951,28,1569535074,2509123
1678022987,202749,true,1567339372,28,1569378136,2038764
1678023767,202750,true,1567182653,28,1569378136,2195483
1678033859,202749,true,1567339372,28,1569535074,2195702
1678034903,202749,true,1567339372,28,1569535074,2195702
1678044587,202747,true,1567652855,28,1569378136,1725281
1678044647,202748,true,1567496106,28,1569378136,1882030
1678044707,202748,true,1567496106,28,1569378136,1882030
1678046651,202747,true,1567652855,28,1568280010,627155
1678047863,202746,true,1567809620,28,1568280010,470390
1678047923,202746,true,1567809620,28,1568280010,470390
1678049423,202746,true,1567809620,28,1568280010,470390
1678049471,202745,true,1567966401,28,1568436838,470437
1678050839,202744,true,1568123198,28,1568436838,313640
1678050899,202744,true,1568123198,28,1568436838,313640
1678050911,202743,true,1568280010,28,1568593682,313672
1678050923,202743,true,1568280010,28,1568593682,313672
1678052507,202740,true,1568750541,28,1572048214,3297673
1678052519,202740,true,1568750541,28,1572048214,3297673
1678052531,202739,true,1568907417,28,1572048214,3140797
1678052543,202738,true,1569064307,28,1572048214,2983907
1678052555,202737,true,1569221214,28,1572048214,2827000
1678053311,202737,true,1569221214,28,1569535074,313860
1678053347,202736,true,1569378136,28,1569378136,0
1678053371,202736,true,1569378136,28,1569378136,0
1678053395,202734,true,1569692027,28,1569378136,-313891
1678054187,202734,true,1569692027,28,1568123198,-1568829
1678055315,202733,true,1569848996,28,1569692027,-156969
1678055339,202733,true,1569848996,28,1569692027,-156969
1678055495,202732,true,1570005981,28,1569535074,-470907
1678055531,202732,true,1570005981,28,1569535074,-470907
1678057031,202732,true,1570005981,28,1566242673,-3763308
1678057391,202732,true,1570005981,28,1565772894,-4233087
1678057847,202731,true,1570162982,28,1565772894,-4390088
1678057871,202731,true,1570162982,28,1565772894,-4390088
1678058183,202732,true,1570005981,28,1564990242,-5015739
1678059707,202733,true,1569848996,28,1561707375,-8141621
1678060283,202732,true,1570005981,28,1561863546,-8142435
1678062611,202732,true,1570005981,28,1561863546,-8142435
1678062719,202733,true,1569848996,28,1562019732,-7829264
1678062887,202733,true,1569848996,28,1562019732,-7829264
1678063079,202732,true,1570005981,28,1562175934,-7830047
1678063115,202732,true,1570005981,28,1562332152,-7673829
1678063139,202733,true,1569848996,28,1562332152,-7516844
1678063403,202735,true,1569535074,28,1562644634,-6890440
1678064483,202734,true,1569692027,28,1564520839,-5171188
1678064927,202734,true,1569692027,28,1564833759,-4858268
1678065203,202735,true,1569535074,28,1564990242,-4544832
1678065491,202737,true,1569221214,28,1564990242,-4230972
1678065563,202736,true,1569378136,28,1564990242,-4387894
1678065671,202737,true,1569221214,28,1564833759,-4387455
1678065779,202739,true,1568907417,28,1564833759,-4073658
1678065875,202741,true,1568593682,28,1564677291,-3916391
1678065887,202740,true,1568750541,28,1564677291,-4073250
1678065911,202741,true,1568593682,28,1564833759,-3759923
1678066595,202742,true,1568436838,28,1565772894,-2663944
1678066787,202745,true,1567966401,28,1566086064,-1880337
1678067111,202744,true,1568123198,28,1566399297,-1723901
1678067639,202745,true,1567966401,28,1567025951,-940450
1678067651,202746,true,1567809620,28,1567025951,-783669
1678068215,202748,true,1567496106,28,1565929471,-1566635
1678068227,202747,true,1567652855,28,1565929471,-1723384
1678068479,202748,true,1567496106,28,1565303256,-2192850
1678068971,202749,true,1567339372,28,1564207982,-3131390
1678069727,202751,true,1567025951,28,1562957178,-4068773
1678070123,202750,true,1567182653,28,1562644634,-4538019
1678073003,202751,true,1567025951,28,1561551220,-5474731
1678073279,202751,true,1567025951,28,1561551220,-5474731
1678074047,202752,true,1566869264,28,1561551220,-5318044
1678077803,202751,true,1567025951,28,1561551220,-5474731
1678079183,202751,true,1567025951,28,1561551220,-5474731
1678084979,202752,true,1566869264,28,1559990527,-6878737
1678085087,202752,true,1566869264,28,1559990527,-6878737
1678086995,202751,true,1567025951,28,1559990527,-7035424
1678087775,202751,true,1567025951,28,1561707375,-5318576
1678088051,202751,true,1567025951,28,1562332152,-4693799
1678088615,202752,true,1566869264,28,1563582455,-3286809
1678089095,202750,true,1567182653,28,1563895187,-3287466
1678090715,202751,true,1567025951,28,1563895187,-3130764
1678090751,202751,true,1567025951,28,1563895187,-3130764
1678091543,202752,true,1566869264,28,1563426112,-3443152
1678093067,202751,true,1567025951,28,1562800898,-4225053
1678095527,202751,true,1567025951,28,1562800898,-4225053
1678096211,202751,true,1567025951,28,1562800898,-4225053
1678097123,202753,true,1566712593,28,1562800898,-3911695
1678097543,202751,true,1567025951,28,1562644634,-4381317
1678098491,202752,true,1566869264,28,1563113474,-3755790
1678100267,202752,true,1566869264,28,1563269786,-3599478
1678100363,202753,true,1566712593,28,1563426112,-3286481
1678102199,202753,true,1566712593,28,1563738813,-2973780
1678104407,202754,true,1566555937,28,1563895187,-2660750
1678105211,202754,true,1566555937,28,1563895187,-2660750
1678106231,202756,true,1566242673,28,1563895187,-2347486
1678106495,202755,true,1566399297,28,1563895187,-2504110
1678108139,202756,true,1566242673,28,1563895187,-2347486
1678109123,202757,true,1566086064,28,1563895187,-2190877
1678109939,202758,true,1565929471,28,1563895187,-2034284
1678110059,202758,true,1565929471,28,1564051577,-1877894
1678110071,202758,true,1565929471,28,1564051577,-1877894
1678110383,202758,true,1565929471,28,1564364403,-1565068
1678112927,202759,true,1565772894,28,1566712593,939699
1678113215,202759,true,1565772894,28,1566869264,1096370
1678114307,202759,true,1565772894,28,1568280010,2507116
1678114919,202759,true,1565772894,28,1569064307,3291413
1678115867,202759,true,1565772894,28,1569064307,3291413
1678117739,202759,true,1565772894,28,1570477030,4704136
1678117895,202759,true,1565772894,28,1570634078,4861184
1678117907,202759,true,1565772894,28,1570634078,4861184
1678117943,202759,true,1565772894,28,1570634078,4861184
1678117955,202758,true,1565929471,28,1570634078,4704607
1678118015,202758,true,1565929471,28,1570791141,4861670
1678118171,202757,true,1566086064,28,1571419552,5333488
1678118459,202757,true,1566086064,28,1572519876,6433812
1678120463,202756,true,1566242673,28,1577402007,11159334
1678121531,202756,true,1566242673,28,1577244282,11001609
1678125179,202756,true,1566242673,28,1576928881,10686208
1678125515,202755,true,1566399297,28,1576928881,10529584
1678130267,202755,true,1566399297,28,1576613542,10214245
1678130303,202754,true,1566555937,28,1576613542,10057605
1678130315,202754,true,1566555937,28,1576613542,10057605
1678130327,202754,true,1566555937,28,1576613542,10057605
1678130351,202753,true,1566712593,28,1576613542,9900949
1678130375,202753,true,1566712593,28,1576455897,9743304
1678130471,202753,true,1566712593,28,1576140653,9428060
1678131059,202753,true,1566712593,28,1573778332,7065739
1678131551,202753,true,1566712593,28,1571733852,5021259
1678132187,202753,true,1566712593,28,1569378136,2665543
1678134143,202753,true,1566712593,28,1568907417,2194824
1678134563,202753,true,1566712593,28,1568750541,2037948
1678135019,202754,true,1566555937,28,1568436838,1880901
1678136243,202754,true,1566555937,28,1567496106,940169
1678136267,202754,true,1566555937,28,1567496106,940169
1678136279,202754,true,1566555937,28,1567496106,940169
1678136435,202755,true,1566399297,28,1567339372,940075
1678136447,202754,true,1566555937,28,1567339372,783435
1678137071,202755,true,1566399297,28,1566242673,-156624
1678140311,202755,true,1566399297,28,1564677291,-1722006
1678140323,202755,true,1566399297,28,1564833759,-1565538
1678141487,202755,true,1566399297,28,1565146741,-1252556
1678142603,202756,true,1566242673,28,1565459786,-782887
1678142651,202756,true,1566242673,28,1565459786,-782887
1678143107,202756,true,1566242673,28,1565772894,-469779
1678151711,202756,true,1566242673,28,1566555937,313264
1678152155,202756,true,1566242673,28,1566712593,469920
1678152191,202755,true,1566399297,28,1566869264,469967
1678152275,202756,true,1566242673,28,1566869264,626591
1678152383,202755,true,1566399297,28,1567025951,626654
1678154447,202754,true,1566555937,28,1569535074,2979137
1678154495,202754,true,1566555937,28,1569692027,3136090
1678154963,202754,true,1566555937,28,1569692027,3136090
1678155083,202753,true,1566712593,28,1569692027,2979434
1678155971,202753,true,1566712593,28,1570005981,3293388
1678156487,202752,true,1566869264,28,1570162982,3293718
1678156499,202752,true,1566869264,28,1570162982,3293718
1678156703,202752,true,1566869264,28,1570319998,3450734
1678157879,202751,true,1567025951,28,1571262426,4236475
1678157951,202750,true,1567182653,28,1571419552,4236899
1678158299,202750,true,1567182653,28,1571891025,4708372
1678158311,202750,true,1567182653,28,1571891025,4708372
1678158323,202749,true,1567339372,28,1572048214,4708842
1678158419,202748,true,1567496106,28,1572362639,4866533
1678161203,202747,true,1567652855,28,1578506519,10853664
1678166087,202747,true,1567652855,28,1578506519,10853664
1678166495,202746,true,1567809620,28,1578506519,10696899
1678167035,202745,true,1567966401,28,1578506519,10540118
1678168175,202744,true,1568123198,28,1578506519,10383321
1678168307,202744,true,1568123198,28,1578348684,10225486
1678168403,202743,true,1568280010,28,1578348684,10068674
1678168547,202742,true,1568436838,28,1578348684,9911846
1678168619,202741,true,1568593682,28,1578348684,9755002
1678169615,202741,true,1568593682,28,1577875275,9281593
1678169999,202741,true,1568593682,28,1577717503,9123821
1678170011,202740,true,1568750541,28,1577717503,8966962
1678172591,202739,true,1568907417,28,1576298267,7390850
1678172939,202738,true,1569064307,28,1576298267,7233960
1678173899,202738,true,1569064307,28,1576140653,7076346
1678174499,202737,true,1569221214,28,1575983054,6761840
1678174859,202736,true,1569378136,28,1575983054,6604918
1678175555,202735,true,1569535074,28,1575825472,6290398
1678176155,202735,true,1569535074,28,1575667905,6132831
1678176251,202733,true,1569848996,28,1575667905,5818909
1678176347,202733,true,1569848996,28,1575510354,5661358
1678176587,202732,true,1570005981,28,1575352819,5346838
1678176815,202732,true,1570005981,28,1575037795,5031814
1678179239,202731,true,1570162982,28,1572991679,2828697
1678180703,202730,true,1570319998,28,1572991679,2671681
1678180799,202729,true,1570477030,28,1572991679,2514649
1678180931,202729,true,1570477030,28,1572834395,2357365
1678181063,202728,true,1570634078,28,1572677128,2043050
1678181075,202728,true,1570634078,28,1572677128,2043050
1678181243,202728,true,1570634078,28,1572519876,1885798
1678181399,202727,true,1570791141,28,1572205419,1414278
1678181843,202727,true,1570791141,28,1571576694,785553
1678181963,202726,true,1570948220,28,1571419552,471332
1678182143,202726,true,1570948220,28,1571105315,157095
1678182311,202726,true,1570948220,28,1570791141,-157079
1678183631,202725,true,1571105315,28,1568907417,-2197898
1678184183,202725,true,1571105315,28,1568593682,-2511633
1678186511,202725,true,1571105315,28,1568907417,-2197898
1678187843,202725,true,1571105315,28,1568123198,-2982117
1678190375,202724,true,1571262426,28,1567652855,-3609571
1678193879,202724,true,1571262426,28,1567182653,-4079773
1678197683,202724,true,1571262426,28,1567025951,-4236475
1678197743,202724,true,1571262426,28,1567025951,-4236475
1678197971,202723,true,1571419552,28,1567025951,-4393601
1678199519,202723,true,1571419552,28,1565303256,-6116296
1678201247,202724,true,1571262426,28,1562957178,-8305248
1678201259,202724,true,1571262426,28,1562957178,-8305248
1678201271,202723,true,1571419552,28,1562800898,-8618654
1678201367,202724,true,1571262426,28,1561863546,-9398880
1678201571,202728,true,1570634078,28,1559834544,-10799534
1678201679,202728,true,1570634078,28,1558743096,-11890982
1678201775,202728,true,1570634078,28,1557652412,-12981666
1678201787,202729,true,1570477030,28,1557652412,-12824618
1678201823,202733,true,1569848996,28,1557185210,-12663786
1678201955,202734,true,1569692027,28,1555628881,-14063146
1678202231,202734,true,1569692027,28,1552520888,-17171139
1678202255,202735,true,1569535074,28,1552210430,-17324644
1678202483,202740,true,1568750541,28,1549883976,-18866565
1678202495,202740,true,1568750541,28,1549729003,-19021538
1678202507,202740,true,1568750541,28,1549574046,-19176495
1678202519,202741,true,1568593682,28,1549419104,-19174578
1678202567,202745,true,1567966401,28,1549264177,-18702224
1678202591,202746,true,1567809620,28,1549109267,-18700353
1678202615,202746,true,1567809620,28,1548954371,-18855249
1678202627,202747,true,1567652855,28,1548954371,-18698484
1678202639,202750,true,1567182653,28,1548954371,-18228282
1678202987,202749,true,1567339372,28,1548954371,-18385001
1678203035,202749,true,1567339372,28,1548954371,-18385001
1678203431,202750,true,1567182653,28,1552520888,-14661765
1678203443,202754,true,1566555937,28,1552676140,-13879797
1678203455,202752,true,1566869264,28,1552831407,-14037857
1678203851,202752,true,1566869264,28,1557963959,-8905305
1678203887,202752,true,1566869264,28,1558431394,-8437870
1678205675,202755,true,1566399297,28,1564364403,-2034894
1678205711,202754,true,1566555937,28,1564207982,-2347955
1678205759,202753,true,1566712593,28,1564207982,-2504611
1678206359,202753,true,1566712593,28,1563426112,-3286481
1678206467,202757,true,1566086064,28,1563113474,-2972590
1678206539,202756,true,1566242673,28,1562957178,-3285495
1678206551,202755,true,1566399297,28,1562957178,-3442119
1678206743,202756,true,1566242673,28,1562175934,-4066739
1678206779,202760,true,1565616332,28,1562019732,-3596600
1678206923,202758,true,1565929471,28,1561238957,-4690514
1678207307,202758,true,1565929471,28,1558898971,-7030500
1678209611,202759,true,1565772894,28,1553141989,-12630905
1678209647,202763,true,1565146741,28,1553297303,-11849438
1678210007,202761,true,1565459786,28,1553918716,-11541070
1678210031,202761,true,1565459786,28,1553918716,-11541070
1678210427,202761,true,1565459786,28,1555006785,-10453001
1678210475,202764,true,1564990242,28,1555162286,-9827956
1678211387,202762,true,1565303256,28,1558119755,-7183501
1678211447,202762,true,1565303256,28,1558431394,-6871862
1678214483,202762,true,1565303256,28,1560302541,-5000715
1678214555,202766,true,1564677291,28,1560302541,-4374750
1678214567,202764,true,1564990242,28,1560302541,-4687701
1678214639,202764,true,1564990242,28,1560302541,-4687701
1678214651,202764,true,1564990242,28,1560302541,-4687701
1678214963,202768,true,1564364403,28,1559990527,-4373876
1678215191,202766,true,1564677291,28,1559678576,-4998715
1678215395,202766,true,1564677291,28,1559366687,-5310604
1678215407,202766,true,1564677291,28,1559210766,-5466525
1678215455,202771,true,1563895187,28,1559210766,-4684421
1678215539,202769,true,1564207982,28,1559054861,-5153121
1678216571,202769,true,1564207982,28,1557185210,-7022772
1678218131,202769,true,1564207982,28,1556718148,-7489834
1678219055,202774,true,1563426112,28,1556718148,-6707964
1678219067,202773,true,1563582455,28,1556718148,-6864307
1678219355,202773,true,1563582455,28,1556406851,-7175604
1678219367,202773,true,1563582455,28,1556406851,-7175604
1678219451,202778,true,1562800898,28,1556251226,-6549672
1678219475,202777,true,1562957178,28,1556251226,-6705952
1678219499,202778,true,1562800898,28,1556095616,-6705282
1678219511,202779,true,1562644634,28,1556095616,-6549018
1678219631,202784,true,1561863546,28,1555784444,-6079102
1678219643,202783,true,1562019732,28,1555784444,-6235288
1678221455,202784,true,1561863546,28,1548180126,-13683420
1678222079,202786,true,1561551220,28,1548180126,-13371094
1678222343,202791,true,1560770679,28,1548180126,-12590553
1678222451,202790,true,1560926756,28,1548334944,-12591812
1678223879,202791,true,1560770679,28,1548489778,-12280901
1678224899,202792,true,1560614617,28,1548489778,-12124839
1678225415,202797,true,1559834544,28,1548644627,-11189917
1678225499,202796,true,1559990527,28,1548799491,-11191036
1678225619,202798,true,1559678576,28,1548799491,-10879085
1678225919,202799,true,1559522624,28,1549109267,-10413357
1678226399,202803,true,1558898971,28,1549419104,-9479867
1678226819,202802,true,1559054861,28,1549729003,-9325858
1678226831,202804,true,1558743096,28,1549729003,-9014093
1678226951,202804,true,1558743096,28,1549729003,-9014093
1678226963,202809,true,1557963959,28,1549729003,-8234956
1678227095,202809,true,1557963959,28,1549729003,-8234956
1678228715,202810,true,1557808178,28,1547561009,-10247169
1678229483,202811,true,1557652412,28,1547406268,-10246144
1678229927,202815,true,1557029507,28,1547561009,-9468498
1678229963,202815,true,1557029507,28,1547561009,-9468498
1678230191,202816,true,1556873820,28,1547870537,-9003283
1678230755,202816,true,1556873820,28,1548644627,-8229193
1678230947,202821,true,1556095616,28,1548954371,-7141245
1678231175,202820,true,1556251226,28,1549419104,-6832122
1678231439,202821,true,1556095616,28,1549883976,-6211640
1678231451,202821,true,1556095616,28,1549883976,-6211640
1678231691,202825,true,1555473334,28,1550504023,-4969311
1678231859,202824,true,1555628881,28,1550814139,-4814742
1678231895,202825,true,1555473334,28,1550814139,-4659195
1678231967,202825,true,1555473334,28,1550969220,-4504114
1678231979,202829,true,1554851300,28,1550969220,-3882080
1678231991,202828,true,1555006785,28,1551124317,-3882468
1678232003,202829,true,1554851300,28,1551124317,-3726983
1678232183,202828,true,1555006785,28,1551744860,-3261925
1678232267,202832,true,1554384938,28,1552055225,-2329713
1678232291,202831,true,1554540376,28,1552055225,-2485151
1678232303,202831,true,1554540376,28,1552210430,-2329946
1678232579,202830,true,1554695830,28,1553452633,-1243197
1678233251,202834,true,1554074107,28,1556406851,2332744
1678233683,202833,true,1554229515,28,1557963959,3734444
1678233803,202833,true,1554229515,28,1558275567,4046052
1678233827,202832,true,1554384938,28,1558431394,4046456
1678233839,202835,true,1553918716,28,1558431394,4512678
1678233851,202834,true,1554074107,28,1558431394,4357287
1678233863,202834,true,1554074107,28,1558587238,4513131
1678235555,202832,true,1554384938,28,1564833759,10448821
1678239155,202831,true,1554540376,28,1565303256,10762880
1678243667,202829,true,1554851300,28,1565303256,10451956
1678244111,202829,true,1554851300,28,1565303256,10451956
1678245215,202827,true,1555162286,28,1565146741,9984455
1678245431,202826,true,1555317802,28,1564990242,9672440
1678245467,202824,true,1555628881,28,1564990242,9361361
1678245707,202824,true,1555628881,28,1564833759,9204878
1678245743,202822,true,1555940022,28,1564833759,8893737
1678245767,202821,true,1556095616,28,1564833759,8738143
1678246499,202819,true,1556406851,28,1563895187,7488336
1678250231,202820,true,1556251226,28,1562488385,6237159
1678251059,202817,true,1556718148,28,1562644634,5926486
1678252907,202818,true,1556562492,28,1562800898,6238406
1678253087,202817,true,1556718148,28,1562800898,6082750
1678253291,202817,true,1556718148,28,1562644634,5926486
1678253399,202815,true,1557029507,28,1562644634,5615127
1678253519,202817,true,1556718148,28,1562488385,5770237
1678253567,202817,true,1556718148,28,1562488385,5770237
1678253591,202818,true,1556562492,28,1562488385,5925893
1678253639,202816,true,1556873820,28,1562332152,5458332
1678253723,202817,true,1556718148,28,1562175934,5457786
1678253819,202817,true,1556718148,28,1562019732,5301584
1678253939,202819,true,1556406851,28,1561707375,5300524
1678254047,202817,true,1556718148,28,1561395081,4676933
1678254059,202819,true,1556406851,28,1561395081,4988230
1678255319,202820,true,1556251226,28,1555784444,-466782
1678255379,202821,true,1556095616,28,1555628881,-466735
1678255415,202820,true,1556251226,28,1555473334,-777892
1678255655,202820,true,1556251226,28,1554540376,-1710850
1678259879,202822,true,1555940022,28,1552831407,-3108615
1678260875,202823,true,1555784444,28,1552831407,-2953037
1678266143,202821,true,1556095616,28,1552986691,-3108925
1678266671,202821,true,1556095616,28,1552986691,-3108925
1678267151,202822,true,1555940022,28,1552986691,-2953331
1678271087,202823,true,1555784444,28,1552676140,-3108304
1678271747,202821,true,1556095616,28,1552831407,-3264209
1678271759,202821,true,1556095616,28,1552831407,-3264209
1678272143,202823,true,1555784444,28,1553141989,-2642455
1678272155,202823,true,1555784444,28,1553141989,-2642455
1678273379,202821,true,1556095616,28,1555162286,-933330
1678276619,202822,true,1555940022,28,1556406851,466829
1678280363,202823,true,1555784444,28,1556251226,466782
1678281155,202824,true,1555628881,28,1556251226,622345
1678281179,202822,true,1555940022,28,1556251226,311204
1678281215,202823,true,1555784444,28,1556251226,466782
1678281227,202824,true,1555628881,28,1556251226,622345
1678282859,202825,true,1555473334,28,1555473334,0
1678283711,202823,true,1555784444,28,1555317802,-466642
1678283723,202823,true,1555784444,28,1555317802,-466642
1678284443,202825,true,1555473334,28,1555006785,-466549
1678284503,202826,true,1555317802,28,1555006785,-311017
1678284515,202824,true,1555628881,28,1555006785,-622096
1678284551,202824,true,1555628881,28,1554851300,-777581
1678284611,202826,true,1555317802,28,1554851300,-466502
1678284719,202827,true,1555162286,28,1554540376,-621910
1678284947,202825,true,1555473334,28,1554074107,-1399227
1678286027,202825,true,1555473334,28,1552055225,-3418109
1678286087,202827,true,1555162286,28,1551900035,-3262251
1678286351,202828,true,1555006785,28,1551434558,-3572227
1678286555,202826,true,1555317802,28,1551434558,-3883244
1678287611,202826,true,1555317802,28,1550969220,-4348582
1678287623,202828,true,1555006785,28,1550969220,-4037565
1678287791,202829,true,1554851300,28,1550659073,-4192227
1678287863,202827,true,1555162286,28,1550659073,-4503213
1678288019,202827,true,1555162286,28,1550504023,-4658263
1678288343,202828,true,1555006785,28,1550348988,-4657797
1678288355,202828,true,1555006785,28,1550348988,-4657797
1678288367,202826,true,1555317802,28,1550348988,-4968814
1678288391,202826,true,1555317802,28,1550348988,-4968814
1678288439,202827,true,1555162286,28,1550504023,-4658263
1678288871,202826,true,1555317802,28,1552520888,-2796914
1678288883,202824,true,1555628881,28,1552676140,-2952741
1678289483,202824,true,1555628881,28,1554540376,-1088505
1678289651,202824,true,1555628881,28,1555473334,-155547
1678289783,202824,true,1555628881,28,1556095616,466735
1678289819,202822,true,1555940022,28,1556406851,466829
1678290275,202822,true,1555940022,28,1558587238,2647216
1678290887,202822,true,1555940022,28,1559366687,3426665
1678292423,202822,true,1555940022,28,1560614617,4674595
1678292999,202820,true,1556251226,28,1560614617,4363391
1678293143,202820,true,1556251226,28,1560614617,4363391
1678293299,202819,true,1556406851,28,1560614617,4207766
1678293311,202819,true,1556406851,28,1560614617,4207766
1678293671,202817,true,1556718148,28,1560302541,3584393
1678296743,202817,true,1556718148,28,1558431394,1713246
1678298195,202817,true,1556718148,28,1558587238,1869090
1678298543,202816,true,1556873820,28,1558587238,1713418
1678299935,202815,true,1557029507,28,1557808178,778671
1678300043,202815,true,1557029507,28,1557652412,622905
1678300055,202815,true,1557029507,28,1557652412,622905
1678300115,202815,true,1557029507,28,1557652412,622905
1678300211,202814,true,1557185210,28,1557340929,155719
1678300871,202814,true,1557185210,28,1555940022,-1245188
1678303007,202815,true,1557029507,28,1553452633,-3576874
1678307675,202814,true,1557185210,28,1553297303,-3887907
1678307723,202813,true,1557340929,28,1553452633,-3888296
1678307735,202814,true,1557185210,28,1553452633,-3732577
1678307747,202815,true,1557029507,28,1553452633,-3576874
1678307819,202814,true,1557185210,28,1553452633,-3732577
1678312007,202813,true,1557340929,28,1556095616,-1245313
1678312043,202814,true,1557185210,28,1556095616,-1089594
1678312163,202815,true,1557029507,28,1556095616,-933891
1678312235,202814,true,1557185210,28,1555940022,-1245188
1678315067,202814,true,1557185210,28,1553297303,-3887907
1678315151,202815,true,1557029507,28,1553297303,-3732204
1678315583,202816,true,1556873820,28,1553297303,-3576517
1678315679,202815,true,1557029507,28,1553297303,-3732204
1678315739,202816,true,1556873820,28,1553297303,-3576517
1678315751,202817,true,1556718148,28,1553297303,-3420845
1678315763,202818,true,1556562492,28,1553297303,-3265189
1678315775,202817,true,1556718148,28,1553297303,-3420845
1678315787,202819,true,1556406851,28,1553141989,-3264862
1678315907,202821,true,1556095616,28,1552831407,-3264209
1678316087,202822,true,1555940022,28,1552365651,-3574371
1678316183,202821,true,1556095616,28,1552055225,-4040391
1678316915,202823,true,1555784444,28,1548954371,-6830073
1678316939,202825,true,1555473334,28,1548799491,-6673843
1678316951,202826,true,1555317802,28,1548644627,-6673175
1678316963,202826,true,1555317802,28,1548644627,-6673175
1678317059,202831,true,1554540376,28,1547251543,-7288833
1678317119,202833,true,1554229515,28,1546478149,-7751366
1678317179,202834,true,1554074107,28,1545705142,-8368965
1678319615,202833,true,1554229515,28,1533236122,-20993393
1678320023,202838,true,1553452633,28,1533389445,-20063188
1678321667,202840,true,1553141989,28,1533389445,-19752544
1678322699,202840,true,1553141989,28,1533696139,-19445850
1678323887,202839,true,1553297303,28,1534002893,-19294410
1678325183,202844,true,1552520888,28,1534002893,-18517995
1678325219,202846,true,1552210430,28,1534156293,-18054137
1678326311,202847,true,1552055225,28,1534309709,-17745516
1678328219,202846,true,1552210430,28,1534463140,-17747290
1678328243,202850,true,1551589701,28,1534616586,-16973115
1678328267,202852,true,1551279430,28,1534616586,-16662844
1678328303,202852,true,1551279430,28,1534616586,-16662844
1678328411,202851,true,1551434558,28,1534770048,-16664510
1678328471,202855,true,1550814139,28,1534770048,-16044091
1678328591,202857,true,1550504023,28,1534923525,-15580498
1678328759,202856,true,1550659073,28,1535384048,-15275025
1678328795,202855,true,1550814139,28,1535384048,-15430091
1678328867,202859,true,1550193968,28,1535691140,-14502828
1678329707,202860,true,1550038965,28,1538457735,-11581230
1678330835,202859,true,1550193968,28,1540458931,-9735037
1678330919,202858,true,1550348988,28,1540458931,-9890057
1678348871,202862,true,1549729003,28,1540458931,-9270072
1678350263,202863,true,1549574046,28,1539842901,-9731145
1678350431,202862,true,1549729003,28,1539688932,-10040071
1678350623,202861,true,1549883976,28,1539534979,-10348997
1678351319,202865,true,1549264177,28,1538919319,-10344858
1678351331,202866,true,1549109267,28,1538919319,-10189948
1678351391,202866,true,1549109267,28,1538765442,-10343825
1678351559,202864,true,1549419104,28,1538457735,-10961369
1678351643,202869,true,1548644627,28,1538303905,-10340722
1678351703,202871,true,1548334944,28,1538150090,-10184854
1678352915,202871,true,1548334944,28,1534463140,-13871804
1678360967,202870,true,1548489778,28,1532316502,-16173276
1678366787,202875,true,1547715765,28,1532316502,-15399263
1678367483,202876,true,1547561009,28,1532316502,-15244507
1678368275,202876,true,1547561009,28,1532316502,-15244507
1678368563,202875,true,1547715765,28,1532316502,-15399263
1678369451,202880,true,1546942139,28,1532010085,-14932054
1678369799,202882,true,1546632797,28,1531856899,-14775898
1678369823,202882,true,1546632797,28,1531856899,-14775898
1678369919,202880,true,1546942139,28,1532010085,-14932054
1678369931,202886,true,1546014299,28,1532010085,-14004214
1678369991,202887,true,1545859713,28,1532010085,-13849628
1678370519,202886,true,1546014299,28,1532929521,-13084778
1678370639,202884,true,1546323517,28,1533236122,-13087395
1678370903,202889,true,1545550587,28,1533696139,-11854448
1678370915,202890,true,1545396048,28,1533696139,-11699909
1678371047,202890,true,1545396048,28,1534002893,-11393155
1678371287,202888,true,1545705142,28,1534616586,-11088556
1678371323,202893,true,1544932522,28,1534770048,-10162474
1678371383,202894,true,1544778044,28,1534923525,-9854519
1678371431,202893,true,1544932522,28,1535077017,-9855505
1678371467,202891,true,1545241523,28,1535230525,-10010998
1678371491,202896,true,1544469134,28,1535384048,-9085086
1678371551,202896,true,1544469134,28,1535691140,-8777994
1678371563,202895,true,1544623581,28,1535691140,-8932441
1678371647,202893,true,1544932522,28,1535998294,-8934228
1678371671,202898,true,1544160287,28,1536151894,-8008393
1678372247,202898,true,1544160287,28,1538150090,-6010197
1678375091,202899,true,1544005886,28,1540921115,-3084771
1678375139,202897,true,1544314703,28,1540921115,-3393588
1678375151,202902,true,1543542777,28,1540921115,-2621662
1678377407,202902,true,1543542777,28,1538303905,-5238872
1678378379,202903,true,1543388438,28,1537688737,-5699701
1678379375,202902,true,1543542777,28,1537073815,-6468962
1678379423,202907,true,1542771237,28,1537073815,-5697422
1678379939,202908,true,1542616976,28,1536920123,-5696853
1678379987,202909,true,1542462729,28,1536920123,-5542606
1678380167,202908,true,1542616976,28,1536612785,-6004191
1678380227,202912,true,1542000083,28,1536612785,-5387298
1678380311,202914,true,1541691729,28,1536459139,-5232590
1678380383,202915,true,1541537576,28,1536305509,-5232067
1678380647,202914,true,1541691729,28,1535537587,-6154142
1678380695,202919,true,1540921115,28,1535230525,-5690590
1678380863,202920,true,1540767038,28,1534309709,-6457329
1678381187,202922,true,1540458931,28,1532163286,-8295645
1678382423,202922,true,1540458931,28,1526199783,-14259148
1678386611,202926,true,1539842901,28,1525894589,-13948312
1678386635,202928,true,1539534979,28,1525894589,-13640390
1678386683,202929,true,1539381041,28,1525589456,-13791585
1678386707,202929,true,1539381041,28,1525436912,-13944129
1678386743,202935,true,1538457735,28,1525284384,-13173351
1678386767,202937,true,1538150090,28,1524979373,-13170717
1678386779,202939,true,1537842506,28,1524826890,-13015616
1678386887,202939,true,1537842506,28,1523912314,-13930192
1678387619,202946,true,1536766447,28,1516767088,-19999359
1678387775,202948,true,1536459139,28,1515402680,-21056459
1678388459,202949,true,1536305509,28,1509051653,-27253856
1678388471,202950,true,1536151894,28,1509051653,-27100241
1678388639,202957,true,1535077017,28,1508599028,-26477989
1678388663,202959,true,1534770048,28,1508599028,-26171020
1678388687,202961,true,1534463140,28,1508448183,-26014957
1678388735,202961,true,1534463140,28,1508297353,-26165787
1678388747,202969,true,1533236122,28,1508297353,-24938769
1678388819,202971,true,1532929521,28,1507844954,-25084567
1678388903,202973,true,1532622981,28,1507241967,-25381014
1678388915,202974,true,1532469734,28,1507241967,-25227767
1678389215,202982,true,1531244309,28,1504982912,-26261397
1678389407,202985,true,1530785028,28,1503629104,-27155924
1678389443,202987,true,1530478917,28,1503328424,-27150493
1678389575,202988,true,1530325884,28,1502426742,-27899142
1678389659,202995,true,1529255084,28,1501825922,-27429162
1678389791,202997,true,1528949279,28,1500925141,-28024138
1678390247,202999,true,1528643535,28,1497926441,-30717094
1678390271,203000,true,1528490686,28,1497776663,-30714023
1678390283,203007,true,1527421171,28,1497626900,-29794271
1678390619,203009,true,1527115732,28,1495681348,-31434384
1678390643,203011,true,1526810355,28,1495681348,-31129007
1678390811,203012,true,1526657689,28,1495382256,-31275433
1678391219,203016,true,1526047179,28,1494933731,-31113448
1678391303,203018,true,1525742015,28,1494784253,-30957762
1678391351,203020,true,1525436912,28,1494634789,-30802123
1678391435,203022,true,1525131871,28,1494335907,-30795964
1678391447,203026,true,1524521970,28,1494335907,-30186063
1678391459,203028,true,1524217112,28,1494186488,-30030624
1678391471,203030,true,1523912314,28,1494186488,-29725826
1678391531,203033,true,1523455232,28,1493887696,-29567536
1678391651,203037,true,1522846002,28,1493140976,-29705026
1678391687,203039,true,1522541479,28,1492991677,-29549802
1678392731,203042,true,1522084807,28,1488221978,-33862829
1678392827,203044,true,1521780436,28,1487775600,-34004836
1678392839,203048,true,1521171876,28,1487626838,-33545038
1678392851,203050,true,1520867687,28,1487626838,-33240849
1678392887,203053,true,1520411518,28,1487478090,-32933428
1678393019,203056,true,1519955486,28,1486734574,-33220912
1678393139,203061,true,1519195736,28,1485991430,-33204306
1678393223,203063,true,1518891943,28,1485694276,-33197667
1678393235,203066,true,1518436366,28,1485694276,-32742090
1678393259,203070,true,1517829143,28,1485545721,-32283422
1678393295,203075,true,1517070457,28,1485100147,-31970310
1678393619,203080,true,1516312149,28,1481688512,-34623637
1678393643,203083,true,1515857346,28,1481392219,-34465127
1678393667,203087,true,1515251155,28,1481244094,-34007061
1678393859,203092,true,1514493756,28,1479615703,-34878053
1678393871,203097,true,1513736737,28,1479467756,-34268981
1678393907,203100,true,1513282706,28,1479319824,-33962882
1678394231,203103,true,1512828812,28,1477398054,-35430758
1678394243,203107,true,1512223832,28,1477250329,-34973503
1678394291,203112,true,1511467947,28,1476807242,-34660705
1678394315,203115,true,1511014597,28,1476659576,-34355021
1678394339,203119,true,1510410343,28,1476364289,-34046054
1678394351,203123,true,1509806329,28,1476216667,-33589662
1678394483,203129,true,1508900763,28,1474446358,-34454405
1678394495,203132,true,1508448183,28,1474298928,-34149255
1678394507,203135,true,1507995739,28,1474151513,-33844226
1678394531,203140,true,1507241967,28,1473709356,-33532611
1678394543,203146,true,1506337938,28,1473562000,-32775938
1678394567,203149,true,1505886127,28,1473267332,-32618795
1678394627,203154,true,1505133410,28,1472236457,-32896953
1678394651,203159,true,1504381069,28,1471794874,-32586195
1678394675,203165,true,1503478756,28,1471353424,-32125332
1678394687,203168,true,1503027803,28,1471059197,-31968606
1678394723,203173,true,1502276514,28,1470470921,-31805593
1678394747,203178,true,1501525601,28,1470029868,-31495733
1678394759,203185,true,1500474954,28,1469735906,-30739048
1678394783,203188,true,1500024901,28,1469295073,-30729828
1678394807,203194,true,1499125201,28,1468854373,-30270828
1678394831,203200,true,1498226041,28,1468266978,-29959063
1678394855,203207,true,1497177702,28,1467679818,-29497884
1678394891,203211,true,1496578981,28,1466946198,-29632783
1678394903,203216,true,1495830916,28,1466652853,-29178063
1678395047,203222,true,1494933731,28,1463576267,-31357464
1678395071,203229,true,1493887696,28,1463137282,-30750414
1678395083,203233,true,1493290290,28,1462990983,-30299307
1678395119,203238,true,1492543869,28,1462552174,-29991695
1678395131,203244,true,1491648656,28,1462552174,-29096482
1678395155,203250,true,1490753980,28,1462259707,-28494273
1678395215,203255,true,1490008827,28,1461528797,-28480030
1678395239,203260,true,1489264046,28,1461236535,-28027511
1678395263,203266,true,1488370800,28,1460944331,-27426469
1678395299,203273,true,1487329357,28,1460506135,-26823222
1678395335,203278,true,1486585915,28,1460068071,-26517844
1678395347,203283,true,1485842845,28,1459922079,-25920766
1678395371,203289,true,1484951652,28,1459484190,-25467462
1678395443,203297,true,1483764225,28,1458462960,-25301265
1678395467,203301,true,1483170867,28,1457879720,-25291147
1678395503,203308,true,1482133063,28,1457005298,-25127765
1678395515,203314,true,1481244094,28,1456713941,-24530153
1678395551,203324,true,1479763664,28,1455694649,-24069015
1678395575,203329,true,1479024005,28,1454967020,-24056985
1678395587,203336,true,1477989102,28,1454676070,-23313032
1678395635,203343,true,1476954923,28,1453222194,-23732729
1678395647,203352,true,1475626328,28,1452786315,-22840013
1678395659,203357,true,1474888736,28,1452495801,-22392935
1678395671,203364,true,1473856727,28,1452205345,-21651382
1678395731,203370,true,1472972722,28,1450318799,-22653923
1678395743,203378,true,1471794874,28,1450028779,-21766095
1678395755,203383,true,1471059197,28,1449593857,-21465340
1678395767,203389,true,1470176871,28,1449303982,-20872889
1678395779,203395,true,1469295073,28,1448869278,-20425795
1678395851,203403,true,1468120166,28,1446987065,-21133101
1678395923,203408,true,1467386326,28,1444962802,-22423524
1678395947,203413,true,1466652853,28,1444384961,-22267892
1678395971,203416,true,1466212945,28,1443662986,-22549959
1678395983,203424,true,1465040502,28,1443374296,-21666206
1678396223,203426,true,1464747538,28,1439194783,-25552755
1678396259,203431,true,1464015384,28,1438619249,-25396135
1678396271,203434,true,1463576267,28,1438331568,-25244699
1678396283,203441,true,1462552174,28,1438187750,-24364424
1678396559,203445,true,1461967299,28,1434883884,-27083415
1678396583,203450,true,1461236535,28,1434740410,-26496125
1678396595,203453,true,1460798251,28,1434596950,-26201301
1678396643,203460,true,1459776101,28,1434453505,-25322596
1678396847,203462,true,1459484190,28,1433879867,-25604323
1678397003,203467,true,1458754667,28,1433019840,-25734827
1678397015,203468,true,1458608806,28,1433019840,-25588966
1678397063,203475,true,1457588188,28,1432876552,-24711636
1678397819,203476,true,1457442444,28,1437900155,-19542289
1678398335,203481,true,1456713941,28,1438763111,-17950830
1678398635,203482,true,1456568284,28,1438906987,-17661297
1678398647,203489,true,1455549094,28,1438906987,-16642107
1678398683,203490,true,1455403554,28,1438906987,-16496567
1678398707,203495,true,1454676070,28,1438763111,-15912959
1678399547,203497,true,1454385179,28,1435888604,-18496575
1678399559,203504,true,1453367516,28,1435888604,-17478912
1678399955,203505,true,1453222194,28,1435888604,-17333590
1678399967,203510,true,1452495801,28,1435888604,-16607197
1678399979,203512,true,1452205345,28,1435888604,-16316741
1678399991,203518,true,1451334327,28,1435888604,-15445723
1678400075,203518,true,1451334327,28,1436175796,-15158531
1678400135,203522,true,1450753938,28,1436463045,-14290893
1678400147,203524,true,1450463831,28,1436606692,-13857139
1678400243,203530,true,1449593857,28,1436894028,-12699829
1678400351,203529,true,1449738817,28,1437181421,-12557396
1678400387,203534,true,1449014165,28,1437325139,-11689026
1678400471,203535,true,1448869278,28,1437468871,-11400407
1678401947,203541,true,1448000260,28,1441355087,-6645173
1678402043,203541,true,1448000260,28,1441210966,-6789294
1678402283,203545,true,1447421205,28,1440922767,-6498438
1678402631,203547,true,1447131764,28,1440490577,-6641187
1678402775,203553,true,1446263789,28,1440346542,-5917247
1678402811,203553,true,1446263789,28,1440202522,-6061267
1678402871,203557,true,1445685428,28,1440058516,-5626912
1678402883,203558,true,1445540874,28,1440058516,-5482358
1678402931,203565,true,1444529400,28,1439770547,-4758853
1678403075,203565,true,1444529400,28,1439194783,-5334617
1678403123,203569,true,1443951733,28,1438906987,-5044746
1678403567,203571,true,1443662986,28,1436750352,-6912634
1678403747,203578,true,1442652826,28,1436032193,-6620633
1678403831,203578,true,1442652826,28,1435601469,-7051357
1678405043,203581,true,1442220116,28,1433306458,-8913658
1678405103,203582,true,1442075909,28,1433306458,-8769451
1678405283,203586,true,1441499223,28,1433593134,-7906089
1678405355,203586,true,1441499223,28,1433593134,-7906089
1678405379,203589,true,1441066859,28,1433736493,-7330366
1678405871,203590,true,1440922767,28,1434023255,-6899512
1678405955,203595,true,1440202522,28,1434166657,-6035865
1678406111,203595,true,1440202522,28,1434310074,-5892448
1678406339,203599,true,1439626585,28,1434453505,-5173080
1678406423,203600,true,1439482636,28,1434596950,-4885686
1678407119,203605,true,1438763111,28,1435170875,-3592236
1678407287,203605,true,1438763111,28,1435170875,-3592236
1678407311,203607,true,1438475401,28,1435170875,-3304526
1678407323,203608,true,1438331568,28,1435170875,-3160693
1678407359,203612,true,1437756379,28,1435027372,-2729007
1678407383,203613,true,1437612618,28,1435027372,-2585246
1678407491,203616,true,1437181421,28,1434596950,-2584471
1678407503,203617,true,1437037717,28,1434453505,-2584212
1678407611,203620,true,1436606692,28,1434166657,-2440035
1678407803,203620,true,1436606692,28,1433736493,-2870199
1678407863,203622,true,1436319414,28,1433449789,-2869625
1678407935,203623,true,1436175796,28,1433163142,-3012654
1678407959,203626,true,1435745029,28,1433019840,-2725189
1678409483,203626,true,1435745029,28,1427442225,-8302804
1678409531,203629,true,1435314392,28,1427299495,-8014897
1678409759,203629,true,1435314392,28,1427014078,-8300314
1678410179,203632,true,1434883884,28,1426728718,-8155166
1678410275,203632,true,1434883884,28,1426586059,-8297825
1678410323,203634,true,1434596950,28,1426443415,-8153535
1678410335,203634,true,1434596950,28,1426443415,-8153535
1678410395,203637,true,1434166657,28,1426300785,-7865872
1678410455,203637,true,1434166657,28,1426158169,-8008488
1678410947,203639,true,1433879867,28,1424875268,-9004599
1678411007,203639,true,1433879867,28,1424732795,-9147072
1678411019,203642,true,1433449789,28,1424732795,-8716994
1678411043,203642,true,1433449789,28,1424590336,-8859453
1678411055,203645,true,1433019840,28,1424590336,-8429504
1678411103,203646,true,1432876552,28,1424305460,-8571092
1678411127,203650,true,1432303545,28,1424163044,-8140501
1678411139,203650,true,1432303545,28,1424163044,-8140501
1678411223,203653,true,1431873940,28,1423593521,-8280419
1678411271,203654,true,1431730767,28,1423308845,-8421922
1678411295,203657,true,1431301333,28,1423166529,-8134804
1678411391,203657,true,1431301333,28,1422597404,-8703929
1678411643,203660,true,1430872029,28,1421317707,-9554322
1678411691,203661,true,1430728956,28,1421175589,-9553367
1678411715,203664,true,1430299823,28,1421033486,-9266337
1678411739,203663,true,1430442853,28,1421033486,-9409367
1678411751,203664,true,1430299823,28,1420891397,-9408426
1678411763,203664,true,1430299823,28,1420891397,-9408426
1678411799,203665,true,1430156807,28,1420749322,-9407485
1678411919,203663,true,1430442853,28,1420323182,-10119671
1678411931,203664,true,1430299823,28,1420323182,-9976641
1678412363,203663,true,1430442853,28,1420607261,-9835592
1678412891,203663,true,1430442853,28,1421744145,-8698708
1678412903,203661,true,1430728956,28,1421744145,-8984811
1678412915,203662,true,1430585897,28,1421744145,-8841752
1678413287,203662,true,1430585897,28,1423878254,-6707643
1678413299,203662,true,1430585897,28,1423878254,-6707643
1678413323,203660,true,1430872029,28,1424020642,-6851387
1678414163,203660,true,1430872029,28,1427014078,-3857951
1678414847,203660,true,1430872029,28,1428298904,-2573125
1678417463,203661,true,1430728956,28,1428870310,-1858646
1678417499,203659,true,1431015116,28,1428870310,-2144806
1678417523,203660,true,1430872029,28,1428870310,-2001719
1678419743,203660,true,1430872029,28,1427299495,-3572534
1678420631,203661,true,1430728956,28,1427299495,-3429461
1678421159,203661,true,1430728956,28,1427299495,-3429461
1678421171,203662,true,1430585897,28,1427299495,-3286402
1678421999,203662,true,1430585897,28,1426728718,-3857179
1678422035,203663,true,1430442853,28,1426728718,-3714135
1678422815,203663,true,1430442853,28,1424732795,-5710058
1678422983,203664,true,1430299823,28,1424163044,-6136779
1678422995,203665,true,1430156807,28,1424163044,-5993763
1678423103,203666,true,1430013806,28,1423735881,-6277925
1678423259,203667,true,1429870819,28,1423166529,-6704290
1678423631,203669,true,1429584888,28,1421459838,-8125050
1678424519,203670,true,1429441943,28,1418336220,-11105723
1678425731,203671,true,1429299013,28,1416635322,-12663691
1678425995,203673,true,1429013197,28,1416635322,-12377875
1678426235,203674,true,1428870310,28,1416635322,-12234988
1678426295,203675,true,1428727437,28,1416635322,-12092115
1678426379,203677,true,1428441734,28,1416635322,-11806412
1678427795,203678,true,1428298904,28,1418761764,-9537140
1678428899,203679,true,1428156089,28,1420323182,-7832907
1678428947,203679,true,1428156089,28,1420465214,-7690875
1678429127,203681,true,1427870500,28,1420465214,-7405286
1678429631,203682,true,1427727727,28,1420465214,-7262513
1678430267,203683,true,1427584969,28,1419187435,-8397534
1678430627,203684,true,1427442225,28,1418194401,-9247824
1678430783,203686,true,1427156779,28,1417769027,-9387752
1678430795,203688,true,1426871391,28,1417769027,-9102364
1678431059,203690,true,1426586059,28,1416918664,-9667395
1678431167,203691,true,1426443415,28,1416635322,-9808093
1678431191,203693,true,1426158169,28,1416493673,-9664496
1678431239,203696,true,1425730407,28,1416352038,-9378369
1678431683,203698,true,1425445304,28,1414087800,-11357504
1678432019,203700,true,1425160257,28,1412250772,-12909485
1678432031,203701,true,1425017756,28,1412109561,-12908195
1678432415,203704,true,1424590336,28,1409993090,-14597246
1678432487,203707,true,1424163044,28,1409429234,-14733810
1678432511,203709,true,1423878254,28,1409288305,-14589949
1678432547,203710,true,1423735881,28,1409006490,-14729391
1678432595,203713,true,1423308845,28,1408583872,-14724973
1678432619,203716,true,1422881938,28,1408443028,-14438910
1678432643,203718,true,1422597404,28,1408302198,-14295206
1678432703,203719,true,1422455159,28,1407739017,-14716142
1678432775,203722,true,1422028508,28,1407035359,-14993149
1678432823,203725,true,1421601984,28,1406613333,-14988651
1678432847,203727,true,1421317707,28,1406332052,-14985655
1678432931,203728,true,1421175589,28,1405629097,-15546492
1678432955,203731,true,1420749322,28,1405348014,-15401308
1678432967,203734,true,1420323182,28,1405348014,-14975168
1678432979,203735,true,1420181164,28,1405207493,-14973671
1678433063,203736,true,1420039160,28,1404786015,-15253145
1678433075,203739,true,1419613233,28,1404786015,-14827218
1678433099,203742,true,1419187435,28,1404645550,-14541885
1678433111,203744,true,1418903640,28,1404645550,-14258090
1678433495,203744,true,1418903640,28,1403241677,-15661963
1678433507,203747,true,1418478054,28,1403241677,-15236377
1678433519,203750,true,1418052595,28,1403241677,-14810918
1678433555,203752,true,1417769027,28,1403101367,-14667660
1678433603,203752,true,1417769027,28,1402961071,-14807956
1678433663,203755,true,1417343782,28,1402961071,-14382711
1678433675,203758,true,1416918664,28,1402961071,-13957593
1678433687,203760,true,1416635322,28,1402961071,-13674251
1678433843,203759,true,1416776986,28,1402961071,-13815915
1678433855,203761,true,1416493673,28,1402961071,-13532602
1678433975,203763,true,1416210417,28,1403241677,-12968740
1678434875,203764,true,1416068810,28,1407176063,-8892747
1678436483,203764,true,1416068810,28,1409288305,-6780505
1678436699,203766,true,1415785639,28,1409288305,-6497334
1678437887,203768,true,1415502524,28,1409288305,-6214219
1678437911,203769,true,1415360988,28,1409288305,-6072683
1678437947,203769,true,1415360988,28,1409288305,-6072683
1678437995,203771,true,1415077958,28,1409147390,-5930568
1678438079,203773,true,1414794985,28,1409147390,-5647595
1678439879,203774,true,1414653520,28,1407598258,-7055262
1678440983,203774,true,1414653520,28,1407176063,-7477457
1678441019,203775,true,1414512068,28,1407176063,-7336005
1678441031,203778,true,1414087800,28,1407176063,-6911737
1678441271,203779,true,1413946405,28,1406753994,-7192411
1678441307,203779,true,1413946405,28,1406753994,-7192411
1678441343,203780,true,1413805025,28,1406613333,-7191692
1678441391,203782,true,1413522306,28,1406472686,-7049620
1678441403,203784,true,1413239644,28,1406472686,-6766958
1678441415,203784,true,1413239644,28,1406472686,-6766958
1678441427,203785,true,1413098334,28,1406332052,-6766282
1678441943,203788,true,1412674489,28,1404364663,-8309826
1678442507,203789,true,1412533236,28,1402400027,-10133209
1678442567,203788,true,1412674489,28,1402119589,-10554900
1678442603,203789,true,1412533236,28,1401979391,-10553845
1678442711,203792,true,1412109561,28,1401418739,-10690822
1678442963,203793,true,1411968364,28,1400438138,-11530226
1678443215,203793,true,1411968364,28,1399598169,-12370195
1678443479,203794,true,1411827181,28,1399178374,-12648807
1678443563,203797,true,1411403718,28,1399038470,-12365248
1678443635,203798,true,1411262591,28,1399038470,-12224121
1678443935,203798,true,1411262591,28,1398478995,-12783596
1678443995,203799,true,1411121479,28,1398339161,-12782318
1678444043,203802,true,1410698228,28,1398199341,-12498887
1678444067,203803,true,1410557172,28,1398059535,-12497637
1678444115,203804,true,1410416130,28,1397919743,-12496387
1678444127,203806,true,1410134089,28,1397779965,-12354124
1678444151,203809,true,1409711134,28,1397640201,-12070933
1678444703,203813,true,1409147390,28,1394011237,-15136153
1678444811,203813,true,1409147390,28,1393453772,-15693618
1678444835,203815,true,1408865603,28,1393175123,-15690480
1678444859,203819,true,1408302198,28,1393035820,-15266378
1678444907,203823,true,1407739017,28,1392478745,-15260272
1678444955,203825,true,1407457512,28,1391921892,-15535620
1678445087,203828,true,1407035359,28,1390530736,-16504623
1678445231,203832,true,1406472686,28,1388863183,-17609503
1678445291,203836,true,1405910237,28,1388307777,-17602460
1678445495,203838,true,1405629097,28,1385949776,-19679321
1678446083,203840,true,1405348014,28,1380969576,-24378438
1678446143,203844,true,1404786015,28,1380693423,-24092592
1678446167,203849,true,1404083833,28,1380693423,-23390410
1678446191,203851,true,1403803058,28,1380555368,-23247690
1678446431,203853,true,1403522339,28,1379727324,-23795015
1678446443,203856,true,1403101367,28,1379589365,-23512002
1678447211,203860,true,1402540267,28,1380831493,-21708774
1678447223,203862,true,1402259801,28,1380831493,-21428308
1678447295,203863,true,1402119589,28,1381107673,-21011916
1678447427,203867,true,1401558881,28,1381383908,-20174973
1678447451,203870,true,1401138497,28,1381383908,-19754589
1678448555,203872,true,1400858312,28,1381383908,-19474404
1678449131,203873,true,1400718240,28,1380141284,-20576956
1678449143,203877,true,1400158093,28,1380141284,-20016809
1678449155,203880,true,1399738129,28,1380141284,-19596845
1678449167,203882,true,1399458224,28,1380141284,-19316940
1678449191,203882,true,1399458224,28,1380141284,-19316940
1678449203,203886,true,1398898580,28,1380141284,-18757296
1678449251,203888,true,1398618843,28,1380141284,-18477559
1678450523,203891,true,1398199341,28,1382489402,-15709939
1678450715,203891,true,1398199341,28,1382904190,-15295151
1678450739,203895,true,1397640201,28,1383042481,-14597720
1678450775,203898,true,1397220993,28,1383180785,-14040208
1678450847,203900,true,1396941590,28,1383457435,-13484155
1678450871,203900,true,1396941590,28,1383595781,-13345809
1678450955,203903,true,1396522592,28,1383872514,-12650078
1678450979,203905,true,1396243329,28,1384010901,-12232428
1678451135,203907,true,1395964122,28,1384564588,-11399534
1678451147,203907,true,1395964122,28,1384564588,-11399534
1678451507,203909,true,1395684971,28,1386642890,-9042081
1678452407,203911,true,1395405876,28,1391504399,-3901477
1678452491,203912,true,1395266350,28,1392061085,-3205265
1678452959,203912,true,1395266350,28,1393732477,-1533873
1678453007,203913,true,1395126837,28,1393732477,-1394360
1678453031,203915,true,1394847853,28,1393732477,-1115376
1678453067,203916,true,1394708383,28,1393732477,-975906
1678453079,203915,true,1394847853,28,1393732477,-1115376
1678454783,203915,true,1394847853,28,1396103719,1255866
1678455011,203917,true,1394568926,28,1396103719,1534793
1678455035,203918,true,1394429483,28,1396243329,1813846
1678455059,203917,true,1394568926,28,1396243329,1674403
1678455143,203916,true,1394708383,28,1396941590,2233207
1678455203,203915,true,1394847853,28,1397360715,2512862
1678455731,203916,true,1394708383,28,1400718240,6009857
1678455743,203915,true,1394847853,28,1400718240,5870387
1678455779,203913,true,1395126837,28,1400998398,5871561
1678455791,203913,true,1395126837,28,1401138497,6011660
1678455803,203912,true,1395266350,28,1401278611,6012261
1678455875,203910,true,1395545417,28,1402259801,6714384
1678455959,203908,true,1395824540,28,1403241677,7417137
1678455971,203908,true,1395824540,28,1403382001,7557461
1678455983,203908,true,1395824540,28,1403522339,7697799
1678455995,203905,true,1396243329,28,1403803058,7559729
1678456007,203903,true,1396522592,28,1403943438,7420846
1678456043,203902,true,1396662244,28,1404505100,7842856
1678456091,203903,true,1396522592,28,1405207493,8684901
1678456139,203900,true,1396941590,28,1405910237,8968647
1678456175,203898,true,1397220993,28,1406613333,9392340
1678456487,203896,true,1397500451,28,1411968364,14467913
1678456847,203897,true,1397360715,28,1418194401,20833686
1678456859,203894,true,1397779965,28,1418336220,20556255
1678456895,203892,true,1398059535,28,1418761764,20702229
1678456931,203891,true,1398199341,28,1419045530,20846189
1678457015,203892,true,1398059535,28,1419897170,21837635
1678457135,203890,true,1398339161,28,1421033486,22694325
1678457147,203887,true,1398758704,28,1421175589,22416885
1678457171,203887,true,1398758704,28,1421317707,22559003
1678457195,203888,true,1398618843,28,1421459838,22840995
1678457219,203887,true,1398758704,28,1421601984,22843280
1678457231,203885,true,1399038470,28,1421744145,22705675
1678457243,203884,true,1399178374,28,1421744145,22565771
1678457267,203886,true,1398898580,28,1421886319,22987739
1678457279,203885,true,1399038470,28,1421886319,22847849
1678457339,203883,true,1399318292,28,1422028508,22710216
1678457687,203883,true,1399318292,28,1421886319,22568027
1678457699,203885,true,1399038470,28,1421744145,22705675
1678457711,203884,true,1399178374,28,1421744145,22565771
1678457723,203883,true,1399318292,28,1421601984,22283692
1678457735,203884,true,1399178374,28,1421459838,22281464
1678457807,203886,true,1398898580,28,1420607261,21708681
1678458011,203885,true,1399038470,28,1417769027,18730557
1678458023,203884,true,1399178374,28,1417485516,18307142
1678458083,203885,true,1399038470,28,1416635322,17596852
1678458107,203887,true,1398758704,28,1416352038,17593334
1678458287,203886,true,1398898580,28,1413805025,14906445
1678458299,203884,true,1399178374,28,1413522306,14343932
1678458515,203884,true,1399178374,28,1410557172,11378798
1678458539,203887,true,1398758704,28,1410275103,11516399
1678458551,203885,true,1399038470,28,1410134089,11095619
1678458587,203883,true,1399318292,28,1409711134,10392842
1678458779,203882,true,1399458224,28,1407598258,8140034
1678458803,203884,true,1399178374,28,1407457512,8279138
1678458851,203883,true,1399318292,28,1407035359,7717067
1678458935,203880,true,1399738129,28,1406332052,6593923
1678458947,203879,true,1399878103,28,1406332052,6453949
1678458959,203881,true,1399598169,28,1406191433,6593264
1678459019,203879,true,1399878103,28,1405769660,5891557
1678459031,203877,true,1400158093,28,1405769660,5611567
1678459211,203876,true,1400298109,28,1405207493,4909384
1678459295,203878,true,1400018091,28,1404926494,4908403
1678459307,203876,true,1400298109,28,1404926494,4628385
1678459379,203874,true,1400578182,28,1404505100,3926918
1678459391,203873,true,1400718240,28,1404505100,3786860
1678459427,203875,true,1400438138,28,1404364663,3926525
1678459499,203873,true,1400718240,28,1403803058,3084818
1678459511,203871,true,1400998398,28,1403662692,2664294
1678459547,203870,true,1401138497,28,1403382001,2243504
1678459679,203871,true,1400998398,28,1402680521,1682123
1678459787,203870,true,1401138497,28,1401979391,840894
1678459811,203868,true,1401418739,28,1401839207,420468
1678459895,203867,true,1401558881,28,1401278611,-280270
1678459919,203869,true,1401278611,28,1401138497,-140114
1678459931,203867,true,1401558881,28,1401138497,-420384
1678459955,203865,true,1401839207,28,1400998398,-840809
1678460351,203862,true,1402259801,28,1400018091,-2241710
1678460387,203864,true,1401979391,28,1399878103,-2101288
1678460435,203863,true,1402119589,28,1399738129,-2381460
1678460447,203860,true,1402540267,28,1399598169,-2942098
1678460459,203858,true,1402820789,28,1399598169,-3222620
1678460471,203859,true,1402680521,28,1399598169,-3082352
1678460483,203858,true,1402820789,28,1399598169,-3222620
1678460507,203855,true,1403241677,28,1399598169,-3643508
1678460555,203852,true,1403662692,28,1399458224,-4204468
1678461275,203853,true,1403522339,28,1399738129,-3784210
1678461287,203851,true,1403803058,28,1399878103,-3924955
1678461299,203848,true,1404224241,28,1399878103,-4346138
1678461335,203845,true,1404645550,28,1400158093,-4487457
1678461419,203846,true,1404505100,28,1400718240,-3786860
1678462235,203846,true,1404505100,28,1404224241,-280859
1678462343,203843,true,1404926494,28,1404083833,-842661
1678462631,203839,true,1405488548,28,1404786015,-702533
1678462655,203841,true,1405207493,28,1404786015,-421478
1678462823,203839,true,1405488548,28,1405348014,-140534
1678462871,203836,true,1405910237,28,1405488548,-421689
1678462883,203832,true,1406472686,28,1405488548,-984138
1678462895,203834,true,1406191433,28,1405629097,-562336
1678462979,203833,true,1406332052,28,1405769660,-562392
1678463099,203830,true,1406753994,28,1406050828,-703166
1678463111,203826,true,1407316780,28,1406191433,-1125347
1678463183,203828,true,1407035359,28,1406332052,-703307
1678463243,203827,true,1407176063,28,1406613333,-562730
1678463255,203826,true,1407316780,28,1406613333,-703447
1678463411,203822,true,1407879791,28,1407457512,-422279
1678463483,203824,true,1407598258,28,1407879791,281533
1678463495,203823,true,1407739017,28,1407879791,140774
1678463543,203821,true,1408020579,28,1408161381,140802
1678463711,203817,true,1408583872,28,1409429234,845362
1678463735,203819,true,1408302198,28,1409570177,1267979
1678463771,203818,true,1408443028,28,1409852105,1409077
1678464911,203816,true,1408724730,28,1415219466,6494736
1678464923,203812,true,1409288305,28,1415360988,6072683
1678465319,203814,true,1409006490,28,1416210417,7203927
1678465343,203813,true,1409147390,28,1416210417,7063027
1678465403,203812,true,1409288305,28,1416352038,7063733
1678465415,203809,true,1409711134,28,1416352038,6640904
1678465571,203811,true,1409429234,28,1416493673,7064439
1678465607,203810,true,1409570177,28,1416493673,6923496
1678465619,203809,true,1409711134,28,1416493673,6782539
1678465631,203807,true,1409993090,28,1416493673,6500583
1678465643,203810,true,1409570177,28,1416635322,7065145
1678465739,203809,true,1409711134,28,1416776986,7065852
1678465823,203809,true,1409711134,28,1417060356,7349222
1678465835,203806,true,1410134089,28,1417060356,6926267
1678465871,203809,true,1409711134,28,1417202062,7490928
1678465883,203808,true,1409852105,28,1417343782,7491677
1678465895,203808,true,1409852105,28,1417343782,7491677
1678465931,203805,true,1410275103,28,1417627265,7352162
1678465979,203808,true,1409852105,28,1417910804,8058699
1678465991,203807,true,1409993090,28,1417910804,7917714
1678466003,203807,true,1409993090,28,1418052595,8059505
1678466015,203805,true,1410275103,28,1418194401,7919298
1678466051,203806,true,1410134089,28,1418478054,8343965
1678466063,203806,true,1410134089,28,1418619902,8485813
1678466183,203805,true,1410275103,28,1419755195,9480092
1678466219,203803,true,1410557172,28,1420039160,9481988
1678466375,203805,true,1410275103,28,1421459838,11184735
1678466387,203804,true,1410416130,28,1421459838,11043708
1678466651,203804,true,1410416130,28,1423024226,12608096
1678466771,203802,true,1410698228,28,1423593521,12895293
1678466783,203804,true,1410416130,28,1423593521,13177391
1678466795,203803,true,1410557172,28,1423593521,13036349
1678466855,203803,true,1410557172,28,1423878254,13321082
1678467143,203802,true,1410698228,28,1425017756,14319528
1678467167,203803,true,1410557172,28,1425017756,14460584
1678467191,203801,true,1410839297,28,1425160257,14320960
1678467287,203801,true,1410839297,28,1425302773,14463476
1678467863,203800,true,1410980381,28,1422028508,11048127
1678467875,203802,true,1410698228,28,1421886319,11188091
1678467887,203800,true,1410980381,28,1421744145,10763764
1678467899,203800,true,1410980381,28,1421601984,10621603
1678467911,203799,true,1411121479,28,1421459838,10338359
1678468115,203799,true,1411121479,28,1418761764,7640285
1678468151,203798,true,1411262591,28,1418336220,7073629
1678468175,203798,true,1411262591,28,1418052595,6790004
1678468187,203796,true,1411544858,28,1417910804,6365946
1678468211,203798,true,1411262591,28,1417627265,6364674
1678468247,203797,true,1411403718,28,1417060356,5656638
1678468259,203797,true,1411403718,28,1417060356,5656638
1678468271,203796,true,1411544858,28,1416918664,5373806
1678468403,203797,true,1411403718,28,1415219466,3815748
1678468571,203795,true,1411686013,28,1413805025,2119012
1678468583,203796,true,1411544858,28,1413805025,2260167
1678468595,203795,true,1411686013,28,1413805025,2119012
1678468631,203796,true,1411544858,28,1413522306,1977448
1678468703,203794,true,1411827181,28,1413098334,1271153
1678468715,203795,true,1411686013,28,1412957038,1271025
1678468811,203795,true,1411686013,28,1412391997,705984
1678468931,203796,true,1411544858,28,1411544858,0
1678469003,203794,true,1411827181,28,1410980381,-846800
1678469015,203795,true,1411686013,28,1410980381,-705632
1678469051,203795,true,1411686013,28,1410698228,-987785
1678469075,203795,true,1411686013,28,1410557172,-1128841
1678469627,203794,true,1411827181,28,1408020579,-3806602
1678469987,203794,true,1411827181,28,1407739017,-4088164
1678470059,203794,true,1411827181,28,1408020579,-3806602
1678470407,203794,true,1411827181,28,1408161381,-3665800
1678470431,203792,true,1412109561,28,1408161381,-3948180
1678470443,203791,true,1412250772,28,1408161381,-4089391
1678470479,203790,true,1412391997,28,1408302198,-4089799
1678470491,203789,true,1412533236,28,1408302198,-4231038
1678470503,203786,true,1412957038,28,1408302198,-4654840
1678470731,203785,true,1413098334,28,1409006490,-4091844
1678470815,203783,true,1413380968,28,1409288305,-4092663
1678470839,203782,true,1413522306,28,1409288305,-4234001
1678470851,203779,true,1413946405,28,1409429234,-4517171
1678470875,203778,true,1414087800,28,1409429234,-4658566
1678471007,203780,true,1413805025,28,1409852105,-3952920
1678471847,203779,true,1413946405,28,1411403718,-2542687
1678472267,203776,true,1414370631,28,1411544858,-2825773
1678472303,203775,true,1414512068,28,1411403718,-3108350
1678473371,203777,true,1414229208,28,1408865603,-5363605
1678473647,203776,true,1414370631,28,1408443028,-5927603
1678474403,203775,true,1414512068,28,1407457512,-7054556
1678474463,203775,true,1414512068,28,1407457512,-7054556
1678474475,203777,true,1414229208,28,1407457512,-6771696
1678474727,203776,true,1414370631,28,1407316780,-7053851
1678475039,203775,true,1414512068,28,1406753994,-7758074
1678475063,203775,true,1414512068,28,1406753994,-7758074
1678475075,203777,true,1414229208,28,1406753994,-7475214
1678475111,203776,true,1414370631,28,1406753994,-7616637
1678475171,203773,true,1414794985,28,1406753994,-8040991
1678475207,203773,true,1414794985,28,1406753994,-8040991
1678475363,203775,true,1414512068,28,1407457512,-7054556
1678475387,203774,true,1414653520,28,1407598258,-7055262
1678475543,203772,true,1414936465,28,1408443028,-6493437
1678475627,203772,true,1414936465,28,1409006490,-5929975
1678475651,203773,true,1414794985,28,1409147390,-5647595
1678476239,203772,true,1414936465,28,1412250772,-2685693
1678476299,203770,true,1415219466,28,1412674489,-2544977
1678476371,203770,true,1415219466,28,1412957038,-2262428
1678476803,203772,true,1414936465,28,1415219466,283001
1678477283,203771,true,1415077958,28,1416493673,1415715
1678477319,203769,true,1415360988,28,1416493673,1132685
1678477379,203769,true,1415360988,28,1416493673,1132685
1678477463,203770,true,1415219466,28,1416635322,1415856
1678477487,203769,true,1415360988,28,1416635322,1274334
1678477859,203767,true,1415644074,28,1417060356,1416282
1678478027,203767,true,1415644074,28,1417202062,1557988
1678478099,203769,true,1415360988,28,1417343782,1982794
1678478159,203768,true,1415502524,28,1417485516,1982992
1678478183,203766,true,1415785639,28,1417627265,1841626
1678478279,203766,true,1415785639,28,1418052595,2266956
1678479107,203768,true,1415502524,28,1420749322,5246798
1678479119,203766,true,1415785639,28,1420749322,4963683
1678479167,203764,true,1416068810,28,1420891397,4822587
1678479611,203764,true,1416068810,28,1422170710,6101900
1678479623,203765,true,1415927217,28,1422170710,6243493
1678479659,203765,true,1415927217,28,1422312927,6385710
1678480775,203763,true,1416210417,28,1423024226,6813809
1678480811,203762,true,1416352038,28,1423024226,6672188
1678481075,203764,true,1416068810,28,1422597404,6528594
1678482023,203764,true,1416068810,28,1420465214,4396404
1678482299,203763,true,1416210417,28,1420039160,3828743
1678482647,203763,true,1416210417,28,1419329353,3118936
1678482947,203765,true,1415927217,28,1419045530,3118313
1678482959,203765,true,1415927217,28,1419045530,3118313
1678482971,203764,true,1416068810,28,1419045530,2976720
1678483115,203765,true,1415927217,28,1418761764,2834547
1678483139,203767,true,1415644074,28,1418761764,3117690
1678483307,203768,true,1415502524,28,1418478054,2975530
1678483319,203767,true,1415644074,28,1418478054,2833980
1678483355,203768,true,1415502524,28,1418336220,2833696
1678483439,203771,true,1415077958,28,1418052595,2974637
1678483511,203772,true,1414936465,28,1417910804,2974339
1678483667,203772,true,1414936465,28,1417343782,2407317
1678483811,203773,true,1414794985,28,1416776986,1982001
1678484291,203776,true,1414370631,28,1415219466,848835
1678484651,203778,true,1414087800,28,1413946405,-141395
1678484855,203777,true,1414229208,28,1413380968,-848240
1678485059,203777,true,1414229208,28,1413098334,-1130874
1678485155,203780,true,1413805025,28,1412957038,-847987
1678485167,203781,true,1413663658,28,1412957038,-706620
1678485179,203781,true,1413663658,28,1412957038,-706620
1678485191,203780,true,1413805025,28,1412957038,-847987
1678485239,203782,true,1413522306,28,1412957038,-565268
1678485263,203783,true,1413380968,28,1412957038,-423930
1678485347,203782,true,1413522306,28,1412957038,-565268
1678485383,203782,true,1413522306,28,1413098334,-423972
1678485395,203782,true,1413522306,28,1413098334,-423972
1678485407,203783,true,1413380968,28,1413098334,-282634
1678485419,203782,true,1413522306,28,1413239644,-282662
1678485431,203780,true,1413805025,28,1413239644,-565381
1678485455,203779,true,1413946405,28,1413380968,-565437
1678485539,203779,true,1413946405,28,1413946405,0
1678485815,203777,true,1414229208,28,1416068810,1839602
1678485827,203776,true,1414370631,28,1416210417,1839786
1678485887,203775,true,1414512068,28,1416635322,2123254
1678486175,203774,true,1414653520,28,1419471286,4817766
1678486211,203771,true,1415077958,28,1419755195,4677237
1678486403,203770,true,1415219466,28,1421601984,6382518
1678486439,203769,true,1415360988,28,1421886319,6525331
1678486727,203767,true,1415644074,28,1425017756,9373682
1678486775,203766,true,1415785639,28,1425445304,9659665
1678486787,203764,true,1416068810,28,1425587848,9519038
1678486907,203763,true,1416210417,28,1426728718,10518301
1678486931,203762,true,1416352038,28,1427014078,10662040
1678487051,203761,true,1416493673,28,1427870500,11376827
1678487375,203760,true,1416635322,28,1429299013,12663691
1678487555,203759,true,1416776986,28,1429441943,12664957
1678487699,203758,true,1416918664,28,1429727846,12809182
1678487759,203756,true,1417202062,28,1429727846,12525784
1678487783,203755,true,1417343782,28,1429727846,12384064
1678488203,203753,true,1417627265,28,1429727846,12100581
1678488227,203752,true,1417769027,28,1429727846,11958819
1678488371,203750,true,1418052595,28,1429441943,11389348
1678488383,203749,true,1418194401,28,1429441943,11247542
1678488563,203748,true,1418336220,28,1429013197,10676977
1678488863,203747,true,1418478054,28,1428584578,10106524
1678488899,203746,true,1418619902,28,1428584578,9964676
1678488911,203744,true,1418903640,28,1428584578,9680938
1678488923,203744,true,1418903640,28,1428584578,9680938
1678489595,203743,true,1419045530,28,1428727437,9681907
1678489607,203742,true,1419187435,28,1428727437,9540002
1678489691,203741,true,1419329353,28,1428870310,9540957
1678489739,203740,true,1419471286,28,1428870310,9399024
1678489799,203739,true,1419613233,28,1428870310,9257077
1678489823,203738,true,1419755195,28,1429013197,9258002
1678489919,203736,true,1420039160,28,1429156098,9116938
1678489943,203735,true,1420181164,28,1429156098,8974934
1678489979,203733,true,1420465214,28,1429299013,8833799
1678490003,203732,true,1420607261,28,1429441943,8834682
1678490087,203730,true,1420891397,28,1429870819,8979422
1678490099,203728,true,1421175589,28,1429870819,8695230
1678490435,203726,true,1421459838,28,1431873940,10414102
1678490675,203724,true,1421744145,28,1433736493,11992348
1678490771,203722,true,1422028508,28,1434310074,12281566
1678491011,203720,true,1422312927,28,1435888604,13575677
1678491791,203718,true,1422597404,28,1439626585,17029181
1678491803,203715,true,1423024226,28,1439626585,16602359
1678492331,203713,true,1423308845,28,1439770547,16461702
1678492523,203711,true,1423593521,28,1439626585,16033064
1678492607,203709,true,1423878254,28,1439482636,15604382
1678492907,203707,true,1424163044,28,1439338703,15175659
1678492919,203705,true,1424447891,28,1439482636,15034745
1678492931,203704,true,1424590336,28,1439482636,14892300
1678493015,203702,true,1424875268,28,1439770547,14895279
1678493195,203700,true,1425160257,28,1440634626,15474369
1678493447,203698,true,1425445304,28,1441643372,16198068
1678493459,203697,true,1425587848,28,1441643372,16055524
1678493483,203694,true,1426015567,28,1441643372,15627805
1678493495,203692,true,1426300785,28,1441643372,15342587
1678493543,203692,true,1426300785,28,1441643372,15342587
1678493687,203690,true,1426586059,28,1442220116,15634057
1678493915,203687,true,1427014078,28,1442941371,15927293
1678494215,203685,true,1427299495,28,1443951733,16652238
1678494299,203685,true,1427299495,28,1444240537,16941042
1678494335,203683,true,1427584969,28,1444384961,16799992
1678494371,203681,true,1427870500,28,1444529400,16658900
1678494419,203678,true,1428298904,28,1444673853,16374949
1678494443,203678,true,1428298904,28,1444818320,16519416
1678494515,203676,true,1428584578,28,1445107298,16522720
1678494539,203674,true,1428870310,28,1445251809,16381499
1678494551,203671,true,1429299013,28,1445251809,15952796
1678494575,203671,true,1429299013,28,1445396334,16097321
1678494587,203670,true,1429441943,28,1445540874,16098931
1678494719,203667,true,1429870819,28,1446119177,16248358
1678494755,203665,true,1430156807,28,1446263789,16106982
1678495223,203665,true,1430156807,28,1446987065,16830258
1678495295,203663,true,1430442853,28,1447276477,16833624
1678495307,203661,true,1430728956,28,1447276477,16547521
1678495379,203658,true,1431158217,28,1447421205,16262988
1678495427,203658,true,1431158217,28,1447565947,16407730
1678495439,203657,true,1431301333,28,1447565947,16264614
1678495535,203654,true,1431730767,28,1447421205,15690438
1678495595,203652,true,1432017127,28,1447276477,15259350
1678495607,203652,true,1432017127,28,1447276477,15259350
1678495619,203651,true,1432160329,28,1447276477,15116148
1678495739,203648,true,1432590020,28,1447276477,14686457
1678495763,203645,true,1433019840,28,1447276477,14256637
1678495787,203645,true,1433019840,28,1447421205,14401365
1678495823,203644,true,1433163142,28,1447421205,14258063
1678495883,203640,true,1433736493,28,1447710704,13974211
1678495979,203637,true,1434166657,28,1447855475,13688818
1678496015,203637,true,1434166657,28,1448000260,13833603
1678496279,203635,true,1434453505,28,1448289875,13836370
1678496315,203631,true,1435027372,28,1448289875,13262503
1678496351,203628,true,1435457923,28,1448289875,12831952
1678496399,203628,true,1435457923,28,1448434704,12976781
1678496555,203626,true,1435745029,28,1448289875,12544846
1678496567,203622,true,1436319414,28,1448289875,11970461
1678496579,203619,true,1436750352,28,1448289875,11539523
1678496591,203619,true,1436750352,28,1448289875,11539523
1678496627,203617,true,1437037717,28,1448289875,11252158
1678496687,203612,true,1437756379,28,1448434704,10678325
1678496723,203609,true,1438187750,28,1448434704,10246954
1678496735,203609,true,1438187750,28,1448579547,10391797
1678496747,203607,true,1438475401,28,1448579547,10104146
1678496939,203602,true,1439194783,28,1449448912,10254129
1678496963,203599,true,1439626585,28,1449593857,9967272
1678496975,203598,true,1439770547,28,1449593857,9823310
1678496987,203596,true,1440058516,28,1449593857,9535341
1678496999,203592,true,1440634626,28,1449593857,8959231
1678497011,203589,true,1441066859,28,1449738817,8671958
1678497035,203589,true,1441066859,28,1449883791,8816932
1678497059,203587,true,1441355087,28,1449883791,8528704
1678497083,203583,true,1441931716,28,1450028779,8097063
1678497107,203581,true,1442220116,28,1450173782,7953666
1678497143,203581,true,1442220116,28,1450318799,8098683
1678497287,203579,true,1442508575,28,1451624608,9116033
1678497371,203575,true,1443085665,28,1452350566,9264901
1678497383,203574,true,1443229973,28,1452495801,9265828
1678497395,203573,true,1443374296,28,1452641050,9266754
1678497407,203572,true,1443518634,28,1452786315,9267681
1678497419,203568,true,1444096128,28,1452931593,8835465
1678497431,203566,true,1444384961,28,1453076886,8691925
1678497611,203564,true,1444673853,28,1455403554,10729701
1678497911,203562,true,1444962802,28,1459192337,14229535
1678497947,203557,true,1445685428,28,1459776101,14090673
1678498007,203555,true,1445974580,28,1460652186,14677606
1678498115,203553,true,1446263789,28,1462113496,15849707
1678498139,203550,true,1446697711,28,1462552174,15854463
1678498211,203546,true,1447276477,28,1463576267,16299790
1678498379,203543,true,1447710704,28,1466212945,18502241
1678498391,203541,true,1448000260,28,1466359566,18359306
1678498403,203539,true,1448289875,28,1466652853,18362978
1678498427,203534,true,1449014165,28,1466946198,17932033
1678498439,203531,true,1449448912,28,1467239602,17790690
1678498451,203529,true,1449738817,28,1467386326,17647509
1678498463,203525,true,1450318799,28,1467679818,17361019
1678498475,203520,true,1451044104,28,1467973369,16929265
1678498487,203516,true,1451624608,28,1468120166,16495558
1678498499,203513,true,1452060139,28,1468413805,16353666
1678498535,203510,true,1452495801,28,1469148159,16652358
1678498559,203505,true,1453222194,28,1469588947,16366753
1678498571,203501,true,1453803570,28,1469735906,15932336
1678498607,203499,true,1454094345,28,1470323888,16229543
1678498751,203495,true,1454676070,28,1472678172,18002102
1678498847,203491,true,1455258028,28,1474298928,19040900
1678498895,203487,true,1455840219,28,1475183729,19343510
1678498991,203485,true,1456131401,28,1476807242,20675841
1678499003,203482,true,1456568284,28,1477102619,20534335
1678499039,203477,true,1457296714,28,1477693548,20396834
1678499075,203473,true,1457879720,28,1478284714,20404994
1678499147,203471,true,1458171311,28,1479763664,21592353
1678499171,203467,true,1458754667,28,1480355659,21600992
1678499183,203463,true,1459338256,28,1480503694,21165438
1678499267,203459,true,1459922079,28,1482133063,22210984
1678499279,203457,true,1460214078,28,1482281276,22067198
1678499363,203453,true,1460798251,28,1483467516,22669265
1678499375,203449,true,1461382658,28,1483615863,22233205
1678499423,203445,true,1461967299,28,1484357819,22390520
1678499459,203443,true,1462259707,28,1484803171,22543464
1678499471,203439,true,1462844699,28,1485100147,22255448
1678499483,203435,true,1463429924,28,1485248657,21818733
1678499603,203431,true,1464015384,28,1487031936,23016552
1678499627,203428,true,1464454633,28,1487329357,22874724
1678499639,203425,true,1464894013,28,1487478090,22584077
1678499651,203421,true,1465480059,28,1487775600,22295541
1678499711,203417,true,1466066338,28,1488817356,22751018
1678499819,203414,true,1466506202,28,1490604920,24098718
1678499831,203411,true,1466946198,28,1490903055,23956857
1678499843,203406,true,1467679818,28,1491052146,23372328
1678499855,203403,true,1468120166,28,1491350371,23230205
1678499867,203398,true,1468854373,28,1491499506,22645133
1678499927,203394,true,1469442003,28,1492842393,23400390
1678499939,203390,true,1470029868,28,1493140976,23111108
1678499987,203386,true,1470617968,28,1494037085,23419117
1678499999,203381,true,1471353424,28,1494335907,22982483
1678500023,203378,true,1471794874,28,1494784253,22989379
1678500047,203373,true,1472530919,28,1495382256,22851337
1678500107,203370,true,1472972722,28,1496578981,23606259
1678500131,203365,true,1473709356,28,1497027999,23318643
1678500359,203362,true,1474151513,28,1500625001,26473488
1678500383,203357,true,1474888736,28,1501075234,26186498
1678500467,203354,true,1475331247,28,1502276514,26945267
1678500479,203349,true,1476069060,28,1502426742,26357682
1678500491,203345,true,1476659576,28,1502727242,26067666
1678500611,203341,true,1477250329,28,1504681960,27431631
1678500683,203337,true,1477841318,28,1505886127,28044809
1678500695,203333,true,1478432543,28,1506036716,27604173
1678500743,203329,true,1479024005,28,1506639221,27615216
1678500755,203325,true,1479615703,28,1506789885,27174182
1678500791,203321,true,1480207638,28,1507392691,27185053
1678500851,203317,true,1480799810,28,1507995739,27195929
1678500875,203313,true,1481392219,28,1508297353,26905134
1678500911,203309,true,1481984864,28,1508599028,26614164
1678501031,203305,true,1482577747,28,1509504413,26926666
1678501103,203300,true,1483319184,28,1510259317,26940133
1678501115,203296,true,1483912601,28,1510259317,26346716
1678501187,203292,true,1484506255,28,1510863511,26357256
1678501271,203289,true,1484951652,28,1511467947,26516295
1678501283,203284,true,1485694276,28,1511467947,25773671
1678501295,203281,true,1486140029,28,1511619094,25479065
1678501403,203278,true,1486585915,28,1511921433,25335518
1678501427,203275,true,1487031936,28,1512072625,25040689
1678501463,203271,true,1487626838,28,1512072625,24445787
1678501475,203268,true,1488073170,28,1512072625,23999455
1678501583,203265,true,1488519637,28,1511921433,23401796
1678501607,203262,true,1488966238,28,1511770256,22804018
1678501619,203258,true,1489561913,28,1511770256,22208343
1678501643,203255,true,1490008827,28,1511619094,21610267
1678501667,203253,true,1490306843,28,1511619094,21312251
1678501703,203250,true,1490753980,28,1511165699,20411719
1678501715,203246,true,1491350371,28,1511165699,19815328
1678501727,203243,true,1491797821,28,1511014597,19216776
1678501739,203242,true,1491947001,28,1510863511,18916510
1678502075,203240,true,1492245405,28,1507392691,15147286
1678502279,203236,true,1492842393,28,1504982912,12140519
1678502387,203233,true,1493290290,28,1503629104,10338814
1678502783,203233,true,1493290290,28,1498975304,5685014
1678502807,203231,true,1493588963,28,1498825421,5236458
1678502879,203227,true,1494186488,28,1498076233,3889745
1678502903,203224,true,1494634789,28,1497926441,3291652
1678503023,203223,true,1494784253,28,1496878311,2094058
1678503059,203222,true,1494933731,28,1496578981,1645250
1678503095,203218,true,1495531794,28,1496429338,897544
1678503167,203215,true,1495980499,28,1495980499,0
1678503191,203214,true,1496130097,28,1495830916,-299181
1678503203,203212,true,1496429338,28,1495830916,-598422
1678503215,203208,true,1497027999,28,1495830916,-1197083
1678503239,203206,true,1497327420,28,1495830916,-1496504
1678503287,203204,true,1497626900,28,1495681348,-1945552
1678503359,203203,true,1497776663,28,1495681348,-2095315
1678503371,203199,true,1498375864,28,1495681348,-2694516
1678503563,203196,true,1498825421,28,1495830916,-2994505
1678503779,203195,true,1498975304,28,1496578981,-2396323
1678503947,203194,true,1499125201,28,1497177702,-1947499
1678503971,203191,true,1499574984,28,1497177702,-2397282
1678504103,203189,true,1499874914,28,1497776663,-2098251
1678504235,203188,true,1500024901,28,1498675554,-1349347
1678504619,203186,true,1500324921,28,1501075234,750313
1678504907,203183,true,1500775064,28,1502727242,1952178
1678504943,203182,true,1500925141,28,1502877515,1952374
1678504979,203180,true,1501225341,28,1503027803,1802462
1678505003,203179,true,1501375464,28,1503178106,1802642
1678505015,203177,true,1501675754,28,1503178106,1502352
1678505027,203175,true,1501976104,28,1503178106,1202002
1678505039,203173,true,1502276514,28,1503328424,1051910
1678505051,203172,true,1502426742,28,1503328424,901682
1678505111,203170,true,1502727242,28,1503629104,901862
1678505231,203169,true,1502877515,28,1504230646,1353131
1678505243,203168,true,1503027803,28,1504230646,1202843
1678505255,203167,true,1503178106,28,1504381069,1202963
1678505267,203165,true,1503478756,28,1504381069,902313
1678505279,203164,true,1503629104,28,1504531507,902403
1678505315,203162,true,1503929845,28,1504832429,902584
1678505339,203161,true,1504080238,28,1504982912,902674
1678505351,203159,true,1504381069,28,1505133410,752341
1678505399,203156,true,1504832429,28,1505735554,903125
1678505411,203154,true,1505133410,28,1505886127,752717
1678505435,203153,true,1505283924,28,1506187320,903396
1678505531,203150,true,1505735554,28,1507543431,1807877
1678505543,203147,true,1506187320,28,1507844954,1657634
1678505555,203145,true,1506488572,28,1508146538,1657966
1678505567,203143,true,1506789885,28,1508448183,1658298
1678505591,203139,true,1507392691,28,1508900763,1508072
1678505603,203137,true,1507694185,28,1509202558,1508373
1678505615,203135,true,1507995739,28,1509353478,1357739
1678505627,203134,true,1508146538,28,1509655364,1508826
1678505639,203130,true,1508749888,28,1509957310,1207422
1678505663,203127,true,1509202558,28,1510410343,1207785
1678505675,203126,true,1509353478,28,1510561384,1207906
1678505699,203124,true,1509655364,28,1511165699,1510335
1678505735,203120,true,1510259317,28,1511770256,1510939
1678505747,203118,true,1510561384,28,1512072625,1511241
1678505771,203116,true,1510863511,28,1512526292,1662781
1678505783,203115,true,1511014597,28,1512828812,1814215
1678505795,203111,true,1511619094,28,1512980095,1361001
1678505843,203109,true,1511921433,28,1514039499,2118066
1678505939,203107,true,1512223832,28,1516008932,3785100
1678506023,203106,true,1512375055,28,1517829143,5454088
1678506083,203102,true,1512980095,28,1519043832,6063737
1678506155,203100,true,1513282706,28,1520867687,7584981
1678506167,203098,true,1513585378,28,1521019774,7434396
1678506191,203097,true,1513736737,28,1521628273,7891536
1678506227,203092,true,1514493756,28,1522846002,8352246
1678506251,203089,true,1514948150,28,1523607577,8659427
1678506263,203087,true,1515251155,28,1524064705,8813550
1678506323,203085,true,1515554220,28,1525742015,10187795
1678506335,203081,true,1516160533,28,1526047179,9886646
1678506347,203079,true,1516463780,28,1526505039,10041259
1678506443,203076,true,1516918765,28,1529255084,12336319
1678506455,203075,true,1517070457,28,1529713907,12643450
1678506467,203071,true,1517677376,28,1530019865,12342489
1678506479,203068,true,1518132724,28,1530325884,12193160
1678506563,203065,true,1518588210,28,1533082813,14494603
1678506659,203064,true,1518740069,28,1536151894,17411825
1678506719,203059,true,1519499591,28,1537996290,18496699
1678506791,203057,true,1519803506,28,1540304900,20501394
1678506851,203055,true,1520107482,28,1542000083,21892601
1678506959,203054,true,1520259492,28,1545087015,24827523
1678506983,203049,true,1521019774,28,1545859713,24839939
1678507127,203047,true,1521323993,28,1549883976,28559983
1678507163,203044,true,1521780436,28,1550659073,28878637
1678507211,203043,true,1521932614,28,1551900035,29967421
1678507235,203038,true,1522693733,28,1552365651,29671918
1678507283,203035,true,1523150587,28,1553452633,30302046
1678507355,203032,true,1523607577,28,1554695830,31088253
1678507463,203031,true,1523759938,28,1556251226,32491288
1678507475,203026,true,1524521970,28,1556406851,31884881
1678507499,203023,true,1524979373,28,1556718148,31738775
1678507775,203020,true,1525436912,28,1560770679,35333767
1678508111,203018,true,1525742015,28,1563738813,37996798
1678508531,203012,true,1526657689,28,1565929471,39271782
1678508543,203009,true,1527115732,28,1566086064,38970332
1678508567,203005,true,1527726670,28,1566086064,38359394
1678508627,203003,true,1528032231,28,1566399297,38367066
1678508687,202998,true,1528796400,28,1566555937,37759537
1678508735,202995,true,1529255084,28,1566555937,37300853
1678508747,202991,true,1529866878,28,1566555937,36689059
1678508771,202988,true,1530325884,28,1566712593,36386709
1678508831,202984,true,1530938106,28,1566712593,35774487
1678508843,202981,true,1531397434,28,1566712593,35315159
1678508879,202976,true,1532163286,28,1566712593,34549307
1678508891,202974,true,1532469734,28,1566555937,34086203
1678508915,202970,true,1533082813,28,1566555937,33473124
1678508927,202967,true,1533542784,28,1566555937,33013153
1678508939,202962,true,1534309709,28,1566555937,32246228
1678508963,202959,true,1534770048,28,1566399297,31629249
1678508975,202955,true,1535384048,28,1566399297,31015249
1678508999,202951,true,1535998294,28,1566242673,30244379
1678509047,202947,true,1536612785,28,1566086064,29473279
1678509059,202944,true,1537073815,28,1566086064,29012249
1678509071,202939,true,1537842506,28,1566086064,28243558
1678509083,202937,true,1538150090,28,1565929471,27779381
1678509155,202933,true,1538765442,28,1565616332,26850890
1678509227,202930,true,1539227118,28,1565146741,25919623
1678509251,202926,true,1539842901,28,1564990242,25147341
1678509263,202923,true,1540304900,28,1564990242,24685342
1678509287,202920,true,1540767038,28,1564677291,23910253
1678509299,202918,true,1541075207,28,1564520839,23445632
1678509311,202914,true,1541691729,28,1564520839,22829110
1678509335,202912,true,1542000083,28,1564207982,22207899
1678509395,202910,true,1542308498,28,1563582455,21273957
1678509431,202907,true,1542771237,28,1563113474,20342237
1678509455,202904,true,1543234115,28,1562957178,19723063
1678509503,202901,true,1543697131,28,1562488385,18791254
1678509551,202898,true,1544160287,28,1562019732,17859445
1678509659,202897,true,1544314703,28,1560458571,16143868
1678509671,202893,true,1544932522,28,1560302541,15370019
1678509695,202891,true,1545241523,28,1560146526,14905003
1678509707,202888,true,1545705142,28,1559990527,14285385
1678509743,202886,true,1546014299,28,1559678576,13664277
1678509791,202883,true,1546478149,28,1559054861,12576712
1678509839,202881,true,1546787461,28,1558587238,11799777
1678509863,202878,true,1547251543,28,1558275567,11024024
1678509899,202877,true,1547406268,28,1557808178,10401910
1678509911,202873,true,1548025324,28,1557652412,9627088
1678509947,202872,true,1548180126,28,1557185210,9005084
1678509959,202870,true,1548489778,28,1557029507,8539729
1678510151,202868,true,1548799491,28,1554540376,5740885
1678510163,202865,true,1549264177,28,1554384938,5120761
1678510175,202863,true,1549574046,28,1554229515,4655469
1678510211,202861,true,1549883976,28,1553763339,3879363
1678510259,202859,true,1550193968,28,1552986691,2792723
1678510283,202856,true,1550659073,28,1552676140,2017067
1678510379,202854,true,1550969220,28,1551589701,620481
1678510487,202853,true,1551124317,28,1550348988,-775329
1678510691,202852,true,1551279430,28,1548644627,-2634803
1678510799,202849,true,1551744860,28,1548180126,-3564734
1678510907,202847,true,1552055225,28,1548025324,-4029901
1678510919,202847,true,1552055225,28,1548025324,-4029901
1678511003,202844,true,1552520888,28,1548180126,-4340762
1678511051,202841,true,1552986691,28,1548489778,-4496913
1678511063,202840,true,1553141989,28,1548644627,-4497362
1678511255,202839,true,1553297303,28,1550348988,-2948315
1678511267,202837,true,1553607978,28,1550504023,-3103955
1678511315,202837,true,1553607978,28,1550814139,-2793839
1678511375,202835,true,1553918716,28,1551434558,-2484158
1678511387,202834,true,1554074107,28,1551434558,-2639549
1678511459,202831,true,1554540376,28,1552210430,-2329946
1678511471,202831,true,1554540376,28,1552365651,-2174725
1678511495,202829,true,1554851300,28,1552676140,-2175160
1678511699,202827,true,1555162286,28,1555006785,-155501
1678512011,202824,true,1555628881,28,1558898971,3270090
1678512143,202823,true,1555784444,28,1560614617,4830173
1678512263,202821,true,1556095616,28,1562019732,5924116
1678512503,202819,true,1556406851,28,1565303256,8896405
1678512947,202817,true,1556718148,28,1568280010,11561862
1678513175,202816,true,1556873820,28,1569064307,12190487
1678513319,202814,true,1557185210,28,1569535074,12349864
1678513343,202813,true,1557340929,28,1569535074,12194145
1678513367,202810,true,1557808178,28,1569535074,11726896
1678513391,202810,true,1557808178,28,1569692027,11883849
1678513571,202808,true,1558119755,28,1569692027,11572272
1678513727,202807,true,1558275567,28,1569692027,11416460
1678513763,202805,true,1558587238,28,1569848996,11261758
1678513823,202806,true,1558431394,28,1569848996,11417602
1678513835,202806,true,1558431394,28,1569848996,11417602
1678513895,202805,true,1558587238,28,1569848996,11261758
1678513967,202803,true,1558898971,28,1569848996,10950025
1678514135,202804,true,1558743096,28,1569692027,10948931
1678514195,202803,true,1558898971,28,1569535074,10636103
1678514363,202802,true,1559054861,28,1569378136,10323275
1678514555,202801,true,1559210766,28,1569378136,10167370
1678514843,202801,true,1559210766,28,1570162982,10952216
1678514903,202800,true,1559366687,28,1570319998,10953311
1678514915,202800,true,1559366687,28,1570319998,10953311
1678514927,202798,true,1559678576,28,1570477030,10798454
1678515023,202798,true,1559678576,28,1570634078,10955502
1678515035,202797,true,1559834544,28,1570791141,10956597
1678515047,202797,true,1559834544,28,1570791141,10956597
1678515059,202795,true,1560146526,28,1570948220,10801694
1678515131,202794,true,1560302541,28,1571419552,11117011
1678515323,202793,true,1560458571,28,1572677128,12218557
1678515491,202792,true,1560614617,28,1573778332,13163715
1678515635,202790,true,1560926756,28,1574722835,13796079
1678515647,202790,true,1560926756,28,1574722835,13796079
1678515659,202789,true,1561082848,28,1574880307,13797459
1678515671,202788,true,1561238957,28,1575037795,13798838
1678515683,202785,true,1561707375,28,1575195299,13487924
1678515731,202784,true,1561863546,28,1575667905,13804359
1678515743,202783,true,1562019732,28,1575667905,13648173
1678515791,202783,true,1562019732,28,1576140653,14120921
1678515803,202781,true,1562332152,28,1576298267,13966115
1678515815,202780,true,1562488385,28,1576455897,13967512
1678515863,202779,true,1562644634,28,1576928881,14284247
1678515875,202779,true,1562644634,28,1577086574,14441940
1678516103,202776,true,1563113474,28,1579611805,16498331
1678516139,202775,true,1563269786,28,1580085736,16815950
1678516163,202774,true,1563426112,28,1580559809,17133697
1678516223,202774,true,1563426112,28,1581666533,18240421
1678516283,202769,true,1564207982,28,1582615771,18407789
1678516295,202767,true,1564520839,28,1582932309,18411470
1678516439,202765,true,1564833759,28,1585149856,20316097
1678516451,202765,true,1564833759,28,1585308371,20474612
1678516487,202760,true,1565616332,28,1585942589,20326257
1678516499,202757,true,1566086064,28,1586101183,20015119
1678516511,202756,true,1566242673,28,1586259794,20017121
1678516559,202755,true,1566399297,28,1586894393,20495096
1678516595,202751,true,1567025951,28,1587370509,20344558
1678516619,202748,true,1567496106,28,1587687999,20191893
1678516655,202747,true,1567652855,28,1588164353,20511498
1678516667,202747,true,1567652855,28,1588323169,20670314
1678516703,202742,true,1568436838,28,1588799714,20362876
1678516715,202740,true,1568750541,28,1588958594,20208053
1678516727,202738,true,1569064307,28,1589117490,20053183
1678516775,202737,true,1569221214,28,1589753232,20532018
1678516787,202731,true,1570162982,28,1589912207,19749225
1678516811,202729,true,1570477030,28,1590389229,19912199
1678516871,202727,true,1570791141,28,1591025480,20234339
1678516883,202725,true,1571105315,28,1591184582,20079267
1678516919,202719,true,1572048214,28,1591821152,19772938
1678516931,202715,true,1572677128,28,1591980334,19303206
1678516943,202713,true,1572991679,28,1592139532,19147853
1678516967,202711,true,1573306293,28,1592457976,19151683
1678516979,202705,true,1574250513,28,1592617221,18366708
1678517015,202702,true,1574722835,28,1592935761,18212926
1678517027,202700,true,1575037795,28,1593095054,18057259
1678517039,202698,true,1575352819,28,1593254364,17901545
1678517051,202691,true,1576455897,28,1593573031,17117134
1678517063,202687,true,1577086574,28,1593732388,16645814
1678517075,202683,true,1577717503,28,1594051150,16333647
1678517087,202681,true,1578033062,28,1594210555,16177493
1678517147,202676,true,1578822236,28,1595326838,16504602
1678517183,202672,true,1579453860,28,1596124661,16670801
1678517219,202668,true,1580085736,28,1596763206,16677470
1678517231,202666,true,1580401769,28,1597082575,16680806
1678517243,202660,true,1581350247,28,1597402007,16051760
1678517255,202654,true,1582299295,28,1597721504,15422209
1678517279,202650,true,1582932309,28,1598360688,15428379
1678517303,202646,true,1583565577,28,1599000128,15434551
1678517315,202641,true,1584357519,28,1599319944,14962425
1678517471,202635,true,1585308371,28,1603643727,18335356
1678517507,202630,true,1586101183,28,1604606153,18504970
1678517555,202627,true,1586577061,28,1605890288,19313227
1678517567,202621,true,1587529246,28,1606211482,18682236
1678517579,202616,true,1588323169,28,1606532740,18209571
1678517591,202611,true,1589117490,28,1606854063,17736573
1678517603,202607,true,1589753232,28,1607175450,17422218
1678517627,202600,true,1590866393,28,1607979198,17112805
1678517639,202594,true,1591821152,28,1608300810,16479658
1678517651,202589,true,1592617221,28,1608783348,16166127
1678517663,202586,true,1593095054,28,1609105121,16010067
1678517675,202580,true,1594051150,28,1609426958,15375808
1678517687,202575,true,1594848335,28,1609748860,14900525
1678517735,202571,true,1595486370,28,1611198213,15711843
1678517747,202568,true,1595965064,28,1611520469,15555405
1678517807,202562,true,1596922883,28,1613616703,16693820
1678517831,202556,true,1597881276,28,1614585115,16703839
1678517843,202551,true,1598680376,28,1615069539,16389163
1678517855,202548,true,1599160028,28,1615392569,16232541
1678517867,202541,true,1600279776,28,1615877236,15597460
1678517879,202535,true,1601240184,28,1616362047,15121863
1678517891,202530,true,1602040964,28,1616847004,14806040
1678517903,202528,true,1602361389,28,1617332107,14970718
1678517927,202522,true,1603323046,28,1618140935,14817889
1678517939,202516,true,1604285280,28,1618626426,14341146
1678517951,202512,true,1604927091,28,1618950167,14023076
1678517999,202510,true,1605248092,28,1620083772,14835680
1678518023,202504,true,1606211482,28,1620731903,14520421
1678518071,202499,true,1607014748,28,1622028942,15014194
1678518083,202494,true,1607818416,28,1622353364,14534948
1678518095,202493,true,1607979198,28,1622677851,14698653
1678518131,202486,true,1609105121,28,1623651701,14546580
1678518143,202480,true,1610070826,28,1623976448,13905622
1678518155,202475,true,1610876022,28,1624463690,13587668
1678518167,202473,true,1611198213,28,1624951078,13752865
1678518179,202466,true,1612326391,28,1625276084,12949693
1678518191,202460,true,1613294028,28,1625601155,12307127
1678518203,202456,true,1613939443,28,1626088885,12149442
1678518215,202454,true,1614262247,28,1626414119,12151872
1678518239,202447,true,1615392569,28,1627227488,11834919
1678518251,202440,true,1616523683,28,1627552950,11029267
1678518287,202435,true,1617332107,28,1628692579,11360472
1678518311,202433,true,1617655590,28,1629670039,12014449
1678518335,202426,true,1618788288,28,1630485037,11696749
1678518347,202420,true,1619759804,28,1630974231,11214427
1678518359,202415,true,1620569846,28,1631463573,10893727
1678518383,202413,true,1620893976,28,1632279467,11385491
1678518407,202406,true,1622028942,28,1633095770,11066828
1678518431,202400,true,1623002403,28,1634075873,11073470
1678518443,202395,true,1623814067,28,1634566145,10752078
1678518455,202393,true,1624138846,28,1635056564,10917718
1678518467,202386,true,1625276084,28,1635383591,10107507
1678518491,202381,true,1626088885,28,1636365067,10276182
1678518503,202376,true,1626902092,28,1636856025,9953933
1678518551,202374,true,1627227488,28,1638657468,11429980
1678518563,202367,true,1628366889,28,1639149114,10782225
1678518575,202362,true,1629181236,28,1639640908,10459672
1678518611,202357,true,1629995989,28,1640953080,10957091
1678518623,202355,true,1630322005,28,1641445415,11123410
1678518635,202349,true,1631300442,28,1641773720,10473278
1678518647,202345,true,1631953061,28,1642266302,10313241
1678518659,202341,true,1632605940,28,1642594771,9988831
1678518683,202338,true,1633095770,28,1643416233,10320463
1678518707,202332,true,1634075873,28,1644073698,9997825
1678518731,202328,true,1634729601,28,1644895899,10166298
1678518755,202324,true,1635383591,28,1645553957,10170366
1678518767,202322,true,1635710684,28,1645883084,10172400
1678518779,202317,true,1636528703,28,1646376898,9848195
1678518803,202312,true,1637347131,28,1647035548,9688417
1678518827,202309,true,1637838385,28,1647859230,10020845
1678518851,202307,true,1638165969,28,1648518473,10352504
1678518863,202303,true,1638821333,28,1648683325,9861992
1678518875,202300,true,1639313029,28,1649013078,9700049
1678518899,202295,true,1640132849,28,1649672782,9539933
1678518911,202293,true,1640460892,28,1650002733,9541841
1678518935,202289,true,1641117175,28,1650662833,9545658
1678518959,202286,true,1641609559,28,1651323197,9713638
1678518971,202282,true,1642266302,28,1651653478,9387176
1678518983,202279,true,1642759031,28,1651983826,9224795
1678518995,202275,true,1643416233,28,1652149024,8732791
1678519007,202272,true,1643909307,28,1652479470,8570163
1678519031,202268,true,1644566970,28,1652975264,8408294
1678519055,202265,true,1645060389,28,1653471206,8410817
1678519103,202262,true,1645553957,28,1654298107,8744150
1678519127,202258,true,1646212277,28,1654628983,8416706
1678519151,202254,true,1646870861,28,1654959925,8089064
1678519187,202252,true,1647200251,28,1655456463,8256212
1678519247,202249,true,1647694461,28,1656449985,8755524
1678519367,202245,true,1648353637,28,1658272992,9919355
1678519379,202241,true,1649013078,28,1658438819,9425741
1678519427,202239,true,1649342897,28,1659102294,9759397
1678519439,202236,true,1649837749,28,1659268204,9430455
1678519451,202232,true,1650497783,28,1659268204,8770421
1678519463,202229,true,1650992982,28,1659434131,8441149
1678519475,202227,true,1651323197,28,1659600074,8276877
1678519487,202223,true,1651983826,28,1659766034,7782208
1678519499,202219,true,1652644718,28,1659932011,7287293
1678519523,202216,true,1653140561,28,1660264014,7123453
1678519535,202214,true,1653471206,28,1660430040,6958834
1678519547,202211,true,1653967297,28,1660596083,6628786
1678519559,202208,true,1654463537,28,1660762143,6298606
1678519571,202205,true,1654959925,28,1660762143,5802218
1678519583,202204,true,1655125421,28,1660928219,5802798
1678519595,202200,true,1655787571,28,1660928219,5140648
1678519607,202197,true,1656284357,28,1661094312,4809955
1678519619,202195,true,1656615630,28,1661094312,4478682
1678519763,202194,true,1656781292,28,1661592690,4811398
1678519787,202191,true,1657278376,28,1661758849,4480473
1678519811,202189,true,1657609848,28,1661925025,4315177
1678519835,202187,true,1657941387,28,1662091218,4149831
1678519943,202187,true,1657941387,28,1662589895,4648508
1678520027,202185,true,1658272992,28,1662423653,4150661
1678520039,202183,true,1658604663,28,1662257427,3652764
1678520087,202182,true,1658770523,28,1662257427,3486904
1678520099,202182,true,1658770523,28,1662091218,3320695
1678520135,202180,true,1659102294,28,1661925025,2822731
1678520159,202179,true,1659268204,28,1661758849,2490645
1678520171,202178,true,1659434131,28,1661592690,2158559
1678520195,202178,true,1659434131,28,1661426547,1992416
1678520291,202177,true,1659600074,28,1660762143,1162069
1678520303,202177,true,1659600074,28,1660762143,1162069
1678520327,202176,true,1659766034,28,1660430040,664006
1678520351,202177,true,1659600074,28,1660264014,663940
1678520375,202176,true,1659766034,28,1659932011,165977
1678520483,202176,true,1659766034,28,1658770523,-995511
1678520519,202175,true,1659932011,28,1658438819,-1493192
1678520531,202176,true,1659766034,28,1658272992,-1493042
1678520567,202176,true,1659766034,28,1657941387,-1824647
1678520579,202177,true,1659600074,28,1657775609,-1824465
1678520591,202177,true,1659600074,28,1657609848,-1990226
1678520615,202179,true,1659268204,28,1657444104,-1824100
1678520663,202181,true,1658936400,28,1656615630,-2320770
1678520687,202182,true,1658770523,28,1656284357,-2486166
1678520747,202182,true,1658770523,28,1655456463,-3314060
1678520759,202183,true,1658604663,28,1655290934,-3313729
1678520795,202184,true,1658438819,28,1654794446,-3644373
1678520819,202185,true,1658272992,28,1654463537,-3809455
1678520843,202185,true,1658272992,28,1654132694,-4140298
1678520855,202186,true,1658107181,28,1653967297,-4139884
1678520867,202187,true,1657941387,28,1653801917,-4139470
1678520879,202188,true,1657775609,28,1653636553,-4139056
1678520891,202188,true,1657775609,28,1653471206,-4304403
1678520927,202189,true,1657609848,28,1652975264,-4634584
1678520939,202191,true,1657278376,28,1652809983,-4468393
1678520975,202191,true,1657278376,28,1652479470,-4798906
1678520999,202192,true,1657112665,28,1652149024,-4963641
1678521011,202193,true,1656946970,28,1651983826,-4963144
1678521035,202195,true,1656615630,28,1651653478,-4962152
1678521047,202196,true,1656449985,28,1651488330,-4961655
1678521119,202197,true,1656284357,28,1650497783,-5786574
1678521131,202198,true,1656118745,28,1650332750,-5785995
1678521143,202200,true,1655787571,28,1650167733,-5619838
1678521155,202201,true,1655622009,28,1650002733,-5619276
1678521167,202202,true,1655456463,28,1649837749,-5618714
1678521227,202203,true,1655290934,28,1649013078,-6277856
1678521263,202205,true,1654959925,28,1648518473,-6441452
1678521287,202207,true,1654628983,28,1648024016,-6604967
1678521299,202208,true,1654463537,28,1647859230,-6604307
1678521323,202209,true,1654298107,28,1647694461,-6603646
1678521335,202211,true,1653967297,28,1647529708,-6437589
1678521359,202212,true,1653801917,28,1647200251,-6601666
1678521371,202214,true,1653471206,28,1646870861,-6600345
1678521383,202215,true,1653305875,28,1646706190,-6599685
1678521407,202217,true,1652975264,28,1646376898,-6598366
1678521431,202218,true,1652809983,28,1646047672,-6762311
1678521443,202220,true,1652479470,28,1645883084,-6596386
1678521455,202221,true,1652314239,28,1645718512,-6595727
1678521479,202224,true,1651818644,28,1645224895,-6593749
1678521527,202227,true,1651323197,28,1644402529,-6920668
1678521539,202228,true,1651158081,28,1644238106,-6919975
1678521575,202230,true,1650827899,28,1643580575,-7247324
1678521587,202233,true,1650332750,28,1643251908,-7080842
1678521599,202235,true,1650002733,28,1643087599,-6915134
1678521611,202236,true,1649837749,28,1642759031,-7078718
1678521647,202239,true,1649342897,28,1641937898,-7404999
1678521743,202242,true,1648848193,28,1639804872,-9043321
1678521755,202245,true,1648353637,28,1639640908,-8712729
1678521767,202245,true,1648353637,28,1639313029,-9040608
1678521779,202248,true,1647859230,28,1639149114,-8710116
1678521827,202251,true,1647364971,28,1638165969,-9199002
1678521851,202253,true,1647035548,28,1637674617,-9360931
1678522007,202255,true,1646706190,28,1634239280,-12466910
1678522055,202258,true,1646212277,28,1633095770,-13116507
1678522079,202261,true,1645718512,28,1632605940,-13112572
1678522091,202263,true,1645389418,28,1632279467,-13109951
1678522115,202266,true,1644895899,28,1631626719,-13269180
1678522151,202270,true,1644238106,28,1630648085,-13590021
1678522259,202274,true,1643580575,28,1628204069,-15376506
1678522283,202276,true,1643251908,28,1627715705,-15536203
1678522295,202279,true,1642759031,28,1627390211,-15368820
1678522307,202283,true,1642102092,28,1627064782,-15037310
1678522355,202288,true,1641281287,28,1625763716,-15517571
1678522367,202291,true,1640789001,28,1625438612,-15350389
1678522379,202293,true,1640460892,28,1625276084,-15184808
1678522403,202297,true,1639804872,28,1624788599,-15016273
1678522427,202301,true,1639149114,28,1624301260,-14847854
1678522499,202303,true,1638821333,28,1623164703,-15656630
1678522523,202306,true,1638329785,28,1622677851,-15651934
1678522571,202308,true,1638002168,28,1622028942,-15973226
1678522643,202312,true,1637347131,28,1620893976,-16453155
1678522823,202314,true,1637019711,28,1618302749,-18716962
1678522847,202316,true,1636692356,28,1617979137,-18713219
1678522907,202320,true,1636037843,28,1617008689,-19029154
1678522919,202324,true,1635383591,28,1616847004,-18536587
1678523039,202327,true,1634893074,28,1614423673,-20469401
1678523051,202330,true,1634402704,28,1614100837,-20301867
1678523063,202333,true,1633912482,28,1613939443,-19973039
1678523075,202338,true,1633095770,28,1613616703,-19479067
1678523099,202342,true,1632442695,28,1613132715,-19309980
1678523135,202344,true,1632116256,28,1612165174,-19951082
1678523171,202348,true,1631463573,28,1611198213,-20265360
1678523183,202352,true,1630811150,28,1610876022,-19935128
1678523219,202357,true,1629995989,28,1609909835,-20086154
1678523279,202361,true,1629344154,28,1608622486,-20721668
1678523303,202365,true,1628692579,28,1608139996,-20552583
1678523315,202369,true,1628041265,28,1607979198,-20062067
1678523339,202373,true,1627390211,28,1607496901,-19893310
1678523363,202377,true,1626739418,28,1606854063,-19885355
1678523411,202381,true,1626088885,28,1605729715,-20359170
1678523531,202386,true,1625276084,28,1603323046,-21953038
1678523543,202391,true,1624463690,28,1603002429,-21461261
1678523591,202394,true,1623976448,28,1601880776,-22095672
1678523651,202399,true,1623164703,28,1600599848,-22564855
1678523663,202404,true,1622353364,28,1600439804,-21913560
1678523747,202408,true,1621704585,28,1598680376,-23024209
1678523783,202412,true,1621056066,28,1597881276,-23174790
1678523795,202416,true,1620407805,28,1597721504,-22686301
1678523843,202421,true,1619597844,28,1596763206,-22834638
1678523867,202425,true,1618950167,28,1596284273,-22665894
1678523903,202429,true,1618302749,28,1595645919,-22656830
1678523939,202433,true,1617655590,28,1595007820,-22647770
1678524071,202438,true,1616847004,28,1592935761,-23911243
1678524155,202443,true,1616038823,28,1591502835,-24535988
1678524167,202447,true,1615392569,28,1591343701,-24048868
1678524179,202451,true,1614746574,28,1591184582,-23561992
1678524215,202455,true,1614100837,28,1590707322,-23393515
1678524299,202459,true,1613455358,28,1589276401,-24178957
1678524335,202462,true,1612971418,28,1588640850,-24330568
1678524443,202466,true,1612326391,28,1586418420,-25907971
1678524515,202471,true,1611520469,28,1584674406,-26846063
1678524527,202474,true,1611037110,28,1584515954,-26521156
1678524551,202478,true,1610392856,28,1583882306,-26510550
1678524575,202482,true,1609748860,28,1583248912,-26499948
1678524599,202487,true,1608944227,28,1582615771,-26328456
1678524635,202490,true,1608461640,28,1581666533,-26795107
1678524719,202494,true,1607818416,28,1579611805,-28206611
1678524755,202499,true,1607014748,28,1578822236,-28192512
1678524767,202504,true,1606211482,28,1578506519,-27704963
1678524791,202507,true,1605729715,28,1577875275,-27854440
1678524887,202512,true,1604927091,28,1575667905,-29259186
1678525043,202517,true,1604124868,28,1572519876,-31604992
1678525187,202522,true,1603323046,28,1569692027,-33631019
1678525199,202525,true,1602842145,28,1569535074,-33307071
1678525235,202530,true,1602040964,28,1569064307,-32976657
1678525271,202534,true,1601400308,28,1568436838,-32963470
1678525319,202540,true,1600439804,28,1567652855,-32786949
1678525391,202544,true,1599799788,28,1566555937,-33243851
1678525403,202548,true,1599160028,28,1566399297,-32760731
1678525415,202554,true,1598200868,28,1566242673,-31958195
1678525427,202558,true,1597561748,28,1566086064,-31475684
1678525595,202561,true,1597082575,28,1564364403,-32718172
1678525607,202566,true,1596284273,28,1564207982,-32076291
1678525643,202571,true,1595486370,28,1563895187,-31591183
1678525667,202576,true,1594688866,28,1563582455,-31106411
1678525763,202579,true,1594210555,28,1562800898,-31409657
1678525847,202584,true,1593413689,28,1562019732,-31393957
1678525895,202589,true,1592617221,28,1561707375,-30909846
1678525979,202594,true,1591821152,28,1561082848,-30738304
1678525991,202596,true,1591502835,28,1561082848,-30419987
1678526111,202601,true,1590707322,28,1559990527,-30716795
1678526159,202606,true,1589912207,28,1559522624,-30389583
1678526219,202611,true,1589117490,28,1559210766,-29906724
1678526231,202614,true,1588640850,28,1559054861,-29585989
1678526243,202619,true,1587846767,28,1559054861,-28791906
1678526255,202624,true,1587053082,28,1558898971,-28154111
1678526267,202628,true,1586418420,28,1558898971,-27519449
1678526279,202631,true,1585942589,28,1558898971,-27043618
1678526315,202635,true,1585308371,28,1558898971,-26409400
1678526351,202639,true,1584674406,28,1558898971,-25775435
1678526411,202643,true,1584040695,28,1559054861,-24985834
1678526531,202644,true,1583882306,28,1559522624,-24359682
1678526567,202648,true,1583248912,28,1559834544,-23414368
1678526603,202652,true,1582615771,28,1560146526,-22469245
1678526615,202655,true,1582141081,28,1560302541,-21838540
1678526639,202656,true,1581982882,28,1560614617,-21368265
1678526687,202659,true,1581508382,28,1561082848,-20425534
1678526711,202662,true,1581034025,28,1561395081,-19638944
1678526735,202664,true,1580717865,28,1561707375,-19010490
1678526747,202665,true,1580559809,28,1562019732,-18540077
1678526759,202667,true,1580243745,28,1562175934,-18067811
1678526783,202670,true,1579769767,28,1562488385,-17281382
1678527023,202673,true,1579295930,28,1565616332,-13679598
1678527191,202674,true,1579138017,28,1567966401,-11171616
1678527239,202675,true,1578980119,28,1568593682,-10386437
1678527371,202678,true,1578506519,28,1569848996,-8657523
1678527383,202681,true,1578033062,28,1570005981,-8027081
1678527455,202682,true,1577875275,28,1570791141,-7084134
1678527575,202683,true,1577717503,28,1571891025,-5826478
1678527671,202685,true,1577402007,28,1572834395,-4567612
1678527803,202687,true,1577086574,28,1574250513,-2836061
1678527815,202688,true,1576928881,28,1574250513,-2678368
1678527827,202689,true,1576771204,28,1574407938,-2363266
1678527863,202691,true,1576455897,28,1574722835,-1733062
1678527899,202692,true,1576298267,28,1575195299,-1102968
1678527947,202692,true,1576298267,28,1575667905,-630362
1678527971,202693,true,1576140653,28,1575983054,-157599
1678527995,202695,true,1575825472,28,1576140653,315181
1678528055,202697,true,1575510354,28,1576771204,1260850
1678528151,202697,true,1575510354,28,1577559747,2049393
1678528319,202698,true,1575352819,28,1578822236,3469417
1678528847,202701,true,1574880307,28,1579611805,4731498
1678528871,202703,true,1574565379,28,1579769767,5204388
1678528883,202704,true,1574407938,28,1579769767,5361829
1678528919,202705,true,1574250513,28,1579769767,5519254
1678528967,202707,true,1573935710,28,1579927744,5992034
1678529027,202709,true,1573620970,28,1580085736,6464766
1678529063,202708,true,1573778332,28,1580243745,6465413
1678529243,202709,true,1573620970,28,1581192128,7571158
1678529783,202710,true,1573463624,28,1583723934,10260310
1678529843,202712,true,1573148978,28,1583882306,10733328
1678530179,202711,true,1573306293,28,1584674406,11368113
1678530227,202711,true,1573306293,28,1584674406,11368113
1678530275,202713,true,1572991679,28,1584832873,11841194
1678530347,202714,true,1572834395,28,1584991357,12156962
1678530395,202712,true,1573148978,28,1585149856,12000878
1678530659,202712,true,1573148978,28,1586101183,12952205
1678530695,202713,true,1572991679,28,1586259794,13268115
1678530839,202715,true,1572677128,28,1586577061,13899933
1678530863,202713,true,1572991679,28,1586577061,13585382
1678530887,202713,true,1572991679,28,1586735719,13744040
1678530899,202713,true,1572991679,28,1586735719,13744040
1678531031,202715,true,1572677128,28,1586418420,13741292
1678531415,202713,true,1572991679,28,1585942589,12950910
1678531451,202712,true,1573148978,28,1585942589,12793611
1678531463,202713,true,1572991679,28,1585942589,12950910
1678531499,202714,true,1572834395,28,1585784011,12949616
1678531547,202712,true,1573148978,28,1585784011,12635033
1678531631,202711,true,1573306293,28,1585784011,12477718
1678531643,202711,true,1573306293,28,1585784011,12477718
1678531847,202711,true,1573306293,28,1586101183,12794890
1678531859,202709,true,1573620970,28,1586101183,12480213
1678532015,202708,true,1573778332,28,1586418420,12640088
1678532159,202708,true,1573778332,28,1586894393,13116061
1678532171,202708,true,1573778332,28,1586894393,13116061
1678532219,202706,true,1574093103,28,1587053082,12959979
1678532243,202704,true,1574407938,28,1587211787,12803849
1678532267,202703,true,1574565379,28,1587211787,12646408
1678532303,202703,true,1574565379,28,1587370509,12805130
1678532315,202701,true,1574880307,28,1587370509,12490202
1678532363,202699,true,1575195299,28,1587529246,12333947
1678532675,202698,true,1575352819,28,1588482001,13129182
1678532759,202698,true,1575352819,28,1589117490,13764671
1678532795,202696,true,1575667905,28,1589435329,13767424
1678532903,202694,true,1575983054,28,1590548267,14565213
1678532951,202691,true,1576455897,28,1591184582,14728685
1678532963,202690,true,1576613542,28,1591343701,14730159
1678532975,202688,true,1576928881,28,1591343701,14414820
1678533023,202684,true,1577559747,28,1591980334,14420587
1678533071,202682,true,1577875275,28,1592617221,14741946
1678533095,202680,true,1578190865,28,1592776483,14585618
1678533107,202678,true,1578506519,28,1592935761,14429242
1678533239,202674,true,1579138017,28,1594369976,15231959
1678533263,202672,true,1579453860,28,1594529413,15075553
1678533347,202670,true,1579769767,28,1595326838,15557071
1678533359,202668,true,1580085736,28,1595326838,15241102
1678533431,202664,true,1580717865,28,1595805484,15087619
1678533455,202662,true,1581034025,28,1595965064,14931039
1678533467,202661,true,1581192128,28,1595965064,14772936
1678533659,202658,true,1581666533,28,1596763206,15096673
1678533683,202655,true,1582141081,28,1596763206,14622125
1678533695,202652,true,1582615771,28,1596922883,14307112
1678533707,202651,true,1582774032,28,1596922883,14148851
1678533971,202650,true,1582932309,28,1597082575,14150266
1678534139,202647,true,1583407237,28,1596763206,13355969
1678534403,202645,true,1583723934,28,1596284273,12560339
1678534415,202644,true,1583882306,28,1596284273,12401967
1678534631,202643,true,1584040695,28,1594848335,10807640
1678534667,202640,true,1584515954,28,1594529413,10013459
1678534871,202639,true,1584674406,28,1592298746,7624340
1678535015,202638,true,1584832873,28,1590707322,5874449
1678535135,202638,true,1584832873,28,1589594272,4761399
1678535195,202635,true,1585308371,28,1589117490,3809119
1678535243,202633,true,1585625448,28,1588799714,3174266
1678535351,202632,true,1585784011,28,1588164353,2380342
1678535375,202632,true,1585784011,28,1588005552,2221541
1678535387,202629,true,1586259794,28,1588005552,1745758
1678535471,202628,true,1586418420,28,1587370509,952089
1678535483,202628,true,1586418420,28,1587370509,952089
1678535495,202628,true,1586418420,28,1587370509,952089
1678535579,202626,true,1586735719,28,1586894393,158674
1678535831,202625,true,1586894393,28,1585308371,-1586022
1678535879,202625,true,1586894393,28,1584991357,-1903036
1678536059,202625,true,1586894393,28,1583882306,-3012087
1678536239,202623,true,1587211787,28,1582774032,-4437755
1678536299,202623,true,1587211787,28,1582615771,-4596016
1678536491,202623,true,1587211787,28,1581666533,-5545254
1678536539,202625,true,1586894393,28,1581666533,-5227860
1678536599,202623,true,1587211787,28,1581350247,-5861540
1678536695,202623,true,1587211787,28,1581034025,-6177762
1678536707,202624,true,1587053082,28,1581034025,-6019057
1678536719,202625,true,1586894393,28,1580875937,-6018456
1678536731,202624,true,1587053082,28,1580875937,-6177145
1678536827,202625,true,1586894393,28,1580401769,-6492624
1678536887,202625,true,1586894393,28,1580085736,-6808657
1678536899,202626,true,1586735719,28,1579927744,-6807975
1678536911,202625,true,1586894393,28,1579927744,-6966649
1678536935,202626,true,1586735719,28,1579769767,-6965952
1678537163,202627,true,1586577061,28,1577875275,-8701786
1678537187,202628,true,1586418420,28,1577717503,-8700917
1678537199,202627,true,1586577061,28,1577559747,-9017314
1678537247,202627,true,1586577061,28,1577086574,-9490487
1678537271,202629,true,1586259794,28,1576928881,-9330913
1678537283,202630,true,1586101183,28,1576771204,-9329979
1678537319,202629,true,1586259794,28,1576455897,-9803897
1678537367,202630,true,1586101183,28,1575983054,-10118129
1678537403,202632,true,1585784011,28,1575667905,-10116106
1678537511,202633,true,1585625448,28,1574565379,-11060069
1678537631,202633,true,1585625448,28,1573306293,-12319155
1678537655,202634,true,1585466902,28,1572991679,-12475223
1678537715,202636,true,1585149856,28,1572205419,-12944437
1678537751,202638,true,1584832873,28,1571733852,-13099021
1678538003,202639,true,1584674406,28,1568593682,-16080724
1678538027,202640,true,1584515954,28,1568280010,-16235944
1678538399,202642,true,1584199099,28,1563738813,-20460286
1678538699,202644,true,1583882306,28,1560458571,-23423735
1678538723,202644,true,1583882306,28,1560146526,-23735780
1678538735,202646,true,1583565577,28,1560146526,-23419051
1678539023,202648,true,1583248912,28,1558431394,-24817518
1678539071,202650,true,1582932309,28,1558119755,-24812554
1678539155,202650,true,1582932309,28,1557808178,-25124131
1678539239,202652,true,1582615771,28,1557652412,-24963359
1678539347,202654,true,1582299295,28,1557496663,-24802632
1678539359,202656,true,1581982882,28,1557496663,-24486219
1678539431,202656,true,1581982882,28,1557496663,-24486219
1678539443,202658,true,1581666533,28,1557496663,-24169870
1678539539,202659,true,1581508382,28,1557652412,-23855970
1678539659,202661,true,1581192128,28,1558119755,-23072373
1678539731,202662,true,1581034025,28,1558275567,-22758458
1678540007,202663,true,1580875937,28,1559366687,-21509250
1678540175,202665,true,1580559809,28,1559990527,-20569282
1678540187,202667,true,1580243745,28,1560146526,-20097219
1678540271,202668,true,1580085736,28,1560458571,-19627165
1678540415,202669,true,1579927744,28,1561238957,-18688787
1678540571,202670,true,1579769767,28,1561863546,-17906221
1678540583,202671,true,1579611805,28,1561863546,-17748259
1678541003,202672,true,1579453860,28,1563895187,-15558673
1678541267,202673,true,1579295930,28,1564990242,-14305688
1678541543,202673,true,1579295930,28,1565929471,-13366459
1678541651,202675,true,1578980119,28,1566242673,-12737446
1678541771,202675,true,1578980119,28,1566712593,-12267526
1678541783,202676,true,1578822236,28,1566712593,-12109643
1678541795,202677,true,1578664370,28,1566712593,-11951777
1678541807,202679,true,1578348684,28,1566869264,-11479420
1678541831,202680,true,1578190865,28,1566869264,-11321601
1678541855,202681,true,1578033062,28,1567025951,-11007111
1678541867,202682,true,1577875275,28,1567025951,-10849324
1678541963,202684,true,1577559747,28,1567496106,-10063641
1678542071,202685,true,1577402007,28,1567966401,-9435606
1678542263,202686,true,1577244282,28,1568593682,-8650600
1678542275,202687,true,1577086574,28,1568593682,-8492892
1678542299,202689,true,1576771204,28,1568750541,-8020663
1678542323,202690,true,1576613542,28,1568750541,-7863001
1678543511,202691,true,1576455897,28,1571733852,-4722045
1678543535,202692,true,1576298267,28,1571891025,-4407242
1678543607,202694,true,1575983054,28,1572048214,-3934840
1678543655,202695,true,1575825472,28,1572205419,-3620053
1678543667,202697,true,1575510354,28,1572205419,-3304935
1678543679,202699,true,1575195299,28,1572205419,-2989880
1678543751,202700,true,1575037795,28,1572519876,-2517919
1678543763,202702,true,1574722835,28,1572519876,-2202959
1678543991,202703,true,1574565379,28,1573463624,-1101755
1678544591,202705,true,1574250513,28,1575195299,944786
1678544831,202706,true,1574093103,28,1575825472,1732369
1678544867,202707,true,1573935710,28,1575983054,2047344
1678544879,202709,true,1573620970,28,1575983054,2362084
1678545287,202710,true,1573463624,28,1576613542,3149918
1678545527,202712,true,1573148978,28,1576613542,3464564
1678545647,202713,true,1572991679,28,1576455897,3464218
1678545827,202714,true,1572834395,28,1576140653,3306258
1678546451,202715,true,1572677128,28,1575667905,2990777
1678546499,202716,true,1572519876,28,1575510354,2990478
1678546655,202717,true,1572362639,28,1575352819,2990180
1678546679,202718,true,1572205419,28,1575352819,3147400
1678546691,202720,true,1571891025,28,1575352819,3461794
1678546703,202720,true,1571891025,28,1575352819,3461794
1678546751,202721,true,1571733852,28,1575195299,3461447
1678547027,202723,true,1571419552,28,1574880307,3460755
1678547243,202724,true,1571262426,28,1574407938,3145512
1678547267,202724,true,1571262426,28,1574407938,3145512
1678547351,202725,true,1571105315,28,1574250513,3145198
1678547387,202726,true,1570948220,28,1574093103,3144883
1678547747,202727,true,1570791141,28,1573306293,2515152
1678547771,202727,true,1570791141,28,1573306293,2515152
1678547903,202728,true,1570634078,28,1572834395,2200317
1678548095,202729,true,1570477030,28,1572362639,1885609
1678548143,202730,true,1570319998,28,1572205419,1885421
1678548359,202730,true,1570319998,28,1571576694,1256696
1678548383,202731,true,1570162982,28,1571576694,1413712
1678548983,202732,true,1570005981,28,1570634078,628097
1678549139,202733,true,1569848996,28,1570634078,785082
1678549475,202733,true,1569848996,28,1570319998,471002
1678549583,202734,true,1569692027,28,1570319998,627971
1678549811,202735,true,1569535074,28,1570162982,627908
1678549895,202736,true,1569378136,28,1570162982,784846
1678549907,202736,true,1569378136,28,1570162982,784846
1678549943,202737,true,1569221214,28,1570162982,941768
1678549967,202737,true,1569221214,28,1570005981,784767
1678549991,202739,true,1568907417,28,1570005981,1098564
1678550243,202739,true,1568907417,28,1569378136,470719
1678550675,202739,true,1568907417,28,1568436838,-470579
1678550711,202740,true,1568750541,28,1568436838,-313703
1678550723,202741,true,1568593682,28,1568436838,-156844
1678550747,202741,true,1568593682,28,1568436838,-156844
1678550891,202741,true,1568593682,28,1568123198,-470484
1678550915,202741,true,1568593682,28,1568123198,-470484
1678551179,202743,true,1568280010,28,1567339372,-940638
1678551551,202743,true,1568280010,28,1566242673,-2037337
1678551575,202743,true,1568280010,28,1566086064,-2193946
1678551827,202743,true,1568280010,28,1565616332,-2663678
1678551899,202744,true,1568123198,28,1565616332,-2506866
1678551935,202744,true,1568123198,28,1565616332,-2506866
1678551971,202745,true,1567966401,28,1565459786,-2506615
1678551983,202745,true,1567966401,28,1565459786,-2506615
1678552043,202745,true,1567966401,28,1565459786,-2506615
1678552307,202746,true,1567809620,28,1564520839,-3288781
1678552367,202746,true,1567809620,28,1564207982,-3601638
1678552475,202746,true,1567809620,28,1563738813,-4070807
1678552511,202747,true,1567652855,28,1563426112,-4226743
1678552523,202748,true,1567496106,28,1563269786,-4226320
1678552547,202748,true,1567496106,28,1563113474,-4382632
1678552571,202748,true,1567496106,28,1562957178,-4538928
1678552655,202748,true,1567496106,28,1562332152,-5163954
1678552667,202749,true,1567339372,28,1562175934,-5163438
1678552679,202748,true,1567496106,28,1562175934,-5320172
1678552751,202748,true,1567496106,28,1561863546,-5632560
1678552787,202748,true,1567496106,28,1561707375,-5788731
1678552811,202748,true,1567496106,28,1561707375,-5788731
1678552823,202748,true,1567496106,28,1561551220,-5944886
1678552859,202748,true,1567496106,28,1561395081,-6101025
1678552943,202748,true,1567496106,28,1560926756,-6569350
1678552979,202749,true,1567339372,28,1560770679,-6568693
1678553027,202749,true,1567339372,28,1560458571,-6880801
1678553075,202749,true,1567339372,28,1559990527,-7348845
1678553123,202750,true,1567182653,28,1559678576,-7504077
1678553195,202751,true,1567025951,28,1559210766,-7815185
1678553219,202751,true,1567025951,28,1559054861,-7971090
1678554407,202750,true,1567182653,28,1554851300,-12331353
1678554419,202752,true,1566869264,28,1554851300,-12017964
1678554443,202753,true,1566712593,28,1554851300,-11861293
1678554599,202752,true,1566869264,28,1554384938,-12484326
1678554635,202753,true,1566712593,28,1554229515,-12483078
1678554659,202754,true,1566555937,28,1554229515,-12326422
1678554695,202755,true,1566399297,28,1554074107,-12325190
1678554719,202755,true,1566399297,28,1554074107,-12325190
1678554743,202756,true,1566242673,28,1553918716,-12323957
1678554767,202757,true,1566086064,28,1553918716,-12167348
1678554779,202759,true,1565772894,28,1553763339,-12009555
1678554791,202760,true,1565616332,28,1553763339,-11852993
1678554815,202761,true,1565459786,28,1553607978,-11851808
1678554863,202763,true,1565146741,28,1553452633,-11694108
1678554899,202765,true,1564833759,28,1553141989,-11691770
1678554911,202766,true,1564677291,28,1553141989,-11535302
1678555355,202768,true,1564364403,28,1548954371,-15410032
1678555379,202770,true,1564051577,28,1548644627,-15406950
1678555415,202772,true,1563738813,28,1548334944,-15403869
1678555427,202773,true,1563582455,28,1548180126,-15402329
1678555835,202776,true,1563113474,28,1543697131,-19416343
1678555883,202778,true,1562800898,28,1543234115,-19566783
1678555931,202780,true,1562488385,28,1542771237,-19717148
1678555967,202781,true,1562332152,28,1542462729,-19869423
1678556039,202783,true,1562019732,28,1541691729,-20328003
1678556051,202786,true,1561551220,28,1541691729,-19859491
1678556063,202788,true,1561238957,28,1541537576,-19701381
1678556075,202789,true,1561082848,28,1541383437,-19699411
1678556099,202791,true,1560770679,28,1541229314,-19541365
1678556135,202793,true,1560458571,28,1541075207,-19383364
1678556231,202795,true,1560146526,28,1540458931,-19687595
1678556315,202796,true,1559990527,28,1539996885,-19993642
1678556471,202798,true,1559678576,28,1539227118,-20451458
1678556687,202800,true,1559366687,28,1538919319,-20447368
1678556807,202802,true,1559054861,28,1539381041,-19673820
1678556819,202804,true,1558743096,28,1539381041,-19362055
1678556831,202806,true,1558431394,28,1539534979,-18896415
1678556855,202808,true,1558119755,28,1539688932,-18430823
1678556867,202809,true,1557963959,28,1539688932,-18275027
1678557263,202809,true,1557963959,28,1543079807,-14884152
1678557287,202811,true,1557652412,28,1543234115,-14418297
1678557335,202813,true,1557340929,28,1543697131,-13643798
1678557431,202814,true,1557185210,28,1544314703,-12870507
1678557515,202815,true,1557029507,28,1544932522,-12096985
1678557755,202818,true,1556562492,28,1546323517,-10238975
1678557887,202820,true,1556251226,28,1546787461,-9463765
1678557935,202821,true,1556095616,28,1546942139,-9153477
1678558067,202822,true,1555940022,28,1546942139,-8997883
1678558391,202825,true,1555473334,28,1546942139,-8531195
1678558475,202827,true,1555162286,28,1546942139,-8220147
1678558571,202828,true,1555006785,28,1546942139,-8064646
1678558631,202829,true,1554851300,28,1546787461,-8063839
1678558751,202832,true,1554384938,28,1546014299,-8370639
1678558811,202834,true,1554074107,28,1545705142,-8368965
1678558835,202835,true,1553918716,28,1545550587,-8368129
1678558871,202836,true,1553763339,28,1545396048,-8367291
1678558883,202839,true,1553297303,28,1545241523,-8055780
1678558895,202840,true,1553141989,28,1545241523,-7900466
1678558979,202842,true,1552831407,28,1544932522,-7898885
1678558991,202842,true,1552831407,28,1544932522,-7898885
1678559075,202845,true,1552365651,28,1544623581,-7742070
1678559123,202846,true,1552210430,28,1544623581,-7586849
1678559135,202847,true,1552055225,28,1544623581,-7431644
1678559351,202847,true,1552055225,28,1544623581,-7431644
1678559531,202850,true,1551589701,28,1544932522,-6657179
1678559843,202851,true,1551434558,28,1545705142,-5729416
1678560371,202852,true,1551279430,28,1547561009,-3718421
1678560383,202852,true,1551279430,28,1547561009,-3718421
1678560611,202854,true,1550969220,28,1548334944,-2634276
1678560683,202856,true,1550659073,28,1548489778,-2169295
1678560719,202857,true,1550504023,28,1548489778,-2014245
1678561019,202857,true,1550504023,28,1548334944,-2169079
1678561103,202860,true,1550038965,28,1548180126,-1858839
1678561163,202861,true,1549883976,28,1548025324,-1858652
1678561175,202862,true,1549729003,28,1548025324,-1703679
1678561259,202863,true,1549574046,28,1547715765,-1858281
1678561391,202865,true,1549264177,28,1547251543,-2012634
1678561799,202866,true,1549109267,28,1545705142,-3404125
1678561895,202867,true,1548954371,28,1545241523,-3712848
1678561931,202868,true,1548799491,28,1545087015,-3712476
1678562111,202871,true,1548334944,28,1544160287,-4174657
1678562483,202872,true,1548180126,28,1542000083,-6180043
1678562699,202873,true,1548025324,28,1540921115,-7104209
1678563395,202875,true,1547715765,28,1538611581,-9104184
1678564019,202877,true,1547406268,28,1537534984,-9871284
1678564727,202878,true,1547251543,28,1537688737,-9562806
1678564811,202880,true,1546942139,28,1537688737,-9253402
1678565579,202881,true,1546787461,28,1536459139,-10328322
1678565591,202884,true,1546323517,28,1536459139,-9864378
1678565831,202885,true,1546168900,28,1535998294,-10170606
1678565999,202886,true,1546014299,28,1535537587,-10476712
1678566011,202887,true,1545859713,28,1535384048,-10475665
1678566023,202890,true,1545396048,28,1535384048,-10012000
1678566047,202891,true,1545241523,28,1535384048,-9857475
1678566107,202891,true,1545241523,28,1535077017,-10164506
1678566299,202894,true,1544778044,28,1533849508,-10928536
1678566335,202896,true,1544469134,28,1533542784,-10926350
1678566347,202898,true,1544160287,28,1533389445,-10770842
1678566359,202898,true,1544160287,28,1533236122,-10924165
1678566371,202901,true,1543697131,28,1533236122,-10461009
1678566383,202904,true,1543234115,28,1533082813,-10151302
1678566419,202907,true,1542771237,28,1532622981,-10148256
1678566503,202908,true,1542616976,28,1531856899,-10760077
1678566515,202910,true,1542308498,28,1531703729,-10604769
1678566527,202913,true,1541845898,28,1531550574,-10295324
1678566539,202916,true,1541383437,28,1531397434,-9986003
1678566587,202917,true,1541229314,28,1530631965,-10597349
1678566599,202920,true,1540767038,28,1530478917,-10288121
1678566623,202923,true,1540304900,28,1530172867,-10132033
1678566635,202925,true,1539996885,28,1530019865,-9977020
1678566647,202927,true,1539688932,28,1529866878,-9822054
1678566743,202931,true,1539073211,28,1528185034,-10888177
1678566779,202935,true,1538457735,28,1527573913,-10883822
1678566815,202937,true,1538150090,28,1526963036,-11187054
1678566827,202939,true,1537842506,28,1526657689,-11184817
1678566995,202942,true,1537381245,28,1524064705,-13316540
1678567031,202946,true,1536766447,28,1523455232,-13311215
1678567079,202948,true,1536459139,28,1522541479,-13917660
1678567163,202950,true,1536151894,28,1521476126,-14675768
1678567187,202953,true,1535691140,28,1521019774,-14671366
1678567547,202955,true,1535384048,28,1516463780,-18920268
1678567571,202957,true,1535077017,28,1516160533,-18916484
1678567595,202958,true,1534923525,28,1515857346,-19066179
1678567619,202961,true,1534463140,28,1515554220,-18908920
1678567655,202964,true,1534002893,28,1515099645,-18903248
1678568027,202965,true,1533849508,28,1510561384,-23288124
1678568123,202966,true,1533696139,28,1509353478,-24342661
1678568135,202969,true,1533236122,28,1509202558,-24033564
1678568183,202971,true,1532929521,28,1508749888,-24179633
1678568243,202973,true,1532622981,28,1508297353,-24325628
1678568495,202974,true,1532469734,28,1507694185,-24775549
1678568507,202976,true,1532163286,28,1507694185,-24469101
1678568615,202978,true,1531856899,28,1507694185,-24162714
1678568699,202980,true,1531550574,28,1507543431,-24007143
1678568843,202981,true,1531397434,28,1507543431,-23854003
1678568975,202984,true,1530938106,28,1507392691,-23545415
1678569275,202985,true,1530785028,28,1506789885,-23995143
1678569335,202987,true,1530478917,28,1506789885,-23689032
1678569371,202988,true,1530325884,28,1506789885,-23535999
1678569395,202991,true,1529866878,28,1506789885,-23076993
1678569467,202992,true,1529713907,28,1506940564,-22773343
1678569515,202994,true,1529408010,28,1507091258,-22316752
1678569527,202995,true,1529255084,28,1507091258,-22163826
1678569539,202998,true,1528796400,28,1507091258,-21705142
1678569599,202999,true,1528643535,28,1507392691,-21250844
1678569647,203000,true,1528490686,28,1507694185,-20796501
1678569683,203001,true,1528337852,28,1507844954,-20492898
1678569695,203004,true,1527879443,28,1507995739,-19883704
1678569731,203005,true,1527726670,28,1508146538,-19580132
1678569875,203006,true,1527573913,28,1509353478,-18220435
1678569947,203008,true,1527268444,28,1510108306,-17160138
1678570127,203011,true,1526810355,28,1511770256,-15040099
1678570139,203012,true,1526657689,28,1511770256,-14887433
1678570151,203013,true,1526505039,28,1511921433,-14583606
1678570331,203014,true,1526352403,28,1514342322,-12010081
1678570415,203015,true,1526199783,28,1515705776,-10494007
1678570571,203015,true,1526199783,28,1518132724,-8067059
1678570631,203017,true,1525894589,28,1519043832,-6850757
1678570667,203017,true,1525894589,28,1519499591,-6394998
1678570799,203018,true,1525742015,28,1521628273,-4113742
1678571159,203017,true,1525894589,28,1527421171,1526582
1678571183,203018,true,1525742015,28,1527726670,1984655
1678571195,203018,true,1525742015,28,1527879443,2137428
1678571303,203019,true,1525589456,28,1529408010,3818554
1678571387,203019,true,1525589456,28,1530325884,4736428
1678571483,203020,true,1525436912,28,1531244309,5807397
1678571543,203020,true,1525436912,28,1531856899,6419987
1678571555,203021,true,1525284384,28,1532010085,6725701
1678571591,203020,true,1525436912,28,1532316502,6879590
1678571615,203021,true,1525284384,28,1532622981,7338597
1678571627,203021,true,1525284384,28,1532776243,7491859
1678571639,203022,true,1525131871,28,1532776243,7644372
1678571651,203021,true,1525284384,28,1532929521,7645137
1678572323,203023,true,1524979373,28,1537073815,12094442
1678572611,203023,true,1524979373,28,1537842506,12863133
1678573943,203024,true,1524826890,28,1538457735,13630845
1678574399,203024,true,1524826890,28,1538457735,13630845
1678575119,203025,true,1524674423,28,1538611581,13937158
1678575947,203025,true,1524674423,28,1538765442,14091019
1678576079,203027,true,1524369534,28,1538765442,14395908
1678576199,203026,true,1524521970,28,1538919319,14397349
1678576631,203027,true,1524369534,28,1538919319,14549785
1678576763,203027,true,1524369534,28,1538919319,14549785
1678576871,203028,true,1524217112,28,1538919319,14702207
1678577399,203028,true,1524217112,28,1538919319,14702207
1678577435,203029,true,1524064705,28,1538919319,14854614
1678577459,203029,true,1524064705,28,1538919319,14854614
1678577507,203030,true,1523912314,28,1538765442,14853128
1678577591,203029,true,1524064705,28,1538611581,14546876
1678577615,203031,true,1523759938,28,1538457735,14697797
1678577639,203031,true,1523759938,28,1538303905,14543967
1678577663,203032,true,1523607577,28,1538303905,14696328
1678578119,203032,true,1523607577,28,1535998294,12390717
1678578215,203033,true,1523455232,28,1535384048,11928816
1678578239,203033,true,1523455232,28,1535230525,11775293
1678578275,203034,true,1523302902,28,1534923525,11620623
1678578323,203034,true,1523302902,28,1534616586,11313684
1678578347,203036,true,1522998287,28,1534463140,11464853
1678578479,203036,true,1522998287,28,1533236122,10237835
1678578527,203037,true,1522846002,28,1532929521,10083519
1678578803,203037,true,1522846002,28,1530478917,7632915
1678578839,203038,true,1522693733,28,1530172867,7479134
1678578851,203038,true,1522693733,28,1530172867,7479134
1678578875,203039,true,1522541479,28,1529866878,7325399
1678578887,203039,true,1522541479,28,1529866878,7325399
1678578899,203040,true,1522389240,28,1529713907,7324667
1678579007,203040,true,1522389240,28,1529102174,6712934
1678579055,203039,true,1522541479,28,1528643535,6102056
1678579067,203039,true,1522541479,28,1528643535,6102056
1678579079,203040,true,1522389240,28,1528643535,6254295
1678579127,203038,true,1522693733,28,1528490686,5796953
1678579139,203036,true,1522998287,28,1528490686,5492399
1678579151,203036,true,1522998287,28,1528490686,5492399
1678579163,203036,true,1522998287,28,1528490686,5492399
1678579379,203034,true,1523302902,28,1528643535,5340633
1678579415,203032,true,1523607577,28,1528796400,5188823
1678579727,203032,true,1523607577,28,1529866878,6259301
1678579811,203031,true,1523759938,28,1530172867,6412929
1678579823,203028,true,1524217112,28,1530172867,5955755
1678579883,203026,true,1524521970,28,1530325884,5803914
1678579931,203026,true,1524521970,28,1530325884,5803914
1678579943,203026,true,1524521970,28,1530325884,5803914
1678579967,203023,true,1524979373,28,1530478917,5499544
1678580039,203020,true,1525436912,28,1530631965,5195053
1678580063,203019,true,1525589456,28,1530631965,5042509
1678580699,203020,true,1525436912,28,1533082813,7645901
1678580711,203017,true,1525894589,28,1533082813,7188224
1678580795,203014,true,1526352403,28,1533082813,6730410
1678581215,203014,true,1526352403,28,1531703729,5351326
1678581239,203014,true,1526352403,28,1531703729,5351326
1678581383,203011,true,1526810355,28,1531091200,4280845
1678581395,203009,true,1527115732,28,1530938106,3822374
1678581503,203010,true,1526963036,28,1530478917,3515881
1678581563,203010,true,1526963036,28,1530325884,3362848
1678581827,203007,true,1527421171,28,1529408010,1986839
1678581899,203005,true,1527726670,28,1529255084,1528414
1678582091,203005,true,1527726670,28,1528796400,1069730
1678582631,203006,true,1527573913,28,1527573913,0
1678583231,203003,true,1528032231,28,1526505039,-1527192
1678583267,203001,true,1528337852,28,1526352403,-1985449
1678583291,203001,true,1528337852,28,1526352403,-1985449
1678583339,203001,true,1528337852,28,1526199783,-2138069
1678583363,202999,true,1528643535,28,1526047179,-2596356
1678583435,202997,true,1528949279,28,1525894589,-3054690
1678583507,202997,true,1528949279,28,1525589456,-3359823
1678583639,202997,true,1528949279,28,1524979373,-3969906
1678583687,202995,true,1529255084,28,1524826890,-4428194
1678583759,202994,true,1529408010,28,1524521970,-4886040
1678583855,202994,true,1529408010,28,1524064705,-5343305
1678584347,202995,true,1529255084,28,1521628273,-7626811
1678584491,202993,true,1529560951,28,1520867687,-8693264
1678584527,202992,true,1529713907,28,1520715616,-8998291
1678584599,202993,true,1529560951,28,1520259492,-9301459
1678584611,202994,true,1529408010,28,1520107482,-9300528
1678584767,202993,true,1529560951,28,1519043832,-10517119
1678584779,202991,true,1529866878,28,1518891943,-10974935
1678584803,202993,true,1529560951,28,1518740069,-10820882
1678584839,202995,true,1529255084,28,1518436366,-10818718
1678584863,202994,true,1529408010,28,1518284538,-11123472
1678585031,202993,true,1529560951,28,1516767088,-12793863
1678585427,202996,true,1529102174,28,1511921433,-17180741
1678585463,202999,true,1528643535,28,1511619094,-17024441
1678585775,202998,true,1528796400,28,1508599028,-20197372
1678585811,202998,true,1528796400,28,1508297353,-20499047
1678585823,203001,true,1528337852,28,1508146538,-20191314
1678585871,203004,true,1527879443,28,1507844954,-20034489
1678586003,203004,true,1527879443,28,1506789885,-21089558
1678586015,203005,true,1527726670,28,1506639221,-21087449
1678586087,203008,true,1527268444,28,1506036716,-21231728
1678586099,203010,true,1526963036,28,1506036716,-20926320
1678586315,203011,true,1526810355,28,1504531507,-22278848
1678586351,203011,true,1526810355,28,1504381069,-22429286
1678586987,203015,true,1526199783,28,1503178106,-23021677
1678587383,203018,true,1525742015,28,1504381069,-21360946
1678588175,203018,true,1525742015,28,1506337938,-19404077
1678588223,203019,true,1525589456,28,1506337938,-19251518
1678588559,203022,true,1525131871,28,1506488572,-18643299
1678588739,203024,true,1524826890,28,1506639221,-18187669
1678588835,203025,true,1524674423,28,1506639221,-18035202
1678588847,203026,true,1524521970,28,1506639221,-17882749
1678589075,203029,true,1524064705,28,1506940564,-17124141
1678589183,203032,true,1523607577,28,1507091258,-16516319
1678589675,203032,true,1523607577,28,1508146538,-15461039
1678589699,203033,true,1523455232,28,1508146538,-15308694
1678590119,203036,true,1522998287,28,1509353478,-13644809
1678590623,203038,true,1522693733,28,1511014597,-11679136
1678590647,203038,true,1522693733,28,1511165699,-11528034
1678590743,203039,true,1522541479,28,1511467947,-11073532
1678591271,203042,true,1522084807,28,1512677545,-9407262
1678591355,203044,true,1521780436,28,1513131393,-8649043
1678591835,203043,true,1521932614,28,1515251155,-6681459
1678591859,203044,true,1521780436,28,1515251155,-6529281
1678591979,203046,true,1521476126,28,1515857346,-5618780
1678592423,203048,true,1521171876,28,1517525623,-3646253
1678592435,203047,true,1521323993,28,1517677376,-3646617
1678592639,203048,true,1521171876,28,1518436366,-2735510
1678592843,203051,true,1520715616,28,1518891943,-1823673
1678592963,203053,true,1520411518,28,1519195736,-1215782
1678592999,203052,true,1520563559,28,1519347656,-1215903
1678593047,203053,true,1520411518,28,1519499591,-911927
1678593443,203055,true,1520107482,28,1519651541,-455941
1678593467,203056,true,1519955486,28,1519651541,-303945
1678593479,203055,true,1520107482,28,1519651541,-455941
1678593551,203056,true,1519955486,28,1519651541,-303945
1678593563,203057,true,1519803506,28,1519651541,-151965
1678593671,203058,true,1519651541,28,1519651541,0
1678594247,203058,true,1519651541,28,1519651541,0
1678594379,203058,true,1519651541,28,1519651541,0
1678594619,203059,true,1519499591,28,1519651541,151950
1678594631,203060,true,1519347656,28,1519651541,303885
1678594943,203059,true,1519499591,28,1519043832,-455759
1678595099,203060,true,1519347656,28,1518588210,-759446
1678595171,203061,true,1519195736,28,1518436366,-759370
1678595279,203062,true,1519043832,28,1518284538,-759294
1678595303,203061,true,1519195736,28,1518284538,-911198
1678595351,203061,true,1519195736,28,1518132724,-1063012
1678595459,203063,true,1518891943,28,1517980926,-911017
1678595495,203064,true,1518740069,28,1517829143,-910926
1678595855,203063,true,1518891943,28,1517070457,-1821486
1678596071,203064,true,1518740069,28,1516615426,-2124643
1678596095,203065,true,1518588210,28,1516615426,-1972784
1678596167,203067,true,1518284538,28,1516463780,-1820758
1678596275,203067,true,1518284538,28,1516463780,-1820758
1678596287,203068,true,1518132724,28,1516463780,-1668944
1678596299,203070,true,1517829143,28,1516463780,-1365363
1678596347,203071,true,1517677376,28,1516463780,-1213596
1678596563,203070,true,1517829143,28,1517222164,-606979
1678597283,203071,true,1517677376,28,1520563559,2886183
1678597559,203072,true,1517525623,28,1521932614,4406991
1678597583,203073,true,1517373886,28,1522084807,4710921
1678597679,203073,true,1517373886,28,1522541479,5167593
1678597751,203074,true,1517222164,28,1522846002,5623838
1678597991,203075,true,1517070457,28,1524217112,7146655
1678598039,203075,true,1517070457,28,1524369534,7299077
1678598159,203074,true,1517222164,28,1524826890,7604726
1678598291,203075,true,1517070457,28,1524979373,7908916
1678598327,203076,true,1516918765,28,1525131871,8213106
1678598339,203076,true,1516918765,28,1525131871,8213106
1678598423,203075,true,1517070457,28,1525284384,8213927
1678598459,203076,true,1516918765,28,1525284384,8365619
1678598471,203077,true,1516767088,28,1525284384,8517296
1678598495,203077,true,1516767088,28,1525436912,8669824
1678598567,203075,true,1517070457,28,1525589456,8518999
1678599359,203076,true,1516918765,28,1528185034,11266269
1678599791,203076,true,1516918765,28,1529255084,12336319
1678599851,203076,true,1516918765,28,1529255084,12336319
1678599899,203075,true,1517070457,28,1529408010,12337553
1678600211,203075,true,1517070457,28,1530019865,12949408
1678600235,203076,true,1516918765,28,1530019865,13101100
1678600259,203075,true,1517070457,28,1530019865,12949408
1678600271,203074,true,1517222164,28,1530019865,12797701
1678600715,203075,true,1517070457,28,1529560951,12490494
1678600799,203075,true,1517070457,28,1529560951,12490494
1678601291,203075,true,1517070457,28,1529102174,12031717
1678602071,203073,true,1517373886,28,1528185034,10811148
1678602083,203073,true,1517373886,28,1528337852,10963966
1678602095,203073,true,1517373886,28,1528337852,10963966
1678602239,203073,true,1517373886,28,1528490686,11116800
1678602359,203071,true,1517677376,28,1528643535,10966159
1678602383,203071,true,1517677376,28,1528643535,10966159
1678602407,203071,true,1517677376,28,1528643535,10966159
1678602455,203070,true,1517829143,28,1528796400,10967257
1678602731,203067,true,1518284538,28,1529560951,11276413
1678602743,203067,true,1518284538,28,1529560951,11276413
1678603043,203067,true,1518284538,28,1530631965,12347427
1678603475,203065,true,1518588210,28,1532163286,13575076
1678603523,203062,true,1519043832,28,1532316502,13272670
1678603535,203062,true,1519043832,28,1532316502,13272670
1678603547,203062,true,1519043832,28,1532316502,13272670
1678603895,203060,true,1519347656,28,1534002893,14655237
1678603991,203056,true,1519955486,28,1534309709,14354223
1678604003,203056,true,1519955486,28,1534309709,14354223
1678604027,203054,true,1520259492,28,1534463140,14203648
1678604039,203052,true,1520563559,28,1534463140,13899581
1678604483,203047,true,1521323993,28,1536305509,14981516
1678604855,203047,true,1521323993,28,1537381245,16057252
1678604879,203045,true,1521628273,28,1537534984,15906711
1678605335,203042,true,1522084807,28,1539688932,17604125
1678605383,203038,true,1522693733,28,1539996885,17303152
1678605515,203037,true,1522846002,28,1540767038,17921036
1678605983,203035,true,1523150587,28,1543234115,20083528
1678606343,203032,true,1523607577,28,1544932522,21324945
1678606823,203028,true,1524217112,28,1547096833,22879721
1678606859,203027,true,1524369534,28,1547251543,22882009
1678607099,203025,true,1524674423,28,1548025324,23350901
1678607591,203022,true,1525131871,28,1548799491,23667620
1678608851,203018,true,1525742015,28,1549729003,23986988
1678609907,203017,true,1525894589,28,1550038965,24144376
1678609919,203015,true,1526199783,28,1550038965,23839182
1678610123,203012,true,1526657689,28,1549883976,23226287
1678610291,203008,true,1527268444,28,1549729003,22460559
1678611323,203007,true,1527421171,28,1548180126,20758955
1678611407,203005,true,1527726670,28,1548025324,20298654
1678612547,203003,true,1528032231,28,1546942139,18909908
1678612607,202999,true,1528643535,28,1546942139,18298604
1678613867,202998,true,1528796400,28,1546787461,17991061
1678613903,202997,true,1528949279,28,1546787461,17838182
1678613927,202994,true,1529408010,28,1546787461,17379451
1678614095,202991,true,1529866878,28,1546787461,16920583
1678614155,202990,true,1530019865,28,1546787461,16767596
1678614479,202989,true,1530172867,28,1546478149,16305282
1678614575,202987,true,1530478917,28,1546478149,15999232
1678614767,202984,true,1530938106,28,1546168900,15230794
1678614779,202984,true,1530938106,28,1546168900,15230794
1678614791,202983,true,1531091200,28,1546168900,15077700
1678615007,202981,true,1531397434,28,1545705142,14307708
1678615139,202979,true,1531703729,28,1545396048,13692319
1678615619,202978,true,1531856899,28,1544314703,12457804
1678615751,202978,true,1531856899,28,1544005886,12148987
1678616591,202976,true,1532163286,28,1542771237,10607951
1678617011,202973,true,1532622981,28,1542616976,9993995
1678617035,202973,true,1532622981,28,1542616976,9993995
1678617131,202973,true,1532622981,28,1542616976,9993995
1678617263,202971,true,1532929521,28,1542616976,9687455
1678617983,202968,true,1533389445,28,1542000083,8610638
1678618127,202968,true,1533389445,28,1541845898,8456453
1678618151,202967,true,1533542784,28,1541845898,8303114
1678618175,202966,true,1533696139,28,1541845898,8149759
1678618427,202963,true,1534156293,28,1541537576,7381283
1678618511,202963,true,1534156293,28,1541383437,7227144
1678618547,202963,true,1534156293,28,1541383437,7227144
1678618763,202961,true,1534463140,28,1540921115,6457975
1678619147,202958,true,1534923525,28,1540458931,5535406
1678619327,202958,true,1534923525,28,1540304900,5381375
1678619483,202957,true,1535077017,28,1540150885,5073868
1678619519,202955,true,1535384048,28,1539996885,4612837
1678619531,202953,true,1535691140,28,1539996885,4305745
1678619567,202952,true,1535844709,28,1539996885,4152176
1678619603,202952,true,1535844709,28,1539996885,4152176
1678619639,202950,true,1536151894,28,1539842901,3691007
1678619819,202948,true,1536459139,28,1539381041,2921902
1678619831,202947,true,1536612785,28,1539381041,2768256
1678620059,202947,true,1536612785,28,1538765442,2152657
1678622207,202946,true,1536766447,28,1535077017,-1689430
1678622795,202943,true,1537227523,28,1535077017,-2150506
1678623143,202943,true,1537227523,28,1535077017,-2150506
1678623251,202943,true,1537227523,28,1535077017,-2150506
1678623311,202942,true,1537381245,28,1535077017,-2304228
1678623575,202941,true,1537534984,28,1534309709,-3225275
1678624739,202942,true,1537381245,28,1531397434,-5983811
1678625327,202941,true,1537534984,28,1530478917,-7056067
1678625531,202940,true,1537688737,28,1530785028,-6903709
1678626215,202939,true,1537842506,28,1531550574,-6291932
1678626803,202940,true,1537688737,28,1532163286,-5525451
1678627319,202940,true,1537688737,28,1532776243,-4912494
1678627571,202939,true,1537842506,28,1532929521,-4912985
1678627859,202938,true,1537996290,28,1533236122,-4760168
1678627955,202938,true,1537996290,28,1533389445,-4606845
1678628411,202938,true,1537996290,28,1533542784,-4453506
1678628663,202937,true,1538150090,28,1533696139,-4453951
1678629155,202936,true,1538303905,28,1533696139,-4607766
1678629671,202937,true,1538150090,28,1533542784,-4607306
1678629683,202937,true,1538150090,28,1533542784,-4607306
1678629791,202936,true,1538303905,28,1533389445,-4914460
1678629851,202935,true,1538457735,28,1533389445,-5068290
1678629911,202936,true,1538303905,28,1533389445,-4914460
1678629995,202936,true,1538303905,28,1533236122,-5067783
1678630211,202936,true,1538303905,28,1532776243,-5527662
1678630487,202935,true,1538457735,28,1532316502,-6141233
1678630787,202936,true,1538303905,28,1531703729,-6600176
1678631171,202936,true,1538303905,28,1530938106,-7365799
1678631195,202936,true,1538303905,28,1530938106,-7365799
1678631231,202935,true,1538457735,28,1530785028,-7672707
1678631267,202936,true,1538303905,28,1530785028,-7518877
1678631339,202936,true,1538303905,28,1530631965,-7671940
1678631375,202935,true,1538457735,28,1530631965,-7825770
1678631435,202934,true,1538611581,28,1530478917,-8132664
1678631507,202935,true,1538457735,28,1530478917,-7978818
1678631687,202935,true,1538457735,28,1530631965,-7825770
1678632047,202934,true,1538611581,28,1531550574,-7061007
1678632131,202934,true,1538611581,28,1531703729,-6907852
1678633403,202934,true,1538611581,28,1534616586,-3994995
1678634111,202934,true,1538611581,28,1534770048,-3841533
1678634843,202933,true,1538765442,28,1534770048,-3995394
1678635431,202933,true,1538765442,28,1534616586,-4148856
1678635683,202934,true,1538611581,28,1534616586,-3994995
1678635911,202933,true,1538765442,28,1534463140,-4302302
1678636031,202933,true,1538765442,28,1534463140,-4302302
1678636703,202934,true,1538611581,28,1533389445,-5222136
1678636775,202934,true,1538611581,28,1533389445,-5222136
1678636979,202934,true,1538611581,28,1533236122,-5375459
1678637375,202934,true,1538611581,28,1532929521,-5682060
1678637567,202934,true,1538611581,28,1532929521,-5682060
1678637735,202935,true,1538457735,28,1532929521,-5528214
1678638143,202935,true,1538457735,28,1533696139,-4761596
1678638539,202934,true,1538611581,28,1534463140,-4148441
1678638635,202935,true,1538457735,28,1534616586,-3841149
1678638899,202936,true,1538303905,28,1535077017,-3226888
1678638911,202935,true,1538457735,28,1535077017,-3380718
1678638923,202935,true,1538457735,28,1535077017,-3380718
1678639007,202936,true,1538303905,28,1535384048,-2919857
1678639103,202937,true,1538150090,28,1535537587,-2612503
1678639127,202937,true,1538150090,28,1535537587,-2612503
1678639271,202938,true,1537996290,28,1535844709,-2151581
1678639343,202939,true,1537842506,28,1535998294,-1844212
1678640075,202939,true,1537842506,28,1537842506,0
1678640099,202940,true,1537688737,28,1537842506,153769
1678640111,202940,true,1537688737,28,1537996290,307553
1678640159,202941,true,1537534984,28,1538150090,615106
1678640615,202941,true,1537534984,28,1539534979,1999995
1678641767,202941,true,1537534984,28,1541845898,4310914
1678641935,202942,true,1537381245,28,1542000083,4618838
1678641971,202943,true,1537227523,28,1542000083,4772560
1678641983,202943,true,1537227523,28,1542000083,4772560
1678641995,202943,true,1537227523,28,1542000083,4772560
1678642007,202943,true,1537227523,28,1542000083,4772560
1678642091,202940,true,1537688737,28,1543079807,5391070
1678642163,202939,true,1537842506,28,1544005886,6163380
1678642175,202939,true,1537842506,28,1544160287,6317781
1678642187,202939,true,1537842506,28,1544314703,6472197
1678642199,202936,true,1538303905,28,1544469134,6165229
1678642331,202934,true,1538611581,28,1546478149,7866568
1678642343,202934,true,1538611581,28,1546632797,8021216
1678642895,202933,true,1538765442,28,1555317802,16552360
1678642907,202930,true,1539227118,28,1555473334,16246216
1678642931,202928,true,1539534979,28,1555940022,16405043
1678642943,202928,true,1539534979,28,1556095616,16560637
1678643159,202926,true,1539842901,28,1559834544,19991643
1678643171,202923,true,1540304900,28,1560146526,19841626
1678643183,202921,true,1540612977,28,1560302541,19689564
1678643195,202921,true,1540612977,28,1560614617,20001640
1678643219,202919,true,1540921115,28,1561082848,20161733
1678643231,202915,true,1541537576,28,1561238957,19701381
1678643243,202913,true,1541845898,28,1561551220,19705322
1678643255,202912,true,1542000083,28,1561863546,19863463
1678643291,202909,true,1542462729,28,1562644634,20181905
1678644023,202906,true,1542925514,28,1576771204,33845690
1678644143,202903,true,1543388438,28,1577875275,34486837
1678644155,202903,true,1543388438,28,1578033062,34644624
1678644167,202900,true,1543851501,28,1578033062,34181561
1678644179,202895,true,1544623581,28,1578190865,33567284
1678644251,202893,true,1544932522,28,1578822236,33889714
1678644299,202892,true,1545087015,28,1579295930,34208915
1678645067,202889,true,1545550587,28,1586101183,40550596
1678645259,202884,true,1546323517,28,1586735719,40412202
1678645271,202882,true,1546632797,28,1586735719,40102922
1678645307,202881,true,1546787461,28,1587053082,40265621
1678645331,202877,true,1547406268,28,1587211787,39805519
1678645343,202872,true,1548180126,28,1587211787,39031661
1678645355,202869,true,1548644627,28,1587370509,38725882
1678645379,202867,true,1548954371,28,1587529246,38574875
1678645439,202863,true,1549574046,28,1588005552,38431506
1678645475,202858,true,1550348988,28,1588323169,37974181
1678645487,202855,true,1550814139,28,1588323169,37509030
1678645511,202853,true,1551124317,28,1588640850,37516533
1678645535,202849,true,1551744860,28,1588799714,37054854
1678645619,202843,true,1552676140,28,1589594272,36918132
1678645655,202840,true,1553141989,28,1590071198,36929209
1678645679,202838,true,1553452633,28,1590389229,36936596
1678645835,202833,true,1554229515,28,1592298746,38069231
1678645847,202827,true,1555162286,28,1592298746,37136460
1678646159,202823,true,1555784444,28,1595167321,39382877
1678646351,202821,true,1556095616,28,1596763206,40667590
1678646363,202816,true,1556873820,28,1596922883,40049063
1678646411,202810,true,1557808178,28,1597242283,39434105
1678646495,202807,true,1558275567,28,1598041064,39765497
1678646507,202805,true,1558587238,28,1598200868,39613630
1678646519,202800,true,1559366687,28,1598360688,38994001
1678646723,202793,true,1560458571,28,1600599848,40141277
1678646747,202790,true,1560926756,28,1600759908,39833152
1678647035,202788,true,1561238957,28,1603643727,42404770
1678647407,202783,true,1562019732,28,1605408617,43388885
1678647671,202777,true,1562957178,28,1605408617,42451439
1678647995,202773,true,1563582455,28,1606693393,43110938
1678648067,202771,true,1563895187,28,1607014748,43119561
1678648199,202766,true,1564677291,28,1607336167,42658876
1678648295,202760,true,1565616332,28,1607336167,41719835
1678648511,202756,true,1566242673,28,1607175450,40932777
1678648559,202754,true,1566555937,28,1607336167,40780230
1678648655,202749,true,1567339372,28,1607336167,39996795
1678648691,202742,true,1568436838,28,1607336167,38899329
1678648751,202738,true,1569064307,28,1607336167,38271860
1678648775,202736,true,1569378136,28,1607336167,37958031
1678648787,202732,true,1570005981,28,1607336167,37330186
1678648835,202725,true,1571105315,28,1607014748,35909433
1678648871,202723,true,1571419552,28,1606854063,35434511
1678648895,202721,true,1571733852,28,1606854063,35120211
1678648967,202716,true,1572519876,28,1606693393,34173517
1678649003,202710,true,1573463624,28,1606532740,33069116
1678649051,202707,true,1573935710,28,1606211482,32275772
1678649111,202706,true,1574093103,28,1605729715,31636612
1678649123,202702,true,1574722835,28,1605729715,31006880
1678649135,202696,true,1575667905,28,1605569158,29901253
1678649147,202694,true,1575983054,28,1605569158,29586104
1678649159,202693,true,1576140653,28,1605408617,29267964
1678649219,202689,true,1576771204,28,1604927091,28155887
1678649231,202683,true,1577717503,28,1604927091,27209588
1678649243,202681,true,1578033062,28,1604766614,26733552
1678649255,202680,true,1578190865,28,1604606153,26415288
1678649267,202676,true,1578822236,28,1604606153,25783917
1678649315,202670,true,1579769767,28,1604124868,24355101
1678649411,202667,true,1580243745,28,1603323046,23079301
1678649459,202667,true,1580243745,28,1602842145,22598400
1678649471,202663,true,1580875937,28,1602681877,21805940
1678649507,202657,true,1581824700,28,1602201169,20376469
1678649555,202655,true,1582141081,28,1601560448,19419367
1678649591,202656,true,1581982882,28,1600919984,18937102
1678649675,202653,true,1582457525,28,1599479876,17022351
1678649687,202647,true,1583407237,28,1599319944,15912707
1678649699,202645,true,1583723934,28,1599000128,15276194
1678649711,202646,true,1583565577,28,1598840244,15274667
1678649975,202642,true,1584199099,28,1595326838,11127739
1678650383,202636,true,1585149856,28,1590548267,5398411
1678650503,202634,true,1585466902,28,1589276401,3809499
1678651019,202634,true,1585466902,28,1586418420,951518
1678651343,202630,true,1586101183,28,1586101183,0
1678652627,202624,true,1587053082,28,1587687999,634917
1678652663,202623,true,1587211787,28,1587687999,476212
1678652711,202623,true,1587211787,28,1587846767,634980
1678653035,202619,true,1587846767,28,1588958594,1111827
1678653059,202612,true,1588958594,28,1589117490,158896
1678653095,202611,true,1589117490,28,1589276401,158911
1678653167,202611,true,1589117490,28,1589594272,476782
1678653179,202606,true,1589912207,28,1589753232,-158975
1678653203,202599,true,1591025480,28,1589912207,-1113273
1678653215,202598,true,1591184582,28,1589912207,-1272375
1678653227,202598,true,1591184582,28,1590071198,-1113384
1678653311,202593,true,1591980334,28,1590866393,-1113941
1678653323,202589,true,1592617221,28,1591025480,-1591741
1678653503,202589,true,1592617221,28,1592935761,318540
1678653887,202588,true,1592776483,28,1596922883,4146400
1678654211,202583,true,1593573031,28,1600279776,6706745
1678654403,202580,true,1594051150,28,1602201169,8150019
1678654763,202580,true,1594051150,28,1604285280,10234130
1678654775,202580,true,1594051150,28,1604445709,10394559
1678654979,202576,true,1594688866,28,1605408617,10719751
1678655903,202573,true,1595167321,28,1603483378,8316057
1678655999,202573,true,1595167321,28,1603162730,7995409
1678656035,202573,true,1595167321,28,1603162730,7995409
1678656467,202569,true,1595805484,28,1602361389,6555905
1678656767,202566,true,1596284273,28,1601560448,5276175
1678656791,202567,true,1596124661,28,1601400308,5275647
1678656839,202567,true,1596124661,28,1601240184,5115523
1678658231,202564,true,1596603546,28,1598041064,1437518
1678658303,202562,true,1596922883,28,1598041064,1118181
1678658315,202563,true,1596763206,28,1598041064,1277858
1678658519,202563,true,1596763206,28,1598041064,1277858
1678658735,202560,true,1597242283,28,1598200868,958585
1678659179,202559,true,1597402007,28,1598200868,798861
1678659323,202559,true,1597402007,28,1598200868,798861
1678659335,202559,true,1597402007,28,1598200868,798861
1678659383,202557,true,1597721504,28,1598200868,479364
1678659419,202555,true,1598041064,28,1598360688,319624
1678659443,202556,true,1597881276,28,1598360688,479412
1678659455,202556,true,1597881276,28,1598520524,639248
1678659467,202554,true,1598200868,28,1598520524,319656
1678659479,202552,true,1598520524,28,1598520524,0
1678659503,202552,true,1598520524,28,1598680376,159852
1678659563,202550,true,1598840244,28,1599479876,639632
1678659743,202547,true,1599319944,28,1601880776,2560832
1678659851,202546,true,1599479876,28,1603323046,3843170
1678659887,202546,true,1599479876,28,1603804091,4324215
1678659971,202544,true,1599799788,28,1605248092,5448304
1678660031,202541,true,1600279776,28,1606211482,5931706
1678660103,202539,true,1600599848,28,1607336167,6736319
1678660187,202540,true,1600439804,28,1608461640,8021836
1678660211,202539,true,1600599848,28,1608783348,8183500
1678660235,202536,true,1601080076,28,1608944227,7864151
1678660271,202535,true,1601240184,28,1609266032,8025848
1678660319,202536,true,1601080076,28,1609748860,8668784
1678660727,202536,true,1601080076,28,1612971418,11891342
1678660847,202534,true,1601400308,28,1613939443,12539135
1678661003,202533,true,1601560448,28,1615231046,13670598
1678661111,202535,true,1601240184,28,1616038823,14798639
1678661123,202534,true,1601400308,28,1616038823,14638515
1678661135,202532,true,1601720604,28,1616038823,14318219
1678661207,202533,true,1601560448,28,1616038823,14478375
1678661231,202535,true,1601240184,28,1616038823,14798639
1678661279,202535,true,1601240184,28,1615877236,14637052
1678661435,202533,true,1601560448,28,1614262247,12701799
1678661519,202534,true,1601400308,28,1613132715,11732407
1678661567,202537,true,1600919984,28,1612487623,11567639
1678661639,202537,true,1600919984,28,1611359333,10439349
1678662899,202536,true,1601080076,28,1595486370,-5593706
1678663199,202537,true,1600919984,28,1594369976,-6550008
1678663391,202540,true,1600439804,28,1594051150,-6388654
1678663403,202540,true,1600439804,28,1594051150,-6388654
1678663835,202539,true,1600599848,28,1594529413,-6070435
1678663859,202540,true,1600439804,28,1594688866,-5750938
1678663991,202543,true,1599959768,28,1594848335,-5111433
1678664027,202543,true,1599959768,28,1594688866,-5270902
1678664039,202542,true,1600119764,28,1594688866,-5430898
1678664051,202543,true,1599959768,28,1594529413,-5430355
1678664063,202547,true,1599319944,28,1594529413,-4790531
1678664075,202547,true,1599319944,28,1594529413,-4790531
1678664099,202546,true,1599479876,28,1594529413,-4950463
1678664135,202546,true,1599479876,28,1594369976,-5109900
1678664147,202549,true,1599000128,28,1594369976,-4630152
1678664183,202549,true,1599000128,28,1594210555,-4789573
1678664219,202548,true,1599160028,28,1594210555,-4949473
1678664231,202548,true,1599160028,28,1594210555,-4949473
1678664519,202551,true,1598680376,28,1593573031,-5107345
1678664735,202550,true,1598840244,28,1593254364,-5585880
1678664747,202549,true,1599000128,28,1593095054,-5905074
1678664759,202549,true,1599000128,28,1593095054,-5905074
1678664771,202552,true,1598520524,28,1593095054,-5425470
1678664783,202549,true,1599000128,28,1593254364,-5745764
1678664807,202547,true,1599319944,28,1593413689,-5906255
1678664843,202547,true,1599319944,28,1593573031,-5746913
1678664915,202549,true,1599000128,28,1593732388,-5267740
1678665035,202548,true,1599160028,28,1593732388,-5427640
1678665083,202545,true,1599639824,28,1593732388,-5907436
1678665131,202545,true,1599639824,28,1593891761,-5748063
1678665155,202548,true,1599160028,28,1593891761,-5268267
1678665479,202546,true,1599479876,28,1594529413,-4950463
1678665503,202543,true,1599959768,28,1594529413,-5430355
1678665827,202542,true,1600119764,28,1596124661,-3995103
1678665947,202545,true,1599639824,28,1597082575,-2557249
1678665983,202542,true,1600119764,28,1597402007,-2717757
1678666115,202538,true,1600759908,28,1598360688,-2399220
1678666811,202537,true,1600919984,28,1601720604,800620
1678666847,202539,true,1600599848,28,1601880776,1280928
1678666859,202536,true,1601080076,28,1602040964,960888
1678666907,202534,true,1601400308,28,1602361389,961081
1678666919,202533,true,1601560448,28,1602361389,800941
1678666943,202534,true,1601400308,28,1602521625,1121317
1678667135,202531,true,1601880776,28,1603804091,1923315
1678667339,202529,true,1602201169,28,1604445709,2244540
1678667351,202528,true,1602361389,28,1604445709,2084320
1678667387,202530,true,1602040964,28,1604606153,2565189
1678667423,202527,true,1602521625,28,1604606153,2084528
1678667471,202525,true,1602842145,28,1604766614,1924469
1678667483,202525,true,1602842145,28,1604766614,1924469
1678668083,202526,true,1602681877,28,1607014748,4332871
1678668095,202523,true,1603162730,28,1607014748,3852018
1678668107,202522,true,1603323046,28,1607175450,3852404
1678668119,202522,true,1603323046,28,1607175450,3852404
1678668131,202522,true,1603323046,28,1607336167,4013121
1678668143,202519,true,1603804091,28,1607496901,3692810
1678668287,202517,true,1604124868,28,1609909835,5784967
1678668299,202516,true,1604285280,28,1610070826,5785546
1678668311,202517,true,1604124868,28,1610231833,6106965
1678668347,202513,true,1604766614,28,1610876022,6109408
1678668383,202511,true,1605087583,28,1611520469,6432886
1678668479,202510,true,1605248092,28,1613294028,8045936
1678668803,202510,true,1605248092,28,1618464579,13216487
1678668851,202507,true,1605729715,28,1619112062,13382347
1678669187,202504,true,1606211482,28,1623651701,17440219
1678669319,202503,true,1606372103,28,1625438612,19066509
1678669355,202504,true,1606211482,28,1625763716,19552234
1678669391,202500,true,1606854063,28,1626251493,19397430
1678669403,202497,true,1607336167,28,1626414119,19077952
1678669487,202496,true,1607496901,28,1627390211,19893310
1678669787,202497,true,1607336167,28,1630485037,23148870
1678669967,202494,true,1607818416,28,1631626719,23808303
1678670099,202491,true,1608300810,28,1631463573,23162763
1678670315,202490,true,1608461640,28,1630485037,22023397
1678671419,202491,true,1608300810,28,1627390211,19089401
1678671455,202488,true,1608783348,28,1627227488,18444140
1678671563,202485,true,1609266032,28,1627064782,17798750
1678671611,202483,true,1609587901,28,1626902092,17314191
1678672091,202486,true,1609105121,28,1625113573,16008452
1678673915,202483,true,1609587901,28,1620569846,10981945
1678674239,202479,true,1610231833,28,1620569846,10338013
1678674251,202479,true,1610231833,28,1620569846,10338013
1678674263,202481,true,1609909835,28,1620569846,10660011
1678674275,202478,true,1610392856,28,1620569846,10176990
1678674311,202477,true,1610553895,28,1620407805,9853910
1678674347,202476,true,1610714951,28,1620245781,9530830
1678674587,202480,true,1610070826,28,1619597844,9527018
1678674731,202478,true,1610392856,28,1619112062,8719206
1678675307,202478,true,1610392856,28,1616685336,6292480
1678675403,202478,true,1610392856,28,1616200427,5807571
1678675415,202482,true,1609748860,28,1616200427,6451567
1678675427,202481,true,1609909835,28,1616038823,6128988
1678675451,202481,true,1609909835,28,1616038823,6128988
1678675559,202481,true,1609909835,28,1615392569,5482734
1678675655,202485,true,1609266032,28,1614585115,5319083
1678675871,202485,true,1609266032,28,1612971418,3705386
1678677383,202485,true,1609266032,28,1606693393,-2572639
1678677407,202485,true,1609266032,28,1606693393,-2572639
1678677539,202488,true,1608783348,28,1606532740,-2250608
1678677587,202486,true,1609105121,28,1606532740,-2572381
1678677707,202486,true,1609105121,28,1606372103,-2733018
1678677719,202486,true,1609105121,28,1606372103,-2733018
1678677887,202489,true,1608622486,28,1606050877,-2571609
1678679375,202488,true,1608783348,28,1603643727,-5139621
1678680743,202488,true,1608783348,28,1604124868,-4658480
1678680839,202487,true,1608944227,28,1604285280,-4658947
1678680863,202489,true,1608622486,28,1604285280,-4337206
1678680875,202487,true,1608944227,28,1604285280,-4658947
1678680911,202487,true,1608944227,28,1604285280,-4658947
1678680923,202485,true,1609266032,28,1604285280,-4980752
1678681019,202486,true,1609105121,28,1604606153,-4498968
1678681067,202484,true,1609426958,28,1604927091,-4499867
1678681091,202483,true,1609587901,28,1604927091,-4660810
1678681103,202482,true,1609748860,28,1605087583,-4661277
1678681319,202482,true,1609748860,28,1606050877,-3697983
1678681859,202479,true,1610231833,28,1610392856,161023
1678682015,202478,true,1610392856,28,1611681621,1288765
1678682339,202477,true,1610553895,28,1614100837,3546942
1678682351,202477,true,1610553895,28,1614262247,3708352
1678682375,202474,true,1611037110,28,1614423673,3386563
1678682507,202473,true,1611198213,28,1615715664,4517451
1678682519,202471,true,1611520469,28,1615715664,4195195
1678682615,202470,true,1611681621,28,1616685336,5003715
1678683299,202468,true,1612003974,28,1619435901,7431927
1678683323,202466,true,1612326391,28,1619435901,7109510
1678683383,202464,true,1612648872,28,1619112062,6463190
1678683407,202464,true,1612648872,28,1618950167,6301295
1678683563,202463,true,1612810137,28,1618140935,5330798
1678683779,202461,true,1613132715,28,1617170390,4037675
1678683923,202459,true,1613455358,28,1616685336,3229978
1678684211,202459,true,1613455358,28,1615715664,2260306
1678684295,202458,true,1613616703,28,1615392569,1775866
1678684307,202456,true,1613939443,28,1615231046,1291603
1678684331,202454,true,1614262247,28,1615231046,968799
1678684499,202454,true,1614262247,28,1614585115,322868
1678684523,202454,true,1614262247,28,1614585115,322868
1678684595,202453,true,1614423673,28,1614262247,-161426
1678684919,202452,true,1614585115,28,1613294028,-1291087
1678684967,202451,true,1614746574,28,1613132715,-1613859
1678685075,202451,true,1614746574,28,1612810137,-1936437
1678686455,202449,true,1615069539,28,1616200427,1130888
1678687547,202447,true,1615392569,28,1618302749,2910180
1678687667,202446,true,1615554109,28,1618950167,3396058
1678687691,202446,true,1615554109,28,1618950167,3396058
1678687703,202444,true,1615877236,28,1618950167,3072931
1678687895,202442,true,1616200427,28,1619597844,3397417
1678687955,202442,true,1616200427,28,1619759804,3559377
1678688927,202442,true,1616200427,28,1621218171,5017744
1678691627,202441,true,1616362047,28,1620245781,3883734
1678692215,202438,true,1616847004,28,1620245781,3398777
1678692239,202438,true,1616847004,28,1620407805,3560801
1678692551,202438,true,1616847004,28,1622028942,5181938
1678693091,202436,true,1617170390,28,1624951078,7780688
1678693691,202433,true,1617655590,28,1628204069,10548479
1678694111,202433,true,1617655590,28,1629995989,12340399
1678694855,202434,true,1617493840,28,1629995989,12502149
1678694867,202431,true,1617979137,28,1629995989,12016852
1678694915,202429,true,1618302749,28,1629995989,11693240
1678694987,202429,true,1618302749,28,1629833006,11530257
1678695095,202429,true,1618302749,28,1629507088,11204339
1678695203,202427,true,1618626426,28,1629181236,10554810
1678695731,202425,true,1618950167,28,1627227488,8277321
1678696259,202426,true,1618788288,28,1625113573,6325285
1678696283,202426,true,1618788288,28,1624951078,6162790
1678696331,202424,true,1619112062,28,1624788599,5676537
1678696343,202422,true,1619435901,28,1624788599,5352698
1678696379,202424,true,1619112062,28,1624626136,5514074
1678696403,202426,true,1618788288,28,1624463690,5675402
1678696439,202426,true,1618788288,28,1624301260,5512972
1678696703,202425,true,1618950167,28,1622840119,3889952
1678696775,202427,true,1618626426,28,1622677851,4051425
1678696787,202429,true,1618302749,28,1622515600,4212851
1678696931,202429,true,1618302749,28,1622028942,3726193
1678697123,202428,true,1618464579,28,1621542431,3077852
1678697135,202430,true,1618140935,28,1621380293,3239358
1678697243,202432,true,1617817355,28,1621056066,3238711
1678697375,202433,true,1617655590,28,1620569846,2914256
1678697471,202432,true,1617817355,28,1620245781,2428426
1678697531,202434,true,1617493840,28,1619921780,2427940
1678698047,202437,true,1617008689,28,1616523683,-485006
1678698107,202437,true,1617008689,28,1616200427,-808262
1678698131,202436,true,1617170390,28,1616038823,-1131567
1678698263,202438,true,1616847004,28,1615231046,-1615958
1678698383,202441,true,1616362047,28,1614585115,-1776932
1678698491,202441,true,1616362047,28,1613778065,-2583982
1678699307,202440,true,1616523683,28,1610392856,-6130827
1678699715,202442,true,1616200427,28,1609909835,-6290592
1678699775,202445,true,1615715664,28,1609909835,-5805829
1678699787,202445,true,1615715664,28,1609909835,-5805829
1678699799,202444,true,1615877236,28,1609909835,-5967401
1678699871,202445,true,1615715664,28,1609748860,-5966804
1678699883,202448,true,1615231046,28,1609587901,-5643145
1678699907,202448,true,1615231046,28,1609426958,-5804088
1678700159,202448,true,1615231046,28,1608300810,-6930236
1678700171,202449,true,1615069539,28,1608139996,-6929543
1678700243,202452,true,1614585115,28,1607818416,-6766699
1678700291,202452,true,1614585115,28,1607496901,-7088214
1678700327,202452,true,1614585115,28,1607175450,-7409665
1678700351,202453,true,1614423673,28,1607014748,-7408925
1678700795,202457,true,1613778065,28,1602361389,-11416676
1678701359,202457,true,1613778065,28,1596922883,-16855182
1678701371,202457,true,1613778065,28,1596922883,-16855182
1678701407,202458,true,1613616703,28,1596763206,-16853497
1678701431,202462,true,1612971418,28,1596603546,-16367872
1678701443,202459,true,1613455358,28,1596443901,-17011457
1678701455,202459,true,1613455358,28,1596443901,-17011457
1678702631,202460,true,1613294028,28,1596284273,-17009755
1678702727,202464,true,1612648872,28,1596603546,-16045326
1678702739,202461,true,1613132715,28,1596603546,-16529169
1678703039,202461,true,1613132715,28,1597242283,-15890432
1678703075,202462,true,1612971418,28,1597242283,-15729135
1678703291,202466,true,1612326391,28,1597242283,-15084108
1678703507,202463,true,1612810137,28,1597082575,-15727562
1678703579,202463,true,1612810137,28,1597082575,-15727562
1678703831,202464,true,1612648872,28,1597402007,-15246865
1678703951,202467,true,1612165174,28,1597402007,-14763167
1678703987,202464,true,1612648872,28,1597561748,-15087124
1678704923,202464,true,1612648872,28,1599639824,-13009048
1678705079,202465,true,1612487623,28,1600119764,-12367859
1678705091,202468,true,1612003974,28,1600119764,-11884210
1678705103,202465,true,1612487623,28,1600119764,-12367859
1678705115,202465,true,1612487623,28,1600119764,-12367859
1678705199,202466,true,1612326391,28,1600439804,-11886587
1678705259,202470,true,1611681621,28,1600599848,-11081773
1678705295,202467,true,1612165174,28,1600759908,-11405266
1678706519,202467,true,1612165174,28,1602842145,-9323029
1678706819,202468,true,1612003974,28,1603162730,-8841244
1678706855,202473,true,1611198213,28,1603323046,-7875167
1678706975,202470,true,1611681621,28,1603323046,-8358575
1678707311,202470,true,1611681621,28,1603323046,-8358575
1678707479,202471,true,1611520469,28,1603323046,-8197423
1678707839,202476,true,1610714951,28,1603323046,-7391905
1678708115,202474,true,1611037110,28,1602201169,-8835941
1678708163,202474,true,1611037110,28,1601880776,-9156334
1678708187,202476,true,1610714951,28,1601880776,-8834175
1678708223,202481,true,1609909835,28,1601720604,-8189231
1678708247,202479,true,1610231833,28,1601720604,-8511229
1678708631,202479,true,1610231833,28,1600759908,-9471925
1678708667,202481,true,1609909835,28,1600599848,-9309987
1678708727,202484,true,1609426958,28,1600439804,-8987154
1678709123,202481,true,1609909835,28,1599639824,-10270011
1678709567,202481,true,1609909835,28,1598840244,-11069591
1678709591,202483,true,1609587901,28,1598840244,-10747657
1678710119,202487,true,1608944227,28,1599319944,-9624283
1678710479,202484,true,1609426958,28,1599479876,-9947082
1678711103,202484,true,1609426958,28,1599479876,-9947082
1678711511,202486,true,1609105121,28,1599479876,-9625245
1678711523,202490,true,1608461640,28,1599479876,-8981764
1678711703,202487,true,1608944227,28,1599479876,-9464351
1678711739,202488,true,1608783348,28,1599479876,-9303472
1678711751,202490,true,1608461640,28,1599479876,-8981764
1678711763,202493,true,1607979198,28,1599479876,-8499322
1678711775,202491,true,1608300810,28,1599319944,-8980866
1678711799,202492,true,1608139996,28,1599319944,-8820052
1678712027,202495,true,1607657650,28,1598840244,-8817406
1678712483,202498,true,1607175450,28,1597561748,-9613702
1678712507,202497,true,1607336167,28,1597561748,-9774419
1678712543,202498,true,1607175450,28,1597402007,-9773443
1678712555,202501,true,1606693393,28,1597402007,-9291386
1678712579,202504,true,1606211482,28,1597402007,-8809475
1678712591,202502,true,1606532740,28,1597402007,-9130733
1678712603,202503,true,1606372103,28,1597402007,-8970096
1678712615,202505,true,1606050877,28,1597402007,-8648870
1678712639,202508,true,1605569158,28,1597561748,-8007410
1678712663,202507,true,1605729715,28,1597561748,-8167967
1678713059,202509,true,1605408617,28,1598680376,-6728241
1678713479,202511,true,1605087583,28,1599959768,-5127815
1678713491,202514,true,1604606153,28,1599959768,-4646385
1678713527,202513,true,1604766614,28,1600119764,-4646850
1678713539,202514,true,1604606153,28,1600119764,-4486389
1678713695,202515,true,1604445709,28,1601400308,-3045401
1678714139,202518,true,1603964471,28,1605248092,1283621
1678714235,202516,true,1604285280,28,1606050877,1765597
1678714379,202517,true,1604124868,28,1607175450,3050582
1678714391,202518,true,1603964471,28,1607175450,3210979
1678714403,202521,true,1603483378,28,1607175450,3692072
1678714523,202520,true,1603643727,28,1607336167,3692440
1678714559,202521,true,1603483378,28,1607336167,3852789
1678714631,202522,true,1603323046,28,1607336167,4013121
1678714643,202524,true,1603002429,28,1607336167,4333738
1678714655,202524,true,1603002429,28,1607175450,4173021
1678714715,202525,true,1602842145,28,1607175450,4333305
1678714787,202526,true,1602681877,28,1607014748,4332871
1678715171,202529,true,1602201169,28,1606050877,3849708
1678715291,202528,true,1602361389,28,1606050877,3689488
1678715327,202529,true,1602201169,28,1605890288,3689119
1678715363,202530,true,1602040964,28,1605729715,3688751
1678715375,202532,true,1601720604,28,1605729715,4009111
1678715399,202531,true,1601880776,28,1605729715,3848939
1678715435,202531,true,1601880776,28,1605569158,3688382
1678715447,202532,true,1601720604,28,1605569158,3848554
1678715471,202533,true,1601560448,28,1605569158,4008710
1678715555,202531,true,1601880776,28,1605729715,3848939
1678715591,202531,true,1601880776,28,1605729715,3848939
1678715627,202532,true,1601720604,28,1605890288,4169684
1678715639,202533,true,1601560448,28,1605890288,4329840
1678715651,202530,true,1602040964,28,1605890288,3849324
1678715735,202531,true,1601880776,28,1606050877,4170101
1678715807,202531,true,1601880776,28,1606050877,4170101
1678716119,202532,true,1601720604,28,1606211482,4490878
1678716515,202530,true,1602040964,28,1607657650,5616686
1678716527,202530,true,1602040964,28,1607657650,5616686
1678716539,202531,true,1601880776,28,1607818416,5937640
1678716551,202531,true,1601880776,28,1607979198,6098422
1678716563,202527,true,1602521625,28,1608139996,5618371
1678717187,202525,true,1602842145,28,1617008689,14166544
1678717307,202525,true,1602842145,28,1618464579,15622434
1678717319,202525,true,1602842145,28,1618626426,15784281
1678717343,202521,true,1603483378,28,1618950167,15466789
1678717403,202517,true,1604124868,28,1619921780,15796912
1678717451,202515,true,1604445709,28,1620569846,16124137
1678717487,202514,true,1604606153,28,1621218171,16612018
1678717499,202510,true,1605248092,28,1621380293,16132201
1678717511,202506,true,1605890288,28,1621704585,15814297
1678717523,202504,true,1606211482,28,1621866756,15655274
1678717895,202502,true,1606532740,28,1629833006,23300266
1678718207,202499,true,1607014748,28,1636365067,29350319
1678718351,202495,true,1607657650,28,1639149114,31491464
1678718783,202493,true,1607979198,28,1644238106,36258908
1678718795,202491,true,1608300810,28,1644402529,36101719
1678718807,202488,true,1608783348,28,1644566970,35783622
1678718819,202484,true,1609426958,28,1644731426,35304468
1678718879,202480,true,1610070826,28,1645553957,35483131
1678719035,202478,true,1610392856,28,1647859230,37466374
1678719155,202475,true,1610876022,28,1649342897,38466875
1678719239,202471,true,1611520469,28,1649837749,38317280
1678719275,202468,true,1612003974,28,1650002733,37998759
1678719527,202466,true,1612326391,28,1650497783,38171392
1678719683,202464,true,1612648872,28,1650662833,38013961
1678719695,202460,true,1613294028,28,1650827899,37533871
1678719719,202456,true,1613939443,28,1650827899,36888456
1678719779,202454,true,1614262247,28,1651488330,37226083
1678719959,202449,true,1615069539,28,1653471206,38401667
1678720007,202445,true,1615715664,28,1653967297,38251633
1678720031,202442,true,1616200427,28,1654298107,38097680
1678720079,202439,true,1616685336,28,1654959925,38274589
1678720091,202435,true,1617332107,28,1655125421,37793314
1678720115,202430,true,1618140935,28,1655456463,37315528
1678720139,202426,true,1618788288,28,1655953150,37164862
1678720151,202422,true,1619435901,28,1656284357,36848456
1678720271,202416,true,1620407805,28,1659102294,38694489
1678720283,202411,true,1621218171,28,1659268204,38050033
1678720751,202408,true,1621704585,28,1669253239,47548654
1678720763,202404,true,1622353364,28,1669420165,47066801
1678720775,202397,true,1623489353,28,1669754065,46264712
1678720859,202392,true,1624301260,28,1671424571,47123311
1678720883,202388,true,1624951078,28,1671926048,46974970
1678720907,202383,true,1625763716,28,1672427676,46663960
1678721003,202376,true,1626902092,28,1674770598,47868506
1678721075,202371,true,1627715705,28,1676446122,48730417
1678721207,202367,true,1628366889,28,1679634238,51267349
1678721291,202362,true,1629181236,28,1681482760,52301524
1678721399,202356,true,1630158989,28,1684006750,53847761
1678721507,202351,true,1630974231,28,1686534529,55560298
1678721519,202346,true,1631789882,28,1686703183,54913301
1678721579,202341,true,1632605940,28,1687884229,55278289
1678721603,202334,true,1633749107,28,1688221823,54472716
1678721699,202330,true,1634402704,28,1689572873,55170169
1678721783,202325,true,1635220069,28,1690755929,55535860
1678721879,202321,true,1635874255,28,1691939813,56065558
1678721903,202314,true,1637019711,28,1691939813,54920102
1678721927,202310,true,1637674617,28,1692109007,54434390
1678722047,202307,true,1638165969,28,1691432333,53266364
1678722083,202303,true,1638821333,28,1691263207,52441874
1678722263,202296,true,1639968852,28,1690925005,50956153
1678722563,202292,true,1640624938,28,1689403933,48778995
1678722599,202288,true,1641281287,28,1689066103,47784816
1678722659,202284,true,1641937898,28,1688559484,46621586
1678722815,202278,true,1642923307,28,1686871853,43948546
1678722911,202274,true,1643580575,28,1686028670,42448095
1678723067,202270,true,1644238106,28,1684343569,40105463
1678723163,202267,true,1644731426,28,1683501649,38770223
1678723175,202261,true,1645718512,28,1683333316,37614804
1678723283,202257,true,1646376898,28,1682155454,35778556
1678723523,202254,true,1646870861,28,1679466291,32595430
1678723643,202250,true,1647529708,28,1678458964,30929256
1678723655,202245,true,1648353637,28,1678291135,29937498
1678723679,202241,true,1649013078,28,1678123323,29110245
1678723775,202238,true,1649507831,28,1677955527,28447696
1678723823,202234,true,1650167733,28,1677955527,27787794
1678723859,202228,true,1651158081,28,1677955527,26797446
1678724291,202225,true,1651653478,28,1677619987,25966509
1678724447,202222,true,1652149024,28,1677787749,25638725
1678724459,202219,true,1652644718,28,1677787749,25143031
1678724471,202213,true,1653636553,28,1677787749,24151196
1678724543,202210,true,1654132694,28,1678123323,23990629
1678724603,202207,true,1654628983,28,1678291135,23662152
1678724615,202203,true,1655290934,28,1678458964,23168030
1678724687,202196,true,1656449985,28,1678794673,22344688
1678724747,202192,true,1657112665,28,1678962552,21849887
1678724783,202189,true,1657609848,28,1679130449,21520601
1678724795,202186,true,1658107181,28,1679130449,21023268
1678724831,202179,true,1659268204,28,1679298362,20030158
1678724987,202175,true,1659932011,28,1679634238,19702227
1678724999,202172,true,1660430040,28,1679634238,19204198
1678725071,202169,true,1660928219,28,1679802202,18873983
1678725083,202162,true,1662091218,28,1679802202,17710984
1678725095,202159,true,1662589895,28,1679802202,17212307
1678725107,202155,true,1663255031,28,1679802202,16547171
1678725131,202153,true,1663587698,28,1679802202,16214504
1678725167,202147,true,1664586101,28,1679634238,15048137
1678725179,202144,true,1665085526,28,1679634238,14548712
1678725191,202141,true,1665585102,28,1679634238,14049136
1678725203,202138,true,1666084827,28,1679634238,13549411
1678725215,202134,true,1666751361,28,1679634238,12882877
1678725227,202131,true,1667251437,28,1679466291,12214854
1678725239,202129,true,1667584904,28,1679466291,11881387
1678725251,202127,true,1667918437,28,1679466291,11547854
1678725263,202122,true,1668752563,28,1679298362,10545799
1678725287,202120,true,1669086331,28,1679130449,10044118
1678725755,202117,true,1669587107,28,1675105569,5518462
1678725779,202115,true,1669921041,28,1674938075,5017034
1678725827,202111,true,1670589109,28,1674603137,4014028
1678725875,202108,true,1671090336,28,1674268267,3177931
1678725899,202105,true,1671591713,28,1674100857,2509144
1678727183,202103,true,1671926048,28,1668252038,-3674010
1678727195,202100,true,1672427676,28,1668252038,-4175638
1678727207,202099,true,1672594919,28,1668418863,-4176056
1678727219,202096,true,1673096748,28,1668418863,-4677885
1678727375,202094,true,1673431384,28,1668585705,-4845679
1678727687,202092,true,1673766087,28,1668585705,-5180382
1678728503,202092,true,1673766087,28,1666084827,-7681260
1678728623,202091,true,1673933464,28,1665751660,-8181804
1678728659,202089,true,1674268267,28,1665585102,-8683165
1678728695,202087,true,1674603137,28,1665585102,-9018035
1678728899,202087,true,1674603137,28,1665252035,-9351102
1678728923,202086,true,1674770598,28,1665252035,-9518563
1678728935,202086,true,1674770598,28,1665252035,-9518563
1678728959,202083,true,1675273079,28,1665252035,-10021044
1678729115,202083,true,1675273079,28,1665585102,-9687977
1678729127,202081,true,1675608150,28,1665751660,-9856490
1678729139,202081,true,1675608150,28,1665751660,-9856490
1678729151,202078,true,1676110883,28,1665751660,-10359223
1678729175,202078,true,1676110883,28,1665918236,-10192647
1678729187,202077,true,1676278494,28,1665918236,-10360258
1678729523,202076,true,1676446122,28,1668085229,-8360893
1678729739,202074,true,1676781428,28,1669420165,-7361263
1678730519,202073,true,1676949106,28,1674268267,-2680839
1678730831,202072,true,1677116801,28,1675775711,-1341090
1678730867,202071,true,1677284513,28,1675943289,-1341224
1678730879,202069,true,1677619987,28,1675943289,-1676698
1678731251,202068,true,1677787749,28,1675608150,-2179599
1678731275,202068,true,1677787749,28,1675608150,-2179599
1678731419,202068,true,1677787749,28,1675440606,-2347143
1678731983,202067,true,1677955527,28,1675273079,-2682448
1678732151,202067,true,1677955527,28,1675273079,-2682448
1678732163,202066,true,1678123323,28,1675273079,-2850244
1678733039,202066,true,1678123323,28,1675943289,-2180034
1678733099,202065,true,1678291135,28,1676110883,-2180252
1678733423,202066,true,1678123323,28,1676446122,-1677201
1678733867,202066,true,1678123323,28,1677116801,-1006522
1678733879,202067,true,1677955527,28,1677116801,-838726
1678734011,202068,true,1677787749,28,1677284513,-503236
1678734035,202068,true,1677787749,28,1677452241,-335508
1678734095,202068,true,1677787749,28,1677619987,-167762
1678734191,202068,true,1677787749,28,1677955527,167778
1678734203,202069,true,1677619987,28,1677955527,335540
1678734359,202069,true,1677619987,28,1678626810,1006823
1678734527,202069,true,1677619987,28,1679634238,2014251
1678734659,202070,true,1677452241,28,1680306193,2853952
1678734743,202071,true,1677284513,28,1680810335,3525822
1678735355,202071,true,1677284513,28,1683838366,6553853
1678735415,202071,true,1677284513,28,1684175151,6890638
1678735727,202072,true,1677116801,28,1685017407,7900606
1678735739,202072,true,1677116801,28,1685017407,7900606
1678735787,202073,true,1676949106,28,1685185909,8236803
1678736555,202074,true,1676781428,28,1683838366,7056938
1678736711,202075,true,1676613767,28,1683838366,7224599
1678736771,202075,true,1676613767,28,1683838366,7224599
1678736879,202076,true,1676446122,28,1683838366,7392244
1678737203,202076,true,1676446122,28,1683838366,7392244
1678737491,202076,true,1676446122,28,1684343569,7897447
1678737503,202077,true,1676278494,28,1684343569,8065075
1678737515,202077,true,1676278494,28,1684343569,8065075
1678737923,202076,true,1676446122,28,1684512003,8065881
1678738451,202076,true,1676446122,28,1684680454,8234332
1678738463,202077,true,1676278494,28,1684680454,8401960
1678738475,202076,true,1676446122,28,1684680454,8234332
1678739015,202076,true,1676446122,28,1682491902,6045780
1678739051,202076,true,1676446122,28,1682323669,5877547
1678739063,202076,true,1676446122,28,1682323669,5877547
1678739435,202076,true,1676446122,28,1680306193,3860071
1678739447,202076,true,1676446122,28,1680306193,3860071
1678739459,202076,true,1676446122,28,1680306193,3860071
1678739507,202076,true,1676446122,28,1679970182,3524060
1678739891,202077,true,1676278494,28,1677955527,1677033
1678741607,202077,true,1676278494,28,1672093241,-4185253
1678741727,202077,true,1676278494,28,1672093241,-4185253
1678741751,202077,true,1676278494,28,1672093241,-4185253
1678741763,202078,true,1676110883,28,1672093241,-4017642
1678741787,202078,true,1676110883,28,1672093241,-4017642
1678742303,202077,true,1676278494,28,1673431384,-2847110
1678742963,202078,true,1676110883,28,1675105569,-1005314
1678743227,202078,true,1676110883,28,1675943289,-167594
1678744427,202078,true,1676110883,28,1676278494,167611
1678744991,202078,true,1676110883,28,1676110883,0
1678745123,202079,true,1675943289,28,1676110883,167594
1678745555,202079,true,1675943289,28,1676278494,335205
1678745603,202080,true,1675775711,28,1676446122,670411
1678745639,202079,true,1675943289,28,1676446122,502833
1678745723,202080,true,1675775711,28,1676781428,1005717
1678745795,202080,true,1675775711,28,1676949106,1173395
1678746635,202080,true,1675775711,28,1680306193,4530482
1678746719,202080,true,1675775711,28,1680642271,4866560
1678748279,202080,true,1675775711,28,1683501649,7725938
1678748363,202079,true,1675943289,28,1683501649,7558360
1678748543,202079,true,1675943289,28,1683669999,7726710
1678749179,202079,true,1675943289,28,1683838366,7895077
1678749287,202079,true,1675943289,28,1684006750,8063461
1678749563,202078,true,1676110883,28,1684006750,7895867
1678749575,202078,true,1676110883,28,1684006750,7895867
1678749587,202077,true,1676278494,28,1684006750,7728256
1678749599,202077,true,1676278494,28,1684006750,7728256
1678749611,202077,true,1676278494,28,1684006750,7728256
1678749875,202077,true,1676278494,28,1682828417,6549923
1678749887,202076,true,1676446122,28,1682828417,6382295
1678749947,202076,true,1676446122,28,1682491902,6045780
1678749959,202075,true,1676613767,28,1682491902,5878135
1678750139,202076,true,1676446122,28,1681482760,5036638
1678751135,202075,true,1676613767,28,1676110883,-502884
1678751171,202074,true,1676781428,28,1675943289,-838139
1678751207,202073,true,1676949106,28,1675775711,-1173395
1678751795,202073,true,1676949106,28,1674770598,-2178508
1678751903,202072,true,1677116801,28,1674770598,-2346203
1678752575,202071,true,1677284513,28,1675943289,-1341224
1678752827,202071,true,1677284513,28,1676278494,-1006019
1678753103,202071,true,1677284513,28,1677284513,0
1678754267,202070,true,1677452241,28,1681482760,4030519
1678754519,202069,true,1677619987,28,1682323669,4703682
1678754939,202068,true,1677787749,28,1682996700,5208951
1678755371,202068,true,1677787749,28,1682996700,5208951
1678755443,202066,true,1678123323,28,1682828417,4705094
1678755503,202065,true,1678291135,28,1682828417,4537282
1678755515,202064,true,1678458964,28,1682828417,4369453
1678755683,202065,true,1678291135,28,1682660151,4369016
1678755767,202063,true,1678626810,28,1682491902,3865092
1678755971,202062,true,1678794673,28,1681987255,3192582
1678756475,202061,true,1678962552,28,1680810335,1847783
1678758407,202063,true,1678626810,28,1677452241,-1174569
1678758431,202061,true,1678962552,28,1677619987,-1342565
1678758983,202060,true,1679130449,28,1678291135,-839314
1678759175,202059,true,1679298362,28,1678626810,-671552
1678759259,202060,true,1679130449,28,1678794673,-335776
1678759427,202059,true,1679298362,28,1679130449,-167913
1678759475,202057,true,1679634238,28,1679298362,-335876
1678760651,202057,true,1679634238,28,1684175151,4540913
1678760999,202058,true,1679466291,28,1685185909,5719618
1678761155,202056,true,1679802202,28,1685354427,5552225
1678761539,202055,true,1679970182,28,1685522963,5552781
1678761743,202055,true,1679970182,28,1685354427,5384245
1678762223,202056,true,1679802202,28,1685185909,5383707
1678762415,202055,true,1679970182,28,1685017407,5047225
1678762499,202053,true,1680306193,28,1685017407,4711214
1678762547,202053,true,1680306193,28,1684848922,4542729
1678762559,202053,true,1680306193,28,1684848922,4542729
1678763891,202053,true,1680306193,28,1682996700,2690507
1678765259,202052,true,1680474223,28,1682491902,2017679
1678769699,202051,true,1680642271,28,1682323669,1681398
1678769783,202052,true,1680474223,28,1682491902,2017679
1678770587,202051,true,1680642271,28,1682491902,1849631
1678770647,202050,true,1680810335,28,1682491902,1681567
1678770671,202050,true,1680810335,28,1682491902,1681567
1678770743,202051,true,1680642271,28,1682828417,2186146
1678770755,202050,true,1680810335,28,1682828417,2018082
1678770815,202048,true,1681146514,28,1683164999,2018485
1678770839,202047,true,1681314628,28,1683333316,2018688
1678770851,202048,true,1681146514,28,1683333316,2186802
1678770887,202047,true,1681314628,28,1683669999,2355371
1678770923,202045,true,1681650908,28,1684006750,2355842
1678770935,202044,true,1681819073,28,1684175151,2356078
1678770959,202045,true,1681650908,28,1684343569,2692661
1678770995,202044,true,1681819073,28,1684512003,2692930
1678771007,202043,true,1681987255,28,1684680454,2693199
1678771079,202043,true,1681987255,28,1685017407,3030152
1678771355,202045,true,1681650908,28,1685691515,4040607
1678771367,202044,true,1681819073,28,1685691515,3872442
1678771379,202042,true,1682155454,28,1685691515,3536061
1678771571,202043,true,1681987255,28,1686028670,4041415
1678771583,202044,true,1681819073,28,1686028670,4209597
1678771595,202044,true,1681819073,28,1686028670,4209597
1678774223,202043,true,1681987255,28,1681650908,-336347
1678775315,202043,true,1681987255,28,1681819073,-168182
1678776275,202045,true,1681650908,28,1681819073,168165
1678777499,202044,true,1681819073,28,1681819073,0
1678779971,202044,true,1681819073,28,1681819073,0
1678779983,202044,true,1681819073,28,1681819073,0
1678780007,202046,true,1681482760,28,1681819073,336313
1678780103,202045,true,1681650908,28,1681819073,168165
1678781471,202045,true,1681650908,28,1678962552,-2688356
1678781483,202045,true,1681650908,28,1678962552,-2688356
1678781567,202047,true,1681314628,28,1678626810,-2687818
1678781603,202045,true,1681650908,28,1678458964,-3191944
1678781651,202046,true,1681482760,28,1678123323,-3359437
1678781699,202046,true,1681482760,28,1677787749,-3695011
1678781807,202048,true,1681146514,28,1677116801,-4029713
1678782011,202046,true,1681482760,28,1676278494,-5204266
1678782251,202047,true,1681314628,28,1675440606,-5874022
1678782287,202046,true,1681482760,28,1675273079,-6209681
1678782515,202048,true,1681146514,28,1674603137,-6543377
1678782755,202046,true,1681482760,28,1673933464,-7549296
1678782767,202047,true,1681314628,28,1673933464,-7381164
1678782935,202046,true,1681482760,28,1673431384,-8051376
1678782995,202048,true,1681146514,28,1673431384,-7715130
1678783115,202047,true,1681314628,28,1673096748,-8217880
1678783559,202047,true,1681314628,28,1673264058,-8050570
1678785659,202046,true,1681482760,28,1674938075,-6544685
1678786607,202048,true,1681146514,28,1674938075,-6208439
1678787579,202047,true,1681314628,28,1674938075,-6376553
1678788563,202047,true,1681314628,28,1675608150,-5706478
1678788875,202047,true,1681314628,28,1675775711,-5538917
1678789403,202048,true,1681146514,28,1675943289,-5203225
1678789427,202047,true,1681314628,28,1676110883,-5203745
1678789499,202048,true,1681146514,28,1676110883,-5035631
1678789703,202048,true,1681146514,28,1676446122,-4700392
1678789967,202049,true,1680978416,28,1676781428,-4196988
1678790039,202048,true,1681146514,28,1676949106,-4197408
1678790243,202048,true,1681146514,28,1677284513,-3862001
1678790267,202048,true,1681146514,28,1677284513,-3862001
1678790663,202050,true,1680810335,28,1678291135,-2519200
1678790999,202049,true,1680978416,28,1679130449,-1847967
1678791071,202049,true,1680978416,28,1679298362,-1680054
1678791347,202049,true,1680978416,28,1679970182,-1008234
1678791443,202050,true,1680810335,28,1680306193,-504142
1678791455,202049,true,1680978416,28,1680306193,-672223
1678791479,202050,true,1680810335,28,1680474223,-336112
1678791527,202048,true,1681146514,28,1680810335,-336179
1678791695,202048,true,1681146514,28,1681650908,504394
1678791719,202047,true,1681314628,28,1681819073,504445
1678792499,202047,true,1681314628,28,1685860084,4545456
1678792535,202045,true,1681650908,28,1686028670,4377762
1678792655,202045,true,1681650908,28,1686703183,5052275
1678792679,202043,true,1681987255,28,1686871853,4884598
1678792715,202043,true,1681987255,28,1687040540,5053285
1678792811,202042,true,1682155454,28,1687715458,5560004
1678792823,202041,true,1682323669,28,1687884229,5560560
1678793591,202040,true,1682491902,28,1690755929,8264027
1678793711,202040,true,1682491902,28,1690925005,8433103
1678795343,202039,true,1682660151,28,1690755929,8095778
1678797023,202038,true,1682828417,28,1691263207,8434790
1678797047,202038,true,1682828417,28,1691432333,8603916
1678797083,202038,true,1682828417,28,1691770636,8942219
1678797107,202037,true,1682996700,28,1691939813,8943113
1678797119,202033,true,1683669999,28,1692109007,8439008
1678797131,202032,true,1683838366,28,1692278218,8439852
1678797167,202031,true,1684006750,28,1692955231,8948481
1678797203,202029,true,1684343569,28,1693463169,9119600
1678797287,202025,true,1685017407,28,1694648948,9631541
1678797311,202024,true,1685185909,28,1694987895,9801986
1678797335,202023,true,1685354427,28,1695157394,9802967
1678797347,202021,true,1685691515,28,1695326910,9635395
1678797371,202019,true,1686028670,28,1695496442,9467772
1678797431,202018,true,1686197273,28,1695835559,9638286
1678797479,202018,true,1686197273,28,1696174743,9977470
1678797491,202016,true,1686534529,28,1696344360,9809831
1678797527,202014,true,1686871853,28,1696513995,9642142
1678797755,202013,true,1687040540,28,1698211272,11170732
1678797767,202013,true,1687040540,28,1698381093,11340553
1678797791,202012,true,1687209244,28,1698550932,11341688
1678797863,202009,true,1687715458,28,1699230454,11514996
1678797887,202008,true,1687884229,28,1699570317,11686088
1678797911,202007,true,1688053018,28,1699910248,11857230
1678797935,202006,true,1688221823,28,1700250247,12028424
1678797995,202002,true,1688897213,28,1701270652,12373439
1678798007,202001,true,1689066103,28,1701440779,12374676
1678798031,202000,true,1689235009,28,1701781084,12546075
1678798043,201998,true,1689572873,28,1702121458,12548585
1678798055,201994,true,1690248804,28,1702291670,12042866
1678798091,201992,true,1690586871,28,1703142986,12556115
1678798139,201990,true,1690925005,28,1704165127,13240122
1678798199,201988,true,1691263207,28,1705528937,14265730
1678798367,201983,true,1692109007,28,1709285043,17176036
1678798439,201981,true,1692447446,28,1710995097,18547651
1678798451,201979,true,1692785953,28,1711337313,18551360
1678798463,201978,true,1692955231,28,1711679598,18724367
1678798499,201972,true,1693971258,28,1712706862,18735604
1678798511,201970,true,1694310070,28,1713049421,18739351
1678798835,201968,true,1694648948,28,1722668926,28019978
1678798859,201966,true,1694987895,28,1723185778,28197883
1678798871,201961,true,1695835559,28,1723530433,27694874
1678798895,201959,true,1696174743,28,1724219948,28045205
1678798907,201956,true,1696683646,28,1724564810,27881164
1678798919,201954,true,1697023000,28,1724737266,27714266
1678798931,201949,true,1697871681,28,1725082231,27210550
1678798943,201946,true,1698381093,28,1725427265,27046172
1678799015,201942,true,1699060548,28,1727326184,28265636
1678799027,201939,true,1699570317,28,1727671666,28101349
1678799087,201932,true,1700760373,28,1729400116,28639743
1678799219,201929,true,1701270652,28,1733902181,32631529
1678799267,201925,true,1701951263,28,1735636864,33685601
1678799483,201922,true,1702461899,28,1743290108,40828209
1678799507,201915,true,1703653980,28,1744161927,40507947
1678799891,201912,true,1704165127,28,1755710888,51545761
1678799903,201907,true,1705017380,28,1755886459,50869079
1678799963,201904,true,1705528937,28,1757115949,51587012
1678799975,201897,true,1706723165,28,1757467389,50744224
1678799987,201894,true,1707235233,28,1757643136,50407903
1678799999,201890,true,1707918230,28,1757818901,49900671
1678800035,201888,true,1708259830,28,1758170482,49910652
1678800347,201882,true,1709285043,28,1760985665,51700622
1678800359,201879,true,1709797879,28,1760985665,51187786
1678800371,201874,true,1710652949,28,1760985665,50332716
1678800395,201873,true,1710824015,28,1760985665,50161650
1678800407,201867,true,1711850766,28,1760985665,49134899
1678800695,201865,true,1712193153,28,1761337880,49144727
1678801211,201859,true,1713220726,28,1755710888,42490162
1678801355,201857,true,1713563387,28,1754306951,40743564
1678801367,201851,true,1714591782,28,1754131538,39539756
1678801379,201848,true,1715106211,28,1753956143,38849932
1678801403,201842,true,1716135532,28,1753780765,37645233
1678801487,201840,true,1716478776,28,1753079428,36600652
1678801499,201834,true,1717508921,28,1753079428,35570507
1678801871,201831,true,1718024225,28,1750626956,32602731
1678801883,201825,true,1719055298,28,1750626956,31571658
1678801931,201823,true,1719399126,28,1750626956,31227830
1678801943,201817,true,1720431023,28,1750626956,30195933
1678801955,201815,true,1720775127,28,1750626956,29851829
1678801979,201810,true,1721635686,28,1750451911,28816225
1678802039,201808,true,1721980031,28,1750451911,28471880
1678802051,201802,true,1723013477,28,1750276883,27263406
1678802735,201802,true,1723013477,28,1746256073,23242596
1678802951,201796,true,1724047544,28,1744859697,20812153
1678803167,201795,true,1724219948,28,1743290108,19070160
1678803191,201789,true,1725254739,28,1743115796,17861057
1678803239,201789,true,1725254739,28,1742767226,17512487
1678803323,201783,true,1726290151,28,1742070293,15780142
1678803419,201781,true,1726635426,28,1741373639,14738213
1678803431,201776,true,1727498916,28,1741373639,13874723
1678804175,201776,true,1727498916,28,1740503213,13004297
1678804199,201770,true,1728535675,28,1740503213,11967538
1678804607,201768,true,1728881399,28,1742592966,13711567
1678804811,201763,true,1729746013,28,1743638783,13892770
1678805171,201762,true,1729918988,28,1745383207,15464219
1678805183,201756,true,1730957198,28,1745383207,14426009
1678805195,201754,true,1731303407,28,1745557745,14254338
1678805219,201749,true,1732169232,28,1745557745,13388513
1678805255,201748,true,1732342449,28,1745732301,13389852
1678805267,201742,true,1733382114,28,1745906874,12524760
1678805279,201740,true,1733728808,28,1745906874,12178066
1678805315,201735,true,1734595846,28,1746256073,11660227
1678805543,201733,true,1734942782,28,1748003115,13060333
1678805555,201727,true,1735984008,28,1748177916,12193908
1678805687,201725,true,1736331223,28,1749926880,13595657
1678805711,201720,true,1737199562,28,1750276883,13077321
1678805747,201717,true,1737720774,28,1750802019,13081245
1678805759,201711,true,1738763667,28,1750977099,12213432
1678805771,201709,true,1739111437,28,1751152197,12040760
1678805951,201703,true,1740155165,28,1754657830,14502665
1678806011,201700,true,1740677264,28,1755710888,15033624
1678806035,201694,true,1741721931,28,1755886459,14164528
1678806431,201692,true,1742070293,28,1761337880,19267587
1678806455,201686,true,1743115796,28,1761690165,18574369
1678806467,201683,true,1743638783,28,1761866334,18227551
1678806479,201677,true,1744685228,28,1762042521,17357293
1678806491,201675,true,1745034183,28,1762042521,17008338
1678806623,201673,true,1745383207,28,1764158135,18774928
1678806647,201670,true,1745906874,28,1764510985,18604111
1678806767,201666,true,1746605342,28,1766452918,19847576
1678806803,201664,true,1746954680,28,1766982906,20028226
1678807031,201661,true,1747478819,28,1770697284,23218465
1678807067,201658,true,1748003115,28,1771228546,23225431
1678807211,201653,true,1748877292,28,1773000572,24123280
1678807583,201651,true,1749227085,28,1775661935,26434850
1678807667,201647,true,1749926880,28,1775661935,25735055
1678807763,201643,true,1750626956,28,1775306856,24679900
1678807775,201638,true,1751502445,28,1775306856,23804411
1678807787,201636,true,1751852763,28,1775306856,23454093
1678808555,201633,true,1752378371,28,1774596911,22218540
1678808615,201629,true,1753079428,28,1774419469,21340041
1678808855,201624,true,1753956143,28,1773709878,19753735
1678808879,201623,true,1754131538,28,1773532525,19400987
1678808915,201619,true,1754833296,28,1773355189,18521893
1678809047,201616,true,1755359799,28,1773000572,17640773
1678809647,201611,true,1756237654,28,1772114337,15876683
1678809731,201610,true,1756413278,28,1772291549,15878271
1678809839,201608,true,1756764578,28,1772468778,15704200
1678809911,201605,true,1757291660,28,1772646025,15354365
1678809947,201600,true,1758170482,28,1772823289,14652807
1678810031,201599,true,1758346299,28,1773177872,14831573
1678810115,201597,true,1758697986,28,1773355189,14657203
1678810835,201595,true,1759049743,28,1775484387,16434644
1678810871,201591,true,1759753468,28,1775484387,15730919
1678810883,201590,true,1759929444,28,1775484387,15554943
1678810907,201588,true,1760281447,28,1775484387,15202940
1678810991,201587,true,1760457475,28,1775484387,15026912
1678811111,201583,true,1761161764,28,1775129343,13967579
1678811123,201582,true,1761337880,28,1775129343,13791463
1678811147,201582,true,1761337880,28,1774951848,13613968
1678811207,201582,true,1761337880,28,1774596911,13259031
1678811255,201579,true,1761866334,28,1774419469,12553135
1678811615,201578,true,1762042521,28,1772291549,10249028
1678812563,201578,true,1762042521,28,1765569956,3527435
1678812815,201578,true,1762042521,28,1764510985,2468464
1678812839,201576,true,1762394947,28,1764334551,1939604
1678813535,201576,true,1762394947,28,1765923088,3528141
1678813919,201576,true,1762394947,28,1766982906,4587959
1678814063,201577,true,1762218725,28,1766982906,4764181
1678814111,201576,true,1762394947,28,1767159605,4764658
1678814327,201576,true,1762394947,28,1767513054,5118107
1678814363,201576,true,1762394947,28,1767513054,5118107
1678814387,201577,true,1762218725,28,1767513054,5294329
1678814495,201577,true,1762218725,28,1767336321,5117596
1678814519,201577,true,1762218725,28,1767336321,5117596
1678814591,201577,true,1762218725,28,1767159605,4940880
1678815551,201578,true,1762042521,28,1763805357,1762836
1678816031,201578,true,1762042521,28,1762571187,528666
1678816079,201579,true,1761866334,28,1762571187,704853
1678816643,201579,true,1761866334,28,1761866334,0
1678816991,201579,true,1761866334,28,1761690165,-176169
1678817015,201579,true,1761866334,28,1761690165,-176169
1678817051,201578,true,1762042521,28,1761514014,-528507
1678817075,201577,true,1762218725,28,1761337880,-880845
1678817087,201578,true,1762042521,28,1761337880,-704641
1678817099,201578,true,1762042521,28,1761337880,-704641
1678817111,201578,true,1762042521,28,1761161764,-880757
1678817159,201577,true,1762218725,28,1760985665,-1233060
1678817171,201578,true,1762042521,28,1760809584,-1232937
1678817471,201579,true,1761866334,28,1757643136,-4223198
1678817963,201579,true,1761866334,28,1752553609,-9312725
1678818083,201578,true,1762042521,28,1751502445,-10540076
1678818155,201579,true,1761866334,28,1750977099,-10889235
1678818215,201580,true,1761690165,28,1750451911,-11238254
1678818287,201580,true,1761690165,28,1749926880,-11763285
1678818443,201579,true,1761866334,28,1748877292,-12989042
1678818467,201580,true,1761690165,28,1748702421,-12987744
1678818515,201582,true,1761337880,28,1748352733,-12985147
1678818587,201581,true,1761514014,28,1748003115,-13510899
1678818659,201580,true,1761690165,28,1747478819,-14211346
1678818683,201580,true,1761690165,28,1747478819,-14211346
1678818743,201581,true,1761514014,28,1747129376,-14384638
1678818923,201580,true,1761690165,28,1746954680,-14735485
1678819727,201578,true,1762042521,28,1752027948,-10014573
1678819775,201577,true,1762218725,28,1752203151,-10015574
1678819787,201578,true,1762042521,28,1752203151,-9839370
1678819835,201576,true,1762394947,28,1752378371,-10016576
1678819859,201576,true,1762394947,28,1752378371,-10016576
1678819871,201575,true,1762571187,28,1752378371,-10192816
1678819883,201576,true,1762394947,28,1752378371,-10016576
1678819895,201575,true,1762571187,28,1752378371,-10192816
1678819955,201576,true,1762394947,28,1752203151,-10191796
1678820087,201576,true,1762394947,28,1751327312,-11067635
1678820615,201577,true,1762218725,28,1746954680,-15264045
1678820627,201577,true,1762218725,28,1746780002,-15438723
1678821167,201577,true,1762218725,28,1741721931,-20496794
1678821239,201578,true,1762042521,28,1740851331,-21191190
1678821263,201579,true,1761866334,28,1740503213,-21363121
1678821275,201579,true,1761866334,28,1740329180,-21537154
1678821311,201582,true,1761337880,28,1739633223,-21704657
1678821335,201584,true,1760985665,28,1738937543,-22048122
1678821347,201587,true,1760457475,28,1738763667,-21693808
1678821359,201587,true,1760457475,28,1738415966,-22041509
1678821383,201591,true,1759753468,28,1737547019,-22206449
1678821503,201595,true,1759049743,28,1734248979,-24800764
1678821527,201598,true,1758522134,28,1733555453,-24966681
1678821539,201599,true,1758346299,28,1733208793,-25137506
1678821551,201603,true,1757643136,28,1733035490,-24607646
1678821599,201607,true,1756940255,28,1731996032,-24944223
1678821623,201609,true,1756588919,28,1731476538,-25112381
1678821875,201610,true,1756413278,28,1728362839,-28050439
1678821899,201615,true,1755535335,28,1728190020,-27345315
1678821935,201619,true,1754833296,28,1727844433,-26988863
1678821947,201621,true,1754482382,28,1727671666,-26810716
1678821971,201622,true,1754306951,28,1727326184,-26980767
1678822007,201627,true,1753430061,28,1726808090,-26621971
1678822019,201631,true,1752728864,28,1726635426,-26093438
1678822031,201634,true,1752203151,28,1726462780,-25740371
1678822055,201635,true,1752027948,28,1726117539,-25910409
1678822079,201641,true,1750977099,28,1725772367,-25204732
1678822235,201645,true,1750276883,28,1723013477,-27263406
1678822271,201648,true,1749751905,28,1722324444,-27427461
1678822607,201649,true,1749576948,28,1716307146,-33269802
1678822631,201655,true,1748527569,28,1715963936,-32563633
1678822691,201660,true,1747653567,28,1714934718,-32718849
1678822727,201663,true,1747129376,28,1714248915,-32880461
1678822931,201664,true,1746954680,28,1710824015,-36130665
1678823279,201670,true,1745906874,28,1708601500,-37305374
1678823435,201675,true,1745034183,28,1708089022,-36945161
1678823471,201677,true,1744685228,28,1707918230,-36766998
1678823483,201678,true,1744510777,28,1707747455,-36763322
1678823519,201683,true,1743638783,28,1707576697,-36062086
1678823543,201688,true,1742767226,28,1707576697,-35190529
1678823831,201689,true,1742592966,28,1707064527,-35528439
1678823903,201690,true,1742418724,28,1707405957,-35012767
1678823915,201695,true,1741547776,28,1707576697,-33971079
1678823939,201699,true,1740851331,28,1707747455,-33103876
1678823963,201701,true,1740503213,28,1707918230,-32584983
1678823987,201701,true,1740503213,28,1708089022,-32414191
1678823999,201706,true,1739633223,28,1708259830,-31373393
1678824191,201709,true,1739111437,28,1710652949,-28458488
1678824275,201711,true,1738763667,28,1711679598,-27084069
1678824287,201711,true,1738763667,28,1711850766,-26912901
1678824551,201716,true,1737894546,28,1715277722,-22616824
1678824587,201719,true,1737373282,28,1715620794,-21752488
1678824671,201721,true,1737025859,28,1716478776,-20547083
1678824695,201721,true,1737025859,28,1716822089,-20203770
1678824767,201726,true,1736157607,28,1717508921,-18648686
1678824791,201729,true,1735636864,28,1717852440,-17784424
1678825283,201730,true,1735463317,28,1722668926,-12794391
1678825415,201730,true,1735463317,28,1723358097,-12105220
1678826135,201736,true,1734422404,28,1723875156,-10547248
1678826147,201738,true,1734075571,28,1723875156,-10200415
1678826159,201739,true,1733902181,28,1723875156,-10027025
1678826243,201739,true,1733902181,28,1723185778,-10716403
1678826315,201745,true,1732862204,28,1722668926,-10193278
1678826327,201748,true,1732342449,28,1722668926,-9673523
1678826351,201749,true,1732169232,28,1722324444,-9844788
1678826363,201750,true,1731996032,28,1722324444,-9671588
1678826375,201757,true,1730784120,28,1722152229,-8631891
1678826735,201760,true,1730264989,28,1718711538,-11553451
1678826819,201761,true,1730091979,28,1718024225,-12067754
1678827107,201762,true,1729918988,28,1715792357,-14126631
1678827299,201769,true,1728708528,28,1714248915,-14459613
1678827779,201772,true,1728190020,28,1710824015,-17366005
1678827839,201773,true,1728017218,28,1710481901,-17535317
1678827863,201773,true,1728017218,28,1710310870,-17706348
1678827875,201780,true,1726808090,28,1710139856,-16668234
1678827923,201783,true,1726290151,28,1709626917,-16663234
1678827947,201785,true,1725944944,28,1709455971,-16488973
1678827995,201786,true,1725772367,28,1708772360,-17000007
1678828055,201793,true,1724564810,28,1707918230,-16646580
1678828067,201797,true,1723875156,28,1707918230,-15956926
1678828079,201799,true,1723530433,28,1707747455,-15782978
1678828091,201800,true,1723358097,28,1707405957,-15952140
1678828103,201808,true,1721980031,28,1707235233,-14744798
1678828115,201812,true,1721291411,28,1707064527,-14226884
1678828127,201814,true,1720947204,28,1706723165,-14224039
1678828139,201815,true,1720775127,28,1706552510,-14222617
1678828151,201823,true,1719399126,28,1706381872,-13017254
1678828235,201826,true,1718883409,28,1705187882,-13695527
1678828259,201827,true,1718711538,28,1704846896,-13864642
1678828271,201828,true,1718539684,28,1704676428,-13863256
1678828283,201835,true,1717337187,28,1704505977,-12831210
1678828415,201838,true,1716822089,28,1703142986,-13679103
1678828427,201839,true,1716650424,28,1702972689,-13677735
1678828583,201840,true,1716478776,28,1701270652,-15208124
1678828607,201848,true,1715106211,28,1701100542,-14005669
1678828619,201850,true,1714763241,28,1700930449,-13832792
1678828631,201851,true,1714591782,28,1700760373,-13831409
1678828655,201854,true,1714077507,28,1700250247,-13827260
1678828703,201863,true,1712535609,28,1699230454,-13305155
1678828715,201866,true,1712021951,28,1699060548,-12961403
1678828727,201867,true,1711850766,28,1698890659,-12960107
1678828763,201870,true,1711337313,28,1698211272,-13126041
1678828787,201879,true,1709797879,28,1697871681,-11926198
1678828811,201881,true,1709455971,28,1697532158,-11923813
1678828823,201883,true,1709114131,28,1697362421,-11751710
1678828835,201885,true,1708772360,28,1697192702,-11579658
1678828883,201893,true,1707405957,28,1696513995,-10891962
1678829027,201894,true,1707235233,28,1694648948,-12586285
1678829171,201896,true,1706893837,28,1692785953,-14107884
1678829183,201898,true,1706552510,28,1692616691,-13935819
1678829315,201904,true,1705528937,28,1691094097,-14434840
1678829447,201905,true,1705358401,28,1689741831,-15616570
1678829459,201905,true,1705358401,28,1689572873,-15785528
1678829471,201908,true,1704846896,28,1689572873,-15274023
1678829483,201914,true,1703824345,28,1689403933,-14420412
1678829495,201914,true,1703824345,28,1689235009,-14589336
1678829663,201914,true,1703824345,28,1688053018,-15771327
1678829675,201916,true,1703483632,28,1688053018,-15430614
1678830587,201919,true,1702972689,28,1696005142,-6967547
1678830599,201918,true,1703142986,28,1696005142,-7137844
1678830647,201917,true,1703313300,28,1696513995,-6799305
1678830743,201918,true,1703142986,28,1697362421,-5780565
1678831055,201921,true,1702632145,28,1699060548,-3571597
1678831067,201919,true,1702972689,28,1699230454,-3742235
1678831079,201918,true,1703142986,28,1699230454,-3912532
1678831763,201920,true,1702802408,28,1700420272,-2382136
1678831787,201922,true,1702461899,28,1700420272,-2041627
1678831799,201921,true,1702632145,28,1700420272,-2211873
1678831991,201921,true,1702632145,28,1700420272,-2211873
1678832027,201923,true,1702291670,28,1700420272,-1871398
1678832051,201925,true,1701951263,28,1700420272,-1530991
1678832111,201924,true,1702121458,28,1700590314,-1531144
1678832159,201923,true,1702291670,28,1700930449,-1361221
1678832195,201923,true,1702291670,28,1701270652,-1021018
1678832207,201925,true,1701951263,28,1701270652,-680611
1678832279,201924,true,1702121458,28,1701781084,-340374
1678832531,201922,true,1702461899,28,1703313300,851401
1678832675,201923,true,1702291670,28,1704676428,2384758
1678832699,201924,true,1702121458,28,1704846896,2725438
1678832735,201922,true,1702461899,28,1705187882,2725983
1678832939,201921,true,1702632145,28,1706552510,3920365
1678833095,201922,true,1702461899,28,1707405957,4944058
1678833107,201923,true,1702291670,28,1707405957,5114287
1678835003,201922,true,1702461899,28,1706893837,4431938
1678835123,201921,true,1702632145,28,1707064527,4432382
1678835135,201922,true,1702461899,28,1707064527,4602628
1678836371,201923,true,1702291670,28,1707576697,5285027
1678838567,201921,true,1702632145,28,1707747455,5115310
1678838699,201920,true,1702802408,28,1707918230,5115822
1678839155,201921,true,1702632145,28,1707918230,5286085
1678839311,201923,true,1702291670,28,1707747455,5455785
1678839707,201922,true,1702461899,28,1707576697,5114798
1678839887,201922,true,1702461899,28,1707405957,4944058
1678839959,201922,true,1702461899,28,1707235233,4773334
1678840007,201924,true,1702121458,28,1707235233,5113775
1678840079,201923,true,1702291670,28,1707064527,4772857
1678840127,201924,true,1702121458,28,1707064527,4943069
1678840139,201926,true,1701781084,28,1706893837,5112753
1678840163,201928,true,1701440779,28,1706893837,5453058
1678840187,201928,true,1701440779,28,1706723165,5282386
1678840235,201929,true,1701270652,28,1706552510,5281858
1678840247,201931,true,1700930449,28,1706381872,5451423
1678840283,201934,true,1700420272,28,1706211250,5790978
1678840331,201935,true,1700250247,28,1705870059,5619812
1678840751,201936,true,1700080239,28,1703142986,3062747
1678841147,201938,true,1699740274,28,1700250247,509973
1678841387,201941,true,1699230454,28,1698720787,-509667
1678841663,201941,true,1699230454,28,1697362421,-1868033
1678841675,201942,true,1699060548,28,1697362421,-1698127
1678841687,201944,true,1698720787,28,1697362421,-1358366
1678841771,201946,true,1698381093,28,1697023000,-1358093
1678841783,201946,true,1698381093,28,1697023000,-1358093
1678841795,201947,true,1698211272,28,1697023000,-1188272
1678841807,201948,true,1698041468,28,1697023000,-1018468
1678842143,201948,true,1698041468,28,1697871681,-169787
1678842155,201948,true,1698041468,28,1698041468,0
1678842191,201949,true,1697871681,28,1698211272,339591
1678842203,201950,true,1697701911,28,1698381093,679182
1678842239,201949,true,1697871681,28,1698720787,849106
1678842359,201948,true,1698041468,28,1699740274,1698806
1678842791,201948,true,1698041468,28,1704165127,6123659
1678843271,201949,true,1697871681,28,1708943237,11071556
1678843283,201948,true,1698041468,28,1708943237,10901769
1678843319,201947,true,1698211272,28,1709455971,11244699
1678843379,201947,true,1698211272,28,1709968859,11757587
1678843439,201948,true,1698041468,28,1710652949,12611481
1678843463,201946,true,1698381093,28,1710824015,12442922
1678843667,201944,true,1698720787,28,1712706862,13986075
1678844171,201944,true,1698720787,28,1715277722,16556935
1678847147,201944,true,1698720787,28,1716822089,18101302
1678850327,201942,true,1699060548,28,1716650424,17589876
1678850351,201940,true,1699400377,28,1716650424,17250047
1678850399,201939,true,1699570317,28,1716650424,17080107
1678850411,201939,true,1699570317,28,1716650424,17080107
1678850531,201936,true,1700080239,28,1716650424,16570185
1678850627,201933,true,1700590314,28,1716478776,15888462
1678850747,201932,true,1700760373,28,1716478776,15718403
1678850759,201931,true,1700930449,28,1716478776,15548327
1678850783,201929,true,1701270652,28,1716307146,15036494
1678850795,201926,true,1701781084,28,1716307146,14526062
1678850987,201925,true,1701951263,28,1716135532,14184269
1678851011,201925,true,1701951263,28,1715963936,14012673
1678851023,201923,true,1702291670,28,1715963936,13672266
1678851107,201921,true,1702632145,28,1715792357,13160212
1678851179,201920,true,1702802408,28,1715620794,12818386
1678851191,201920,true,1702802408,28,1715620794,12818386
1678851755,201918,true,1703142986,28,1714077507,10934521
1678853363,201916,true,1703483632,28,1710995097,7511465
1678854923,201916,true,1703483632,28,1710824015,7340383
1678856147,201914,true,1703824345,28,1710824015,6999670
1678856663,201911,true,1704335544,28,1710824015,6488471
1678856795,201909,true,1704676428,28,1710995097,6318669
1678856915,201908,true,1704846896,28,1710995097,6148201
1678857323,201907,true,1705017380,28,1711337313,6319933
1678857551,201904,true,1705528937,28,1711508447,5979510
1678858067,201902,true,1705870059,28,1712021951,6151892
1678858475,201901,true,1706040646,28,1712706862,6666216
1678859567,201900,true,1706211250,28,1713392048,7180798
1678860155,201897,true,1706723165,28,1713392048,6668883
1678860347,201896,true,1706893837,28,1713392048,6498211
1678860359,201895,true,1707064527,28,1713392048,6327521
1678860443,201894,true,1707235233,28,1713392048,6156815
1678860983,201892,true,1707576697,28,1712193153,4616456
1678861259,201892,true,1707576697,28,1711508447,3931750
1678861427,201891,true,1707747455,28,1710995097,3247642
1678861799,201890,true,1707918230,28,1709797879,1879649
1678861991,201889,true,1708089022,28,1709114131,1025109
1678862399,201889,true,1708089022,28,1708259830,170808
1678862471,201888,true,1708259830,28,1708089022,-170808
1678862531,201887,true,1708430656,28,1708089022,-341634
1678862807,201887,true,1708430656,28,1708089022,-341634
1678865171,201887,true,1708430656,28,1709626917,1196261
1678866083,201887,true,1708430656,28,1709626917,1196261
1678866551,201886,true,1708601500,28,1709626917,1025417
1678867163,201885,true,1708772360,28,1709626917,854557
1678867271,201884,true,1708943237,28,1709797879,854642
1678867331,201884,true,1708943237,28,1709797879,854642
1678867559,201883,true,1709114131,28,1709968859,854728
1678868939,201882,true,1709285043,28,1711166197,1881154
1678869179,201882,true,1709285043,28,1711166197,1881154
1678869251,201882,true,1709285043,28,1711166197,1881154
1678871363,201882,true,1709285043,28,1710310870,1025827
1678871831,201881,true,1709455971,28,1710310870,854899
1678872107,201881,true,1709455971,28,1710310870,854899
1678872251,201882,true,1709285043,28,1710310870,1025827
1678872275,201882,true,1709285043,28,1710310870,1025827
1678872287,201881,true,1709455971,28,1710310870,854899
1678872359,201882,true,1709285043,28,1710310870,1025827
1678872395,201883,true,1709114131,28,1710310870,1196739
1678872419,201883,true,1709114131,28,1710310870,1196739
1678872431,201882,true,1709285043,28,1710139856,854813
1678872563,201883,true,1709114131,28,1710139856,1025725
1678872611,201883,true,1709114131,28,1709968859,854728
1678873091,201883,true,1709114131,28,1709114131,0
1678873103,201883,true,1709114131,28,1708943237,-170894
1678873187,201883,true,1709114131,28,1708772360,-341771
1678873223,201883,true,1709114131,28,1708601500,-512631
1678873235,201884,true,1708943237,28,1708601500,-341737
1678873259,201883,true,1709114131,28,1708430656,-683475
1678873271,201884,true,1708943237,28,1708430656,-512581
1678873547,201885,true,1708772360,28,1706552510,-2219850
1678873619,201886,true,1708601500,28,1706040646,-2560854
1678873895,201885,true,1708772360,28,1704335544,-4436816
1678874063,201886,true,1708601500,28,1703142986,-5458514
1678875203,201887,true,1708430656,28,1698550932,-9879724
1678876043,201888,true,1708259830,28,1698381093,-9878737
1678876055,201887,true,1708430656,28,1698381093,-10049563
1678876079,201887,true,1708430656,28,1698381093,-10049563
1678876115,201889,true,1708089022,28,1698381093,-9707929
1678876139,201889,true,1708089022,28,1698381093,-9707929
1678876391,201889,true,1708089022,28,1697701911,-10387111
1678876403,201889,true,1708089022,28,1697701911,-10387111
1678876415,201890,true,1707918230,28,1697701911,-10216319
1678876439,201890,true,1707918230,28,1697701911,-10216319
1678876523,201890,true,1707918230,28,1697362421,-10555809
1678877195,201890,true,1707918230,28,1694818413,-13099817
1678878143,201891,true,1707747455,28,1691770636,-15976819
1678878263,201891,true,1707747455,28,1691432333,-16315122
1678878359,201891,true,1707747455,28,1691263207,-16484248
1678878419,201891,true,1707747455,28,1691094097,-16653358
1678878479,201892,true,1707576697,28,1690925005,-16651692
1678878503,201893,true,1707405957,28,1690925005,-16480952
1678878659,201894,true,1707235233,28,1690248804,-16986429
1678879079,201894,true,1707235233,28,1688728340,-18506893
1678879091,201896,true,1706893837,28,1688559484,-18334353
1678879127,201897,true,1706723165,28,1688390645,-18332520
1678879139,201898,true,1706552510,28,1688390645,-18161865
1678879175,201899,true,1706381872,28,1688221823,-18160049
1678879295,201901,true,1706040646,28,1687377965,-18662681
1678879307,201902,true,1705870059,28,1687377965,-18492094
1678879319,201904,true,1705528937,28,1687209244,-18319693
1678879355,201906,true,1705187882,28,1687040540,-18147342
1678879379,201908,true,1704846896,28,1686871853,-17975043
1678879391,201909,true,1704676428,28,1686703183,-17973245
1678879799,201912,true,1704165127,28,1682996700,-21168427
1678879823,201914,true,1703824345,28,1682660151,-21164194
1678879835,201916,true,1703483632,28,1682491902,-20991730
1678880003,201918,true,1703142986,28,1680306193,-22836793
1678880303,201922,true,1702461899,28,1676613767,-25848132
1678880327,201924,true,1702121458,28,1676446122,-25675336
1678880339,201927,true,1701610923,28,1676278494,-25332429
1678880387,201929,true,1701270652,28,1675943289,-25327363
1678880399,201933,true,1700590314,28,1675775711,-24814603
1678880459,201934,true,1700420272,28,1675440606,-24979666
1678880471,201936,true,1700080239,28,1675273079,-24807160
1678880699,201938,true,1699740274,28,1673933464,-25806810
1678880711,201941,true,1699230454,28,1673766087,-25464367
1678881287,201943,true,1698890659,28,1672427676,-26462983
1678881311,201945,true,1698550932,28,1672427676,-26123256
1678881347,201946,true,1698381093,28,1672594919,-25786174
1678881371,201950,true,1697701911,28,1672594919,-25106992
1678881383,201950,true,1697701911,28,1672762179,-24939732
1678881455,201952,true,1697362421,28,1673096748,-24265673
1678882439,201952,true,1697362421,28,1681650908,-15711513
1678882511,201956,true,1696683646,28,1682155454,-14528192
1678882523,201956,true,1696683646,28,1682155454,-14528192
1678882631,201957,true,1696513995,28,1682660151,-13853844
1678882643,201958,true,1696344360,28,1682660151,-13684209
1678882679,201962,true,1695665992,28,1682660151,-13005841
1678882739,201962,true,1695665992,28,1682828417,-12837575
1678882751,201964,true,1695326910,28,1682996700,-12330210
1678882763,201965,true,1695157394,28,1682996700,-12160694
1678882775,201968,true,1694648948,28,1682996700,-11652248
1678882787,201969,true,1694479501,28,1682996700,-11482801
1678882823,201971,true,1694140655,28,1682996700,-11143955
1678882895,201972,true,1693971258,28,1682996700,-10974558
1678882931,201976,true,1693293839,28,1682996700,-10297139
1678882955,201976,true,1693293839,28,1682996700,-10297139
1678882967,201978,true,1692955231,28,1682996700,-9958531
1678883387,201980,true,1692616691,28,1680978416,-11638275
1678883411,201984,true,1691939813,28,1680810335,-11129478
1678883423,201985,true,1691770636,28,1680810335,-10960301
1678883435,201987,true,1691432333,28,1680810335,-10621998
1678883459,201987,true,1691432333,28,1680810335,-10621998
1678883507,201989,true,1691094097,28,1680978416,-10115681
1678883519,201989,true,1691094097,28,1680978416,-10115681
1678883531,201991,true,1690755929,28,1681146514,-9609415
1678883543,201990,true,1690925005,28,1681146514,-9778491
1678883555,201992,true,1690586871,28,1681314628,-9272243
1678883567,201991,true,1690755929,28,1681314628,-9441301
1678883579,201993,true,1690417829,28,1681482760,-8935069
1678883795,201992,true,1690586871,28,1682828417,-7758454
1678883831,201994,true,1690248804,28,1683164999,-7083805
1678883843,201994,true,1690248804,28,1683164999,-7083805
1678883867,201996,true,1689910805,28,1683333316,-6577489
1678884227,201996,true,1689910805,28,1684175151,-5735654
1678884239,201998,true,1689572873,28,1684175151,-5397722
1678884251,201998,true,1689572873,28,1684175151,-5397722
1678884263,202000,true,1689235009,28,1684175151,-5059858
1678884287,202002,true,1688897213,28,1684175151,-4722062
1678884347,202004,true,1688559484,28,1684006750,-4552734
1678884359,202005,true,1688390645,28,1683838366,-4552279
1678884623,202008,true,1687884229,28,1682323669,-5560560
1678884671,202010,true,1687546703,28,1682155454,-5391249
1678884695,202012,true,1687209244,28,1682155454,-5053790
1678884707,202013,true,1687040540,28,1682155454,-4885086
1678884743,202016,true,1686534529,28,1682155454,-4379075
1678884839,202017,true,1686365893,28,1682323669,-4042224
1678884851,202020,true,1685860084,28,1682323669,-3536415
1678885115,202020,true,1685860084,28,1683333316,-2526768
1678885223,202022,true,1685522963,28,1683669999,-1852964
1678885451,202023,true,1685354427,28,1681987255,-3367172
1678885619,202026,true,1684848922,28,1680474223,-4374699
1678885847,202025,true,1685017407,28,1679466291,-5551116
1678885859,202028,true,1684512003,28,1679466291,-5045712
1678885931,202028,true,1684512003,28,1679298362,-5213641
1678886027,202031,true,1684006750,28,1679130449,-4876301
1678886039,202030,true,1684175151,28,1679130449,-5044702
1678886075,202032,true,1683838366,28,1679130449,-4707917
1678886087,202032,true,1683838366,28,1679298362,-4540004
1678886099,202033,true,1683669999,28,1679298362,-4371637
1678886363,202032,true,1683838366,28,1682491902,-1346464
1678886447,202033,true,1683669999,28,1683501649,-168350
1678886543,202033,true,1683669999,28,1684680454,1010455
1678886555,202034,true,1683501649,28,1684680454,1178805
1678886567,202033,true,1683669999,28,1684848922,1178923
1678886639,202034,true,1683501649,28,1685691515,2189866
1678887059,202033,true,1683669999,28,1690079796,6409797
1678887107,202035,true,1683333316,28,1690417829,7084513
1678887167,202033,true,1683669999,28,1690925005,7255006
1678887191,202034,true,1683501649,28,1691094097,7592448
1678887431,202034,true,1683501649,28,1692785953,9284304
1678887467,202035,true,1683333316,28,1692955231,9621915
1678887611,202033,true,1683669999,28,1693463169,9793170
1678888043,202035,true,1683333316,28,1693124527,9791211
1678888295,202035,true,1683333316,28,1692109007,8775691
1678888331,202036,true,1683164999,28,1691939813,8774814
1678888379,202034,true,1683501649,28,1691601476,8099827
1678888571,202036,true,1683164999,28,1689910805,6745806
1678888583,202037,true,1682996700,28,1689910805,6914105
1678888595,202038,true,1682828417,28,1689741831,6913414
1678888631,202036,true,1683164999,28,1689403933,6238934
1678888655,202038,true,1682828417,28,1689066103,6237686
1678888907,202039,true,1682660151,28,1686197273,3537122
1678889231,202039,true,1682660151,28,1682996700,336549
1678889267,202038,true,1682828417,28,1682660151,-168266
1678889963,202040,true,1682491902,28,1679130449,-3361453
1678890095,202040,true,1682491902,28,1678458964,-4032938
1678890371,202041,true,1682323669,28,1677452241,-4871428
1678890407,202039,true,1682660151,28,1677452241,-5207910
1678890419,202040,true,1682491902,28,1677452241,-5039661
1678890443,202041,true,1682323669,28,1677452241,-4871428
1678890455,202042,true,1682155454,28,1677284513,-4870941
1678890479,202040,true,1682491902,28,1677284513,-5207389
1678890491,202042,true,1682155454,28,1677284513,-4870941
1678890623,202043,true,1681987255,28,1676613767,-5373488
1678890659,202043,true,1681987255,28,1676446122,-5541133
1678890671,202041,true,1682323669,28,1676446122,-5877547
1678890683,202043,true,1681987255,28,1676278494,-5708761
1678890695,202044,true,1681819073,28,1676278494,-5540579
1678890719,202043,true,1681987255,28,1676110883,-5876372
1678891139,202042,true,1682155454,28,1673431384,-8724070
1678891247,202043,true,1681987255,28,1672594919,-9392336
1678891259,202044,true,1681819073,28,1672594919,-9224154
1678891271,202044,true,1681819073,28,1672427676,-9391397
1678891283,202043,true,1681987255,28,1672260450,-9726805
1678891295,202045,true,1681650908,28,1672260450,-9390458
1678891307,202047,true,1681314628,28,1672093241,-9221387
1678891379,202048,true,1681146514,28,1670923244,-10223270
1678891403,202048,true,1681146514,28,1670589109,-10557405
1678891415,202051,true,1680642271,28,1670255042,-10387229
1678891427,202053,true,1680306193,28,1670088033,-10218160
1678891571,202055,true,1679970182,28,1667418162,-12552020
1678891871,202055,true,1679970182,28,1662091218,-17878964
1678891907,202059,true,1679298362,28,1661426547,-17871815
1678891943,202062,true,1678794673,28,1660762143,-18032530
1678891991,202063,true,1678626810,28,1660098004,-18528806
1678892027,202063,true,1678626810,28,1659434131,-19192679
1678892039,202067,true,1677955527,28,1659268204,-18687323
1678892075,202069,true,1677619987,28,1658770523,-18849464
1678892087,202070,true,1677452241,28,1658604663,-18847578
1678892159,202070,true,1677452241,28,1657609848,-19842393
1678892291,202073,true,1676949106,28,1656118745,-20830361
1678892303,202075,true,1676613767,28,1656118745,-20495022
1678892315,202076,true,1676446122,28,1655953150,-20492972
1678892363,202075,true,1676613767,28,1655622009,-20991758
1678892735,202077,true,1676278494,28,1653967297,-22311197
1678892927,202079,true,1675943289,28,1652975264,-22968025
1678893155,202080,true,1675775711,28,1652314239,-23461472
1678893299,202079,true,1675943289,28,1652809983,-23133306
1678893347,202081,true,1675608150,28,1652975264,-22632886
1678893503,202083,true,1675273079,28,1653636553,-21636526
1678893575,202084,true,1675105569,28,1653967297,-21138272
1678893587,202084,true,1675105569,28,1654132694,-20972875
1678893851,202085,true,1674938075,28,1655290934,-19647141
1678893875,202089,true,1674268267,28,1655290934,-18977333
1678894091,202092,true,1673766087,28,1654959925,-18806162
1678894463,202092,true,1673766087,28,1653636553,-20129534
1678894487,202094,true,1673431384,28,1653636553,-19794831
1678894535,202098,true,1672762179,28,1653305875,-19456304
1678894571,202101,true,1672260450,28,1653140561,-19119889
1678894583,202102,true,1672093241,28,1652975264,-19117977
1678894655,202105,true,1671591713,28,1652479470,-19112243
1678894667,202109,true,1670923244,28,1652479470,-18443774
1678894691,202113,true,1670255042,28,1652149024,-18106018
1678894787,202114,true,1670088033,28,1651488330,-18599703
1678894811,202117,true,1669587107,28,1651158081,-18429026
1678894907,202120,true,1669086331,28,1650167733,-18918598
1678894931,202124,true,1668418863,28,1650002733,-18416130
1678895123,202125,true,1668252038,28,1648188818,-20063220
1678895231,202128,true,1667751662,28,1647200251,-20551411
1678895243,202131,true,1667251437,28,1647200251,-20051186
1678895267,202134,true,1666751361,28,1647035548,-19715813
1678895651,202134,true,1666751361,28,1644402529,-22348832
1678895687,202135,true,1666584703,28,1644073698,-22511005
1678895723,202137,true,1666251436,28,1643744933,-22506503
1678895759,202140,true,1665751660,28,1643416233,-22335427
1678896095,202141,true,1665585102,28,1640624938,-24960164
1678896155,202143,true,1665252035,28,1640132849,-25119186
1678896215,202146,true,1664752559,28,1639640908,-25111651
1678896515,202149,true,1664253233,28,1637838385,-26414848
1678896551,202151,true,1663920433,28,1637674617,-26245816
1678896947,202152,true,1663754057,28,1637674617,-26079440
1678896959,202155,true,1663255031,28,1637674617,-25580414
1678896995,202158,true,1662756154,28,1637838385,-24917769
1678897619,202159,true,1662589895,28,1638329785,-24260110
1678897703,202161,true,1662257427,28,1638657468,-23599959
1678898423,202164,true,1661758849,28,1640624938,-21133911
1678898435,202167,true,1661260421,28,1640789001,-20471420
1678898447,202169,true,1660928219,28,1640789001,-20139218
1678898507,202171,true,1660596083,28,1640624938,-19971145
1678898519,202175,true,1659932011,28,1640624938,-19307073
1678898531,202179,true,1659268204,28,1640624938,-18643266
1678898555,202181,true,1658936400,28,1640624938,-18311462
1678898603,202184,true,1658438819,28,1640460892,-17977927
1678898639,202188,true,1657775609,28,1640132849,-17642760
1678899431,202193,true,1656946970,28,1632932477,-24014493
1678899851,202196,true,1656449985,28,1629018334,-27431651
1678899863,202199,true,1655953150,28,1628855448,-27097702
1678899875,202204,true,1655125421,28,1628692579,-26432842
1678899923,202209,true,1654298107,28,1628204069,-26094038
1678899983,202213,true,1653636553,28,1627715705,-25920848
1678899995,202215,true,1653305875,28,1627552950,-25752925
1678900007,202220,true,1652479470,28,1627390211,-25089259
1678900019,202224,true,1651818644,28,1627390211,-24428433
1678900259,202226,true,1651488330,28,1625926292,-25562038
1678900403,202228,true,1651158081,28,1625601155,-25556926
1678900415,202232,true,1650497783,28,1625601155,-24896628
1678900439,202237,true,1649672782,28,1625601155,-24071627
1678900547,202238,true,1649507831,28,1625926292,-23581539
1678900559,202240,true,1649177979,28,1626088885,-23089094
1678900775,202243,true,1648683325,28,1626902092,-21781233
1678900871,202248,true,1647859230,28,1627227488,-20631742
1678900907,202249,true,1647694461,28,1627390211,-20304250
1678901087,202250,true,1647529708,28,1628041265,-19488443
1678902083,202253,true,1647035548,28,1631789882,-15245666
1678902119,202257,true,1646376898,28,1631953061,-14423837
1678902143,202259,true,1646047672,28,1631953061,-14094611
1678902311,202260,true,1645883084,28,1631953061,-13930023
1678902323,202263,true,1645389418,28,1631953061,-13436357
1678902371,202268,true,1644566970,28,1631789882,-12777088
1678902383,202269,true,1644402529,28,1631789882,-12612647
1678902851,202271,true,1644073698,28,1630648085,-13425613
1678902971,202274,true,1643580575,28,1630322005,-13258570
1678902995,202278,true,1642923307,28,1630158989,-12764318
1678903019,202279,true,1642759031,28,1630158989,-12600042
1678903187,202280,true,1642594771,28,1629995989,-12598782
1678904159,202282,true,1642266302,28,1629507088,-12759214
1678904699,202286,true,1641609559,28,1630322005,-11287554
1678904747,202288,true,1641281287,28,1630485037,-10796250
1678904771,202289,true,1641117175,28,1630485037,-10632138
1678904783,202291,true,1640789001,28,1630485037,-10303964
1678904807,202294,true,1640296863,28,1630485037,-9811826
1678904843,202295,true,1640132849,28,1630648085,-9484764
1678904879,202295,true,1640132849,28,1630648085,-9484764
1678904891,202297,true,1639804872,28,1630811150,-8993722
1678904903,202301,true,1639149114,28,1630811150,-8337964
1678904915,202301,true,1639149114,28,1630811150,-8337964
1678904951,202300,true,1639313029,28,1630974231,-8338798
1678904975,202302,true,1638985215,28,1631137329,-7847886
1678905071,202304,true,1638657468,28,1631626719,-7030749
1678905083,202303,true,1638821333,28,1631789882,-7031451
1678905107,202302,true,1638985215,28,1631953061,-7032154
1678906103,202302,true,1638985215,28,1640624938,1639723
1678906235,202303,true,1638821333,28,1641773720,2952387
1678906247,202303,true,1638821333,28,1641937898,3116565
1678906271,202302,true,1638985215,28,1642102092,3116877
1678906283,202302,true,1638985215,28,1642266302,3281087
1678906487,202304,true,1638657468,28,1643580575,4923107
1678906511,202304,true,1638657468,28,1643744933,5087465
1678906523,202303,true,1638821333,28,1643744933,4923600
1678906559,202304,true,1638657468,28,1644073698,5416230
1678906799,202305,true,1638493618,28,1645389418,6895800
1678906835,202306,true,1638329785,28,1645553957,7224172
1678907411,202305,true,1638493618,28,1646047672,7554054
1678907771,202305,true,1638493618,28,1646047672,7554054
1678908263,202307,true,1638165969,28,1647035548,8869579
1678908335,202307,true,1638165969,28,1647364971,9199002
1678908347,202307,true,1638165969,28,1647364971,9199002
1678908539,202307,true,1638165969,28,1647859230,9693261
1678908551,202308,true,1638002168,28,1647859230,9857062
1678908563,202308,true,1638002168,28,1648024016,10021848
1678908611,202308,true,1638002168,28,1648188818,10186650
1678909163,202307,true,1638165969,28,1650662833,12496864
1678909235,202308,true,1638002168,28,1650992982,12990814
1678909283,202308,true,1638002168,28,1651158081,13155913
1678909295,202308,true,1638002168,28,1651158081,13155913
1678909331,202307,true,1638165969,28,1651323197,13157228
1678909343,202308,true,1638002168,28,1651323197,13321029
1678909355,202308,true,1638002168,28,1651323197,13321029
1678909427,202308,true,1638002168,28,1651323197,13321029
1678909439,202308,true,1638002168,28,1651323197,13321029
1678909583,202308,true,1638002168,28,1651488330,13486162
1678909859,202308,true,1638002168,28,1651323197,13321029
1678909895,202307,true,1638165969,28,1651323197,13157228
1678909919,202307,true,1638165969,28,1651323197,13157228
1678910399,202308,true,1638002168,28,1650167733,12165565
1678912523,202307,true,1638165969,28,1646212277,8046308
1678912631,202306,true,1638329785,28,1646376898,8047113
1678912643,202306,true,1638329785,28,1646376898,8047113
1678912655,202306,true,1638329785,28,1646376898,8047113
1678912871,202304,true,1638657468,28,1647200251,8542783
1678912907,202303,true,1638821333,28,1647364971,8543638
1678913087,202302,true,1638985215,28,1648024016,9038801
1678915163,202302,true,1638985215,28,1654298107,15312892
1678916519,202301,true,1639149114,28,1654463537,15314423
1678916531,202300,true,1639313029,28,1654463537,15150508
1678917611,202299,true,1639476960,28,1655290934,15813974
1678917827,202299,true,1639476960,28,1655787571,16310611
1678917839,202297,true,1639804872,28,1655787571,15982699
1678917851,202296,true,1639968852,28,1655787571,15818719
1678917887,202294,true,1640296863,28,1655953150,15656287
1678917899,202294,true,1640296863,28,1655953150,15656287
1678917911,202291,true,1640789001,28,1656118745,15329744
1678917995,202290,true,1640953080,28,1656615630,15662550
1678918451,202288,true,1641281287,28,1659268204,17986917
1678918499,202288,true,1641281287,28,1659600074,18318787
1678919423,202285,true,1641773720,28,1665252035,23478315
1678919435,202285,true,1641773720,28,1665252035,23478315
1678919447,202282,true,1642266302,28,1665418560,23152258
1678919483,202282,true,1642266302,28,1665418560,23152258
1678919687,202280,true,1642594771,28,1666084827,23490056
1678919711,202279,true,1642759031,28,1666251436,23492405
1678919723,202276,true,1643251908,28,1666084827,22832919
1678919747,202276,true,1643251908,28,1666084827,22832919
1678919807,202275,true,1643416233,28,1665918236,22502003
1678919819,202273,true,1643744933,28,1665751660,22006727
1678919843,202271,true,1644073698,28,1665585102,21511404
1678921511,202270,true,1644238106,28,1653636553,9398447
1678921595,202269,true,1644402529,28,1653471206,9068677
1678921727,202267,true,1644731426,28,1653471206,8739780
1678922159,202264,true,1645224895,28,1653801917,8577022
1678923263,202263,true,1645389418,28,1654298107,8908689
1678923275,202262,true,1645553957,28,1654463537,8909580
1678923443,202260,true,1645883084,28,1654628983,8745899
1678924907,202257,true,1646376898,28,1655953150,9576252
1678925123,202256,true,1646541536,28,1656118745,9577209
1678925759,202256,true,1646541536,28,1656118745,9577209
1678925915,202254,true,1646870861,28,1656118745,9247884
1678926035,202251,true,1647364971,28,1656118745,8753774
1678926071,202251,true,1647364971,28,1656284357,8919386
1678926203,202250,true,1647529708,28,1656449985,8920277
1678926311,202248,true,1647859230,28,1656615630,8756400
1678926839,202245,true,1648353637,28,1657941387,9587750
1678926875,202245,true,1648353637,28,1658107181,9753544
1678926887,202244,true,1648518473,28,1658107181,9588708
1678926911,202242,true,1648848193,28,1658107181,9258988
1678926923,202239,true,1649342897,28,1658107181,8764284
1678927475,202239,true,1649342897,28,1657941387,8598490
1678927571,202239,true,1649342897,28,1657775609,8432712
1678927643,202237,true,1649672782,28,1657775609,8102827
1678928231,202234,true,1650167733,28,1655787571,5619838
1678928303,202234,true,1650167733,28,1655622009,5454276
1678929311,202234,true,1650167733,28,1651818644,1650911
1678929347,202232,true,1650497783,28,1651818644,1320861
1678929371,202229,true,1650992982,28,1651818644,825662
1678929419,202229,true,1650992982,28,1651653478,660496
1678929443,202229,true,1650992982,28,1651488330,495348
1678929455,202228,true,1651158081,28,1651488330,330249
1678929719,202226,true,1651488330,28,1650167733,-1320597
1678929731,202226,true,1651488330,28,1650002733,-1485597
1678930259,202226,true,1651488330,28,1648353637,-3134693
1678930475,202225,true,1651653478,28,1647859230,-3794248
1678931723,202222,true,1652149024,28,1648024016,-4125008
1678932491,202223,true,1651983826,28,1648683325,-3300501
1678932503,202223,true,1651983826,28,1648683325,-3300501
1678933439,202221,true,1652314239,28,1650002733,-2311506
1678933607,202219,true,1652644718,28,1650332750,-2311968
1678933631,202219,true,1652644718,28,1650497783,-2146935
1678933715,202219,true,1652644718,28,1650662833,-1981885
1678933751,202218,true,1652809983,28,1650827899,-1982084
1678933907,202215,true,1653305875,28,1651323197,-1982678
1678935431,202216,true,1653140561,28,1654463537,1322976
1678936427,202216,true,1653140561,28,1654463537,1322976
1678936487,202215,true,1653305875,28,1654463537,1157662
1678936511,202214,true,1653471206,28,1654463537,992331
1678937291,202214,true,1653471206,28,1653801917,330711
1678938527,202215,true,1653305875,28,1652975264,-330611
1678938647,202214,true,1653471206,28,1652975264,-495942
1678941419,202212,true,1653801917,28,1652149024,-1652893
1678941491,202212,true,1653801917,28,1652149024,-1652893
1678941587,202213,true,1653636553,28,1652149024,-1487529
1678941611,202211,true,1653967297,28,1652149024,-1818273
1678941779,202210,true,1654132694,28,1651983826,-2148868
1678941923,202211,true,1653967297,28,1651653478,-2313819
1678942019,202212,true,1653801917,28,1651488330,-2313587
1678942355,202211,true,1653967297,28,1650827899,-3139398
1678942379,202210,true,1654132694,28,1650827899,-3304795
1678942607,202211,true,1653967297,28,1650167733,-3799564
1678943495,202212,true,1653801917,28,1648353637,-5448280
1678944119,202211,true,1653967297,28,1647859230,-6108067
1678944743,202210,true,1654132694,28,1647859230,-6273464
1678946699,202211,true,1653967297,28,1648518473,-5448824
1678946723,202212,true,1653801917,28,1648683325,-5118592
1678946735,202212,true,1653801917,28,1648683325,-5118592
1678947239,202211,true,1653967297,28,1649672782,-4294515
1678947455,202212,true,1653801917,28,1650002733,-3799184
1678949135,202213,true,1653636553,28,1652149024,-1487529
1678949219,202212,true,1653801917,28,1652149024,-1652893
1678949807,202212,true,1653801917,28,1652149024,-1652893
1678949867,202212,true,1653801917,28,1652314239,-1487678
1678949879,202213,true,1653636553,28,1652314239,-1322314
1678950071,202212,true,1653801917,28,1652644718,-1157199
1678950515,202210,true,1654132694,28,1653636553,-496141
1678950995,202210,true,1654132694,28,1654959925,827231
1678951583,202211,true,1653967297,28,1656615630,2648333
1678951607,202210,true,1654132694,28,1656615630,2482936
1678951715,202208,true,1654463537,28,1656946970,2483433
1678951823,202208,true,1654463537,28,1657112665,2649128
1678954067,202208,true,1654463537,28,1658936400,4472863
1678954871,202207,true,1654628983,28,1658936400,4307417
1678955039,202205,true,1654959925,28,1658936400,3976475
1678955423,202205,true,1654959925,28,1658936400,3976475
1678955603,202206,true,1654794446,28,1658936400,4141954
1678957655,202205,true,1654959925,28,1658936400,3976475
1678957679,202204,true,1655125421,28,1658936400,3810979
1678958039,202204,true,1655125421,28,1658604663,3479242
1678958087,202205,true,1654959925,28,1658604663,3644738
1678958123,202205,true,1654959925,28,1658604663,3644738
1678958291,202204,true,1655125421,28,1658272992,3147571
1678958303,202204,true,1655125421,28,1658272992,3147571
1678958375,202206,true,1654794446,28,1657941387,3146941
1678958399,202205,true,1654959925,28,1657941387,2981462
1678958459,202205,true,1654959925,28,1657609848,2649923
1678959047,202206,true,1654794446,28,1654794446,0
1678959719,202208,true,1654463537,28,1651653478,-2810059
1678959779,202208,true,1654463537,28,1651488330,-2975207
1678959791,202208,true,1654463537,28,1651488330,-2975207
1678959803,202210,true,1654132694,28,1651488330,-2644364
1678959827,202211,true,1653967297,28,1651488330,-2478967
1678959839,202211,true,1653967297,28,1651488330,-2478967
1678959863,202210,true,1654132694,28,1651488330,-2644364
1678960067,202211,true,1653967297,28,1652314239,-1653058
1678960847,202211,true,1653967297,28,1657444104,3476807
1678960859,202211,true,1653967297,28,1657444104,3476807
1678960871,202211,true,1653967297,28,1657609848,3642551
1678960883,202211,true,1653967297,28,1657609848,3642551
1678960895,202211,true,1653967297,28,1657775609,3808312
1678960907,202210,true,1654132694,28,1657775609,3642915
1678960943,202210,true,1654132694,28,1657941387,3808693
1678961471,202210,true,1654132694,28,1660098004,5965310
1678961939,202210,true,1654132694,28,1659766034,5633340
1678961951,202210,true,1654132694,28,1659766034,5633340
1678962707,202209,true,1654298107,28,1658272992,3974885
1678962719,202209,true,1654298107,28,1658272992,3974885
1678962947,202209,true,1654298107,28,1658936400,4638293
1678963103,202208,true,1654463537,28,1659268204,4804667
1678963151,202208,true,1654463537,28,1659434131,4970594
1678963163,202208,true,1654463537,28,1659434131,4970594
1678963175,202208,true,1654463537,28,1659434131,4970594
1678963535,202207,true,1654628983,28,1660430040,5801057
1678963595,202206,true,1654794446,28,1660596083,5801637
1678963631,202207,true,1654628983,28,1660762143,6133160
1678963667,202207,true,1654628983,28,1660928219,6299236
1678963679,202206,true,1654794446,28,1660928219,6133773
1678963691,202206,true,1654794446,28,1660928219,6133773
1678963727,202206,true,1654794446,28,1661094312,6299866
1678963775,202206,true,1654794446,28,1661260421,6465975
1678963787,202205,true,1654959925,28,1661260421,6300496
1678965239,202204,true,1655125421,28,1667751662,12626241
1678965299,202203,true,1655290934,28,1667918437,12627503
1678966367,202203,true,1655290934,28,1668085229,12794295
1678967867,202202,true,1655456463,28,1667751662,12295199
1678968239,202201,true,1655622009,28,1667751662,12129653
1678968251,202200,true,1655787571,28,1667751662,11964091
1678968455,202199,true,1655953150,28,1667584904,11631754
1678968467,202199,true,1655953150,28,1667584904,11631754
1678968551,202197,true,1656284357,28,1667418162,11133805
1678968587,202197,true,1656284357,28,1667418162,11133805
1678968863,202196,true,1656449985,28,1666751361,10301376
1678968983,202195,true,1656615630,28,1666418061,9802431
1678970027,202194,true,1656781292,28,1663255031,6473739
1678970591,202193,true,1656946970,28,1662257427,5310457
1678970675,202192,true,1657112665,28,1662257427,5144762
1678970687,202192,true,1657112665,28,1662257427,5144762
1678970735,202191,true,1657278376,28,1662091218,4812842
1678970747,202190,true,1657444104,28,1662091218,4647114
1678970951,202190,true,1657444104,28,1661592690,4148586
1678970963,202190,true,1657444104,28,1661592690,4148586
1678971131,202189,true,1657609848,28,1661094312,3484464
1678972607,202189,true,1657609848,28,1657278376,-331472
1678972631,202189,true,1657609848,28,1657278376,-331472
1678972679,202189,true,1657609848,28,1657112665,-497183
1678972751,202188,true,1657775609,28,1657112665,-662944
1678972775,202188,true,1657775609,28,1657112665,-662944
1678972787,202189,true,1657609848,28,1656946970,-662878
1678972811,202189,true,1657609848,28,1656946970,-662878
1678973291,202189,true,1657609848,28,1654794446,-2815402
1678973891,202189,true,1657609848,28,1652149024,-5460824
1678973939,202190,true,1657444104,28,1651983826,-5460278
1678974023,202190,true,1657444104,28,1651653478,-5790626
1678974035,202190,true,1657444104,28,1651653478,-5790626
1678974047,202190,true,1657444104,28,1651653478,-5790626
1678974803,202190,true,1657444104,28,1650167733,-7276371
1678974815,202190,true,1657444104,28,1650167733,-7276371
1678974839,202190,true,1657444104,28,1650332750,-7111354
1678974971,202189,true,1657609848,28,1650827899,-6781949
1678975151,202188,true,1657775609,28,1651488330,-6287279
1678975163,202188,true,1657775609,28,1651653478,-6122131
1678976243,202188,true,1657775609,28,1656284357,-1491252
1678976291,202187,true,1657941387,28,1656449985,-1491402
1678976387,202186,true,1658107181,28,1656615630,-1491551
1678977095,202186,true,1658107181,28,1657112665,-994516
1678977107,202186,true,1658107181,28,1657112665,-994516
1678977179,202186,true,1658107181,28,1657112665,-994516
1678978019,202185,true,1658272992,28,1657112665,-1160327
1678978043,202184,true,1658438819,28,1657112665,-1326154
1678978055,202184,true,1658438819,28,1657112665,-1326154
1678978139,202184,true,1658438819,28,1657444104,-994715
1678978211,202182,true,1658770523,28,1657609848,-1160675
1678978235,202182,true,1658770523,28,1657775609,-994914
1678978991,202182,true,1658770523,28,1661260421,2489898
1678979051,202182,true,1658770523,28,1661426547,2656024
1678979063,202180,true,1659102294,28,1661426547,2324253
1678981379,202180,true,1659102294,28,1662589895,3487601
1678982051,202180,true,1659102294,28,1662589895,3487601
1678982243,202180,true,1659102294,28,1662589895,3487601
1678982255,202178,true,1659434131,28,1662589895,3155764
1678982291,202179,true,1659268204,28,1662589895,3321691
1678982351,202179,true,1659268204,28,1662589895,3321691
1678982471,202179,true,1659268204,28,1662756154,3487950
1678983791,202177,true,1659600074,28,1664086825,4486751
1678984547,202178,true,1659434131,28,1663920433,4486302
1678984559,202178,true,1659434131,28,1663920433,4486302
1678989275,202178,true,1659434131,28,1662091218,2657087
1678989707,202177,true,1659600074,28,1662091218,2491144
1678990079,202177,true,1659600074,28,1661925025,2324951
1678993511,202177,true,1659600074,28,1661758849,2158775
1678993583,202177,true,1659600074,28,1661925025,2324951
1678993607,202176,true,1659766034,28,1661925025,2158991
1678993751,202176,true,1659766034,28,1662091218,2325184
1678993895,202176,true,1659766034,28,1662257427,2491393
1678993931,202176,true,1659766034,28,1662257427,2491393
1678994183,202174,true,1660098004,28,1662589895,2491891
1678994207,202174,true,1660098004,28,1662756154,2658150
1678994231,202173,true,1660264014,28,1662756154,2492140
1678994267,202173,true,1660264014,28,1662922430,2658416
1678994291,202170,true,1660762143,28,1662922430,2160287
1678994303,202170,true,1660762143,28,1663088722,2326579
1678994495,202169,true,1660928219,28,1664253233,3325014
1678994627,202168,true,1661094312,28,1665085526,3991214
1678994651,202166,true,1661426547,28,1665252035,3825488
1678994663,202166,true,1661426547,28,1665418560,3992013
1678994675,202165,true,1661592690,28,1665585102,3992412
1678994687,202164,true,1661758849,28,1665751660,3992811
1678994795,202161,true,1662257427,28,1667251437,4994010
1678994879,202160,true,1662423653,28,1668585705,6162052
1678995143,202159,true,1662589895,28,1672427676,9837781
1678995239,202159,true,1662589895,28,1673766087,11176192
1678995251,202155,true,1663255031,28,1673933464,10678433
1678997003,202156,true,1663088722,28,1682660151,19571429
1678997087,202154,true,1663421356,28,1682491902,19070546
1678997447,202153,true,1663587698,28,1682491902,18904204
1678998311,202150,true,1664086825,28,1682491902,18405077
1678999211,202150,true,1664086825,28,1682323669,18236844
1678999247,202149,true,1664253233,28,1682323669,18070436
1678999343,202148,true,1664419659,28,1682323669,17904010
1678999379,202145,true,1664919034,28,1682323669,17404635
1678999451,202146,true,1664752559,28,1682155454,17402895
1678999463,202145,true,1664919034,28,1682155454,17236420
1678999583,202144,true,1665085526,28,1681987255,16901729
1678999643,202141,true,1665585102,28,1681819073,16233971
1678999691,202142,true,1665418560,28,1681650908,16232348
1678999703,202142,true,1665418560,28,1681650908,16232348
1678999715,202141,true,1665585102,28,1681650908,16065806
1678999955,202139,true,1665918236,28,1680138179,14219943
1678999967,202140,true,1665751660,28,1680138179,14386519
1679000015,202140,true,1665751660,28,1679802202,14050542
1679000063,202140,true,1665751660,28,1679466291,13714631
1679000075,202138,true,1666084827,28,1679466291,13381464
1679000099,202139,true,1665918236,28,1679130449,13212213
1679000111,202140,true,1665751660,28,1679130449,13378789
1679000243,202141,true,1665585102,28,1677619987,12034885
1679000279,202139,true,1665918236,28,1677284513,11366277
1679000291,202140,true,1665751660,28,1677116801,11365141
1679000315,202141,true,1665585102,28,1676781428,11196326
1679000411,202142,true,1665418560,28,1675775711,10357151
1679001467,202140,true,1665751660,28,1663920433,-1831227
1679001479,202142,true,1665418560,28,1663920433,-1498127
1679001575,202142,true,1665418560,28,1663255031,-2163529
1679001587,202143,true,1665252035,28,1663255031,-1997004
1679001827,202140,true,1665751660,28,1662091218,-3660442
1679001875,202142,true,1665418560,28,1661925025,-3493535
1679002007,202142,true,1665418560,28,1662091218,-3327342
1679002043,202142,true,1665418560,28,1662257427,-3161133
1679002055,202140,true,1665751660,28,1662257427,-3494233
1679002187,202141,true,1665585102,28,1662589895,-2995207
1679002403,202141,true,1665585102,28,1663255031,-2330071
1679002415,202141,true,1665585102,28,1663255031,-2330071
1679003051,202138,true,1666084827,28,1665751660,-333167
1679003063,202139,true,1665918236,28,1665751660,-166576
1679003099,202138,true,1666084827,28,1666084827,0
1679003135,202139,true,1665918236,28,1666418061,499825
1679003903,202133,true,1666918036,28,1673431384,6513348
1679004095,202134,true,1666751361,28,1674770598,8019237
1679005979,202133,true,1666918036,28,1678626810,11708774
1679006099,202134,true,1666751361,28,1678626810,11875449
1679006183,202128,true,1667751662,28,1678626810,10875148
1679006675,202129,true,1667584904,28,1678291135,10706231
1679009975,202127,true,1667918437,28,1677452241,9533804
1679012951,202128,true,1667751662,28,1677452241,9700579
1679013035,202122,true,1668752563,28,1677452241,8699678
1679013095,202123,true,1668585705,28,1677452241,8866536
1679013191,202121,true,1668919439,28,1677284513,8365074
1679013203,202122,true,1668752563,28,1677284513,8531950
1679013395,202116,true,1669754065,28,1676949106,7195041
1679013467,202118,true,1669420165,28,1676949106,7528941
1679013539,202117,true,1669587107,28,1676781428,7194321
1679013575,202117,true,1669587107,28,1676613767,7026660
1679013611,202113,true,1670255042,28,1676446122,6191080
1679015015,202114,true,1670088033,28,1672260450,2172417
1679016047,202113,true,1670255042,28,1671758873,1503831
1679016107,202114,true,1670088033,28,1671926048,1838015
1679016551,202110,true,1670756168,28,1672093241,1337073
1679016563,202111,true,1670589109,28,1672093241,1504132
1679016575,202110,true,1670756168,28,1672260450,1504282
1679016875,202110,true,1670756168,28,1674100857,3344689
1679017151,202104,true,1671758873,28,1675943289,4184416
1679017163,202106,true,1671424571,28,1676110883,4686312
1679017211,202104,true,1671758873,28,1676446122,4687249
1679017223,202104,true,1671758873,28,1676446122,4687249
1679017247,202099,true,1672594919,28,1676613767,4018848
1679017259,202101,true,1672260450,28,1676781428,4520978
1679017271,202100,true,1672427676,28,1676781428,4353752
1679017355,202100,true,1672427676,28,1677452241,5024565
1679017367,202095,true,1673264058,28,1677619987,4355929
1679017499,202096,true,1673096748,28,1678794673,5697925
1679017943,202095,true,1673264058,28,1682491902,9227844
1679018015,202094,true,1673431384,28,1683164999,9733615
1679018027,202089,true,1674268267,28,1683333316,9065049
1679018267,202090,true,1674100857,28,1686028670,11927813
1679018339,202088,true,1674435694,28,1686871853,12436159
1679018459,202088,true,1674435694,28,1687884229,13448535
1679018807,202083,true,1675273079,28,1690248804,14975725
1679018819,202083,true,1675273079,28,1690248804,14975725
1679018831,202081,true,1675608150,28,1690417829,14809679
1679018843,202081,true,1675608150,28,1690586871,14978721
1679018867,202075,true,1676613767,28,1690755929,14142162
1679018879,202075,true,1676613767,28,1690925005,14311238
1679018939,202072,true,1677116801,28,1691770636,14653835
1679018987,202071,true,1677284513,28,1692447446,15162933
1679019047,202065,true,1678291135,28,1693124527,14833392
1679019059,202065,true,1678291135,28,1693293839,15002704
1679019083,202062,true,1678794673,28,1693632515,14837842
1679019323,202061,true,1678962552,28,1697023000,18060448
1679019467,202055,true,1679970182,28,1699230454,19260272
1679019767,202055,true,1679970182,28,1703824345,23854163
1679019791,202052,true,1680474223,28,1704165127,23690904
1679019803,202051,true,1680642271,28,1704335544,23693273
1679019827,202045,true,1681650908,28,1704676428,23025520
1679019839,202044,true,1681819073,28,1705017380,23198307
1679019959,202041,true,1682323669,28,1706893837,24570168
1679020415,202040,true,1682491902,28,1714420340,31928438
1679020439,202034,true,1683501649,28,1714763241,31261592
1679020451,202033,true,1683669999,28,1714934718,31264719
1679020931,202031,true,1684006750,28,1719399126,35392376
1679020943,202031,true,1684006750,28,1719399126,35392376
1679020955,202027,true,1684680454,28,1719571066,34890612
1679021003,202027,true,1684680454,28,1719743023,35062569
1679021039,202025,true,1685017407,28,1719743023,34725616
1679021051,202025,true,1685017407,28,1719743023,34725616
1679021063,202021,true,1685691515,28,1719743023,34051508
1679021087,202020,true,1685860084,28,1719743023,33882939
1679021195,202019,true,1686028670,28,1719571066,33542396
1679021303,202019,true,1686028670,28,1719227203,33198533
1679022479,202016,true,1686534529,28,1710481901,23947372
1679022491,202015,true,1686703183,28,1710310870,23607687
1679022563,202014,true,1686871853,28,1709968859,23097006
1679023631,202013,true,1687040540,28,1710995097,23954557
1679024543,202009,true,1687715458,28,1712878133,25162675
1679024555,202008,true,1687884229,28,1712878133,24993904
1679024567,202007,true,1688053018,28,1712878133,24825115
1679024675,202007,true,1688053018,28,1712878133,24825115
1679024855,202002,true,1688897213,28,1712706862,23809649
1679024867,202001,true,1689066103,28,1712706862,23640759
1679024975,202000,true,1689235009,28,1712535609,23300600
1679025251,202000,true,1689235009,28,1712021951,22786942
1679026271,201995,true,1690079796,28,1709968859,19889063
1679029523,201993,true,1690417829,28,1710139856,19722027
1679029703,201992,true,1690586871,28,1710139856,19552985
1679031215,201992,true,1690586871,28,1709285043,18698172
1679031227,201986,true,1691601476,28,1709114131,17512655
1679031251,201985,true,1691770636,28,1709114131,17343495
1679031263,201984,true,1691939813,28,1709114131,17174318
1679032151,201983,true,1692109007,28,1707747455,15638448
1679032163,201977,true,1693124527,28,1707747455,14622928
1679032367,201976,true,1693293839,28,1707918230,14624391
1679033819,201974,true,1693632515,28,1708943237,15310722
1679033963,201973,true,1693801878,28,1709114131,15312253
1679034227,201967,true,1694818413,28,1708943237,14124824
1679034275,201966,true,1694987895,28,1709114131,14126236
1679034815,201964,true,1695326910,28,1709968859,14641949
1679034863,201962,true,1695665992,28,1709968859,14302867
1679034875,201957,true,1696513995,28,1709968859,13454864
1679035139,201955,true,1696853314,28,1710824015,13970701
1679035235,201953,true,1697192702,28,1711166197,13973495
1679035247,201951,true,1697532158,28,1711166197,13634039
1679035283,201946,true,1698381093,28,1711337313,12956220
1679035355,201945,true,1698550932,28,1711679598,13128666
1679035367,201942,true,1699060548,28,1711850766,12790218
1679035427,201940,true,1699400377,28,1712193153,12792776
1679035439,201936,true,1700080239,28,1712193153,12112914
1679036099,201933,true,1700590314,28,1716822089,16231775
1679036111,201931,true,1700930449,28,1716822089,15891640
1679036123,201929,true,1701270652,28,1716993772,15723120
1679036135,201927,true,1701610923,28,1717165471,15554548
1679036159,201923,true,1702291670,28,1717337187,15045517
1679036183,201921,true,1702632145,28,1717508921,14876776
1679036327,201919,true,1702972689,28,1718883409,15910720
1679036591,201916,true,1703483632,28,1721635686,18152054
1679036699,201913,true,1703994728,28,1722496676,18501948
1679036783,201910,true,1704505977,28,1723185778,18679801
1679036975,201908,true,1704846896,28,1724564810,19717914
1679037383,201906,true,1705187882,28,1726290151,21102269
1679037455,201902,true,1705870059,28,1726462780,20592721
1679037527,201900,true,1706211250,28,1726635426,20424176
1679037575,201898,true,1706552510,28,1726635426,20082916
1679037647,201895,true,1707064527,28,1726635426,19570899
1679037695,201892,true,1707576697,28,1726808090,19231393
1679037731,201890,true,1707918230,28,1726808090,18889860
1679037887,201888,true,1708259830,28,1726635426,18375596
1679037899,201885,true,1708772360,28,1726635426,17863066
1679038487,201882,true,1709285043,28,1723530433,14245390
1679038499,201879,true,1709797879,28,1723530433,13732554
1679038979,201878,true,1709968859,28,1721291411,11322552
1679039747,201875,true,1710481901,28,1719399126,8917225
1679039819,201872,true,1710995097,28,1719399126,8404029
1679040431,201870,true,1711337313,28,1719399126,8061813
1679042027,201868,true,1711679598,28,1721119299,9439701
1679042447,201867,true,1711850766,28,1721291411,9440645
1679043095,201864,true,1712364372,28,1721291411,8927039
1679043263,201862,true,1712706862,28,1721291411,8584549
1679044439,201861,true,1712878133,28,1721119299,8241166
1679044463,201860,true,1713049421,28,1721119299,8069878
1679044847,201857,true,1713563387,28,1721119299,7555912
1679045075,201854,true,1714077507,28,1721119299,7041792
1679046815,201853,true,1714248915,28,1720603066,6354151
1679046827,201852,true,1714420340,28,1720603066,6182726
1679047031,201849,true,1714934718,28,1720603066,5668348
1679047043,201847,true,1715277722,28,1720775127,5497405
1679047415,201846,true,1715449250,28,1721635686,6186436
1679047451,201845,true,1715620794,28,1721807850,6187056
1679047583,201842,true,1716135532,28,1722324444,6188912
1679047691,201840,true,1716478776,28,1722668926,6190150
1679047715,201839,true,1716650424,28,1722841193,6190769
1679047751,201838,true,1716822089,28,1722841193,6019104
1679047763,201835,true,1717337187,28,1723013477,5676290
1679047787,201834,true,1717508921,28,1723185778,5676857
1679047799,201832,true,1717852440,28,1723185778,5333338
1679048087,201831,true,1718024225,28,1725254739,7230514
1679048519,201828,true,1718539684,28,1728190020,9650336
1679048603,201828,true,1718539684,28,1728708528,10168844
1679048615,201827,true,1718711538,28,1728708528,9996990
1679048627,201826,true,1718883409,28,1728881399,9997990
1679049575,201823,true,1719399126,28,1735116277,15717151
1679049635,201822,true,1719571066,28,1735289788,15718722
1679049671,201821,true,1719743023,28,1735289788,15546765
1679049683,201821,true,1719743023,28,1735463317,15720294
1679049755,201818,true,1720258997,28,1735636864,15377867
1679049767,201817,true,1720431023,28,1735636864,15205841
1679049803,201816,true,1720603066,28,1735810427,15207361
1679050091,201816,true,1720603066,28,1737373282,16770216
1679050427,201813,true,1721119299,28,1739459277,18339978
1679050511,201813,true,1721119299,28,1739807186,18687887
1679050667,201812,true,1721291411,28,1740677264,19385853
1679051363,201811,true,1721463540,28,1744336344,22872804
1679053343,201808,true,1721980031,28,1748003115,26023084
1679053463,201808,true,1721980031,28,1748527569,26547538
1679053979,201806,true,1722324444,28,1750802019,28477575
1679054075,201805,true,1722496676,28,1751152197,28655521
1679054171,201801,true,1723185778,28,1751677595,28491817
1679054207,201800,true,1723358097,28,1751852763,28494666
1679054219,201798,true,1723702786,28,1751852763,28149977
1679054267,201796,true,1724047544,28,1752203151,28155607
1679054279,201791,true,1724909740,28,1752378371,27468631
1679054291,201789,true,1725254739,28,1752378371,27123632
1679054363,201787,true,1725599807,28,1752904137,27304330
1679054375,201785,true,1725944944,28,1753079428,27134484
1679054807,201780,true,1726808090,28,1756588919,29780829
1679054831,201778,true,1727153468,28,1756764578,29611110
1679054927,201777,true,1727326184,28,1757291660,29965476
1679054951,201775,true,1727671666,28,1757467389,29795723
1679054999,201771,true,1728362839,28,1757643136,29280297
1679055191,201769,true,1728708528,28,1758522134,29813606
1679055203,201768,true,1728881399,28,1758522134,29640735
1679055347,201766,true,1729227193,28,1758522134,29294941
1679055383,201761,true,1730091979,28,1758522134,28430155
1679055479,201760,true,1730264989,28,1758522134,28257145
1679055527,201758,true,1730611059,28,1758346299,27735240
1679055755,201757,true,1730784120,28,1757818901,27034781
1679056199,201753,true,1731476538,28,1756062048,24585510
1679056211,201751,true,1731822850,28,1756062048,24239198
1679056223,201750,true,1731996032,28,1755886459,23890427
1679056235,201748,true,1732342449,28,1755886459,23544010
1679056547,201744,true,1733035490,28,1753605404,20569914
1679056559,201743,true,1733208793,28,1753605404,20396611
1679056595,201741,true,1733555453,28,1753254736,19699283
1679056631,201740,true,1733728808,28,1752904137,19175329
1679056679,201736,true,1734422404,28,1752553609,18131205
1679056691,201735,true,1734595846,28,1752378371,17782525
1679056811,201734,true,1734769305,28,1751152197,16382892
1679056835,201733,true,1734942782,28,1750802019,15859237
1679056955,201730,true,1735463317,28,1749751905,14288588
1679057651,201729,true,1735636864,28,1744161927,8525063
1679058215,201728,true,1735810427,28,1740851331,5040904
1679058239,201727,true,1735984008,28,1740677264,4693256
1679058587,201724,true,1736504856,28,1739981167,3476311
1679060159,201723,true,1736678506,28,1743813147,7134641
1679060171,201722,true,1736852174,28,1743813147,6960973
1679060975,201722,true,1736852174,28,1743115796,6263622
1679061239,201719,true,1737373282,28,1742592966,5219684
1679061311,201718,true,1737547019,28,1742418724,4871705
1679061803,201718,true,1737547019,28,1740851331,3304312
1679061911,201717,true,1737720774,28,1740677264,2956490
1679061983,201715,true,1738068335,28,1740503213,2434878
1679062415,201715,true,1738068335,28,1740503213,2434878
1679062607,201714,true,1738242142,28,1740329180,2087038
1679063207,201713,true,1738415966,28,1740677264,2261298
1679063219,201712,true,1738589808,28,1740677264,2087456
1679063231,201712,true,1738589808,28,1740677264,2087456
1679063315,201711,true,1738763667,28,1740503213,1739546
1679063327,201712,true,1738589808,28,1740503213,1913405
1679063363,201711,true,1738763667,28,1740503213,1739546
1679063375,201711,true,1738763667,28,1740503213,1739546
1679063411,201710,true,1738937543,28,1740329180,1391637
1679063723,201711,true,1738763667,28,1739111437,347770
1679063735,201710,true,1738937543,28,1738937543,0
1679063747,201709,true,1739111437,28,1738937543,-173894
1679063795,201709,true,1739111437,28,1738589808,-521629
1679063807,201710,true,1738937543,28,1738589808,-347735
1679063891,201708,true,1739285348,28,1737894546,-1390802
1679063927,201708,true,1739285348,28,1737720774,-1564574
1679063999,201708,true,1739285348,28,1737025859,-2259489
1679064023,201709,true,1739111437,28,1736678506,-2432931
1679064047,201708,true,1739285348,28,1736504856,-2780492
1679064131,201708,true,1739285348,28,1735289788,-3995560
1679064143,201708,true,1739285348,28,1735116277,-4169071
1679064263,201709,true,1739111437,28,1733382114,-5729323
1679064299,201708,true,1739285348,28,1732862204,-6423144
1679064539,201710,true,1738937543,28,1728535675,-10401868
1679064599,201710,true,1738937543,28,1727498916,-11438627
1679065091,201711,true,1738763667,28,1719399126,-19364541
1679065307,201711,true,1738763667,28,1716650424,-22113243
1679065991,201712,true,1738589808,28,1711850766,-26739042
1679066015,201712,true,1738589808,28,1711850766,-26739042
1679066075,201713,true,1738415966,28,1711850766,-26565200
1679066087,201712,true,1738589808,28,1711850766,-26739042
1679066207,201713,true,1738415966,28,1712193153,-26222813
1679066231,201713,true,1738415966,28,1712364372,-26051594
1679066255,201714,true,1738242142,28,1712535609,-25706533
1679066267,201713,true,1738415966,28,1712535609,-25880357
1679066747,201713,true,1738415966,28,1715620794,-22795172
1679066771,201714,true,1738242142,28,1715620794,-22621348
1679066795,201715,true,1738068335,28,1715792357,-22275978
1679066819,201714,true,1738242142,28,1715963936,-22278206
1679066879,201714,true,1738242142,28,1716135532,-22106610
1679067839,201716,true,1737894546,28,1719055298,-18839248
1679067851,201716,true,1737894546,28,1719055298,-18839248
1679069615,201716,true,1737894546,28,1717165471,-20729075
1679069627,201716,true,1737894546,28,1717165471,-20729075
1679069639,201718,true,1737547019,28,1717165471,-20381548
1679069651,201720,true,1737199562,28,1717165471,-20034091
1679071187,201719,true,1737373282,28,1719743023,-17630259
1679071223,201719,true,1737373282,28,1719743023,-17630259
1679072699,201721,true,1737025859,28,1718883409,-18142450
1679072783,201722,true,1736852174,28,1718883409,-17968765
1679073203,201722,true,1736852174,28,1719227203,-17624971
1679073239,201723,true,1736678506,28,1719399126,-17279380
1679073251,201724,true,1736504856,28,1719399126,-17105730
1679073287,201726,true,1736157607,28,1719571066,-16586541
1679074511,201724,true,1736504856,28,1727498916,-9005940
1679074607,201725,true,1736331223,28,1728017218,-8314005
1679074631,201726,true,1736157607,28,1728017218,-8140389
1679074871,201728,true,1735810427,28,1729054287,-6756140
1679074979,201727,true,1735984008,28,1729400116,-6583892
1679076443,201728,true,1735810427,28,1726808090,-9002337
1679076527,201730,true,1735463317,28,1726808090,-8655227
1679076599,201732,true,1735116277,28,1726808090,-8308187
1679076623,201731,true,1735289788,28,1726808090,-8481698
1679076635,201732,true,1735116277,28,1726635426,-8480851
1679076863,201735,true,1734595846,28,1726290151,-8305695
1679076911,201737,true,1734248979,28,1726290151,-7958828
1679076935,201738,true,1734075571,28,1726117539,-7958032
1679078855,201739,true,1733902181,28,1722152229,-11749952
1679078867,201742,true,1733382114,28,1722324444,-11057670
1679078891,201745,true,1732862204,28,1722324444,-10537760
1679078927,201746,true,1732688935,28,1722324444,-10364491
1679079023,201747,true,1732515683,28,1722496676,-10019007
1679079323,201749,true,1732169232,28,1723185778,-8983454
1679079395,201752,true,1731649685,28,1723358097,-8291588
1679079491,201753,true,1731476538,28,1723530433,-7946105
1679079539,201754,true,1731303407,28,1723875156,-7428251
1679079587,201756,true,1730957198,28,1724047544,-6909654
1679079887,201759,true,1730438015,28,1725254739,-5183276
1679079923,201759,true,1730438015,28,1725599807,-4838208
1679079935,201760,true,1730264989,28,1725599807,-4665182
1679079971,201761,true,1730091979,28,1725772367,-4319612
1679079983,201763,true,1729746013,28,1725944944,-3801069
1679080475,201763,true,1729746013,28,1729746013,0
1679080487,201764,true,1729573056,28,1729918988,345932
1679080523,201765,true,1729400116,28,1730264989,864873
1679080979,201766,true,1729227193,28,1734075571,4848378
1679080991,201766,true,1729227193,28,1734075571,4848378
1679081039,201766,true,1729227193,28,1734595846,5368653
1679083343,201767,true,1729054287,28,1742244500,13190213
1679084255,201768,true,1728881399,28,1742244500,13363101
1679084399,201767,true,1729054287,28,1742418724,13364437
1679084411,201767,true,1729054287,28,1742592966,13538679
1679084447,201769,true,1728708528,28,1742592966,13884438
1679084459,201769,true,1728708528,28,1742767226,14058698
1679084519,201766,true,1729227193,28,1743115796,13888603
1679084699,201766,true,1729227193,28,1743987529,14760336
1679084747,201766,true,1729227193,28,1744336344,15109151
1679084963,201767,true,1729054287,28,1745383207,16328920
1679085431,201764,true,1729573056,28,1747478819,17905763
1679085515,201764,true,1729573056,28,1748003115,18430059
1679085623,201764,true,1729573056,28,1748352733,18779677
1679085671,201764,true,1729573056,28,1748527569,18954513
1679085731,201762,true,1729918988,28,1748877292,18958304
1679085755,201762,true,1729918988,28,1748877292,18958304
1679085767,201763,true,1729746013,28,1748877292,19131279
1679085779,201763,true,1729746013,28,1748877292,19131279
1679085791,201761,true,1730091979,28,1748877292,18785313
1679085803,201761,true,1730091979,28,1748877292,18785313
1679085827,201762,true,1729918988,28,1749052179,19133191
1679086055,201763,true,1729746013,28,1748877292,19131279
1679087111,201761,true,1730091979,28,1744161927,14069948
1679088143,201761,true,1730091979,28,1743115796,13023817
1679088971,201762,true,1729918988,28,1744685228,14766240
1679089091,201762,true,1729918988,28,1744859697,14940709
1679089103,201760,true,1730264989,28,1744859697,14594708
1679089331,201760,true,1730264989,28,1745557745,15292756
1679089343,201760,true,1730264989,28,1745557745,15292756
1679089355,201760,true,1730264989,28,1745557745,15292756
1679089367,201757,true,1730784120,28,1745732301,14948181
1679089391,201756,true,1730957198,28,1745906874,14949676
1679089559,201754,true,1731303407,28,1748177916,16874509
1679089571,201753,true,1731476538,28,1748177916,16701378
1679089595,201750,true,1731996032,28,1748527569,16531537
1679089667,201749,true,1732169232,28,1749052179,16882947
1679089691,201748,true,1732342449,28,1749227085,16884636
1679089715,201747,true,1732515683,28,1749402007,16886324
1679089763,201745,true,1732862204,28,1749576948,16714744
1679089931,201744,true,1733035490,28,1750101873,17066383
1679089991,201743,true,1733208793,28,1750276883,17068090
1679090063,201742,true,1733382114,28,1750451911,17069797
1679090147,201740,true,1733728808,28,1750626956,16898148
1679090171,201738,true,1734075571,28,1750802019,16726448
1679090183,201737,true,1734248979,28,1750802019,16553040
1679090195,201735,true,1734595846,28,1750977099,16381253
1679090315,201731,true,1735289788,28,1751677595,16387807
1679090435,201729,true,1735636864,28,1752553609,16916745
1679090555,201727,true,1735984008,28,1753430061,17446053
1679090831,201725,true,1736331223,28,1755535335,19204112
1679090843,201721,true,1737025859,28,1755710888,18685029
1679090879,201719,true,1737373282,28,1756062048,18688766
1679091215,201717,true,1737720774,28,1758522134,20801360
1679091779,201715,true,1738068335,28,1760985665,22917330
1679091791,201711,true,1738763667,28,1761161764,22398097
1679092259,201709,true,1739111437,28,1763981737,24870300
1679092583,201706,true,1739633223,28,1765216895,25583672
1679092643,201704,true,1739981167,28,1765569956,25588789
1679092655,201700,true,1740677264,28,1765569956,24892692
1679092691,201699,true,1740851331,28,1765746513,24895182
1679092751,201696,true,1741373639,28,1766276290,24902651
1679092859,201693,true,1741896103,28,1767159605,25263502
1679092871,201689,true,1742592966,28,1767159605,24566639
1679092883,201687,true,1742941502,28,1767336321,24394819
1679092943,201683,true,1743638783,28,1767689806,24051023
1679092967,201681,true,1743987529,28,1767866575,23879046
1679093099,201677,true,1744685228,28,1768573827,23888599
1679093123,201675,true,1745034183,28,1768750685,23716502
1679093147,201672,true,1745557745,28,1768927560,23369815
1679093159,201669,true,1746081465,28,1769104452,23022987
1679093243,201665,true,1746780002,28,1769812200,23032198
1679093723,201663,true,1747129376,28,1774064638,26935262
1679093783,201659,true,1747828332,28,1774596911,26768579
1679093795,201656,true,1748352733,28,1774596911,26244178
1679093915,201652,true,1749052179,28,1775661935,26609756
1679093927,201650,true,1749402007,28,1775839501,26437494
1679094395,201647,true,1749926880,28,1779216635,29289755
1679094407,201644,true,1750451911,28,1779216635,28764724
1679094419,201642,true,1750802019,28,1779394556,28592537
1679094455,201640,true,1751152197,28,1779750453,28598256
1679094467,201636,true,1751852763,28,1779750453,27897690
1679094503,201633,true,1752378371,28,1780106421,27728050
1679094539,201630,true,1752904137,28,1780284431,27380294
1679094551,201627,true,1753430061,28,1780462460,27032399
1679094983,201622,true,1754306951,28,1785097453,30790502
1679095283,201618,true,1755008779,28,1787776975,32768196
1679095403,201615,true,1755535335,28,1788849909,33314574
1679095415,201612,true,1756062048,28,1788849909,32787861
1679095451,201607,true,1756940255,28,1789207697,32267442
1679095487,201604,true,1757467389,28,1789386618,31919229
1679095499,201601,true,1757994682,28,1789565557,31570875
1679095775,201598,true,1758522134,28,1791176810,32654676
1679095787,201593,true,1759401570,28,1791176810,31775240
1679096087,201590,true,1759929444,28,1793148090,33218646
1679096243,201587,true,1760457475,28,1794044843,33587368
1679096279,201585,true,1760809584,28,1794044843,33235259
1679096411,201580,true,1761690165,28,1793865457,32175292
1679096675,201577,true,1762218725,28,1792968793,30750068
1679098763,201574,true,1762747444,28,1790460518,27713074
1679098775,201572,true,1763100011,28,1790460518,27360507
1679098787,201567,true,1763981737,28,1790460518,26478781
1679098799,201564,true,1764510985,28,1790460518,25949533
1679099687,201564,true,1764510985,28,1784562031,20051046
1679099831,201562,true,1764863905,28,1783670018,18806113
1679099843,201557,true,1765746513,28,1783491669,17745156
1679100155,201555,true,1766099680,28,1782421948,16322268
1679100299,201554,true,1766276290,28,1782065517,15789227
1679100383,201552,true,1766629563,28,1781709158,15079595
1679100623,201547,true,1767513054,28,1781531005,14017951
1679100791,201545,true,1767866575,28,1782421948,14555373
1679100887,201545,true,1767866575,28,1783135024,15268449
1679100911,201542,true,1768396988,28,1783313337,14916349
1679100923,201538,true,1769104452,28,1783491669,14387217
1679100959,201535,true,1769635237,28,1783848385,14213148
1679100971,201533,true,1769989182,28,1784026770,14037588
1679100983,201531,true,1770343197,28,1784205172,13861975
1679101079,201524,true,1771582809,28,1785990181,14407372
1679101187,201521,true,1772114337,28,1788313362,16199025
1679101331,201520,true,1772291549,28,1791535063,19243514
1679101343,201518,true,1772646025,28,1791714217,19068192
1679101475,201511,true,1773887249,28,1794942045,21054796
1679101547,201507,true,1774596911,28,1796737795,22140884
1679101571,201506,true,1774774370,28,1797276870,22502500
1679101595,201503,true,1775306856,28,1797995889,22689033
1679101859,201495,true,1776727598,28,1805743529,29015931
1679101871,201490,true,1777616140,28,1806104696,28488556
1679101907,201489,true,1777793902,28,1807007929,29214027
1679101931,201486,true,1778327293,28,1807550086,29222793
1679101943,201478,true,1779750453,28,1807911614,28161161
1679102987,201474,true,1780462460,28,1828273017,47810557
1679103071,201473,true,1780640506,28,1828821554,48181048
1679103179,201469,true,1781352869,28,1829187336,47834467
1679103215,201461,true,1782778450,28,1829370255,46591805
1679103227,201457,true,1783491669,28,1829370255,45878586
1679104895,201456,true,1783670018,28,1823890642,40220624
1679105051,201453,true,1784205172,28,1823525918,39320746
1679105123,201445,true,1785633036,28,1823525918,37892882
1679105291,201441,true,1786347397,28,1823343584,36996187
1679105303,201441,true,1786347397,28,1823343584,36996187
1679105327,201438,true,1786883354,28,1823161268,36277914
1679105363,201431,true,1788134548,28,1823161268,35026720
1679105387,201427,true,1788849909,28,1823161268,34311359
1679105831,201427,true,1788849909,28,1821703395,32853486
1679105855,201426,true,1789028794,28,1821703395,32674601
1679105915,201420,true,1790102480,28,1821521243,31418763
1679105927,201417,true,1790639564,28,1821521243,30881679
1679106035,201416,true,1790818628,28,1821156993,30338365
1679106059,201415,true,1790997710,28,1821156993,30159283
1679106191,201408,true,1792251785,28,1821156993,28905208
1679106467,201404,true,1792968793,28,1821156993,28188200
1679106515,201403,true,1793148090,28,1820974896,27826806
1679106527,201400,true,1793686088,28,1820974896,27288808
1679107103,201393,true,1794942045,28,1820064681,25122636
1679107631,201390,true,1795480582,28,1820064681,24584099
1679107643,201389,true,1795660130,28,1820064681,24404551
1679107655,201387,true,1796019280,28,1820064681,24045401
1679107727,201380,true,1797276870,28,1819882693,22605823
1679107739,201378,true,1797636344,28,1819882693,22246349
1679107955,201378,true,1797636344,28,1818609284,20972940
1679108435,201376,true,1797995889,28,1815520429,17524540
1679109191,201370,true,1799074956,28,1812074388,12999432
1679109659,201367,true,1799614733,28,1810987523,11372790
1679110487,201368,true,1799434789,28,1810806443,11371654
1679110499,201366,true,1799794694,28,1810987523,11192829
1679110571,201360,true,1800874841,28,1810987523,10112682
1679110751,201358,true,1801235034,28,1811168622,9933588
1679110895,201358,true,1801235034,28,1811349739,10114705
1679111195,201356,true,1801595299,28,1811893198,10297899
1679112803,201350,true,1802676526,28,1815520429,12843903
1679113595,201348,true,1803037080,28,1814612941,11575861
1679113679,201348,true,1803037080,28,1814612941,11575861
1679113703,201347,true,1803217383,28,1814794403,11577020
1679114423,201341,true,1804299584,28,1816428371,12128787
1679115071,201340,true,1804480014,28,1818427442,13947428
1679115095,201340,true,1804480014,28,1818609284,14129270
1679115107,201339,true,1804660462,28,1818609284,13948822
1679115227,201333,true,1805743529,28,1818791145,13047616
1679115239,201332,true,1805924104,28,1818791145,12867041
1679115443,201332,true,1805924104,28,1818791145,12867041
1679115467,201331,true,1806104696,28,1818791145,12686449
1679116139,201326,true,1807007929,28,1816610014,9602085
1679116163,201324,true,1807369349,28,1816610014,9240665
1679116931,201325,true,1807188630,28,1813524555,6335925
1679116967,201324,true,1807369349,28,1813343220,5973871
1679117435,201319,true,1808273214,28,1812980606,4707392
1679117687,201318,true,1808454041,28,1812799326,4345285
1679117867,201319,true,1808273214,28,1812618064,4344850
1679117999,201318,true,1808454041,28,1812436821,3982780
1679118083,201313,true,1809358449,28,1812618064,3259615
1679118851,201311,true,1809720339,28,1812980606,3260267
1679119259,201312,true,1809539385,28,1813343220,3803835
1679120147,201311,true,1809720339,28,1813887278,4166939
1679121575,201307,true,1810444336,28,1814068666,3624330
1679124203,201306,true,1810625380,28,1814068666,3443286
1679124287,201308,true,1810263310,28,1814068666,3805356
1679125343,201307,true,1810444336,28,1814794403,4350067
1679125355,201304,true,1810987523,28,1814794403,3806880
1679125367,201302,true,1811349739,28,1814794403,3444664
1679125763,201304,true,1810987523,28,1816065140,5077617
1679126243,201302,true,1811349739,28,1817700253,6350514
1679127119,201299,true,1811893198,28,1820428712,8535514
1679127143,201298,true,1812074388,28,1820428712,8354324
1679127167,201299,true,1811893198,28,1820428712,8535514
1679127179,201297,true,1812255595,28,1820428712,8173117
1679127191,201294,true,1812799326,28,1820428712,7629386
1679127203,201293,true,1812980606,28,1820428712,7448106
1679127251,201294,true,1812799326,28,1820246688,7447362
1679127287,201292,true,1813161904,28,1820064681,6902777
1679127311,201290,true,1813524555,28,1819882693,6358138
1679127323,201289,true,1813705907,28,1819700723,5994816
1679127335,201290,true,1813524555,28,1819700723,6176168
1679127347,201289,true,1813705907,28,1819518771,5812864
1679127899,201287,true,1814068666,28,1814250073,181407
1679127947,201286,true,1814250073,28,1813887278,-362795
1679128271,201286,true,1814250073,28,1810806443,-3443630
1679128607,201284,true,1814612941,28,1807911614,-6701327
1679128643,201282,true,1814975882,28,1807730841,-7245041
1679129567,201281,true,1815157380,28,1806104696,-9052684
1679129615,201281,true,1815157380,28,1806285307,-8872073
1679129627,201280,true,1815338896,28,1806285307,-9053589
1679129639,201277,true,1815883552,28,1806465935,-9417617
1679129651,201276,true,1816065140,28,1806465935,-9599205
1679132879,201276,true,1816065140,28,1812799326,-3265814
1679133131,201275,true,1816246747,28,1812799326,-3447421
1679133623,201273,true,1816610014,28,1812799326,-3810688
1679134259,201272,true,1816791675,28,1813161904,-3629771
1679134307,201273,true,1816610014,28,1813161904,-3448110
1679134727,201272,true,1816791675,28,1813524555,-3267120
1679134799,201272,true,1816791675,28,1813524555,-3267120
1679134811,201272,true,1816791675,28,1813524555,-3267120
1679135471,201273,true,1816610014,28,1814612941,-1997073
1679135507,201272,true,1816791675,28,1814794403,-1997272
1679136419,201272,true,1816791675,28,1815701981,-1089694
1679136683,201273,true,1816610014,28,1816065140,-544874
1679137583,201274,true,1816428371,28,1816246747,-181624
1679137979,201274,true,1816428371,28,1816428371,0
1679138291,201276,true,1816065140,28,1816428371,363231
1679140091,201277,true,1815883552,28,1816428371,544819
1679141603,201278,true,1815701981,28,1816428371,726390
1679141915,201278,true,1815701981,28,1816428371,726390
1679141951,201279,true,1815520429,28,1816428371,907942
1679142023,201279,true,1815520429,28,1816428371,907942
1679142071,201280,true,1815338896,28,1816428371,1089475
1679142863,201280,true,1815338896,28,1814975882,-363014
1679143211,201282,true,1814975882,28,1814431498,-544384
1679143415,201282,true,1814975882,28,1814068666,-907216
1679143439,201282,true,1814975882,28,1814068666,-907216
1679143619,201282,true,1814975882,28,1814250073,-725809
1679143631,201283,true,1814794403,28,1814250073,-544330
1679143655,201283,true,1814794403,28,1814431498,-362905
1679143667,201283,true,1814794403,28,1814431498,-362905
1679144579,201280,true,1815338896,28,1825167748,9828852
1679144735,201281,true,1815157380,28,1826993737,11836357
1679144771,201280,true,1815338896,28,1827359154,12020258
1679144783,201280,true,1815338896,28,1827359154,12020258
1679144795,201277,true,1815883552,28,1827541890,11658338
1679144807,201278,true,1815701981,28,1827724645,12022664
1679145251,201278,true,1815701981,28,1831383569,15681588
1679145731,201278,true,1815701981,28,1831933039,16231058
1679145959,201275,true,1816246747,28,1831383569,15136822
1679145971,201276,true,1816065140,28,1831383569,15318429
1679146019,201276,true,1816065140,28,1831383569,15318429
1679146439,201276,true,1816065140,28,1829736147,13671007
1679146463,201274,true,1816428371,28,1829736147,13307776
1679146475,201275,true,1816246747,28,1829553192,13306445
1679146871,201275,true,1816246747,28,1828273017,12026270
1679147087,201276,true,1816065140,28,1827541890,11476750
1679147543,201273,true,1816610014,28,1825897925,9287911
1679149691,201274,true,1816428371,28,1823525918,7097547
1679150783,201273,true,1816610014,28,1824255438,7645424
1679150807,201273,true,1816610014,28,1824073031,7463017
1679151767,201270,true,1817155052,28,1823708271,6553219
1679151839,201271,true,1816973354,28,1823525918,6552564
1679151851,201271,true,1816973354,28,1823525918,6552564
1679151875,201271,true,1816973354,28,1823525918,6552564
1679151899,201268,true,1817518501,28,1823343584,5825083
1679152103,201270,true,1817155052,28,1822614429,5459377
1679152115,201269,true,1817336767,28,1822614429,5277662
1679152139,201270,true,1817155052,28,1822432185,5277133
1679152187,201268,true,1817518501,28,1822249960,4731459
1679153327,201270,true,1817155052,28,1815701981,-1453071
1679153339,201270,true,1817155052,28,1815701981,-1453071
1679153351,201270,true,1817155052,28,1815520429,-1634623
1679153627,201268,true,1817518501,28,1813161904,-4356597
1679153651,201272,true,1816791675,28,1812799326,-3992349
1679153711,201273,true,1816610014,28,1812074388,-4535626
1679153795,201273,true,1816610014,28,1811168622,-5441392
1679153807,201272,true,1816791675,28,1810987523,-5804152
1679154251,201277,true,1815883552,28,1805924104,-9959448
1679154275,201277,true,1815883552,28,1805562973,-10320579
1679154287,201278,true,1815701981,28,1805382435,-10319546
1679154323,201277,true,1815883552,28,1804840928,-11042624
1679154407,201282,true,1814975882,28,1803758403,-11217479
1679154539,201282,true,1814975882,28,1801955636,-13020246
1679154743,201283,true,1814794403,28,1799254864,-15539539
1679154767,201282,true,1814975882,28,1798895067,-16080815
1679155703,201286,true,1814250073,28,1790997710,-23252363
1679155727,201287,true,1814068666,28,1790818628,-23250038
1679155751,201287,true,1814068666,28,1790818628,-23250038
1679155799,201286,true,1814250073,28,1790818628,-23431445
1679156795,201290,true,1813524555,28,1792610253,-20914302
1679156831,201290,true,1813524555,28,1792789514,-20735041
1679156939,201291,true,1813343220,28,1792789514,-20553706
1679156951,201290,true,1813524555,28,1792789514,-20735041
1679156963,201294,true,1812799326,28,1792789514,-20009812
1679156975,201295,true,1812618064,28,1792789514,-19828550
1679157011,201296,true,1812436821,28,1792610253,-19826568
1679157023,201296,true,1812436821,28,1792610253,-19826568
1679157035,201301,true,1811530874,28,1792431010,-19099864
1679157071,201302,true,1811349739,28,1792072577,-19277162
1679157083,201305,true,1810806443,28,1791893388,-18913055
1679157095,201306,true,1810625380,28,1791714217,-18911163
1679157107,201311,true,1809720339,28,1791535063,-18185276
1679157119,201313,true,1809358449,28,1791355928,-18002521
1679157155,201317,true,1808634887,28,1790818628,-17816259
1679157431,201318,true,1808454041,28,1786168780,-22285261
1679157515,201322,true,1807730841,28,1784918962,-22811879
1679157587,201324,true,1807369349,28,1783670018,-23699331
1679157611,201327,true,1806827246,28,1783313337,-23513909
1679157647,201327,true,1806827246,28,1782778450,-24048796
1679157659,201332,true,1805924104,28,1782600190,-23323914
1679157671,201333,true,1805743529,28,1782421948,-23321581
1679157683,201335,true,1805382435,28,1782243724,-23138711
1679157695,201334,true,1805562973,28,1782243724,-23319249
1679157755,201337,true,1805021412,28,1781709158,-23312254
1679157779,201338,true,1804840928,28,1781531005,-23309923
1679157791,201340,true,1804480014,28,1781352869,-23127145
1679157815,201339,true,1804660462,28,1781174752,-23485710
1679157959,201341,true,1804299584,28,1780640506,-23659078
1679157971,201342,true,1804119172,28,1780640506,-23478666
1679157995,201344,true,1803758403,28,1780640506,-23117897
1679158019,201342,true,1804119172,28,1780640506,-23478666
1679158307,201343,true,1803938779,28,1781531005,-22407774
1679158331,201344,true,1803758403,28,1781531005,-22227398
1679158979,201347,true,1803217383,28,1785811600,-17405783
1679159339,201345,true,1803578045,28,1793148090,-10429955
1679159471,201346,true,1803397705,28,1795660130,-7737575
1679159771,201347,true,1803217383,28,1797995889,-5221494
1679159795,201350,true,1802676526,28,1797995889,-4680637
1679159843,201349,true,1802856794,28,1797995889,-4860905
1679159867,201349,true,1802856794,28,1797995889,-4860905
1679159891,201351,true,1802496277,28,1797816107,-4680170
1679160299,201354,true,1801955636,28,1796019280,-5936356
1679160311,201354,true,1801955636,28,1796019280,-5936356
1679160335,201354,true,1801955636,28,1795839696,-6115940
1679160431,201356,true,1801595299,28,1795301051,-6294248
1679160467,201360,true,1800874841,28,1795121539,-5753302
1679160527,201359,true,1801054928,28,1794762569,-6292359
1679160539,201360,true,1800874841,28,1794762569,-6112272
1679160551,201362,true,1800514720,28,1794583110,-5931610
1679160707,201366,true,1799794694,28,1793506737,-6287957
1679160719,201366,true,1799794694,28,1793327405,-6467289
1679160731,201366,true,1799794694,28,1793327405,-6467289
1679160743,201369,true,1799254864,28,1793148090,-6106774
1679160755,201373,true,1798535342,28,1792968793,-5566549
1679161163,201373,true,1798535342,28,1787598215,-10937127
1679161283,201374,true,1798355506,28,1785990181,-12365325
1679161511,201376,true,1797995889,28,1783491669,-14504220
1679161547,201381,true,1797097161,28,1783135024,-13962137
1679161763,201381,true,1797097161,28,1781174752,-15922409
1679161823,201382,true,1796917469,28,1780818570,-16098899
1679161895,201384,true,1796558139,28,1780462460,-16095679
1679162087,201389,true,1795660130,28,1779572496,-16087634
1679162099,201391,true,1795301051,28,1779572496,-15728555
1679162111,201392,true,1795121539,28,1779394556,-15726983
1679162255,201394,true,1794762569,28,1779038731,-15723838
1679162351,201399,true,1793865457,28,1779038731,-14826726
1679162375,201401,true,1793506737,28,1779038731,-14468006
1679162387,201401,true,1793506737,28,1779038731,-14468006
1679163143,201403,true,1793148090,28,1783313337,-9834753
1679163191,201407,true,1792431010,28,1783670018,-8760992
1679163275,201409,true,1792072577,28,1784205172,-7867405
1679163683,201410,true,1791893388,28,1786526031,-5367357
1679163719,201411,true,1791714217,28,1786704684,-5009533
1679164631,201415,true,1790997710,28,1789744513,-1253197
1679165807,201417,true,1790639564,28,1791355928,716364
1679165831,201417,true,1790639564,28,1791355928,716364
1679165855,201418,true,1790460518,28,1791355928,895410
1679165879,201421,true,1789923488,28,1791355928,1432440
1679165915,201423,true,1789565557,28,1791355928,1790371
1679165963,201423,true,1789565557,28,1791535063,1969506
1679166011,201424,true,1789386618,28,1791535063,2148445
1679166263,201427,true,1788849909,28,1792072577,3222668
1679166299,201429,true,1788492193,28,1792251785,3759592
1679166335,201428,true,1788671042,28,1792431010,3759968
1679166947,201429,true,1788492193,28,1794762569,6270376
1679167175,201432,true,1787955753,28,1795660130,7704377
1679167343,201433,true,1787776975,28,1796378501,8601526
1679168783,201432,true,1787955753,28,1798715195,10759442
1679168987,201432,true,1787955753,28,1798715195,10759442
1679169323,201436,true,1787240749,28,1798715195,11474446
1679170019,201437,true,1787062043,28,1798715195,11653152
1679170031,201435,true,1787419473,28,1798715195,11295722
1679170727,201435,true,1787419473,28,1798355506,10936033
1679170943,201439,true,1786704684,28,1798175688,11471004
1679172095,201440,true,1786526031,28,1797456598,10930567
1679172179,201437,true,1787062043,28,1797636344,10574301
1679172455,201437,true,1787062043,28,1797816107,10754064
1679172863,201439,true,1786704684,28,1798715195,12010511
1679172875,201439,true,1786704684,28,1798715195,12010511
1679173367,201436,true,1787240749,28,1799794694,12553945
1679173943,201436,true,1787240749,28,1800694771,13454022
1679174063,201438,true,1786883354,28,1800874841,13991487
1679174459,201438,true,1786883354,28,1800874841,13991487
1679174627,201433,true,1787776975,28,1800694771,12917796
1679174735,201433,true,1787776975,28,1800514720,12737745
1679174783,201436,true,1787240749,28,1800334686,13093937
1679175083,201436,true,1787240749,28,1799794694,12553945
1679175287,201432,true,1787955753,28,1799434789,11479036
1679175503,201432,true,1787955753,28,1799074956,11119203
1679175527,201435,true,1787419473,28,1798895067,11475594
1679175803,201434,true,1787598215,28,1798355506,10757291
1679175815,201431,true,1788134548,28,1798355506,10220958
1679175875,201431,true,1788134548,28,1798175688,10041140
1679175887,201434,true,1787598215,28,1797995889,10397674
1679175971,201435,true,1787419473,28,1797636344,10216871
1679175983,201432,true,1787955753,28,1797456598,9500845
1679176079,201432,true,1787955753,28,1796917469,8961716
1679176691,201434,true,1787598215,28,1793327405,5729190
1679176835,201434,true,1787598215,28,1792610253,5012038
1679178203,201430,true,1788313362,28,1787240749,-1072613
1679179163,201430,true,1788313362,28,1786883354,-1430008
1679179295,201431,true,1788134548,28,1786883354,-1251194
1679179307,201431,true,1788134548,28,1786883354,-1251194
1679179343,201427,true,1788849909,28,1786883354,-1966555
1679179379,201426,true,1789028794,28,1786704684,-2324110
1679179391,201427,true,1788849909,28,1786704684,-2145225
1679179403,201426,true,1789028794,28,1786704684,-2324110
1679179415,201423,true,1789565557,28,1786526031,-3039526
1679179487,201422,true,1789744513,28,1786168780,-3575733
1679180903,201424,true,1789386618,28,1777082962,-12303656
1679180939,201424,true,1789386618,28,1776905271,-12481347
1679181035,201421,true,1789923488,28,1776194687,-13728801
1679181047,201421,true,1789923488,28,1776017085,-13906403
1679181167,201423,true,1789565557,28,1775129343,-14436214
1679181527,201424,true,1789386618,28,1774242044,-15144574
1679181551,201422,true,1789744513,28,1774242044,-15502469
1679182079,201422,true,1789744513,28,1773532525,-16211988
1679182091,201424,true,1789386618,28,1773532525,-15854093
1679182115,201426,true,1789028794,28,1773532525,-15496269
1679182139,201424,true,1789386618,28,1773355189,-16031429
1679182199,201426,true,1789028794,28,1773000572,-16028222
1679182511,201429,true,1788492193,28,1771228546,-17263647
1679183063,201430,true,1788313362,28,1769104452,-19208910
1679183075,201431,true,1788134548,28,1768927560,-19206988
1679183087,201432,true,1787955753,28,1768927560,-19028193
1679183435,201435,true,1787419473,28,1767159605,-20259868
1679183471,201437,true,1787062043,28,1766982906,-20079137
1679184503,201438,true,1786883354,28,1763100011,-23783343
1679184527,201439,true,1786704684,28,1762923719,-23780965
1679184551,201443,true,1785990181,28,1762923719,-23066462
1679184587,201444,true,1785811600,28,1762923719,-22887881
1679184671,201444,true,1785811600,28,1762923719,-22887881
1679184803,201445,true,1785633036,28,1762923719,-22709317
1679184815,201448,true,1785097453,28,1762923719,-22173734
1679184827,201449,true,1784918962,28,1762923719,-21995243
1679184851,201449,true,1784918962,28,1762923719,-21995243
1679185475,201449,true,1784918962,28,1765923088,-18995874
1679185787,201451,true,1784562031,28,1767689806,-16872225
1679185883,201453,true,1784205172,28,1768220166,-15985006
1679185919,201452,true,1784383593,28,1768396988,-15986605
1679185943,201452,true,1784383593,28,1768573827,-15809766
1679185991,201453,true,1784205172,28,1769104452,-15100720
1679186015,201454,true,1784026770,28,1769281363,-14745407
1679186027,201453,true,1784205172,28,1769458291,-14746881
1679186159,201453,true,1784205172,28,1770874353,-13330819
1679188727,201453,true,1784205172,28,1782065517,-2139655
1679189495,201453,true,1784205172,28,1782065517,-2139655
1679189507,201452,true,1784383593,28,1782243724,-2139869
1679189531,201451,true,1784562031,28,1782243724,-2318307
1679189663,201451,true,1784562031,28,1782421948,-2140083
1679191451,201451,true,1784562031,28,1784740488,178457
1679191883,201450,true,1784740488,28,1784740488,0
1679192867,201450,true,1784740488,28,1784740488,0
1679198483,201450,true,1784740488,28,1784562031,-178457
1679198519,201450,true,1784740488,28,1784562031,-178457
1679201399,201450,true,1784740488,28,1785454491,714003
1679201459,201450,true,1784740488,28,1785454491,714003
1679201951,201450,true,1784740488,28,1785454491,714003
1679204327,201450,true,1784740488,28,1785454491,714003
1679206163,201450,true,1784740488,28,1785454491,714003
1679206991,201450,true,1784740488,28,1785454491,714003
1679207015,201450,true,1784740488,28,1785454491,714003
1679207039,201450,true,1784740488,28,1785454491,714003
1679207051,201450,true,1784740488,28,1785454491,714003
1679207171,201451,true,1784562031,28,1785275963,713932
1679207183,201452,true,1784383593,28,1785275963,892370
1679207555,201452,true,1784383593,28,1784562031,178438
1679208263,201452,true,1784383593,28,1782600190,-1783403
1679208335,201453,true,1784205172,28,1782421948,-1783224
1679208407,201454,true,1784026770,28,1782243724,-1783046
1679208419,201455,true,1783848385,28,1782243724,-1604661
1679208455,201455,true,1783848385,28,1782065517,-1782868
1679208491,201456,true,1783670018,28,1781887329,-1782689
1679209463,201457,true,1783491669,28,1779038731,-4452938
1679209487,201458,true,1783313337,28,1779038731,-4274606
1679209631,201458,true,1783313337,28,1778682976,-4630361
1679209787,201460,true,1782956728,28,1777971681,-4985047
1679209859,201462,true,1782600190,28,1777793902,-4806288
1679211227,201463,true,1782421948,28,1772823289,-9598659
1679211959,201464,true,1782243724,28,1772823289,-9420435
1679212403,201465,true,1782065517,28,1773177872,-8887645
1679212739,201467,true,1781709158,28,1773532525,-8176633
1679212943,201468,true,1781531005,28,1773709878,-7821127
1679213291,201468,true,1781531005,28,1774242044,-7288961
1679214059,201470,true,1781174752,28,1774951848,-6222904
1679214071,201472,true,1780818570,28,1774951848,-5866722
1679214131,201473,true,1780640506,28,1775129343,-5511163
1679214143,201473,true,1780640506,28,1775129343,-5511163
1679214767,201474,true,1780462460,28,1776549943,-3912517
1679216795,201476,true,1780106421,28,1779216635,-889786
1679216927,201477,true,1779928428,28,1779394556,-533872
1679218415,201477,true,1779928428,28,1779572496,-355932
1679221919,201478,true,1779750453,28,1779572496,-177957
1679223983,201480,true,1779394556,28,1779750453,355897
1679224019,201481,true,1779216635,28,1779750453,533818
1679224031,201481,true,1779216635,28,1779750453,533818
1679225615,201482,true,1779038731,28,1777616140,-1422591
1679226395,201484,true,1778682976,28,1777260670,-1422306
1679226479,201485,true,1778505126,28,1777438396,-1066730
1679226503,201485,true,1778505126,28,1777438396,-1066730
1679226515,201486,true,1778327293,28,1777438396,-888897
1679226623,201488,true,1777971681,28,1777616140,-355541
1679226755,201489,true,1777793902,28,1777793902,0
1679226791,201489,true,1777793902,28,1777793902,0
1679226803,201490,true,1777616140,28,1777971681,355541
1679226887,201491,true,1777438396,28,1778149478,711082
1679226971,201490,true,1777616140,28,1778505126,888986
1679227055,201490,true,1777616140,28,1778860845,1244705
1679227139,201490,true,1777616140,28,1779216635,1600495
1679227223,201492,true,1777260670,28,1779750453,2489783
1679227643,201491,true,1777438396,28,1782065517,4627121
1679227667,201490,true,1777616140,28,1782243724,4627584
1679227679,201490,true,1777616140,28,1782243724,4627584
1679227727,201491,true,1777438396,28,1782600190,5161794
1679227763,201490,true,1777616140,28,1782956728,5340588
1679227775,201489,true,1777793902,28,1783135024,5341122
1679228927,201489,true,1777793902,28,1791714217,13920315
1679228939,201489,true,1777793902,28,1791714217,13920315
1679228963,201488,true,1777971681,28,1791893388,13921707
1679229059,201487,true,1778149478,28,1792072577,13923099
1679231255,201486,true,1778327293,28,1790997710,12670417
1679231267,201486,true,1778327293,28,1790997710,12670417
1679231315,201484,true,1778682976,28,1790997710,12314734
1679231375,201484,true,1778682976,28,1790997710,12314734
1679231435,201483,true,1778860845,28,1790818628,11957783
1679231447,201483,true,1778860845,28,1790818628,11957783
1679233067,201482,true,1779038731,28,1785990181,6951450
1679233127,201481,true,1779216635,28,1785811600,6594965
1679236151,201481,true,1779216635,28,1784562031,5345396
1679236163,201481,true,1779216635,28,1784740488,5523853
1679236199,201479,true,1779572496,28,1784740488,5167992
1679236223,201478,true,1779750453,28,1784740488,4990035
1679236235,201477,true,1779928428,28,1784740488,4812060
1679237219,201476,true,1780106421,28,1787419473,7313052
1679237579,201475,true,1780284431,28,1788492193,8207762
1679237699,201474,true,1780462460,28,1788849909,8387449
1679238083,201472,true,1780818570,28,1789565557,8746987
1679238203,201471,true,1780996652,28,1789744513,8747861
1679238239,201469,true,1781352869,28,1789744513,8391644
1679238263,201468,true,1781531005,28,1789744513,8213508
1679238275,201466,true,1781887329,28,1789744513,7857184
1679238287,201465,true,1782065517,28,1789744513,7678996
1679238311,201463,true,1782421948,28,1789923488,7501540
1679238323,201461,true,1782778450,28,1790102480,7324030
1679238371,201459,true,1783135024,28,1790460518,7325494
1679238803,201457,true,1783491669,28,1794583110,11091441
1679238815,201454,true,1784026770,28,1794583110,10556340
1679239367,201454,true,1784026770,28,1797995889,13969119
1679239439,201453,true,1784205172,28,1798535342,14330170
1679239451,201451,true,1784562031,28,1798535342,13973311
1679241263,201449,true,1784918962,28,1797456598,12537636
1679241311,201449,true,1784918962,28,1797636344,12717382
1679241455,201448,true,1785097453,28,1797636344,12538891
1679241515,201446,true,1785454491,28,1797816107,12361616
1679242163,201444,true,1785811600,28,1799614733,13803133
1679242751,201444,true,1785811600,28,1801054928,15243328
1679242763,201443,true,1785990181,28,1801235034,15244853
1679242775,201442,true,1786168780,28,1801235034,15066254
1679242787,201440,true,1786526031,28,1801235034,14709003
1679243531,201439,true,1786704684,28,1803758403,17053719
1679243579,201439,true,1786704684,28,1803758403,17053719
1679243603,201437,true,1787062043,28,1803758403,16696360
1679243615,201436,true,1787240749,28,1803938779,16698030
1679243639,201435,true,1787419473,28,1803938779,16519306
1679243663,201434,true,1787598215,28,1804119172,16520957
1679243915,201431,true,1788134548,28,1806465935,18331387
1679243939,201429,true,1788492193,28,1806646582,18154389
1679244239,201428,true,1788671042,28,1810625380,21954338
1679244539,201426,true,1789028794,28,1814612941,25584147
1679244683,201423,true,1789565557,28,1816791675,27226118
1679244755,201421,true,1789923488,28,1817700253,27776765
1679244971,201419,true,1790281490,28,1820974896,30693406
1679245055,201417,true,1790639564,28,1822249960,31610396
1679245079,201414,true,1791176810,28,1822614429,31437619
1679245103,201412,true,1791535063,28,1822796690,31261627
1679245115,201410,true,1791893388,28,1822978970,31085582
1679245127,201408,true,1792251785,28,1823161268,30909483
1679245259,201405,true,1792789514,28,1824437864,31648350
1679245283,201403,true,1793148090,28,1824802769,31654679
1679245307,201402,true,1793327405,28,1824985250,31657845
1679245331,201399,true,1793865457,28,1825167748,31302291
1679245343,201397,true,1794224248,28,1825167748,30943500
1679245691,201396,true,1794403670,28,1825350265,30946595
1679245703,201394,true,1794762569,28,1825350265,30587696
1679245859,201392,true,1795121539,28,1824985250,29863711
1679245895,201390,true,1795480582,28,1824985250,29504668
1679246807,201388,true,1795839696,28,1820610755,24771059
1679246927,201386,true,1796198881,28,1819882693,23683812
1679247011,201383,true,1796737795,28,1819700723,22962928
1679247095,201381,true,1797097161,28,1819518771,22421610
1679248259,201379,true,1797456598,28,1818427442,20970844
1679248931,201377,true,1797816107,28,1817518501,19702394
1679248991,201374,true,1798355506,28,1817518501,19162995
1679249003,201372,true,1798715195,28,1817518501,18803306
1679249963,201370,true,1799074956,28,1816791675,17716719
1679250791,201369,true,1799254864,28,1816065140,16810276
1679250851,201366,true,1799794694,28,1816065140,16270446
1679250887,201364,true,1800154671,28,1816065140,15910469
1679251307,201362,true,1800514720,28,1816973354,16458634
1679251331,201360,true,1800874841,28,1816973354,16098513
1679252411,201358,true,1801235034,28,1820428712,19193678
1679252423,201355,true,1801775458,28,1820428712,18653254
1679252567,201354,true,1801955636,28,1820974896,19019260
1679252591,201351,true,1802496277,28,1821156993,18660716
1679252663,201349,true,1802856794,28,1821521243,18664449
1679252783,201346,true,1803397705,28,1821885565,18487860
1679252867,201344,true,1803758403,28,1822249960,18491557
1679252915,201342,true,1804119172,28,1822432185,18313013
1679253095,201339,true,1804660462,28,1823343584,18683122
1679253251,201336,true,1805201915,28,1824255438,19053523
1679253287,201334,true,1805562973,28,1824437864,18874891
1679253347,201332,true,1805924104,28,1824802769,18878665
1679253491,201328,true,1806646582,28,1825715353,19068771
1679253515,201325,true,1807188630,28,1825897925,18709295
1679253755,201323,true,1807550086,28,1827907417,20357331
1679253935,201321,true,1807911614,28,1829187336,21275722
1679254331,201318,true,1808454041,28,1832116232,23662191
1679254367,201315,true,1808996632,28,1832482673,23486041
1679254379,201313,true,1809358449,28,1832482673,23124224
1679254415,201311,true,1809720339,28,1832849188,23128849
1679254631,201307,true,1810444336,28,1834315981,23871645
1679254643,201304,true,1810987523,28,1834499413,23511890
1679254667,201303,true,1811168622,28,1834499413,23330791
1679254691,201300,true,1811712027,28,1834682863,22970836
1679254919,201298,true,1812074388,28,1835233322,23158934
1679254943,201295,true,1812618064,28,1835233322,22615258
1679255099,201294,true,1812799326,28,1835416846,22617520
1679255123,201292,true,1813161904,28,1835416846,22254942
1679255207,201290,true,1813524555,28,1835416846,21892291
1679255243,201287,true,1814068666,28,1835416846,21348180
1679255279,201287,true,1814068666,28,1835416846,21348180
1679255291,201285,true,1814431498,28,1835416846,20985348
1679255783,201282,true,1814975882,28,1833949173,18973291
1679255795,201279,true,1815520429,28,1833949173,18428744
1679255915,201279,true,1815520429,28,1833582438,18062009
1679256803,201277,true,1815883552,28,1830651198,14767646
1679256851,201274,true,1816428371,28,1830468151,14039780
1679256863,201271,true,1816973354,28,1830468151,13494797
1679256959,201270,true,1817155052,28,1829919121,12764069
1679257007,201269,true,1817336767,28,1829736147,12399380
1679258243,201267,true,1817700253,28,1823343584,5643331
1679258279,201264,true,1818245617,28,1823161268,4915651
1679258291,201263,true,1818427442,28,1823161268,4733826
1679258315,201262,true,1818609284,28,1822978970,4369686
1679258327,201260,true,1818973025,28,1822796690,3823665
1679258339,201259,true,1819154922,28,1822796690,3641768
1679258351,201258,true,1819336837,28,1822614429,3277592
1679258363,201257,true,1819518771,28,1822432185,2913414
1679258399,201257,true,1819518771,28,1821885565,2366794
1679258411,201256,true,1819700723,28,1821703395,2002672
1679258435,201255,true,1819882693,28,1821339109,1456416
1679258507,201256,true,1819700723,28,1819882693,181970
1679258531,201256,true,1819700723,28,1819518771,-181952
1679259119,201254,true,1820064681,28,1811168622,-8896059
1679259851,201255,true,1819882693,28,1802135832,-17746861
1679259887,201255,true,1819882693,28,1801595299,-18287394
1679259899,201256,true,1819700723,28,1801595299,-18105424
1679259911,201256,true,1819700723,28,1801415157,-18285566
1679259923,201256,true,1819700723,28,1801235034,-18465689
1679259947,201256,true,1819700723,28,1801054928,-18645795
1679259995,201256,true,1819700723,28,1800514720,-19186003
1679260091,201255,true,1819882693,28,1799794694,-20087999
1679260115,201255,true,1819882693,28,1799614733,-20267960
1679260127,201254,true,1820064681,28,1799614733,-20449948
1679260151,201255,true,1819882693,28,1799614733,-20267960
1679260163,201253,true,1820246688,28,1799614733,-20631955
1679260187,201253,true,1820246688,28,1799794694,-20451994
1679260199,201252,true,1820428712,28,1799794694,-20634018
1679260391,201252,true,1820428712,28,1801595299,-18833413
1679260439,201250,true,1820792816,28,1802135832,-18656984
1679260523,201250,true,1820792816,28,1802676526,-18116290
1679261435,201251,true,1820610755,28,1809720339,-10890416
1679261795,201251,true,1820610755,28,1812255595,-8355160
1679261843,201249,true,1820974896,28,1812255595,-8719301
1679261891,201249,true,1820974896,28,1812436821,-8538075
1679261915,201250,true,1820792816,28,1812436821,-8355995
1679262647,201251,true,1820610755,28,1810444336,-10166419
1679262659,201251,true,1820610755,28,1810263310,-10347445
1679262683,201251,true,1820610755,28,1810263310,-10347445
1679263331,201253,true,1820246688,28,1806104696,-14141992
1679263427,201256,true,1819700723,28,1805382435,-14318288
1679263835,201256,true,1819700723,28,1802856794,-16843929
1679263871,201257,true,1819518771,28,1802676526,-16842245
1679264159,201259,true,1819154922,28,1801775458,-17379464
1679264795,201262,true,1818609284,28,1801235034,-17374250
1679264867,201262,true,1818609284,28,1801235034,-17374250
1679264903,201262,true,1818609284,28,1801235034,-17374250
1679265035,201265,true,1818063811,28,1801415157,-16648654
1679265203,201267,true,1817700253,28,1801775458,-15924795
1679265671,201266,true,1817882023,28,1802676526,-15205497
1679265683,201267,true,1817700253,28,1802676526,-15023727
1679265731,201269,true,1817336767,28,1802856794,-14479973
1679266295,201270,true,1817155052,28,1804480014,-12675038
1679266715,201269,true,1817336767,28,1805743529,-11593238
1679267963,201268,true,1817518501,28,1807911614,-9606887
1679268023,201270,true,1817155052,28,1807911614,-9243438
1679268095,201272,true,1816791675,28,1808092405,-8699270
1679268131,201271,true,1816973354,28,1808092405,-8880949
1679268743,201271,true,1816973354,28,1808815750,-8157604
1679268959,201272,true,1816791675,28,1808996632,-7795043
1679269115,201274,true,1816428371,28,1809177532,-7250839
1679269175,201273,true,1816610014,28,1809177532,-7432482
1679269583,201272,true,1816791675,28,1809539385,-7252290
1679269595,201274,true,1816428371,28,1809539385,-6888986
1679269655,201276,true,1816065140,28,1809539385,-6525755
1679269679,201274,true,1816428371,28,1809539385,-6888986
1679269835,201274,true,1816428371,28,1809539385,-6888986
1679269871,201276,true,1816065140,28,1809358449,-6706691
1679269895,201278,true,1815701981,28,1809358449,-6343532
1679269943,201276,true,1816065140,28,1809177532,-6887608
1679269955,201276,true,1816065140,28,1809177532,-6887608
1679269979,201279,true,1815520429,28,1809177532,-6342897
1679270003,201281,true,1815157380,28,1808996632,-6160748
1679270015,201280,true,1815338896,28,1808996632,-6342264
1679270039,201280,true,1815338896,28,1808815750,-6523146
1679270051,201283,true,1814794403,28,1808815750,-5978653
1679270063,201286,true,1814250073,28,1808634887,-5615186
1679270075,201285,true,1814431498,28,1808634887,-5796611
1679270111,201287,true,1814068666,28,1808092405,-5976261
1679270159,201290,true,1813524555,28,1807550086,-5974469
1679270735,201294,true,1812799326,28,1800334686,-12464640
1679270747,201294,true,1812799326,28,1800154671,-12644655
1679270759,201295,true,1812618064,28,1799974674,-12643390
1679271275,201300,true,1811712027,28,1790818628,-20893399
1679271503,201304,true,1810987523,28,1787240749,-23746774
1679271515,201304,true,1810987523,28,1787062043,-23925480
1679271551,201306,true,1810625380,28,1786526031,-24099349
1679271575,201310,true,1809901311,28,1786168780,-23732531
1679272259,201315,true,1808996632,28,1781352869,-27643763
1679272379,201315,true,1808996632,28,1780996652,-27999980
1679272499,201317,true,1808634887,28,1780640506,-27994381
1679272583,201321,true,1807911614,28,1780640506,-27271108
1679272595,201326,true,1807007929,28,1780640506,-26367423
1679272667,201326,true,1807007929,28,1780996652,-26011277
1679272691,201328,true,1806646582,28,1780996652,-25649930
1679273243,201332,true,1805924104,28,1782956728,-22967376
1679273411,201336,true,1805201915,28,1783313337,-21888578
1679273423,201336,true,1805201915,28,1783313337,-21888578
1679273471,201338,true,1804840928,28,1783313337,-21527591
1679273495,201342,true,1804119172,28,1783313337,-20805835
1679273507,201346,true,1803397705,28,1783313337,-20084368
1679273519,201346,true,1803397705,28,1783313337,-20084368
1679273531,201348,true,1803037080,28,1783313337,-19723743
1679273639,201352,true,1802316045,28,1783135024,-19181021
1679273675,201356,true,1801595299,28,1783135024,-18460275
1679274179,201356,true,1801595299,28,1782243724,-19351575
1679274191,201358,true,1801235034,28,1782243724,-18991310
1679274503,201362,true,1800514720,28,1780818570,-19696150
1679274851,201367,true,1799614733,28,1779038731,-20576002
1679274863,201367,true,1799614733,28,1778860845,-20753888
1679274875,201369,true,1799254864,28,1778860845,-20394019
1679274887,201372,true,1798715195,28,1778860845,-19854350
1679274959,201375,true,1798175688,28,1778505126,-19670562
1679275715,201376,true,1797995889,28,1777082962,-20912927
1679275727,201378,true,1797636344,28,1777082962,-20553382
1679275943,201381,true,1797097161,28,1777082962,-20014199
1679279807,201383,true,1796737795,28,1782065517,-14672278
1679279819,201383,true,1796737795,28,1782065517,-14672278
1679279843,201384,true,1796558139,28,1782065517,-14492622
1679279855,201387,true,1796019280,28,1782065517,-13953763
1679279903,201388,true,1795839696,28,1781887329,-13952367
1679279915,201388,true,1795839696,28,1781887329,-13952367
1679279927,201389,true,1795660130,28,1781887329,-13772801
1679279951,201392,true,1795121539,28,1781709158,-13412381
1679279963,201393,true,1794942045,28,1781709158,-13232887
1679279999,201394,true,1794762569,28,1781352869,-13409700
1679280215,201395,true,1794583110,28,1779750453,-14832657
1679280239,201398,true,1794044843,28,1779394556,-14650287
1679280275,201400,true,1793686088,28,1779038731,-14647357
1679280287,201400,true,1793686088,28,1779038731,-14647357
1679280383,201403,true,1793148090,28,1777971681,-15176409
1679280587,201405,true,1792789514,28,1775839501,-16950013
1679280623,201408,true,1792251785,28,1775484387,-16767398
1679280647,201408,true,1792251785,28,1775306856,-16944929
1679280731,201411,true,1791714217,28,1774419469,-17294748
1679280863,201413,true,1791355928,28,1773355189,-18000739
1679280959,201416,true,1790818628,28,1772468778,-18349850
1679281151,201417,true,1790639564,28,1770874353,-19765211
1679281463,201419,true,1790281490,28,1768396988,-21884502
1679281655,201422,true,1789744513,28,1766982906,-22761607
1679282615,201425,true,1789207697,28,1767689806,-21517891
1679282711,201426,true,1789028794,28,1767689806,-21338988
1679282723,201429,true,1788492193,28,1767689806,-20802387
1679282735,201431,true,1788134548,28,1767689806,-20444742
1679283095,201436,true,1787240749,28,1765923088,-21317661
1679283107,201437,true,1787062043,28,1765746513,-21315530
1679283119,201440,true,1786526031,28,1765746513,-20779518
1679283503,201442,true,1786168780,28,1762571187,-23597593
1679284823,201446,true,1785454491,28,1754482382,-30972109
1679284895,201448,true,1785097453,28,1754482382,-30615071
1679284919,201450,true,1784740488,28,1754482382,-30258106
1679284931,201452,true,1784383593,28,1754482382,-29901211
1679284967,201455,true,1783848385,28,1754482382,-29366003
1679284979,201457,true,1783491669,28,1754482382,-29009287
1679285159,201460,true,1782956728,28,1754131538,-28825190
1679285783,201462,true,1782600190,28,1753430061,-29170129
1679285879,201465,true,1782065517,28,1753254736,-28810781
1679285927,201467,true,1781709158,28,1753254736,-28454422
1679286047,201470,true,1781174752,28,1753254736,-27920016
1679286203,201472,true,1780818570,28,1753254736,-27563834
1679289311,201474,true,1780462460,28,1759753468,-20708992
1679292059,201476,true,1780106421,28,1759753468,-20352953
1679292083,201479,true,1779572496,28,1759929444,-19643052
1679292179,201481,true,1779216635,28,1759929444,-19287191
1679292203,201483,true,1778860845,28,1759929444,-18931401
1679292251,201485,true,1778505126,28,1760105437,-18399689
1679292527,201488,true,1777971681,28,1760633521,-17338160
1679292971,201489,true,1777793902,28,1761690165,-16103737
1679293007,201492,true,1777260670,28,1761690165,-15570505
1679293019,201494,true,1776905271,28,1761866334,-15038937
1679295335,201497,true,1776372306,28,1764158135,-12214171
1679296271,201498,true,1776194687,28,1764863905,-11330782
1679296283,201501,true,1775661935,28,1764863905,-10798030
1679296295,201503,true,1775306856,28,1764863905,-10442951
1679296307,201506,true,1774774370,28,1764863905,-9910465
1679296319,201507,true,1774596911,28,1764863905,-9733006
1679296355,201509,true,1774242044,28,1765040391,-9201653
1679296427,201510,true,1774064638,28,1765393417,-8671221
1679296535,201513,true,1773532525,28,1765923088,-7609437
1679296955,201513,true,1773532525,28,1768220166,-5312359
1679297807,201515,true,1773177872,28,1772114337,-1063535
1679297819,201517,true,1772823289,28,1772291549,-531740
1679297843,201519,true,1772468778,28,1772468778,0
1679297891,201520,true,1772291549,28,1772646025,354476
1679297903,201521,true,1772114337,28,1772823289,708952
1679298047,201522,true,1771937144,28,1773709878,1772734
1679298059,201524,true,1771582809,28,1773709878,2127069
1679298083,201524,true,1771582809,28,1774064638,2481829
1679298095,201525,true,1771405669,28,1774064638,2658969
1679298143,201525,true,1771405669,28,1774419469,3013800
1679298167,201526,true,1771228546,28,1774596911,3368365
1679298179,201525,true,1771405669,28,1774596911,3191242
1679298227,201526,true,1771228546,28,1774951848,3723302
1679298335,201525,true,1771405669,28,1775839501,4433832
1679298707,201526,true,1771228546,28,1779216635,7988089
1679298851,201524,true,1771582809,28,1780640506,9057697
1679298935,201524,true,1771582809,28,1781531005,9948196
1679299247,201523,true,1771759968,28,1785275963,13515995
1679299259,201523,true,1771759968,28,1785454491,13694523
1679299271,201521,true,1772114337,28,1785633036,13518699
1679299307,201521,true,1772114337,28,1786168780,14054443
1679299523,201519,true,1772468778,28,1789386618,16917840
1679299535,201519,true,1772468778,28,1789565557,17096779
1679299547,201517,true,1772823289,28,1789744513,16921224
1679299583,201517,true,1772823289,28,1790281490,17458201
1679299883,201514,true,1773355189,28,1795660130,22304941
1679299895,201514,true,1773355189,28,1795839696,22484507
1679299931,201513,true,1773532525,28,1796198881,22666356
1679299943,201512,true,1773709878,28,1796378501,22668623
1679299991,201510,true,1774064638,28,1796737795,22673157
1679300051,201511,true,1773887249,28,1797276870,23389621
1679300063,201509,true,1774242044,28,1797276870,23034826
1679300087,201509,true,1774242044,28,1797456598,23214554
1679300099,201507,true,1774596911,28,1797456598,22859687
1679300195,201507,true,1774596911,28,1797816107,23219196
1679300219,201506,true,1774774370,28,1797995889,23221519
1679300243,201505,true,1774951848,28,1797995889,23044041
1679300255,201504,true,1775129343,28,1797995889,22866546
1679300267,201504,true,1775129343,28,1797995889,22866546
1679300423,201503,true,1775306856,28,1798175688,22868832
1679301407,201503,true,1775306856,28,1795660130,20353274
1679301419,201500,true,1775839501,28,1795660130,19820629
1679301443,201501,true,1775661935,28,1795480582,19818647
1679301455,201500,true,1775839501,28,1795301051,19461550
1679301623,201499,true,1776017085,28,1794403670,18386585
1679301635,201496,true,1776549943,28,1794224248,17674305
1679301659,201497,true,1776372306,28,1794044843,17672537
1679301731,201496,true,1776549943,28,1793686088,17136145
1679301935,201496,true,1776549943,28,1793148090,16598147
1679302103,201494,true,1776905271,28,1792968793,16063522
1679302523,201495,true,1776727598,28,1793327405,16599807
1679302751,201494,true,1776905271,28,1793686088,16780817
1679302943,201493,true,1777082962,28,1793865457,16782495
1679303087,201491,true,1777438396,28,1793865457,16427061
1679303231,201492,true,1777260670,28,1794044843,16784173
1679303255,201490,true,1777616140,28,1794044843,16428703
1679303267,201489,true,1777793902,28,1794044843,16250941
1679303927,201487,true,1778149478,28,1792431010,14281532
1679304143,201487,true,1778149478,28,1792072577,13923099
1679305019,201486,true,1778327293,28,1789923488,11596195
1679305031,201484,true,1778682976,28,1789923488,11240512
1679306555,201483,true,1778860845,28,1784383593,5522748
1679306963,201483,true,1778860845,28,1783313337,4452492
1679307263,201482,true,1779038731,28,1783491669,4452938
1679308271,201480,true,1779394556,28,1781887329,2492773
1679308835,201479,true,1779572496,28,1781174752,1602256
1679308847,201479,true,1779572496,28,1781174752,1602256
1679311079,201479,true,1779572496,28,1781709158,2136662
1679311091,201477,true,1779928428,28,1781887329,1958901
1679311103,201476,true,1780106421,28,1781887329,1780908
1679311163,201476,true,1780106421,28,1781887329,1780908
1679311175,201475,true,1780284431,28,1781887329,1602898
1679311259,201474,true,1780462460,28,1782065517,1603057
1679311319,201473,true,1780640506,28,1782065517,1425011
1679311331,201473,true,1780640506,28,1782065517,1425011
1679311511,201472,true,1780818570,28,1782600190,1781620
1679311523,201469,true,1781352869,28,1782600190,1247321
1679311595,201467,true,1781709158,28,1782778450,1069292
1679311751,201467,true,1781709158,28,1783313337,1604179
1679312783,201465,true,1782065517,28,1787062043,4996526
1679312807,201462,true,1782600190,28,1787240749,4640559
1679312819,201460,true,1782956728,28,1787240749,4284021
1679312879,201460,true,1782956728,28,1787240749,4284021
1679314823,201459,true,1783135024,28,1783135024,0
1679315027,201456,true,1783670018,28,1783135024,-534994
1679315519,201454,true,1784026770,28,1783135024,-891746
1679319083,201454,true,1784026770,28,1784026770,0
1679319299,201453,true,1784205172,28,1783848385,-356787
1679319323,201450,true,1784740488,28,1783848385,-892103
1679319335,201448,true,1785097453,28,1783848385,-1249068
1679319371,201448,true,1785097453,28,1783670018,-1427435
1679319383,201449,true,1784918962,28,1783491669,-1427293
1679319419,201448,true,1785097453,28,1783135024,-1962429
1679319479,201446,true,1785454491,28,1782600190,-2854301
1679320031,201447,true,1785275963,28,1776549943,-8726020
1679320943,201448,true,1785097453,28,1766452918,-18644535
1679320955,201447,true,1785275963,28,1766452918,-18823045
1679320967,201445,true,1785633036,28,1766276290,-19356746
1679320991,201447,true,1785275963,28,1766099680,-19176283
1679321003,201447,true,1785275963,28,1766099680,-19176283
1679321015,201445,true,1785633036,28,1766099680,-19533356
1679321267,201443,true,1785990181,28,1766276290,-19713891
1679321315,201444,true,1785811600,28,1766629563,-19182037
1679321375,201444,true,1785811600,28,1766982906,-18828694
1679321387,201443,true,1785990181,28,1766982906,-19007275
1679321423,201441,true,1786347397,28,1767159605,-19187792
1679321483,201442,true,1786168780,28,1767513054,-18655726
1679321507,201443,true,1785990181,28,1767689806,-18300375
1679322887,201443,true,1785990181,28,1771405669,-14584512
1679322935,201441,true,1786347397,28,1771228546,-15118851
1679322947,201443,true,1785990181,28,1771228546,-14761635
1679324267,201444,true,1785811600,28,1772291549,-13520051
1679324411,201443,true,1785990181,28,1772468778,-13521403
1679324435,201441,true,1786347397,28,1772646025,-13701372
1679325095,201443,true,1785990181,28,1774242044,-11748137
1679325143,201443,true,1785990181,28,1774419469,-11570712
1679325155,201443,true,1785990181,28,1774419469,-11570712
1679325227,201441,true,1786347397,28,1774596911,-11750486
1679326703,201443,true,1785990181,28,1775839501,-10150680
1679326811,201444,true,1785811600,28,1775839501,-9972099
1679327915,201443,true,1785990181,28,1775306856,-10683325
1679327939,201443,true,1785990181,28,1775306856,-10683325
1679327951,201445,true,1785633036,28,1775306856,-10326180
1679328599,201445,true,1785633036,28,1774064638,-11568398
1679328803,201446,true,1785454491,28,1773709878,-11744613
1679328815,201446,true,1785454491,28,1773709878,-11744613
1679328827,201448,true,1785097453,28,1773709878,-11387575
1679328851,201449,true,1784918962,28,1773532525,-11386437
1679328887,201450,true,1784740488,28,1773355189,-11385299
1679329151,201450,true,1784740488,28,1772291549,-12448939
1679329175,201453,true,1784205172,28,1772291549,-11913623
1679329187,201455,true,1783848385,28,1772114337,-11734048
1679329295,201456,true,1783670018,28,1771405669,-12264349
1679329859,201458,true,1783313337,28,1767689806,-15623531
1679329883,201461,true,1782778450,28,1767513054,-15265396
1679331395,201462,true,1782600190,28,1763628994,-18971196
1679331419,201464,true,1782243724,28,1763628994,-18614730
1679331431,201467,true,1781709158,28,1763628994,-18080164
1679331731,201470,true,1781174752,28,1763452649,-17722103
1679331803,201471,true,1780996652,28,1763276321,-17720331
1679331851,201473,true,1780640506,28,1763100011,-17540495
1679332043,201475,true,1780284431,28,1762747444,-17536987
1679332055,201478,true,1779750453,28,1762747444,-17003009
1679332091,201479,true,1779572496,28,1762571187,-17001309
1679332103,201481,true,1779216635,28,1762571187,-16645448
1679332547,201483,true,1778860845,28,1762218725,-16642120
1679332607,201485,true,1778505126,28,1762218725,-16286401
1679332631,201486,true,1778327293,28,1762218725,-16108568
1679332691,201488,true,1777971681,28,1762218725,-15752956
1679333855,201489,true,1777793902,28,1763805357,-13988545
1679334491,201491,true,1777438396,28,1764510985,-12927411
1679334923,201492,true,1777260670,28,1764687436,-12573234
1679335007,201493,true,1777082962,28,1764510985,-12571977
1679335223,201495,true,1776727598,28,1763805357,-12922241
1679335259,201497,true,1776372306,28,1763805357,-12566949
1679335319,201498,true,1776194687,28,1763452649,-12742038
1679335331,201501,true,1775661935,28,1763452649,-12209286
1679335343,201503,true,1775306856,28,1763452649,-11854207
1679335907,201505,true,1774951848,28,1760457475,-14494373
1679335967,201507,true,1774596911,28,1760105437,-14491474
1679336003,201509,true,1774242044,28,1759929444,-14312600
1679336327,201510,true,1774064638,28,1758522134,-15542504
1679336375,201513,true,1773532525,28,1758346299,-15186226
1679336387,201514,true,1773355189,28,1758346299,-15008890
1679336975,201516,true,1773000572,28,1756940255,-16060317
1679337059,201517,true,1772823289,28,1756940255,-15883034
1679337071,201520,true,1772291549,28,1756940255,-15351294
1679337083,201521,true,1772114337,28,1757115949,-14998388
1679337095,201523,true,1771759968,28,1757115949,-14644019
1679337359,201523,true,1771759968,28,1758346299,-13413669
1679337947,201525,true,1771405669,28,1760985665,-10420004
1679337959,201526,true,1771228546,28,1760985665,-10242881
1679337971,201528,true,1770874353,28,1760985665,-9888688
1679338235,201527,true,1771051441,28,1762218725,-8832716
1679338271,201529,true,1770697284,28,1762394947,-8302337
1679339735,201529,true,1770697284,28,1767866575,-2830709
1679339747,201531,true,1770343197,28,1767866575,-2476622
1679339891,201530,true,1770520231,28,1767866575,-2653656
1679339903,201532,true,1770166181,28,1767866575,-2299606
1679339951,201533,true,1769989182,28,1767866575,-2122607
1679339963,201534,true,1769812200,28,1767866575,-1945625
1679340131,201533,true,1769989182,28,1767513054,-2476128
1679340155,201535,true,1769635237,28,1767513054,-2122183
1679340167,201537,true,1769281363,28,1767513054,-1768309
1679340179,201538,true,1769104452,28,1767513054,-1591398
1679340191,201538,true,1769104452,28,1767336321,-1768131
1679340227,201540,true,1768750685,28,1767159605,-1591080
1679340239,201542,true,1768396988,28,1767159605,-1237383
1679340251,201544,true,1768043361,28,1767159605,-883756
1679340275,201544,true,1768043361,28,1766806226,-1237135
1679341607,201547,true,1767513054,28,1756588919,-10924135
1679341811,201549,true,1767159605,28,1755359799,-11799806
1679341859,201550,true,1766982906,28,1755008779,-11974127
1679342699,201550,true,1766982906,28,1755359799,-11623107
1679342723,201553,true,1766452918,28,1755359799,-11093119
1679343671,201554,true,1766276290,28,1757467389,-8808901
1679343695,201556,true,1765923088,28,1757467389,-8455699
1679343863,201555,true,1766099680,28,1757643136,-8456544
1679344283,201558,true,1765569956,28,1758346299,-7223657
1679344307,201559,true,1765393417,28,1758522134,-6871283
1679346107,201560,true,1765216895,28,1761514014,-3702881
1679346215,201560,true,1765216895,28,1761690165,-3526730
1679346287,201562,true,1764863905,28,1761690165,-3173740
1679346875,201562,true,1764863905,28,1762218725,-2645180
1679348723,201562,true,1764863905,28,1762923719,-1940186
1679348807,201561,true,1765040391,28,1762923719,-2116672
1679348879,201562,true,1764863905,28,1762923719,-1940186
1679349395,201562,true,1764863905,28,1762571187,-2292718
1679350007,201563,true,1764687436,28,1762218725,-2468711
1679350211,201562,true,1764863905,28,1762042521,-2821384
1679350283,201563,true,1764687436,28,1762042521,-2644915
1679350355,201563,true,1764687436,28,1761866334,-2821102
1679350403,201564,true,1764510985,28,1761866334,-2644651
1679350415,201565,true,1764334551,28,1761866334,-2468217
1679350475,201566,true,1764158135,28,1761690165,-2467970
1679350487,201567,true,1763981737,28,1761690165,-2291572
1679350499,201568,true,1763805357,28,1761690165,-2115192
1679351327,201568,true,1763805357,28,1760281447,-3523910
1679351519,201569,true,1763628994,28,1759929444,-3699550
1679352863,201570,true,1763452649,28,1758170482,-5282167
1679352899,201570,true,1763452649,28,1758170482,-5282167
1679353667,201571,true,1763276321,28,1757994682,-5281639
1679353679,201572,true,1763100011,28,1757994682,-5105329
1679353691,201573,true,1762923719,28,1757994682,-4929037
1679353703,201573,true,1762923719,28,1757994682,-4929037
1679353871,201574,true,1762747444,28,1757818901,-4928543
1679353919,201576,true,1762394947,28,1757818901,-4576046
1679353943,201577,true,1762218725,28,1757818901,-4399824
1679353955,201577,true,1762218725,28,1757643136,-4575589
1679353967,201578,true,1762042521,28,1757643136,-4399385
1679354027,201580,true,1761690165,28,1757643136,-4047029
1679354063,201581,true,1761514014,28,1757467389,-4046625
1679354159,201582,true,1761337880,28,1756940255,-4397625
1679354171,201583,true,1761161764,28,1756940255,-4221509
1679354183,201585,true,1760809584,28,1756764578,-4045006
1679354255,201587,true,1760457475,28,1756062048,-4395427
1679355731,201589,true,1760105437,28,1741199519,-18905918
1679355827,201590,true,1759929444,28,1740329180,-19600264
1679355839,201592,true,1759577511,28,1740155165,-19422346
1679355899,201594,true,1759225648,28,1739807186,-19418462
1679357711,201596,true,1758873856,28,1735984008,-22889848
1679357759,201596,true,1758873856,28,1736157607,-22716249
1679357771,201598,true,1758522134,28,1736157607,-22364527
1679357795,201600,true,1758170482,28,1736157607,-22012875
1679358071,201601,true,1757994682,28,1736678506,-21316176
1679358203,201601,true,1757994682,28,1737025859,-20968823
1679358215,201603,true,1757643136,28,1737199562,-20443574
1679358239,201605,true,1757291660,28,1737199562,-20092098
1679358275,201606,true,1757115949,28,1737373282,-19742667
1679358287,201605,true,1757291660,28,1737373282,-19918378
1679358683,201607,true,1756940255,28,1739285348,-17654907
1679358995,201608,true,1756764578,28,1741025416,-15739162
1679359019,201609,true,1756588919,28,1741199519,-15389400
1679359031,201608,true,1756764578,28,1741199519,-15565059
1679359043,201609,true,1756588919,28,1741373639,-15215280
1679359103,201610,true,1756413278,28,1741721931,-14691347
1679359115,201611,true,1756237654,28,1741721931,-14515723
1679359139,201611,true,1756237654,28,1741896103,-14341551
1679359295,201612,true,1756062048,28,1743115796,-12946252
1679359343,201613,true,1755886459,28,1743464437,-12422022
1679359583,201614,true,1755710888,28,1745383207,-10327681
1679359619,201614,true,1755710888,28,1745557745,-10153143
1679359643,201615,true,1755535335,28,1745732301,-9803034
1679359667,201616,true,1755359799,28,1746081465,-9278334
1679359703,201616,true,1755359799,28,1746430699,-8929100
1679360963,201615,true,1755535335,28,1756062048,526713
1679360987,201616,true,1755359799,28,1756062048,702249
1679360999,201616,true,1755359799,28,1756237654,877855
1679361143,201616,true,1755359799,28,1756764578,1404779
1679361167,201615,true,1755535335,28,1756764578,1229243
1679361191,201616,true,1755359799,28,1756940255,1580456
1679361203,201616,true,1755359799,28,1756940255,1580456
1679361227,201616,true,1755359799,28,1756940255,1580456
1679361923,201616,true,1755359799,28,1755359799,0
1679362859,201617,true,1755184280,28,1752203151,-2981129
1679362883,201617,true,1755184280,28,1752027948,-3156332
1679362895,201617,true,1755184280,28,1752027948,-3156332
1679362943,201618,true,1755008779,28,1752027948,-2980831
1679363459,201617,true,1755184280,28,1753079428,-2104852
1679364851,201617,true,1755184280,28,1756764578,1580298
1679366447,201618,true,1755008779,28,1756764578,1755799
1679367491,201619,true,1754833296,28,1756764578,1931282
1679367587,201619,true,1754833296,28,1756764578,1931282
1679368691,201619,true,1754833296,28,1756940255,2106959
1679368703,201619,true,1754833296,28,1756940255,2106959
1679369207,201620,true,1754657830,28,1756764578,2106748
1679369219,201620,true,1754657830,28,1756764578,2106748
1679369231,201621,true,1754482382,28,1756764578,2282196
1679369255,201622,true,1754306951,28,1756764578,2457627
1679369459,201623,true,1754131538,28,1756588919,2457381
1679369723,201623,true,1754131538,28,1756237654,2106116
1679370983,201623,true,1754131538,28,1755008779,877241
1679374871,201624,true,1753956143,28,1754657830,701687
1679376719,201625,true,1753780765,28,1754131538,350773
1679376815,201625,true,1753780765,28,1754131538,350773
1679376827,201625,true,1753780765,28,1754131538,350773
1679376863,201626,true,1753605404,28,1754131538,526134
1679376947,201627,true,1753430061,28,1753956143,526082
1679377043,201627,true,1753430061,28,1753780765,350704
1679377055,201627,true,1753430061,28,1753780765,350704
1679377331,201628,true,1753254736,28,1753254736,0
1679377547,201628,true,1753254736,28,1752553609,-701127
1679377583,201628,true,1753254736,28,1752553609,-701127
1679377619,201628,true,1753254736,28,1752378371,-876365
1679377631,201629,true,1753079428,28,1752378371,-701057
1679377655,201630,true,1752904137,28,1752203151,-700986
1679377703,201629,true,1753079428,28,1752203151,-876277
1679378663,201630,true,1752904137,28,1749052179,-3851958
1679378759,201631,true,1752728864,28,1748877292,-3851572
1679379347,201632,true,1752553609,28,1748003115,-4550494
1679379863,201631,true,1752728864,28,1747653567,-5075297
1679382455,201632,true,1752553609,28,1747129376,-5424233
1679382467,201633,true,1752378371,28,1747129376,-5248995
1679382479,201635,true,1752027948,28,1747129376,-4898572
1679382491,201634,true,1752203151,28,1747129376,-5073775
1679382503,201636,true,1751852763,28,1747129376,-4723387
1679382647,201639,true,1751327312,28,1746256073,-5071239
1679382671,201640,true,1751152197,28,1746081465,-5070732
1679382767,201640,true,1751152197,28,1745383207,-5768990
1679382851,201642,true,1750802019,28,1744685228,-6116791
1679382863,201644,true,1750451911,28,1744685228,-5766683
1679382935,201646,true,1750101873,28,1743987529,-6114344
1679383007,201646,true,1750101873,28,1743290108,-6811765
1679383751,201648,true,1749751905,28,1736157607,-13594298
1679383835,201651,true,1749227085,28,1735463317,-13763768
1679383859,201652,true,1749052179,28,1735289788,-13762391
1679385995,201652,true,1749052179,28,1734075571,-14976608
1679387039,201654,true,1748702421,28,1734595846,-14106575
1679387459,201656,true,1748352733,28,1734942782,-13409951
1679387471,201657,true,1748177916,28,1734942782,-13235134
1679387483,201656,true,1748352733,28,1734942782,-13409951
1679387495,201658,true,1748003115,28,1734942782,-13060333
1679388671,201660,true,1747653567,28,1738068335,-9585232
1679388779,201661,true,1747478819,28,1738415966,-9062853
1679389475,201660,true,1747653567,28,1739807186,-7846381
1679389907,201662,true,1747304089,28,1739981167,-7322922
