Timestamp,OAT,Success,Quote,Observations,Regular_Quote,Difference
1633991729,-185959,true,8400536475,22,8524077788,123541313
1633991866,-185961,true,8398856620,22,8522373228,123516608
1633991914,-185961,true,8398856620,22,8521521076,122664456
1633992043,-185955,true,8403897194,22,8541142149,137244955
1633992121,-185947,true,8410622665,22,8557384933,146762268
1633992184,-185946,true,8411463727,22,8569373062,157909335
1633992313,-185945,true,8412304874,22,8592540473,180235599
1633992334,-185939,true,8417353519,22,8596837602,179484083
1633992371,-185933,true,8422405194,22,8601996995,179591801
1633992429,-185933,true,8422405194,22,8608881001,186475807
1633992445,-185934,true,8421563037,22,8611463924,189900887
1633992523,-185928,true,8426617239,22,8624390166,197772927
1633992640,-185920,true,8433360892,22,8641655342,208294450
1633992695,-185920,true,8433360892,22,8645112523,211751631
1633992756,-185921,true,8432517641,22,8647706316,215188675
1633992786,-185915,true,8437578416,22,8649435944,211857528
1633992966,-185910,true,8441798049,22,8635608602,193810553
1633993005,-185910,true,8441798049,22,8632155222,190357173
1633993016,-185912,true,8440109943,22,8631292093,191182150
1633993080,-185906,true,8445175275,22,8627840439,182665164
1633993098,-185901,true,8449398707,22,8626977742,177579035
1633993198,-185901,true,8449398707,22,8623527813,174129106
1633993205,-185900,true,8450243647,22,8623527813,173284166
1633993245,-185894,true,8455315061,22,8621803366,166488305
1633993297,-185889,true,8459543564,22,8621803366,162259802
1633993332,-185889,true,8459543564,22,8621803366,162259802
1633993480,-185888,true,8460389518,22,8622665546,162276028
1633993499,-185882,true,8465467021,22,8620941272,155474251
1633993597,-185877,true,8469700602,22,8619217342,149516740
1633993614,-185876,true,8470547572,22,8619217342,148669770
1633993654,-185876,true,8470547572,22,8619217342,148669770
1633993721,-185872,true,8473936299,22,8614047621,140111322
1633993790,-185868,true,8477326382,22,8609741889,132415507
1633993918,-185868,true,8477326382,22,8601996995,124670613
1633994025,-185869,true,8476478734,22,8590822222,114343488
1633994063,-185865,true,8479869834,22,8587386753,107516919
1633994123,-185861,true,8483262291,22,8582236123,98973832
1633994162,-185860,true,8484110617,22,8580519934,96409317
1633994175,-185860,true,8484110617,22,8580519934,96409317
1633994229,-185854,true,8489202356,22,8580519934,91317578
1633994273,-185848,true,8494297151,22,8578804087,84506936
1633994362,-185847,true,8495146581,22,8575373423,80226842
1633994433,-185847,true,8495146581,22,8574515971,79369390
1633994462,-185839,true,8501945077,22,8574515971,72570894
1633994499,-185832,true,8507898225,22,8573658606,65760381
1633994734,-185827,true,8512153025,22,8607159483,95006458
1633995649,-185829,true,8510450849,22,8601996995,91546146
1633995720,-185821,true,8517261593,22,8606298853,89037260
1633995782,-185814,true,8523225465,22,8611463924,88238459
1633995801,-185811,true,8525782689,22,8610602864,84820175
1633996045,-185814,true,8523225465,22,8601996995,78771530
1633996097,-185809,true,8527487931,22,8603717480,76229549
1633996141,-185803,true,8532605703,22,8600276853,67671150
1633996188,-185800,true,8535165740,22,8597697286,62531546
1633996273,-185804,true,8531752527,22,8591681305,59928778
1633996318,-185799,true,8536019257,22,8589104316,53085059
1633996320,-185792,true,8541996263,22,8589104316,47108053
1633996400,-185788,true,8545413574,22,8587386753,41973179
1633996438,-185791,true,8542850463,22,8586528100,43677637
1633996557,-185785,true,8547977455,22,8580519934,32542479
1633996736,-185780,true,8552252298,22,8565946170,13693872
1633996867,-185776,true,8555673712,22,8565089661,9415949
1633996953,-185780,true,8552252298,22,8565089661,12837363
1633997004,-185776,true,8555673712,22,8568516210,12842498
1633997064,-185772,true,8559096495,22,8576230960,17134465
1633997225,-185766,true,8564233237,22,8592540473,28307236
1633997458,-185769,true,8561664481,22,8605438310,43773829
1633997694,-185764,true,8565946170,22,8620941272,54995102
1633997701,-185756,true,8572801325,22,8620079264,47277939
1633997786,-185750,true,8577946292,22,8620941272,42994980
1633997852,-185752,true,8576230960,22,8622665546,46434586
1633998033,-185748,true,8579661967,22,8603717480,24055513
1633998246,-185741,true,8585669533,22,8588245491,2575958
1633998291,-185735,true,8590822222,22,8584811052,-6011170
1633998442,-185740,true,8586528100,22,8555673712,-30854388
1633998591,-185742,true,8584811052,22,8526635267,-58175785
1633998839,-185742,true,8584811052,22,8491749372,-93061680
1633998902,-185736,true,8589963226,22,8484110617,-105852609
1633999174,-185740,true,8586528100,22,8488353521,-98174579
1633999187,-185743,true,8583952656,22,8488353521,-95599135
1633999271,-185742,true,8584811052,22,8498545149,-86265903
1633999427,-185736,true,8589963226,22,8520669009,-69294217
1633999430,-185737,true,8589104316,22,8520669009,-68435307
1633999492,-185739,true,8587386753,22,8529193513,-58193240
1633999530,-185738,true,8588245491,22,8533458963,-54786528
1633999552,-185732,true,8593399727,22,8536019257,-57380470
1633999573,-185735,true,8590822222,22,8537726546,-53095676
1633999592,-185737,true,8589104316,22,8539434177,-49670139
1633999692,-185737,true,8589104316,22,8547977455,-41126861
1633999763,-185732,true,8593399727,22,8554818231,-38581496
1633999887,-185735,true,8590822222,22,8555673712,-35148510
1633999951,-185739,true,8587386753,22,8552252298,-35134455
1633999995,-185741,true,8585669533,22,8552252298,-33417235
1634000034,-185738,true,8588245491,22,8552252298,-35993193
1634000089,-185741,true,8585669533,22,8552252298,-33417235
1634000121,-185744,true,8583094347,22,8553107524,-29986823
1634000162,-185747,true,8580519934,22,8548832252,-31687682
1634000221,-185745,true,8582236123,22,8541142149,-41093974
1634000327,-185749,true,8578804087,22,8527487931,-51316156
1634000373,-185752,true,8576230960,22,8528340679,-47890281
1634000430,-185755,true,8573658606,22,8528340679,-45317927
1634000515,-185751,true,8577088583,22,8531752527,-45336056
1634000554,-185753,true,8575373423,22,8532605703,-42767720
1634000728,-185756,true,8572801325,22,8536872859,-35928466
1634000894,-185757,true,8571944131,22,8536872859,-35071272
1634000908,-185754,true,8574515971,22,8536019257,-38496714
1634000972,-185755,true,8573658606,22,8541142149,-32516457
1634001025,-185757,true,8571944131,22,8545413574,-26530557
1634001100,-185755,true,8573658606,22,8564233237,-9425369
1634001155,-185752,true,8576230960,22,8577088583,857623
1634001219,-185753,true,8575373423,22,8589104316,13730893
1634001258,-185755,true,8573658606,22,8593399727,19741121
1634001333,-185754,true,8574515971,22,8598557056,24041085
1634001430,-185749,true,8578804087,22,8619217342,40413255
1634001541,-185750,true,8577946292,22,8641655342,63709050
1634001567,-185751,true,8577088583,22,8647706316,70617733
1634001662,-185748,true,8579661967,22,8667617935,87955968
1634001685,-185744,true,8583094347,22,8671952610,88858263
1634001722,-185743,true,8583952656,22,8679760490,95807834
1634002042,-185743,true,8583952656,22,8719777356,135824700
1634002126,-185739,true,8587386753,22,8729373908,141987155
1634002138,-185734,true,8591681305,22,8731119871,139438566
1634002189,-185732,true,8593399727,22,8736359852,142960125
1634002476,-185734,true,8591681305,22,8726755620,135074315
1634002616,-185730,true,8595118493,22,8728501058,133382565
1634002667,-185725,true,8599416912,22,8729373908,129956996
1634002781,-185724,true,8600276853,22,8729373908,129097055
1634003041,-185726,true,8598557056,22,8722393551,123836495
1634003153,-185724,true,8600276853,22,8720649334,120372481
1634003223,-185719,true,8604577852,22,8729373908,124796056
1634003304,-185718,true,8605438310,22,8732866182,127427872
1634003575,-185722,true,8601996995,22,8711062373,109065378
1634003761,-185721,true,8602857194,22,8673687088,70829894
1634003788,-185720,true,8603717480,22,8669351545,65634065
1634003823,-185718,true,8605438310,22,8663285425,57847115
1634003837,-185725,true,8599416912,22,8660686960,61270048
1634003910,-185725,true,8599416912,22,8648571087,49154175
1634004110,-185722,true,8601996995,22,8613186303,11189308
1634004205,-185720,true,8603717480,22,8593399727,-10317753
1634004310,-185726,true,8598557056,22,8583952656,-14604400
1634004328,-185725,true,8599416912,22,8582236123,-17180789
1634004348,-185722,true,8601996995,22,8580519934,-21477061
1634004395,-185719,true,8604577852,22,8576230960,-28346892
1634004625,-185725,true,8599416912,22,8571087022,-28329890
1634004633,-185723,true,8601136881,22,8571087022,-30049859
1634004765,-185723,true,8601136881,22,8559096495,-42040386
1634004820,-185721,true,8602857194,22,8553962834,-48894360
1634004838,-185729,true,8595978005,22,8555673712,-40304293
1634004903,-185725,true,8599416912,22,8563376900,-36040012
1634005136,-185719,true,8604577852,22,8583094347,-21483505
1634005724,-185716,true,8607159483,22,8656357915,49198432
1634005968,-185724,true,8600276853,22,8657223551,56946698
1634005984,-185722,true,8601996995,22,8657223551,55226556
1634006034,-185718,true,8605438310,22,8658089273,52650963
1634006112,-185716,true,8607159483,22,8653761527,46602044
1634006136,-185724,true,8600276853,22,8652896237,52619384
1634006201,-185722,true,8601996995,22,8649435944,47438949
1634006275,-185718,true,8605438310,22,8645112523,39674213
1634006319,-185716,true,8607159483,22,8641655342,34495859
1634006365,-185723,true,8601136881,22,8638199544,37062663
1634006485,-185718,true,8605438310,22,8644248098,38809788
1634006516,-185713,true,8609741889,22,8645112523,35370634
1634006628,-185709,true,8613186303,22,8644248098,31061795
1634006661,-185714,true,8608881001,22,8642519508,33638507
1634006692,-185708,true,8614047621,22,8641655342,27607721
1634006829,-185703,true,8618355507,22,8638199544,19844037
1634007033,-185701,true,8620079264,22,8639927270,19848006
1634007136,-185706,true,8615770517,22,8650300887,34530370
1634007155,-185702,true,8619217342,22,8652896237,33678895
1634007233,-185698,true,8622665546,22,8664151754,41486208
1634007338,-185693,true,8626977742,22,8671085502,44107760
1634007391,-185698,true,8622665546,22,8673687088,51021542
1634007554,-185694,true,8626115130,22,8689313002,63197872
1634007591,-185689,true,8630429050,22,8686706730,56277680
1634007641,-185685,true,8633881740,22,8691050952,57169212
1634007756,-185689,true,8630429050,22,8699745915,69316865
1634007818,-185686,true,8633018438,22,8700615889,67597451
1634007911,-185681,true,8637335811,22,8703226335,65890524
1634007956,-185677,true,8640791263,22,8704096658,63305395
1634008199,-185680,true,8638199544,22,8706708148,68508604
1634008483,-185677,true,8640791263,22,8712804672,72013409
1634008570,-185672,true,8645112523,22,8703226335,58113812
1634008748,-185670,true,8646841632,22,8687575400,40733768
1634009180,-185676,true,8641655342,22,8634745128,-6910214
1634009320,-185673,true,8644248098,22,8615770517,-28477581
1634009353,-185667,true,8649435944,22,8612325070,-37110874
1634009624,-185663,true,8652896237,22,8619217342,-33678895
1634009770,-185668,true,8648571087,22,8632155222,-16415865
1634009800,-185665,true,8651165917,22,8635608602,-15557315
1634009830,-185660,true,8655492366,22,8637335811,-18156555
1634009917,-185657,true,8658089273,22,8640791263,-17298010
1634010011,-185663,true,8652896237,22,8645977034,-6919203
1634010543,-185651,true,8663285425,22,8807408172,144122747
1634010631,-185645,true,8668484696,22,8820628536,152143840
1634010654,-185641,true,8671952610,22,8826804829,154852219
1634010757,-185646,true,8667617935,22,8860408814,192790879
1634010778,-185638,true,8674554456,22,8866612961,192058505
1634010813,-185631,true,8680628466,22,8876371114,195742648
1634010854,-185628,true,8683232915,22,8885251480,202018565
1634010861,-185635,true,8677157083,22,8886140005,208982922
1634010907,-185627,true,8684101239,22,8895030145,210928906
1634011027,-185623,true,8687575400,22,8885251480,197676080
1634011104,-185621,true,8689313002,22,8880810187,191497185
1634011267,-185629,true,8682364679,22,8871047154,188682475
1634011354,-185622,true,8688444158,22,8864839905,176395747
1634011370,-185617,true,8692789249,22,8863067202,170277953
1634011400,-185615,true,8694527894,22,8861294855,166766961
1634011425,-185623,true,8687575400,22,8859522862,171947462
1634011586,-185618,true,8691920057,22,8849783231,157863174
1634011625,-185613,true,8696266886,22,8842706590,146439704
1634011846,-185612,true,8697136513,22,8825922236,128785723
1634012251,-185613,true,8696266886,22,8900368498,204101612
1634012627,-185606,true,8702356099,22,8970059328,267703229
1634012765,-185601,true,8706708148,22,8990713175,284005027
1634012936,-185599,true,8708449577,22,8979931329,271481752
1634013039,-185601,true,8706708148,22,8974545255,267837107
1634013086,-185594,true,8712804672,22,8972750615,259945943
1634013095,-185590,true,8716290317,22,8972750615,256460298
1634013138,-185586,true,8719777356,22,8970956334,251178978
1634013157,-185587,true,8718905466,22,8970059328,251153862
1634013216,-185578,true,8726755620,22,8967368849,240613229
1634013333,-185573,true,8731119871,22,8965575644,234455773
1634013368,-185568,true,8735486304,22,8964679176,229192872
1634013396,-185567,true,8736359852,22,8961990310,225630458
1634013577,-185560,true,8742477139,22,8942296587,199819448
1634013613,-185556,true,8745974655,22,8939614434,193639779
1634013809,-185552,true,8749473569,22,8922646140,173172571
1634013852,-185550,true,8751223551,22,8924430759,173207208
1634014167,-185541,true,8759102804,22,8921753965,162651161
1634014354,-185538,true,8761730797,22,8904819572,143088775
1634014632,-185535,true,8764359580,22,8894140731,129781151
1634014682,-185534,true,8765236015,22,8893251406,128015391
1634014832,-185527,true,8771373522,22,8876371114,104997592
1634014863,-185522,true,8775760086,22,8871934259,96174173
1634014906,-185519,true,8778393077,22,8865726389,87333312
1634014953,-185516,true,8781026858,22,8859522862,78496004
1634014982,-185512,true,8784539796,22,8855094429,70554633
1634015106,-185512,true,8784539796,22,8842706590,58166794
1634015350,-185510,true,8786296792,22,8840054308,53757516
1634015460,-185507,true,8788932944,22,8838286562,49353618
1634015676,-185503,true,8792449045,22,8826804829,34355784
1634015701,-185503,true,8792449045,22,8825922236,33473191
1634015744,-185502,true,8793328290,22,8823274989,29946699
1634015768,-185498,true,8796846149,22,8822392750,25546601
1634015799,-185494,true,8800365415,22,8819746561,19381146
1634015986,-185493,true,8801245452,22,8818864675,17619223
1634016125,-185490,true,8803886089,22,8817982877,14096788
1634016237,-185486,true,8807408172,22,8817982877,10574705
1634016307,-185484,true,8809169742,22,8816219545,7049803
1634016510,-185486,true,8807408172,22,8799485467,-7922705
1634016571,-185484,true,8809169742,22,8803005789,-6163953
1634016577,-185481,true,8811812757,22,8802125576,-9687181
1634016684,-185479,true,8813575208,22,8795966552,-17608656
1634016740,-185479,true,8813575208,22,8790690819,-22884389
1634017285,-185478,true,8814456565,22,8752973884,-61482681
1634017337,-185476,true,8816219545,22,8753849181,-62370364
1634017371,-185474,true,8817982877,22,8754724566,-63258311
1634017474,-185475,true,8817101167,22,8751223551,-65877616
1634017530,-185475,true,8817101167,22,8753849181,-63251986
1634017631,-185474,true,8817982877,22,8754724566,-63258311
1634017742,-185472,true,8819746561,22,8755600038,-64146523
1634017885,-185472,true,8819746561,22,8767865849,-51880712
1634017916,-185472,true,8819746561,22,8762606971,-57139590
1634018028,-185472,true,8819746561,22,8755600038,-64146523
1634018070,-185469,true,8822392750,22,8752098674,-70294076
1634018156,-185472,true,8819746561,22,8746849252,-72897309
1634018385,-185473,true,8818864675,22,8722393551,-96471124
1634018423,-185473,true,8818864675,22,8718033662,-100831013
1634018507,-185472,true,8819746561,22,8708449577,-111296984
1634018828,-185475,true,8817101167,22,8658089273,-159011894
1634018933,-185475,true,8817101167,22,8653761527,-163339640
1634019151,-185474,true,8817982877,22,8635608602,-182374275
1634019161,-185471,true,8820628536,22,8634745128,-185883408
1634019557,-185473,true,8818864675,22,8643383760,-175480915
1634019652,-185474,true,8817982877,22,8645112523,-172870354
1634019747,-185474,true,8817982877,22,8638199544,-179783333
1634019907,-185472,true,8819746561,22,8635608602,-184137959
1634019991,-185475,true,8817101167,22,8639063364,-178037803
1634020095,-185477,true,8815338011,22,8639927270,-175410741
1634020186,-185475,true,8817101167,22,8636472163,-180629004
1634020325,-185480,true,8812693938,22,8646841632,-165852306
1634020702,-185482,true,8810931664,22,8688444158,-122487506
1634020796,-185484,true,8809169742,22,8701485951,-107683791
1634020964,-185484,true,8809169742,22,8725010531,-84159211
1634021189,-185488,true,8805646955,22,8746849252,-58797703
1634021254,-185492,true,8802125576,22,8747723937,-54401639
1634021287,-185493,true,8801245452,22,8747723937,-53521515
1634021315,-185489,true,8804766478,22,8752098674,-52667804
1634021316,-185492,true,8802125576,22,8752098674,-50026902
1634021672,-185490,true,8803886089,22,8802125576,-1760513
1634021760,-185491,true,8803005789,22,8810931664,7925875
1634022055,-185489,true,8804766478,22,8831219114,26452636
1634022187,-185492,true,8802125576,22,8842706590,40581014
1634022380,-185490,true,8803886089,22,8864839905,60953816
1634022477,-185489,true,8804766478,22,8877258751,72492273
1634022675,-185485,true,8808288913,22,8887028619,78739706
1634022936,-185487,true,8806527519,22,8909272872,102745353
1634023003,-185485,true,8808288913,22,8915511235,107222322
1634023062,-185485,true,8808288913,22,8917294426,109005513
1634023223,-185486,true,8807408172,22,8903038875,95630703
1634023364,-185491,true,8803005789,22,8886140005,83134216
1634023546,-185489,true,8804766478,22,8883474696,78708218
1634023826,-185489,true,8804766478,22,8898588691,93822213
1634023877,-185489,true,8804766478,22,8900368498,95602020
1634023909,-185493,true,8801245452,22,8902148660,100903208
1634024020,-185490,true,8803886089,22,8908382034,104495945
1634024295,-185492,true,8802125576,22,8919969882,117844306
1634024471,-185493,true,8801245452,22,8912837116,111591664
1634024629,-185497,true,8797725833,22,8893251406,95525573
1634024646,-185495,true,8799485467,22,8891473022,91987555
1634024920,-185498,true,8796846149,22,8866612961,69766812
1634025009,-185498,true,8796846149,22,8862180984,65334835
1634025377,-185500,true,8795087043,22,8855094429,60007386
1634025378,-185496,true,8798605606,22,8855094429,56488823
1634025469,-185499,true,8795966552,22,8856865536,60898984
1634025698,-185499,true,8795966552,22,8863067202,67100650
1634025709,-185503,true,8792449045,22,8863067202,70618157
1634025760,-185499,true,8795966552,22,8860408814,64442262
1634025883,-185500,true,8795087043,22,8861294855,66207812
1634025920,-185502,true,8793328290,22,8860408814,67080524
1634025961,-185503,true,8792449045,22,8859522862,67073817
1634026198,-185496,true,8798605606,22,8879922195,81316589
1634026311,-185497,true,8797725833,22,8887917322,90191489
1634026552,-185495,true,8799485467,22,8941402447,141916980
1634026794,-185494,true,8800365415,22,8996108952,195743537
1634026922,-185487,true,8806527519,22,9000607906,194080387
1634026978,-185487,true,8806527519,22,9004208689,197681170
1634027168,-185486,true,8807408172,22,9016822778,209414606
1634027272,-185487,true,8806527519,22,9007810913,201283394
1634027404,-185479,true,8813575208,22,8988915302,175340094
1634027711,-185479,true,8813575208,22,8957510659,143935451
1634027891,-185480,true,8812693938,22,8942296587,129602649
1634028364,-185481,true,8811812757,22,8901258534,89445777
1634028501,-185475,true,8817101167,22,8891473022,74371855
1634028762,-185475,true,8817101167,22,8895030145,77928978
1634028805,-185476,true,8816219545,22,8897698921,81479376
1634028845,-185476,true,8816219545,22,8899478550,83259005
1634028888,-185468,true,8823274989,22,8901258534,77983545
1634028927,-185469,true,8822392750,22,8903038875,80646125
1634028962,-185468,true,8823274989,22,8903929179,80654190
1634028995,-185468,true,8823274989,22,8905710054,82435065
1634029009,-185460,true,8830336080,22,8907491285,77155205
1634029283,-185461,true,8829453135,22,8910163800,80710665
1634029434,-185460,true,8830336080,22,8910163800,79827720
1634029505,-185460,true,8830336080,22,8908382034,78045954
1634029636,-185452,true,8837402822,22,8903929179,66526357
1634029666,-185454,true,8835635607,22,8903038875,67403268
1634029703,-185453,true,8836519170,22,8905710054,69190884
1634029959,-185455,true,8834752131,22,8875483565,40731434
1634030046,-185450,true,8839170391,22,8867499622,28329231
1634030102,-185451,true,8838286562,22,8864839905,26553343
1634030126,-185449,true,8840054308,22,8863953509,23899201
1634030339,-185450,true,8839170391,22,8853323676,14153285
1634030544,-185441,true,8847128827,22,8841822407,-5306420
1634030737,-185444,true,8844475219,22,8817982877,-26492342
1634030894,-185443,true,8845359667,22,8806527519,-38832148
1634031283,-185445,true,8843590860,22,8754724566,-88866294
1634031301,-185436,true,8851553276,22,8752098674,-99454602
1634031459,-185439,true,8848898341,22,8727628296,-121270045
1634031720,-185439,true,8848898341,22,8713675953,-135222388
1634031946,-185440,true,8848013540,22,8727628296,-120385244
1634032044,-185432,true,8855094429,22,8724138117,-130956312
1634032225,-185435,true,8852438432,22,8719777356,-132661076
1634032302,-185434,true,8853323676,22,8718905466,-134418210
1634032433,-185437,true,8850668210,22,8716290317,-134377893
1634032483,-185429,true,8857751223,22,8707578819,-150172404
1634032493,-185433,true,8854209008,22,8705837564,-148371444
1634032556,-185434,true,8853323676,22,8698876027,-154447649
1634032713,-185442,true,8846244203,22,8670218480,-176025723
1634032942,-185439,true,8848898341,22,8592540473,-256357868
1634032986,-185444,true,8844475219,22,8580519934,-263955285
1634033467,-185448,true,8840938314,22,8473088990,-367849324
1634033502,-185458,true,8832102236,22,8468006915,-364095321
1634033514,-185456,true,8833868745,22,8466313568,-367555177
1634033562,-185460,true,8830336080,22,8460389518,-369946562
1634033675,-185464,true,8826804829,22,8456160592,-370644237
1634033780,-185474,true,8817982877,22,8456160592,-361822285
1634033793,-185476,true,8816219545,22,8455315061,-360904484
1634033886,-185481,true,8811812757,22,8460389518,-351423239
1634033968,-185484,true,8809169742,22,8464620559,-344549183
1634033971,-185492,true,8802125576,22,8464620559,-337505017
1634034059,-185495,true,8799485467,22,8468853716,-330631751
1634034125,-185501,true,8794207623,22,8472241766,-321965857
1634034138,-185506,true,8789811838,22,8471394626,-318417212
1634034189,-185514,true,8782783151,22,8479021932,-303761219
1634034281,-185514,true,8782783151,22,8494297151,-288486000
1634034482,-185518,true,8779270916,22,8516409952,-262860964
1634034783,-185523,true,8774882597,22,8541142149,-233740448
1634034815,-185530,true,8768742636,22,8545413574,-223329062
1634035097,-185530,true,8768742636,22,8570229999,-198512637
1634035221,-185535,true,8764359580,22,8570229999,-194129581
1634035224,-185539,true,8760854712,22,8570229999,-190624713
1634035753,-185547,true,8753849181,22,8599416912,-154432269
1634035777,-185547,true,8753849181,22,8599416912,-154432269
1634035828,-185551,true,8750348517,22,8599416912,-150931605
1634035850,-185554,true,8747723937,22,8598557056,-149166881
1634035981,-185563,true,8739854920,22,8594259067,-145595853
1634036009,-185564,true,8738981022,22,8589963226,-149017796
1634036192,-185567,true,8736359852,22,8577946292,-158413560
1634036311,-185570,true,8733739468,22,8575373423,-158366045
1634036374,-185579,true,8725883032,22,8574515971,-151367061
1634036619,-185579,true,8725883032,22,8570229999,-155653033
1634036826,-185582,true,8723265790,22,8572801325,-150464465
1634036842,-185584,true,8721521399,22,8573658606,-147862793
1634036961,-185593,true,8713675953,22,8583952656,-129723297
1634037122,-185593,true,8713675953,22,8586528100,-127147853
1634037218,-185596,true,8711062373,22,8583952656,-127109717
1634037304,-185599,true,8708449577,22,8580519934,-127929643
1634037323,-185608,true,8700615889,22,8577946292,-122669597
1634037392,-185613,true,8696266886,22,8567659444,-128607442
1634037466,-185619,true,8691050952,22,8556529280,-134521672
1634037522,-185625,true,8685838146,22,8553962834,-131875312
1634037540,-185636,true,8676289454,22,8552252298,-124037156
1634037827,-185638,true,8674554456,22,8536019257,-138535199
1634037852,-185644,true,8669351545,22,8534312309,-135039236
1634038020,-185647,true,8666751259,22,8542850463,-123900796
1634038264,-185655,true,8659820977,22,8562520647,-97300330
1634038431,-185657,true,8658089273,22,8578804087,-79285186
1634038470,-185662,true,8653761527,22,8582236123,-71525404
1634038735,-185665,true,8651165917,22,8586528100,-64637817
1634038790,-185674,true,8643383760,22,8580519934,-62863826
1634038944,-185676,true,8641655342,22,8560808400,-80846942
1634038949,-185681,true,8637335811,22,8559952405,-77383406
1634038968,-185687,true,8632155222,22,8557384933,-74770289
1634039015,-185696,true,8624390166,22,8550542104,-73848062
1634039019,-185700,true,8620941272,22,8549687136,-71254136
1634039045,-185705,true,8616632094,22,8545413574,-71218520
1634039315,-185710,true,8612325070,22,8513855540,-98469530
1634039463,-185719,true,8604577852,22,8496845695,-107732157
1634039485,-185723,true,8601136881,22,8495146581,-105990300
1634039491,-185727,true,8597697286,22,8494297151,-103400135
1634039634,-185731,true,8594259067,22,8484110617,-110148450
1634039666,-185740,true,8586528100,22,8484959028,-101569072
1634039815,-185743,true,8583952656,22,8489202356,-94750300
1634039849,-185748,true,8579661967,22,8484959028,-94702939
1634040013,-185756,true,8572801325,22,8468853716,-103947609
1634040174,-185763,true,8566802764,22,8451088671,-115714093
1634040345,-185769,true,8561664481,22,8410622665,-151041816
1634040570,-185778,true,8553962834,22,8306980038,-246982796
1634040744,-185789,true,8544559118,22,8226795863,-317763255
1634040748,-185801,true,8534312309,22,8225150751,-309161558
1634040777,-185810,true,8526635267,22,8218573590,-308061677
1634040792,-185817,true,8520669009,22,8215286982,-305382027
1634040861,-185821,true,8517261593,22,8204614582,-312647011
1634040908,-185830,true,8509599889,22,8193136731,-316463158
1634041094,-185839,true,8501945077,22,8155536729,-346408348
1634041125,-185845,true,8496845695,22,8152275329,-344570366
1634041144,-185849,true,8493447806,22,8149830136,-343617670
1634041236,-185860,true,8484110617,22,8136801485,-347309132
1634041281,-185869,true,8476478734,22,8140870699,-335608035
1634041318,-185875,true,8471394626,22,8145756443,-325638183
1634041526,-185880,true,8467160199,22,8161247317,-305912882
1634041818,-185889,true,8459543564,22,8157983634,-301559930
1634041935,-185898,true,8451933780,22,8152275329,-299658451
1634042065,-185903,true,8447709081,22,8149830136,-297878945
1634042114,-185906,true,8445175275,22,8150645119,-294530156
1634042658,-185911,true,8440953954,22,8169412238,-271541716
1634042666,-185916,true,8436734743,22,8170229179,-266505564
1634042669,-185921,true,8432517641,22,8170229179,-262288462
1634042818,-185921,true,8432517641,22,8186585170,-245932471
1634042889,-185923,true,8430831390,22,8193956045,-236875345
1634043431,-185928,true,8426617239,22,8237497117,-189120122
1634043539,-185933,true,8422405194,22,8229264149,-193141045
1634043587,-185935,true,8420720965,22,8225150751,-195570214
1634043619,-185936,true,8419878977,22,8221039409,-198839568
1634043782,-185945,true,8412304874,22,8203794202,-208510672
1634043843,-185950,true,8408099983,22,8198873648,-209226335
1634044090,-185952,true,8406418615,22,8178403086,-228015529
1634044132,-185954,true,8404737584,22,8175132543,-229605041
1634044140,-185963,true,8397177100,22,8174315111,-222861989
1634044377,-185968,true,8392979771,22,8162063442,-230916329
1634044392,-185969,true,8392140557,22,8162879648,-229260909
1634044441,-185972,true,8389623418,22,8166961905,-222661513
1634044459,-185984,true,8379562411,22,8167778601,-211783810
1634044643,-185988,true,8376211424,22,8178403086,-197808338
1634044689,-185989,true,8375373887,22,8181674938,-193698949
1634044726,-185992,true,8372861777,22,8181674938,-191186839
1634044864,-186005,true,8361984672,22,8175132543,-186852129
1634044961,-186010,true,8357804934,22,8180856852,-176948082
1634045035,-186011,true,8356969237,22,8184129686,-172839551
1634045113,-186014,true,8354462647,22,8188222569,-166240078
1634045204,-186025,true,8345278250,22,8193136731,-152141519
1634045325,-186030,true,8341106862,22,8198873648,-142233214
1634045343,-186032,true,8339438891,22,8199693535,-139745356
1634045401,-186033,true,8338605031,22,8202153689,-136451342
1634045621,-186043,true,8330271010,22,8209538581,-120732429
1634045659,-186047,true,8326939735,22,8213644171,-113295564
1634045736,-186050,true,8324442152,22,8220217387,-104224765
1634045759,-186051,true,8323609791,22,8222683699,-100926092
1634045914,-186061,true,8315290758,22,8230087075,-85203683
1634045957,-186066,true,8311134359,22,8231733175,-79401184
1634046071,-186068,true,8309472382,22,8235849865,-73622517
1634046104,-186069,true,8308641517,22,8239968613,-68672904
1634046110,-186078,true,8301167478,22,8240792610,-60374868
1634046337,-186081,true,8298677625,22,8258941403,-39736222
1634046376,-186082,true,8297847841,22,8259767297,-38080544
1634046458,-186085,true,8295358984,22,8253162456,-42196528
1634046512,-186093,true,8288725682,22,8249862016,-38863666
1634046801,-186099,true,8283754187,22,8227618543,-56135644
1634047094,-186099,true,8283754187,22,8193136731,-90617456
1634047623,-186102,true,8281269558,22,8173497761,-107771797
1634047690,-186113,true,8272165624,22,8174315111,-97850513
1634048248,-186118,true,8268030782,22,8183311355,-84719427
1634048475,-186122,true,8264724396,22,8138428926,-126295470
1634048565,-186127,true,8260593274,22,8116485902,-144107372
1634048633,-186139,true,8250687002,22,8097840367,-152846635
1634048640,-186153,true,8239144699,22,8096221042,-142923657
1634048743,-186157,true,8235849865,22,8065515315,-170334550
1634049066,-186155,true,8237497117,22,8038140495,-199356622
1634049127,-186165,true,8229264149,22,8030909785,-198354364
1634049229,-186178,true,8218573590,22,8037336762,-181236828
1634049398,-186178,true,8218573590,22,8058259979,-160313611
1634049497,-186177,true,8219395448,22,8071969986,-147425462
1634049498,-186186,true,8212001689,22,8071969986,-140031703
1634049591,-186199,true,8201333556,22,8088938085,-112395471
1634049671,-186200,true,8200513505,22,8097840367,-102673138
1634049755,-186198,true,8202153689,22,8097840367,-104313322
1634049842,-186207,true,8194775441,22,8097030664,-97744777
1634049899,-186219,true,8184948099,22,8096221042,-88727057
1634049906,-186221,true,8183311355,22,8096221042,-87090313
1634049963,-186219,true,8184948099,22,8095411501,-89536598
1634050012,-186229,true,8176767651,22,8097030664,-79736987
1634050067,-186241,true,8166961905,22,8097030664,-69931241
1634050149,-186240,true,8167778601,22,8098650151,-69128450
1634050242,-186237,true,8170229179,22,8099460016,-70769163
1634050331,-186243,true,8165328757,22,8101079989,-64248768
1634050482,-186250,true,8159615313,22,8099460016,-60155297
1634050599,-186245,true,8163695936,22,8100269962,-63425974
1634050786,-186238,true,8169412238,22,8103510556,-65901682
1634050870,-186242,true,8166145290,22,8105131339,-61013951
1634050897,-186249,true,8160431274,22,8105941852,-54489422
1634050908,-186250,true,8159615313,22,8105131339,-54483974
1634050922,-186244,true,8164512306,22,8104320907,-60191399
1634051099,-186252,true,8157983634,22,8082469846,-75513788
1634051116,-186260,true,8151460183,22,8080853594,-70606589
1634051163,-186260,true,8151460183,22,8077622060,-73838123
1634051349,-186253,true,8157167918,22,8065515315,-91652603
1634051397,-186260,true,8151460183,22,8058259979,-93200204
1634051409,-186268,true,8144941949,22,8054232058,-90709891
1634051427,-186268,true,8144941949,22,8052621453,-92320496
1634051480,-186263,true,8149015234,22,8046986872,-102028362
1634051533,-186269,true,8144127536,22,8040552179,-103575357
1634051667,-186281,true,8134360932,22,8000451757,-133909175
1634051741,-186279,true,8135987886,22,7993254950,-142732936
1634051744,-186276,true,8138428926,22,7992455704,-145973222
1634051779,-186284,true,8131921112,22,7981274654,-150646458
1634051787,-186293,true,8124606041,22,7980476606,-144129435
1634051964,-186291,true,8126231044,22,7980476606,-145754438
1634052101,-186290,true,8127043667,22,7982870988,-144172679
1634052230,-186298,true,8120544956,22,7969312314,-151232642
1634052265,-186306,true,8114051443,22,7970906256,-143145187
1634052274,-186304,true,8115674334,22,7973297767,-142376567
1634052290,-186303,true,8116485902,22,7977285213,-139200689
1634052357,-186298,true,8120544956,22,7992455704,-128089252
1634052484,-186308,true,8112428876,22,8010858587,-101570289
1634052534,-186307,true,8113240119,22,8022883290,-90356829
1634052742,-186307,true,8113240119,22,8049401210,-63838909
1634052783,-186303,true,8116485902,22,8051011170,-65474732
1634052877,-186314,true,8107563122,22,8051011170,-56551952
1634052991,-186314,true,8107563122,22,8050206150,-57356972
1634053374,-186313,true,8108373878,22,8073584461,-34789417
1634053415,-186309,true,8111617714,22,8074391819,-37225895
1634053516,-186320,true,8102700286,22,8077622060,-25078226
1634053622,-186319,true,8103510556,22,8080045589,-23464967
1634053967,-186318,true,8104320907,22,8099460016,-4860891
1634054034,-186313,true,8108373878,22,8101079989,-7293889
1634054098,-186324,true,8099460016,22,8103510556,4050540
1634054156,-186323,true,8100269962,22,8104320907,4050945
1634054166,-186322,true,8101079989,22,8102700286,1620297
1634054532,-186321,true,8101890097,22,8086511889,-15378208
1634054637,-186333,true,8092174146,22,8084086420,-8087726
1634054881,-186332,true,8092983363,22,8079237666,-13745697
1634054990,-186331,true,8093792661,22,8063902454,-29890207
1634055033,-186331,true,8093792661,22,8059065805,-34726856
1634055055,-186343,true,8084086420,22,8057454234,-26632186
1634055201,-186344,true,8083278093,22,8051816271,-31461822
1634055208,-186343,true,8084086420,22,8051816271,-32270149
1634055399,-186343,true,8084086420,22,8044573259,-39513161
1634055525,-186355,true,8074391819,22,8040552179,-33839640
1634055741,-186356,true,8073584461,22,8029303844,-44280617
1634055772,-186356,true,8073584461,22,8025290396,-48294065
1634055831,-186357,true,8072777183,22,8020476906,-52300277
1634056091,-186371,true,8061483767,22,8012460839,-49022928
1634056111,-186374,true,8059065805,22,8010858587,-48207218
1634056133,-186372,true,8060677699,22,8007655045,-53022654
1634056141,-186372,true,8060677699,22,8007655045,-53022654
1634056171,-186379,true,8055037481,22,8011659673,-43377808
1634056213,-186381,true,8053426715,22,8013262085,-40164630
1634056276,-186377,true,8056648569,22,8015666304,-40982265
1634056295,-186377,true,8056648569,22,8016467871,-40180698
1634056309,-186386,true,8049401210,22,8016467871,-32933339
1634056338,-186385,true,8050206150,22,8018873052,-31333098
1634056373,-186379,true,8055037481,22,8020476906,-34560575
1634056679,-186378,true,8055842985,22,8043768882,-12074103
1634056748,-186380,true,8054232058,22,8054232058,0
1634056789,-186377,true,8056648569,22,8059065805,2417236
1634056924,-186376,true,8057454234,22,8076814379,19360145
1634057082,-186376,true,8057454234,22,8092174146,34719912
1634057172,-186378,true,8055842985,22,8094602041,38759056
1634057353,-186378,true,8055842985,22,8084086420,28243435
1634057367,-186378,true,8055842985,22,8083278093,27435108
1634057439,-186378,true,8055842985,22,8077622060,21779075
1634057662,-186382,true,8052621453,22,8063096144,10474691
1634057802,-186381,true,8053426715,22,8051011170,-2415545
1634057940,-186381,true,8053426715,22,8040552179,-12874536
1634058050,-186382,true,8052621453,22,8030106774,-22514679
1634058255,-186386,true,8049401210,22,8020476906,-28924304
1634058341,-186387,true,8048596350,22,8017269518,-31326832
1634058425,-186387,true,8048596350,22,8014864818,-33731532
1634058842,-186388,true,8047791571,22,7997252376,-50539195
1634058843,-186392,true,8044573259,22,7997252376,-47320883
1634058980,-186392,true,8044573259,22,8009256656,-35316603
1634059043,-186392,true,8044573259,22,8014864818,-29708441
1634059233,-186392,true,8044573259,22,8014063411,-30509848
1634059487,-186394,true,8042964585,22,8044573259,1608674
1634059698,-186393,true,8043768882,22,8070355834,26586952
1634059725,-186393,true,8043768882,22,8074391819,30622937
1634059784,-186392,true,8044573259,22,8077622060,33048801
1634059904,-186395,true,8042160369,22,8080853594,38693225
1634059937,-186394,true,8042964585,22,8081661679,38697094
1634060210,-186393,true,8043768882,22,8105941852,62172970
1634060484,-186387,true,8048596350,22,8107563122,58966772
1634060525,-186389,true,8046986872,22,8109995634,63008762
1634060647,-186388,true,8047791571,22,8116485902,68694331
1634060708,-186387,true,8048596350,22,8120544956,71948606
1634060756,-186379,true,8055037481,22,8123793662,68756181
1634060934,-186380,true,8054232058,22,8138428926,84196868
1634061048,-186378,true,8055842985,22,8148200414,92357429
1634061118,-186375,true,8058259979,22,8153905866,95645887
1634061166,-186368,true,8063902454,22,8160431274,96528820
1634061306,-186364,true,8067128499,22,8179220926,112092427
1634061536,-186363,true,8067935212,22,8194775441,126840229
1634061587,-186359,true,8071162870,22,8197234119,126071249
1634062680,-186350,true,8078429823,22,8230087075,151657252
1634062690,-186350,true,8078429823,22,8229264149,150834326
1634062803,-186349,true,8079237666,22,8234202942,154965276
1634062913,-186346,true,8081661679,22,8238320867,156659188
1634062987,-186336,true,8089746979,22,8235849865,146102886
1634063231,-186337,true,8088938085,22,8228441305,139503220
1634063379,-186337,true,8088938085,22,8225150751,136212666
1634063414,-186334,true,8091365009,22,8224328318,132963309
1634063417,-186332,true,8092983363,22,8224328318,131344955
1634063445,-186332,true,8092983363,22,8221861513,128878150
1634064029,-186333,true,8092174146,22,8189041392,96867246
1634064197,-186329,true,8095411501,22,8184948099,89536598
1634064210,-186326,true,8097840367,22,8184948099,87107732
1634064439,-186325,true,8098650151,22,8180856852,82206701
1634064542,-186326,true,8097840367,22,8179220926,81380559
1634064588,-186323,true,8100269962,22,8182493106,82223144
1634064929,-186319,true,8103510556,22,8202973905,99463349
1634065238,-186320,true,8102700286,22,8182493106,79792820
1634065376,-186321,true,8101890097,22,8174315111,72425014
1634065430,-186319,true,8103510556,22,8171046202,67535646
1634065454,-186317,true,8105131339,22,8171046202,65914863
1634065498,-186318,true,8104320907,22,8169412238,65091331
1634065541,-186318,true,8104320907,22,8167778601,63457694
1634065568,-186314,true,8107563122,22,8166145290,58582168
1634065704,-186311,true,8109995634,22,8156352282,46356648
1634065990,-186312,true,8109184716,22,8153090557,43905841
1634066037,-186312,true,8109184716,22,8153905866,44721150
1634066162,-186309,true,8111617714,22,8156352282,44734568
1634066252,-186306,true,8114051443,22,8158799433,44747990
1634066505,-186306,true,8114051443,22,8156352282,42300839
1634066651,-186304,true,8115674334,22,8155536729,39862395
1634066727,-186301,true,8118109280,22,8152275329,34166049
1634066808,-186299,true,8119732983,22,8149015234,29282251
1634066902,-186300,true,8118921091,22,8145756443,26835352
1634067349,-186300,true,8118921091,22,8122169147,3248056
1634067388,-186297,true,8121357011,22,8119732983,-1624028
1634067430,-186294,true,8123793662,22,8118109280,-5684382
1634067536,-186294,true,8123793662,22,8114051443,-9742219
1634067880,-186292,true,8125418502,22,8110806634,-14611868
1634067926,-186289,true,8127856371,22,8113240119,-14616252
1634067958,-186286,true,8130294972,22,8114862848,-15432124
1634068014,-186288,true,8128669157,22,8116485902,-12183255
1634068066,-186287,true,8129482024,22,8118921091,-10560933
1634068182,-186285,true,8131108001,22,8124606041,-6501960
1634068238,-186282,true,8133547578,22,8127856371,-5691207
1634068361,-186284,true,8131921112,22,8128669157,-3251955
1634068517,-186284,true,8131921112,22,8126231044,-5690068
1634068529,-186283,true,8132734304,22,8126231044,-6503260
1634068538,-186281,true,8134360932,22,8126231044,-8129888
1634068568,-186283,true,8132734304,22,8126231044,-6503260
1634068620,-186284,true,8131921112,22,8122981364,-8939748
1634068949,-186285,true,8131108001,22,8097030664,-34077337
1634069052,-186283,true,8132734304,22,8087320540,-45413764
1634069113,-186285,true,8131108001,22,8081661679,-49446322
1634069237,-186285,true,8131108001,22,8074391819,-56716182
1634069307,-186284,true,8131921112,22,8074391819,-57529293
1634069475,-186280,true,8135174368,22,8074391819,-60782549
1634069560,-186282,true,8133547578,22,8072777183,-60770395
1634069587,-186282,true,8133547578,22,8071969986,-61577592
1634069692,-186284,true,8131921112,22,8059871712,-72049400
1634069767,-186281,true,8134360932,22,8063096144,-71264788
1634069826,-186281,true,8134360932,22,8065515315,-68845617
1634069934,-186279,true,8135987886,22,8071162870,-64825016
1634069963,-186278,true,8136801485,22,8072777183,-64024302
1634070175,-186275,true,8139242769,22,8076814379,-62428390
1634070296,-186275,true,8139242769,22,8076814379,-62428390
1634070472,-186274,true,8140056694,22,8083278093,-56778601
1634070538,-186273,true,8140870699,22,8092174146,-48696553
1634070543,-186271,true,8142498955,22,8093792661,-48706294
1634070792,-186273,true,8140870699,22,8105941852,-34928847
1634070926,-186272,true,8141684786,22,8109995634,-31689152
1634070965,-186271,true,8142498955,22,8111617714,-30881241
1634071126,-186271,true,8142498955,22,8103510556,-38988399
1634071168,-186273,true,8140870699,22,8101079989,-39790710
1634071295,-186274,true,8140056694,22,8097840367,-42216327
1634071323,-186273,true,8140870699,22,8097840367,-43030332
1634071349,-186273,true,8140870699,22,8097030664,-43840035
1634071539,-186275,true,8139242769,22,8092174146,-47068623
1634072300,-186274,true,8140056694,22,8126231044,-13825650
1634072514,-186273,true,8140870699,22,8134360932,-6509767
1634072714,-186275,true,8139242769,22,8135987886,-3254883
1634072742,-186277,true,8137615165,22,8136801485,-813680
1634073005,-186275,true,8139242769,22,8146571019,7328250
1634073013,-186275,true,8139242769,22,8147385676,8142907
1634073075,-186276,true,8138428926,22,8149015234,10586308
1634073271,-186276,true,8138428926,22,8184948099,46519173
1634073281,-186272,true,8141684786,22,8186585170,44900384
1634073509,-186271,true,8142498955,22,8225150751,82651796
1634073633,-186272,true,8141684786,22,8244089422,102404636
1634073723,-186273,true,8140870699,22,8255638652,114767953
1634073827,-186269,true,8144127536,22,8266377424,122249888
1634074097,-186269,true,8144127536,22,8278785674,134658138
1634074200,-186271,true,8142498955,22,8275474987,132976032
1634074454,-186270,true,8143313205,22,8276302534,132989329
1634074592,-186266,true,8146571019,22,8275474987,128903968
1634074622,-186265,true,8147385676,22,8274647522,127261846
1634074642,-186267,true,8145756443,22,8273820140,128063697
1634074658,-186266,true,8146571019,22,8276302534,129731515
1634074664,-186260,true,8151460183,22,8277130165,125669982
1634074667,-186257,true,8153905866,22,8277957878,124052012
1634074682,-186255,true,8155536729,22,8280441513,124904784
1634074690,-186255,true,8155536729,22,8281269558,125732829
1634074717,-186248,true,8161247317,22,8284582562,123335245
1634074840,-186246,true,8162879648,22,8297847841,134968193
1634074855,-186246,true,8162879648,22,8300337444,137457796
1634074981,-186244,true,8164512306,22,8317785594,153273288
1634075010,-186237,true,8170229179,22,8321945319,151716140
1634075397,-186235,true,8171863307,22,8357804934,185941627
1634075415,-186232,true,8174315111,22,8359476578,185161467
1634075422,-186231,true,8175132543,22,8361148557,186016014
1634075435,-186226,true,8179220926,22,8362820871,183599945
1634075470,-186223,true,8181674938,22,8368676602,187001664
1634075599,-186218,true,8185766594,22,8387107035,201340441
1634075774,-186216,true,8187403829,22,8403897194,216493365
1634075901,-186211,true,8191498350,22,8410622665,219124315
1634076132,-186207,true,8194775441,22,8427459900,232684459
1634076166,-186202,true,8198873648,22,8429145477,230271829
1634076214,-186200,true,8200513505,22,8433360892,232847387
1634076257,-186196,true,8203794202,22,8432517641,228723439
1634076372,-186195,true,8204614582,22,8429145477,224530895
1634076439,-186189,true,8209538581,22,8424089759,214551178
1634076456,-186188,true,8210359535,22,8422405194,212045659
1634076734,-186182,true,8215286982,22,8392979771,177692789
1634076774,-186180,true,8216930122,22,8392140557,175210435
1634076777,-186175,true,8221039409,22,8391301427,170262018
1634076912,-186174,true,8221861513,22,8378724539,156863026
1634077451,-186169,true,8225973266,22,8358640714,132667448
1634077664,-186167,true,8227618543,22,8356969237,129350694
1634077745,-186162,true,8231733175,22,8358640714,126907539
1634078018,-186160,true,8233379604,22,8362820871,129441267
1634078050,-186156,true,8236673450,22,8363657153,126983703
1634078275,-186155,true,8237497117,22,8363657153,126160036
1634078388,-186150,true,8241616689,22,8361984672,120367983
1634078617,-186150,true,8241616689,22,8346947389,105330700
1634078706,-186144,true,8246562896,22,8350286669,103723773
1634078944,-186141,true,8249037112,22,8366166501,117129389
1634079102,-186137,true,8252337222,22,8351956810,99619588
1634079539,-186137,true,8252337222,22,8330271010,77933788
1634079637,-186131,true,8257289862,22,8318617373,61327511
1634079661,-186129,true,8258941403,22,8317785594,58844191
1634079726,-186123,true,8263898007,22,8316953899,53055892
1634079989,-186122,true,8264724396,22,8309472382,44747986
1634081114,-186117,true,8268857585,22,8306149423,37291838
1634081230,-186116,true,8269684471,22,8306149423,36464952
1634081240,-186111,true,8273820140,22,8306149423,32329283
1634081368,-186110,true,8274647522,22,8305318892,30671370
1634081615,-186105,true,8278785674,22,8302827794,24042120
1634081672,-186102,true,8281269558,22,8302827794,21558236
1634081917,-186096,true,8286239562,22,8300337444,14097882
1634081927,-186095,true,8287068186,22,8301997594,14929408
1634082196,-186090,true,8291212549,22,8316953899,25741350
1634082243,-186089,true,8292041670,22,8321945319,29903649
1634082315,-186082,true,8297847841,22,8321945319,24097478
1634082330,-186081,true,8298677625,22,8325274596,26596971
1634082436,-186076,true,8302827794,22,8331937148,29109354
1634082668,-186075,true,8303658077,22,8343609445,39951368
1634083082,-186068,true,8309472382,22,8347782084,38309702
1634083112,-186068,true,8309472382,22,8346947389,37475007
1634083129,-186064,true,8312796669,22,8346112778,33316109
1634083385,-186063,true,8313627949,22,8346947389,33319440
1634083520,-186055,true,8320281179,22,8349451724,29170545
1634083642,-186053,true,8321945319,22,8352792005,30846686
1634083686,-186048,true,8326107124,22,8353627285,27520161
1634083694,-186046,true,8327772429,22,8353627285,25854856
1634083706,-186039,true,8333603618,22,8353627285,20023667
1634083803,-186038,true,8334436979,22,8353627285,19190306
1634083957,-186036,true,8336103949,22,8351121698,15017749
1634083967,-186034,true,8337771254,22,8351121698,13350444
1634084301,-186027,true,8343609445,22,8343609445,0
1634084317,-186028,true,8342775167,22,8342775167,0
1634084378,-186026,true,8344443806,22,8343609445,-834361
1634084413,-186025,true,8345278250,22,8341940973,-3337277
1634084516,-186018,true,8351121698,22,8336937560,-14184138
1634084606,-186022,true,8347782084,22,8331104037,-16678047
1634084620,-186023,true,8346947389,22,8331104037,-15843352
1634084797,-186022,true,8347782084,22,8327772429,-20009655
1634085018,-186016,true,8352792005,22,8326939735,-25852270
1634085177,-186020,true,8349451724,22,8320281179,-29170545
1634085226,-186021,true,8348616862,22,8317785594,-30831268
1634085289,-186021,true,8348616862,22,8310303329,-38313533
1634085533,-186016,true,8352792005,22,8297018139,-55773866
1634085845,-186020,true,8349451724,22,8274647522,-74804202
1634086116,-186022,true,8347782084,22,8260593274,-87188810
1634086151,-186022,true,8347782084,22,8259767297,-88014787
1634086161,-186017,true,8351956810,22,8261419333,-90537477
1634086222,-186021,true,8348616862,22,8268030782,-80586080
1634086227,-186020,true,8349451724,22,8268030782,-81420942
1634086396,-186022,true,8347782084,22,8274647522,-73134562
1634086561,-186022,true,8347782084,22,8282097685,-65684399
1634086853,-186025,true,8345278250,22,8305318892,-39959358
1634086897,-186024,true,8346112778,22,8309472382,-36640396
1634087032,-186025,true,8345278250,22,8322777513,-22500737
1634087121,-186025,true,8345278250,22,8321113208,-24165042
1634087172,-186028,true,8342775167,22,8321945319,-20829848
1634087372,-186027,true,8343609445,22,8325274596,-18334849
1634087503,-186028,true,8342775167,22,8326107124,-16668043
1634087515,-186028,true,8342775167,22,8325274596,-17500571
1634087581,-186031,true,8340272835,22,8319449235,-20823600
1634087630,-186032,true,8339438891,22,8315290758,-24148133
1634087650,-186036,true,8336103949,22,8314459312,-21644637
1634087712,-186037,true,8335270422,22,8310303329,-24967093
1634087760,-186041,true,8331937148,22,8307810736,-24126412
1634087770,-186041,true,8331937148,22,8307810736,-24126412
1634087861,-186045,true,8328605206,22,8301997594,-26607612
1634088051,-186047,true,8326939735,22,8287068186,-39871549
1634088086,-186049,true,8325274596,22,8287896892,-37377704
1634088149,-186049,true,8325274596,22,8290383510,-34891086
1634088305,-186050,true,8324442152,22,8293700161,-30741991
1634088350,-186049,true,8325274596,22,8295358984,-29915612
1634088395,-186051,true,8323609791,22,8297018139,-26591652
1634088465,-186050,true,8324442152,22,8301997594,-22444558
1634088466,-186051,true,8323609791,22,8301997594,-21612197
1634088530,-186050,true,8324442152,22,8308641517,-15800635
1634088837,-186052,true,8322777513,22,8333603618,10826105
1634089029,-186051,true,8323609791,22,8341106862,17497071
1634089152,-186052,true,8322777513,22,8341106862,18329349
1634089256,-186051,true,8323609791,22,8341106862,17497071
1634089348,-186054,true,8321113208,22,8333603618,12490410
1634089429,-186054,true,8321113208,22,8326107124,4993916
1634090016,-186057,true,8318617373,22,8278785674,-39831699
1634090068,-186056,true,8319449235,22,8274647522,-44801713
1634090102,-186057,true,8318617373,22,8271338491,-47278882
1634090127,-186058,true,8317785594,22,8268857585,-48928009
1634090158,-186062,true,8314459312,22,8267204062,-47255250
1634090170,-186061,true,8315290758,22,8267204062,-48086696
1634090252,-186061,true,8315290758,22,8267204062,-48086696
1634090363,-186061,true,8315290758,22,8268030782,-47259976
1634090525,-186064,true,8312796669,22,8267204062,-45592607
1634090609,-186063,true,8313627949,22,8267204062,-46423887
1634090767,-186065,true,8311965473,22,8267204062,-44761411
1634090797,-186064,true,8312796669,22,8267204062,-45592607
1634090805,-186066,true,8311134359,22,8266377424,-44756935
1634091042,-186063,true,8313627949,22,8286239562,-27388387
1634091157,-186063,true,8313627949,22,8295358984,-18268965
1634091341,-186062,true,8314459312,22,8304488443,-9970869
1634091352,-186065,true,8311965473,22,8304488443,-7477030
1634091481,-186062,true,8314459312,22,8316953899,2494587
1634091484,-186062,true,8314459312,22,8316953899,2494587
1634091626,-186061,true,8315290758,22,8329438066,14147308
1634091834,-186064,true,8312796669,22,8337771254,24974585
1634091950,-186062,true,8314459312,22,8334436979,19977667
1634092031,-186063,true,8313627949,22,8331104037,17476088
1634092141,-186063,true,8313627949,22,8326107124,12479175
1634092277,-186066,true,8311134359,22,8326107124,14972765
1634092635,-186064,true,8312796669,22,8317785594,4988925
1634093245,-186064,true,8312796669,22,8323609791,10813122
1634093276,-186064,true,8312796669,22,8323609791,10813122
1634093301,-186067,true,8310303329,22,8322777513,12474184
1634093308,-186066,true,8311134359,22,8321945319,10810960
1634093349,-186067,true,8310303329,22,8321113208,10809879
1634093419,-186066,true,8311134359,22,8323609791,12475432
1634093505,-186069,true,8308641517,22,8326107124,17465607
1634093711,-186068,true,8309472382,22,8327772429,18300047
1634093780,-186068,true,8309472382,22,8328605206,19132824
1634093887,-186066,true,8311134359,22,8334436979,23302620
1634094059,-186068,true,8309472382,22,8342775167,33302785
1634094110,-186066,true,8311134359,22,8344443806,33309447
1634094213,-186066,true,8311134359,22,8347782084,36647725
1634094416,-186065,true,8311965473,22,8346947389,34981916
1634094479,-186068,true,8309472382,22,8346947389,37475007
1634094590,-186066,true,8311134359,22,8346112778,34978419
1634094669,-186066,true,8311134359,22,8341940973,30806614
1634094806,-186062,true,8314459312,22,8356969237,42509925
1634094983,-186063,true,8313627949,22,8376211424,62583475
1634095105,-186060,true,8316122287,22,8394658451,78536164
1634095126,-186058,true,8317785594,22,8400536475,82750881
1634095327,-186051,true,8323609791,22,8456160592,132550801
1634095336,-186050,true,8324442152,22,8457851909,133409757
1634095523,-186044,true,8329438066,22,8504495916,175057850
1634095655,-186040,true,8332770341,22,8551397159,218626818
1634095799,-186030,true,8341106862,22,8590822222,249715360
1634096015,-186027,true,8343609445,22,8653761527,310152082
1634096127,-186018,true,8351121698,22,8678024799,326903101
1634096194,-186015,true,8353627285,22,8683232915,329605630
1634096388,-186009,true,8358640714,22,8715418775,356778061
1634096434,-186006,true,8361148557,22,8721521399,360372842
1634096751,-185998,true,8367839818,22,8711933479,344093661
1634097020,-185995,true,8370350421,22,8684969649,314619228
1634097232,-185990,true,8374536433,22,8679760490,305224057
1634097278,-185988,true,8376211424,22,8677157083,300945659
1634097575,-185981,true,8382076531,22,8655492366,273415835
1634097658,-185978,true,8384591406,22,8650300887,265709481
1634097802,-185973,true,8388784540,22,8644248098,255463558
1634097836,-185971,true,8390462381,22,8644248098,253785717
1634098047,-185966,true,8394658451,22,8616632094,221973643
1634098058,-185963,true,8397177100,22,8614909026,217731926
1634098304,-185959,true,8400536475,22,8589963226,189426751
1634098415,-185954,true,8404737584,22,8590822222,186084638
1634098467,-185949,true,8408940793,22,8588245491,179304698
1634098833,-185948,true,8409781687,22,8553962834,144181147
1634098965,-185944,true,8413146104,22,8553107524,139961420
1634099094,-185940,true,8416511868,22,8553107524,136595656
1634099974,-185934,true,8421563037,22,8557384933,135821896
1634100124,-185933,true,8422405194,22,8551397159,128991965
1634100188,-185929,true,8425774661,22,8548832252,123057591
1634100505,-185927,true,8427459900,22,8536019257,108559357
1634100787,-185925,true,8429145477,22,8519817027,90671550
1634101656,-185924,true,8429988391,22,8507047520,77059129
1634102047,-185920,true,8433360892,22,8507047520,73686628
1634102058,-185918,true,8435047649,22,8508749014,73701365
1634102458,-185914,true,8438422174,22,8553962834,115540660
1634102487,-185913,true,8439266016,22,8556529280,117263264
1634102495,-185906,true,8445175275,22,8556529280,111354005
1634102615,-185904,true,8446864394,22,8567659444,120795050
1634102738,-185901,true,8449398707,22,8577946292,128547585
1634102807,-185898,true,8451933780,22,8583952656,132018876
1634102840,-185891,true,8457851909,22,8586528100,128676191
1634103152,-185888,true,8460389518,22,8586528100,126138582
1634103160,-185884,true,8463774182,22,8585669533,121895351
1634103167,-185882,true,8465467021,22,8583094347,117627326
1634103316,-185877,true,8469700602,22,8561664481,91963879
1634103474,-185883,true,8464620559,22,8501945077,37324518
1634103660,-185881,true,8466313568,22,8432517641,-33795927
1634103730,-185880,true,8467160199,22,8406418615,-60741584
1634104129,-185880,true,8467160199,22,8230087075,-237073124
1634104205,-185886,true,8462081681,22,8220217387,-241864294
1634104330,-185885,true,8462927889,22,8219395448,-243532441
1634104378,-185883,true,8464620559,22,8220217387,-244403172
1634104544,-185881,true,8466313568,22,8208717709,-257595859
1634104886,-185888,true,8460389518,22,8224328318,-236061200
1634105098,-185890,true,8458697694,22,8225150751,-233546943
1634105163,-185890,true,8458697694,22,8220217387,-238480307
1634105646,-185888,true,8460389518,22,8198053843,-262335675
1634105893,-185895,true,8454469614,22,8198053843,-256415771
1634105920,-185897,true,8452778974,22,8195594918,-257184056
1634106030,-185897,true,8452778974,22,8195594918,-257184056
1634106046,-185895,true,8454469614,22,8198053843,-256415771
1634106154,-185902,true,8448553852,22,8205435043,-243118809
1634106210,-185901,true,8449398707,22,8216108511,-233290196
1634106424,-185900,true,8450243647,22,8233379604,-216864043
1634106437,-185898,true,8451933780,22,8235026362,-216907418
1634106707,-185904,true,8446864394,22,8250687002,-196177392
1634106788,-185905,true,8446019792,22,8253162456,-192857336
1634106956,-185904,true,8446864394,22,8258115591,-188748803
1634107182,-185901,true,8449398707,22,8258115591,-191283116
1634107230,-185908,true,8443486493,22,8257289862,-186196631
1634107243,-185908,true,8443486493,22,8257289862,-186196631
1634107660,-185907,true,8444330842,22,8253987772,-190343070
1634107714,-185906,true,8445175275,22,8254813171,-190362104
1634107954,-185912,true,8440109943,22,8264724396,-175385547
1634108053,-185912,true,8440109943,22,8267204062,-172905881
1634108285,-185909,true,8442642229,22,8279613552,-163028677
1634108531,-185908,true,8443486493,22,8292870874,-150615619
1634108593,-185915,true,8437578416,22,8296188520,-141389896
1634108706,-185915,true,8437578416,22,8297018139,-140560277
1634109186,-185912,true,8440109943,22,8312796669,-127313274
1634109320,-185910,true,8441798049,22,8317785594,-124012455
1634109326,-185916,true,8436734743,22,8317785594,-118949149
1634109458,-185916,true,8436734743,22,8314459312,-122275431
1634109593,-185913,true,8439266016,22,8311965473,-127300543
1634109748,-185914,true,8438422174,22,8305318892,-133103282
1634110072,-185924,true,8429988391,22,8272165624,-157822767
1634110493,-185927,true,8427459900,22,8243265095,-184194805
1634110519,-185926,true,8428302646,22,8240792610,-187510036
1634110541,-185930,true,8424932168,22,8238320867,-186611301
1634111180,-185943,true,8413987419,22,8178403086,-235584333
1634111378,-185950,true,8408099983,22,8140870699,-267229284
1634111510,-185952,true,8406418615,22,8127856371,-278562244
1634111617,-185958,true,8401376529,22,8122981364,-278395165
1634111830,-185973,true,8388784540,22,8135987886,-252796654
1634111931,-185981,true,8382076531,22,8142498955,-239577576
1634112100,-185982,true,8381238407,22,8139242769,-241995638
1634112407,-185989,true,8375373887,22,8141684786,-233689101
1634112599,-186005,true,8361984672,22,8128669157,-233315515
1634112706,-186013,true,8355298094,22,8114862848,-240435246
1634112755,-186014,true,8354462647,22,8115674334,-238788313
1634112814,-186019,true,8350286669,22,8115674334,-234612335
1634112877,-186032,true,8339438891,22,8120544956,-218893935
1634112895,-186036,true,8336103949,22,8122169147,-213934802
1634113135,-186036,true,8336103949,22,8153905866,-182198083
1634113248,-186043,true,8330271010,22,8158799433,-171471577
1634113295,-186055,true,8320281179,22,8175132543,-145148636
1634113395,-186057,true,8318617373,22,8186585170,-132032203
1634113452,-186058,true,8317785594,22,8192317500,-125468094
1634113636,-186061,true,8315290758,22,8208717709,-106573049
1634113771,-186075,true,8303658077,22,8205435043,-98223034
1634113790,-186077,true,8301997594,22,8204614582,-97383012
1634114281,-186078,true,8301167478,22,8179220926,-121946552
1634114305,-186082,true,8297847841,22,8177585328,-120262513
1634114402,-186095,true,8287068186,22,8173497761,-113570425
1634114413,-186098,true,8284582562,22,8173497761,-111084801
1634114455,-186099,true,8283754187,22,8171863307,-111890880
1634114534,-186103,true,8280441513,22,8169412238,-111029275
1634114576,-186116,true,8269684471,22,8167778601,-101905870
1634114621,-186117,true,8268857585,22,8166961905,-101895680
1634114642,-186118,true,8268030782,22,8165328757,-102702025
1634114806,-186123,true,8263898007,22,8152275329,-111622678
1634114886,-186136,true,8253162456,22,8152275329,-100887127
1634115075,-186139,true,8250687002,22,8147385676,-103301326
1634115822,-186140,true,8249862016,22,8152275329,-97586687
1634116724,-186147,true,8244089422,22,8207076212,-37013210
1634116992,-186159,true,8234202942,22,8193956045,-40246897
1634117028,-186161,true,8232556348,22,8193136731,-39419617
1634117183,-186162,true,8231733175,22,8185766594,-45966581
1634117265,-186169,true,8225973266,22,8182493106,-43480160
1634117602,-186182,true,8215286982,22,8167778601,-47508381
1634117649,-186183,true,8214465536,22,8165328757,-49136779
1634117741,-186184,true,8213644171,22,8162879648,-50764523
1634118130,-186188,true,8210359535,22,8194775441,-15584094
1634118186,-186190,true,8208717709,22,8199693535,-9024174
1634118209,-186189,true,8209538581,22,8201333556,-8205025
1634118272,-186188,true,8210359535,22,8207076212,-3283323
1634118358,-186186,true,8212001689,22,8214465536,2463847
1634118402,-186188,true,8210359535,22,8217751815,7392280
1634118553,-186187,true,8211180571,22,8232556348,21375777
1634119018,-186185,true,8212822889,22,8253987772,41164883
1634119039,-186186,true,8212001689,22,8253162456,41160767
1634119508,-186187,true,8211180571,22,8246562896,35382325
1634120093,-186184,true,8213644171,22,8270511439,56867268
1634120332,-186182,true,8215286982,22,8282925894,67638912
1634121044,-186182,true,8215286982,22,8282097685,66810703
1634121130,-186182,true,8215286982,22,8282925894,67638912
1634121378,-186180,true,8216930122,22,8273820140,56890018
1634121535,-186178,true,8218573590,22,8267204062,48630472
1634121714,-186180,true,8216930122,22,8252337222,35407100
1634122186,-186183,true,8214465536,22,8198053843,-16411693
1634122476,-186184,true,8213644171,22,8174315111,-39329060
1634122546,-186183,true,8214465536,22,8169412238,-45053298
1634122571,-186186,true,8212001689,22,8166961905,-45039784
1634122633,-186189,true,8209538581,22,8163695936,-45842645
1634122674,-186190,true,8208717709,22,8162063442,-46654267
1634122777,-186189,true,8209538581,22,8160431274,-49107307
1634122782,-186192,true,8207076212,22,8160431274,-46644938
1634123026,-186192,true,8207076212,22,8184948099,-22128113
1634123589,-186191,true,8207896920,22,8242440851,34543931
1634123691,-186189,true,8209538581,22,8252337222,42798641
1634123995,-186192,true,8207076212,22,8242440851,35364639
1634124062,-186193,true,8206255586,22,8237497117,31241531
1634124191,-186194,true,8205435043,22,8232556348,27121305
1634124219,-186193,true,8206255586,22,8230910084,24654498
1634124361,-186197,true,8202973905,22,8225973266,22999361
1634124401,-186198,true,8202153689,22,8221861513,19707824
1634124520,-186200,true,8200513505,22,8207076212,6562707
1634124686,-186201,true,8199693535,22,8191498350,-8195185
1634124750,-186207,true,8194775441,22,8185766594,-9008847
1634124773,-186208,true,8193956045,22,8183311355,-10644690
1634124781,-186209,true,8193136731,22,8182493106,-10643625
1634124859,-186209,true,8193136731,22,8176767651,-16369080
1634124862,-186213,true,8189860296,22,8176767651,-13092645
1634124958,-186213,true,8189860296,22,8173497761,-16362535
1634125007,-186214,true,8189041392,22,8170229179,-18812213
1634125188,-186214,true,8189041392,22,8158799433,-30241959
1634125341,-186217,true,8186585170,22,8155536729,-31048441
1634125387,-186214,true,8189041392,22,8157983634,-31057758
1634125925,-186212,true,8190679282,22,8181674938,-9004344
1634126181,-186210,true,8192317500,22,8193136731,819231
1634126312,-186214,true,8189041392,22,8190679282,1637890
1634126659,-186212,true,8190679282,22,8169412238,-21267044
1634126927,-186211,true,8191498350,22,8171046202,-20452148
1634127003,-186211,true,8191498350,22,8171863307,-19635043
1634127034,-186212,true,8190679282,22,8179220926,-11458356
1634127221,-186202,true,8198873648,22,8230910084,32036436
1634127240,-186196,true,8203794202,22,8236673450,32879248
1634127477,-186193,true,8206255586,22,8306980038,100724452
1634127488,-186197,true,8202973905,22,8310303329,107329424
1634127505,-186189,true,8209538581,22,8315290758,105752177
1634127927,-186186,true,8212001689,22,8418195254,206193565
1634128020,-186182,true,8215286982,22,8418195254,202908272
1634128028,-186184,true,8213644171,22,8417353519,203709348
1634128185,-186179,true,8217751815,22,8407259257,189507442
1634128543,-186177,true,8219395448,22,8392140557,172745109
1634128703,-186173,true,8222683699,22,8381238407,158554708
1634128870,-186177,true,8219395448,22,8362820871,143425423
1634128933,-186170,true,8225150751,22,8357804934,132654183
1634129033,-186169,true,8225973266,22,8355298094,129324828
1634129269,-186164,true,8230087075,22,8347782084,117695009
1634129467,-186167,true,8227618543,22,8342775167,115156624
1634129650,-186160,true,8233379604,22,8341940973,108561369
1634129910,-186160,true,8233379604,22,8324442152,91062548
1634129927,-186156,true,8236673450,22,8322777513,86104063
1634130329,-186160,true,8233379604,22,8293700161,60320557
1634130579,-186154,true,8238320867,22,8277130165,38809298
1634130727,-186154,true,8238320867,22,8282925894,44605027
1634131170,-186149,true,8242440851,22,8297018139,54577288
1634131229,-186151,true,8240792610,22,8299507493,58714883
1634132166,-186142,true,8248212291,22,8368676602,120464311
1634132415,-186142,true,8248212291,22,8360312526,112100235
1634132465,-186137,true,8252337222,22,8359476578,107139356
1634132484,-186140,true,8249862016,22,8358640714,108778698
1634132627,-186134,true,8254813171,22,8345278250,90465079
1634132743,-186135,true,8253987772,22,8333603618,79615846
1634132799,-186133,true,8255638652,22,8325274596,69635944
1634132839,-186135,true,8253987772,22,8319449235,65461463
1634132886,-186129,true,8258941403,22,8315290758,56349355
1634132987,-186130,true,8258115591,22,8306149423,48033832
1634133081,-186126,true,8261419333,22,8297018139,35598806
1634133312,-186130,true,8258115591,22,8281269558,23153967
1634133511,-186125,true,8262245475,22,8277130165,14884690
1634133541,-186126,true,8261419333,22,8277957878,16538545
1634133557,-186124,true,8263071699,22,8278785674,15713975
1634133888,-186127,true,8260593274,22,8295358984,34765710
1634134484,-186121,true,8265550869,22,8318617373,53066504
1634134783,-186122,true,8264724396,22,8317785594,53061198
1634134812,-186121,true,8265550869,22,8317785594,52234725
1634135035,-186123,true,8263898007,22,8318617373,54719366
1634135400,-186117,true,8268857585,22,8317785594,48928009
1634135417,-186120,true,8266377424,22,8315290758,48913334
1634135526,-186118,true,8268030782,22,8317785594,49754812
1634135642,-186121,true,8265550869,22,8320281179,54730310
1634135804,-186115,true,8270511439,22,8321945319,51433880
1634135842,-186116,true,8269684471,22,8322777513,53093042
1634135941,-186115,true,8270511439,22,8321113208,50601769
1634136155,-186116,true,8269684471,22,8322777513,53093042
1634136257,-186108,true,8276302534,22,8323609791,47307257
1634136362,-186109,true,8275474987,22,8324442152,48967165
1634137090,-186107,true,8277130165,22,8314459312,37329147
1634137135,-186108,true,8276302534,22,8312796669,36494135
1634137253,-186100,true,8282925894,22,8312796669,29870775
1634137275,-186100,true,8282925894,22,8312796669,29870775
1634137329,-186098,true,8284582562,22,8314459312,29876750
1634137385,-186098,true,8284582562,22,8317785594,33203032
1634137588,-186093,true,8288725682,22,8323609791,34884109
1634137665,-186094,true,8287896892,22,8329438066,41541174
1634137833,-186093,true,8288725682,22,8329438066,40712384
1634137956,-186093,true,8288725682,22,8329438066,40712384
1634138176,-186089,true,8292041670,22,8328605206,36563536
1634138227,-186089,true,8292041670,22,8326939735,34898065
1634138278,-186088,true,8292870874,22,8324442152,31571278
1634138420,-186088,true,8292870874,22,8318617373,25746499
1634138445,-186083,true,8297018139,22,8317785594,20767455
1634138488,-186082,true,8297847841,22,8315290758,17442917
1634138525,-186081,true,8298677625,22,8309472382,10794757
1634138700,-186082,true,8297847841,22,8292041670,-5806171
1634138921,-186077,true,8301997594,22,8275474987,-26522607
1634138929,-186077,true,8301997594,22,8274647522,-27350072
1634139061,-186076,true,8302827794,22,8267204062,-35623732
1634139220,-186077,true,8301997594,22,8257289862,-44707732
1634139257,-186072,true,8306149423,22,8255638652,-50510771
1634139351,-186072,true,8306149423,22,8249862016,-56287407
1634139437,-186071,true,8306980038,22,8244913831,-62066207
1634139502,-186073,true,8305318892,22,8242440851,-62878041
1634139734,-186069,true,8308641517,22,8234202942,-74438575
1634139758,-186070,true,8307810736,22,8233379604,-74431132
1634139859,-186070,true,8307810736,22,8227618543,-80192193
1634139914,-186072,true,8306149423,22,8223505967,-82643456
1634139942,-186069,true,8308641517,22,8221039409,-87602108
1634140179,-186064,true,8312796669,22,8247387552,-65409117
1634140500,-186062,true,8314459312,22,8291212549,-23246763
1634140519,-186064,true,8312796669,22,8293700161,-19096508
1634140590,-186065,true,8311965473,22,8303658077,-8307396
1634140610,-186066,true,8311134359,22,8305318892,-5815467
1634141013,-186068,true,8309472382,22,8317785594,8313212
1634141079,-186070,true,8307810736,22,8309472382,1661646
1634141156,-186073,true,8305318892,22,8295358984,-9959908
1634141371,-186075,true,8303658077,22,8255638652,-48019425
1634141396,-186081,true,8298677625,22,8251512071,-47165554
1634141687,-186083,true,8297018139,22,8216930122,-80088017
1634141700,-186085,true,8295358984,22,8215286982,-80072002
1634141837,-186085,true,8295358984,22,8204614582,-90744402
1634142043,-186090,true,8291212549,22,8195594918,-95617631
1634142050,-186091,true,8290383510,22,8195594918,-94788592
1634142142,-186092,true,8289554555,22,8211180571,-78373984
1634142220,-186089,true,8292041670,22,8223505967,-68535703
1634142421,-186090,true,8291212549,22,8254813171,-36399378
1634142818,-186092,true,8289554555,22,8305318892,15764337
1634143400,-186094,true,8287896892,22,8289554555,1657663
1634143416,-186091,true,8290383510,22,8288725682,-1657828
1634143451,-186092,true,8289554555,22,8287068186,-2486369
1634143561,-186094,true,8287896892,22,8278785674,-9111218
1634143568,-186095,true,8287068186,22,8277957878,-9110308
1634143806,-186093,true,8288725682,22,8262245475,-26480207
1634143840,-186094,true,8287896892,22,8260593274,-27303618
1634144210,-186097,true,8285411021,22,8250687002,-34724019
1634144224,-186101,true,8282097685,22,8249862016,-32235669
1634144483,-186098,true,8284582562,22,8249037112,-35545450
1634144523,-186100,true,8282925894,22,8250687002,-32238892
1634144626,-186102,true,8281269558,22,8256464216,-24805342
1634144630,-186104,true,8279613552,22,8256464216,-23149336
1634144770,-186101,true,8282097685,22,8247387552,-34710133
1634144857,-186103,true,8280441513,22,8241616689,-38824824
1634145020,-186104,true,8279613552,22,8248212291,-31401261
1634145148,-186106,true,8277957878,22,8243265095,-34692783
1634145426,-186104,true,8279613552,22,8221861513,-57752039
1634145536,-186106,true,8277957878,22,8208717709,-69240169
1634145609,-186109,true,8275474987,22,8209538581,-65936406
1634145656,-186111,true,8273820140,22,8210359535,-63460605
1634145713,-186109,true,8275474987,22,8209538581,-65936406
1634145765,-186112,true,8272992841,22,8207076212,-65916629
1634145799,-186115,true,8270511439,22,8206255586,-64255853
1634145894,-186116,true,8269684471,22,8205435043,-64249428
1634146061,-186113,true,8272165624,22,8212822889,-59342735
1634146417,-186120,true,8266377424,22,8178403086,-87974338
1634146438,-186123,true,8263898007,22,8179220926,-84677081
1634146591,-186124,true,8263071699,22,8184129686,-78942013
1634146682,-186122,true,8264724396,22,8185766594,-78957802
1634146963,-186125,true,8262245475,22,8171863307,-90382168
1634147045,-186128,true,8259767297,22,8183311355,-76455942
1634147243,-186130,true,8258115591,22,8212822889,-45292702
1634147492,-186128,true,8259767297,22,8218573590,-41193707
1634147760,-186132,true,8256464216,22,8199693535,-56770681
1634147911,-186136,true,8253162456,22,8188222569,-64939887
1634147924,-186138,true,8251512071,22,8187403829,-64108242
1634148032,-186137,true,8252337222,22,8179220926,-73116296
1634148120,-186141,true,8249037112,22,8171863307,-77173805
1634148157,-186144,true,8246562896,22,8168595379,-77967517
1634148252,-186147,true,8244089422,22,8163695936,-80393486
1634148324,-186146,true,8244913831,22,8158799433,-86114398
1634148365,-186150,true,8241616689,22,8156352282,-85264407
1634148537,-186154,true,8238320867,22,8153905866,-84415001
1634148548,-186157,true,8235849865,22,8153905866,-81943999
1634148783,-186157,true,8235849865,22,8155536729,-80313136
1634148926,-186161,true,8232556348,22,8147385676,-85170672
1634149054,-186165,true,8229264149,22,8144941949,-84322200
1634149144,-186167,true,8227618543,22,8142498955,-85119588
1634149169,-186167,true,8227618543,22,8142498955,-85119588
1634149227,-186170,true,8225150751,22,8142498955,-82651796
1634149421,-186175,true,8221039409,22,8135174368,-85865041
1634149479,-186178,true,8218573590,22,8133547578,-85026012
1634149611,-186177,true,8219395448,22,8127856371,-91539077
1634149621,-186180,true,8216930122,22,8127856371,-89073751
1634149810,-186182,true,8215286982,22,8128669157,-86617825
1634149865,-186184,true,8213644171,22,8128669157,-84975014
1634149966,-186183,true,8214465536,22,8127856371,-86609165
1634149986,-186186,true,8212001689,22,8127856371,-84145318
1634150074,-186188,true,8210359535,22,8127856371,-82503164
1634150214,-186191,true,8207896920,22,8129482024,-78414896
1634150446,-186190,true,8208717709,22,8131108001,-77609708
1634150456,-186193,true,8206255586,22,8131108001,-75147585
1634150587,-186194,true,8205435043,22,8131921112,-73513931
1634150607,-186196,true,8203794202,22,8131921112,-71873090
1634150799,-186193,true,8206255586,22,8138428926,-67826660
1634150933,-186195,true,8204614582,22,8144941949,-59672633
1634150948,-186196,true,8203794202,22,8143313205,-60480997
1634150957,-186197,true,8202973905,22,8142498955,-60474950
1634151039,-186202,true,8198873648,22,8135174368,-63699280
1634151226,-186212,true,8190679282,22,8108373878,-82305404
1634151267,-186214,true,8189041392,22,8102700286,-86341106
1634151563,-186213,true,8189860296,22,8091365009,-98495287
1634151620,-186217,true,8186585170,22,8089746979,-96838191
1634151640,-186223,true,8181674938,22,8088129272,-93545666
1634151700,-186224,true,8180856852,22,8085703318,-95153534
1634151719,-186221,true,8183311355,22,8085703318,-97608037
1634151820,-186224,true,8180856852,22,8076814379,-104042473
1634151960,-186228,true,8177585328,22,8084894829,-92690499
1634152004,-186229,true,8176767651,22,8088938085,-87829566
1634152072,-186226,true,8179220926,22,8092983363,-86237563
1634152117,-186231,true,8175132543,22,8095411501,-79721042
1634152122,-186236,true,8171046202,22,8095411501,-75634701
1634152132,-186237,true,8170229179,22,8095411501,-74817678
1634152175,-186237,true,8170229179,22,8097030664,-73198515
1634152212,-186243,true,8165328757,22,8095411501,-69917256
1634152403,-186250,true,8159615313,22,8089746979,-69868334
1634152632,-186251,true,8158799433,22,8076006778,-82792655
1634152960,-186250,true,8159615313,22,8063096144,-96519169
1634153194,-186256,true,8154721257,22,8061483767,-93237490
1634153209,-186263,true,8149015234,22,8060677699,-88337535
1634153564,-186265,true,8147385676,22,8024487947,-122897729
1634153582,-186264,true,8148200414,22,8022883290,-125317124
1634153606,-186270,true,8143313205,22,8024487947,-118825258
1634153977,-186274,true,8140056694,22,8046986872,-93069822
1634154100,-186273,true,8140870699,22,8054232058,-86638641
1634154125,-186271,true,8142498955,22,8057454234,-85044721
1634154284,-186279,true,8135987886,22,8067128499,-68859387
1634154310,-186284,true,8131921112,22,8068742005,-63179107
1634154346,-186286,true,8130294972,22,8070355834,-59939138
1634154376,-186284,true,8131921112,22,8072777183,-59143929
1634154399,-186290,true,8127043667,22,8074391819,-52651848
1634154432,-186294,true,8123793662,22,8076814379,-46979283
1634154474,-186296,true,8122169147,22,8080045589,-42123558
1634154608,-186295,true,8122981364,22,8071162870,-51818494
1634154728,-186300,true,8118921091,22,8060677699,-58243392
1634154886,-186303,true,8116485902,22,8060677699,-55808203
1634155179,-186302,true,8117297550,22,8075199258,-42098292
1634155205,-186300,true,8118921091,22,8077622060,-41299031
1634155213,-186305,true,8114862848,22,8078429823,-36433025
1634155247,-186307,true,8113240119,22,8079237666,-34002453
1634155250,-186309,true,8111617714,22,8079237666,-32380048
1634155287,-186309,true,8111617714,22,8080853594,-30764120
1634155313,-186315,true,8106752447,22,8081661679,-25090768
1634155378,-186312,true,8109184716,22,8084894829,-24289887
1634155408,-186313,true,8108373878,22,8086511889,-21861989
1634155699,-186311,true,8109995634,22,8115674334,5678700
1634155742,-186316,true,8105941852,22,8117297550,11355698
1634155818,-186317,true,8105131339,22,8116485902,11354563
1634155885,-186318,true,8104320907,22,8114862848,10541941
1634155890,-186317,true,8105131339,22,8114051443,8920104
1634155961,-186324,true,8099460016,22,8107563122,8103106
1634156027,-186325,true,8098650151,22,8101890097,3239946
1634156116,-186327,true,8097030664,22,8096221042,-809622
1634156164,-186325,true,8098650151,22,8096221042,-2429109
1634156397,-186329,true,8095411501,22,8088938085,-6473416
1634156639,-186330,true,8094602041,22,8072777183,-21824858
1634156724,-186331,true,8093792661,22,8070355834,-23436827
1634156749,-186329,true,8095411501,22,8069548879,-25862622
1634156858,-186334,true,8091365009,22,8070355834,-21009175
1634157058,-186335,true,8090555953,22,8070355834,-20200119
1634157144,-186339,true,8087320540,22,8051816271,-35504269
1634157334,-186337,true,8088938085,22,8027698224,-61239861
1634157447,-186343,true,8084086420,22,8011659673,-72426747
1634157816,-186347,true,8080853594,22,7958163640,-122689954
1634157829,-186349,true,8079237666,22,7955776668,-123460998
1634158275,-186346,true,8081661679,22,7982072781,-99588898
1634158362,-186351,true,8077622060,22,7986064616,-91557444
1634158912,-186353,true,8076006778,22,8022883290,-53123488
1634159419,-186356,true,8073584461,22,8007655045,-65929416
1634159774,-186353,true,8076006778,22,7991656538,-84350240
1634159806,-186358,true,8071969986,22,7987661909,-84308077
1634159833,-186361,true,8069548879,22,7984467642,-85081237
1634159981,-186364,true,8067128499,22,7982870988,-84257511
1634160156,-186363,true,8067935212,22,7969312314,-98622898
1634160222,-186369,true,8063096144,22,7964532399,-98563745
1634160305,-186372,true,8060677699,22,7957367903,-103309796
1634160503,-186377,true,8056648569,22,7940675798,-115972771
1634160614,-186376,true,8057454234,22,7935913059,-121541175
1634160664,-186381,true,8053426715,22,7933532762,-119893953
1634160852,-186383,true,8051816271,22,7929567185,-122249086
1634160873,-186387,true,8048596350,22,7927981509,-120614841
1634160997,-186387,true,8048596350,22,7924018708,-124577642
1634161156,-186394,true,8042964585,22,7913724690,-129239895
1634161306,-186397,true,8040552179,22,7920849892,-119702287
1634161552,-186401,true,8037336762,22,7920849892,-116486870
1634161556,-186401,true,8037336762,22,7920057887,-117278875
1634161791,-186404,true,8034926043,22,7933532762,-101393281
1634162053,-186400,true,8038140495,22,7968515462,-69625033
1634162111,-186403,true,8035729535,22,7971703346,-64026189
1634162127,-186404,true,8034926043,22,7973297767,-61628276
1634162262,-186408,true,8031712876,22,7979678638,-52034238
1634162383,-186406,true,8033319299,22,7985266089,-48053210
1634162676,-186412,true,8028500993,22,7966125386,-62375607
1634162731,-186415,true,8026092925,22,7961347383,-64745542
1634162760,-186418,true,8023685578,22,7958163640,-65521938
1634162824,-186417,true,8024487947,22,7959755352,-64732595
1634163361,-186418,true,8023685578,22,7974095097,-49590481
1634163473,-186421,true,8021278954,22,7975689995,-45588959
1634163633,-186424,true,8018873052,22,7986064616,-32808436
1634163691,-186421,true,8021278954,22,7986064616,-35214338
1634163818,-186423,true,8019674939,22,7981274654,-38400285
1634163960,-186425,true,8018071244,22,7974892506,-43178738
1634163982,-186428,true,8015666304,22,7974095097,-41571207
1634164418,-186427,true,8016467871,22,7963736026,-52731845
1634164442,-186430,true,8014063411,22,7963736026,-50327385
1634164588,-186431,true,8013262085,22,7962939732,-50322353
1634164744,-186434,true,8010858587,22,7960551328,-50307259
1634164959,-186435,true,8010057581,22,7937500321,-72557260
1634165004,-186436,true,8009256656,22,7932739488,-76517168
1634165041,-186437,true,8008455810,22,7929567185,-78888625
1634165118,-186441,true,8005253229,22,7921641977,-83611252
1634165284,-186444,true,8002852133,22,7908187298,-94664835
1634165290,-186449,true,7998851907,22,7907396559,-91455348
1634165355,-186450,true,7998052102,22,7905815317,-92236785
1634165447,-186451,true,7997252376,22,7904234391,-93017985
1634165955,-186450,true,7998052102,22,7941469865,-56582237
1634166398,-186455,true,7994054275,22,7916890655,-77163620
1634166697,-186456,true,7993254950,22,7894755472,-98499478
1634166878,-186457,true,7992455704,22,7904234391,-88221313
1634167129,-186457,true,7992455704,22,7943058239,-49397465
1634167194,-186460,true,7990058447,22,7952595153,-37463294
1634167201,-186459,true,7990857453,22,7952595153,-38262300
1634167365,-186458,true,7991656538,22,7987661909,-3994629
1634167505,-186458,true,7991656538,22,8012460839,20804301
1634167940,-186461,true,7989259521,22,8051011170,61751649
1634168155,-186461,true,7989259521,22,8063096144,73836623
1634168252,-186461,true,7989259521,22,8055037481,65777960
1634168322,-186461,true,7989259521,22,8046986872,57727351
1634168479,-186465,true,7986064616,22,8029303844,43239228
1634168545,-186466,true,7985266089,22,8023685578,38419489
1634168605,-186467,true,7984467642,22,8018071244,33603602
1634168621,-186467,true,7984467642,22,8017269518,32801876
1634168921,-186470,true,7982072781,22,8002051928,19979147
1634168998,-186472,true,7980476606,22,7999651792,19175186
1634169158,-186473,true,7979678638,22,8004452783,24774145
1634169166,-186473,true,7979678638,22,8005253229,25574591
1634169376,-186474,true,7978880750,22,8033319299,54438549
1634169710,-186474,true,7978880750,22,8060677699,81796949
1634169919,-186473,true,7979678638,22,8066321867,86643229
1634169925,-186472,true,7980476606,22,8066321867,85845261
1634169961,-186472,true,7980476606,22,8067128499,86651893
1634169978,-186474,true,7978880750,22,8067935212,89054462
1634170006,-186473,true,7979678638,22,8067935212,88256574
1634170122,-186473,true,7979678638,22,8068742005,89063367
1634170381,-186473,true,7979678638,22,8063902454,84223816
1634170440,-186475,true,7978082942,22,8063902454,85819512
1634170472,-186474,true,7978880750,22,8063902454,85021704
1634170663,-186472,true,7980476606,22,8067935212,87458606
1634170834,-186470,true,7982072781,22,8071162870,89090089
1634170871,-186470,true,7982072781,22,8070355834,88283053
1634170907,-186468,true,7983669275,22,8070355834,86686559
1634170981,-186465,true,7986064616,22,8068742005,82677389
1634171013,-186464,true,7986863222,22,8068742005,81878783
1634171595,-186468,true,7983669275,22,8033319299,49650024
1634171729,-186466,true,7985266089,22,8026895534,41629445
1634171755,-186465,true,7986064616,22,8025290396,39225780
1634171825,-186463,true,7987661909,22,8022081082,34419173
1634171891,-186467,true,7984467642,22,8019674939,35207297
1634171961,-186465,true,7986064616,22,8022883290,36818674
1634172068,-186462,true,7988460675,22,8025290396,36829721
1634172258,-186461,true,7989259521,22,8014063411,24803890
1634172284,-186464,true,7986863222,22,8013262085,26398863
1634172596,-186462,true,7988460675,22,7998052102,9591427
1634172693,-186460,true,7990058447,22,7995653166,5594719
1634172738,-186458,true,7991656538,22,7994054275,2397737
1634172835,-186460,true,7990058447,22,7986863222,-3195225
1634173025,-186458,true,7991656538,22,7983669275,-7987263
1634173350,-186456,true,7993254950,22,7996452731,3197781
1634173531,-186454,true,7994853680,22,8006854359,12000679
1634173575,-186455,true,7994054275,22,8009256656,15202381
1634173852,-186453,true,7995653166,22,7996452731,799565
1634174198,-186453,true,7995653166,22,7964532399,-31120767
1634174237,-186452,true,7996452731,22,7962143517,-34309214
1634174288,-186454,true,7994853680,22,7958163640,-36690040
1634174324,-186455,true,7994054275,22,7954981170,-39073105
1634174513,-186454,true,7994853680,22,7940675798,-54177882
1634174523,-186455,true,7994054275,22,7939881810,-54172465
1634174659,-186456,true,7993254950,22,7940675798,-52579152
1634175072,-186457,true,7992455704,22,7953390412,-39065292
1634175077,-186456,true,7993254950,22,7953390412,-39864538
1634175263,-186455,true,7994054275,22,7941469865,-52584410
1634175310,-186457,true,7992455704,22,7942264012,-50191692
1634175364,-186457,true,7992455704,22,7944646930,-47808774
1634175548,-186455,true,7994054275,22,7951004872,-43049403
1634175660,-186456,true,7993254950,22,7953390412,-39864538
1634175699,-186458,true,7991656538,22,7947825265,-43831273
1634175803,-186459,true,7990857453,22,7949414910,-41442543
1634175837,-186456,true,7993254950,22,7953390412,-39864538
1634175858,-186456,true,7993254950,22,7954981170,-38273780
1634175913,-186455,true,7994054275,22,7960551328,-33502947
1634176285,-186457,true,7992455704,22,7978880750,-13574954
1634176362,-186455,true,7994054275,22,7978082942,-15971333
1634176559,-186454,true,7994853680,22,7976487564,-18366116
1634176656,-186455,true,7994054275,22,7983669275,-10385000
1634176737,-186456,true,7993254950,22,7984467642,-8787308
1634176815,-186451,true,7997252376,22,7982072781,-15179595
1634176933,-186449,true,7998851907,22,7990058447,-8793460
1634177096,-186448,true,7999651792,22,7994853680,-4798112
1634177171,-186447,true,8000451757,22,7998851907,-1599850
1634177346,-186443,true,8003652418,22,8002852133,-800285
1634177445,-186442,true,8004452783,22,8003652418,-800365
1634177634,-186442,true,8004452783,22,8002852133,-1600650
1634177727,-186443,true,8003652418,22,7998052102,-5600316
1634177731,-186442,true,8004452783,22,7998052102,-6400681
1634177825,-186439,true,8006854359,22,7994054275,-12800084
1634177852,-186438,true,8007655045,22,7993254950,-14400095
1634177904,-186439,true,8006854359,22,7993254950,-13599409
1634177926,-186438,true,8007655045,22,7994054275,-13600770
1634178019,-186436,true,8009256656,22,7995653166,-13603490
1634178020,-186437,true,8008455810,22,7995653166,-12802644
1634178052,-186439,true,8006854359,22,7995653166,-11201193
1634178117,-186440,true,8006053754,22,7996452731,-9601023
1634178182,-186437,true,8008455810,22,8001251802,-7204008
1634178344,-186438,true,8007655045,22,8012460839,4805794
1634178379,-186440,true,8006053754,22,8014063411,8009657
1634178586,-186440,true,8006053754,22,8026092925,20039171
1634178609,-186436,true,8009256656,22,8026092925,16836269
1634178632,-186435,true,8010057581,22,8028500993,18443412
1634178706,-186436,true,8009256656,22,8032516047,23259391
1634178831,-186436,true,8009256656,22,8038944309,29687653
1634178945,-186433,true,8011659673,22,8041356234,29696561
1634178992,-186433,true,8011659673,22,8042964585,31304912
1634179102,-186435,true,8010057581,22,8044573259,34515678
1634179169,-186435,true,8010057581,22,8043768882,33711301
1634179175,-186434,true,8010858587,22,8043768882,32910295
1634179355,-186436,true,8009256656,22,8035729535,26472879
1634179371,-186438,true,8007655045,22,8034926043,27270998
1634179381,-186438,true,8007655045,22,8034926043,27270998
1634179583,-186437,true,8008455810,22,8028500993,20045183
1634179602,-186438,true,8007655045,22,8027698224,20043179
1634179761,-186441,true,8005253229,22,8020476906,15223677
1634180018,-186442,true,8004452783,22,8005253229,800446
1634180089,-186441,true,8005253229,22,8002852133,-2401096
1634180115,-186442,true,8004452783,22,8002852133,-1600650
1634180459,-186445,true,8002051928,22,8005253229,3201301
1634180495,-186446,true,8001251802,22,8005253229,4001427
1634180704,-186446,true,8001251802,22,7996452731,-4799071
1634180763,-186447,true,8000451757,22,7997252376,-3199381
1634180779,-186450,true,7998052102,22,7997252376,-799726
1634180923,-186450,true,7998052102,22,7997252376,-799726
1634180957,-186449,true,7998851907,22,7994054275,-4797632
1634181186,-186448,true,7999651792,22,7999651792,0
1634181230,-186451,true,7997252376,22,7999651792,2399416
1634181275,-186451,true,7997252376,22,7996452731,-799645
1634181391,-186449,true,7998851907,22,7998851907,0
1634181449,-186449,true,7998851907,22,7998851907,0
1634181483,-186453,true,7995653166,22,7998052102,2398936
1634181666,-186453,true,7995653166,22,7997252376,1599210
1634181682,-186451,true,7997252376,22,7996452731,-799645
1634182017,-186451,true,7997252376,22,7983669275,-13583101
1634182105,-186454,true,7994853680,22,7976487564,-18366116
1634182361,-186454,true,7994853680,22,7966921998,-27931682
1634182387,-186452,true,7996452731,22,7967718690,-28734041
1634182418,-186452,true,7996452731,22,7966921998,-29530733
1634182471,-186456,true,7993254950,22,7966125386,-27129564
1634182660,-186456,true,7993254950,22,7966921998,-26332952
1634182662,-186454,true,7994853680,22,7966921998,-27931682
1634182791,-186453,true,7995653166,22,7972500517,-23152649
1634182856,-186457,true,7992455704,22,7970906256,-21549448
1634182899,-186454,true,7994853680,22,7970109245,-24744435
1634183155,-186453,true,7995653166,22,7969312314,-26340852
1634183290,-186451,true,7997252376,22,7985266089,-11986287
1634183369,-186453,true,7995653166,22,7989259521,-6393645
1634183457,-186450,true,7998052102,22,8004452783,6400681
1634183493,-186445,true,8002051928,22,8011659673,9607745
1634183515,-186443,true,8003652418,22,8015666304,12013886
1634183531,-186443,true,8003652418,22,8017269518,13617100
1634183658,-186441,true,8005253229,22,8031712876,26459647
1634183682,-186436,true,8009256656,22,8034122630,24865974
1634183807,-186433,true,8011659673,22,8055842985,44183312
1634183832,-186432,true,8012460839,22,8059871712,47410873
1634183954,-186432,true,8012460839,22,8080853594,68392755
1634184035,-186429,true,8014864818,22,8095411501,80546683
1634184118,-186425,true,8018071244,22,8101079989,83008745
1634184204,-186424,true,8018873052,22,8105131339,86258287
1634184292,-186425,true,8018071244,22,8105131339,87060095
1634184315,-186422,true,8020476906,22,8104320907,83844001
1634184349,-186422,true,8020476906,22,8101890097,81413191
1634184473,-186420,true,8022081082,22,8092983363,70902281
1634184592,-186419,true,8022883290,22,8092983363,70100073
1634184628,-186416,true,8025290396,22,8093792661,68502265
1634184661,-186415,true,8026092925,22,8091365009,65272084
1634184721,-186415,true,8026092925,22,8086511889,60418964
1634184942,-186416,true,8025290396,22,8067935212,42644816
1634185199,-186414,true,8026895534,22,8056648569,29753035
1634185225,-186414,true,8026895534,22,8055842985,28947451
1634185895,-186413,true,8027698224,22,8057454234,29756010
1634185953,-186413,true,8027698224,22,8059065805,31367581
1634186158,-186411,true,8029303844,22,8055037481,25733637
1634186283,-186411,true,8029303844,22,8052621453,23317609
1634186317,-186410,true,8030106774,22,8052621453,22514679
1634186403,-186410,true,8030106774,22,8052621453,22514679
1634186416,-186407,true,8032516047,22,8053426715,20910668
1634186449,-186406,true,8033319299,22,8053426715,20107416
1634186489,-186405,true,8034122630,22,8054232058,20109428
1634186531,-186405,true,8034122630,22,8055842985,21720355
1634186564,-186403,true,8035729535,22,8056648569,20919034
1634186592,-186402,true,8036533108,22,8058259979,21726871
1634186645,-186402,true,8036533108,22,8058259979,21726871
1634186748,-186403,true,8035729535,22,8056648569,20919034
1634186761,-186402,true,8036533108,22,8055842985,19309877
1634186824,-186402,true,8036533108,22,8054232058,17698950
1634187006,-186402,true,8036533108,22,8055842985,19309877
1634187185,-186403,true,8035729535,22,8055842985,20113450
1634187687,-186401,true,8037336762,22,8042964585,5627823
1634187775,-186401,true,8037336762,22,8043768882,6432120
1634188204,-186401,true,8037336762,22,8048596350,11259588
1634188278,-186403,true,8035729535,22,8043768882,8039347
1634188330,-186402,true,8036533108,22,8041356234,4823126
1634188510,-186402,true,8036533108,22,8034926043,-1607065
1634188736,-186404,true,8034926043,22,8026092925,-8833118
1634188975,-186406,true,8033319299,22,8007655045,-25664254
1634189148,-186405,true,8034122630,22,7998851907,-35270723
1634189351,-186404,true,8034926043,22,7997252376,-37673667
1634189409,-186405,true,8034122630,22,7995653166,-38469464
1634189840,-186406,true,8033319299,22,7991656538,-41662761
1634190568,-186405,true,8034122630,22,8010858587,-23264043
1634190724,-186404,true,8034926043,22,8014063411,-20862632
1634190731,-186405,true,8034122630,22,8014063411,-20059219
1634190833,-186406,true,8033319299,22,8013262085,-20057214
1634191421,-186403,true,8035729535,22,8026895534,-8834001
1634191681,-186401,true,8037336762,22,8055842985,18506223
1634191781,-186402,true,8036533108,22,8063902454,27369346
1634191837,-186403,true,8035729535,22,8066321867,30592332
1634192024,-186398,true,8039748204,22,8073584461,33836257
1634192092,-186395,true,8042160369,22,8081661679,39501310
1634192106,-186396,true,8041356234,22,8082469846,41113612
1634192383,-186399,true,8038944309,22,8066321867,27377558
1634192431,-186395,true,8042160369,22,8065515315,23354946
1634192491,-186394,true,8042964585,22,8063902454,20937869
1634192582,-186395,true,8042160369,22,8052621453,10461084
1634192625,-186398,true,8039748204,22,8046986872,7238668
1634192674,-186395,true,8042160369,22,8041356234,-804135
1634192924,-186396,true,8041356234,22,8008455810,-32900424
1634193067,-186396,true,8041356234,22,7994054275,-47301959
1634193075,-186399,true,8038944309,22,7993254950,-45689359
1634193406,-186395,true,8042160369,22,7977285213,-64875156
1634193853,-186393,true,8043768882,22,8018071244,-25697638
1634194570,-186395,true,8042160369,22,7988460675,-53699694
1634194631,-186397,true,8040552179,22,7983669275,-56882904
1634194742,-186393,true,8043768882,22,7974095097,-69673785
1634194846,-186392,true,8044573259,22,7977285213,-67288046
1634194952,-186393,true,8043768882,22,7981274654,-62494228
1634195018,-186396,true,8041356234,22,7983669275,-57686959
1634195112,-186392,true,8044573259,22,7981274654,-63298605
1634195242,-186393,true,8043768882,22,7980476606,-63292276
1634195364,-186394,true,8042964585,22,7980476606,-62487979
1634195418,-186397,true,8040552179,22,7980476606,-60075573
1634195607,-186392,true,8044573259,22,7978880750,-65692509
1634195726,-186394,true,8042964585,22,7975689995,-67274590
1634196478,-186393,true,8043768882,22,8013262085,-30506797
1634196534,-186397,true,8040552179,22,8016467871,-24084308
1634196667,-186396,true,8041356234,22,8022081082,-19275152
1634196921,-186398,true,8039748204,22,8020476906,-19271298
1634197220,-186399,true,8038944309,22,8020476906,-18467403
1634197420,-186403,true,8035729535,22,8018873052,-16856483
1634197454,-186401,true,8037336762,22,8018873052,-18463710
1634197541,-186403,true,8035729535,22,8013262085,-22467450
1634197579,-186406,true,8033319299,22,8010057581,-23261718
1634197751,-186411,true,8029303844,22,8000451757,-28852087
1634197977,-186410,true,8030106774,22,7982870988,-47235786
1634198646,-186414,true,8026895534,22,7912142183,-114753351
1634199411,-186417,true,8024487947,22,7898703639,-125784308
1634199553,-186421,true,8021278954,22,7893966075,-127312879
1634199695,-186420,true,8022081082,22,7886865057,-135216025
1634199780,-186424,true,8018873052,22,7880558403,-138314649
1634199804,-186429,true,8014864818,22,7877406968,-137457850
1634199889,-186435,true,8010057581,22,7875831722,-134225859
1634200075,-186433,true,8011659673,22,7871894988,-139764685
1634200126,-186436,true,8009256656,22,7871107877,-138148779
1634200221,-186440,true,8006053754,22,7867960221,-138093533
1634200232,-186444,true,8002852133,22,7867960221,-134891912
1634200351,-186443,true,8003652418,22,7865600305,-138052113
1634200512,-186444,true,8002852133,22,7886076449,-116775684
1634200608,-186447,true,8000451757,22,7897124135,-103327622
1634200649,-186451,true,7997252376,22,7903444046,-93808330
1634200709,-186448,true,7999651792,22,7912933397,-86718395
1634201041,-186449,true,7998851907,22,7945441395,-53410512
1634201313,-186451,true,7997252376,22,7966125386,-31126990
1634201376,-186456,true,7993254950,22,7961347383,-31907567
1634201444,-186453,true,7995653166,22,7956572246,-39080920
1634201556,-186456,true,7993254950,22,7951004872,-42250078
1634201846,-186460,true,7990058447,22,7931946293,-58112154
1634202295,-186465,true,7986064616,22,7908978117,-77086499
1634202462,-186463,true,7987661909,22,7908978117,-78683792
1634202507,-186466,true,7985266089,22,7908978117,-76287972
1634202640,-186471,true,7981274654,22,7900283459,-80991195
1634202944,-186474,true,7978880750,22,7906605898,-72274852
1634203139,-186472,true,7980476606,22,7903444046,-77032560
1634203678,-186475,true,7978082942,22,7897124135,-80958807
1634203843,-186479,true,7974892506,22,7890020276,-84872230
1634204178,-186484,true,7970906256,22,7880558403,-90347853
1634204513,-186482,true,7972500517,22,7872682177,-99818340
1634204997,-186485,true,7970109245,22,7870320845,-99788400
1634205136,-186489,true,7966921998,22,7876619306,-90302692
1634205278,-186493,true,7963736026,22,7882922807,-80813219
1634205303,-186490,true,7966125386,22,7884499470,-81625916
1634205642,-186492,true,7964532399,22,7894755472,-69776927
1634205654,-186495,true,7962143517,22,7895544947,-66598570
1634205741,-186499,true,7958959456,22,7891598359,-67361097
1634205912,-186496,true,7961347383,22,7904234391,-57112992
1634206048,-186497,true,7960551328,22,7908187298,-52364030
1634206421,-186499,true,7958959456,22,7919265960,-39693496
1634206443,-186503,true,7955776668,22,7917682344,-38094324
1634206486,-186500,true,7958163640,22,7919265960,-38897680
1634206512,-186501,true,7957367903,22,7920057887,-37310016
1634207250,-186503,true,7955776668,22,7928774308,-27002360
1634207965,-186508,true,7951799973,22,7914516063,-37283910
1634208138,-186506,true,7953390412,22,7920849892,-32540520
1634208169,-186508,true,7951799973,22,7922434142,-29365831
1634208505,-186511,true,7949414910,22,7939881810,-9533100
1634209158,-186514,true,7947030562,22,7958163640,11133078
1634209401,-186514,true,7947030562,22,7958163640,11133078
1634209586,-186516,true,7945441395,22,7962143517,16702122
1634209724,-186518,true,7943852545,22,7964532399,20679854
1634209753,-186519,true,7943058239,22,7958959456,15901217
1634209842,-186519,true,7943058239,22,7954185751,11127512
1634209941,-186521,true,7941469865,22,7949414910,7945045
1634210000,-186525,true,7938294071,22,7946235939,7941868
1634210445,-186525,true,7938294071,22,7931153178,-7140893
1634210604,-186523,true,7939881810,22,7921641977,-18239833
1634210621,-186524,true,7939087901,22,7918474113,-20613788
1634210657,-186528,true,7935913059,22,7912933397,-22979662
1634210714,-186531,true,7933532762,22,7907396559,-26136203
1634211043,-186533,true,7931946293,22,7867173503,-64772790
1634211162,-186536,true,7929567185,22,7852240811,-77326374
1634211648,-186538,true,7927981509,22,7818550346,-109431163
1634211778,-186542,true,7924811109,22,7812298320,-112512789
1634211898,-186544,true,7923226385,22,7806051293,-117175092
1634212119,-186547,true,7920849892,22,7793572220,-127277672
1634212173,-186552,true,7916890655,22,7786561511,-130329144
1634212781,-186558,true,7912142183,22,7712171882,-199970301
1634212816,-186561,true,7909769015,22,7711400742,-198368273
1634212921,-186562,true,7908978117,22,7714485765,-194492352
1634213002,-186566,true,7905815317,22,7717572022,-188243295
1634213079,-186568,true,7904234391,22,7722203723,-182030668
1634213556,-186572,true,7901073487,22,7754703555,-146369932
1634213698,-186575,true,7898703639,22,7763237996,-135465643
1634213775,-186581,true,7893966075,22,7760133477,-133832598
1634213918,-186583,true,7892387519,22,7752377609,-140009910
1634214091,-186588,true,7888442509,22,7746953115,-141489394
1634214160,-186591,true,7886076449,22,7745403957,-140672492
1634214470,-186597,true,7881346459,22,7736889122,-144457337
1634214854,-186600,true,7878982528,22,7729929402,-149053126
1634215144,-186605,true,7875044218,22,7732248613,-142795605
1634215189,-186607,true,7873469445,22,7732248613,-141220832
1634215373,-186612,true,7869533891,22,7733021838,-136512053
1634215650,-186614,true,7867960221,22,7730702395,-137257826
1634215773,-186618,true,7864813823,22,7730702395,-134111428
1634215816,-186618,true,7864813823,22,7732248613,-132565210
1634216176,-186626,true,7858524803,22,7692147279,-166377524
1634216296,-186628,true,7856953333,22,7679850299,-177103034
1634216349,-186633,true,7853026035,22,7674476553,-178549482
1634216505,-186633,true,7853026035,22,7658377867,-194648168
1634216584,-186638,true,7849100700,22,7655315281,-193785419
1634216670,-186639,true,7848315868,22,7649193784,-199122084
1634216898,-186644,true,7844392887,22,7649193784,-195199103
1634216971,-186645,true,7843608526,22,7651488772,-192119754
1634217133,-186650,true,7839687898,22,7659143705,-180544193
1634217188,-186652,true,7838120196,22,7662207822,-175912374
1634217248,-186656,true,7834985731,22,7662974042,-172011689
1634217411,-186660,true,7831852520,22,7665273165,-166579355
1634217461,-186667,true,7826372416,22,7662974042,-163398374
1634217486,-186668,true,7825589857,22,7665273165,-160316692
1634217545,-186673,true,7821678236,22,7672941888,-148736348
1634217938,-186673,true,7821678236,22,7701382934,-120295302
1634218093,-186680,true,7816205250,22,7709087784,-107117466
1634218530,-186682,true,7814642244,22,7718343779,-96298465
1634218620,-186687,true,7810736094,22,7716028739,-94707355
1634218722,-186686,true,7811517168,22,7713714393,-97802775
1634218732,-186692,true,7806831898,22,7712943099,-93888799
1634218762,-186694,true,7805270766,22,7711400742,-93870024
1634218887,-186700,true,7800589242,22,7703693580,-96895662
1634219002,-186700,true,7800589242,22,7695994122,-104595120
1634219009,-186705,true,7796690117,22,7695994122,-100695995
1634219248,-186709,true,7793572220,22,7673709182,-119863038
1634219620,-186713,true,7790455571,22,7676011525,-114444046
1634219810,-186712,true,7791234616,22,7685227807,-106006809
1634220170,-186717,true,7787340167,22,7719115613,-68224554
1634220174,-186719,true,7785782933,22,7719115613,-66667320
1634220227,-186722,true,7783447665,22,7715257213,-68190452
1634220506,-186725,true,7781113098,22,7670640466,-110472632
1634220668,-186734,true,7774113596,22,7647664175,-126449421
1634220693,-186736,true,7772559007,22,7643841490,-128717517
1634221064,-186740,true,7769450760,22,7586729970,-182720790
1634221132,-186744,true,7766343757,22,7579905326,-186438431
1634221244,-186753,true,7759357541,22,7580663316,-178694225
1634221343,-186754,true,7758581683,22,7578389572,-180192111
1634221641,-186760,true,7753928163,22,7569301413,-184626750
1634221688,-186765,true,7750052361,22,7567031077,-183021284
1634222041,-186776,true,7741532416,22,7529292234,-212240182
1634222652,-186779,true,7739210421,22,7483505632,-255704789
1634222795,-186786,true,7733795140,22,7485002407,-248792733
1634222983,-186790,true,7730702395,22,7499986642,-230715753
1634223018,-186801,true,7722203723,22,7503737386,-218466337
1634223053,-186802,true,7721431580,22,7505988732,-215442848
1634223092,-186808,true,7716800342,22,7508991578,-207808764
1634223260,-186816,true,7710629679,22,7499986642,-210643037
1634223340,-186829,true,7700612873,22,7496987398,-203625475
1634223371,-186832,true,7698303151,22,7496237774,-202065377
1634223479,-186838,true,7693685786,22,7490992506,-202693280
1634223498,-186846,true,7687533606,22,7490992506,-196541100
1634223745,-186859,true,7677546804,22,7476026240,-201520564
1634223772,-186864,true,7673709182,22,7459597882,-214111300
1634223800,-186872,true,7667572976,22,7443949945,-223623031
1634224021,-186885,true,7657612106,22,7351484308,-306127798
1634224057,-186905,true,7642312951,22,7338998025,-303314926
1634224109,-186912,true,7636965471,22,7314089046,-322876425
1634224201,-186922,true,7629332704,22,7269611123,-359721581
1634224229,-186939,true,7616374504,22,7255812664,-360561840
1634224269,-186959,true,7601157737,22,7239868219,-361289518
1634224283,-186963,true,7598118034,22,7234078930,-364039104
1634224290,-186967,true,7595079547,22,7231186021,-363893526
1634224343,-186983,true,7582937743,22,7210247005,-372690738
1634224406,-187003,true,7567787780,22,7185056509,-382731271
1634224485,-187005,true,7566274449,22,7159238098,-407036351
1634224533,-187009,true,7563248696,22,7144220223,-419028473
1634224960,-187017,true,7557200819,22,7173570185,-383630634
1634225042,-187034,true,7544365132,22,7195841641,-348523491
1634225135,-187033,true,7545119569,22,7213131537,-331988032
1634225211,-187037,true,7542102276,22,7223958811,-318143465
1634225404,-187048,true,7533810939,22,7239868219,-293942720
1634225508,-187066,true,7520262953,22,7239868219,-280394734
1634225566,-187068,true,7518759126,22,7236972995,-281786131
1634225624,-187070,true,7517255600,22,7233355594,-283900006
1634225784,-187082,true,7508240754,22,7209526052,-298714702
1634225788,-187100,true,7494738751,22,7210247005,-284491746
1634225901,-187100,true,7494738751,22,7214574235,-280164516
1634226030,-187102,true,7493240028,22,7216738824,-276501204
1634226399,-187113,true,7485002407,22,7213852850,-271149557
1634226416,-187131,true,7471542194,22,7212410295,-259131899
1634226435,-187132,true,7470795114,22,7211689127,-259105987
1634226692,-187135,true,7468554324,22,7210968030,-257586294
1634226744,-187148,true,7458851996,22,7195122129,-263729867
1634227221,-187170,true,7442461378,22,7107168548,-335292830
1634227259,-187171,true,7441717206,22,7101485371,-340231835
1634227334,-187177,true,7437253738,22,7082338178,-354915560
1634227335,-187190,true,7427592073,22,7082338178,-345253895
1634227380,-187209,true,7413493750,22,7082338178,-331155572
1634227481,-187210,true,7412752475,22,7065361795,-347390680
1634227483,-187212,true,7411270147,22,7065361795,-345908352
1634227613,-187224,true,7402382401,22,7054066819,-348315582
1634227701,-187245,true,7386854484,22,7058300318,-328554166
1634227729,-187245,true,7386854484,22,7059006148,-327848336
1634227784,-187248,true,7384638871,22,7058300318,-326338553
1634228114,-187263,true,7373570769,22,7047016631,-326554138
1634228183,-187285,true,7357367554,22,7042085692,-315281862
1634228315,-187286,true,7356631891,22,7029421971,-327209920
1634228349,-187289,true,7354425342,22,7028719099,-325706243
1634228360,-187306,true,7341934065,22,7028016298,-313917767
1634228382,-187327,true,7326532950,22,7027313566,-299219384
1634228509,-187327,true,7326532950,22,7015377878,-311155072
1634228778,-187332,true,7322870782,22,6999261856,-323608926
1634228832,-187351,true,7308971231,22,6998561999,-310409232
1634229058,-187372,true,7293639263,22,6997862213,-295777050
1634229161,-187371,true,7294368626,22,7004162809,-290205817
1634229200,-187375,true,7291451608,22,7006964894,-284486714
1634229316,-187394,true,7277611694,22,7011170124,-266441570
1634229381,-187414,true,7263071743,22,7012572429,-250499314
1634229726,-187406,true,7268884234,22,7094387790,-174496444
1634229850,-187408,true,7267430675,22,7123533029,-143897646
1634229913,-187423,true,7256538245,22,7137079930,-119458315
1634229953,-187442,true,7242764600,22,7141363249,-101401351
1634230129,-187435,true,7247836057,22,7159954021,-87882036
1634230225,-187441,true,7243488877,22,7169984475,-73504402
1634230464,-187459,true,7230462975,22,7149222677,-81240298
1634230505,-187478,true,7216738824,22,7152082796,-64656028
1634230526,-187472,true,7221069950,22,7153513284,-67556666
1634230608,-187475,true,7218904062,22,7159238098,-59665964
1634230997,-187482,true,7213852850,22,7205201850,-8651000
1634231045,-187497,true,7203040722,22,7213852850,10812128
1634232221,-187495,true,7204481402,22,7175722471,-28758931
1634232325,-187499,true,7201600330,22,7155659552,-45940778
1634232400,-187508,true,7195122129,22,7142077385,-53044744
1634232820,-187525,true,7182901423,22,7070309032,-112592391
1634232835,-187530,true,7179311050,22,7068188364,-111122686
1634233107,-187530,true,7179311050,22,7053361483,-125949567
1634233266,-187539,true,7172852899,22,7066068331,-106784568
1634233519,-187550,true,7164967493,22,7101485371,-63482122
1634233577,-187553,true,7162818433,22,7108590053,-54228380
1634233687,-187553,true,7162818433,22,7115701843,-47116590
1634233744,-187562,true,7156375118,22,7117836767,-38538351
1634233757,-187576,true,7146363703,22,7116413413,-29950290
1634233901,-187578,true,7144934645,22,7131372835,-13561810
1634234208,-187575,true,7147078340,22,7163534714,16456374
1634234434,-187579,true,7144220223,22,7178593190,34372967
1634234666,-187591,true,7135652728,22,7215295692,79642964
1634234976,-187592,true,7134939234,22,7222514236,87575002
1634235005,-187589,true,7137079930,22,7222514236,85434306
1634235371,-187592,true,7134939234,22,7235525818,100586584
1634235522,-187604,true,7126382870,22,7241316265,114933395
1634235781,-187602,true,7127808218,22,7250735626,122927408
1634235788,-187597,true,7131372835,22,7250010625,118637790
1634236466,-187593,true,7134225812,22,7279795196,145569384
1634236922,-187597,true,7131372835,22,7247836057,116463222
1634237059,-187595,true,7132799181,22,7240592206,107793025
1634237343,-187588,true,7137793638,22,7226126215,88332577
1634237787,-187580,true,7143505872,22,7241316265,97810393
1634238018,-187583,true,7141363249,22,7244937647,103574398
1634238380,-187581,true,7142791593,22,7247111346,104319753
1634238989,-187576,true,7146363703,22,7225403675,79039972
1634239024,-187571,true,7149937600,22,7224681207,74743607
1634239124,-187574,true,7147793047,22,7226848828,79055781
1634239241,-187574,true,7147793047,22,7229740001,81946954
1634239281,-187568,true,7152082796,22,7227571513,75488717
1634239371,-187571,true,7149937600,22,7224681207,74743607
1634239580,-187576,true,7146363703,22,7220347915,73984212
1634239715,-187578,true,7144934645,22,7214574235,69639590
1634239776,-187572,true,7149222677,22,7219625952,70403275
1634240828,-187566,true,7153513284,22,7317746822,164233538
1634241699,-187570,true,7150652593,22,7311164142,160511549
1634241998,-187572,true,7149222677,22,7285621071,136398394
1634242062,-187567,true,7152798004,22,7274701377,121903373
1634242261,-187561,true,7157090756,22,7241316265,84225509
1634242282,-187569,true,7151367659,22,7237696693,86329034
1634242350,-187577,true,7145649138,22,7223958811,78309673
1634242452,-187571,true,7149937600,22,7204481402,54543802
1634242721,-187569,true,7151367659,22,7147078340,-4289319
1634243128,-187578,true,7144934645,22,7087297302,-57637343
1634243221,-187585,true,7139935191,22,7081630015,-58305176
1634243326,-187578,true,7144934645,22,7076674856,-68259789
1634243414,-187574,true,7147793047,22,7077382524,-70410523
1634243598,-187578,true,7144934645,22,7079505951,-65428694
1634243668,-187584,true,7140649184,22,7080213901,-60435283
1634244046,-187573,true,7148507827,22,7116413413,-32094414
1634244118,-187569,true,7151367659,22,7124957807,-26409852
1634244418,-187571,true,7149937600,22,7156375118,6437518
1634244514,-187576,true,7146363703,22,7164251068,17887365
1634244844,-187563,true,7155659552,22,7224681207,69021655
1634244883,-187559,true,7158522245,22,7225403675,66881430
1634245144,-187563,true,7155659552,22,7190806567,35147015
1634245200,-187569,true,7151367659,22,7185056509,33688850
1634245263,-187562,true,7156375118,22,7182183205,25808087
1634245373,-187555,true,7161386084,22,7179311050,17924966
1634245516,-187555,true,7161386084,22,7164967493,3581409
1634245951,-187560,true,7157806465,22,7144934645,-12871820
1634245971,-187552,true,7163534714,22,7147078340,-16456374
1634246027,-187543,true,7169984475,22,7152798004,-17186471
1634246056,-187544,true,7169267548,22,7154228635,-15038913
1634246155,-187546,true,7167833910,22,7169984475,2150565
1634246210,-187538,true,7173570185,22,7175004970,1434785
1634246507,-187527,true,7181465058,22,7211689127,30224069
1634246626,-187528,true,7180746984,22,7218904062,38157078
1634246735,-187531,true,7178593190,22,7228294270,49701080
1634246773,-187523,true,7184338075,22,7231909140,47571065
1634247174,-187513,true,7191525647,22,7242764600,51238953
1634247205,-187514,true,7190806567,22,7241316265,50509698
1634247208,-187525,true,7182901423,22,7240592206,57690783
1634247389,-187519,true,7187212242,22,7224681207,37468965
1634247407,-187512,true,7192244800,22,7223958811,31714011
1634247740,-187513,true,7191525647,22,7229740001,38214354
1634247780,-187521,true,7185775015,22,7229017099,43242084
1634249221,-187514,true,7190806567,22,7223958811,33152244
1634250114,-187506,true,7196561226,22,7189368621,-7192605
1634250324,-187507,true,7195841641,22,7224681207,28839566
1634250371,-187515,true,7190087558,22,7231909140,41821582
1634250513,-187510,true,7193683321,22,7230462975,36779654
1634250537,-187505,true,7197280882,22,7232632331,35351449
1634250794,-187510,true,7193683321,22,7248560841,54877520
1634250799,-187514,true,7190806567,22,7248560841,57754274
1634250814,-187507,true,7195841641,22,7248560841,52719200
1634250846,-187500,true,7200880242,22,7249285697,48405455
1634250870,-187504,true,7198000610,22,7250010625,52010015
1634251097,-187501,true,7200160226,22,7242764600,42604374
1634251204,-187497,true,7203040722,22,7222514236,19473514
1634251236,-187492,true,7206642963,22,7217460498,10817535
1634251302,-187499,true,7201600330,22,7212410295,10809965
1634251514,-187499,true,7201600330,22,7198000610,-3599720
1634251539,-187494,true,7205201850,22,7195841641,-9360209
1634251550,-187489,true,7208805172,22,7195122129,-13683043
1634251594,-187495,true,7204481402,22,7190806567,-13674835
1634251617,-187496,true,7203761026,22,7190806567,-12954459
1634251646,-187496,true,7203761026,22,7186493592,-17267434
1634251687,-187493,true,7205922371,22,7180746984,-25175387
1634251750,-187498,true,7202320490,22,7180746984,-21573506
1634251766,-187500,true,7200880242,22,7180746984,-20133258
1634252355,-187492,true,7206642963,22,7257263899,50620936
1634252603,-187489,true,7208805172,22,7290722536,81917364
1634252649,-187494,true,7205201850,22,7293639263,88437413
1634252924,-187498,true,7202320490,22,7279795196,77474706
1634253438,-187492,true,7206642963,22,7264524430,57881467
1634253691,-187490,true,7208084363,22,7265250882,57166519
1634253815,-187495,true,7204481402,22,7249285697,44804295
1634253935,-187499,true,7201600330,22,7233355594,31755264
1634253991,-187495,true,7204481402,22,7223958811,19477409
1634254061,-187497,true,7203040722,22,7210247005,7206283
1634254104,-187503,true,7198720410,22,7201600330,2879920
1634254239,-187508,true,7195122129,22,7175004970,-20117159
1634254293,-187504,true,7198000610,22,7165683990,-32316620
1634254364,-187505,true,7197280882,22,7154944058,-42336824
1634254478,-187510,true,7193683321,22,7137079930,-56603391
1634254511,-187514,true,7190806567,22,7133512461,-57294106
1634254598,-187511,true,7192964024,22,7125670303,-67293721
1634254656,-187510,true,7193683321,22,7127095508,-66587813
1634254846,-187513,true,7191525647,22,7131372835,-60152812
1634254896,-187516,true,7189368621,22,7134225812,-55142809
1634254986,-187513,true,7191525647,22,7143505872,-48019775
1634255128,-187517,true,7188649756,22,7157806465,-30843291
1634255192,-187521,true,7185775015,22,7162818433,-22956582
1634255338,-187523,true,7184338075,22,7174287542,-10050533
1634255699,-187520,true,7186493592,22,7185775015,-718577
1634255852,-187522,true,7185056509,22,7189368621,4312112
1634256204,-187521,true,7185775015,22,7200880242,15105227
1634256523,-187520,true,7186493592,22,7198000610,11507018
1634256556,-187517,true,7188649756,22,7198720410,10070654
1634256591,-187516,true,7189368621,22,7198720410,9351789
1634256611,-187514,true,7190806567,22,7199440282,8633715
1634256666,-187513,true,7191525647,22,7197280882,5755235
1634257142,-187515,true,7190087558,22,7127095508,-62992050
1634257190,-187515,true,7190087558,22,7121396397,-68691161
1634257370,-187515,true,7190087558,22,7102195519,-87892039
1634257514,-187514,true,7190806567,22,7085171538,-105635029
1634257764,-187517,true,7188649756,22,7092969125,-95680631
1634257840,-187517,true,7188649756,22,7096516319,-92133437
1634257879,-187518,true,7187930963,22,7095097229,-92833734
1634257971,-187518,true,7187930963,22,7094387790,-93543173
1634258016,-187527,true,7181465058,22,7092259899,-89205159
1634258071,-187528,true,7180746984,22,7094387790,-86359194
1634258147,-187526,true,7182183205,22,7093678422,-88504783
1634258274,-187525,true,7182901423,22,7096516319,-86385104
1634258330,-187527,true,7181465058,22,7095806738,-85658320
1634258481,-187529,true,7180028981,22,7091550744,-88478237
1634258591,-187531,true,7178593190,22,7083046412,-95546778
1634258663,-187531,true,7178593190,22,7077382524,-101210666
1634258896,-187533,true,7177157687,22,7073844894,-103312793
1634259068,-187535,true,7175722471,22,7070309032,-105413439
1634259118,-187536,true,7175004970,22,7069602072,-105402898
1634259157,-187539,true,7172852899,22,7068188364,-104664535
1634259511,-187543,true,7169984475,22,7061830174,-108154301
1634259608,-187548,true,7166400558,22,7056183251,-110217307
1634259624,-187550,true,7164967493,22,7053361483,-111606010
1634259752,-187555,true,7161386084,22,7029421971,-131964113
1634260342,-187559,true,7158522245,22,6997162497,-161359748
1634260433,-187564,true,7154944058,22,6985278019,-169666039
1634260496,-187567,true,7152798004,22,6975505961,-177292043
1634260864,-187574,true,7147793047,22,6930314463,-217478584
1634260897,-187582,true,7142077385,22,6926157729,-215919656
1634261307,-187586,true,7139221268,22,6863418726,-275802542
1634261355,-187590,true,7136366294,22,6861360113,-275006181
1634261570,-187597,true,7131372835,22,6863418726,-267954109
1634261583,-187605,true,7125670303,22,6864105068,-261565235
1634261626,-187609,true,7122820747,22,6859988046,-262832701
1634261962,-187611,true,7121396397,22,6880597879,-240798518
1634262410,-187613,true,7119972331,22,6969231143,-150741188
1634262575,-187621,true,7114278916,22,6996462851,-117816065
1634262849,-187629,true,7108590053,22,6995763274,-112826779
1634262950,-187627,true,7110011842,22,6978296582,-131715260
1634263062,-187632,true,7106457902,22,6957394107,-149063795
1634263401,-187643,true,7098645487,22,6907483259,-191162228
1634263744,-187650,true,7093678422,22,6911628785,-182049637
1634263871,-187646,true,7096516319,22,6928928608,-167587711
1634264701,-187648,true,7095097229,22,6992266442,-102830787
1634264753,-187657,true,7088714833,22,6992965668,-95749165
1634265331,-187662,true,7085171538,22,7023800963,-61370575
1634265520,-187658,true,7088006032,22,7018184450,-69821582
1634265577,-187657,true,7088714833,22,7016781024,-71933809
1634265625,-187667,true,7081630015,22,7015377878,-66252137
1634265703,-187675,true,7075967260,22,7009768101,-66199159
1634265837,-187667,true,7081630015,22,7017482702,-64147313
1634265908,-187666,true,7082338178,22,7022396414,-59941764
1634266133,-187670,true,7079505951,22,7060418020,-19087931
1634266226,-187675,true,7075967260,22,7068188364,-7778896
1634266229,-187667,true,7081630015,22,7068895183,-12734832
1634266283,-187667,true,7081630015,22,7072430337,-9199678
1634266396,-187683,true,7070309032,22,7083046412,12737380
1634266638,-187690,true,7065361795,22,7102905739,37543944
1634266936,-187682,true,7071016063,22,7080921923,9905860
1634267022,-187681,true,7071723165,22,7071016063,-707102
1634267070,-187695,true,7061830174,22,7070309032,8478858
1634267119,-187701,true,7057594558,22,7070309032,12714474
1634267271,-187692,true,7063948935,22,7077382524,13433589
1634267761,-187692,true,7063948935,22,7063948935,0
1634267980,-187704,true,7055477703,22,7051951022,-3526681
1634268182,-187707,true,7053361483,22,7037158203,-16203280
1634268464,-187697,true,7060418020,22,7035047478,-25370542
1634268771,-187696,true,7061124061,22,7030827926,-30296135
1634268832,-187709,true,7051951022,22,7030827926,-21123096
1634268861,-187712,true,7049835860,22,7030124914,-19710946
1634268874,-187703,true,7056183251,22,7030124914,-26058337
1634268905,-187702,true,7056888869,22,7030124914,-26763955
1634268941,-187716,true,7047016631,22,7029421971,-17594660
1634269150,-187720,true,7044198529,22,7025205794,-18992735
1634269214,-187712,true,7049835860,22,7025908314,-23927546
1634269252,-187711,true,7050540844,22,7026610905,-23929939
1634269530,-187724,true,7041381553,22,7037861919,-3519634
1634269630,-187729,true,7037861919,22,7030827926,-7033993
1634269641,-187721,true,7043494179,22,7030827926,-12666253
1634270008,-187722,true,7042789900,22,7020290116,-22499784
1634270063,-187737,true,7032234162,22,7017482702,-14751460
1634270075,-187742,true,7028719099,22,7016781024,-11938075
1634270167,-187734,true,7034344043,22,7010469078,-23874965
1634270485,-187736,true,7032937385,22,6986675145,-46262240
1634270673,-187751,true,7022396414,22,6985278019,-37118395
1634270876,-187755,true,7019588158,22,6985278019,-34310139
1634271184,-187747,true,7025205794,22,6990868198,-34337596
1634271733,-187752,true,7021694245,22,6920619296,-101074949
1634271909,-187762,true,7014676411,22,6896440675,-118235736
1634272094,-187767,true,7011170124,22,6875095877,-136074247
1634272576,-187760,true,7016079416,22,6886104285,-129975131
1634273025,-187764,true,7013273686,22,6894372156,-118901530
1634273127,-187776,true,7004863225,22,6896440675,-108422550
1634273313,-187780,true,7002061980,22,6904030553,-98031427
1634273478,-187773,true,7006964894,22,6915085291,-91879603
1634273518,-187776,true,7004863225,22,6916468377,-88394848
1634274684,-187787,true,6997162497,22,6877846328,-119316169
1634274963,-187792,true,6993664965,22,6879909888,-113755077
1634275077,-187784,true,6999261856,22,6910937692,-88324164
1634275131,-187788,true,6996462851,22,6918543525,-77919326
1634275391,-187798,true,6989470234,22,6912319948,-77150286
1634275657,-187802,true,6986675145,22,6915085291,-71589854
1634275683,-187797,true,6990169181,22,6915085291,-75083890
1634276064,-187800,true,6988072550,22,6881974068,-106098482
1634276319,-187811,true,6980390280,22,6874408436,-105981844
1634276390,-187815,true,6977598822,22,6870972263,-106626559
1634276426,-187810,true,6981088319,22,6868911384,-112176935
1634276437,-187815,true,6977598822,22,6868224561,-109374261
1634276593,-187825,true,6970625059,22,6862732453,-107892606
1634277422,-187830,true,6967140792,22,6814863456,-152277336
1634277579,-187824,true,6971322122,22,6813500688,-157821434
1634277613,-187828,true,6968534290,22,6811457047,-157077243
1634277685,-187837,true,6962265744,22,6808733145,-153532599
1634278354,-187842,true,6958785655,22,6813500688,-145284967
1634278459,-187835,true,6963658267,22,6812138192,-151520075
1634278509,-187836,true,6962961970,22,6812819406,-150142564
1634278872,-187841,true,6959481534,22,6810775969,-148705565
1634279251,-187846,true,6956002836,22,6800567973,-155434863
1634279387,-187840,true,6960177482,22,6795809479,-164368003
1634279591,-187841,true,6959481534,22,6789696308,-169785226
1634279603,-187846,true,6956002836,22,6789696308,-166306528
1634279849,-187851,true,6952525878,22,6779519906,-173005972
1634279998,-187847,true,6955307306,22,6781553966,-173753340
1634280014,-187854,true,6950440538,22,6781553966,-168886572
1634280022,-187859,true,6946966360,22,6782232121,-164734239
1634280101,-187862,true,6944882686,22,6784266994,-160615692
1634280158,-187859,true,6946966360,22,6783588635,-163377725
1634280216,-187863,true,6944188268,22,6783588635,-160599633
1634280354,-187866,true,6942105428,22,6784945421,-157160007
1634280372,-187871,true,6938635416,22,6784945421,-153689995
1634280600,-187868,true,6940717215,22,6792412594,-148304621
1634280670,-187876,true,6935167139,22,6781553966,-153613173
1634280800,-187881,true,6931700595,22,6778842022,-152858573
1634281295,-187889,true,6926157729,22,6735598123,-190559606
1634281584,-187885,true,6928928608,22,6751107052,-177821556
1634283171,-187893,true,6923387959,22,6749082125,-174305834
1634283244,-187898,true,6919927303,22,6749082125,-170845178
1634283741,-187903,true,6916468377,22,6745034093,-171434284
1634284039,-187903,true,6916468377,22,6756509828,-159958549
1634284100,-187912,true,6910246667,22,6757861198,-152385469
1634284159,-187922,true,6903340219,22,6759212838,-144127381
1634284323,-187927,true,6899889585,22,6763945706,-135943879
1634284480,-187929,true,6898509814,22,6762593120,-135916694
1634284482,-187938,true,6892304258,22,6761916929,-130387329
1634284489,-187943,true,6888859139,22,6760564748,-128294391
1634284604,-187950,true,6884038866,22,6752457341,-131581525
1634284691,-187955,true,6880597879,22,6743685288,-136912591
1634284806,-187964,true,6874408436,22,6730212069,-144196367
1634284836,-187969,true,6870972263,22,6726175355,-144796908
1634284908,-187977,true,6865477958,22,6717437444,-148040514
1634284946,-187984,true,6860674045,22,6706698675,-153975370
1634285049,-187992,true,6855187975,22,6692630088,-162557887
1634285114,-187997,true,6851761409,22,6682599170,-169162239
1634285137,-188005,true,6846282466,22,6678591013,-167691453
1634285267,-188012,true,6841491984,22,6653927116,-187564868
1634285433,-188022,true,6834654254,22,6625378081,-209276173
1634285497,-188028,true,6830554896,22,6616771116,-213783780
1634285514,-188037,true,6824410469,22,6612802442,-211608027
1634285549,-188046,true,6818271570,22,6604211814,-214059756
1634285803,-188058,true,6810094960,22,6556834620,-253260340
1634285835,-188063,true,6806690933,22,6555523450,-251167483
1634285842,-188071,true,6801248030,22,6555523450,-245724580
1634286445,-188082,true,6793771144,22,6478626701,-315144443
1634286650,-188096,true,6784266994,22,6454055862,-330211132
1634286704,-188104,true,6778842022,22,6447605355,-331236667
1634286843,-188112,true,6773421388,22,6427649723,-345771665
1634286929,-188128,true,6762593120,22,6410960374,-351632746
1634287073,-188140,true,6754483281,22,6406474496,-348008785
1634287114,-188145,true,6751107052,22,6405833912,-345273140
1634287151,-188153,true,6745708596,22,6403912547,-341796049
1634287267,-188166,true,6736945310,22,6394314358,-342630952
1634287618,-188174,true,6731558179,22,6432150428,-299407751
1634287743,-188180,true,6727520657,22,6448894940,-278625717
1634287745,-188187,true,6722813276,22,6449539830,-273273446
1634287778,-188199,true,6714751141,22,6458575057,-256176084
1634288046,-188210,true,6707369345,22,6448250115,-259119230
1634288243,-188216,true,6703346331,22,6436654284,-266692047
1634288480,-188221,true,6699995663,22,6423152167,-276843496
1634288607,-188231,true,6693299351,22,6426364386,-266934965
1634288655,-188241,true,6686609732,22,6425079306,-261530426
1634288784,-188245,true,6683935756,22,6432793643,-251142113
1634288810,-188250,true,6680594791,22,6435367146,-245227645
1634288879,-188260,true,6673917869,22,6450184784,-223733085
1634288895,-188270,true,6667247620,22,6454055862,-213191758
1634288928,-188267,true,6669247995,22,6463097416,-206150579
1634288941,-188272,true,6665914371,22,6463097416,-202816955
1634288994,-188286,true,6656589086,22,6466329611,-190259475
1634289070,-188299,true,6647941575,22,6472151636,-175789939
1634289128,-188301,true,6646612186,22,6474740885,-171871301
1634289134,-188304,true,6644618601,22,6476035898,-168582703
1634289167,-188316,true,6636650239,22,6478626701,-158023538
1634289449,-188325,true,6630680239,22,6489649182,-141031057
1634289737,-188324,true,6631343307,22,6511099325,-120243982
1634289795,-188327,true,6629354302,22,6509797300,-119557002
1634290181,-188338,true,6622066386,22,6532620367,-89446019
1634290227,-188346,true,6616771116,22,6534580349,-82190767
1634290290,-188346,true,6616771116,22,6537848292,-78922824
1634290330,-188347,true,6616109505,22,6541117870,-74991635
1634290332,-188356,true,6610157982,22,6541117870,-69040112
1634290438,-188361,true,6606853895,22,6548971530,-57882365
1634290986,-188359,true,6608175332,22,6593654051,-14521281
1634291904,-188360,true,6607514580,22,6622728592,15214012
1634292209,-188370,true,6600910698,22,6592335518,-8575180
1634292631,-188377,true,6596291908,22,6552246671,-44045237
1634292750,-188375,true,6597611233,22,6537194573,-60416660
1634292796,-188378,true,6595632345,22,6527396621,-68235724
1634292830,-188389,true,6588381501,22,6522177053,-66204448
1634292859,-188399,true,6581796741,22,6516310028,-65486713
1634293004,-188403,true,6579164681,22,6489000282,-90164399
1634293053,-188406,true,6577191326,22,6478626701,-98564625
1634293180,-188419,true,6568646960,22,6452120032,-116526928
1634293255,-188428,true,6562738132,22,6443093836,-119644296
1634293305,-188431,true,6560769704,22,6433436922,-127332782
1634293311,-188436,true,6557490303,22,6432793643,-124696660
1634293356,-188451,true,6547661933,22,6414807912,-132854021
1634293365,-188464,true,6539155927,22,6410960374,-128195553
1634293675,-188473,true,6533273629,22,6301640170,-231633459
1634293692,-188478,true,6530007972,22,6297230786,-232777186
1634293740,-188492,true,6520872813,22,6287792492,-233080321
1634293801,-188502,true,6514355525,22,6288421271,-225934254
1634293966,-188504,true,6513052850,22,6284021136,-229031714
1634294202,-188508,true,6510448280,22,6257059203,-253389077
1634294468,-188523,true,6500690416,22,6280252043,-220438373
1634294874,-188534,true,6493543945,22,6283392797,-210151148
1634295219,-188534,true,6493543945,22,6322468889,-171075056
1634295294,-188538,true,6490947176,22,6331959234,-158987942
1634295499,-188551,true,6482514849,22,6350982682,-131532167
1634295679,-188559,true,6477331170,22,6389840128,-87491042
1634295774,-188558,true,6477978903,22,6401351622,-76627281
1634295819,-188563,true,6474740885,22,6402631956,-72108929
1634295849,-188573,true,6468269704,22,6403272219,-64997485
1634295893,-188583,true,6461804990,22,6404552938,-57252052
1634295937,-188582,true,6462451171,22,6404552938,-57898233
1634296098,-188585,true,6460512823,22,6404552938,-55959885
1634296216,-188591,true,6456637872,22,6413525142,-43112730
1634296342,-188601,true,6450184784,22,6423152167,-27032617
1634296349,-188600,true,6450829802,22,6423794482,-27035320
1634296359,-188601,true,6450184784,22,6424436862,-25747922
1634296528,-188608,true,6445671460,22,6412883854,-32787606
1634296607,-188618,true,6439229332,22,6407115143,-32114189
1634296747,-188615,true,6441161294,22,6414807912,-26353382
1634296948,-188615,true,6441161294,22,6425721814,-15439480
1634297057,-188621,true,6437297949,22,6428292488,-9005461
1634297201,-188626,true,6434080266,22,6443738145,9657879
1634297228,-188622,true,6436654284,22,6446316027,9661743
1634297256,-188618,true,6439229332,22,6451474885,12245553
1634297504,-188618,true,6439229332,22,6506543378,67314046
1634297570,-188620,true,6437941679,22,6516961659,79019980
1634297646,-188616,true,6440517242,22,6527396621,86879379
1634297676,-188612,true,6443093836,22,6531967170,88873334
1634297793,-188611,true,6443738145,22,6549626428,105888283
1634297871,-188612,true,6443093836,22,6558801867,115708031
1634297915,-188608,true,6445671460,22,6564050745,118379285
1634298143,-188604,true,6448250115,22,6567990161,119740046
1634298155,-188598,true,6452120032,22,6567990161,115870129
1634298314,-188599,true,6451474885,22,6567990161,116515276
1634298321,-188595,true,6454055862,22,6567990161,113934299
1634298465,-188590,true,6457283535,22,6569960755,112677220
1634298537,-188586,true,6459866836,22,6568646960,108780124
1634298550,-188591,true,6456637872,22,6569303824,112665952
1634298618,-188586,true,6459866836,22,6571931940,112065104
1634298702,-188582,true,6462451171,22,6575218563,112767392
1634298749,-188579,true,6464390100,22,6577849045,113458945
1634298772,-188578,true,6465036539,22,6580480580,115444041
1634298852,-188569,true,6470857400,22,6593654051,122796651
1634298872,-188565,true,6473446131,22,6596291908,122845777
1634298941,-188562,true,6475388359,22,6605532722,130144363
1634298977,-188562,true,6475388359,22,6610818998,135430639
1634299088,-188555,true,6479922491,22,6623390865,143468374
1634299134,-188552,true,6481866662,22,6624715610,142848948
1634299267,-188549,true,6483811417,22,6637977635,154166218
1634299482,-188548,true,6484459798,22,6667914345,183454547
1634299543,-188546,true,6485756755,22,6674585261,188828506
1634299624,-188543,true,6487702676,22,6684604150,196901474
1634299660,-188535,true,6492894655,22,6691960892,199066237
1634299693,-188529,true,6496791366,22,6700665663,203874297
1634299902,-188519,true,6503291082,22,6751107052,247815970
1634300011,-188515,true,6505892788,22,6764622101,258729313
1634300289,-188511,true,6508495536,22,6782910344,274414808
1634300316,-188508,true,6510448280,22,6783588635,273140355
1634300463,-188503,true,6513704155,22,6789696308,275992153
1634300546,-188501,true,6515006961,22,6776131163,261124202
1634300585,-188499,true,6516310028,22,6768681889,252371861
1634300642,-188498,true,6516961659,22,6755834245,238872586
1634300774,-188494,true,6519568834,22,6726175355,206606521
1634300917,-188491,true,6521524901,22,6706698675,185173774
1634301083,-188491,true,6521524901,22,6693299351,171774450
1634301141,-188491,true,6521524901,22,6689284777,167759876
1634301280,-188490,true,6522177053,22,6677923221,155746168
1634301648,-188488,true,6523481554,22,6672583286,149101732
1634301711,-188486,true,6524786315,22,6669914919,145128604
1634301948,-188486,true,6524786315,22,6661916222,137129907
1634301986,-188484,true,6526091338,22,6661250097,135158759
1634302186,-188479,true,6529355036,22,6655257968,125902932
1634302196,-188477,true,6530660972,22,6655923494,125262522
1634302246,-188474,true,6532620367,22,6647941575,115321208
1634302260,-188467,true,6537194573,22,6645947591,108753018
1634302402,-188465,true,6538502077,22,6631343307,92841230
1634302815,-188462,true,6540463824,22,6594972848,54509024
1634302822,-188460,true,6541771982,22,6594972848,53200866
1634303246,-188452,true,6547007232,22,6597611233,50604001
1634303312,-188450,true,6548316699,22,6599590714,51274015
1634303435,-188443,true,6552901896,22,6601570789,48668893
1634303604,-188436,true,6557490303,22,6616109505,58619202
1634303673,-188421,true,6567333427,22,6622728592,55395165
1634303911,-188418,true,6569303824,22,6632006441,62702617
1634303954,-188411,true,6573903717,22,6633996242,60092525
1634304041,-188405,true,6577849045,22,6637977635,60128590
1634304069,-188398,true,6582454921,22,6639305297,56850376
1634304094,-188393,true,6585746807,22,6640633225,54886418
1634304431,-188386,true,6590358213,22,6657920470,67562257
1634304850,-188380,true,6594313417,22,6657920470,63607053
1634304867,-188373,true,6598930821,22,6657920470,58989649
1634304969,-188370,true,6600910698,22,6654592509,53681811
1634304979,-188365,true,6604211814,22,6652596530,48384716
1634305118,-188368,true,6602230946,22,6630017237,27786291
1634305298,-188364,true,6604872235,22,6603551459,-1320776
1634305435,-188361,true,6606853895,22,6590358213,-16495682
1634305651,-188357,true,6609497033,22,6573246392,-36250641
1634306025,-188357,true,6609497033,22,6547007232,-62489801
1634306195,-188353,true,6612141228,22,6547007232,-65133996
1634306282,-188350,true,6614125069,22,6547007232,-67117837
1634306317,-188348,true,6615447960,22,6546352597,-69095363
1634306428,-188348,true,6615447960,22,6545043522,-70404438
1634306595,-188343,true,6618756346,22,6547007232,-71749114
1634306911,-188341,true,6620080163,22,6564050745,-56029418
1634306946,-188337,true,6622728592,22,6564707150,-58021442
1634307020,-188336,true,6623390865,22,6566020158,-57370707
1634307232,-188332,true,6626040619,22,6565363621,-60676998
1634307502,-188332,true,6626040619,22,6558146052,-67894567
1634307684,-188329,true,6628028630,22,6550281390,-77747240
1634307728,-188330,true,6627365893,22,6547661933,-79703960
1634307883,-188327,true,6629354302,22,6548971530,-80382772
1634307976,-188329,true,6628028630,22,6556179002,-71849628
1634308120,-188331,true,6626703223,22,6547007232,-79695991
1634308258,-188334,true,6624715610,22,6539155927,-85559683
1634308361,-188332,true,6626040619,22,6533926956,-92113663
1634308375,-188335,true,6624053204,22,6533273629,-90779575
1634308591,-188336,true,6623390865,22,6528049361,-95341504
1634308648,-188337,true,6622728592,22,6527396621,-95331971
1634308814,-188335,true,6624053204,22,6515658462,-108394742
1634308926,-188338,true,6622066386,22,6500040411,-122025975
1634308966,-188340,true,6620742171,22,6498090789,-122651382
1634308994,-188343,true,6618756346,22,6496791366,-121964980
1634309146,-188342,true,6619418221,22,6495492203,-123926018
1634309443,-188347,true,6616109505,22,6484459798,-131649707
1634309846,-188351,true,6613463722,22,6432150428,-181313294
1634309916,-188353,true,6612141228,22,6440517242,-171623986
1634310052,-188352,true,6612802442,22,6442449591,-170352851
1634310306,-188356,true,6610157982,22,6459220914,-150937068
1634310467,-188356,true,6610157982,22,6478626701,-131531281
1634310476,-188360,true,6607514580,22,6479922491,-127592089
1634310556,-188360,true,6607514580,22,6490947176,-116567404
1634310604,-188367,true,6602891169,22,6496141752,-106749417
1634310719,-188368,true,6602230946,22,6513052850,-89178096
1634310744,-188371,true,6600250673,22,6517613355,-82637318
1634310854,-188370,true,6600910698,22,6518265116,-82645582
1634311413,-188374,true,6598270994,22,6540463824,-57807170
1634311588,-188377,true,6596291908,22,6533926956,-62364952
1634311765,-188383,true,6592335518,22,6518916943,-73418575
1634311801,-188383,true,6592335518,22,6515658462,-76677056
1634312215,-188390,true,6587722729,22,6489649182,-98073547
1634312416,-188395,true,6584429855,22,6467622941,-116806914
1634312719,-188404,true,6578506830,22,6448894940,-129611890
1634312871,-188410,true,6574561107,22,6437941679,-136619428
1634312916,-188419,true,6568646960,22,6439873255,-128773705
1634313037,-188420,true,6567990161,22,6437297949,-130692212
1634313143,-188427,true,6563394406,22,6437941679,-125452727
1634313166,-188428,true,6562738132,22,6439229332,-123508800
1634313232,-188436,true,6557490303,22,6443738145,-113752158
1634313264,-188435,true,6558146052,22,6445671460,-112474592
1634313382,-188442,true,6553557186,22,6454055862,-99501324
1634313448,-188441,true,6554212542,22,6458575057,-95637485
1634313669,-188454,true,6545698027,22,6448894940,-96803087
1634313707,-188454,true,6545698027,22,6446960658,-98737369
1634313937,-188458,true,6543080402,22,6455992272,-87088130
1634314097,-188456,true,6544389083,22,6461158874,-83230209
1634314262,-188466,true,6537848292,22,6461158874,-76689418
1634314610,-188466,true,6537848292,22,6485108244,-52740048
1634314642,-188471,true,6534580349,22,6483163100,-51417249
1634314666,-188469,true,6535887330,22,6482514849,-53372481
1634314718,-188479,true,6529355036,22,6480570483,-48784553
1634315461,-188478,true,6530007972,22,6476683501,-53324471
1634316223,-188481,true,6528049361,22,6491596271,-36453090
1634316273,-188479,true,6529355036,22,6492245431,-37109605
1634316294,-188485,true,6525438794,22,6491596271,-33842523
1634316571,-188484,true,6526091338,22,6485756755,-40334583
1634316606,-188488,true,6523481554,22,6484459798,-39021756
1634316631,-188489,true,6522829271,22,6478626701,-44202570
1634317087,-188496,true,6518265116,22,6446316027,-71949089
1634317534,-188498,true,6516961659,22,6413525142,-103436517
1634317589,-188503,true,6513704155,22,6412242630,-101461525
1634318144,-188504,true,6513052850,22,6393674991,-119377859
1634318355,-188513,true,6507194032,22,6378987170,-128206862
1634318422,-188517,true,6504591805,22,6375161117,-129430688
1634318660,-188522,true,6501340485,22,6372611690,-128728795
1634318709,-188525,true,6499390472,22,6372611690,-126778782
1634318890,-188534,true,6493543945,22,6367515894,-126028051
1634319529,-188540,true,6489649182,22,6335759360,-153889822
1634319605,-188545,true,6486405330,22,6328794204,-157611126
1634319796,-188548,true,6484459798,22,6316781512,-167678286
1634319941,-188558,true,6477978903,22,6300380031,-177598872
1634320063,-188566,true,6472798851,22,6293453769,-179345082
1634320168,-188567,true,6472151636,22,6285906531,-186245105
1634320291,-188568,true,6471504486,22,6288421271,-183083215
1634320377,-188576,true,6466329611,22,6280880068,-185449543
1634320427,-188585,true,6460512823,22,6279624081,-180888742
1634320433,-188584,true,6461158874,22,6279624081,-181534793
1634320590,-188584,true,6461158874,22,6292824487,-168334387
1634320621,-188589,true,6457929264,22,6295341994,-162587270
1634320777,-188597,true,6452765244,22,6309206298,-143558946
1634320860,-188599,true,6451474885,22,6311099250,-140375635
1634320888,-188602,true,6449539830,22,6311099250,-138440580
1634320960,-188609,true,6445026957,22,6312361533,-132665424
1634321032,-188617,true,6439873255,22,6318676735,-121196520
1634321042,-188618,true,6439229332,22,6319308603,-119920729
1634321117,-188619,true,6438585473,22,6320572528,-118012945
1634321214,-188623,true,6436010683,22,6324365820,-111644863
1634321324,-188631,true,6430864191,22,6334492398,-96371793
1634321393,-188632,true,6430221168,22,6334492398,-95728770
1634321471,-188632,true,6430221168,22,6333859012,-96362156
1634321549,-188638,true,6426364386,22,6333225689,-93138697
1634321799,-188645,true,6421867730,22,6343366454,-78501276
1634321863,-188645,true,6421867730,22,6348442924,-73424806
1634322423,-188644,true,6422509916,22,6360515827,-61994089
1634322732,-188647,true,6420583549,22,6364969524,-55614025
1634322779,-188655,true,6415449392,22,6364969524,-50479868
1634322896,-188655,true,6415449392,22,6369426340,-46023052
1634323075,-188654,true,6416090937,22,6369426340,-46664597
1634323162,-188656,true,6414807912,22,6369426340,-45381572
1634323201,-188663,true,6410319342,22,6370063282,-40256060
1634323228,-188662,true,6410960374,22,6370700289,-40260085
1634323294,-188660,true,6412242630,22,6372611690,-39630940
1634323348,-188663,true,6410319342,22,6370700289,-39619053
1634323573,-188669,true,6406474496,22,6364969524,-41504972
1634323624,-188669,true,6406474496,22,6364333091,-42141405
1634323722,-188667,true,6407755855,22,6360515827,-47240028
1634323805,-188672,true,6404552938,22,6352888167,-51664771
1634323832,-188682,true,6398151906,22,6350982682,-47169224
1634324083,-188677,true,6401351622,22,6381539148,-19812474
1634324282,-188672,true,6404552938,22,6410319342,5766404
1634324441,-188672,true,6404552938,22,6451474885,46921947
1634324539,-188682,true,6398151906,22,6468269704,70117798
1634324987,-188671,true,6405193393,22,6583113167,177919774
1634325051,-188666,true,6408396630,22,6592994752,184598122
1634325337,-188666,true,6408396630,22,6627365893,218969263
1634325465,-188674,true,6403272219,22,6645283063,242010844
1634325507,-188661,true,6411601470,22,6660584038,248982568
1634325863,-188647,true,6420583549,22,6780197858,359614309
1634326014,-188638,true,6426364386,22,6829871909,403507523
1634326216,-188644,true,6422509916,22,6869598275,447088359
1634326357,-188629,true,6432150428,22,6913702481,481552053
1634326358,-188617,true,6439873255,22,6914393852,474520597
1634326506,-188607,true,6446316027,22,6909555711,463239684
1634326600,-188608,true,6445671460,22,6925465183,479793723
1634326727,-188592,true,6455992272,22,6945577175,489584903
1634326854,-188579,true,6464390100,22,6967837506,503447406
1634326900,-188565,true,6473446131,22,6976901132,503455001
1634327088,-188569,true,6470857400,22,7004863225,534005825
1634327599,-188552,true,6481866662,22,7061830174,579963512
1634327606,-188540,true,6489649182,22,7061830174,572180992
1634327665,-188523,true,6500690416,22,7060418020,559727604
1634327705,-188524,true,6500040411,22,7059712048,559671637
1634327780,-188509,true,6509797300,22,7058300318,548503018
1634328035,-188504,true,6513052850,22,7042789900,529737050
1634328737,-188491,true,6521524901,22,6954611845,433086944
1634328777,-188492,true,6520872813,22,6954611845,433739032
1634328929,-188477,true,6530660972,22,6949050658,418389686
1634329097,-188471,true,6534580349,22,6950440538,415860189
1634329359,-188460,true,6541771982,22,6932393765,390621783
1634329834,-188465,true,6538502077,22,6868224561,329722484
1634330071,-188451,true,6547661933,22,6838756072,291094139
1634330180,-188446,true,6550936418,22,6831237951,280301533
1634330289,-188436,true,6557490303,22,6830554896,273064593
1634330530,-188440,true,6554867963,22,6842860351,287992388
1634330785,-188426,true,6564050745,22,6843544637,279493892
1634331337,-188421,true,6567333427,22,6814863456,247530029
1634331365,-188410,true,6574561107,22,6812819406,238258299
1634331966,-188417,true,6569960755,22,6726847972,156887217
1634332061,-188403,true,6579164681,22,6720796835,141632154
1634332158,-188400,true,6581138628,22,6722141062,141002434
1634332244,-188388,true,6589040339,22,6708040082,118999743
1634332312,-188392,true,6586405382,22,6703346331,116940949
1634332467,-188382,true,6592994752,22,6687278393,94283641
1634332518,-188381,true,6593654051,22,6682599170,88945119
1634332563,-188371,true,6600250673,22,6677923221,77672548
1634332917,-188376,true,6596951538,22,6624053204,27101666
1634332967,-188365,true,6604211814,22,6614125069,9913255
1634333140,-188362,true,6606193275,22,6604872235,-1321040
1634333148,-188350,true,6614125069,22,6604872235,-9252834
1634333630,-188349,true,6614786481,22,6641297288,26510807
1634333813,-188337,true,6622728592,22,6658586262,35857670
1634333881,-188335,true,6624053204,22,6662582413,38529209
1634333949,-188324,true,6631343307,22,6659252121,27908814
1634334042,-188324,true,6631343307,22,6653261790,21918483
1634334090,-188314,true,6637977635,22,6651266210,13288575
1634334110,-188313,true,6638641433,22,6650601150,11959717
1634334235,-188304,true,6644618601,22,6648606369,3987768
1634334519,-188303,true,6645283063,22,6648606369,3323306
1634334702,-188292,true,6652596530,22,6649271229,-3325301
1634334770,-188289,true,6654592509,22,6647941575,-6650934
1634334970,-188281,true,6659918046,22,6640633225,-19284821
1634335032,-188279,true,6661250097,22,6637977635,-23272462
1634335045,-188270,true,6667247620,22,6637977635,-29269985
1634335091,-188267,true,6669247995,22,6643954205,-25293790
1634335170,-188254,true,6677923221,22,6655923494,-21999727
1634335383,-188249,true,6681262850,22,6685272610,4009760
1634335644,-188240,true,6687278393,22,6722141062,34862669
1634335668,-188238,true,6688615915,22,6724830321,36214406
1634335742,-188226,true,6696646670,22,6733577848,36931178
1634335759,-188221,true,6699995663,22,6734924631,34928968
1634335919,-188217,true,6702676064,22,6747057805,44381741
1634335963,-188216,true,6703346331,22,6747057805,43711474
1634335988,-188204,true,6711394773,22,6744359657,32964884
1634336117,-188200,true,6714079733,22,6728193409,14113676
1634336342,-188191,true,6720124823,22,6734924631,14799808
1634336592,-188191,true,6720124823,22,6708710886,-11413937
1634336764,-188180,true,6727520657,22,6720796835,-6723822
1634336811,-188175,true,6730885090,22,6727520657,-3364433
1634336905,-188167,true,6736271683,22,6736945310,673627
1634337864,-188165,true,6737619005,22,6772066907,34447902
1634338159,-188153,true,6745708596,22,6772066907,26358311
1634338193,-188145,true,6751107052,22,6772066907,20959855
1634338256,-188137,true,6756509828,22,6770035693,13525865
1634338918,-188136,true,6757185479,22,6747732511,-9452968
1634339198,-188124,true,6765298563,22,6743010987,-22287576
1634340648,-188118,true,6769358757,22,6719452877,-49905880
1634340764,-188116,true,6770712697,22,6717437444,-53275253
1634340827,-188118,true,6769358757,22,6716765768,-52592989
1634341090,-188109,true,6775453618,22,6716765768,-58687850
1634341245,-188104,true,6778842022,22,6714079733,-64762289
1634341450,-188107,true,6776808776,22,6705357536,-71451240
1634341964,-188111,true,6774098730,22,6697986067,-76112663
1634342041,-188105,true,6778164206,22,6692630088,-85534118
1634342276,-188102,true,6780197858,22,6663248671,-116949187
1634342346,-188109,true,6775453618,22,6643954205,-131499413
1634342411,-188128,true,6762593120,22,6624053204,-138539916
1634342517,-188131,true,6760564748,22,6593654051,-166910697
1634342820,-188134,true,6758536984,22,6509146385,-249390599
1634343111,-188141,true,6753807900,22,6456637872,-297170028
1634343386,-188155,true,6744359657,22,6498090789,-246268868
1634343479,-188156,true,6743685288,22,6506543378,-237141910
1634343668,-188163,true,6738966596,22,6536540919,-202425677
1634343728,-188170,true,6734251206,22,6545698027,-188553179
1634343733,-188186,true,6723485557,22,6546352597,-177132960
1634344215,-188189,true,6721468915,22,6603551459,-117917456
1634344702,-188191,true,6720124823,22,6632006441,-88118382
1634344723,-188199,true,6714751141,22,6630680239,-84070902
1634344993,-188215,true,6704016666,22,6612802442,-91214224
1634345115,-188219,true,6701335729,22,6604872235,-96463494
1634345144,-188225,true,6697316335,22,6602891169,-94425166
1634345242,-188233,true,6691960892,22,6597611233,-94349659
1634345421,-188243,true,6685272610,22,6589699243,-95573367
1634345518,-188244,true,6684604150,22,6584429855,-100174295
1634345767,-188249,true,6681262850,22,6592335518,-88927332
1634345862,-188256,true,6676587836,22,6596951538,-79636298
1634346497,-188266,true,6669914919,22,6615447960,-54466959
1634346844,-188264,true,6671248969,22,6628028630,-43220339
1634346886,-188266,true,6669914919,22,6628691433,-41223486
1634347015,-188272,true,6665914371,22,6632006441,-33907930
1634347248,-188279,true,6661250097,22,6640633225,-20616872
1634347664,-188279,true,6661250097,22,6609497033,-51753064
1634348035,-188283,true,6658586262,22,6591017249,-67569013
1634348054,-188288,true,6655257968,22,6590358213,-64899755
1634348164,-188295,true,6650601150,22,6589040339,-61560811
1634348501,-188293,true,6651931337,22,6610157982,-41773355
1634348628,-188292,true,6652596530,22,6618094536,-34501994
1634348758,-188296,true,6649936157,22,6623390865,-26545292
1634348795,-188301,true,6646612186,22,6625378081,-21234105
1634349304,-188299,true,6647941575,22,6616771116,-31170459
1634349376,-188299,true,6647941575,22,6613463722,-34477853
1634349976,-188303,true,6645283063,22,6560113693,-85169370
1634350012,-188304,true,6644618601,22,6559457747,-85160854
1634350209,-188303,true,6645283063,22,6556834620,-88448443
1634350408,-188302,true,6645947591,22,6543080402,-102867189
1634350455,-188305,true,6643954205,22,6540463824,-103490381
1634350618,-188307,true,6642625614,22,6555523450,-87102164
1634350946,-188305,true,6643954205,22,6579822597,-64131608
1634351348,-188308,true,6641961418,22,6578506830,-63454588
1634351670,-188312,true,6639305297,22,6548971530,-90333767
1634351747,-188314,true,6637977635,22,6541117870,-96859765
1634351752,-188313,true,6638641433,22,6540463824,-98177609
1634351788,-188316,true,6636650239,22,6535233807,-101416432
1634351879,-188320,true,6633996242,22,6528702166,-105294076
1634352296,-188322,true,6632669642,22,6524133902,-108535740
1634352509,-188321,true,6633332909,22,6522177053,-111155856
1634352570,-188325,true,6630680239,22,6522177053,-108503186
1634352871,-188329,true,6628028630,22,6528049361,-99979269
1634352884,-188330,true,6627365893,22,6528049361,-99316532
1634352901,-188329,true,6628028630,22,6527396621,-100632009
1634353349,-188328,true,6628691433,22,6571274813,-57416620
1634353443,-188329,true,6628028630,22,6579164681,-48863949
1634353610,-188332,true,6626040619,22,6585746807,-40293812
1634353704,-188337,true,6622728592,22,6587064022,-35664570
1634353725,-188342,true,6619418221,22,6587722729,-31695492
1634353787,-188344,true,6618094536,22,6589040339,-29054197
1634353802,-188348,true,6615447960,22,6590358213,-25089747
1634353839,-188351,true,6613463722,22,6589699243,-23764479
1634353892,-188354,true,6611480080,22,6588381501,-23098579
1634355271,-188351,true,6613463722,22,6590358213,-23105509
1634355440,-188354,true,6611480080,22,6587722729,-23757351
1634355760,-188358,true,6608836149,22,6560113693,-48722456
1634355901,-188361,true,6606853895,22,6548316699,-58537196
1634356425,-188366,true,6603551459,22,6511750435,-91801024
1634357001,-188367,true,6602891169,22,6539155927,-63735242
1634357022,-188371,true,6600250673,22,6539809843,-60440830
1634357365,-188377,true,6596291908,22,6503941411,-92350497
1634357814,-188382,true,6592994752,22,6452765244,-140229508
1634358043,-188390,true,6587722729,22,6443093836,-144628893
1634358090,-188394,true,6585088298,22,6444382519,-140705779
1634358342,-188399,true,6581796741,22,6452765244,-129031497
1634358632,-188403,true,6579164681,22,6460512823,-118651858
1634358659,-188410,true,6574561107,22,6459866836,-114694271
1634359182,-188414,true,6571931940,22,6454701268,-117230672
1634359239,-188418,true,6569303824,22,6454055862,-115247962
1634359690,-188422,true,6566676760,22,6448894940,-117781820
1634359885,-188428,true,6562738132,22,6450829802,-111908330
1634359893,-188432,true,6560113693,22,6450829802,-109283891
1634359910,-188436,true,6557490303,22,6452120032,-105370271
1634359986,-188439,true,6555523450,22,6455992272,-99531178
1634360075,-188443,true,6552901896,22,6460512823,-92389073
1634360385,-188446,true,6550936418,22,6474740885,-76195533
1634360696,-188449,true,6548971530,22,6480570483,-68401047
1634360759,-188450,true,6548316699,22,6481866662,-66450037
1634361291,-188449,true,6548971530,22,6448250115,-100721415
1634362086,-188450,true,6548316699,22,6433436922,-114879777
1634362213,-188449,true,6548971530,22,6435367146,-113604384
1634362349,-188451,true,6547661933,22,6439229332,-108432601
1634362606,-188453,true,6546352597,22,6446960658,-99391939
1634363047,-188453,true,6546352597,22,6463743726,-82608871
1634363125,-188454,true,6545698027,22,6466329611,-79368416
1634363153,-188459,true,6542426159,22,6466976244,-75449915
1634363351,-188460,true,6541771982,22,6472798851,-68973131
1634363979,-188463,true,6539809843,22,6477331170,-62478673
1634364117,-188465,true,6538502077,22,6477978903,-60523174
1634364323,-188470,true,6535233807,22,6473446131,-61787676
1634364356,-188470,true,6535233807,22,6472798851,-62434956
1634364531,-188473,true,6533273629,22,6463097416,-70176213
1634364802,-188474,true,6532620367,22,6450184784,-82435583
1634364817,-188480,true,6528702166,22,6449539830,-79162336
1634364855,-188480,true,6528702166,22,6448894940,-79807226
1634364926,-188484,true,6526091338,22,6446960658,-79130680
1634364957,-188483,true,6526743947,22,6448250115,-78493832
1634365015,-188488,true,6523481554,22,6450184784,-73296770
1634365189,-188488,true,6523481554,22,6460512823,-62968731
1634365222,-188491,true,6521524901,22,6462451171,-59073730
1634365508,-188490,true,6522177053,22,6493543945,-28633108
1634366199,-188498,true,6516961659,22,6480570483,-36391176
1634366250,-188499,true,6516310028,22,6477331170,-38978858
1634366471,-188500,true,6515658462,22,6467622941,-48035521
1634366697,-188499,true,6516310028,22,6468269704,-48040324
1634366775,-188507,true,6511099325,22,6468269704,-42829621
1634367166,-188507,true,6511099325,22,6472798851,-38300474
1634367265,-188509,true,6509797300,22,6474093476,-35703824
1634367275,-188510,true,6509146385,22,6474093476,-35052909
1634367337,-188517,true,6504591805,22,6473446131,-31145674
1634368019,-188518,true,6503941411,22,6468916531,-35024880
1634368333,-188520,true,6502640818,22,6469563422,-33077396
1634368451,-188520,true,6502640818,22,6471504486,-31136332
1634368595,-188524,true,6500040411,22,6473446131,-26594280
1634369061,-188524,true,6500040411,22,6485108244,-14932167
1634369750,-188524,true,6500040411,22,6490298146,-9742265
1634370028,-188524,true,6500040411,22,6483811417,-16228994
1634370139,-188528,true,6497441045,22,6481218540,-16222505
1634370673,-188526,true,6498740598,22,6569303824,70563226
1634370714,-188525,true,6499390472,22,6576533673,77143201
1634370834,-188521,true,6501990619,22,6596951538,94960919
1634371008,-188524,true,6500040411,22,6626040619,126000208
1634371081,-188522,true,6501340485,22,6630680239,129339754
1634371131,-188519,true,6503291082,22,6630680239,127389157
1634371500,-188509,true,6509797300,22,6684604150,174806850
1634371552,-188509,true,6509797300,22,6691960892,182163592
1634371563,-188505,true,6512401610,22,6693299351,180897741
1634371618,-188502,true,6514355525,22,6700665663,186310138
1634372143,-188493,true,6520220791,22,6760564748,240343957
1634372231,-188492,true,6520872813,22,6768681889,247809076
1634372249,-188489,true,6522829271,22,6767328356,244499085
1634372816,-188487,true,6524133902,22,6737619005,213485103
1634373006,-188482,true,6527396621,22,6735598123,208201502
1634373094,-188485,true,6525438794,22,6716765768,191326974
1634373339,-188482,true,6527396621,22,6702005863,174609242
1634373617,-188483,true,6526743947,22,6665247846,138503899
1634373740,-188479,true,6529355036,22,6645283063,115928027
1634374007,-188481,true,6528049361,22,6614125069,86075708
1634374514,-188481,true,6528049361,22,6563394406,35345045
1634374582,-188483,true,6526743947,22,6561425781,34681834
1634374778,-188480,true,6528702166,22,6548971530,20269364
1634375186,-188485,true,6525438794,22,6533273629,7834835
1634375486,-188485,true,6525438794,22,6526743947,1305153
1634375684,-188486,true,6524786315,22,6527396621,2610306
1634376466,-188483,true,6526743947,22,6536540919,9796972
1634376573,-188484,true,6526091338,22,6536540919,10449581
1634376608,-188484,true,6526091338,22,6537194573,11103235
1634376802,-188486,true,6524786315,22,6538502077,13715762
1634376905,-188480,true,6528702166,22,6545043522,16341356
1634377080,-188480,true,6528702166,22,6546352597,17650431
1634377238,-188477,true,6530660972,22,6547661933,17000961
1634377679,-188478,true,6530007972,22,6557490303,27482331
1634377697,-188473,true,6533273629,22,6558146052,24872423
1634377847,-188473,true,6533273629,22,6553557186,20283557
1634378055,-188470,true,6535233807,22,6554867963,19634156
1634378278,-188471,true,6534580349,22,6554212542,19632193
1634378421,-188466,true,6537848292,22,6552246671,14398379
1634378781,-188466,true,6537848292,22,6550281390,12433098
1634379716,-188463,true,6539809843,22,6558801867,18992024
1634379759,-188464,true,6539155927,22,6568646960,29491033
1634379864,-188458,true,6543080402,22,6577191326,34110924
1634380091,-188458,true,6543080402,22,6591676350,48595948
1634380146,-188453,true,6546352597,22,6595632345,49279748
1634380159,-188455,true,6545043522,22,6596291908,51248386
1634380370,-188449,true,6548971530,22,6606193275,57221745
1634380488,-188449,true,6548971530,22,6612141228,63169698
1634380544,-188443,true,6552901896,22,6615447960,62546064
1634380644,-188443,true,6552901896,22,6617432793,64530897
1634380708,-188436,true,6557490303,22,6615447960,57957657
1634380886,-188435,true,6558146052,22,6622728592,64582540
1634381256,-188429,true,6562081924,22,6633332909,71250985
1634381970,-188431,true,6560769704,22,6626040619,65270915
1634382196,-188425,true,6564707150,22,6627365893,62658743
1634382426,-188423,true,6566020158,22,6633332909,67312751
1634382451,-188418,true,6569303824,22,6633332909,64029085
1634382574,-188420,true,6567990161,22,6628691433,60701272
1634382749,-188413,true,6572589133,22,6645947591,73358458
1634382818,-188410,true,6574561107,22,6653261790,78700683
1634383217,-188407,true,6576533673,22,6640633225,64099552
1634383320,-188407,true,6576533673,22,6637313904,60780231
1634383371,-188400,true,6581138628,22,6637313904,56175276
1634383428,-188397,true,6583113167,22,6639305297,56192130
1634383688,-188394,true,6585088298,22,6618756346,33668048
1634383716,-188395,true,6584429855,22,6616109505,31679650
1634383789,-188388,true,6589040339,22,6624053204,35012865
1634384028,-188385,true,6591017249,22,6650601150,59583901
1634384163,-188380,true,6594313417,22,6664581388,70267971
1634384234,-188383,true,6592335518,22,6662582413,70246895
1634384419,-188377,true,6596291908,22,6675252719,78960811
1634384532,-188372,true,6599590714,22,6681930977,82340263
1634384765,-188368,true,6602230946,22,6674585261,72354315
1634384811,-188370,true,6600910698,22,6671248969,70338271
1634384815,-188364,true,6604872235,22,6671248969,66376734
1634384953,-188359,true,6608175332,22,6664581388,56406056
1634385008,-188355,true,6610818998,22,6661250097,50431099
1634385241,-188357,true,6609497033,22,6659918046,50421013
1634385349,-188351,true,6613463722,22,6654592509,41128787
1634385481,-188347,true,6616109505,22,6649936157,33826652
1634385569,-188343,true,6618756346,22,6647941575,29185229
1634385737,-188346,true,6616771116,22,6645283063,28511947
1634385989,-188340,true,6620742171,22,6633996242,13254071
1634386172,-188336,true,6623390865,22,6631343307,7952442
1634386711,-188334,true,6624715610,22,6603551459,-21164151
1634386756,-188337,true,6622728592,22,6602891169,-19837423
1634386966,-188333,true,6625378081,22,6594972848,-30405233
1634387017,-188329,true,6628028630,22,6592994752,-35033878
1634387046,-188330,true,6627365893,22,6589040339,-38325554
1634387130,-188337,true,6622728592,22,6581138628,-41589964
1634387710,-188339,true,6621404245,22,6535887330,-85516915
1634387952,-188336,true,6623390865,22,6526743947,-96646918
1634388090,-188337,true,6622728592,22,6530007972,-92720620
1634388254,-188344,true,6618094536,22,6535233807,-82860729
1634388465,-188350,true,6614125069,22,6541771982,-72353087
1634388584,-188349,true,6614786481,22,6545698027,-69088454
1634388802,-188351,true,6613463722,22,6547007232,-66456490
1634389271,-188359,true,6608175332,22,6545043522,-63131810
1634389629,-188363,true,6605532722,22,6552901896,-52630826
1634390602,-188364,true,6604872235,22,6567333427,-37538808
1634390932,-188365,true,6604211814,22,6570617751,-33594063
1634391138,-188371,true,6600250673,22,6559457747,-40792926
1634391229,-188375,true,6597611233,22,6555523450,-42087783
1634391324,-188374,true,6598270994,22,6562081924,-36189070
1634391374,-188375,true,6597611233,22,6565363621,-32247612
1634391703,-188377,true,6596291908,22,6559457747,-36834161
1634391797,-188379,true,6594972848,22,6558146052,-36826796
1634391927,-188378,true,6595632345,22,6558146052,-37486293
1634391930,-188376,true,6596951538,22,6558146052,-38805486
1634391959,-188378,true,6595632345,22,6559457747,-36174598
1634392169,-188379,true,6594972848,22,6565363621,-29609227
1634392305,-188376,true,6596951538,22,6556179002,-40772536
1634392335,-188374,true,6598270994,22,6556179002,-42091992
1634392394,-188375,true,6597611233,22,6558146052,-39465181
1634392447,-188376,true,6596951538,22,6560113693,-36837845
1634392456,-188373,true,6598930821,22,6560113693,-38817128
1634392515,-188370,true,6600910698,22,6562738132,-38172566
1634392580,-188372,true,6599590714,22,6565363621,-34227093
1634392960,-188373,true,6598930821,22,6581138628,-17792193
1634393232,-188370,true,6600910698,22,6591676350,-9234348
1634393292,-188368,true,6602230946,22,6584429855,-17801091
1634393302,-188370,true,6600910698,22,6583113167,-17797531
1634393480,-188373,true,6598930821,22,6571931940,-26998881
1634393532,-188373,true,6598930821,22,6564707150,-34223671
1634393574,-188371,true,6600250673,22,6559457747,-40792926
1634393730,-188373,true,6598930821,22,6541771982,-57158839
1634393810,-188377,true,6596291908,22,6533926956,-62364952
1634394030,-188377,true,6596291908,22,6512401610,-83890298
1634394056,-188375,true,6597611233,22,6510448280,-87162953
1634394165,-188377,true,6596291908,22,6508495536,-87796372
1634394189,-188381,true,6593654051,22,6510448280,-83205771
1634394391,-188380,true,6594313417,22,6514355525,-79957892
1634394450,-188381,true,6593654051,22,6520220791,-73433260
1634394608,-188381,true,6593654051,22,6533273629,-60380422
1634394691,-188385,true,6591017249,22,6534580349,-56436900
1634395153,-188385,true,6591017249,22,6529355036,-61662213
1634395259,-188387,true,6589699243,22,6524786315,-64912928
1634395286,-188388,true,6589040339,22,6523481554,-65558785
1634395398,-188393,true,6585746807,22,6518265116,-67481691
1634395425,-188394,true,6585088298,22,6518265116,-66823182
1634395602,-188395,true,6584429855,22,6513052850,-71377005
1634395710,-188396,true,6583771478,22,6513052850,-70718628
1634395982,-188400,true,6581138628,22,6518265116,-62873512
1634396077,-188401,true,6580480580,22,6524786315,-55694265
1634396164,-188403,true,6579164681,22,6522829271,-56335410
1634396632,-188402,true,6579822597,22,6550281390,-29541207
1634396675,-188407,true,6576533673,22,6552246671,-24287002
1634396950,-188408,true,6575876085,22,6564050745,-11825340
1634396975,-188407,true,6576533673,22,6563394406,-13139267
1634397100,-188406,true,6577191326,22,6573246392,-3944934
1634397242,-188410,true,6574561107,22,6577191326,2630219
1634397245,-188410,true,6574561107,22,6577191326,2630219
1634397582,-188409,true,6575218563,22,6585088298,9869735
1634397604,-188408,true,6575876085,22,6585746807,9870722
1634397805,-188412,true,6573246392,22,6602230946,28984554
1634399303,-188412,true,6573246392,22,6650601150,77354758
1634399338,-188413,true,6572589133,22,6648606369,76017236
1634399456,-188412,true,6573246392,22,6643289876,70043484
1634399818,-188415,true,6571274813,22,6630680239,59405426
1634400009,-188415,true,6571274813,22,6631343307,60068494
1634400671,-188415,true,6571274813,22,6645283063,74008250
1634400747,-188413,true,6572589133,22,6649936157,77347024
1634401011,-188414,true,6571931940,22,6667247620,95315680
1634401050,-188415,true,6571274813,22,6669247995,97973182
1634401149,-188412,true,6573246392,22,6675920244,102673852
1634401294,-188410,true,6574561107,22,6686609732,112048625
1634401324,-188411,true,6573903717,22,6688615915,114712198
1634401396,-188410,true,6574561107,22,6692630088,118068981
1634401432,-188407,true,6576533673,22,6695977073,119443400
1634401647,-188405,true,6577849045,22,6707369345,129520300
1634401650,-188405,true,6577849045,22,6707369345,129520300
1634402210,-188405,true,6577849045,22,6714751141,136902096
1634402328,-188400,true,6581138628,22,6714751141,133612513
1634402359,-188397,true,6583113167,22,6715422616,132309449
1634402511,-188398,true,6582454921,22,6710723700,128268779
1634402543,-188398,true,6582454921,22,6708040082,125585161
1634402817,-188394,true,6585088298,22,6695307542,110219244
1634402924,-188391,true,6587064022,22,6683935756,96871734
1634403381,-188389,true,6588381501,22,6649936157,61554656
1634403403,-188389,true,6588381501,22,6649936157,61554656
1634403689,-188386,true,6590358213,22,6641297288,50939075
1634403941,-188383,true,6592335518,22,6643289876,50954358
1634404115,-188382,true,6592994752,22,6645947591,52952839
1634404538,-188383,true,6592335518,22,6636650239,44314721
1634404944,-188381,true,6593654051,22,6610157982,16503931
1634405136,-188378,true,6595632345,22,6608175332,12542987
1634405268,-188378,true,6595632345,22,6609497033,13864688
1634405311,-188379,true,6594972848,22,6609497033,14524185
1634405371,-188377,true,6596291908,22,6610157982,13866074
1634405582,-188371,true,6600250673,22,6635323108,35072435
1634405612,-188369,true,6601570789,22,6639305297,37734508
1634406018,-188371,true,6600250673,22,6671248969,70998296
1634406082,-188368,true,6602230946,22,6675252719,73021773
1634406102,-188364,true,6604872235,22,6677255495,72383260
1634406159,-188362,true,6606193275,22,6682599170,76405895
1634406165,-188361,true,6606853895,22,6683267430,76413535
1634406371,-188357,true,6609497033,22,6693968681,84471648
1634406440,-188353,true,6612141228,22,6693299351,81158123
1634406532,-188352,true,6612802442,22,6692630088,79827646
1634406562,-188351,true,6613463722,22,6693299351,79835629
1634406870,-188347,true,6616109505,22,6705357536,89248031
1634406967,-188343,true,6618756346,22,6706028072,87271726
1634407069,-188343,true,6618756346,22,6697316335,78559989
1634407169,-188344,true,6618094536,22,6696646670,78552134
1634407501,-188340,true,6620742171,22,6699325731,78583560
1634407547,-188336,true,6623390865,22,6697986067,74595202
1634407681,-188336,true,6623390865,22,6694638078,71247213
1634407925,-188337,true,6622728592,22,6693299351,70570759
1634408884,-188331,true,6626703223,22,6714751141,88047918
1634409019,-188328,true,6628691433,22,6710052695,81361262
1634409140,-188325,true,6630680239,22,6709381757,78701518
1634409354,-188323,true,6632006441,22,6708040082,76033641
1634409528,-188319,true,6634659642,22,6699995663,65336021
1634409629,-188315,true,6637313904,22,6696646670,59332766
1634409697,-188312,true,6639305297,22,6691960892,52655595
1634409797,-188311,true,6639969228,22,6684604150,44634922
1634409885,-188308,true,6641961418,22,6682599170,40637752
1634409901,-188304,true,6644618601,22,6685941138,41322537
1634410019,-188298,true,6648606369,22,6696646670,48040301
1634410102,-188297,true,6649271229,22,6703346331,54075102
1634410145,-188291,true,6653261790,22,6706028072,52766282
1634410249,-188288,true,6655257968,22,6714751141,59493173
1634410322,-188285,true,6657254745,22,6712737119,55482374
1634410875,-188287,true,6655923494,22,6693299351,37375857
1634410886,-188281,true,6659918046,22,6691960892,32042846
1634410901,-188278,true,6661916222,22,6689953705,28037483
1634410954,-188275,true,6663914996,22,6683267430,19352434
1634411147,-188276,true,6663248671,22,6661250097,-1998574
1634411178,-188270,true,6667247620,22,6663248671,-3998949
1634411276,-188268,true,6668581136,22,6663914996,-4666140
1634411308,-188264,true,6671248969,22,6663914996,-7333973
1634411453,-188265,true,6670581911,22,6672583286,2001375
1634411648,-188259,true,6674585261,22,6679926798,5341537
1634412126,-188258,true,6675252719,22,6687278393,12025674
1634412145,-188255,true,6677255495,22,6687278393,10022898
1634412267,-188257,true,6675920244,22,6682599170,6678926
1634412367,-188251,true,6679926798,22,6677255495,-2671303
1634412573,-188248,true,6681930977,22,6702676064,20745087
1634412579,-188246,true,6683267430,22,6702676064,19408634
1634412663,-188247,true,6682599170,22,6697986067,15386897
1634413211,-188245,true,6683935756,22,6676587836,-7347920
1634413306,-188245,true,6683935756,22,6669914919,-14020837
1634413816,-188243,true,6685272610,22,6654592509,-30680101
1634413963,-188246,true,6683267430,22,6663248671,-20018759
1634414075,-188244,true,6684604150,22,6669247995,-15356155
1634414111,-188243,true,6685272610,22,6670581911,-14690699
1634414526,-188241,true,6686609732,22,6665914371,-20695361
1634414554,-188244,true,6684604150,22,6665914371,-18689779
1634414995,-188242,true,6685941138,22,6669914919,-16026219
1634415111,-188241,true,6686609732,22,6673917869,-12691863
1634415198,-188240,true,6687278393,22,6675920244,-11358149
1634415225,-188242,true,6685941138,22,6675920244,-10020894
1634415516,-188245,true,6683935756,22,6668581136,-15354620
1634415560,-188245,true,6683935756,22,6667914345,-16021411
1634415770,-188245,true,6683935756,22,6652596530,-31339226
1634415792,-188247,true,6682599170,22,6650601150,-31998020
1634415929,-188250,true,6680594791,22,6645283063,-35311728
1634415985,-188251,true,6679926798,22,6635323108,-44603690
1634416098,-188250,true,6680594791,22,6635323108,-45271683
1634416334,-188252,true,6679258872,22,6642625614,-36633258
1634416483,-188254,true,6677923221,22,6645947591,-31975630
1634416681,-188255,true,6677255495,22,6648606369,-28649126
1634417187,-188254,true,6677923221,22,6641297288,-36625933
1634417302,-188255,true,6677255495,22,6637977635,-39277860
1634417451,-188257,true,6675920244,22,6634659642,-41260602
1634417530,-188257,true,6675920244,22,6634659642,-41260602
1634417558,-188255,true,6677255495,22,6633996242,-43259253
1634417563,-188257,true,6675920244,22,6634659642,-41260602
1634418061,-188253,true,6678591013,22,6681262850,2671837
1634418252,-188254,true,6677923221,22,6677255495,-667726
1634418300,-188253,true,6678591013,22,6676587836,-2003177
1634418412,-188254,true,6677923221,22,6677255495,-667726
1634418453,-188253,true,6678591013,22,6675920244,-2670769
1634418475,-188254,true,6677923221,22,6673250544,-4672677
1634418647,-188253,true,6678591013,22,6649936157,-28654856
1634418801,-188254,true,6677923221,22,6629354302,-48568919
1634418858,-188254,true,6677923221,22,6622728592,-55194629
1634418905,-188258,true,6675252719,22,6617432793,-57819926
1634419098,-188259,true,6674585261,22,6603551459,-71033802
1634419278,-188261,true,6673250544,22,6595632345,-77618199
1634419358,-188261,true,6673250544,22,6592994752,-80255792
1634419471,-188264,true,6671248969,22,6598930821,-72318148
1634419614,-188263,true,6671916094,22,6608175332,-63740762
1634420141,-188264,true,6671248969,22,6643289876,-27959093
1634420198,-188266,true,6669914919,22,6645283063,-24631856
1634420541,-188270,true,6667247620,22,6608836149,-58411471
1634420956,-188271,true,6666580962,22,6559457747,-107123215
1634421000,-188275,true,6663914996,22,6555523450,-108391546
1634421119,-188277,true,6662582413,22,6549626428,-112955985
1634421179,-188280,true,6660584038,22,6554867963,-105716075
1634421276,-188278,true,6661916222,22,6562738132,-99178090
1634421306,-188281,true,6659918046,22,6564707150,-95210896
1634421477,-188283,true,6658586262,22,6569960755,-88625507
1634421675,-188289,true,6654592509,22,6569303824,-85288685
1634421800,-188288,true,6655257968,22,6569303824,-85954144
1634422015,-188292,true,6652596530,22,6554867963,-97728567
1634422075,-188296,true,6649936157,22,6548316699,-101619458
1634422554,-188301,true,6646612186,22,6526743947,-119868239
1634422606,-188300,true,6647276847,22,6525438794,-121838053
1634422677,-188304,true,6644618601,22,6531314038,-113304563
1634422706,-188306,true,6643289876,22,6529355036,-113934840
1634422759,-188310,true,6640633225,22,6533273629,-107359596
1634422950,-188308,true,6641961418,22,6547007232,-94954186
1634423111,-188311,true,6639969228,22,6554212542,-85756686
1634423175,-188313,true,6638641433,22,6556834620,-81806813
1634423409,-188317,true,6635986640,22,6564707150,-71279490
1634423473,-188318,true,6635323108,22,6567333427,-67989681
1634423711,-188323,true,6632006441,22,6572589133,-59417308
1634423790,-188327,true,6629354302,22,6574561107,-54793195
1634423897,-188330,true,6627365893,22,6577849045,-49516848
1634424133,-188329,true,6628028630,22,6586405382,-41623248
1634424360,-188329,true,6628028630,22,6587722729,-40305901
1634424446,-188333,true,6625378081,22,6587064022,-38314059
1634424728,-188335,true,6624053204,22,6590358213,-33694991
1634424923,-188334,true,6624715610,22,6589040339,-35675271
1634425416,-188335,true,6624053204,22,6597611233,-26441971
1634425689,-188338,true,6622066386,22,6598270994,-23795392
1634425900,-188340,true,6620742171,22,6589699243,-31042928
1634425928,-188339,true,6621404245,22,6588381501,-33022744
1634426066,-188342,true,6619418221,22,6584429855,-34988366
1634426351,-188345,true,6617432793,22,6596291908,-21140885
1634427091,-188345,true,6617432793,22,6624053204,6620411
1634427247,-188344,true,6618094536,22,6620742171,2647635
1634427249,-188346,true,6616771116,22,6620080163,3309047
1634427424,-188349,true,6614786481,22,6603551459,-11235022
1634427570,-188353,true,6612141228,22,6613463722,1322494
1634427583,-188352,true,6612802442,22,6614125069,1322627
1634427634,-188354,true,6611480080,22,6615447960,3967880
1634427705,-188351,true,6613463722,22,6612802442,-661280
1634427983,-188355,true,6610818998,22,6606193275,-4625723
1634428135,-188355,true,6610818998,22,6604872235,-5946763
1634428216,-188358,true,6608836149,22,6610818998,1982849
1634428615,-188355,true,6610818998,22,6614786481,3967483
1634428652,-188359,true,6608175332,22,6616109505,7934173
1634428750,-188358,true,6608836149,22,6616771116,7934967
1634428757,-188360,true,6607514580,22,6616771116,9256536
1634428802,-188358,true,6608836149,22,6621404245,12568096
1634428943,-188359,true,6608175332,22,6635986640,27811308
1634429266,-188357,true,6609497033,22,6666580962,57083929
1634429327,-188359,true,6608175332,22,6670581911,62406579
1634429680,-188355,true,6610818998,22,6687947121,77128123
1634429728,-188357,true,6609497033,22,6687278393,77781360
1634429873,-188354,true,6611480080,22,6686609732,75129652
1634430090,-188356,true,6610157982,22,6677923221,67765239
1634430240,-188353,true,6612141228,22,6673917869,61776641
1634430299,-188353,true,6612141228,22,6673917869,61776641
1634430309,-188352,true,6612802442,22,6673917869,61115427
1634430595,-188355,true,6610818998,22,6669914919,59095921
1634430829,-188352,true,6612802442,22,6665914371,53111929
1634430899,-188353,true,6612141228,22,6665914371,53773143
1634430919,-188351,true,6613463722,22,6665914371,52450649
1634431283,-188353,true,6612141228,22,6667914345,55773117
1634431294,-188349,true,6614786481,22,6667914345,53127864
1634431352,-188350,true,6614125069,22,6668581136,54456067
1634431451,-188348,true,6615447960,22,6673917869,58469909
1634431470,-188349,true,6614786481,22,6673917869,59131388
1634431503,-188351,true,6613463722,22,6672583286,59119564
1634431550,-188351,true,6613463722,22,6671916094,58452372
1634431586,-188351,true,6613463722,22,6670581911,57118189
1634431652,-188352,true,6612802442,22,6667247620,54445178
1634431726,-188350,true,6614125069,22,6664581388,50456319
1634431885,-188350,true,6614125069,22,6656589086,42464017
1634432744,-188350,true,6614125069,22,6619418221,5293152
1634433028,-188351,true,6613463722,22,6620080163,6616441
1634433207,-188349,true,6614786481,22,6608836149,-5950332
1634433301,-188350,true,6614125069,22,6610157982,-3967087
1634433545,-188348,true,6615447960,22,6622728592,7280632
1634433623,-188348,true,6615447960,22,6626040619,10592659
1634433703,-188344,true,6618094536,22,6628691433,10596897
1634433763,-188345,true,6617432793,22,6631343307,13910514
1634433779,-188346,true,6616771116,22,6630680239,13909123
1634433875,-188349,true,6614786481,22,6630680239,15893758
1634434052,-188346,true,6616771116,22,6635986640,19215524
1634434182,-188345,true,6617432793,22,6643954205,26521412
1634434519,-188342,true,6619418221,22,6645283063,25864842
1634435681,-188341,true,6620080163,22,6679926798,59846635
1634435755,-188338,true,6622066386,22,6679926798,57860412
1634436767,-188336,true,6623390865,22,6695977073,72586208
1634436812,-188336,true,6623390865,22,6696646670,73255805
1634436972,-188334,true,6624715610,22,6697986067,73270457
1634437301,-188331,true,6626703223,22,6700665663,73962440
1634437414,-188327,true,6629354302,22,6702005863,72651561
1634437586,-188325,true,6630680239,22,6704016666,73336427
1634437728,-188322,true,6632669642,22,6715422616,82752974
1634437954,-188316,true,6636650239,22,6730885090,94234851
1634438158,-188312,true,6639305297,22,6742336753,103031456
1634438491,-188311,true,6639969228,22,6726175355,86206127
1634438520,-188310,true,6640633225,22,6719452877,78819652
1634438581,-188306,true,6643289876,22,6713408392,70118516
1634439222,-188304,true,6644618601,22,6668581136,23962535
1634439743,-188305,true,6643954205,22,6671916094,27961889
1634440013,-188303,true,6645283063,22,6666580962,21297899
1634440202,-188299,true,6647941575,22,6661916222,13974647
1634440458,-188298,true,6648606369,22,6657920470,9314101
1634440488,-188299,true,6647941575,22,6657920470,9978895
1634440641,-188297,true,6649271229,22,6657254745,7983516
1634440673,-188293,true,6651931337,22,6657254745,5323408
1634440702,-188292,true,6652596530,22,6657920470,5323940
1634440728,-188295,true,6650601150,22,6654592509,3991359
1634440740,-188294,true,6651266210,22,6653927116,2660906
1634440785,-188290,true,6653927116,22,6654592509,665393
1634441031,-188288,true,6655257968,22,6657254745,1996777
1634441143,-188289,true,6654592509,22,6659252121,4659612
1634441178,-188290,true,6653927116,22,6659918046,5990930
1634441301,-188287,true,6655923494,22,6644618601,-11304893
1634441405,-188288,true,6655257968,22,6631343307,-23914661
1634441441,-188291,true,6653261790,22,6627365893,-25895897
1634441629,-188290,true,6653927116,22,6620080163,-33846953
1634441789,-188287,true,6655923494,22,6611480080,-44443414
1634442091,-188288,true,6655257968,22,6596291908,-58966060
1634442102,-188292,true,6652596530,22,6596951538,-55644992
1634442200,-188291,true,6653261790,22,6602891169,-50370621
1634443158,-188285,true,6657254745,22,6657920470,665725
1634443615,-188285,true,6657254745,22,6655257968,-1996777
1634444201,-188288,true,6655257968,22,6650601150,-4656818
1634444244,-188288,true,6655257968,22,6649936157,-5321811
1634444249,-188285,true,6657254745,22,6648606369,-8648376
1634444351,-188282,true,6659252121,22,6650601150,-8650971
1634444481,-188285,true,6657254745,22,6651266210,-5988535
1634444602,-188286,true,6656589086,22,6641297288,-15291798
1634444724,-188284,true,6657920470,22,6633996242,-23924228
1634444863,-188284,true,6657920470,22,6621404245,-36516225
1634444871,-188288,true,6655257968,22,6620742171,-34515797
1634444937,-188289,true,6654592509,22,6612141228,-42451281
1634445194,-188290,true,6653927116,22,6581796741,-72130375
1634445447,-188288,true,6655257968,22,6592994752,-62263216
1634445466,-188295,true,6650601150,22,6594313417,-56287733
1634445489,-188295,true,6650601150,22,6595632345,-54968805
1634445771,-188291,true,6653261790,22,6622728592,-30533198
1634446455,-188288,true,6655257968,22,6686609732,31351764
1634446602,-188294,true,6651266210,22,6695307542,44041332
1634446764,-188295,true,6650601150,22,6692630088,42028938
1634446941,-188290,true,6653927116,22,6689284777,35357661
1634447088,-188287,true,6655923494,22,6687947121,32023627
1634447186,-188293,true,6651931337,22,6685941138,34009801
1634447200,-188294,true,6651266210,22,6685272610,34006400
1634447316,-188289,true,6654592509,22,6683267430,28674921
1634447847,-188281,true,6659918046,22,6751107052,91189006
1634448036,-188285,true,6657254745,22,6775453618,118198873
1634448037,-188286,true,6656589086,22,6776131163,119542077
1634448316,-188283,true,6658586262,22,6764622101,106035839
1634448569,-188278,true,6661916222,22,6732231335,70315113
1634448687,-188285,true,6657254745,22,6718780999,61526254
1634449159,-188285,true,6657254745,22,6703346331,46091586
1634449345,-188282,true,6659252121,22,6693968681,34716560
1634449408,-188277,true,6662582413,22,6694638078,32055665
1634449449,-188282,true,6659252121,22,6693299351,34047230
1634449519,-188284,true,6657920470,22,6690622701,32702231
1634449774,-188275,true,6663914996,22,6712737119,48822123
1634449952,-188267,true,6669247995,22,6727520657,58272662
1634450001,-188271,true,6666580962,22,6730885090,64304128
1634450020,-188272,true,6665914371,22,6731558179,65643808
1634450133,-188263,true,6671916094,22,6745034093,73117999
1634450396,-188256,true,6676587836,22,6778842022,102254186
1634450413,-188261,true,6673250544,22,6781553966,108303422
1634450488,-188263,true,6671916094,22,6777486457,105570363
1634450557,-188256,true,6676587836,22,6773421388,96833552
1634450565,-188251,true,6679926798,22,6773421388,93494590
1634450631,-188256,true,6676587836,22,6767328356,90740520
1634450817,-188257,true,6675920244,22,6751782163,75861919
1634451419,-188250,true,6680594791,22,6715422616,34827825
1634451607,-188245,true,6683935756,22,6712065912,28130156
1634451919,-188251,true,6679926798,22,6711394773,31467975
1634452044,-188254,true,6677923221,22,6716094159,38170938
1634452092,-188246,true,6683267430,22,6718780999,35513569
1634452221,-188242,true,6685941138,22,6725502804,39561666
1634452394,-188246,true,6683267430,22,6737619005,54351575
1634452432,-188249,true,6681262850,22,6740988488,59725638
1634452490,-188243,true,6685272610,22,6739640493,54367883
1634452552,-188238,true,6688615915,22,6742336753,53720838
1634452612,-188244,true,6684604150,22,6743685288,59081138
1634452648,-188249,true,6681262850,22,6745034093,63771243
1634453058,-188242,true,6685941138,22,6749757033,63815895
1634453189,-188240,true,6687278393,22,6726847972,39569579
1634453488,-188246,true,6683267430,22,6699995663,16728233
1634453753,-188250,true,6680594791,22,6682599170,2004379
1634454221,-188243,true,6685272610,22,6683267430,-2005180
1634454767,-188237,true,6689284777,22,6745708596,56423819
1634454975,-188242,true,6685941138,22,6759888759,73947621
1634455333,-188245,true,6683935756,22,6756509828,72574072
1634455759,-188238,true,6688615915,22,6729539115,40923200
1634455835,-188232,true,6692630088,22,6726175355,33545267
1634455972,-188237,true,6689284777,22,6720796835,31512058
1634456100,-188241,true,6686609732,22,6716765768,30156036
1634456397,-188235,true,6690622701,22,6711394773,20772072
1634456701,-188230,true,6693968681,22,6708710886,14742205
1634457015,-188234,true,6691291763,22,6700665663,9373900
1634457215,-188236,true,6689953705,22,6697316335,7362630
1634457469,-188231,true,6693299351,22,6676587836,-16711515
1634458142,-188230,true,6693968681,22,6621404245,-72564436
1634458320,-188236,true,6689953705,22,6616771116,-73182589
1634458358,-188239,true,6687947121,22,6615447960,-72499161
1634458575,-188233,true,6691960892,22,6611480080,-80480812
1634458961,-188230,true,6693968681,22,6604872235,-89096446
1634459343,-188233,true,6691960892,22,6611480080,-80480812
1634459687,-188237,true,6689284777,22,6621404245,-67880532
1634459737,-188231,true,6693299351,22,6623390865,-69908486
1634459857,-188228,true,6695307542,22,6627365893,-67941649
1634459919,-188232,true,6692630088,22,6628028630,-64601458
1634460264,-188235,true,6690622701,22,6634659642,-55963059
1634460556,-188232,true,6692630088,22,6638641433,-53988655
1634461264,-188230,true,6693968681,22,6626703223,-67265458
1634461289,-188233,true,6691960892,22,6625378081,-66582811
1634461370,-188237,true,6689284777,22,6620742171,-68542606
1634461629,-188234,true,6691291763,22,6603551459,-87740304
1634462199,-188234,true,6691291763,22,6586405382,-104886381
1634463227,-188239,true,6687947121,22,6565363621,-122583500
1634463563,-188241,true,6686609732,22,6566020158,-120589574
1634463875,-188238,true,6688615915,22,6564707150,-123908765
1634464441,-188237,true,6689284777,22,6562081924,-127202853
1634464703,-188240,true,6687278393,22,6560769704,-126508689
1634466473,-188242,true,6685941138,22,6558146052,-127795086
1634466985,-188237,true,6689284777,22,6571274813,-118009964
1634467438,-188239,true,6687947121,22,6581796741,-106150380
1634467567,-188242,true,6685941138,22,6581138628,-104802510
1634467640,-188244,true,6684604150,22,6580480580,-104123570
1634467691,-188243,true,6685272610,22,6579164681,-106107929
1634468886,-188247,true,6682599170,22,6570617751,-111981419
1634468954,-188250,true,6680594791,22,6568646960,-111947831
1634469189,-188252,true,6679258872,22,6564707150,-114551722
1634469403,-188252,true,6679258872,22,6560769704,-118489168
1634469536,-188256,true,6676587836,22,6559457747,-117130089
1634469926,-188258,true,6675252719,22,6559457747,-115794972
1634470688,-188260,true,6673917869,22,6564707150,-109210719
1634470954,-188260,true,6673917869,22,6562081924,-111835945
1634471100,-188269,true,6667914345,22,6558146052,-109768293
1634471494,-188274,true,6664581388,22,6544389083,-120192305
1634471511,-188277,true,6662582413,22,6543734710,-118847703
1634471559,-188276,true,6663248671,22,6541771982,-121476689
1634471590,-188282,true,6659252121,22,6541117870,-118134251
1634472439,-188287,true,6655923494,22,6498090789,-157832705
1634472471,-188291,true,6653261790,22,6483163100,-170098690
1634472739,-188289,true,6654592509,22,6501340485,-153252024
1634472894,-188295,true,6650601150,22,6509797300,-140803850
1634472975,-188298,true,6648606369,22,6515006961,-133599408
1634473141,-188298,true,6648606369,22,6524786315,-123820054
1634473439,-188302,true,6645947591,22,6555523450,-90424141
1634473785,-188310,true,6640633225,22,6540463824,-100169401
1634473869,-188314,true,6637977635,22,6537848292,-100129343
1634474066,-188315,true,6637313904,22,6535887330,-101426574
1634474177,-188319,true,6634659642,22,6534580349,-100079293
1634474477,-188326,true,6630017237,22,6541117870,-88899367
1634474763,-188329,true,6628028630,22,6560113693,-67914937
1634474777,-188329,true,6628028630,22,6560113693,-67914937
1634474843,-188332,true,6626040619,22,6562738132,-63302487
1634474923,-188337,true,6622728592,22,6565363621,-57364971
1634475112,-188343,true,6618756346,22,6554867963,-63888383
1634475235,-188343,true,6618756346,22,6547661933,-71094413
1634475244,-188346,true,6616771116,22,6547661933,-69109183
1634475283,-188351,true,6613463722,22,6548971530,-64492192
1634475765,-188351,true,6613463722,22,6566020158,-47443564
1634475898,-188350,true,6614125069,22,6576533673,-37591396
1634476055,-188354,true,6611480080,22,6595632345,-15847735
1634476061,-188360,true,6607514580,22,6594972848,-12541732
1634476859,-188362,true,6606193275,22,6605532722,-660553
1634476964,-188362,true,6606193275,22,6606193275,0
1634477715,-188364,true,6604872235,22,6600910698,-3961537
1634477822,-188370,true,6600910698,22,6600910698,0
1634477908,-188371,true,6600250673,22,6600250673,0
1634478146,-188371,true,6600250673,22,6590358213,-9892460
1634478370,-188376,true,6596951538,22,6579822597,-17128941
1634478700,-188380,true,6594313417,22,6564707150,-29606267
1634478721,-188380,true,6594313417,22,6564050745,-30262672
1634478763,-188380,true,6594313417,22,6563394406,-30919011
1634478844,-188383,true,6592335518,22,6564050745,-28284773
1634478916,-188389,true,6588381501,22,6567333427,-21048074
1634479210,-188388,true,6589040339,22,6589699243,658904
1634479313,-188388,true,6589040339,22,6597611233,8570894
1634479897,-188394,true,6585088298,22,6587064022,1975724
1634480030,-188399,true,6581796741,22,6579164681,-2632060
1634480041,-188399,true,6581796741,22,6577849045,-3947696
1634480338,-188398,true,6582454921,22,6564707150,-17747771
1634480522,-188404,true,6578506830,22,6567333427,-11173403
1634481516,-188408,true,6575876085,22,6580480580,4604495
1634481611,-188407,true,6576533673,22,6579822597,3288924
1634481889,-188407,true,6576533673,22,6572589133,-3944540
1634482210,-188411,true,6573903717,22,6558801867,-15101850
1634482591,-188414,true,6571931940,22,6547661933,-24270007
1634482753,-188413,true,6572589133,22,6547007232,-25581901
1634482904,-188412,true,6573246392,22,6546352597,-26893795
1634483007,-188416,true,6570617751,22,6549626428,-20991323
1634483127,-188417,true,6569960755,22,6552901896,-17058859
1634483253,-188416,true,6570617751,22,6556179002,-14438749
1634483459,-188416,true,6570617751,22,6555523450,-15094301
1634483671,-188421,true,6567333427,22,6545698027,-21635400
1634483705,-188424,true,6565363621,22,6544389083,-20974538
1634483856,-188424,true,6565363621,22,6537848292,-27515329
1634483979,-188424,true,6565363621,22,6535887330,-29476291
1634483985,-188429,true,6562081924,22,6535887330,-26194594
1634484199,-188430,true,6561425781,22,6532620367,-28805414
1634484220,-188429,true,6562081924,22,6533273629,-28808295
1634484236,-188429,true,6562081924,22,6533273629,-28808295
1634484429,-188432,true,6560113693,22,6539809843,-20303850
1634484432,-188432,true,6560113693,22,6539809843,-20303850
1634484553,-188430,true,6561425781,22,6549626428,-11799353
1634484679,-188428,true,6562738132,22,6560769704,-1968428
1634484869,-188430,true,6561425781,22,6577191326,15765545
1634484937,-188429,true,6562081924,22,6582454921,20372997
1634485081,-188426,true,6564050745,22,6592335518,28284773
1634485218,-188425,true,6564707150,22,6600250673,35543523
1634485239,-188427,true,6563394406,22,6600910698,37516292
1634485254,-188426,true,6564050745,22,6600910698,36859953
1634485404,-188422,true,6566676760,22,6617432793,50756033
1634485608,-188419,true,6568646960,22,6633996242,65349282
1634486495,-188421,true,6567333427,22,6655923494,88590067
1634487303,-188421,true,6567333427,22,6644618601,77285174
1634487405,-188416,true,6570617751,22,6643289876,72672125
1634487413,-188413,true,6572589133,22,6643954205,71365072
1634487698,-188415,true,6571274813,22,6657254745,85979932
1634487742,-188412,true,6573246392,22,6659918046,86671654
1634487916,-188407,true,6576533673,22,6667914345,91380672
1634488032,-188405,true,6577849045,22,6673250544,95401499
1634488135,-188407,true,6576533673,22,6678591013,102057340
1634488309,-188404,true,6578506830,22,6687278393,108771563
1634488343,-188398,true,6582454921,22,6687278393,104823472
1634488616,-188395,true,6584429855,22,6687947121,103517266
1634488681,-188396,true,6583771478,22,6688615915,104844437
1634488690,-188393,true,6585746807,22,6688615915,102869108
1634488911,-188385,true,6591017249,22,6685272610,94255361
1634489258,-188383,true,6592335518,22,6665914371,73578853
1634489317,-188385,true,6591017249,22,6662582413,71565164
1634489328,-188383,true,6592335518,22,6662582413,70246895
1634489344,-188377,true,6596291908,22,6661250097,64958189
1634489415,-188377,true,6596291908,22,6658586262,62294354
1634489446,-188379,true,6594972848,22,6657254745,62281897
1634489609,-188375,true,6597611233,22,6651266210,53654977
1634489680,-188370,true,6600910698,22,6648606369,47695671
1634489711,-188369,true,6601570789,22,6647941575,46370786
1634489901,-188372,true,6599590714,22,6632669642,33078928
1634489939,-188371,true,6600250673,22,6630017237,29766564
1634490291,-188367,true,6602891169,22,6614786481,11895312
1634490407,-188366,true,6603551459,22,6611480080,7928621
1634490454,-188370,true,6600910698,22,6610157982,9247284
1634490569,-188369,true,6601570789,22,6601570789,0
1634490665,-188360,true,6607514580,22,6609497033,1982453
1634490729,-188358,true,6608836149,22,6616109505,7273356
1634490777,-188362,true,6606193275,22,6612802442,6609167
1634490856,-188360,true,6607514580,22,6618756346,11241766
1634490947,-188356,true,6610157982,22,6626703223,16545241
1634490991,-188356,true,6610157982,22,6630017237,19859255
1634491455,-188358,true,6608836149,22,6663248671,54412522
1634491712,-188355,true,6610818998,22,6670581911,59762913
1634492263,-188352,true,6612802442,22,6673917869,61115427
1634492490,-188351,true,6613463722,22,6672583286,59119564
1634492569,-188354,true,6611480080,22,6661250097,49770017
1634493606,-188355,true,6610818998,22,6555523450,-55295548
1634493697,-188354,true,6611480080,22,6555523450,-55956630
1634493996,-188353,true,6612141228,22,6561425781,-50715447
1634494122,-188355,true,6610818998,22,6564707150,-46111848
1634494271,-188354,true,6611480080,22,6573246392,-38233688
1634494406,-188352,true,6612802442,22,6580480580,-32321862
1634494504,-188351,true,6613463722,22,6587722729,-25740993
1634494590,-188352,true,6612802442,22,6587064022,-25738420
1634494775,-188355,true,6610818998,22,6583113167,-27705831
1634494824,-188355,true,6610818998,22,6583113167,-27705831
1634494895,-188354,true,6611480080,22,6589040339,-22439741
1634494929,-188353,true,6612141228,22,6592335518,-19805710
1634495222,-188354,true,6611480080,22,6589699243,-21780837
1634495584,-188353,true,6612141228,22,6592994752,-19146476
1634495723,-188351,true,6613463722,22,6610157982,-3305740
1634495745,-188350,true,6614125069,22,6606193275,-7931794
1634495760,-188352,true,6612802442,22,6606193275,-6609167
1634496014,-188348,true,6615447960,22,6617432793,1984833
1634496104,-188348,true,6615447960,22,6616109505,661545
1634496237,-188347,true,6616109505,22,6612141228,-3968277
1634496369,-188348,true,6615447960,22,6608175332,-7272628
1634496434,-188347,true,6616109505,22,6606193275,-9916230
1634496472,-188346,true,6616771116,22,6605532722,-11238394
1634496513,-188346,true,6616771116,22,6601570789,-15200327
1634496527,-188348,true,6615447960,22,6600250673,-15197287
1634496724,-188345,true,6617432793,22,6591017249,-26415544
1634496863,-188344,true,6618094536,22,6585088298,-33006238
1634496927,-188342,true,6619418221,22,6583771478,-35646743
1634497099,-188343,true,6618756346,22,6592994752,-25761594
1634497137,-188339,true,6621404245,22,6594972848,-26431397
1634497217,-188337,true,6622728592,22,6600250673,-22477919
1634497364,-188336,true,6623390865,22,6612141228,-11249637
1634497877,-188333,true,6625378081,22,6671248969,45870888
1634498102,-188329,true,6628028630,22,6690622701,62594071
1634498523,-188328,true,6628691433,22,6697316335,68624902
1634498721,-188326,true,6630017237,22,6693968681,63951444
1634498744,-188324,true,6631343307,22,6693968681,62625374
1634498750,-188321,true,6633332909,22,6693968681,60635772
1634498776,-188320,true,6633996242,22,6691291763,57295521
1634498810,-188322,true,6632669642,22,6689284777,56615135
1634498882,-188322,true,6632669642,22,6683935756,51266114
1634498896,-188319,true,6634659642,22,6683267430,48607788
1634499028,-188319,true,6634659642,22,6673250544,38590902
1634499125,-188321,true,6633332909,22,6667914345,34581436
1634499367,-188319,true,6634659642,22,6655257968,20598326
1634499441,-188319,true,6634659642,22,6650601150,15941508
1634499962,-188320,true,6633996242,22,6641297288,7301046
1634499987,-188322,true,6632669642,22,6641961418,9291776
1634500199,-188320,true,6633996242,22,6641297288,7301046
1634500240,-188320,true,6633996242,22,6637977635,3981393
1634500515,-188318,true,6635323108,22,6665247846,29924738
1634500533,-188320,true,6633996242,22,6666580962,32584720
1634500792,-188318,true,6635323108,22,6689953705,54630597
1634501079,-188318,true,6635323108,22,6712737119,77414011
1634501231,-188316,true,6636650239,22,6724830321,88180082
1634501649,-188321,true,6633332909,22,6655923494,22590585
1634501779,-188320,true,6633996242,22,6641961418,7965176
1634502027,-188321,true,6633332909,22,6630680239,-2652670
1634502183,-188320,true,6633996242,22,6624053204,-9943038
1634502325,-188326,true,6630017237,22,6608175332,-21841905
1634502490,-188328,true,6628691433,22,6591017249,-37674184
1634502572,-188332,true,6626040619,22,6581138628,-44901991
1634503056,-188332,true,6626040619,22,6485756755,-140283864
1634503146,-188338,true,6622066386,22,6479922491,-142143895
1634503522,-188338,true,6622066386,22,6497441045,-124625341
1634503569,-188341,true,6620080163,22,6501340485,-118739678
1634503722,-188341,true,6620080163,22,6514355525,-105724638
1634503751,-188346,true,6616771116,22,6516310028,-100461088
1634503890,-188346,true,6616771116,22,6522177053,-94594063
1634503934,-188349,true,6614786481,22,6524786315,-90000166
1634504017,-188349,true,6614786481,22,6531314038,-83472443
1634504059,-188352,true,6612802442,22,6534580349,-78222093
1634504180,-188349,true,6614786481,22,6540463824,-74322657
1634504255,-188352,true,6612802442,22,6544389083,-68413359
1634504309,-188351,true,6613463722,22,6547007232,-66456490
1634504322,-188355,true,6610818998,22,6547661933,-63157065
1634504376,-188352,true,6612802442,22,6549626428,-63176014
1634504407,-188356,true,6610157982,22,6550936418,-59221564
1634504493,-188358,true,6608836149,22,6549626428,-59209721
1634504724,-188359,true,6608175332,22,6555523450,-52651882
1634504775,-188358,true,6608836149,22,6558801867,-50034282
1634504817,-188362,true,6606193275,22,6559457747,-46735528
1634504884,-188364,true,6604872235,22,6557490303,-47381932
1634505088,-188369,true,6601570789,22,6547661933,-53908856
1634505169,-188367,true,6602891169,22,6552246671,-50644498
1634505211,-188371,true,6600250673,22,6554212542,-46038131
1634505533,-188371,true,6600250673,22,6562081924,-38168749
1634505627,-188374,true,6598270994,22,6568646960,-29624034
1634505644,-188368,true,6602230946,22,6567990161,-34240785
1634505817,-188371,true,6600250673,22,6571931940,-28318733
1634505856,-188369,true,6601570789,22,6575876085,-25694704
1634506046,-188372,true,6599590714,22,6587064022,-12526692
1634506119,-188368,true,6602230946,22,6583771478,-18459468
1634506216,-188370,true,6600910698,22,6586405382,-14505316
1634506285,-188370,true,6600910698,22,6587064022,-13846676
1634506654,-188372,true,6599590714,22,6602891169,3300455
1634506716,-188366,true,6603551459,22,6606853895,3302436
1634506770,-188367,true,6602891169,22,6608175332,5284163
1634506921,-188367,true,6602891169,22,6608836149,5944980
1634507007,-188370,true,6600910698,22,6614125069,13214371
1634507134,-188364,true,6604872235,22,6620742171,15869936
1634507162,-188365,true,6604211814,22,6622728592,18516778
1634507338,-188367,true,6602891169,22,6610157982,7266813
1634507370,-188370,true,6600910698,22,6606853895,5943197
1634507388,-188367,true,6602891169,22,6607514580,4623411
1634507506,-188368,true,6602230946,22,6614125069,11894123
1634507798,-188365,true,6604211814,22,6631343307,27131493
1634508088,-188369,true,6601570789,22,6620080163,18509374
1634508288,-188365,true,6604211814,22,6629354302,25142488
1634508395,-188365,true,6604211814,22,6621404245,17192431
1634508440,-188362,true,6606193275,22,6617432793,11239518
1634508868,-188366,true,6603551459,22,6602891169,-660290
1634508911,-188362,true,6606193275,22,6601570789,-4622486
1634509136,-188365,true,6604211814,22,6592335518,-11876296
1634509227,-188363,true,6605532722,22,6587722729,-17809993
1634509256,-188369,true,6601570789,22,6587722729,-13848060
1634509472,-188361,true,6606853895,22,6616771116,9917221
1634509655,-188359,true,6608175332,22,6641297288,33121956
1634509723,-188355,true,6610818998,22,6658586262,47767264
1634509818,-188357,true,6609497033,22,6710723700,101226667
1634509947,-188345,true,6617432793,22,6786981108,169548315
1634510004,-188334,true,6624715610,22,6831921075,207205465
1634510027,-188326,true,6630017237,22,6847651791,217634554
1634510199,-188322,true,6632669642,22,6985278019,352608377
1634510286,-188304,true,6644618601,22,7051951022,407332421
1634510311,-188290,true,6653927116,22,7078090262,424163146
1634510316,-188280,true,6660584038,22,7083046412,422462374
1634510379,-188265,true,6670581911,22,7146363703,475781792
1634510423,-188242,true,6685941138,22,7184338075,498396937
1634510475,-188231,true,6693299351,22,7226126215,532826864
1634510517,-188223,true,6698655865,22,7262345508,563689643
1634510575,-188211,true,6706698675,22,7306778978,600080303
1634510599,-188188,true,6722141062,22,7327998330,605857268
1634510627,-188177,true,6729539115,22,7345605766,616066651
1634510628,-188169,true,6734924631,22,7345605766,610681135
1634510653,-188157,true,6743010987,22,7355896301,612885314
1634510663,-188137,true,6756509828,22,7360310942,603801114
1634510700,-188130,true,6761240804,22,7368411334,607170530
1634510722,-188125,true,6764622101,22,7373570769,608948668
1634510822,-188115,true,6771389768,22,7399422188,628032420
1634510845,-188099,true,6782232121,22,7400162130,617930009
1634510934,-188096,true,6784266994,22,7390548650,606281656
1634510955,-188092,true,6786981108,22,7386854484,599873376
1634511009,-188082,true,6793771144,22,7377996018,584224874
1634511090,-188063,true,6806690933,22,7369148175,562457242
1634511102,-188059,true,6809414018,22,7366201252,556787234
1634511155,-188056,true,6811457047,22,7347074960,535617913
1634511159,-188046,true,6818271570,22,7345605766,527334196
1634511179,-188028,true,6830554896,22,7340465898,509911002
1634511391,-188016,true,6838756072,22,7257263899,418507827
1634511431,-188009,true,6843544637,22,7242040396,398495759
1634511555,-187999,true,6850391262,22,7206642963,356251701
1634511699,-187981,true,6862732453,22,7187212242,324479789
1634511744,-187970,true,6870285234,22,7186493592,316208358
1634511746,-187964,true,6874408436,22,7186493592,312085156
1634511842,-187953,true,6881974068,22,7195841641,313867573
1634511890,-187935,true,6894372156,22,7200160226,305788070
1634511944,-187918,true,6906101970,22,7218904062,312802092
1634511948,-187912,true,6910246667,22,7219625952,309379285
1634512025,-187898,true,6919927303,22,7234802338,314875035
1634512062,-187879,true,6933087005,22,7244937647,311850642
1634512134,-187865,true,6942799638,22,7259441296,316641658
1634512162,-187858,true,6947661056,22,7268884234,321223178
1634512208,-187844,true,6957394107,22,7279067289,321673182
1634512302,-187821,true,6973413728,22,7318478597,345064869
1634512356,-187807,true,6983182855,22,7329464003,346281148
1634512527,-187801,true,6987373812,22,7365464706,378090894
1634512603,-187787,true,6997162497,22,7382423922,385261425
1634512684,-187767,true,7011170124,22,7397202805,386032681
1634512712,-187753,true,7020992145,22,7397202805,376210660
1634512787,-187750,true,7023098654,22,7396463159,373364505
1634512805,-187736,true,7032937385,22,7392026834,359089449
1634512869,-187719,true,7044902948,22,7378733818,333830870
1634512878,-187706,true,7054066819,22,7378733818,324666999
1634513077,-187700,true,7058300318,22,7372096276,313795958
1634513090,-187688,true,7066774938,22,7371359140,304584202
1634513147,-187669,true,7080213901,22,7364728233,284514332
1634513328,-187655,true,7090132647,22,7344871279,254738632
1634513381,-187649,true,7094387790,22,7343402525,249014735
1634513691,-187638,true,7102195519,22,7341934065,239738546
1634513695,-187619,true,7115701843,22,7341934065,226232222
1634513764,-187608,true,7123533029,22,7334596167,211063138
1634513786,-187603,true,7127095508,22,7331663062,204567554
1634513986,-187599,true,7129946774,22,7295827573,165880799
1634514035,-187582,true,7142077385,22,7279067289,136989904
1634514070,-187571,true,7149937600,22,7271792224,121854624
1634514165,-187565,true,7154228635,22,7259441296,105212661
1634514339,-187561,true,7157090756,22,7237696693,80605937
1634514445,-187545,true,7168550693,22,7209526052,40975359
1634514475,-187534,true,7176440043,22,7201600330,25160287
1634514565,-187528,true,7180746984,22,7181465058,718074
1634514657,-187524,true,7183619713,22,7177157687,-6462026
1634514769,-187504,true,7198000610,22,7182901423,-15099187
1634515401,-187495,true,7204481402,22,7194402689,-10078713
1634515504,-187493,true,7205922371,22,7195841641,-10080730
1634515589,-187487,true,7210247005,22,7196561226,-13685779
1634515663,-187467,true,7224681207,22,7195122129,-29559078
1634515851,-187458,true,7231186021,22,7184338075,-46847946
1634515909,-187455,true,7233355594,22,7181465058,-51890536
1634516177,-187450,true,7236972995,22,7177875403,-59097592
1634516276,-187430,true,7251460700,22,7175004970,-76455730
1634516345,-187420,true,7258715425,22,7174287542,-84427883
1634516671,-187416,true,7261619346,22,7168550693,-93068653
1634516736,-187410,true,7265977407,22,7170701474,-95275933
1634516797,-187394,true,7277611694,22,7174287542,-103324152
1634516860,-187388,true,7281979353,22,7175722471,-106256882
1634516938,-187386,true,7283435822,22,7176440043,-106995779
1634517037,-187385,true,7284164165,22,7177157687,-107006478
1634517088,-187376,true,7290722536,22,7178593190,-112129346
1634517188,-187380,true,7287806976,22,7182183205,-105623771
1634517272,-187385,true,7284164165,22,7173570185,-110593980
1634517384,-187392,true,7279067289,22,7155659552,-123407737
1634517415,-187392,true,7279067289,22,7147078340,-131988949
1634517477,-187403,true,7271065118,22,7129946774,-141118344
1634517703,-187412,true,7264524430,22,7068895183,-195629247
1634517738,-187430,true,7251460700,22,7059006148,-192454552
1634517777,-187433,true,7249285697,22,7049835860,-199449837
1634517830,-187440,true,7244213226,22,7038565705,-205647521
1634517984,-187446,true,7239868219,22,7005563712,-234304507
1634518022,-187460,true,7229740001,22,6997162497,-232577504
1634518177,-187463,true,7227571513,22,6977598822,-249972691
1634518271,-187470,true,7222514236,22,6976203511,-246310725
1634518361,-187475,true,7218904062,22,6983881173,-235022889
1634518612,-187489,true,7208805172,22,7009067194,-199737978
1634518655,-187490,true,7208084363,22,7010469078,-197615285
1634518669,-187493,true,7205922371,22,7009768101,-196154270
1634519146,-187498,true,7202320490,22,6993664965,-208655525
1634519301,-187511,true,7192964024,22,6987373812,-205590212
1634519833,-187509,true,7194402689,22,6985278019,-209124670
1634521019,-187510,true,7193683321,22,6945577175,-248106146
1634521192,-187516,true,7189368621,22,6936554242,-252814379
1634521539,-187525,true,7182901423,22,6931700595,-251200828
1634521670,-187525,true,7182901423,22,6936554242,-246347181
1634521891,-187526,true,7182183205,22,6948355822,-233827383
1634521952,-187529,true,7180028981,22,6957394107,-222634874
1634522049,-187536,true,7175004970,22,6975505961,-199499009
1634524219,-187528,true,7180746984,22,7088006032,-92740952
1634524284,-187532,true,7177875403,22,7088006032,-89869371
1634524413,-187535,true,7175722471,22,7097935693,-77786778
1634524435,-187542,true,7170701474,22,7099355351,-71346123
1634524520,-187529,true,7180028981,22,7119972331,-60056650
1634524577,-187530,true,7179311050,22,7134225812,-45085238
1634524775,-187529,true,7180028981,22,7180746984,718003
1634525871,-187536,true,7175004970,22,7327265603,152260633
1634526005,-187524,true,7183619713,22,7327265603,143645890
1634526224,-187530,true,7179311050,22,7325800370,146489320
1634526631,-187529,true,7180028981,22,7320674360,140645379
1634526658,-187539,true,7172852899,22,7320674360,147821461
1634526692,-187529,true,7180028981,22,7324335430,144306449
1634526817,-187532,true,7177875403,22,7330929969,153054566
1634527094,-187530,true,7179311050,22,7347074960,167763910
1634527215,-187540,true,7172135686,22,7356631891,184496205
1634527574,-187534,true,7176440043,22,7389070762,212630719
1634527580,-187537,true,7174287542,22,7389070762,214783220
1634527619,-187531,true,7178593190,22,7391287705,212694515
1634527754,-187541,true,7171418544,22,7400162130,228743586
1634527998,-187531,true,7178593190,22,7417201239,238608049
1634528381,-187533,true,7177157687,22,7433536227,256378540
1634528757,-187525,true,7182901423,22,7436510087,253608664
1634528779,-187533,true,7177157687,22,7436510087,259352400
1634529126,-187520,true,7186493592,22,7437997464,251503872
1634529145,-187523,true,7184338075,22,7437997464,253659389
1634529167,-187518,true,7187930963,22,7438741263,250810300
1634529270,-187526,true,7182183205,22,7442461378,260278173
1634529349,-187515,true,7190087558,22,7440229086,250141528
1634529420,-187517,true,7188649756,22,7440973109,252323353
1634529473,-187513,true,7191525647,22,7441717206,250191559
1634529516,-187520,true,7186493592,22,7444694340,258200748
1634529549,-187507,true,7195841641,22,7446183353,250341712
1634529801,-187506,true,7196561226,22,7461089876,264528650
1634529806,-187501,true,7200160226,22,7461835985,261675759
1634529847,-187502,true,7199440282,22,7464074759,264634477
1634530073,-187489,true,7208805172,22,7464821167,256015995
1634530112,-187490,true,7208084363,22,7461089876,253005513
1634530275,-187485,true,7211689127,22,7461835985,250146858
1634530401,-187487,true,7210247005,22,7458106186,247859181
1634530588,-187474,true,7219625952,22,7446183353,226557401
1634530700,-187474,true,7219625952,22,7437253738,217627786
1634530734,-187469,true,7223236487,22,7435766511,212530024
1634530956,-187469,true,7223236487,22,7430563555,207327068
1634531025,-187460,true,7229740001,22,7420168564,190428563
1634531157,-187464,true,7226848828,22,7395723587,168874759
1634531227,-187459,true,7230462975,22,7383900481,153437506
1634531260,-187463,true,7227571513,22,7384638871,157067358
1634531266,-187453,true,7234802338,22,7384638871,149836533
1634531388,-187455,true,7233355594,22,7366201252,132845658
1634531448,-187450,true,7236972995,22,7357367554,120394559
1634531504,-187454,true,7234078930,22,7349279303,115200373
1634531637,-187445,true,7240592206,22,7330929969,90337763
1634531649,-187447,true,7239144304,22,7327998330,88854026
1634531693,-187442,true,7242764600,22,7320674360,77909760
1634531743,-187447,true,7239144304,22,7313357711,74213407
1634531878,-187441,true,7243488877,22,7279067289,35578412
1634532203,-187442,true,7242764600,22,7265977407,23212807
1634532305,-187440,true,7244213226,22,7250735626,6522400
1634532307,-187445,true,7240592206,22,7250735626,10143420
1634532323,-187439,true,7244937647,22,7249285697,4348050
1634532412,-187442,true,7242764600,22,7242764600,0
1634532431,-187435,true,7247836057,22,7241316265,-6519792
1634532465,-187437,true,7246386707,22,7239144304,-7242403
1634532512,-187429,true,7252185846,22,7235525818,-16660028
1634532530,-187428,true,7252911064,22,7234078930,-18832134
1634532646,-187417,true,7260893257,22,7230462975,-30430282
1634532759,-187418,true,7260167240,22,7234802338,-25364902
1634532816,-187410,true,7265977407,22,7234078930,-31898477
1634532857,-187410,true,7265977407,22,7230462975,-35514432
1634533114,-187404,true,7270338084,22,7210247005,-60091079
1634533236,-187405,true,7269611123,22,7213131537,-56479586
1634533286,-187398,true,7274701377,22,7210247005,-64454372
1634533326,-187398,true,7274701377,22,7205922371,-68779006
1634533371,-187393,true,7278339455,22,7200880242,-77459213
1634533391,-187397,true,7275428847,22,7198720410,-76708437
1634533626,-187391,true,7279795196,22,7172852899,-106942297
1634533771,-187391,true,7279795196,22,7161386084,-118409112
1634533804,-187384,true,7284892582,22,7159238098,-125654484
1634533863,-187386,true,7283435822,22,7157090756,-126345066
1634534023,-187380,true,7287806976,22,7149937600,-137869376
1634534463,-187375,true,7291451608,22,7190087558,-101364050
1634534555,-187367,true,7297286812,22,7200880242,-96406570
1634534769,-187369,true,7295827573,22,7225403675,-70423898
1634534837,-187361,true,7301666278,22,7229740001,-71926277
1634535074,-187355,true,7306048374,22,7261619346,-44429028
1634535099,-187347,true,7311895258,22,7263071743,-48823515
1634535258,-187350,true,7309702128,22,7273246655,-36455473
1634535311,-187346,true,7312626448,22,7275428847,-37197601
1634535352,-187342,true,7315551937,22,7277611694,-37940243
1634535541,-187335,true,7320674360,22,7283435822,-37238538
1634535700,-187339,true,7317746822,22,7290722536,-27024286
1634535763,-187341,true,7316283492,22,7292180753,-24102739
1634535823,-187339,true,7317746822,22,7291451608,-26295214
1634535847,-187336,true,7319942366,22,7290722536,-29219830
1634535892,-187341,true,7316283492,22,7287806976,-28476516
1634536097,-187342,true,7315551937,22,7287078268,-28473669
1634536143,-187341,true,7316283492,22,7281251228,-35032264
1634536157,-187339,true,7317746822,22,7279067289,-38679533
1634536201,-187344,true,7314089046,22,7276156390,-37932656
1634536205,-187350,true,7309702128,22,7275428847,-34273281
1634536367,-187350,true,7309702128,22,7259441296,-50260832
1634536385,-187350,true,7309702128,22,7257989626,-51712502
1634536415,-187355,true,7306048374,22,7258715425,-47332949
1634536607,-187359,true,7303126685,22,7260893257,-42233428
1634536747,-187357,true,7304587383,22,7257989626,-46597757
1634536872,-187359,true,7303126685,22,7248560841,-54565844
1634536884,-187364,true,7299476217,22,7247111346,-52364871
1634536890,-187371,true,7294368626,22,7247111346,-47257280
1634536937,-187369,true,7295827573,22,7244937647,-50889926
1634537041,-187369,true,7295827573,22,7247111346,-48716227
1634537088,-187375,true,7291451608,22,7250735626,-40715982
1634537198,-187381,true,7287078268,22,7260167240,-26911028
1634537224,-187380,true,7287806976,22,7263071743,-24735233
1634537338,-187379,true,7288535757,22,7271792224,-16743533
1634537441,-187384,true,7284892582,22,7275428847,-9463735
1634537520,-187389,true,7281251228,22,7279067289,-2183939
1634537859,-187387,true,7282707551,22,7316283492,33575941
1634537925,-187385,true,7284164165,22,7319942366,35778201
1634538155,-187391,true,7279795196,22,7324335430,44540234
1634539358,-187399,true,7273973980,22,7290722536,16748556
1634539492,-187399,true,7273973980,22,7290722536,16748556
1634539668,-187398,true,7274701377,22,7295098063,20396686
1634539769,-187403,true,7271065118,22,7298016540,26951422
1634540029,-187409,true,7266704005,22,7307509656,40805651
1634540212,-187406,true,7268884234,22,7318478597,49594363
1634540426,-187404,true,7270338084,22,7332396228,62058144
1634540923,-187409,true,7266704005,22,7353689973,86985968
1634541235,-187414,true,7263071743,22,7344136865,81065122
1634541250,-187411,true,7265250882,22,7343402525,78151643
1634541293,-187410,true,7265977407,22,7341934065,75956658
1634541622,-187416,true,7261619346,22,7323603069,61983723
1634542477,-187421,true,7257989626,22,7300936185,42946559
1634542534,-187415,true,7262345508,22,7306778978,44433470
1634542624,-187412,true,7264524430,22,7303856997,39332567
1634542902,-187416,true,7261619346,22,7288535757,26916411
1634543771,-187424,true,7255812664,22,7252185846,-3626818
1634544008,-187419,true,7259441296,22,7250735626,-8705670
1634544052,-187417,true,7260893257,22,7250010625,-10882632
1634544152,-187420,true,7258715425,22,7247836057,-10879368
1634544370,-187427,true,7253636356,22,7243488877,-10147479
1634544456,-187423,true,7256538245,22,7239144304,-17393941
1634544554,-187421,true,7257989626,22,7232632331,-25357295
1634544663,-187425,true,7255087155,22,7225403675,-29683480
1634544749,-187428,true,7252911064,22,7226126215,-26784849
1634544976,-187423,true,7256538245,22,7239868219,-16670026
1634545394,-187418,true,7260167240,22,7271065118,10897878
1634545486,-187420,true,7258715425,22,7280523176,21807751
1634545524,-187425,true,7255087155,22,7285621071,30533916
1634545647,-187417,true,7260893257,22,7296557156,35663899
1634546196,-187414,true,7263071743,22,7300206164,37134421
1634546271,-187417,true,7260893257,22,7296557156,35663899
1634546396,-187421,true,7257989626,22,7291451608,33461982
1634546496,-187414,true,7263071743,22,7280523176,17451433
1634546524,-187415,true,7262345508,22,7275428847,13083339
1634547020,-187419,true,7259441296,22,7205201850,-54239446
1634547126,-187424,true,7255812664,22,7193683321,-62129343
1634547266,-187417,true,7260893257,22,7183619713,-77273544
1634547312,-187416,true,7261619346,22,7179311050,-82308296
1634548213,-187422,true,7257263899,22,7147078340,-110185559
1634548615,-187427,true,7253636356,22,7139221268,-114415088
1634548855,-187420,true,7258715425,22,7135652728,-123062697
1634548976,-187419,true,7259441296,22,7134225812,-125215484
1634548994,-187423,true,7256538245,22,7133512461,-123025784
1634549128,-187428,true,7252911064,22,7127808218,-125102846
1634549551,-187422,true,7257263899,22,7116413413,-140850486
1634549700,-187421,true,7257989626,22,7110722843,-147266783
1634549959,-187423,true,7256538245,22,7132085972,-124452273
1634550103,-187428,true,7252911064,22,7146363703,-106547361
1634550141,-187424,true,7255812664,22,7146363703,-109448961
1634550288,-187424,true,7255812664,22,7137079930,-118732734
1634550394,-187431,true,7250735626,22,7130659769,-120075857
1634550546,-187439,true,7244937647,22,7122820747,-122116900
1634550581,-187438,true,7245662141,22,7120684328,-124977813
1634550883,-187438,true,7245662141,22,7074552278,-171109863
1634551184,-187447,true,7239144304,22,7055477703,-183666601
1634551317,-187456,true,7232632331,22,7054066819,-178565512
1634551951,-187453,true,7234802338,22,7046311999,-188490339
1634552059,-187453,true,7234802338,22,7044902948,-189899390
1634552291,-187461,true,7229017099,22,7043494179,-185522920
1634552400,-187470,true,7222514236,22,7039973488,-182540748
1634552921,-187470,true,7222514236,22,7023800963,-198713273
1634553429,-187471,true,7221792057,22,7007665591,-214126466
1634553577,-187478,true,7216738824,22,7022396414,-194342410
1634553756,-187488,true,7209526052,22,7037158203,-172367849
1634553869,-187485,true,7211689127,22,7048426104,-163263023
1634553874,-187482,true,7213852850,22,7049130947,-164721903
1634553984,-187489,true,7208805172,22,7061830174,-146974998
1634554186,-187493,true,7205922371,22,7088006032,-117916339
1634554210,-187490,true,7208084363,22,7089423704,-118660659
1634554247,-187487,true,7210247005,22,7091550744,-118696261
1634554283,-187495,true,7204481402,22,7097935693,-106545709
1634554305,-187502,true,7199440282,22,7100775293,-98664989
1634554375,-187501,true,7200160226,22,7104326391,-95833835
1634554731,-187496,true,7203761026,22,7115701843,-88059183
1634554777,-187504,true,7198000610,22,7119260405,-78740205
1634554797,-187510,true,7193683321,22,7120684328,-72998993
1634554857,-187506,true,7196561226,22,7127808218,-68753008
1634554880,-187501,true,7200160226,22,7129946774,-70213452
1634555317,-187507,true,7195841641,22,7179311050,-16530591
1634555599,-187513,true,7191525647,22,7208084363,16558716
1634555770,-187511,true,7192964024,22,7203761026,10797002
1634555795,-187506,true,7196561226,22,7200160226,3599000
1634556529,-187518,true,7187930963,22,7099355351,-88575612
1634556554,-187527,true,7181465058,22,7097225971,-84239087
1634556612,-187526,true,7182183205,22,7092969125,-89214080
1634556809,-187522,true,7185056509,22,7092259899,-92796610
1634557029,-187532,true,7177875403,22,7097935693,-79939710
1634557145,-187539,true,7172852899,22,7101485371,-71367528
1634557173,-187538,true,7173570185,22,7103616030,-69954155
1634557255,-187533,true,7177157687,22,7102195519,-74962168
1634557367,-187543,true,7169984475,22,7110722843,-59261632
1634557429,-187551,true,7164251068,22,7113567559,-50683509
1634557479,-187550,true,7164967493,22,7116413413,-48554080
1634557642,-187545,true,7168550693,22,7124957807,-43592886
1634557863,-187555,true,7161386084,22,7134939234,-26446850
1634558058,-187563,true,7155659552,22,7143505872,-12153680
1634558285,-187562,true,7156375118,22,7153513284,-2861834
1634558548,-187556,true,7160670017,22,7166400558,5730541
1634558575,-187564,true,7154944058,22,7167833910,12889852
1634558584,-187571,true,7149937600,22,7167833910,17896310
1634558673,-187568,true,7152082796,22,7180746984,28664188
1634558681,-187559,true,7158522245,22,7182183205,23660960
1634558782,-187562,true,7156375118,22,7207363627,50988509
1634558794,-187566,true,7153513284,22,7210247005,56733721
1634559014,-187559,true,7158522245,22,7273246655,114724410
1634559321,-187546,true,7167833910,22,7394244664,226410754
1634559430,-187547,true,7167117198,22,7435023008,267905810
1634559667,-187552,true,7163534714,22,7463328427,299793713
1634559704,-187543,true,7169984475,22,7464074759,294090284
1634559860,-187533,true,7177157687,22,7462582168,285424481
1634560148,-187535,true,7175722471,22,7437997464,262274993
1634560198,-187539,true,7172852899,22,7428334832,255481933
1634560551,-187534,true,7176440043,22,7400162130,223722087
1634560771,-187526,true,7182183205,22,7395723587,213540382
1634560923,-187529,true,7180028981,22,7391287705,211258724
1634561053,-187533,true,7177157687,22,7388331929,211174242
1634561079,-187527,true,7181465058,22,7389809669,208344611
1634561112,-187519,true,7187212242,22,7392026834,204814592
1634561253,-187521,true,7185775015,22,7400902147,215127132
1634561516,-187522,true,7185056509,22,7437253738,252197229
1634561587,-187516,true,7189368621,22,7439485137,250116516
1634561653,-187505,true,7197280882,22,7443205624,245924742
1634562026,-187504,true,7198000610,22,7461835985,263835375
1634562044,-187506,true,7196561226,22,7462582168,266020942
1634562096,-187499,true,7201600330,22,7461835985,260235655
1634562442,-187489,true,7208805172,22,7428334832,219529660
1634562790,-187489,true,7208805172,22,7406824941,198019769
1634563102,-187490,true,7208084363,22,7389809669,181725306
1634563241,-187483,true,7213131537,22,7387593170,174461633
1634563430,-187474,true,7219625952,22,7379471691,159845739
1634563544,-187474,true,7219625952,22,7375783062,156157110
1634564159,-187475,true,7218904062,22,7365464706,146560644
1634564448,-187467,true,7224681207,22,7362519256,137838049
1634564478,-187458,true,7231186021,22,7357367554,126181533
1634564481,-187460,true,7229740001,22,7356631891,126891890
1634564633,-187466,true,7225403675,22,7330929969,105526294
1634564724,-187464,true,7226848828,22,7317015121,90166293
1634564971,-187453,true,7234802338,22,7281979353,47177015
1634565007,-187451,true,7236249370,22,7277611694,41362324
1634565191,-187454,true,7234078930,22,7257263899,23184969
1634565288,-187452,true,7235525818,22,7246386707,10860889
1634565723,-187443,true,7242040396,22,7212410295,-29630101
1634566282,-187442,true,7242764600,22,7185775015,-56989585
1634566338,-187445,true,7240592206,22,7187930963,-52661243
1634566505,-187443,true,7242040396,22,7193683321,-48357075
1634566743,-187434,true,7248560841,22,7200160226,-48400615
1634566807,-187432,true,7250010625,22,7198720410,-51290215
1634567256,-187435,true,7247836057,22,7192244800,-55591257
1634567588,-187430,true,7251460700,22,7231186021,-20274679
1634567620,-187420,true,7258715425,22,7234802338,-23913087
1634567898,-187417,true,7260893257,22,7271065118,10171861
1634568290,-187418,true,7260167240,22,7302396445,42229205
1634568402,-187414,true,7263071743,22,7294368626,31296883
1634568474,-187408,true,7267430675,22,7290722536,23291861
1634568638,-187406,true,7268884234,22,7280523176,11638942
1634569007,-187409,true,7266704005,22,7256538245,-10165760
1634569335,-187406,true,7268884234,22,7236972995,-31911239
1634569341,-187399,true,7273973980,22,7236972995,-37000985
1634569531,-187398,true,7274701377,22,7234078930,-40622447
1634569542,-187401,true,7272519403,22,7234078930,-38440473
1634569693,-187398,true,7274701377,22,7236249370,-38452007
1634569706,-187392,true,7279067289,22,7236249370,-42817919
1634569793,-187389,true,7281251228,22,7241316265,-39934963
1634570249,-187391,true,7279795196,22,7268157418,-11637778
1634570388,-187389,true,7281251228,22,7275428847,-5822381
1634570463,-187386,true,7283435822,22,7276884006,-6551816
1634570484,-187385,true,7284164165,22,7276884006,-7280159
1634570982,-187389,true,7281251228,22,7260893257,-20357971
1634571046,-187386,true,7283435822,22,7254361719,-29074103
1634571212,-187383,true,7285621071,22,7261619346,-24001725
1634571660,-187375,true,7291451608,22,7292909972,1458364
1634572075,-187375,true,7291451608,22,7322870782,31419174
1634572163,-187371,true,7294368626,22,7325800370,31431744
1634572173,-187368,true,7296557156,22,7325800370,29243214
1634572245,-187361,true,7301666278,22,7322870782,21204504
1634572266,-187362,true,7300936185,22,7322138568,21202383
1634572373,-187360,true,7302396445,22,7318478597,16082152
1634572477,-187356,true,7305317842,22,7316283492,10965650
1634572539,-187350,true,7309702128,22,7319210445,9508317
1634572744,-187349,true,7310433099,22,7330929969,20496870
1634573946,-187345,true,7313357711,22,7377996018,64638307
1634574204,-187342,true,7315551937,22,7377258292,61706355
1634574246,-187335,true,7320674360,22,7381685754,61011394
1634574269,-187334,true,7321406428,22,7386115873,64709445
1634574297,-187329,true,7325067863,22,7388331929,63264066
1634574391,-187317,true,7333862781,22,7415718021,81855240
1634574410,-187309,true,7339731925,22,7420910581,81178656
1634574495,-187307,true,7341199945,22,7445438809,104238864
1634574499,-187303,true,7344136865,22,7447672664,103535799
1634574538,-187292,true,7352219456,22,7464074759,111855303
1634574563,-187286,true,7356631891,22,7474531259,117899368
1634574624,-187282,true,7359574985,22,7499236719,139661734
1634574682,-187281,true,7360310942,22,7524023837,163712895
1634574693,-187274,true,7365464706,22,7529292234,163827528
1634574698,-187270,true,7368411334,22,7532304402,163893068
1634574755,-187263,true,7373570769,22,7556445174,182874405
1634574772,-187262,true,7374308126,22,7567031077,192722951
1634574792,-187251,true,7382423922,22,7577631809,195207887
1634574923,-187247,true,7385377335,22,7638492940,253115605
1634574934,-187239,true,7391287705,22,7644605874,253318169
1634574992,-187239,true,7391287705,22,7666039692,274751987
1634575061,-187228,true,7399422188,22,7695224600,295802412
1634575069,-187225,true,7401642237,22,7699072982,297430745
1634575371,-187214,true,7409788115,22,7794351578,384563463
1634575565,-187213,true,7410529094,22,7813860858,403331764
1634575639,-187203,true,7417942959,22,7818550346,400607387
1634575700,-187200,true,7420168564,22,7815423708,395255144
1634575765,-187193,true,7425364241,22,7816205250,390841009
1634575771,-187193,true,7425364241,22,7816205250,390841009
1634575817,-187183,true,7432792947,22,7816986871,384193924
1634575824,-187180,true,7435023008,22,7816205250,381182242
1634575906,-187176,true,7437997464,22,7813079550,375082086
1634575940,-187175,true,7438741263,22,7813079550,374338287
1634575998,-187164,true,7446927971,22,7811517168,364589197
1634576019,-187161,true,7449162273,22,7806831898,357669625
1634576182,-187157,true,7452142385,22,7778001430,325859045
1634576206,-187156,true,7452887599,22,7774891008,322003409
1634576396,-187145,true,7461089876,22,7752377609,291287733
1634576425,-187140,true,7464821167,22,7750052361,285231194
1634576438,-187135,true,7468554324,22,7749277433,280723109
1634576481,-187135,true,7468554324,22,7739210421,270656097
1634576574,-187126,true,7475278712,22,7719887525,244608813
1634576678,-187123,true,7477521520,22,7700612873,223091353
1634576708,-187114,true,7484253982,22,7695994122,211740140
1634576804,-187108,true,7488745657,22,7695994122,207248465
1634576895,-187098,true,7496237774,22,7693685786,197448012
1634576948,-187094,true,7499236719,22,7690609080,191372361
1634577006,-187088,true,7503737386,22,7681386345,177648959
1634577123,-187084,true,7506739331,22,7666806296,160066965
1634577306,-187075,true,7513498099,22,7640020715,126522616
1634577318,-187070,true,7517255600,22,7638492940,121237340
1634577332,-187062,true,7523271510,22,7639256789,115985279
1634577351,-187057,true,7527033898,22,7640020715,112986817
1634577560,-187043,true,7537578598,22,7660675610,123097012
1634577609,-187039,true,7540594081,22,7662207822,121613741
1634577617,-187030,true,7547383331,22,7662974042,115590711
1634577735,-187029,true,7548138070,22,7656080813,107942743
1634577790,-187015,true,7558712334,22,7653019146,94306812
1634577968,-187013,true,7560224152,22,7667572976,107348824
1634578003,-187008,true,7564005021,22,7670640466,106635445
1634578075,-187005,true,7566274449,22,7678314559,112040110
1634578180,-186992,true,7576116510,22,7690609080,114492570
1634578226,-186988,true,7579147411,22,7693685786,114538375
1634578265,-186980,true,7585212851,22,7692916494,107703643
1634578506,-186975,true,7589006216,22,7702923288,113917072
1634578627,-186960,true,7600397698,22,7716800342,116402644
1634578704,-186956,true,7603438313,22,7726065597,122627284
1634578748,-186948,true,7609523193,22,7726838203,117315010
1634578973,-186943,true,7613328715,22,7757030199,143701484
1634579097,-186928,true,7624756706,22,7762461749,137705043
1634579116,-186925,true,7627044362,22,7763237996,136193634
1634579206,-186917,true,7633148133,22,7769450760,136302627
1634579403,-186915,true,7634674839,22,7759357541,124682702
1634579415,-186901,true,7645370334,22,7757030199,111659865
1634579894,-186898,true,7647664175,22,7738436577,90772402
1634580039,-186888,true,7655315281,22,7742306570,86991289
1634580267,-186884,true,7658377867,22,7754703555,96325688
1634580389,-186871,true,7668339734,22,7764014319,95674585
1634580473,-186868,true,7670640466,22,7767897103,97256637
1634580513,-186860,true,7676779126,22,7767897103,91117977
1634580822,-186857,true,7679082390,22,7772559007,93476617
1634580842,-186845,true,7688302359,22,7771781828,83479469
1634581204,-186841,true,7691378141,22,7764014319,72636178
1634581330,-186833,true,7697533398,22,7760133477,62600079
1634581455,-186829,true,7700612873,22,7759357541,58744668
1634581494,-186816,true,7710629679,22,7766343757,55714078
1634581545,-186813,true,7712943099,22,7768673893,55730794
1634581843,-186806,true,7718343779,22,7782669398,64325619
1634581919,-186802,true,7721431580,22,7786561511,65129931
1634581972,-186790,true,7730702395,22,7788897713,58195318
1634582024,-186788,true,7732248613,22,7787340167,55091554
1634582323,-186783,true,7736115511,22,7786561511,50446000
1634582395,-186781,true,7737662811,22,7785004432,47341621
1634582442,-186779,true,7739210421,22,7778779231,39568810
1634582483,-186779,true,7739210421,22,7773336263,34125842
1634582594,-186774,true,7743080800,22,7769450760,26369960
1634582690,-186774,true,7743080800,22,7768673893,25593093
1634582709,-186774,true,7743080800,22,7767897103,24816303
1634582732,-186774,true,7743080800,22,7766343757,23262957
1634582920,-186771,true,7745403957,22,7778779231,33375274
1634582981,-186770,true,7746178497,22,7785004432,38825935
1634583035,-186769,true,7746953115,22,7791234616,44281501
1634583120,-186769,true,7746953115,22,7799029358,52076243
1634583145,-186767,true,7748502583,22,7799809261,51306678
1634583377,-186770,true,7746178497,22,7812298320,66119823
1634583404,-186770,true,7746178497,22,7811517168,65338671
1634583580,-186772,true,7744629494,22,7796690117,52060623
1634584127,-186772,true,7744629494,22,7736889122,-7740372
1634585210,-186772,true,7744629494,22,7749277433,4647939
1634585310,-186771,true,7745403957,22,7752377609,6973652
1634585525,-186772,true,7744629494,22,7751602449,6972955
1634585917,-186775,true,7742306570,22,7755479026,13172456
1634585970,-186776,true,7741532416,22,7758581683,17049267
1634585974,-186776,true,7741532416,22,7759357541,17825125
1634586147,-186773,true,7743855108,22,7790455571,46600463
1634586384,-186773,true,7743855108,22,7805270766,61415658
1634586407,-186774,true,7743080800,22,7806831898,63751098
1634586493,-186773,true,7743855108,22,7816986871,73131763
1634586519,-186772,true,7744629494,22,7820114135,75484641
1634586601,-186767,true,7748502583,22,7829503435,81000852
1634586910,-186771,true,7745403957,22,7816986871,71582914
1634587103,-186771,true,7745403957,22,7788897713,43493756
1634587360,-186769,true,7746953115,22,7778779231,31826116
1634587488,-186763,true,7751602449,22,7768673893,17071444
1634587530,-186766,true,7749277433,22,7771004728,21727295
1634588056,-186768,true,7747727810,22,7749277433,1549623
1634588168,-186769,true,7746953115,22,7721431580,-25521535
1634588189,-186765,true,7750052361,22,7719115613,-30936748
1634588200,-186768,true,7747727810,22,7716028739,-31699071
1634588382,-186769,true,7746953115,22,7699072982,-47880133
1634588583,-186767,true,7748502583,22,7685996330,-62506253
1634588651,-186762,true,7752377609,22,7692916494,-59461115
1634588972,-186763,true,7751602449,22,7726065597,-25536852
1634589089,-186765,true,7750052361,22,7752377609,2325248
1634589248,-186762,true,7752377609,22,7751602449,-775160
1634589395,-186758,true,7755479026,22,7739210421,-16268605
1634589407,-186760,true,7753928163,22,7738436577,-15491586
1634589770,-186762,true,7752377609,22,7679850299,-72527310
1634589885,-186759,true,7754703555,22,7662974042,-91729513
1634590149,-186754,true,7758581683,22,7661441677,-97140006
1634590475,-186756,true,7757030199,22,7693685786,-63344413
1634590529,-186763,true,7751602449,22,7696763722,-54838727
1634590564,-186760,true,7753928163,22,7699072982,-54855181
1634590693,-186755,true,7757805902,22,7699842889,-57963013
1634590756,-186756,true,7757030199,22,7710629679,-46400520
1634590776,-186761,true,7753152847,22,7711400742,-41752105
1634590847,-186760,true,7753928163,22,7699072982,-54855181
1634591253,-186754,true,7758581683,22,7687533606,-71048077
1634591440,-186756,true,7757030199,22,7681386345,-75643854
1634591466,-186761,true,7753152847,22,7682154484,-70998363
1634591554,-186760,true,7753928163,22,7687533606,-66394557
1634591564,-186755,true,7757805902,22,7688302359,-69503543
1634591620,-186758,true,7755479026,22,7687533606,-67945420
1634591697,-186764,true,7750827366,22,7685227807,-65599559
1634591745,-186764,true,7750827366,22,7692147279,-58680087
1634591986,-186758,true,7755479026,22,7694455154,-61023872
1634592128,-186762,true,7752377609,22,7702923288,-49454321
1634592321,-186767,true,7748502583,22,7716800342,-31702241
1634592417,-186768,true,7747727810,22,7704463950,-43263860
1634592762,-186764,true,7750827366,22,7682922700,-67904666
1634593024,-186766,true,7749277433,22,7662974042,-86303391
1634593285,-186772,true,7744629494,22,7647664175,-96965319
1634593360,-186773,true,7743855108,22,7650723699,-93131409
1634593434,-186769,true,7746953115,22,7652253921,-94699194
1634593492,-186772,true,7744629494,22,7649958703,-94670791
1634593577,-186779,true,7739210421,22,7649193784,-90016637
1634593657,-186780,true,7738436577,22,7653784448,-84652129
1634593785,-186775,true,7742306570,22,7661441677,-80864893
1634593896,-186777,true,7740758341,22,7668339734,-72418607
1634593968,-186782,true,7736889122,22,7672941888,-63947234
1634593986,-186783,true,7736115511,22,7673709182,-62406329
1634594178,-186778,true,7739984342,22,7689071189,-50913153
1634594316,-186779,true,7739210421,22,7697533398,-41677023
1634594331,-186785,true,7734568520,22,7698303151,-36265369
1634594625,-186787,true,7733021838,22,7713714393,-19307445
1634594646,-186783,true,7736115511,22,7713714393,-22401118
1634594754,-186787,true,7733021838,22,7697533398,-35488440
1634594852,-186794,true,7727610887,22,7683690992,-43919895
1634594926,-186799,true,7723748241,22,7674476553,-49271688
1634594965,-186794,true,7727610887,22,7669106568,-58504319
1634594974,-186798,true,7724520616,22,7668339734,-56180882
1634595052,-186802,true,7721431580,22,7660675610,-60755970
1634595195,-186806,true,7718343779,22,7650723699,-67620080
1634595222,-186800,true,7722975943,22,7649193784,-73782159
1634595308,-186803,true,7720659514,22,7648428941,-72230573
1634595325,-186807,true,7717572022,22,7648428941,-69143081
1634595359,-186812,true,7713714393,22,7641548796,-72165597
1634595379,-186809,true,7716028739,22,7640784717,-75244022
1634596113,-186810,true,7715257213,22,7703693580,-11563633
1634596158,-186816,true,7710629679,22,7695224600,-15405079
1634596226,-186822,true,7706004920,22,7679850299,-26154621
1634596330,-186819,true,7708316952,22,7676011525,-32305427
1634596458,-186824,true,7704463950,22,7665273165,-39190785
1634596647,-186827,true,7702153073,22,7646899485,-55253588
1634596703,-186830,true,7699842889,22,7640784717,-59058172
1634596803,-186826,true,7702923288,22,7627807066,-75116222
1634596819,-186831,true,7699072982,22,7626281734,-72791248
1634596874,-186835,true,7695994122,22,7623231983,-72762139
1634596936,-186837,true,7694455154,22,7616374504,-78080650
1634597098,-186833,true,7697533398,22,7620183453,-77349945
1634597239,-186840,true,7692147279,22,7615612943,-76534336
1634597300,-186844,true,7689071189,22,7614851457,-74219732
1634597336,-186850,true,7684459361,22,7610284145,-74175216
1634597398,-186850,true,7684459361,22,7602678045,-81781316
1634597621,-186859,true,7677546804,22,7579147411,-98399393
1634597789,-186863,true,7674476553,22,7563248696,-111227857
1634597815,-186867,true,7671407530,22,7560224152,-111183378
1634597872,-186869,true,7669873478,22,7552668085,-117205393
1634597996,-186874,true,7666039692,22,7542102276,-123937416
1634598160,-186877,true,7663740340,22,7535317776,-128422564
1634598189,-186881,true,7660675610,22,7532304402,-128371208
1634598404,-186883,true,7659143705,22,7529292234,-129851471
1634598497,-186889,true,7654549826,22,7528539380,-126010446
1634598542,-186891,true,7653019146,22,7527786601,-125232545
1634598613,-186893,true,7651488772,22,7527033898,-124454874
1634598659,-186894,true,7650723699,22,7526281270,-124442429
1634599288,-186898,true,7647664175,22,7535317776,-112346399
1634599327,-186898,true,7647664175,22,7536071308,-111592867
1634599374,-186902,true,7644605874,22,7537578598,-107027276
1634599399,-186904,true,7643077182,22,7539086189,-103990993
1634599686,-186910,true,7638492940,22,7542102276,-96390664
1634599731,-186911,true,7637729167,22,7542102276,-95626891
1634599849,-186916,true,7633911448,22,7541348141,-92563307
1634599976,-186916,true,7633911448,22,7542102276,-91809172
1634600017,-186919,true,7631621733,22,7541348141,-90273592
1634600156,-186917,true,7633148133,22,7539840097,-93308036
1634600287,-186922,true,7629332704,22,7539086189,-90246515
1634600395,-186924,true,7627807066,22,7539086189,-88720877
1634600441,-186928,true,7624756706,22,7539086189,-85670517
1634600472,-186927,true,7625519182,22,7539086189,-86432993
1634600637,-186929,true,7623994307,22,7557956539,-66037768
1634600843,-186929,true,7623994307,22,7573086821,-50907486
1634600921,-186933,true,7620945471,22,7579905326,-41040145
1634600956,-186932,true,7621707566,22,7582937743,-38769823
1634600960,-186933,true,7620945471,22,7583696036,-37249435
1634601106,-186933,true,7620945471,22,7599637734,-21307737
1634601127,-186936,true,7618659645,22,7601917853,-16741792
1634601171,-186935,true,7619421511,22,7604959077,-14462434
1634601317,-186937,true,7617897855,22,7615612943,-2284912
1634601394,-186937,true,7617897855,22,7620183453,2285598
1634601449,-186941,true,7614851457,22,7617897855,3046398
1634601455,-186941,true,7614851457,22,7617897855,3046398
1634601618,-186940,true,7615612943,22,7623994307,8381364
1634601628,-186940,true,7615612943,22,7624756706,9143763
1634602012,-186945,true,7611806278,22,7634674839,22868561
1634602139,-186945,true,7611806278,22,7641548796,29742518
1634602219,-186944,true,7612567459,22,7644605874,32038415
1634602250,-186942,true,7614090048,22,7644605874,30515826
1634602339,-186946,true,7611045174,22,7646899485,35854311
1634602522,-186945,true,7611806278,22,7645370334,33564056
1634602566,-186945,true,7611806278,22,7643841490,32035212
1634602582,-186943,true,7613328715,22,7643077182,29748467
1634602609,-186947,true,7610284145,22,7640784717,30500572
1634602644,-186948,true,7609523193,22,7637729167,28205974
1634602751,-186949,true,7608762317,22,7629332704,20570387
1634602788,-186949,true,7608762317,22,7627044362,18282045
1634602913,-186953,true,7605719572,22,7621707566,15987994
1634603012,-186955,true,7604198657,22,7615612943,11414286
1634603057,-186955,true,7604198657,22,7614090048,9891391
1634603069,-186956,true,7603438313,22,7614090048,10651735
1634603094,-186960,true,7600397698,22,7613328715,12931017
1634603174,-186960,true,7600397698,22,7613328715,12931017
1634603204,-186960,true,7600397698,22,7613328715,12931017
1634603321,-186960,true,7600397698,22,7613328715,12931017
1634603347,-186962,true,7598877846,22,7612567459,13689613
1634603383,-186961,true,7599637734,22,7612567459,12929725
1634603553,-186957,true,7602678045,22,7620183453,17505408
1634603702,-186957,true,7602678045,22,7631621733,28943688
1634603718,-186959,true,7601157737,22,7634674839,33517102
1634603856,-186959,true,7601157737,22,7646134871,44977134
1634603943,-186956,true,7603438313,22,7653019146,49580833
1634603956,-186954,true,7604959077,22,7654549826,49590749
1634603981,-186957,true,7602678045,22,7656080813,53402768
1634604172,-186959,true,7601157737,22,7664506714,63348977
1634604264,-186955,true,7604198657,22,7666806296,62607639
1634604463,-186954,true,7604959077,22,7672941888,67982811
1634604473,-186959,true,7601157737,22,7673709182,72551445
1634604526,-186959,true,7601157737,22,7680618284,79460547
1634604559,-186955,true,7604198657,22,7681386345,77187688
1634604631,-186953,true,7605719572,22,7679850299,74130727
1634604713,-186953,true,7605719572,22,7679082390,73362818
1634604745,-186956,true,7603438313,22,7678314559,74876246
1634604866,-186952,true,7606480144,22,7677546804,71066660
1634604964,-186949,true,7608762317,22,7682154484,73392167
1634604975,-186949,true,7608762317,22,7682922700,74160383
1634604976,-186951,true,7607240792,22,7682922700,75681908
1634605011,-186946,true,7611045174,22,7685227807,74182633
1634605129,-186943,true,7613328715,22,7692916494,79587779
1634605149,-186941,true,7614851457,22,7694455154,79603697
1634605326,-186944,true,7612567459,22,7706004920,93437461
1634605341,-186937,true,7617897855,22,7708316952,90419097
1634605354,-186932,true,7621707566,22,7709858693,88151127
1634605487,-186928,true,7624756706,22,7723748241,98991535
1634605858,-186927,true,7625519182,22,7772559007,147039825
1634605931,-186922,true,7629332704,22,7767120391,137787687
1634605991,-186918,true,7632384895,22,7759357541,126972646
1634606146,-186916,true,7633911448,22,7750052361,116140913
1634606317,-186920,true,7630858647,22,7733021838,102163191
1634606441,-186914,true,7635438307,22,7721431580,85993273
1634606630,-186908,true,7640020715,22,7705234396,65213681
1634606642,-186905,true,7642312951,22,7704463950,62150999
1634606758,-186909,true,7639256789,22,7682154484,42897695
1634606880,-186904,true,7643077182,22,7682154484,39077302
1634606920,-186900,true,7646134871,22,7681386345,35251474
1634606936,-186899,true,7646899485,22,7682154484,35254999
1634607008,-186901,true,7645370334,22,7682922700,37552366
1634607045,-186896,true,7649193784,22,7683690992,34497208
1634607098,-186892,true,7652253921,22,7684459361,32205440
1634607170,-186891,true,7653019146,22,7680618284,27599138
1634607301,-186895,true,7649958703,22,7670640466,20681763
1634607348,-186891,true,7653019146,22,7660675610,7656464
1634607548,-186890,true,7653784448,22,7617136141,-36648307
1634607619,-186889,true,7654549826,22,7613328715,-41221111
1634607624,-186895,true,7649958703,22,7612567459,-37391244
1634607751,-186892,true,7652253921,22,7588247392,-64006529
1634607758,-186891,true,7653019146,22,7586729970,-66289176
1634607797,-186893,true,7651488772,22,7579905326,-71583446
1634607807,-186899,true,7646899485,22,7578389572,-68509913
1634607991,-186896,true,7649193784,22,7545874081,-103319703
1634608048,-186897,true,7648428941,22,7539086189,-109342752
1634608144,-186898,true,7647664175,22,7528539380,-119124795
1634608175,-186904,true,7643077182,22,7525528717,-117548465
1634608316,-186900,true,7646134871,22,7529292234,-116842637
1634608447,-186900,true,7646134871,22,7536824915,-109309956
1634608501,-186902,true,7644605874,22,7537578598,-107027276
1634608569,-186907,true,7640784717,22,7544365132,-96419585
1634608642,-186902,true,7644605874,22,7554178694,-90427180
1634608693,-186902,true,7644605874,22,7560980175,-83625699
1634608878,-186905,true,7642312951,22,7563248696,-79064255
1634608893,-186910,true,7638492940,22,7563248696,-75244244
1634609010,-186908,true,7640020715,22,7562492447,-77528268
1634609115,-186908,true,7640020715,22,7560980175,-79040540
1634609148,-186911,true,7637729167,22,7560224152,-77505015
1634609160,-186917,true,7633148133,22,7560224152,-72923981
1634609331,-186913,true,7636201851,22,7557956539,-78245312
1634609362,-186913,true,7636201851,22,7559468206,-76733645
1634609382,-186916,true,7633911448,22,7557956539,-75954909
1634609522,-186922,true,7629332704,22,7549647773,-79684931
1634609528,-186918,true,7632384895,22,7548892883,-83492012
1634609685,-186918,true,7632384895,22,7548892883,-83492012
1634609701,-186921,true,7630095637,22,7549647773,-80447864
1634609749,-186924,true,7627807066,22,7550402737,-77404329
1634609776,-186919,true,7631621733,22,7550402737,-81218996
1634609803,-186920,true,7630858647,22,7550402737,-80455910
1634609916,-186923,true,7628569847,22,7553423352,-75146495
1634610006,-186926,true,7626281734,22,7556445174,-69836560
1634610093,-186922,true,7629332704,22,7557956539,-71376165
1634610114,-186922,true,7629332704,22,7558712334,-70620370
1634610409,-186925,true,7627044362,22,7564005021,-63039341
1634610486,-186930,true,7623231983,22,7566274449,-56957534
1634610539,-186926,true,7626281734,22,7567787780,-58493954
1634610700,-186926,true,7626281734,22,7576116510,-50165224
1634610745,-186928,true,7624756706,22,7577631809,-47124897
1634610798,-186932,true,7621707566,22,7583696036,-38011530
1634610821,-186928,true,7624756706,22,7583696036,-41060670
1634611006,-186930,true,7623231983,22,7580663316,-42568667
1634611057,-186933,true,7620945471,22,7579905326,-41040145
1634611358,-186938,true,7617136141,22,7575358974,-41777167
1634611362,-186935,true,7619421511,22,7575358974,-44062537
1634611412,-186937,true,7617897855,22,7575358974,-42538881
1634611565,-186940,true,7615612943,22,7572329588,-43283355
1634611574,-186944,true,7612567459,22,7572329588,-40237871
1634611699,-186940,true,7615612943,22,7570058343,-45554600
1634611802,-186942,true,7614090048,22,7576116510,-37973538
1634611936,-186944,true,7612567459,22,7582937743,-29629716
1634611988,-186948,true,7609523193,22,7585971373,-23551820
1634612081,-186944,true,7612567459,22,7592042274,-20525185
1634612142,-186947,true,7610284145,22,7595079547,-15204598
1634612458,-186952,true,7606480144,22,7576874121,-29606023
1634612524,-186955,true,7604198657,22,7575358974,-28839683
1634612714,-186953,true,7605719572,22,7551157778,-54561794
1634612736,-186957,true,7602678045,22,7548138070,-54539975
1634612782,-186963,true,7598118034,22,7542856486,-55261548
1634612878,-186967,true,7595079547,22,7531551247,-63528300
1634613008,-186966,true,7595839055,22,7515000874,-80838181
1634613102,-186971,true,7592042274,22,7508240754,-83801520
1634613195,-186977,true,7587488643,22,7505238208,-82250435
1634613370,-186983,true,7582937743,22,7487248133,-95689610
1634613461,-186983,true,7582937743,22,7480512977,-102424766
1634613495,-186988,true,7579147411,22,7479765001,-99382410
1634613695,-186995,true,7573844129,22,7476026240,-97817889
1634613725,-187002,true,7568544558,22,7475278712,-93265846
1634613857,-187001,true,7569301413,22,7469301180,-100000233
1634613949,-187006,true,7565517897,22,7466314206,-99203691
1634614142,-187011,true,7561736273,22,7467807543,-93928730
1634614196,-187014,true,7559468206,22,7470795114,-88673092
1634614252,-187013,true,7560224152,22,7474531259,-85692893
1634614921,-187018,true,7556445174,22,7494738751,-61706423
1634615025,-187024,true,7551912893,22,7486499483,-65413410
1634615125,-187027,true,7549647773,22,7478269272,-71378501
1634615146,-187025,true,7551157778,22,7476026240,-75131538
1634615444,-187033,true,7545119569,22,7441717206,-103402363
1634615500,-187039,true,7540594081,22,7435023008,-105571073
1634615508,-187043,true,7537578598,22,7434279580,-103299018
1634615588,-187043,true,7537578598,22,7422394837,-115183761
1634615604,-187051,true,7531551247,22,7419426622,-112124625
1634615622,-187057,true,7527033898,22,7417201239,-109832659
1634615667,-187060,true,7524776239,22,7412011274,-112764965
1634615715,-187057,true,7527033898,22,7406824941,-120208957
1634615817,-187060,true,7524776239,22,7403862951,-120913288
1634615951,-187065,true,7521014979,22,7410529094,-110485885
1634616021,-187065,true,7521014979,22,7414235100,-106779879
1634616046,-187061,true,7524023837,22,7416459593,-107564244
1634616195,-187063,true,7522519258,22,7428334832,-94184426
1634616258,-187065,true,7521014979,22,7435023008,-85991971
1634616441,-187067,true,7519511002,22,7437997464,-81513538
1634616454,-187065,true,7521014979,22,7440229086,-80785893
1634616538,-187069,true,7518007325,22,7442461378,-75545947
1634616679,-187073,true,7515000874,22,7435023008,-79977866
1634617450,-187075,true,7513498099,22,7390548650,-122949449
1634617487,-187074,true,7514249449,22,7394244664,-120004785
1634617611,-187080,true,7509742477,22,7392026834,-117715643
1634617760,-187084,true,7506739331,22,7391287705,-115451626
1634617865,-187087,true,7504487759,22,7389809669,-114678090
1634617892,-187087,true,7504487759,22,7388331929,-116155830
1634617913,-187092,true,7500736641,22,7388331929,-112404712
1634617933,-187096,true,7497737096,22,7388331929,-109405167
1634618034,-187098,true,7496237774,22,7387593170,-108644604
1634618093,-187096,true,7497737096,22,7389809669,-107927427
1634618170,-187100,true,7494738751,22,7391287705,-103451046
1634618295,-187103,true,7492490779,22,7393505313,-98985466
1634618384,-187106,true,7490243481,22,7392766037,-97477444
1634618405,-187105,true,7490992506,22,7393505313,-97487193
1634618482,-187110,true,7487248133,22,7396463159,-90784974
1634618488,-187113,true,7485002407,22,7396463159,-88539248
1634618607,-187115,true,7483505632,22,7396463159,-87042473
1634618934,-187112,true,7485750908,22,7426106777,-59644131
1634619186,-187117,true,7482009155,22,7430563555,-51445600
1634619215,-187120,true,7479765001,22,7431306612,-48458389
1634619398,-187122,true,7478269272,22,7435766511,-42502761
1634619495,-187119,true,7480512977,22,7440973109,-39539868
1634619619,-187124,true,7476773843,22,7438741263,-38032580
1634619680,-187127,true,7474531259,22,7437997464,-36533795
1634619724,-187130,true,7472289348,22,7435766511,-36522837
1634619789,-187127,true,7474531259,22,7432049742,-42481517
1634619840,-187134,true,7469301180,22,7424621779,-44679401
1634620150,-187140,true,7464821167,22,7398682320,-66138847
1634620182,-187143,true,7462582168,22,7396463159,-66119009
1634620249,-187141,true,7464074759,22,7391287705,-72787054
1634620288,-187147,true,7459597882,22,7389070762,-70527120
1634620318,-187153,true,7455123689,22,7386854484,-68269205
1634620556,-187157,true,7452142385,22,7367674566,-84467819
1634620569,-187155,true,7453632888,22,7366201252,-87431636
1634620686,-187160,true,7449907189,22,7359574985,-90332204
1634620901,-187164,true,7446927971,22,7386854484,-60073487
1634620958,-187165,true,7446183353,22,7393505313,-52678040
1634621110,-187163,true,7447672664,22,7411270147,-36402517
1634621168,-187167,true,7444694340,22,7413493750,-31200590
1634621228,-187170,true,7442461378,22,7421652672,-20808706
1634621282,-187173,true,7440229086,22,7423137077,-17092009
1634621326,-187173,true,7440229086,22,7423879391,-16349695
1634621445,-187178,true,7436510087,22,7427592073,-8918014
1634621448,-187184,true,7432049742,22,7427592073,-4457669
1634621466,-187186,true,7430563555,22,7428334832,-2228723
1634621494,-187186,true,7430563555,22,7429820573,-742982
1634622141,-187190,true,7427592073,22,7406824941,-20767132
1634622180,-187192,true,7426106777,22,7407565623,-18541154
1634622304,-187195,true,7423879391,22,7412011274,-11868117
1634622439,-187193,true,7425364241,22,7417201239,-8163002
1634622572,-187195,true,7423879391,22,7420168564,-3710827
1634622637,-187197,true,7422394837,22,7422394837,0
1634622825,-187198,true,7421652672,22,7429077666,7424994
1634622920,-187196,true,7423137077,22,7432792947,9655870
1634623160,-187199,true,7420910581,22,7441717206,20806625
1634623326,-187200,true,7420168564,22,7447672664,27504100
1634623459,-187199,true,7420910581,22,7451397245,30486664
1634623693,-187197,true,7422394837,22,7448417431,26022594
1634624059,-187200,true,7420168564,22,7441717206,21548642
1634624107,-187201,true,7419426622,22,7440229086,20802464
1634624467,-187204,true,7417201239,22,7398682320,-18518919
1634624507,-187202,true,7418684753,22,7394984088,-23700665
1634624700,-187207,true,7414976523,22,7378733818,-36242705
1634624730,-187209,true,7413493750,22,7375783062,-37710688
1634625320,-187211,true,7412011274,22,7353689973,-58321301
1634625384,-187210,true,7412752475,22,7353689973,-59062502
1634625422,-187215,true,7409047211,22,7352219456,-56827755
1634625485,-187217,true,7407565623,22,7349279303,-58286320
1634625557,-187220,true,7405343798,22,7347809668,-57534130
1634625625,-187219,true,7406084332,22,7347074960,-59009372
1634625637,-187219,true,7406084332,22,7347074960,-59009372
1634625658,-187221,true,7404603338,22,7347074960,-57528378
1634625784,-187222,true,7403862951,22,7352219456,-51643495
1634625851,-187219,true,7406084332,22,7355160785,-50923547
1634626011,-187221,true,7404603338,22,7348544449,-56058889
1634626066,-187221,true,7404603338,22,7347074960,-57528378
1634626167,-187223,true,7403122639,22,7347074960,-56047679
1634626179,-187223,true,7403122639,22,7346340326,-56782313
1634626318,-187227,true,7400162130,22,7339731925,-60430205
1634626792,-187229,true,7398682320,22,7317015121,-81667199
1634626954,-187231,true,7397202805,22,7333129468,-64073337
1634626968,-187231,true,7397202805,22,7333129468,-64073337
1634627044,-187235,true,7394244664,22,7336063159,-58181505
1634627294,-187234,true,7394984088,22,7355160785,-39823303
1634627611,-187235,true,7394244664,22,7380209638,-14035026
1634627684,-187235,true,7394244664,22,7386115873,-8128791
1634627825,-187237,true,7392766037,22,7382423922,-10342115
1634628665,-187235,true,7394244664,22,7395723587,1478923
1634628765,-187235,true,7394244664,22,7397202805,2958141
1634628929,-187235,true,7394244664,22,7397202805,2958141
1634629265,-187237,true,7392766037,22,7389070762,-3695275
1634629393,-187235,true,7394244664,22,7388331929,-5912735
1634629686,-187235,true,7394244664,22,7386115873,-8128791
1634629828,-187234,true,7394984088,22,7384638871,-10345217
1634630175,-187236,true,7393505313,22,7395723587,2218274
1634630179,-187234,true,7394984088,22,7395723587,739499
1634630866,-187233,true,7395723587,22,7420168564,24444977
1634630926,-187233,true,7395723587,22,7419426622,23703035
1634630940,-187235,true,7394244664,22,7419426622,25181958
1634631367,-187233,true,7395723587,22,7403122639,7399052
1634631606,-187234,true,7394984088,22,7394244664,-739424
1634631807,-187234,true,7394984088,22,7388331929,-6652159
1634631990,-187236,true,7393505313,22,7387593170,-5912143
1634632431,-187236,true,7393505313,22,7364728233,-28777080
1634632507,-187236,true,7393505313,22,7358839101,-34666212
1634632663,-187239,true,7391287705,22,7356631891,-34655814
1634632869,-187241,true,7389809669,22,7352954678,-36854991
1634632891,-187240,true,7390548650,22,7352954678,-37593972
1634633021,-187241,true,7389809669,22,7358103291,-31706378
1634633068,-187243,true,7388331929,22,7360310942,-28020987
1634633213,-187245,true,7386854484,22,7366201252,-20653232
1634633422,-187244,true,7387593170,22,7380209638,-7383532
1634633553,-187243,true,7388331929,22,7384638871,-3693058
1634633833,-187244,true,7387593170,22,7397942526,10349356
1634634501,-187245,true,7386854484,22,7403122639,16268155
1634635123,-187242,true,7389070762,22,7369148175,-19922587
1634635364,-187242,true,7389070762,22,7359574985,-29495777
1634635518,-187243,true,7388331929,22,7358839101,-29492828
1634635716,-187245,true,7386854484,22,7361783078,-25071406
1634635918,-187243,true,7388331929,22,7359574985,-28756944
1634636265,-187242,true,7389070762,22,7362519256,-26551506
1634636330,-187243,true,7388331929,22,7363255508,-25076421
1634636356,-187245,true,7386854484,22,7363255508,-23598976
1634636696,-187244,true,7387593170,22,7368411334,-19181836
1634636800,-187246,true,7386115873,22,7369885090,-16230783
1634636811,-187248,true,7384638871,22,7369885090,-14753781
1634637009,-187250,true,7383162165,22,7368411334,-14750831
1634637186,-187250,true,7383162165,22,7367674566,-15487599
1634637247,-187252,true,7381685754,22,7359574985,-22110769
1634637473,-187250,true,7383162165,22,7372096276,-11065889
1634637547,-187252,true,7381685754,22,7375783062,-5902692
1634637610,-187249,true,7383900481,22,7379471691,-4428790
1634637670,-187249,true,7383900481,22,7389809669,5909188
1634637737,-187246,true,7386115873,22,7401642237,15526364
1634637776,-187246,true,7386115873,22,7410529094,24413221
1634637873,-187242,true,7389070762,22,7429077666,40006904
1634638121,-187241,true,7389809669,22,7479017099,89207430
1634638223,-187239,true,7391287705,22,7496237774,104950069
1634638494,-187240,true,7390548650,22,7530045163,139496513
1634638540,-187236,true,7393505313,22,7533057633,139552320
1634638806,-187236,true,7393505313,22,7531551247,138045934
1634639264,-187234,true,7394984088,22,7512746825,117762737
1634639299,-187236,true,7393505313,22,7510493451,116988138
1634639400,-187233,true,7395723587,22,7505238208,109514621
1634639559,-187234,true,7394984088,22,7493989352,99005264
1634639695,-187233,true,7395723587,22,7485002407,89278820
1634639925,-187233,true,7395723587,22,7486499483,90775896
1634640022,-187230,true,7397942526,22,7486499483,88556957
1634640129,-187228,true,7399422188,22,7487248133,87825945
1634640498,-187226,true,7400902147,22,7493989352,93087205
1634640654,-187225,true,7401642237,22,7496237774,94595537
1634640739,-187222,true,7403862951,22,7487996858,84133907
1634640985,-187221,true,7404603338,22,7471542194,66938856
1634641512,-187220,true,7405343798,22,7445438809,40095011
1634641585,-187220,true,7405343798,22,7439485137,34141339
1634641725,-187216,true,7408306380,22,7432049742,23743362
1634642115,-187216,true,7408306380,22,7406084332,-2222048
1634642296,-187217,true,7407565623,22,7395723587,-11842036
1634642397,-187216,true,7408306380,22,7394244664,-14061716
1634642472,-187213,true,7410529094,22,7391287705,-19241389
1634642607,-187215,true,7409047211,22,7389809669,-19237542
1634642729,-187217,true,7407565623,22,7386115873,-21449750
1634643303,-187216,true,7408306380,22,7363991834,-44314546
1634643788,-187213,true,7410529094,22,7366937873,-43591221
1634643822,-187213,true,7410529094,22,7367674566,-42854528
1634643854,-187215,true,7409047211,22,7367674566,-41372645
1634644089,-187212,true,7411270147,22,7374308126,-36962021
1634644180,-187208,true,7414235100,22,7377258292,-36976808
1634644596,-187208,true,7414235100,22,7402382401,-11852699
1634644768,-187210,true,7412752475,22,7409047211,-3705264
1634644771,-187208,true,7414235100,22,7409047211,-5187889
1634644818,-187206,true,7415718021,22,7414235100,-1482921
1634644946,-187205,true,7416459593,22,7423879391,7419798
1634645070,-187205,true,7416459593,22,7432049742,15590149
1634645230,-187203,true,7417942959,22,7436510087,18567128
1634645370,-187203,true,7417942959,22,7440973109,23030150
1634645399,-187202,true,7418684753,22,7442461378,23776625
1634645402,-187202,true,7418684753,22,7442461378,23776625
1634645702,-187200,true,7420168564,22,7452142385,31973821
1634645838,-187199,true,7420910581,22,7451397245,30486664
1634646093,-187197,true,7422394837,22,7452887599,30492762
1634646109,-187198,true,7421652672,22,7452887599,31234927
1634646272,-187197,true,7422394837,22,7447672664,25277827
1634646686,-187196,true,7423137077,22,7437253738,14116661
1634646797,-187197,true,7422394837,22,7429820573,7425736
1634647283,-187198,true,7421652672,22,7409047211,-12605461
1634647505,-187197,true,7422394837,22,7406084332,-16310505
1634647604,-187196,true,7423137077,22,7406084332,-17052745
1634647737,-187196,true,7423137077,22,7409788115,-13348962
1634647769,-187196,true,7423137077,22,7411270147,-11866930
1634647876,-187195,true,7423879391,22,7414976523,-8902868
1634648268,-187193,true,7425364241,22,7426849388,1485147
1634648346,-187191,true,7426849388,22,7429077666,2228278
1634648365,-187191,true,7426849388,22,7429820573,2971185
1634648383,-187190,true,7427592073,22,7430563555,2971482
1634648492,-187186,true,7430563555,22,7438741263,8177708
1634648688,-187184,true,7432049742,22,7455123689,23073947
1634648820,-187186,true,7430563555,22,7448417431,17853876
1634648836,-187185,true,7431306612,22,7447672664,16366052
1634648888,-187183,true,7432792947,22,7443949945,11156998
1634648954,-187185,true,7431306612,22,7439485137,8178525
1634649099,-187187,true,7429820573,22,7432049742,2229169
1634649317,-187186,true,7430563555,22,7418684753,-11878802
1634649483,-187183,true,7432792947,22,7400162130,-32630817
1634649664,-187184,true,7432049742,22,7394984088,-37065654
1634649721,-187185,true,7431306612,22,7397202805,-34103807
1634649852,-187182,true,7433536227,22,7405343798,-28192429
1634649964,-187179,true,7435766511,22,7411270147,-24496364
1634650043,-187180,true,7435023008,22,7413493750,-21529258
1634650045,-187181,true,7434279580,22,7412752475,-21527105
1634650143,-187179,true,7435766511,22,7412752475,-23014036
1634650200,-187177,true,7437253738,22,7412752475,-24501263
1634650245,-187179,true,7435766511,22,7412011274,-23755237
1634650331,-187180,true,7435023008,22,7411270147,-23752861
1634650772,-187178,true,7436510087,22,7395723587,-40786500
1634650956,-187175,true,7438741263,22,7390548650,-48192613
1634650972,-187176,true,7437997464,22,7391287705,-46709759
1634650986,-187179,true,7435766511,22,7391287705,-44478806
1634650992,-187178,true,7436510087,22,7391287705,-45222382
1634651161,-187176,true,7437997464,22,7390548650,-47448814
1634651354,-187180,true,7435023008,22,7386854484,-48168524
1634651554,-187185,true,7431306612,22,7382423922,-48882690
1634651649,-187185,true,7431306612,22,7380209638,-51096974
1634651706,-187186,true,7430563555,22,7379471691,-51091864
1634651752,-187190,true,7427592073,22,7370622078,-56969995
1634651923,-187197,true,7422394837,22,7359574985,-62819852
1634651924,-187198,true,7421652672,22,7359574985,-62077687
1634652055,-187198,true,7421652672,22,7358103291,-63549381
1634652206,-187200,true,7420168564,22,7361783078,-58385486
1634652290,-187204,true,7417201239,22,7364728233,-52473006
1634652419,-187205,true,7416459593,22,7369148175,-47311418
1634652967,-187205,true,7416459593,22,7392766037,-23693556
1634653008,-187206,true,7415718021,22,7393505313,-22212708
1634653077,-187209,true,7413493750,22,7394244664,-19249086
1634653620,-187210,true,7412752475,22,7401642237,-11110238
1634653727,-187210,true,7412752475,22,7389809669,-22942806
1634653904,-187212,true,7411270147,22,7396463159,-14806988
1634653970,-187215,true,7409047211,22,7398682320,-10364891
1634654141,-187216,true,7408306380,22,7403122639,-5183741
1634654209,-187214,true,7409788115,22,7400902147,-8885968
1634654264,-187216,true,7408306380,22,7396463159,-11843221
1634654268,-187218,true,7406824941,22,7397202805,-9622136
1634654318,-187219,true,7406084332,22,7397942526,-8141806
1634654471,-187216,true,7408306380,22,7397942526,-10363854
1634654974,-187216,true,7408306380,22,7405343798,-2962582
1634655131,-187217,true,7407565623,22,7403862951,-3702672
1634655283,-187219,true,7406084332,22,7401642237,-4442095
1634655541,-187216,true,7408306380,22,7398682320,-9624060
1634655704,-187216,true,7408306380,22,7397942526,-10363854
1634655790,-187216,true,7408306380,22,7397202805,-11103575
1634656807,-187216,true,7408306380,22,7408306380,0
1634657334,-187212,true,7411270147,22,7439485137,28214990
1634657368,-187213,true,7410529094,22,7440973109,30444015
1634657406,-187212,true,7411270147,22,7443949945,32679798
1634657692,-187211,true,7412011274,22,7462582168,50570894
1634657851,-187207,true,7414976523,22,7464821167,49844644
1634657886,-187209,true,7413493750,22,7465567649,52073899
1634658001,-187209,true,7413493750,22,7467060837,53567087
1634658222,-187208,true,7414235100,22,7469301180,55066080
1634658246,-187204,true,7417201239,22,7472289348,55088109
1634658451,-187206,true,7415718021,22,7479765001,64046980
1634658495,-187207,true,7414976523,22,7482009155,67032632
1634658560,-187204,true,7417201239,22,7486499483,69298244
1634658577,-187201,true,7419426622,22,7487248133,67821511
1634658592,-187202,true,7418684753,22,7487996858,69312105
1634658673,-187203,true,7417942959,22,7490992506,73049547
1634658868,-187201,true,7419426622,22,7496987398,77560776
1634659090,-187198,true,7421652672,22,7502236863,80584191
1634659215,-187199,true,7420910581,22,7496987398,76076817
1634659234,-187201,true,7419426622,22,7496237774,76811152
1634659396,-187199,true,7420910581,22,7491741605,70831024
1634659631,-187195,true,7423879391,22,7488745657,64866266
1634659759,-187195,true,7423879391,22,7489494532,65615141
1634660044,-187196,true,7423137077,22,7492490779,69353702
1634660108,-187194,true,7424621779,22,7493240028,68618249
1634660375,-187190,true,7427592073,22,7495488225,67896152
1634660688,-187190,true,7427592073,22,7489494532,61902459
1634660899,-187192,true,7426106777,22,7485750908,59644131
1634661159,-187190,true,7427592073,22,7482009155,54417082
1634661165,-187187,true,7429820573,22,7482009155,52188582
1634661229,-187187,true,7429820573,22,7479017099,49196526
1634661289,-187189,true,7428334832,22,7476773843,48439011
1634661451,-187189,true,7428334832,22,7473783881,45449049
1634661597,-187187,true,7429820573,22,7470048110,40227537
1634661795,-187189,true,7428334832,22,7464821167,36486335
1634661842,-187189,true,7428334832,22,7464821167,36486335
1634661950,-187188,true,7429077666,22,7464074759,34997093
1634662106,-187185,true,7431306612,22,7464074759,32768147
1634662259,-187184,true,7432049742,22,7462582168,30532426
1634662287,-187184,true,7432049742,22,7463328427,31278685
1634662539,-187183,true,7432792947,22,7467060837,34267890
1634662540,-187181,true,7434279580,22,7467060837,32781257
1634662561,-187180,true,7435023008,22,7467060837,32037829
1634662594,-187180,true,7435023008,22,7467807543,32784535
1634662643,-187180,true,7435023008,22,7468554324,33531316
1634662873,-187175,true,7438741263,22,7485002407,46261144
1634662950,-187174,true,7439485137,22,7487996858,48511721
1634663333,-187175,true,7438741263,22,7496987398,58246135
1634663365,-187174,true,7439485137,22,7497737096,58251959
1634663416,-187170,true,7442461378,22,7496987398,54526020
1634663456,-187168,true,7443949945,22,7496237774,52287829
1634663746,-187171,true,7441717206,22,7478269272,36552066
1634664181,-187170,true,7442461378,22,7458106186,15644808
1634665230,-187167,true,7444694340,22,7417201239,-27493101
1634665286,-187166,true,7445438809,22,7416459593,-28979216
1634665351,-187169,true,7443205624,22,7416459593,-26746031
1634665429,-187169,true,7443205624,22,7416459593,-26746031
1634665739,-187168,true,7443949945,22,7393505313,-50444632
1634665870,-187167,true,7444694340,22,7384638871,-60055469
1634665958,-187170,true,7442461378,22,7379471691,-62989687
1634665966,-187170,true,7442461378,22,7379471691,-62989687
1634666140,-187167,true,7444694340,22,7378733818,-65960522
1634666313,-187164,true,7446927971,22,7375783062,-71144909
1634666519,-187165,true,7446183353,22,7388331929,-57851424
1634666651,-187166,true,7445438809,22,7386854484,-58584325
1634666836,-187164,true,7446927971,22,7389809669,-57118302
1634666956,-187163,true,7447672664,22,7385377335,-62295329
1634666998,-187167,true,7444694340,22,7383900481,-60793859
1634667349,-187166,true,7445438809,22,7383162165,-62276644
1634667695,-187164,true,7446927971,22,7394984088,-51943883
1634667742,-187163,true,7447672664,22,7394984088,-52688576
1634668064,-187167,true,7444694340,22,7385377335,-59317005
1634668103,-187167,true,7444694340,22,7383900481,-60793859
1634668335,-187165,true,7446183353,22,7375045557,-71137796
1634668597,-187166,true,7445438809,22,7355160785,-90278024
1634668663,-187171,true,7441717206,22,7346340326,-95376880
1634669205,-187170,true,7442461378,22,7347074960,-95386418
1634669338,-187170,true,7442461378,22,7343402525,-99058853
1634669390,-187169,true,7443205624,22,7343402525,-99803099
1634669413,-187174,true,7439485137,22,7343402525,-96082612
1634669531,-187174,true,7439485137,22,7344136865,-95348272
1634669566,-187176,true,7437997464,22,7346340326,-91657138
1634669811,-187175,true,7438741263,22,7335329627,-103411636
1634669922,-187179,true,7435766511,22,7330196949,-105569562
1634669962,-187179,true,7435766511,22,7327998330,-107768181
1634670539,-187181,true,7434279580,22,7314089046,-120190534
1634670656,-187180,true,7435023008,22,7311164142,-123858866
1634670727,-187185,true,7431306612,22,7312626448,-118680164
1634671081,-187184,true,7432049742,22,7326532950,-105516792
1634671718,-187185,true,7431306612,22,7354425342,-76881270
1634671862,-187185,true,7431306612,22,7356631891,-74674721
1634672076,-187189,true,7428334832,22,7359574985,-68759847
1634672107,-187191,true,7426849388,22,7359574985,-67274403
1634672153,-187192,true,7426106777,22,7360310942,-65795835
1634672468,-187192,true,7426106777,22,7354425342,-71681435
1634672680,-187197,true,7422394837,22,7348544449,-73850388
1634672871,-187199,true,7420910581,22,7346340326,-74570255
1634673079,-187200,true,7420168564,22,7338998025,-81170539
1634673462,-187201,true,7419426622,22,7336063159,-83363463
1634673720,-187208,true,7414235100,22,7298746342,-115488758
1634673852,-187213,true,7410529094,22,7279067289,-131461805
1634673988,-187215,true,7409047211,22,7264524430,-144522781
1634674094,-187219,true,7406084332,22,7252911064,-153173268
1634674193,-187226,true,7400902147,22,7240592206,-160309941
1634674403,-187229,true,7398682320,22,7224681207,-174001113
1634674583,-187231,true,7397202805,22,7231186021,-166016784
1634674620,-187235,true,7394244664,22,7231909140,-162335524
1634674645,-187241,true,7389809669,22,7232632331,-157177338
1634675015,-187243,true,7388331929,22,7249285697,-139046232
1634675038,-187245,true,7386854484,22,7252185846,-134668638
1634675245,-187248,true,7384638871,22,7273246655,-111392216
1634675333,-187254,true,7380209638,22,7280523176,-99686462
1634675381,-187254,true,7380209638,22,7281979353,-98230285
1634675646,-187258,true,7377258292,22,7273246655,-104011637
1634675762,-187263,true,7373570769,22,7268884234,-104686535
1634675809,-187270,true,7368411334,22,7267430675,-100980659
1634675874,-187270,true,7368411334,22,7265977407,-102433927
1634676209,-187273,true,7366201252,22,7239144304,-127056948
1634676545,-187275,true,7364728233,22,7270338084,-94390149
1634676746,-187281,true,7360310942,22,7287078268,-73232674
1634676912,-187281,true,7360310942,22,7292180753,-68130189
1634677071,-187282,true,7359574985,22,7303856997,-55717988
1634677456,-187286,true,7356631891,22,7279067289,-77564602
1634677505,-187293,true,7351484308,22,7273246655,-78237653
1634677553,-187293,true,7351484308,22,7274701377,-76782931
1634677974,-187293,true,7351484308,22,7298016540,-53467768
1634678393,-187294,true,7350749233,22,7337530445,-13218788
1634678797,-187301,true,7345605766,22,7336063159,-9542607
1634678882,-187301,true,7345605766,22,7335329627,-10276139
1634679020,-187301,true,7345605766,22,7327998330,-17607436
1634679067,-187304,true,7343402525,22,7325800370,-17602155
1634679314,-187312,true,7337530445,22,7306778978,-30751467
1634679453,-187313,true,7336796766,22,7297286812,-39509954
1634679540,-187317,true,7333862781,22,7289993537,-43869244
1634679584,-187319,true,7332396228,22,7285621071,-46775157
1634679838,-187327,true,7326532950,22,7271065118,-55467832
1634679849,-187327,true,7326532950,22,7270338084,-56194866
1634680050,-187329,true,7325067863,22,7280523176,-44544687
1634680501,-187329,true,7325067863,22,7312626448,-12441415
1634680534,-187336,true,7319942366,22,7308971231,-10971135
1634681156,-187335,true,7320674360,22,7330196949,9522589
1634681254,-187335,true,7320674360,22,7337530445,16856085
1634681350,-187335,true,7320674360,22,7343402525,22728165
1634681405,-187340,true,7317015121,22,7346340326,29325205
1634681557,-187338,true,7318478597,22,7354425342,35946745
1634681688,-187335,true,7320674360,22,7356631891,35957531
1634681705,-187336,true,7319942366,22,7354425342,34482976
1634681779,-187342,true,7315551937,22,7347074960,31523023
1634681998,-187342,true,7315551937,22,7326532950,10981013
1634682261,-187343,true,7314820455,22,7293639263,-21181192
1634682299,-187344,true,7314089046,22,7289264610,-24824436
1634682399,-187351,true,7308971231,22,7279795196,-29176035
1634682585,-187350,true,7309702128,22,7260167240,-49534888
1634682847,-187351,true,7308971231,22,7263071743,-45899488
1634683262,-187351,true,7308971231,22,7263798050,-45173181
1634683345,-187357,true,7304587383,22,7263071743,-41515640
1634683644,-187357,true,7304587383,22,7292180753,-12406630
1634684000,-187356,true,7305317842,22,7317015121,11697279
1634684207,-187356,true,7305317842,22,7321406428,16088586
1634684287,-187361,true,7301666278,22,7320674360,19008082
1634684487,-187361,true,7301666278,22,7306778978,5112700
1634684562,-187361,true,7301666278,22,7302396445,730167
1634684647,-187361,true,7301666278,22,7298016540,-3649738
1634684655,-187365,true,7298746342,22,7297286812,-1459530
1634684958,-187365,true,7298746342,22,7285621071,-13125271
1634685019,-187365,true,7298746342,22,7286349633,-12396709
1634685266,-187365,true,7298746342,22,7284164165,-14582177
1634685416,-187369,true,7295827573,22,7287806976,-8020597
1634685661,-187366,true,7298016540,22,7295098063,-2918477
1634685784,-187365,true,7298746342,22,7312626448,13880106
1634685844,-187364,true,7299476217,22,7312626448,13150231
1634685905,-187368,true,7296557156,22,7312626448,16069292
1634685957,-187365,true,7298746342,22,7313357711,14611369
1634686071,-187366,true,7298016540,22,7317015121,18998581
1634686224,-187364,true,7299476217,22,7319942366,20466149
1634686249,-187369,true,7295827573,22,7318478597,22651024
1634686255,-187366,true,7298016540,22,7319210445,21193905
1634686295,-187369,true,7295827573,22,7317746822,21919249
1634686528,-187370,true,7295098063,22,7302396445,7298382
1634686681,-187375,true,7291451608,22,7281251228,-10200380
1634686769,-187371,true,7294368626,22,7290722536,-3646090
1634686954,-187374,true,7292180753,22,7287806976,-4373777
1634687098,-187374,true,7292180753,22,7280523176,-11657577
1634687130,-187378,true,7289264610,22,7277611694,-11652916
1634687202,-187376,true,7290722536,22,7277611694,-13110842
1634687287,-187378,true,7289264610,22,7281251228,-8013382
1634687421,-187378,true,7289264610,22,7287078268,-2186342
1634687516,-187379,true,7288535757,22,7286349633,-2186124
1634687625,-187376,true,7290722536,22,7282707551,-8014985
1634687665,-187377,true,7289993537,22,7277611694,-12381843
1634687720,-187374,true,7292180753,22,7276156390,-16024363
1634687869,-187375,true,7291451608,22,7276156390,-15295218
1634687953,-187373,true,7292909972,22,7277611694,-15298278
1634688234,-187375,true,7291451608,22,7279067289,-12384319
1634688742,-187372,true,7293639263,22,7274701377,-18937886
1634688909,-187374,true,7292180753,22,7255812664,-36368089
1634689077,-187373,true,7292909972,22,7238420462,-54489510
1634689391,-187377,true,7289993537,22,7208084363,-81909174
1634689417,-187378,true,7289264610,22,7205922371,-83342239
1634689477,-187381,true,7287078268,22,7200160226,-86918042
1634689555,-187382,true,7286349633,22,7193683321,-92666312
1634689866,-187382,true,7286349633,22,7190087558,-96262075
1634689875,-187381,true,7287078268,22,7190087558,-96990710
1634690166,-187383,true,7285621071,22,7198720410,-86900661
1634690364,-187383,true,7285621071,22,7206642963,-78978108
1634690388,-187384,true,7284892582,22,7207363627,-77528955
1634690511,-187385,true,7284164165,22,7214574235,-69589930
1634690588,-187386,true,7283435822,22,7218904062,-64531760
1634690623,-187385,true,7284164165,22,7221069950,-63094215
1634691047,-187387,true,7282707551,22,7243488877,-39218674
1634691133,-187386,true,7283435822,22,7247111346,-36324476
1634691258,-187387,true,7282707551,22,7251460700,-31246851
1634691470,-187387,true,7282707551,22,7250735626,-31971925
1634691619,-187391,true,7279795196,22,7241316265,-38478931
1634691787,-187393,true,7278339455,22,7230462975,-47876480
1634692077,-187395,true,7276884006,22,7213852850,-63031156
1634692238,-187395,true,7276884006,22,7210968030,-65915976
1634692278,-187399,true,7273973980,22,7209526052,-64447928
1634692331,-187400,true,7273246655,22,7208805172,-64441483
1634692446,-187399,true,7273973980,22,7209526052,-64447928
1634692637,-187398,true,7274701377,22,7217460498,-57240879
1634693129,-187403,true,7271065118,22,7199440282,-71624836
1634693271,-187405,true,7269611123,22,7194402689,-75208434
1634693456,-187404,true,7270338084,22,7185056509,-85281575
1634693518,-187403,true,7271065118,22,7182183205,-88881913
1634693780,-187410,true,7265977407,22,7182901423,-83075984
1634693802,-187413,true,7263798050,22,7182901423,-80896627
1634693813,-187412,true,7264524430,22,7182901423,-81623007
1634693991,-187413,true,7263798050,22,7180746984,-83051066
1634694030,-187420,true,7258715425,22,7180746984,-77968441
1634694043,-187424,true,7255812664,22,7180746984,-75065680
1634694314,-187423,true,7256538245,22,7177875403,-78662842
1634694357,-187425,true,7255087155,22,7177157687,-77929468
1634694526,-187432,true,7250010625,22,7177875403,-72135222
1634694875,-187434,true,7248560841,22,7179311050,-69249791
1634694920,-187433,true,7249285697,22,7180028981,-69256716
1634694949,-187432,true,7250010625,22,7180746984,-69263641
1634695128,-187436,true,7247111346,22,7191525647,-55585699
1634695183,-187438,true,7245662141,22,7190806567,-54855574
1634695235,-187436,true,7247111346,22,7189368621,-57742725
1634695238,-187435,true,7247836057,22,7188649756,-59186301
1634695418,-187440,true,7244213226,22,7196561226,-47652000
1634695742,-187441,true,7243488877,22,7211689127,-31799750
1634695776,-187439,true,7244937647,22,7213131537,-31806110
1634695923,-187439,true,7244937647,22,7216738824,-28198823
1634695947,-187445,true,7240592206,22,7216738824,-23853382
1634695972,-187446,true,7239868219,22,7216738824,-23129395
1634696001,-187445,true,7240592206,22,7216017222,-24574984
1634696036,-187445,true,7240592206,22,7215295692,-25296514
1634696068,-187450,true,7236972995,22,7217460498,-19512497
1634696147,-187451,true,7236249370,22,7221792057,-14457313
1634696438,-187450,true,7236972995,22,7216017222,-20955773
1634696603,-187450,true,7236972995,22,7213131537,-23841458
1634696642,-187455,true,7233355594,22,7211689127,-21666467
1634696672,-187456,true,7232632331,22,7210247005,-22385326
1634696770,-187456,true,7232632331,22,7204481402,-28150929
1634696929,-187457,true,7231909140,22,7196561226,-35347914
1634696974,-187463,true,7227571513,22,7195122129,-32449384
1634697120,-187465,true,7226126215,22,7193683321,-32442894
1634697228,-187465,true,7226126215,22,7192964024,-33162191
1634697260,-187467,true,7224681207,22,7192244800,-32436407
1634697386,-187469,true,7223236487,22,7194402689,-28833798
1634697415,-187471,true,7221792057,22,7193683321,-28108736
1634697694,-187473,true,7220347915,22,7183619713,-36728202
1634697939,-187475,true,7218904062,22,7179311050,-39593012
1634697947,-187478,true,7216738824,22,7179311050,-37427774
1634697965,-187477,true,7217460498,22,7180028981,-37431517
1634698002,-187478,true,7216738824,22,7180746984,-35991840
1634698411,-187480,true,7215295692,22,7184338075,-30957617
1634698557,-187483,true,7213131537,22,7194402689,-18728848
1634698595,-187483,true,7213131537,22,7195841641,-17289896
1634698614,-187483,true,7213131537,22,7196561226,-16570311
1634698776,-187484,true,7212410295,22,7200160226,-12250069
1634698803,-187488,true,7209526052,22,7197280882,-12245170
1634698873,-187489,true,7208805172,22,7198000610,-10804562
1634698880,-187490,true,7208084363,22,7198000610,-10083753
1634698956,-187491,true,7207363627,22,7195841641,-11521986
1634699044,-187494,true,7205201850,22,7196561226,-8640624
1634699247,-187494,true,7205201850,22,7194402689,-10799161
1634699349,-187495,true,7204481402,22,7191525647,-12955755
1634699377,-187497,true,7203040722,22,7187930963,-15109759
1634699459,-187500,true,7200880242,22,7179311050,-21569192
1634699810,-187502,true,7199440282,22,7167833910,-31606372
1634699922,-187502,true,7199440282,22,7162818433,-36621849
1634699994,-187503,true,7198720410,22,7159954021,-38766389
1634700033,-187505,true,7197280882,22,7159238098,-38042784
1634700256,-187503,true,7198720410,22,7152798004,-45922406
1634700402,-187504,true,7198000610,22,7158522245,-39478365
1634700445,-187504,true,7198000610,22,7158522245,-39478365
1634700503,-187507,true,7195841641,22,7158522245,-37319396
1634700545,-187506,true,7196561226,22,7157806465,-38754761
1634700565,-187507,true,7195841641,22,7158522245,-37319396
1634700611,-187508,true,7195122129,22,7157806465,-37315664
1634700648,-187511,true,7192964024,22,7157090756,-35873268
1634700899,-187510,true,7193683321,22,7155659552,-38023769
1634701032,-187513,true,7191525647,22,7152082796,-39442851
1634701058,-187515,true,7190087558,22,7151367659,-38719899
1634701102,-187518,true,7187930963,22,7149937600,-37993363
1634701176,-187518,true,7187930963,22,7148507827,-39423136
1634701218,-187519,true,7187212242,22,7152082796,-35129446
1634701269,-187519,true,7187212242,22,7156375118,-30837124
1634701452,-187518,true,7187930963,22,7177157687,-10773276
1634701540,-187516,true,7189368621,22,7184338075,-5030546
1634701554,-187517,true,7188649756,22,7185775015,-2874741
1634701641,-187517,true,7188649756,22,7192244800,3595044
1634701764,-187517,true,7188649756,22,7202320490,13670734
1634701780,-187515,true,7190087558,22,7203761026,13673468
1634701843,-187516,true,7189368621,22,7210247005,20878384
1634702301,-187517,true,7188649756,22,7221069950,32420194
1634702326,-187516,true,7189368621,22,7220347915,30979294
1634702335,-187514,true,7190806567,22,7219625952,28819385
1634702468,-187515,true,7190087558,22,7217460498,27372940
1634702684,-187516,true,7189368621,22,7211689127,22320506
1634702847,-187515,true,7190087558,22,7210247005,20159447
1634702938,-187512,true,7192244800,22,7210247005,18002205
1634703262,-187512,true,7192244800,22,7223958811,31714011
1634703665,-187512,true,7192244800,22,7238420462,46175662
1634703863,-187511,true,7192964024,22,7223236487,30272463
1634703972,-187509,true,7194402689,22,7211689127,17286438
1634704095,-187511,true,7192964024,22,7198000610,5036586
1634704392,-187513,true,7191525647,22,7169267548,-22258099
1634704554,-187513,true,7191525647,22,7151367659,-40157988
1634704580,-187511,true,7192964024,22,7152082796,-40881228
1634704762,-187512,true,7192244800,22,7164967493,-27277307
1634704917,-187514,true,7190806567,22,7169984475,-20822092
1634704969,-187513,true,7191525647,22,7171418544,-20107103
1634705077,-187512,true,7192244800,22,7174287542,-17957258
1634705217,-187513,true,7191525647,22,7178593190,-12932457
1634705270,-187515,true,7190087558,22,7179311050,-10776508
1634705325,-187514,true,7190806567,22,7181465058,-9341509
1634705655,-187514,true,7190806567,22,7180028981,-10777586
1634705695,-187515,true,7190087558,22,7182901423,-7186135
1634705800,-187516,true,7189368621,22,7191525647,2157026
1634705984,-187516,true,7189368621,22,7192244800,2876179
1634706025,-187516,true,7189368621,22,7191525647,2157026
1634706689,-187514,true,7190806567,22,7244213226,53406659
1634706770,-187515,true,7190087558,22,7250010625,59923067
1634707546,-187513,true,7191525647,22,7250010625,58484978
1634707639,-187513,true,7191525647,22,7247111346,55585699
1634707712,-187512,true,7192244800,22,7245662141,53417341
1634707825,-187512,true,7192244800,22,7238420462,46175662
1634708126,-187513,true,7191525647,22,7221792057,30266410
1634708379,-187513,true,7191525647,22,7200880242,9354595
1634708430,-187512,true,7192244800,22,7197280882,5036082
1634708659,-187511,true,7192964024,22,7205201850,12237826
1634709160,-187510,true,7193683321,22,7240592206,46908885
1634709229,-187509,true,7194402689,22,7247836057,53433368
1634709354,-187508,true,7195122129,22,7256538245,61416116
1634709478,-187507,true,7195841641,22,7256538245,60696604
1634709602,-187506,true,7196561226,22,7257263899,60702673
1634709674,-187506,true,7196561226,22,7255087155,58525929
1634709771,-187503,true,7198720410,22,7252911064,54190654
1634709982,-187503,true,7198720410,22,7244937647,46217237
1634710081,-187502,true,7199440282,22,7245662141,46221859
1634710358,-187501,true,7200160226,22,7246386707,46226481
1634710396,-187499,true,7201600330,22,7246386707,44786377
1634710422,-187499,true,7201600330,22,7246386707,44786377
1634710492,-187499,true,7201600330,22,7245662141,44061811
1634710612,-187498,true,7202320490,22,7248560841,46240351
1634711026,-187496,true,7203761026,22,7256538245,52777219
1634711172,-187496,true,7203761026,22,7255812664,52051638
1634711211,-187494,true,7205201850,22,7255812664,50610814
1634711780,-187493,true,7205922371,22,7258715425,52793054
1634711803,-187491,true,7207363627,22,7259441296,52077669
1634711986,-187491,true,7207363627,22,7259441296,52077669
1634712667,-187490,true,7208084363,22,7259441296,51356933
1634712785,-187489,true,7208805172,22,7259441296,50636124
1634713546,-187486,true,7210968030,22,7262345508,51377478
1634713618,-187486,true,7210968030,22,7262345508,51377478
1634713636,-187484,true,7212410295,22,7260167240,47756945
1634713700,-187482,true,7213852850,22,7260893257,47040407
1634713829,-187479,true,7216017222,22,7261619346,45602124
1634713853,-187479,true,7216017222,22,7261619346,45602124
1634713896,-187477,true,7217460498,22,7262345508,44885010
1634713920,-187475,true,7218904062,22,7262345508,43441446
1634714183,-187473,true,7220347915,22,7262345508,41997593
1634714372,-187474,true,7219625952,22,7247111346,27485394
1634714834,-187471,true,7221792057,22,7247111346,25319289
1634714891,-187470,true,7222514236,22,7244937647,22423411
1634715011,-187467,true,7224681207,22,7241316265,16635058
1634715035,-187468,true,7223958811,22,7238420462,14461651
1634715239,-187466,true,7225403675,22,7244937647,19533972
1634715343,-187465,true,7226126215,22,7244213226,18087011
1634715374,-187462,true,7228294270,22,7242764600,14470330
1634715461,-187462,true,7228294270,22,7239868219,11573949
1634715741,-187461,true,7229017099,22,7231909140,2892041
1634716143,-187459,true,7230462975,22,7233355594,2892619
1634716294,-187457,true,7231909140,22,7234802338,2893198
1634716325,-187459,true,7230462975,22,7235525818,5062843
1634716376,-187460,true,7229740001,22,7235525818,5785817
1634716470,-187459,true,7230462975,22,7237696693,7233718
1634716613,-187457,true,7231909140,22,7240592206,8683066
1634716676,-187458,true,7231186021,22,7241316265,10130244
1634716836,-187458,true,7231186021,22,7244213226,13027205
1634717007,-187457,true,7231909140,22,7244937647,13028507
1634717098,-187456,true,7232632331,22,7244937647,12305316
1634717146,-187457,true,7231909140,22,7244937647,13028507
1634717335,-187457,true,7231909140,22,7240592206,8683066
1634717679,-187457,true,7231909140,22,7223958811,-7950329
1634718014,-187456,true,7232632331,22,7206642963,-25989368
1634718050,-187457,true,7231909140,22,7205201850,-26707290
1634718235,-187458,true,7231186021,22,7202320490,-28865531
1634718453,-187458,true,7231186021,22,7198000610,-33185411
1634718473,-187458,true,7231186021,22,7196561226,-34624795
1634718512,-187459,true,7230462975,22,7195841641,-34621334
1634718611,-187460,true,7229740001,22,7193683321,-36056680
1634718631,-187460,true,7229740001,22,7195122129,-34617872
1634718650,-187458,true,7231186021,22,7196561226,-34624795
1634719062,-187458,true,7231186021,22,7184338075,-46847946
1634719185,-187458,true,7231186021,22,7181465058,-49720963
1634719537,-187458,true,7231186021,22,7175004970,-56181051
1634719574,-187457,true,7231909140,22,7174287542,-57621598
1634719665,-187458,true,7231186021,22,7175004970,-56181051
1634719791,-187459,true,7230462975,22,7176440043,-54022932
1634719862,-187459,true,7230462975,22,7176440043,-54022932
1634719980,-187458,true,7231186021,22,7177157687,-54028334
1634720418,-187458,true,7231186021,22,7177875403,-53310618
1634720863,-187459,true,7230462975,22,7182183205,-48279770
1634721108,-187459,true,7230462975,22,7190806567,-39656408
1634721229,-187457,true,7231909140,22,7195122129,-36787011
1634721256,-187458,true,7231186021,22,7196561226,-34624795
1634721257,-187458,true,7231186021,22,7196561226,-34624795
1634721352,-187457,true,7231909140,22,7203761026,-28148114
1634721366,-187457,true,7231909140,22,7205201850,-26707290
1634721526,-187458,true,7231186021,22,7216738824,-14447197
1634721614,-187459,true,7230462975,22,7223236487,-7226488
1634721684,-187459,true,7230462975,22,7218904062,-11558913
1634721747,-187459,true,7230462975,22,7219625952,-10837023
1634721771,-187461,true,7229017099,22,7219625952,-9391147
1634721865,-187461,true,7229017099,22,7216017222,-12999877
1634721913,-187460,true,7229740001,22,7213852850,-15887151
1634721949,-187460,true,7229740001,22,7211689127,-18050874
1634722096,-187463,true,7227571513,22,7203040722,-24530791
1634722175,-187464,true,7226848828,22,7203761026,-23087802
1634722423,-187463,true,7227571513,22,7198000610,-29570903
1634722586,-187462,true,7228294270,22,7204481402,-23812868
1634722747,-187465,true,7226126215,22,7211689127,-14437088
1634722935,-187467,true,7224681207,22,7218182244,-6498963
1634723032,-187466,true,7225403675,22,7208084363,-17319312
1634723071,-187467,true,7224681207,22,7202320490,-22360717
1634723320,-187471,true,7221792057,22,7170701474,-51090583
1634723376,-187474,true,7219625952,22,7163534714,-56091238
1634723509,-187475,true,7218904062,22,7148507827,-70396235
1634723716,-187475,true,7218904062,22,7128520999,-90383063
1634723925,-187479,true,7216017222,22,7131372835,-84644387
1634724029,-187481,true,7214574235,22,7137793638,-76780597
1634724425,-187481,true,7214574235,22,7158522245,-56051990
1634724459,-187480,true,7215295692,22,7159954021,-55341671
1634724508,-187484,true,7212410295,22,7159238098,-53172197
1634724622,-187488,true,7209526052,22,7159238098,-50287954
1634724679,-187488,true,7209526052,22,7157090756,-52435296
1634724818,-187488,true,7209526052,22,7153513284,-56012768
1634724909,-187492,true,7206642963,22,7149937600,-56705363
1634725185,-187495,true,7204481402,22,7142077385,-62404017
1634725350,-187496,true,7203761026,22,7137079930,-66681096
1634725474,-187496,true,7203761026,22,7139221268,-64539758
1634725690,-187500,true,7200880242,22,7142077385,-58802857
1634725772,-187503,true,7198720410,22,7143505872,-55214538
1634725776,-187503,true,7198720410,22,7143505872,-55214538
1634725867,-187503,true,7198720410,22,7146363703,-52356707
1634725873,-187506,true,7196561226,22,7146363703,-50197523
1634726103,-187510,true,7193683321,22,7146363703,-47319618
1634726115,-187511,true,7192964024,22,7147078340,-45885684
1634726286,-187509,true,7194402689,22,7158522245,-35880444
1634726406,-187510,true,7193683321,22,7166400558,-27282763
1634726474,-187513,true,7191525647,22,7170701474,-20824173
1634726566,-187513,true,7191525647,22,7175004970,-16520677
1634726749,-187512,true,7192244800,22,7182901423,-9343377
1634726827,-187514,true,7190806567,22,7185775015,-5031552
1634726839,-187516,true,7189368621,22,7186493592,-2875029
1634727011,-187516,true,7189368621,22,7198000610,8631989
1634727016,-187514,true,7190806567,22,7197280882,6474315
1634727032,-187516,true,7189368621,22,7196561226,7192605
1634727106,-187518,true,7187930963,22,7195122129,7191166
1634727195,-187519,true,7187212242,22,7194402689,7190447
1634727486,-187517,true,7188649756,22,7187930963,-718793
1634727692,-187519,true,7187212242,22,7185775015,-1437227
1634727725,-187521,true,7185775015,22,7185056509,-718506
1634727842,-187523,true,7184338075,22,7181465058,-2873017
1634728041,-187522,true,7185056509,22,7175722471,-9334038
1634728239,-187525,true,7182901423,22,7169267548,-13633875
1634728492,-187527,true,7181465058,22,7160670017,-20795041
1634729122,-187527,true,7181465058,22,7178593190,-2871868
1634729407,-187526,true,7182183205,22,7184338075,2154870
1634729550,-187529,true,7180028981,22,7180746984,718003
1634729885,-187531,true,7178593190,22,7172135686,-6457504
1634729994,-187531,true,7178593190,22,7169984475,-8608715
1634730117,-187529,true,7180028981,22,7169984475,-10044506
1634730479,-187532,true,7177875403,22,7160670017,-17205386
1634730508,-187534,true,7176440043,22,7159238098,-17201945
1634730966,-187534,true,7176440043,22,7144220223,-32219820
1634731274,-187532,true,7177875403,22,7142077385,-35798018
1634731856,-187535,true,7175722471,22,7137793638,-37928833
1634731944,-187537,true,7174287542,22,7138507418,-35780124
1634732083,-187537,true,7174287542,22,7137079930,-37207612
1634732380,-187537,true,7174287542,22,7129233851,-45053691
1634732554,-187539,true,7172852899,22,7127095508,-45757391
1634732649,-187540,true,7172135686,22,7125670303,-46465383
1634732775,-187541,true,7171418544,22,7123533029,-47885515
1634732817,-187540,true,7172135686,22,7122108536,-50027150
1634732978,-187542,true,7170701474,22,7119972331,-50729143
1634732990,-187544,true,7169267548,22,7120684328,-48583220
1634733195,-187543,true,7169984475,22,7127808218,-42176257
1634733408,-187542,true,7170701474,22,7134225812,-36475662
1634733448,-187544,true,7169267548,22,7134939234,-34328314
1634733948,-187546,true,7167833910,22,7144934645,-22899265
1634734030,-187546,true,7167833910,22,7143505872,-24328038
1634734218,-187545,true,7168550693,22,7141363249,-27187444
1634734402,-187548,true,7166400558,22,7142077385,-24323173
1634734435,-187551,true,7164251068,22,7142077385,-22173683
1634734496,-187552,true,7163534714,22,7141363249,-22171465
1634734779,-187552,true,7163534714,22,7137079930,-26454784
1634735054,-187556,true,7160670017,22,7133512461,-27157556
1634735589,-187560,true,7157806465,22,7095806738,-61999727
1634735662,-187559,true,7158522245,22,7091550744,-66971501
1634735764,-187560,true,7157806465,22,7085880055,-71926410
1634735793,-187563,true,7155659552,22,7085171538,-70488014
1634736050,-187565,true,7154228635,22,7080921923,-73306712
1634736216,-187565,true,7154228635,22,7088006032,-66222603
1634736308,-187565,true,7154228635,22,7090841660,-63386975
1634736565,-187567,true,7152798004,22,7097225971,-55572033
1634736679,-187570,true,7150652593,22,7099355351,-51297242
1634736896,-187571,true,7149937600,22,7105036824,-44900776
1634736914,-187572,true,7149222677,22,7105747327,-43475350
1634736973,-187576,true,7146363703,22,7103616030,-42747673
1634737219,-187579,true,7144220223,22,7092259899,-51960324
1634737226,-187579,true,7144220223,22,7092259899,-51960324
1634737919,-187579,true,7144220223,22,7071723165,-72497058
1634738031,-187580,true,7143505872,22,7065361795,-78144077
1634738140,-187582,true,7142077385,22,7059006148,-83071237
1634738284,-187584,true,7140649184,22,7049835860,-90813324
1634739317,-187588,true,7137793638,22,6974808480,-162985158
1634739342,-187590,true,7136366294,22,6974111069,-162255225
1634739373,-187593,true,7134225812,22,6974111069,-160114743
1634739467,-187595,true,7132799181,22,6974111069,-158688112
1634739763,-187600,true,7129233851,22,6973413728,-155820123
1634740033,-187605,true,7125670303,22,6946271732,-179398571
1634740221,-187608,true,7123533029,22,6928235785,-195297244
1634740402,-187610,true,7122108536,22,6907483259,-214625277
1634740475,-187617,true,7117125054,22,6899889585,-217235469
1634740633,-187622,true,7113567559,22,6877846328,-235721231
1634740872,-187626,true,7110722843,22,6864791479,-245931364
1634741117,-187629,true,7108590053,22,6856559081,-252030972
1634741916,-187636,true,7103616030,22,6843544637,-260071393
1634741942,-187641,true,7100065287,22,6842176133,-257889154
1634742285,-187646,true,7096516319,22,6832604267,-263912052
1634742328,-187649,true,7094387790,22,6836021253,-258366537
1634742513,-187656,true,7089423704,22,6839439947,-249983757
1634742728,-187662,true,7085171538,22,6839439947,-245731591
1634743012,-187667,true,7081630015,22,6825775420,-255854595
1634743189,-187671,true,7078798071,22,6818953397,-259844674
1634743451,-187680,true,7072430337,22,6799208064,-273222273
1634743872,-187685,true,7068895183,22,6827823357,-241071826
1634743932,-187691,true,7064655330,22,6833287528,-231367802
1634743946,-187694,true,7062536357,22,6833970857,-228565500
1634744237,-187702,true,7056888869,22,6847651791,-209237078
1634744546,-187708,true,7052656218,22,6841491984,-211164234
1634744572,-187714,true,7048426104,22,6842176133,-206249971
1634745211,-187718,true,7045607439,22,6814182038,-231425401
1634745525,-187727,true,7039269561,22,6797848426,-241421135
1634746113,-187734,true,7034344043,22,6799208064,-235135979
1634746237,-187740,true,7030124914,22,6793091835,-237033079
1634746579,-187745,true,7026610905,22,6768005089,-258605816
1634746732,-187754,true,7020290116,22,6753807900,-266482216
1634747312,-187764,true,7013273686,22,6726847972,-286425714
1634747416,-187769,true,7009768101,22,6728193409,-281574692
1634747575,-187774,true,7006264268,22,6732231335,-274032933
1634747600,-187783,true,6999961782,22,6732904558,-267057224
1634747728,-187791,true,6994364331,22,6735598123,-258766208
1634747746,-187796,true,6990868198,22,6735598123,-255270075
1634747881,-187802,true,6986675145,22,6739640493,-247034652
1634747914,-187811,true,6980390280,22,6740314457,-240075823
1634747955,-187819,true,6974808480,22,6740314457,-234494023
1634748144,-187825,true,6970625059,22,6740988488,-229636571
1634748432,-187831,true,6966444148,22,6734251206,-232192942
1634748577,-187840,true,6960177482,22,6730212069,-229965413
1634748806,-187846,true,6956002836,22,6745034093,-210968743
1634748921,-187851,true,6952525878,22,6755834245,-196691633
1634749263,-187854,true,6950440538,22,6791054315,-159386223
1634749347,-187862,true,6944882686,22,6799887985,-144994701
1634749543,-187866,true,6942105428,22,6833970857,-108134571
1634749654,-187869,true,6940023213,22,6857244737,-82778476
1634749823,-187866,true,6942105428,22,6892304258,-49801170
1634749852,-187873,true,6937247897,22,6897130319,-40117578
1634749883,-187874,true,6936554242,22,6903340219,-33214023
1634750187,-187878,true,6933780313,22,6949745563,15965250
1634750869,-187879,true,6933087005,22,6922695689,-10391316
1634750891,-187885,true,6928928608,22,6917851740,-11076868
1634751327,-187888,true,6926850345,22,6901269631,-25580714
1634751532,-187892,true,6924080298,22,6907483259,-16597039
1634752101,-187893,true,6923387959,22,6928928608,5540649
1634752108,-187900,true,6918543525,22,6928928608,10385083
1634752276,-187903,true,6916468377,22,6909555711,-6912666
1634752434,-187909,true,6912319948,22,6886792895,-25527053
1634752569,-187913,true,6909555711,22,6884727270,-24828441
1634752661,-187919,true,6905411429,22,6879909888,-25501541
1634752725,-187921,true,6904030553,22,6875095877,-28934676
1634752930,-187924,true,6901959758,22,6870285234,-31674524
1634753077,-187929,true,6898509814,22,6872346526,-26163288
1634753266,-187934,true,6895061593,22,6890236980,-4824613
1634753610,-187936,true,6893682788,22,6887481574,-6201214
1634753842,-187939,true,6891615096,22,6882662265,-8952831
1634753854,-187943,true,6888859139,22,6882662265,-6196874
1634753906,-187948,true,6885415743,22,6883350531,-2065212
1634753953,-187948,true,6885415743,22,6884038866,-1376877
1634754130,-187950,true,6884038866,22,6888170322,4131456
1634754165,-187955,true,6880597879,22,6888859139,8261260
1634754272,-187960,true,6877158612,22,6892993488,15834876
1634754437,-187961,true,6876470965,22,6899889585,23418620
1634754472,-187963,true,6875095877,22,6901959758,26863881
1634754656,-187967,true,6872346526,22,6911628785,39282259
1634754850,-187972,true,6868911384,22,6920619296,51707912
1634755076,-187972,true,6868911384,22,6926157729,57246345
1634755173,-187973,true,6868224561,22,6927543030,59318469
1634755189,-187976,true,6866164506,22,6927543030,61378524
1634755324,-187982,true,6862046249,22,6928235785,66189536
1634755391,-187982,true,6862046249,22,6926157729,64111480
1634755467,-187983,true,6861360113,22,6923387959,62027846
1634755492,-187986,true,6859302116,22,6922695689,63393573
1634755531,-187987,true,6858616254,22,6921311358,62695104
1634755675,-187988,true,6857930461,22,6914393852,56463391
1634755715,-187989,true,6857244737,22,6913011180,55766443
1634756039,-187994,true,6853817143,22,6875783387,21966244
1634756625,-187993,true,6854502525,22,6890236980,35734455
1634756722,-187990,true,6856559081,22,6900579574,44020493
1634756804,-187991,true,6855873494,22,6906101970,50228476
1634756830,-187993,true,6854502525,22,6908174007,53671482
1634756932,-187991,true,6855873494,22,6914393852,58520358
1634756945,-187989,true,6857244737,22,6914393852,57149115
1634757000,-187987,true,6858616254,22,6918543525,59927271
1634757119,-187989,true,6857244737,22,6915085291,57840554
1634757328,-187987,true,6858616254,22,6910246667,51630413
1634757719,-187985,true,6859988046,22,6906792580,46804534
1634757911,-187983,true,6861360113,22,6904720956,43360843
1634757968,-187985,true,6859988046,22,6905411429,45423383
1634758536,-187981,true,6862732453,22,6938635416,75902963
1634758804,-187978,true,6864791479,22,6946966360,82174881
1634758827,-187974,true,6867537807,22,6949745563,82207756
1634758867,-187976,true,6866164506,22,6948355822,82191316
1634759585,-187973,true,6868224561,22,6924080298,55855737
1634759662,-187971,true,6869598275,22,6924080298,54482023
1634761620,-187972,true,6868911384,22,6847651791,-21259593
1634761862,-187974,true,6867537807,22,6849706292,-17831515
1634762508,-187973,true,6868224561,22,6861360113,-6864448
1634762549,-187970,true,6870285234,22,6861360113,-8925121
1634763112,-187970,true,6870285234,22,6864791479,-5493755
1634763174,-187971,true,6869598275,22,6865477958,-4120317
1634763184,-187969,true,6870972263,22,6865477958,-5494305
1634763268,-187966,true,6873033761,22,6868911384,-4122377
1634763279,-187964,true,6874408436,22,6869598275,-4810161
1634763348,-187963,true,6875095877,22,6870972263,-4123614
1634763500,-187961,true,6876470965,22,6873721064,-2749901
1634763712,-187956,true,6879909888,22,6875783387,-4126501
1634763911,-187954,true,6881285939,22,6877846328,-3439611
1634763919,-187954,true,6881285939,22,6878534113,-2751826
1634763940,-187951,true,6883350531,22,6878534113,-4816418
1634764002,-187947,true,6886104285,22,6877846328,-8257957
1634764103,-187949,true,6884727270,22,6866164506,-18562764
1634764540,-187951,true,6883350531,22,6813500688,-69849843
1634764724,-187949,true,6884727270,22,6795129966,-89597304
1634764789,-187945,true,6887481574,22,6789017406,-98464168
1634765194,-187946,true,6886792895,22,6788338572,-98454323
1634765292,-187947,true,6886104285,22,6790375277,-95729008
1634765327,-187944,true,6888170322,22,6791733420,-96436902
1634765855,-187942,true,6889548025,22,6796489060,-93058965
1634765871,-187944,true,6888170322,22,6795809479,-92360843
1634765978,-187946,true,6886792895,22,6801248030,-85544865
1634766013,-187945,true,6887481574,22,6802608348,-84873226
1634766247,-187941,true,6890236980,22,6816226497,-74010483
1634766489,-187945,true,6887481574,22,6831237951,-56243623
1634766521,-187952,true,6882662265,22,6833287528,-49374737
1634766816,-187952,true,6882662265,22,6851076301,-31585964
1634766961,-187951,true,6883350531,22,6851761409,-31589122
1634767185,-187953,true,6881974068,22,6850391262,-31582806
1634767249,-187957,true,6879221966,22,6852446585,-26775381
1634767574,-187956,true,6879909888,22,6864791479,-15118409
1634767598,-187953,true,6881974068,22,6865477958,-16496110
1634767642,-187955,true,6880597879,22,6865477958,-15119921
1634767889,-187961,true,6876470965,22,6853131830,-23339135
1634768265,-187963,true,6875095877,22,6827823357,-47272520
1634768686,-187960,true,6877158612,22,6803288609,-73870003
1634769151,-187960,true,6877158612,22,6804649334,-72509278
1634769273,-187964,true,6874408436,22,6802608348,-71800088
1634769388,-187966,true,6873033761,22,6801928155,-71105606
1634769785,-187965,true,6873721064,22,6801928155,-71792909
1634770154,-187965,true,6873721064,22,6832604267,-41116797
1634770207,-187968,true,6871659360,22,6836704855,-34954505
1634770295,-187969,true,6870972263,22,6841491984,-29480279
1634770450,-187966,true,6873033761,22,6848336556,-24697205
1634770518,-187967,true,6872346526,22,6851076301,-21270225
1634770540,-187970,true,6870285234,22,6851076301,-19208933
1634770565,-187972,true,6868911384,22,6852446585,-16464799
1634770654,-187970,true,6870285234,22,6855873494,-14411740
1634770680,-187972,true,6868911384,22,6857930461,-10980923
1634770734,-187974,true,6867537807,22,6859302116,-8235691
1634770844,-187975,true,6866851122,22,6860674045,-6177077
1634771081,-187972,true,6868911384,22,6859302116,-9609268
1634771094,-187974,true,6867537807,22,6859302116,-8235691
1634771271,-187977,true,6865477958,22,6857930461,-7547497
1634771397,-187979,true,6864105068,22,6857244737,-6860331
1634771471,-187978,true,6864791479,22,6857930461,-6861018
1634771611,-187980,true,6863418726,22,6856559081,-6859645
1634771770,-187983,true,6861360113,22,6851076301,-10283812
1634771778,-187984,true,6860674045,22,6851076301,-9597744
1634771829,-187981,true,6862732453,22,6857244737,-5487716
1634771950,-187979,true,6864105068,22,6869598275,5493207
1634772029,-187979,true,6864105068,22,6878534113,14429045
1634772775,-187983,true,6861360113,22,6906792580,45432467
1634772987,-187980,true,6863418726,22,6890236980,26818254
1634773034,-187979,true,6864105068,22,6889548025,25442957
1634773100,-187977,true,6865477958,22,6889548025,24070067
1634773210,-187984,true,6860674045,22,6888170322,27496277
1634773331,-187981,true,6862732453,22,6886104285,23371832
1634773427,-187980,true,6863418726,22,6886104285,22685559
1634773468,-187978,true,6864791479,22,6891615096,26823617
1634773500,-187983,true,6861360113,22,6896440675,35080562
1634773530,-187976,true,6866164506,22,6900579574,34415068
1634773694,-187972,true,6868911384,22,6927543030,58631646
1634773805,-187969,true,6870972263,22,6953221131,82248868
1634773844,-187973,true,6868224561,22,6961569587,93345026
1634773919,-187966,true,6873033761,22,6978994411,105960650
1634773930,-187960,true,6877158612,22,6982484607,105325995
1634773955,-187957,true,6879221966,22,6987373812,108151846
1634774039,-187964,true,6874408436,22,7003462463,129054027
1634774073,-187958,true,6878534113,22,7009768101,131233988
1634774124,-187953,true,6881974068,22,7019588158,137614090
1634774168,-187950,true,6884038866,22,7030124914,146086048
1634774257,-187954,true,6881285939,22,7051245898,169959959
1634774292,-187947,true,6886104285,22,7059006148,172901863
1634774907,-187938,true,6892304258,22,7088006032,195701774
1634775959,-187937,true,6892993488,22,7028016298,135022810
1634776013,-187941,true,6890236980,22,7028016298,137779318
1634776278,-187935,true,6894372156,22,6999261856,104889700
1634776311,-187929,true,6898509814,22,6995763274,97253460
1634776326,-187932,true,6896440675,22,6994364331,97923656
1634776417,-187937,true,6892993488,22,6982484607,89491119
1634776584,-187936,true,6893682788,22,6940023213,46340425
1634777169,-187933,true,6895751099,22,6827140643,-68610456
1634777319,-187937,true,6892993488,22,6811457047,-81536441
1634777325,-187942,true,6889548025,22,6812138192,-77409833
1634777360,-187940,true,6890926004,22,6812819406,-78106598
1634777445,-187937,true,6892993488,22,6814863456,-78130032
1634777606,-187940,true,6890926004,22,6819635292,-71290712
1634777628,-187945,true,6887481574,22,6820317256,-67164318
1634777747,-187943,true,6888859139,22,6823045792,-65813347
1634777854,-187935,true,6894372156,22,6826457997,-67914159
1634777953,-187936,true,6893682788,22,6830554896,-63127892
1634778074,-187941,true,6890236980,22,6836021253,-54215727
1634778083,-187939,true,6891615096,22,6836021253,-55593843
1634778583,-187931,true,6897130319,22,6853817143,-43313176
1634778747,-187932,true,6896440675,22,6862732453,-33708222
1634779234,-187937,true,6892993488,22,6849706292,-43287196
1634779369,-187935,true,6894372156,22,6846282466,-48089690
1634779389,-187928,true,6899199665,22,6845597906,-53601759
1634779410,-187930,true,6897820032,22,6844913415,-52906617
1634779658,-187935,true,6894372156,22,6833970857,-60401299
1634779742,-187936,true,6893682788,22,6834654254,-59028534
1634779927,-187929,true,6898509814,22,6830554896,-67954918
1634780259,-187931,true,6897130319,22,6831237951,-65892368
1634780318,-187937,true,6892993488,22,6833287528,-59705960
1634780393,-187937,true,6892993488,22,6828506139,-64487349
1634780515,-187931,true,6897130319,22,6820999287,-76131032
1634780666,-187935,true,6894372156,22,6812819406,-81552750
1634781021,-187942,true,6889548025,22,6798528211,-91019814
1634781101,-187943,true,6888859139,22,6794450521,-94408618
1634781153,-187936,true,6893682788,22,6803968937,-89713851
1634781271,-187937,true,6892993488,22,6807371602,-85621886
1634781516,-187939,true,6891615096,22,6826457997,-65157099
1634781711,-187939,true,6891615096,22,6841491984,-50123112
1634781722,-187933,true,6895751099,22,6842860351,-52890748
1634781996,-187935,true,6894372156,22,6842176133,-52196023
1634782046,-187937,true,6892993488,22,6837388525,-55604963
1634782099,-187938,true,6892304258,22,6838072264,-54231994
1634782116,-187933,true,6895751099,22,6838756072,-56995027
1634782736,-187937,true,6892993488,22,6809414018,-83579470
1634782855,-187939,true,6891615096,22,6810775969,-80839127
1634782900,-187942,true,6889548025,22,6810094960,-79453065
1634782990,-187937,true,6892993488,22,6801248030,-91745458
1634783069,-187940,true,6890926004,22,6798528211,-92397793
1634783143,-187942,true,6889548025,22,6800567973,-88980052
1634783297,-187944,true,6888170322,22,6805329799,-82840523
1634783361,-187939,true,6891615096,22,6801248030,-90367066
1634783437,-187944,true,6888170322,22,6796489060,-91681262
1634783449,-187948,true,6885415743,22,6796489060,-88926683
1634783532,-187952,true,6882662265,22,6793091835,-89570430
1634783600,-187947,true,6886104285,22,6790375277,-95729008
1634783694,-187950,true,6884038866,22,6787659806,-96379060
1634783951,-187953,true,6881974068,22,6784945421,-97028647
1634784238,-187956,true,6879909888,22,6777486457,-102423431
1634784352,-187951,true,6883350531,22,6782232121,-101118410
1634784490,-187955,true,6880597879,22,6779519906,-101077973
1634784591,-187958,true,6878534113,22,6777486457,-101047656
1634784668,-187963,true,6875095877,22,6775453618,-99642259
1634784763,-187960,true,6877158612,22,6779519906,-97638706
1634785002,-187965,true,6873721064,22,6789017406,-84703658
1634785010,-187964,true,6874408436,22,6789696308,-84712128
1634785343,-187969,true,6870972263,22,6803288609,-67683654
1634785598,-187966,true,6873033761,22,6810775969,-62257792
1634785623,-187971,true,6869598275,22,6811457047,-58141228
1634785775,-187969,true,6870972263,22,6814863456,-56108807
1634785897,-187973,true,6868224561,22,6814863456,-53361105
1634786358,-187970,true,6870285234,22,6822363555,-47921679
1634786717,-187976,true,6866164506,22,6824410469,-41754037
1634786732,-187975,true,6866851122,22,6824410469,-42440653
1634786776,-187982,true,6862046249,22,6825775420,-36270829
1634786894,-187983,true,6861360113,22,6826457997,-34902116
1634787018,-187991,true,6855873494,22,6823728096,-32145398
1634787105,-187990,true,6856559081,22,6826457997,-30101084
1634787142,-187998,true,6851076301,22,6827140643,-23935658
1634787359,-187999,true,6850391262,22,6834654254,-15737008
1634787392,-188006,true,6845597906,22,6835337719,-10260187
1634787437,-188004,true,6846967094,22,6838756072,-8211022
1634787758,-188011,true,6842176133,22,6849706292,7530159
1634787764,-188012,true,6841491984,22,6850391262,8899278
1634787871,-188020,true,6836021253,22,6849021389,13000136
1634788469,-188017,true,6838072264,22,6895751099,57678835
1634788891,-188023,true,6833970857,22,6918543525,84572668
1634789268,-188024,true,6833287528,22,6915085291,81797763
1634789371,-188029,true,6829871909,22,6910937692,81065783
1634789429,-188026,true,6831921075,22,6909555711,77634636
1634789474,-188031,true,6828506139,22,6908174007,79667868
1634789579,-188034,true,6826457997,22,6891615096,65157099
1634789655,-188036,true,6825092910,22,6887481574,62388664
1634789762,-188031,true,6828506139,22,6882662265,54156126
1634789895,-188032,true,6827823357,22,6877846328,50022971
1634790099,-188030,true,6829188990,22,6870285234,41096244
1634790565,-188032,true,6827823357,22,6873033761,45210404
1634790878,-188027,true,6831237951,22,6871659360,40421409
1634790923,-188028,true,6830554896,22,6871659360,41104464
1634790934,-188027,true,6831237951,22,6873033761,41795810
1634791019,-188028,true,6830554896,22,6882662265,52107369
1634791741,-188018,true,6837388525,22,6974808480,137419955
1634792860,-188018,true,6837388525,22,6982484607,145096082
1634792892,-188018,true,6837388525,22,6981088319,143699794
1634793002,-188019,true,6836704855,22,6962265744,125560889
1634793175,-188010,true,6842860351,22,6940023213,97162862
1634793388,-188016,true,6838756072,22,6915776800,77020728
1634793399,-188017,true,6838072264,22,6916468377,78396113
1634793431,-188018,true,6837388525,22,6913702481,76313956
1634793662,-188007,true,6844913415,22,6895751099,50837684
1634793754,-188013,true,6840807904,22,6884038866,43230962
1634794000,-188014,true,6840123891,22,6883350531,43226640
1634794499,-188015,true,6839439947,22,6871659360,32219413
1634794637,-188005,true,6846282466,22,6870285234,24002768
1634794789,-188010,true,6842860351,22,6872346526,29486175
1634794871,-188011,true,6842176133,22,6873721064,31544931
1634794948,-188012,true,6841491984,22,6874408436,32916452
1634795212,-188002,true,6848336556,22,6874408436,26071880
1634795341,-188006,true,6845597906,22,6881974068,36376162
1634795355,-188007,true,6844913415,22,6882662265,37748850
1634795446,-188005,true,6846282466,22,6888170322,41887856
1634795463,-187993,true,6854502525,22,6888859139,34356614
1634795599,-187997,true,6851761409,22,6896440675,44679266
1634795603,-187999,true,6850391262,22,6896440675,46049413
1634795715,-187999,true,6850391262,22,6899199665,48808403
1634795936,-187990,true,6856559081,22,6903340219,46781138
1634795952,-187995,true,6853131830,22,6903340219,50208389
1634796126,-187996,true,6852446585,22,6906101970,53655385
1634796224,-187995,true,6853131830,22,6903340219,50208389
1634796278,-187985,true,6859988046,22,6901959758,41971712
1634796316,-187990,true,6856559081,22,6901269631,44710550
1634796440,-187991,true,6855873494,22,6898509814,42636320
1634796462,-187989,true,6857244737,22,6898509814,41265077
1634796595,-187979,true,6864105068,22,6896440675,32335607
1634796632,-187984,true,6860674045,22,6895751099,35077054
1634796696,-187984,true,6860674045,22,6896440675,35766630
1634796769,-187982,true,6862046249,22,6900579574,38533325
1634796841,-187970,true,6870285234,22,6907483259,37198025
1634797300,-187978,true,6864791479,22,6900579574,35788095
1634797712,-187979,true,6864105068,22,6877846328,13741260
1634797971,-187976,true,6866164506,22,6870285234,4120728
1634798020,-187964,true,6874408436,22,6869598275,-4810161
1634798234,-187970,true,6870285234,22,6866164506,-4120728
1634798820,-187972,true,6868911384,22,6865477958,-3433426
1634799202,-187970,true,6870285234,22,6862046249,-8238985
1634799484,-187959,true,6877846328,22,6860674045,-17172283
1634799505,-187965,true,6873721064,22,6859988046,-13733018
1634799662,-187967,true,6872346526,22,6859302116,-13044410
1634799928,-187964,true,6874408436,22,6864105068,-10303368
1634800326,-187952,true,6882662265,22,6873033761,-9628504
1634800377,-187958,true,6878534113,22,6875095877,-3438236
1634800466,-187960,true,6877158612,22,6877158612,0
1634800638,-187959,true,6877846328,22,6877158612,-687716
1634800822,-187948,true,6885415743,22,6877158612,-8257131
1634800963,-187954,true,6881285939,22,6877158612,-4127327
1634801337,-187955,true,6880597879,22,6876470965,-4126914
1634801408,-187954,true,6881285939,22,6879909888,-1376051
1634801774,-187943,true,6888859139,22,6894372156,5513017
1634802045,-187948,true,6885415743,22,6897820032,12404289
1634802169,-187951,true,6883350531,22,6897130319,13779788
1634802501,-187950,true,6884038866,22,6886104285,2065419
1634802602,-187939,true,6891615096,22,6881974068,-9641028
1634802619,-187945,true,6887481574,22,6881974068,-5507506
1634802724,-187947,true,6886104285,22,6884727270,-1377015
1634803399,-187943,true,6888859139,22,6917851740,28992601
1634803539,-187933,true,6895751099,22,6919927303,24176204
1634803639,-187940,true,6890926004,22,6912319948,21393944
1634803754,-187942,true,6889548025,22,6904720956,15172931
1634803811,-187942,true,6889548025,22,6897130319,7582294
1634804911,-187935,true,6894372156,22,6828506139,-65866017
1634805360,-187942,true,6889548025,22,6814863456,-74684569
1634805689,-187945,true,6887481574,22,6808052340,-79429234
1634806055,-187945,true,6887481574,22,6815544943,-71936631
1634806126,-187940,true,6890926004,22,6817589811,-73336193
1634806711,-187948,true,6885415743,22,6821681387,-63734356
1634806766,-187951,true,6883350531,22,6820999287,-62351244
1634806980,-187951,true,6883350531,22,6820317256,-63033275
1634807245,-187945,true,6887481574,22,6822363555,-65118019
1634807324,-187953,true,6881974068,22,6822363555,-59610513
1634807350,-187953,true,6881974068,22,6822363555,-59610513
1634807402,-187952,true,6882662265,22,6822363555,-60298710
1634807611,-187947,true,6886104285,22,6821681387,-64422898
1634807697,-187955,true,6880597879,22,6821681387,-58916492
1634807802,-187957,true,6879221966,22,6820999287,-58222679
1634807867,-187955,true,6880597879,22,6822363555,-58234324
1634808233,-187951,true,6883350531,22,6811457047,-71893484
1634808675,-187960,true,6877158612,22,6809414018,-67744594
1634808772,-187961,true,6876470965,22,6806690933,-69780032
1634808838,-187961,true,6876470965,22,6807371602,-69099363
1634809023,-187963,true,6875095877,22,6806690933,-68404944
1634809112,-187972,true,6868911384,22,6805329799,-63581585
1634809215,-187974,true,6867537807,22,6802608348,-64929459
1634809279,-187974,true,6867537807,22,6801248030,-66289777
1634809364,-187976,true,6866164506,22,6789017406,-77147100
1634809446,-187979,true,6864105068,22,6783588635,-80516433
1634809460,-187982,true,6862046249,22,6781553966,-80492283
1634809686,-187986,true,6859302116,22,6749082125,-110219991
1634809707,-187989,true,6857244737,22,6746383167,-110861570
1634810103,-187994,true,6853817143,22,6702005863,-151811280
1634810316,-187995,true,6853131830,22,6693299351,-159832479
1634810942,-187998,true,6851076301,22,6697986067,-153090234
1634810968,-188001,true,6849021389,22,6697986067,-151035322
1634811003,-188005,true,6846282466,22,6697986067,-148296399
1634811449,-188007,true,6844913415,22,6699325731,-145587684
1634811796,-188012,true,6841491984,22,6675252719,-166239265
1634811858,-188014,true,6840123891,22,6675252719,-164871172
1634812372,-188019,true,6836704855,22,6675252719,-161452136
1634812497,-188021,true,6835337719,22,6683935756,-151401963
1634812529,-188025,true,6832604267,22,6684604150,-148000117
1634812548,-188030,true,6829188990,22,6684604150,-144584840
1634812858,-188036,true,6825092910,22,6683267430,-141825480
1634812925,-188039,true,6823045792,22,6681262850,-141782942
1634812955,-188042,true,6820999287,22,6679926798,-141072489
1634812984,-188046,true,6818271570,22,6678591013,-139680557
1634813245,-188054,true,6812819406,22,6652596530,-160222876
1634813300,-188057,true,6810775969,22,6647276847,-163499122
1634813319,-188061,true,6808052340,22,6646612186,-161440154
1634813428,-188063,true,6806690933,22,6647941575,-158749358
1634813910,-188074,true,6799208064,22,6604872235,-194335829
1634813979,-188078,true,6796489060,22,6602230946,-194258114
1634814093,-188081,true,6794450521,22,6598930821,-195519700
1634814512,-188084,true,6792412594,22,6604872235,-187540359
1634814753,-188092,true,6786981108,22,6621404245,-165576863
1634814754,-188096,true,6784266994,22,6621404245,-162862749
1634814895,-188099,true,6782232121,22,6629354302,-152877819
1634815029,-188105,true,6778164206,22,6624053204,-154111002
1634815114,-188114,true,6772066907,22,6616771116,-155295791
1634815188,-188116,true,6770712697,22,6610818998,-159893699
1634815216,-188121,true,6767328356,22,6608836149,-158492207
1634815479,-188125,true,6764622101,22,6590358213,-174263888
1634815660,-188134,true,6758536984,22,6574561107,-183975877
1634815665,-188136,true,6757185479,22,6573903717,-183281762
1634815759,-188141,true,6753807900,22,6567990161,-185817739
1634815800,-188145,true,6751107052,22,6565363621,-185743431
1634816461,-188154,true,6745034093,22,6566676760,-178357333
1634816674,-188156,true,6743685288,22,6567333427,-176351861
1634817104,-188162,true,6739640493,22,6559457747,-180182746
1634817210,-188167,true,6736271683,22,6556834620,-179437063
1634817389,-188176,true,6730212069,22,6550936418,-179275651
1634817946,-188176,true,6730212069,22,6592994752,-137217317
1634818092,-188180,true,6727520657,22,6604211814,-123308843
1634818283,-188185,true,6724157906,22,6618756346,-105401560
1634818320,-188193,true,6718780999,22,6618756346,-100024653
1634818416,-188194,true,6718109188,22,6616771116,-101338072
1634818800,-188196,true,6716765768,22,6645947591,-70818177
1634818972,-188200,true,6714079733,22,6651931337,-62148396
1634819139,-188209,true,6708040082,22,6657920470,-50119612
1634819342,-188210,true,6707369345,22,6665247846,-42121499
1634819384,-188212,true,6706028072,22,6663248671,-42779401
1634819576,-188216,true,6703346331,22,6654592509,-48753822
1634819724,-188224,true,6697986067,22,6645947591,-52038476
1634819810,-188226,true,6696646670,22,6643289876,-53356794
1634819823,-188231,true,6693299351,22,6643289876,-50009475
1634819986,-188237,true,6689284777,22,6626703223,-62581554
1634820107,-188245,true,6683935756,22,6624715610,-59220146
1634820291,-188246,true,6683267430,22,6625378081,-57889349
1634820305,-188248,true,6681930977,22,6626040619,-55890358
1634820506,-188249,true,6681262850,22,6629354302,-51908548
1634820821,-188256,true,6676587836,22,6652596530,-23991306
1634820843,-188256,true,6676587836,22,6655257968,-21329868
1634821009,-188258,true,6675252719,22,6664581388,-10671331
1634821162,-188259,true,6674585261,22,6672583286,-2001975
1634821293,-188265,true,6670581911,22,6674585261,4003350
1634821303,-188266,true,6669914919,22,6674585261,4670342
1634821590,-188267,true,6669247995,22,6676587836,7339841
1634821702,-188269,true,6667914345,22,6677255495,9341150
1634821829,-188276,true,6663248671,22,6673250544,10001873
1634822022,-188278,true,6661916222,22,6653927116,-7989106
1634822121,-188281,true,6659918046,22,6645283063,-14634983
1634822154,-188282,true,6659252121,22,6642625614,-16626507
1634822178,-188291,true,6653261790,22,6640633225,-12628565
1634822282,-188292,true,6652596530,22,6633332909,-19263621
1634822427,-188295,true,6650601150,22,6620742171,-29858979
1634822497,-188296,true,6649936157,22,6616771116,-33165041
1634822639,-188305,true,6643954205,22,6606853895,-37100310
1634822878,-188306,true,6643289876,22,6605532722,-37757154
1634822957,-188309,true,6641297288,22,6600910698,-40386590
1634823069,-188311,true,6639969228,22,6598270994,-41698234
1634823229,-188319,true,6634659642,22,6595632345,-39027297
1634823718,-188320,true,6633996242,22,6587064022,-46932220
1634823724,-188323,true,6632006441,22,6587064022,-44942419
1634823949,-188321,true,6633332909,22,6608175332,-25157577
1634824197,-188328,true,6628691433,22,6619418221,-9273212
1634824355,-188326,true,6630017237,22,6624715610,-5301627
1634824521,-188327,true,6629354302,22,6630680239,1325937
1634824548,-188326,true,6630017237,22,6630680239,663002
1634824632,-188333,true,6625378081,22,6631343307,5965226
1634824696,-188333,true,6625378081,22,6623390865,-1987216
1634824839,-188336,true,6623390865,22,6606193275,-17197590
1634824895,-188335,true,6624053204,22,6601570789,-22482415
1634825127,-188343,true,6618756346,22,6583113167,-35643179
1634825226,-188341,true,6620080163,22,6585088298,-34991865
1634825334,-188342,true,6619418221,22,6587064022,-32354199
1634825415,-188340,true,6620742171,22,6585746807,-34995364
1634825473,-188346,true,6616771116,22,6586405382,-30365734
1634825535,-188345,true,6617432793,22,6587722729,-29710064
1634825581,-188347,true,6616109505,22,6590358213,-25751292
1634825645,-188346,true,6616771116,22,6594313417,-22457699
1634825760,-188350,true,6614125069,22,6601570789,-12554280
1634825847,-188348,true,6615447960,22,6606853895,-8594065
1634825907,-188351,true,6613463722,22,6611480080,-1983642
1634826123,-188348,true,6615447960,22,6627365893,11917933
1634826161,-188349,true,6614786481,22,6627365893,12579412
1634826527,-188347,true,6616109505,22,6630680239,14570734
1634826584,-188349,true,6614786481,22,6632006441,17219960
1634826696,-188348,true,6615447960,22,6635323108,19875148
1634826727,-188348,true,6615447960,22,6634659642,19211682
1634826832,-188343,true,6618756346,22,6643289876,24533530
1634827290,-188344,true,6618094536,22,6660584038,42489502
1634827425,-188343,true,6618756346,22,6667247620,48491274
1634827435,-188344,true,6618094536,22,6667914345,49819809
1634827737,-188340,true,6620742171,22,6678591013,57848842
1634827940,-188341,true,6620080163,22,6679926798,59846635
1634827999,-188338,true,6622066386,22,6680594791,58528405
1634828040,-188337,true,6622728592,22,6680594791,57866199
1634828280,-188333,true,6625378081,22,6682599170,57221089
1634828330,-188333,true,6625378081,22,6682599170,57221089
1634828398,-188331,true,6626703223,22,6680594791,53891568
1634828697,-188328,true,6628691433,22,6700665663,71974230
1634829526,-188325,true,6630680239,22,6677923221,47242982
1634829642,-188324,true,6631343307,22,6675920244,44576937
1634829683,-188322,true,6632669642,22,6679926798,47257156
1634829709,-188320,true,6633996242,22,6682599170,48602928
1634830727,-188315,true,6637313904,22,6700665663,63351759
1634830850,-188315,true,6637313904,22,6696646670,59332766
1634831005,-188313,true,6638641433,22,6683267430,44625997
1634831058,-188311,true,6639969228,22,6678591013,38621785
1634831148,-188311,true,6639969228,22,6671916094,31946866
1634831275,-188313,true,6638641433,22,6662582413,23940980
1634831369,-188311,true,6639969228,22,6657254745,17285517
1634831525,-188309,true,6641297288,22,6649271229,7973941
1634831631,-188309,true,6641297288,22,6644618601,3321313
1634831745,-188313,true,6638641433,22,6641961418,3319985
1634831824,-188311,true,6639969228,22,6647941575,7972347
1634831940,-188308,true,6641961418,22,6655257968,13296550
1634832260,-188308,true,6641961418,22,6672583286,30621868
1634833242,-188310,true,6640633225,22,6701335729,60702504
1634833282,-188308,true,6641961418,22,6701335729,59374311
1634833352,-188305,true,6643954205,22,6703346331,59392126
1634833455,-188303,true,6645283063,22,6705357536,60074473
1634833461,-188304,true,6644618601,22,6705357536,60738935
1634833751,-188303,true,6645283063,22,6688615915,43332852
1634834140,-188300,true,6647276847,22,6669914919,22638072
1634834149,-188301,true,6646612186,22,6669247995,22635809
1634834395,-188301,true,6646612186,22,6658586262,11974076
1634834509,-188303,true,6645283063,22,6655923494,10640431
1634834722,-188301,true,6646612186,22,6656589086,9976900
1634834856,-188301,true,6646612186,22,6660584038,13971852
1634834879,-188302,true,6645947591,22,6661250097,15302506
1634835301,-188303,true,6645283063,22,6669914919,24631856
1634835572,-188300,true,6647276847,22,6687278393,40001546
1634835975,-188301,true,6646612186,22,6677255495,30643309
1634836087,-188302,true,6645947591,22,6670581911,24634320
1634836106,-188303,true,6645283063,22,6671248969,25965906
1634836298,-188300,true,6647276847,22,6679926798,32649951
1634836348,-188297,true,6649271229,22,6681262850,31991621
1634836493,-188296,true,6649936157,22,6683935756,33999599
1634836860,-188295,true,6650601150,22,6708710886,58109736
1634837001,-188292,true,6652596530,22,6720124823,67528293
1634837310,-188290,true,6653927116,22,6714751141,60824025
1634837366,-188288,true,6655257968,22,6714079733,58821765
1634837390,-188288,true,6655257968,22,6714079733,58821765
1634837431,-188285,true,6657254745,22,6713408392,56153647
1634837539,-188283,true,6658586262,22,6712065912,53479650
1634837646,-188281,true,6659918046,22,6711394773,51476727
1634837762,-188281,true,6659918046,22,6706698675,46780629
1634838200,-188277,true,6662582413,22,6697986067,35403654
1634838301,-188276,true,6663248671,22,6693299351,30050680
1634838341,-188274,true,6664581388,22,6691291763,26710375
1634838431,-188276,true,6663248671,22,6688615915,25367244
1634838438,-188274,true,6664581388,22,6688615915,24034527
1634838521,-188273,true,6665247846,22,6685941138,20693292
1634838793,-188270,true,6667247620,22,6687947121,20699501
1634839260,-188271,true,6666580962,22,6691291763,24710801
1634839662,-188268,true,6668581136,22,6689953705,21372569
1634839770,-188267,true,6669247995,22,6685941138,16693143
1634839797,-188262,true,6672583286,22,6684604150,12020864
1634839978,-188264,true,6671248969,22,6673917869,2668900
1634840028,-188262,true,6672583286,22,6671248969,-1334317
1634840060,-188263,true,6671916094,22,6669247995,-2668099
1634840125,-188259,true,6674585261,22,6665914371,-8670890
1634840262,-188260,true,6673917869,22,6663248671,-10669198
1634840289,-188260,true,6673917869,22,6662582413,-11335456
1634840322,-188260,true,6673917869,22,6662582413,-11335456
1634840372,-188254,true,6677923221,22,6662582413,-15340808
1634840430,-188255,true,6677255495,22,6663914996,-13340499
1634840519,-188254,true,6677923221,22,6665247846,-12675375
1634841005,-188255,true,6677255495,22,6683267430,6011935
1634841184,-188250,true,6680594791,22,6687278393,6683602
1634841215,-188251,true,6679926798,22,6686609732,6682934
1634841274,-188251,true,6679926798,22,6684604150,4677352
1634841315,-188252,true,6679258872,22,6682599170,3340298
1634841401,-188248,true,6681930977,22,6679258872,-2672105
1634841492,-188250,true,6680594791,22,6673250544,-7344247
1634841851,-188250,true,6680594791,22,6657254745,-23340046
1634842053,-188252,true,6679258872,22,6651931337,-27327535
1634842241,-188249,true,6681262850,22,6649936157,-31326693
1634842310,-188251,true,6679926798,22,6649271229,-30655569
1634842599,-188252,true,6679258872,22,6655257968,-24000904
1634842758,-188253,true,6678591013,22,6663248671,-15342342
1634843177,-188250,true,6680594791,22,6671248969,-9345822
1634843456,-188252,true,6679258872,22,6677923221,-1335651
1634843481,-188252,true,6679258872,22,6678591013,-667859
1634843633,-188254,true,6677923221,22,6677255495,-667726
1634843732,-188250,true,6680594791,22,6676587836,-4006955
1634843788,-188252,true,6679258872,22,6676587836,-2671036
1634844395,-188251,true,6679926798,22,6718109188,38182390
1634844549,-188251,true,6679926798,22,6728193409,48266611
1634844610,-188248,true,6681930977,22,6726847972,44916995
1634844802,-188250,true,6680594791,22,6719452877,38858086
1634844955,-188251,true,6679926798,22,6708710886,28784088
1634845032,-188253,true,6678591013,22,6705357536,26766523
1634845284,-188248,true,6681930977,22,6693968681,12037704
1634845313,-188250,true,6680594791,22,6692630088,12035297
1634845677,-188250,true,6680594791,22,6694638078,14043287
1634845741,-188249,true,6681262850,22,6695977073,14714223
1634845918,-188244,true,6684604150,22,6699325731,14721581
1634845981,-188246,true,6683267430,22,6699325731,16058301
1634846190,-188246,true,6683267430,22,6703346331,20078901
1634846210,-188245,true,6683935756,22,6704016666,20080910
1634846570,-188239,true,6687947121,22,6713408392,25461271
1634846882,-188241,true,6686609732,22,6737619005,51009273
1634847258,-188240,true,6687278393,22,6756509828,69231435
1634847299,-188240,true,6687278393,22,6757861198,70582805
1634847355,-188235,true,6690622701,22,6759212838,68590137
1634847833,-188237,true,6689284777,22,6753807900,64523123
1634848050,-188237,true,6689284777,22,6749757033,60472256
1634848191,-188237,true,6689284777,22,6745708596,56423819
1634848197,-188233,true,6691960892,22,6746383167,54422275
1634848216,-188232,true,6692630088,22,6746383167,53753079
1634848310,-188231,true,6693299351,22,6749757033,56457682
1634848557,-188229,true,6694638078,22,6757861198,63223120
1634848584,-188225,true,6697316335,22,6758536984,61220649
1634848727,-188224,true,6697986067,22,6761916929,63930862
1634848891,-188223,true,6698655865,22,6763945706,65289841
1634848966,-188222,true,6699325731,22,6765298563,65972832
1634849029,-188218,true,6702005863,22,6766651691,64645828
1634849083,-188219,true,6701335729,22,6768681889,67346160
1634849087,-188218,true,6702005863,22,6768681889,66676026
1634849138,-188216,true,6703346331,22,6768005089,64658758
1634849184,-188212,true,6706028072,22,6767328356,61300284
1634849206,-188212,true,6706028072,22,6766651691,60623619
1634849490,-188212,true,6706028072,22,6763945706,57917634
1634849533,-188213,true,6705357536,22,6757185479,51827943
1634849614,-188212,true,6706028072,22,6743685288,37657216
1634849732,-188213,true,6705357536,22,6734251206,28893670
1634849783,-188216,true,6703346331,22,6730212069,26865738
1634850050,-188215,true,6704016666,22,6708710886,4694220
1634850998,-188213,true,6705357536,22,6695977073,-9380463
1634851138,-188213,true,6705357536,22,6703346331,-2011205
1634851400,-188216,true,6703346331,22,6716765768,13419437
1634851406,-188215,true,6704016666,22,6716765768,12749102
1634851481,-188211,true,6706698675,22,6719452877,12754202
1634851502,-188211,true,6706698675,22,6720124823,13426148
1634851829,-188214,true,6704687068,22,6728866228,24179160
1634851855,-188213,true,6705357536,22,6729539115,24181579
1634852054,-188209,true,6708040082,22,6724830321,16790239
1634852085,-188209,true,6708040082,22,6723485557,15445475
1634852393,-188213,true,6705357536,22,6706028072,670536
1634852435,-188212,true,6706028072,22,6704687068,-1341004
1634852451,-188209,true,6708040082,22,6704016666,-4023416
1634852534,-188210,true,6707369345,22,6699995663,-7373682
1634852573,-188213,true,6705357536,22,6698655865,-6701671
1634852812,-188212,true,6706028072,22,6689953705,-16074367
1634852921,-188209,true,6708040082,22,6687947121,-20092961
1634852982,-188208,true,6708710886,22,6686609732,-22101154
1634853067,-188210,true,6707369345,22,6687278393,-20090952
1634853303,-188208,true,6708710886,22,6693299351,-15411535
1634853394,-188204,true,6711394773,22,6695977073,-15417700
1634853405,-188205,true,6710723700,22,6695307542,-15416158
1634853446,-188207,true,6709381757,22,6697986067,-11395690
1634853746,-188205,true,6710723700,22,6704016666,-6707034
1634853889,-188202,true,6712737119,22,6708040082,-4697037
1634853941,-188203,true,6712065912,22,6709381757,-2684155
1634853965,-188206,true,6710052695,22,6710052695,0
1634854159,-188203,true,6712065912,22,6710723700,-1342212
1634854291,-188200,true,6714079733,22,6712065912,-2013821
1634854356,-188202,true,6712737119,22,6709381757,-3355362
1634854424,-188204,true,6711394773,22,6708040082,-3354691
1634854513,-188202,true,6712737119,22,6706028072,-6709047
1634854743,-188199,true,6714751141,22,6700665663,-14085478
1634854833,-188199,true,6714751141,22,6697316335,-17434806
1634854922,-188201,true,6713408392,22,6694638078,-18770314
1634854943,-188199,true,6714751141,22,6693299351,-21451790
1634855306,-188193,true,6718780999,22,6713408392,-5372607
1634855379,-188194,true,6718109188,22,6718780999,671811
1634855474,-188195,true,6717437444,22,6724830321,7392877
1634855672,-188193,true,6718780999,22,6738966596,20185597
1634855751,-188188,true,6722141062,22,6745034093,22893031
1634855838,-188188,true,6722141062,22,6751782163,29641101
1634856215,-188190,true,6720796835,22,6753132587,32335752
1634856232,-188188,true,6722141062,22,6751782163,29641101
1634856261,-188183,true,6725502804,22,6749082125,23579321
1634856604,-188185,true,6724157906,22,6722141062,-2016844
1634856646,-188193,true,6718780999,22,6718780999,0
1634856668,-188191,true,6720124823,22,6717437444,-2687379
1634856846,-188186,true,6723485557,22,6702676064,-20809493
1634857023,-188188,true,6722141062,22,6687278393,-34862669
1634857049,-188194,true,6718109188,22,6683935756,-34173432
1634857134,-188191,true,6720124823,22,6684604150,-35520673
1634857218,-188185,true,6724157906,22,6691291763,-32866143
1634857222,-188185,true,6724157906,22,6691960892,-32197014
1634857442,-188191,true,6720124823,22,6702676064,-17448759
1634857446,-188189,true,6721468915,22,6702676064,-18792851
1634857462,-188183,true,6725502804,22,6703346331,-22156473
1634857502,-188184,true,6724830321,22,6705357536,-19472785
1634857770,-188190,true,6720796835,22,6718109188,-2687647
1634857807,-188188,true,6722141062,22,6719452877,-2688185
1634857836,-188183,true,6725502804,22,6720796835,-4705969
1634858077,-188184,true,6724830321,22,6734251206,9420885
1634858405,-188190,true,6720796835,22,6743685288,22888453
1634858425,-188187,true,6722813276,22,6743685288,20872012
1634858490,-188184,true,6724830321,22,6743685288,18854967
1634858544,-188184,true,6724830321,22,6743685288,18854967
1634858573,-188191,true,6720124823,22,6743685288,23560465
1634858600,-188189,true,6721468915,22,6742336753,20867838
1634858815,-188183,true,6725502804,22,6751782163,26279359
1634858915,-188183,true,6725502804,22,6751782163,26279359
1634859219,-188191,true,6720124823,22,6752457341,32332518
1634859342,-188190,true,6720796835,22,6753807900,33011065
1634859401,-188185,true,6724157906,22,6755834245,31676339
1634859406,-188185,true,6724157906,22,6755834245,31676339
1634859440,-188192,true,6719452877,22,6756509828,37056951
1634859480,-188191,true,6720124823,22,6757861198,37736375
1634859658,-188185,true,6724157906,22,6757861198,33703292
1634859687,-188185,true,6724157906,22,6757185479,33027573
1634859723,-188192,true,6719452877,22,6757185479,37732602
1634859868,-188190,true,6720796835,22,6763269380,42472545
1634860183,-188183,true,6725502804,22,6779519906,54017102
1634860299,-188183,true,6725502804,22,6782232121,56729317
1634860365,-188190,true,6720796835,22,6785623915,64827080
1634860392,-188188,true,6722141062,22,6786302478,64161416
1634860548,-188179,true,6728193409,22,6790375277,62181868
1634860597,-188178,true,6728866228,22,6793771144,64904916
1634860648,-188182,true,6726175355,22,6792412594,66237239
1634860702,-188181,true,6726847972,22,6790375277,63527305
1634860735,-188174,true,6731558179,22,6788338572,56780393
1634860752,-188173,true,6732231335,22,6787659806,55428471
1634860768,-188179,true,6728193409,22,6786302478,58109069
1634860865,-188179,true,6728193409,22,6776808776,48615367
1634861032,-188175,true,6730885090,22,6761916929,31031839
1634861034,-188175,true,6730885090,22,6761916929,31031839
1634861157,-188178,true,6728866228,22,6761240804,32374576
1634861202,-188178,true,6728866228,22,6757185479,28319251
1634861225,-188173,true,6732231335,22,6755158729,22927394
1634861381,-188174,true,6731558179,22,6740988488,9430309
1634861383,-188177,true,6729539115,22,6740988488,11449373
1634861477,-188178,true,6728866228,22,6729539115,672887
1634861517,-188172,true,6732904558,22,6726175355,-6729203
1634861665,-188172,true,6732904558,22,6717437444,-15467114
1634861752,-188176,true,6730212069,22,6717437444,-12774625
1634861909,-188176,true,6730212069,22,6715422616,-14789453
1634861957,-188170,true,6734251206,22,6712737119,-21514087
1634863607,-188172,true,6732904558,22,6691960892,-40943666
1634863637,-188176,true,6730212069,22,6691960892,-38251177
1634863811,-188177,true,6729539115,22,6679926798,-49612317
1634863838,-188171,true,6733577848,22,6677255495,-56322353
1634864117,-188177,true,6729539115,22,6660584038,-68955077
1634864124,-188181,true,6726847972,22,6659918046,-66929926
1634864210,-188182,true,6726175355,22,6652596530,-73578825
1634864250,-188177,true,6729539115,22,6647276847,-82262268
1634864555,-188185,true,6724157906,22,6612141228,-112016678
1634864681,-188189,true,6721468915,22,6605532722,-115936193
1634864764,-188191,true,6720124823,22,6602891169,-117233654
1634865089,-188185,true,6724157906,22,6594972848,-129185058
1634865546,-188194,true,6718109188,22,6579164681,-138944507
1634865673,-188198,true,6715422616,22,6575218563,-140204053
1634865786,-188200,true,6714079733,22,6570617751,-143461982
1634865861,-188194,true,6718109188,22,6568646960,-149462228
1634866050,-188201,true,6713408392,22,6572589133,-140819259
1634866110,-188204,true,6711394773,22,6577849045,-133545728
1634866336,-188204,true,6711394773,22,6596951538,-114443235
1634866413,-188201,true,6713408392,22,6603551459,-109856933
1634866792,-188211,true,6706698675,22,6591676350,-115022325
1634867358,-188216,true,6703346331,22,6547007232,-156339099
1634867407,-188218,true,6702005863,22,6547661933,-154343930
1634867612,-188215,true,6704016666,22,6549626428,-154390238
1634867950,-188225,true,6697316335,22,6554212542,-143103793
1634868034,-188229,true,6694638078,22,6555523450,-139114628
1634868065,-188231,true,6693299351,22,6556179002,-137120349
1634868136,-188228,true,6695307542,22,6558146052,-137161490
1634868180,-188235,true,6690622701,22,6560113693,-130509008
1634868265,-188236,true,6689953705,22,6565363621,-124590084
1634868276,-188237,true,6689284777,22,6566676760,-122608017
1634868318,-188233,true,6691960892,22,6569303824,-122657068
1634868410,-188239,true,6687947121,22,6575876085,-112071036
1634868493,-188240,true,6687278393,22,6582454921,-104823472
1634868642,-188242,true,6685941138,22,6592335518,-93605620
1634868901,-188238,true,6688615915,22,6617432793,-71183122
1634869019,-188245,true,6683935756,22,6629354302,-54581454
1634869115,-188246,true,6683267430,22,6633996242,-49271188
1634869122,-188248,true,6681930977,22,6633996242,-47934735
1634869141,-188243,true,6685272610,22,6634659642,-50612968
1634869191,-188252,true,6679258872,22,6634659642,-44599230
1634869283,-188254,true,6677923221,22,6633996242,-43926979
1634869335,-188255,true,6677255495,22,6632669642,-44585853
1634869688,-188251,true,6679926798,22,6621404245,-58522553
1634869825,-188261,true,6673250544,22,6614786481,-58464063
1634869908,-188264,true,6671248969,22,6608836149,-62412820
1634870009,-188265,true,6670581911,22,6606853895,-63728016
1634870076,-188261,true,6673250544,22,6607514580,-65735964
1634870099,-188270,true,6667247620,22,6606193275,-61054345
1634870131,-188273,true,6665247846,22,6602230946,-63016900
1634870189,-188274,true,6664581388,22,6602230946,-62350442
1634870194,-188273,true,6665247846,22,6602230946,-63016900
1634870216,-188283,true,6658586262,22,6602230946,-56355316
1634870369,-188285,true,6657254745,22,6596291908,-60962837
1634870529,-188286,true,6656589086,22,6596951538,-59637548
1634870554,-188284,true,6657920470,22,6597611233,-60309237
1634870981,-188292,true,6652596530,22,6606853895,-45742635
1634871178,-188293,true,6651931337,22,6620080163,-31851174
1634871184,-188294,true,6651266210,22,6620742171,-30524039
1634871205,-188293,true,6651931337,22,6621404245,-30527092
1634871230,-188302,true,6645947591,22,6619418221,-26529370
1634871329,-188304,true,6644618601,22,6622066386,-22552215
1634871440,-188305,true,6643954205,22,6623390865,-20563340
1634871643,-188305,true,6643954205,22,6623390865,-20563340
1634871899,-188313,true,6638641433,22,6621404245,-17237188
1634872254,-188316,true,6636650239,22,6623390865,-13259374
1634872437,-188317,true,6635986640,22,6624715610,-11271030
1634872500,-188316,true,6636650239,22,6624715610,-11934629
1634872617,-188325,true,6630680239,22,6625378081,-5302158
1634872658,-188327,true,6629354302,22,6626040619,-3313683
1634872783,-188327,true,6629354302,22,6627365893,-1988409
1634872883,-188325,true,6630680239,22,6630017237,-663002
1634872938,-188333,true,6625378081,22,6630017237,4639156
1634873077,-188335,true,6624053204,22,6630680239,6627035
1634873708,-188333,true,6625378081,22,6632006441,6628360
1634873790,-188332,true,6626040619,22,6630680239,4639620
1634873869,-188339,true,6621404245,22,6631343307,9939062
1634874022,-188342,true,6619418221,22,6630680239,11262018
1634874255,-188342,true,6619418221,22,6618756346,-661875
1634874335,-188342,true,6619418221,22,6614125069,-5293152
1634874513,-188348,true,6615447960,22,6606193275,-9254685
1634874553,-188350,true,6614125069,22,6602230946,-11894123
1634874656,-188351,true,6613463722,22,6593654051,-19809671
1634874824,-188347,true,6616109505,22,6606193275,-9916230
1634875239,-188351,true,6613463722,22,6651266210,37802488
1634875274,-188352,true,6612802442,22,6651931337,39128895
1634875631,-188355,true,6610818998,22,6645283063,34464065
1634875635,-188352,true,6612802442,22,6644618601,31816159
1634875642,-188358,true,6608836149,22,6643954205,35118056
1634875713,-188360,true,6607514580,22,6634659642,27145062
1634875777,-188362,true,6606193275,22,6627365893,21172618
1634875948,-188360,true,6607514580,22,6602891169,-4623411
1634876167,-188363,true,6605532722,22,6573903717,-31629005
1634876446,-188365,true,6604211814,22,6567990161,-36221653
1634876885,-188366,true,6603551459,22,6563394406,-40157053
1634876996,-188364,true,6604872235,22,6564050745,-40821490
1634877040,-188365,true,6604211814,22,6563394406,-40817408
1634877119,-188367,true,6602891169,22,6563394406,-39496763
1634877171,-188366,true,6603551459,22,6569960755,-33590704
1634877245,-188363,true,6605532722,22,6577191326,-28341396
1634877398,-188361,true,6606853895,22,6590358213,-16495682
1634877488,-188362,true,6606193275,22,6598270994,-7922281
1634877510,-188362,true,6606193275,22,6600250673,-5942602
1634877574,-188357,true,6609497033,22,6605532722,-3964311
1634877619,-188358,true,6608836149,22,6608836149,0
1634877623,-188359,true,6608175332,22,6609497033,1321701
1634877842,-188360,true,6607514580,22,6630017237,22502657
1634877914,-188356,true,6610157982,22,6634659642,24501660
1634877969,-188354,true,6611480080,22,6637313904,25833824
1634878122,-188356,true,6610157982,22,6626703223,16545241
1634878868,-188358,true,6608836149,22,6570617751,-38218398
1634879101,-188355,true,6610818998,22,6570617751,-40201247
1634879118,-188353,true,6612141228,22,6570617751,-41523477
1634879174,-188355,true,6610818998,22,6570617751,-40201247
1634879273,-188357,true,6609497033,22,6572589133,-36907900
1634879335,-188352,true,6612802442,22,6578506830,-34295612
1634879359,-188350,true,6614125069,22,6581138628,-32986441
1634879419,-188352,true,6612802442,22,6587064022,-25738420
1634879487,-188352,true,6612802442,22,6594313417,-18489025
1634880251,-188348,true,6615447960,22,6659252121,43804161
1634880392,-188347,true,6616109505,22,6657254745,41145240
1634880800,-188349,true,6614786481,22,6647941575,33155094
1634880997,-188350,true,6614125069,22,6638641433,24516364
1634881431,-188348,true,6615447960,22,6632006441,16558481
1634881439,-188348,true,6615447960,22,6632006441,16558481
1634881496,-188350,true,6614125069,22,6632006441,17881372
1634881521,-188351,true,6613463722,22,6632006441,18542719
1634882020,-188348,true,6615447960,22,6643289876,27841916
1634882191,-188346,true,6616771116,22,6645947591,29176475
1634882326,-188348,true,6615447960,22,6648606369,33158409
1634882394,-188349,true,6614786481,22,6648606369,33819888
1634882730,-188345,true,6617432793,22,6643954205,26521412
1634882777,-188344,true,6618094536,22,6642625614,24531078
1634882962,-188346,true,6616771116,22,6639305297,22534181
1634883032,-188347,true,6616109505,22,6637313904,21204399
1634883236,-188344,true,6618094536,22,6630017237,11922701
1634883591,-188343,true,6618756346,22,6626703223,7946877
1634883827,-188344,true,6618094536,22,6624715610,6621074
1634883963,-188344,true,6618094536,22,6625378081,7283545
1634884033,-188340,true,6620742171,22,6626703223,5961052
1634884166,-188339,true,6621404245,22,6628691433,7287188
1634884269,-188340,true,6620742171,22,6629354302,8612131
1634884399,-188341,true,6620080163,22,6631343307,11263144
1634884646,-188337,true,6622728592,22,6634659642,11931050
1634884785,-188338,true,6622066386,22,6629354302,7287916
1634884790,-188340,true,6620742171,22,6628691433,7949262
1634884796,-188342,true,6619418221,22,6628691433,9273212
1634885152,-188339,true,6621404245,22,6622066386,662141
1634885272,-188339,true,6621404245,22,6614125069,-7279176
1634885299,-188340,true,6620742171,22,6612141228,-8600943
1634885472,-188343,true,6618756346,22,6597611233,-21145113
1634885537,-188342,true,6619418221,22,6592994752,-26423469
1634885655,-188343,true,6618756346,22,6588381501,-30374845
1634885807,-188344,true,6618094536,22,6580480580,-37613956
1634885966,-188347,true,6616109505,22,6570617751,-45491754
1634886038,-188346,true,6616771116,22,6566676760,-50094356
1634886077,-188348,true,6615447960,22,6564707150,-50740810
1634887016,-188345,true,6617432793,22,6628028630,10595837
1634887129,-188348,true,6615447960,22,6627365893,11917933
1634887207,-188347,true,6616109505,22,6626703223,10593718
1634887502,-188348,true,6615447960,22,6620742171,5294211
1634887505,-188346,true,6616771116,22,6620742171,3971055
1634887586,-188349,true,6614786481,22,6620080163,5293682
1634888100,-188348,true,6615447960,22,6608175332,-7272628
1634888179,-188350,true,6614125069,22,6608175332,-5949737
1634888848,-188348,true,6615447960,22,6598270994,-17176966
1634888956,-188350,true,6614125069,22,6596291908,-17833161
1634889484,-188349,true,6614786481,22,6589699243,-25087238
1634889793,-188351,true,6613463722,22,6567990161,-45473561
1634889892,-188349,true,6614786481,22,6562081924,-52704557
1634889900,-188350,true,6614125069,22,6562738132,-51386937
1634890284,-188350,true,6614125069,22,6597611233,-16513836
1634890459,-188353,true,6612141228,22,6608175332,-3965896
1634890662,-188351,true,6613463722,22,6626040619,12576897
1634890711,-188351,true,6613463722,22,6630680239,17216517
1634890862,-188351,true,6613463722,22,6643289876,29826154
1634890994,-188350,true,6614125069,22,6637977635,23852566
1634891417,-188347,true,6616109505,22,6632669642,16560137
1634891459,-188347,true,6616109505,22,6633996242,17886737
1634891972,-188347,true,6616109505,22,6630680239,14570734
1634892467,-188345,true,6617432793,22,6634659642,17226849
1634892476,-188343,true,6618756346,22,6635323108,16566762
1634892982,-188343,true,6618756346,22,6624053204,5296858
1634893813,-188343,true,6618756346,22,6618094536,-661810
1634893879,-188342,true,6619418221,22,6618756346,-661875
1634894034,-188339,true,6621404245,22,6620080163,-1324082
1634894056,-188340,true,6620742171,22,6620080163,-662008
1634894150,-188342,true,6619418221,22,6620080163,661942
1634894166,-188342,true,6619418221,22,6622066386,2648165
1634894190,-188339,true,6621404245,22,6624053204,2648959
1634894203,-188340,true,6620742171,22,6625378081,4635910
1634894237,-188337,true,6622728592,22,6629354302,6625710
1634894474,-188339,true,6621404245,22,6642625614,21221369
1634894486,-188337,true,6622728592,22,6643289876,20561284
1634894491,-188338,true,6622066386,22,6644618601,22552215
1634894524,-188335,true,6624053204,22,6647276847,23223643
1634894563,-188336,true,6623390865,22,6648606369,25215504
1634894696,-188334,true,6624715610,22,6653927116,29211506
1634894818,-188331,true,6626703223,22,6665914371,39211148
1634894888,-188327,true,6629354302,22,6674585261,45230959
1634895014,-188328,true,6628691433,22,6681930977,53239544
1634895092,-188324,true,6631343307,22,6687278393,55935086
1634895444,-188322,true,6632669642,22,6693968681,61299039
1634895529,-188321,true,6633332909,22,6695307542,61974633
1634895546,-188322,true,6632669642,22,6695307542,62637900
1634895816,-188321,true,6633332909,22,6683267430,49934521
1634895838,-188322,true,6632669642,22,6683267430,50597788
1634896181,-188318,true,6635323108,22,6696646670,61323562
1634896362,-188318,true,6635323108,22,6714751141,79428033
1634896470,-188314,true,6637977635,22,6728866228,90888593
1634896865,-188314,true,6637977635,22,6771389768,133412133
1634896875,-188308,true,6641961418,22,6771389768,129428350
1634897178,-188308,true,6641961418,22,6789017406,147055988
1634897242,-188303,true,6645283063,22,6789696308,144413245
1634897361,-188302,true,6645947591,22,6797168709,151221118
1634897393,-188297,true,6649271229,22,6798528211,149256982
1634897442,-188296,true,6649936157,22,6801928155,151991998
1634897598,-188291,true,6653261790,22,6811457047,158195257
1634897815,-188290,true,6653927116,22,6822363555,168436439
1634897916,-188284,true,6657920470,22,6830554896,172634426
1634898375,-188281,true,6659918046,22,6851761409,191843363
1634898721,-188276,true,6663248671,22,6860674045,197425374
1634899225,-188275,true,6663914996,22,6857244737,193329741
1634899488,-188268,true,6668581136,22,6853817143,185236007
1634899592,-188266,true,6669914919,22,6852446585,182531666
1634899775,-188260,true,6673917869,22,6851076301,177158432
1634900865,-188260,true,6673917869,22,6849021389,175103520
1634901072,-188253,true,6678591013,22,6843544637,164953624
1634901098,-188251,true,6679926798,22,6842860351,162933553
1634901124,-188246,true,6683267430,22,6842860351,159592921
1634901144,-188247,true,6682599170,22,6842176133,159576963
1634901278,-188240,true,6687278393,22,6840123891,152845498
1634901445,-188237,true,6689284777,22,6838072264,148787487
1634901656,-188232,true,6692630088,22,6835337719,142707631
1634901723,-188232,true,6692630088,22,6833287528,140657440
1634902034,-188225,true,6697316335,22,6829871909,132555574
1634902633,-188223,true,6698655865,22,6821681387,123025522
1634902788,-188217,true,6702676064,22,6822363555,119687491
1634902805,-188217,true,6702676064,22,6820999287,118323223
1634902885,-188208,true,6708710886,22,6818271570,109560684
1634903074,-188203,true,6712065912,22,6833970857,121904945
1634903143,-188197,true,6716094159,22,6839439947,123345788
1634903224,-188196,true,6716765768,22,6842176133,125410365
1634903351,-188187,true,6722813276,22,6846282466,123469190
1634903707,-188183,true,6725502804,22,6868911384,143408580
1634903764,-188180,true,6727520657,22,6873721064,146200407
1634903833,-188179,true,6728193409,22,6874408436,146215027
1634903928,-188170,true,6734251206,22,6872346526,138095320
1634904254,-188166,true,6736945310,22,6875783387,138838077
1634904277,-188162,true,6739640493,22,6875783387,136142894
1634904432,-188162,true,6739640493,22,6874408436,134767943
1634904438,-188152,true,6746383167,22,6874408436,128025269
1634904478,-188148,true,6749082125,22,6871659360,122577235
1634904495,-188145,true,6751107052,22,6868911384,117804332
1634904511,-188149,true,6748407284,22,6866851122,118443838
1634904855,-188142,true,6753132587,22,6812138192,59005605
1634904968,-188138,true,6755834245,22,6793771144,37936899
1634905179,-188134,true,6758536984,22,6761240804,2703820
1634905384,-188138,true,6755834245,22,6734251206,-21583039
1634905427,-188133,true,6759212838,22,6735598123,-23614715
1634905480,-188131,true,6760564748,22,6736945310,-23619438
1634905482,-188127,true,6763269380,22,6736945310,-26324070
1634905530,-188129,true,6761916929,22,6739640493,-22276436
1634905556,-188123,true,6765975093,22,6742336753,-23638340
1634905612,-188119,true,6768681889,22,6747057805,-21624084
1634905643,-188117,true,6770035693,22,6746383167,-23652526
1634905755,-188122,true,6766651691,22,6743010987,-23640704
1634905826,-188115,true,6771389768,22,6743685288,-27704480
1634906113,-188112,true,6773421388,22,6748407284,-25014104
1634906135,-188110,true,6774776140,22,6749082125,-25694015
1634906753,-188113,true,6772744114,22,6757185479,-15558635
1634906820,-188106,true,6777486457,22,6757861198,-19625259
1634906983,-188103,true,6779519906,22,6757861198,-21658708
1634907208,-188101,true,6780875878,22,6751107052,-29768826
1634907256,-188105,true,6778164206,22,6749757033,-28407173
1634907482,-188098,true,6782910344,22,6743010987,-39899357
1634907581,-188096,true,6784266994,22,6738966596,-45300398
1634907935,-188095,true,6784945421,22,6726175355,-58770066
1634908190,-188100,true,6781553966,22,6721468915,-60085051
1634908287,-188099,true,6782232121,22,6710723700,-71508421
1634908301,-188094,true,6785623915,22,6709381757,-76242158
1634908339,-188094,true,6785623915,22,6705357536,-80266379
1634908373,-188102,true,6780197858,22,6702676064,-77521794
1634908401,-188100,true,6781553966,22,6699995663,-81558303
1634908578,-188096,true,6784266994,22,6686609732,-97657262
1634908711,-188095,true,6784945421,22,6677255495,-107689926
1634908904,-188104,true,6778842022,22,6665247846,-113594176
1634908991,-188102,true,6780197858,22,6662582413,-117615445
1634909176,-188097,true,6783588635,22,6666580962,-117007673
1634909291,-188097,true,6783588635,22,6667914345,-115674290
1634909399,-188105,true,6778164206,22,6669914919,-108249287
1634909505,-188102,true,6780197858,22,6682599170,-97598688
1634910255,-188094,true,6785623915,22,6749757033,-35866882
1634910292,-188093,true,6786302478,22,6753132587,-33169891
1634910351,-188100,true,6781553966,22,6751107052,-30446914
1634910596,-188099,true,6782232121,22,6741662587,-40569534
1634910639,-188094,true,6785623915,22,6740314457,-45309458
1634910925,-188095,true,6784945421,22,6730885090,-54060331
1634910979,-188103,true,6779519906,22,6728866228,-50653678
1634911032,-188103,true,6779519906,22,6727520657,-51999249
1634911083,-188098,true,6782910344,22,6725502804,-57407540
1634912257,-188099,true,6782232121,22,6724830321,-57401800
1634912666,-188108,true,6776131163,22,6726847972,-49283191
1634912763,-188109,true,6775453618,22,6728193409,-47260209
1634912887,-188105,true,6778164206,22,6728866228,-49297978
1634913077,-188105,true,6778164206,22,6747057805,-31106401
1634913416,-188111,true,6774098730,22,6775453618,1354888
1634913487,-188112,true,6773421388,22,6779519906,6098518
1634913801,-188109,true,6775453618,22,6791054315,15600697
1634914074,-188110,true,6774776140,22,6780875878,6099738
1634914084,-188117,true,6770035693,22,6780875878,10840185
1634914179,-188118,true,6769358757,22,6778842022,9483265
1634914280,-188114,true,6772066907,22,6778164206,6097299
1634914299,-188114,true,6772066907,22,6777486457,5419550
1634914341,-188121,true,6767328356,22,6776808776,9480420
1634914444,-188122,true,6766651691,22,6777486457,10834766
1634914852,-188116,true,6770712697,22,6804649334,33936637
1634915084,-188116,true,6770712697,22,6808052340,37339643
1634915125,-188122,true,6766651691,22,6809414018,42762327
1634915140,-188123,true,6765975093,22,6810094960,44119867
1634915179,-188118,true,6769358757,22,6811457047,42098290
1634915387,-188116,true,6770712697,22,6826457997,55745300
1634915410,-188121,true,6767328356,22,6826457997,59129641
1634915491,-188123,true,6765975093,22,6822363555,56388462
1634915498,-188118,true,6769358757,22,6820317256,50958499
1634915693,-188119,true,6768681889,22,6805329799,36647910
1634915867,-188125,true,6764622101,22,6796489060,31866959
1634915883,-188126,true,6763945706,22,6797848426,33902720
1634916287,-188121,true,6767328356,22,6795809479,28481123
1634916660,-188123,true,6765975093,22,6816908120,50933027
1634916785,-188128,true,6762593120,22,6822363555,59770435
1634916837,-188130,true,6761240804,22,6818271570,57030766
1634917152,-188124,true,6765298563,22,6824410469,59111906
1634917334,-188125,true,6764622101,22,6828506139,63884038
1634917491,-188130,true,6761240804,22,6830554896,69314092
1634917548,-188132,true,6759888759,22,6831237951,71349192
1634917553,-188127,true,6763269380,22,6831921075,68651695
1634917809,-188125,true,6764622101,22,6864105068,99482967
1634917994,-188127,true,6763269380,22,6884727270,121457890
1634918096,-188128,true,6762593120,22,6900579574,137986454
1634918307,-188121,true,6767328356,22,6926157729,158829373
1634918309,-188118,true,6769358757,22,6926850345,157491588
1634918414,-188115,true,6771389768,22,6947661056,176271288
1634918418,-188113,true,6772744114,22,6947661056,174916942
1634918440,-188103,true,6779519906,22,6951830695,172310789
1634918476,-188100,true,6781553966,22,6955307306,173753340
1634918576,-188098,true,6782910344,22,6962961970,180051626
1634918677,-188096,true,6784266994,22,6969928066,185661072
1634918835,-188086,true,6791054315,22,6981088319,190034004
1634918852,-188083,true,6793091835,22,6982484607,189392772
1634919016,-188082,true,6793771144,22,6989470234,195699090
1634919157,-188081,true,6794450521,22,6999961782,205511261
1634919399,-188073,true,6799887985,22,7002762186,202874201
1634919534,-188069,true,6802608348,22,7002762186,200153838
1634919589,-188065,true,6805329799,22,7002762186,197432387
1634919749,-188064,true,6806010332,22,6999961782,193951450
1634920338,-188056,true,6811457047,22,6989470234,178013187
1634920402,-188052,true,6814182038,22,6989470234,175288196
1634920425,-188050,true,6815544943,22,6988771357,173226414
1634920627,-188049,true,6816226497,22,6990169181,173942684
1634920770,-188042,true,6820999287,22,6981786428,160787141
1634921597,-188040,true,6822363555,22,6917160024,94796469
1634921768,-188037,true,6824410469,22,6915776800,91366331
1634922032,-188037,true,6824410469,22,6915776800,91366331
1634922084,-188030,true,6829188990,22,6915776800,86587810
1634922175,-188028,true,6830554896,22,6916468377,85913481
1634922298,-188024,true,6833287528,22,6917851740,84564212
1634922340,-188022,true,6834654254,22,6918543525,83889271
1634922520,-188015,true,6839439947,22,6918543525,79103578
1634922736,-188012,true,6841491984,22,6919927303,78435319
1634922794,-188006,true,6845597906,22,6919235380,73637474
1634922844,-188004,true,6846967094,22,6919235380,72268286
1634923065,-187997,true,6851761409,22,6917851740,66090331
1634923182,-187995,true,6853131830,22,6915776800,62644970
1634923276,-187988,true,6857930461,22,6915085291,57154830
1634923384,-187988,true,6857930461,22,6914393852,56463391
1634923779,-187982,true,6862046249,22,6910246667,48200418
1634923812,-187979,true,6864105068,22,6913011180,48906112
1634924441,-187971,true,6869598275,22,6959481534,89883259
1634924507,-187970,true,6870285234,22,6964354632,94069398
1634924547,-187966,true,6873033761,22,6967140792,94107031
1634924709,-187964,true,6874408436,22,6972019254,97610818
1634924981,-187957,true,6879221966,22,6966444148,87222182
1634925275,-187955,true,6880597879,22,6969928066,89330187
1634925390,-187949,true,6884727270,22,6973413728,88686458
1634925463,-187947,true,6886104285,22,6976901132,90796847
1634925636,-187939,true,6891615096,22,6985278019,93662923
1634925672,-187937,true,6892993488,22,6985976547,92983059
1634925698,-187931,true,6897130319,22,6987373812,90243493
1634925785,-187929,true,6898509814,22,6989470234,90960420
1634926157,-187918,true,6906101970,22,7018886269,112784299
1634926249,-187917,true,6906792580,22,7022396414,115603834
1634926331,-187911,true,6910937692,22,7022396414,111458722
1634926378,-187910,true,6911628785,22,7022396414,110767629
1634926524,-187904,true,6915776800,22,7022396414,106619614
1634926576,-187903,true,6916468377,22,7023800963,107332586
1634927246,-187893,true,6923387959,22,7064655330,141267371
1634927329,-187891,true,6924772706,22,7072430337,147657631
1634927345,-187883,true,6930314463,22,7073844894,143530431
1634927360,-187882,true,6931007495,22,7075259734,144252239
1634927719,-187873,true,6937247897,22,7081630015,144382118
1634927819,-187873,true,6937247897,22,7078798071,141550174
1634927909,-187866,true,6942105428,22,7069602072,127496644
1634928004,-187865,true,6942799638,22,7057594558,114794920
1634928159,-187861,true,6945577175,22,7037158203,91581028
1634928213,-187862,true,6944882686,22,7030827926,85945240
1634928313,-187855,true,6949745563,22,7018184450,68438887
1634929127,-187856,true,6949050658,22,6958785655,9734997
1634929283,-187851,true,6952525878,22,6957394107,4868229
1634929511,-187854,true,6950440538,22,6956698437,6257899
1634929627,-187848,true,6954611845,22,6956698437,2086592
1634929764,-187847,true,6955307306,22,6958785655,3478349
1634929796,-187843,true,6958089846,22,6958785655,695809
1634929840,-187842,true,6958785655,22,6957394107,-1391548
1634930627,-187836,true,6962961970,22,6940023213,-22938757
1634930852,-187836,true,6962961970,22,6940023213,-22938757
1634930918,-187833,true,6965051068,22,6940023213,-25027855
1634931065,-187833,true,6965051068,22,6940717215,-24333853
1634931235,-187828,true,6968534290,22,6942105428,-26428862
1634931412,-187828,true,6968534290,22,6942799638,-25734652
1634932086,-187825,true,6970625059,22,6942799638,-27825421
1634932165,-187826,true,6969928066,22,6942105428,-27822638
1634932188,-187821,true,6973413728,22,6941411287,-32002441
1634932378,-187821,true,6973413728,22,6939329280,-34084448
1634932396,-187819,true,6974808480,22,6938635416,-36173064
1634932580,-187824,true,6971322122,22,6928235785,-43086337
1634932712,-187822,true,6972716456,22,6920619296,-52097160
1634933168,-187824,true,6971322122,22,6904030553,-67291569
1634933375,-187822,true,6972716456,22,6901269631,-71446825
1634933426,-187827,true,6969231143,22,6901959758,-67271385
1634934232,-187826,true,6969928066,22,6910246667,-59681399
1634934307,-187828,true,6968534290,22,6910246667,-58287623
1634934506,-187828,true,6968534290,22,6909555711,-58978579
1634934587,-187833,true,6965051068,22,6910246667,-54804401
1634934606,-187831,true,6966444148,22,6910246667,-56197481
1634934619,-187833,true,6965051068,22,6910246667,-54804401
1634934638,-187834,true,6964354632,22,6909555711,-54798921
1634934804,-187837,true,6962265744,22,6915085291,-47180453
1634934858,-187836,true,6962961970,22,6917160024,-45801946
1634935114,-187837,true,6962265744,22,6925465183,-36800561
1634935363,-187838,true,6961569587,22,6934473692,-27095895
1634935369,-187841,true,6959481534,22,6934473692,-25007842
1634935774,-187838,true,6961569587,22,6960177482,-1392105
1634936069,-187839,true,6960873499,22,6974808480,13934981
1634936093,-187839,true,6960873499,22,6976203511,15330012
1634936157,-187842,true,6958785655,22,6979692311,20906656
1634936448,-187839,true,6960873499,22,6979692311,18818812
1634936771,-187840,true,6960177482,22,6970625059,10447577
1634936813,-187839,true,6960873499,22,6969231143,8357644
1634937120,-187840,true,6960177482,22,6963658267,3480785
1634937188,-187837,true,6962265744,22,6962961970,696226
1634937464,-187838,true,6961569587,22,6960873499,-696088
1634937495,-187836,true,6962961970,22,6960873499,-2088471
1634937512,-187837,true,6962265744,22,6959481534,-2784210
1634938009,-187834,true,6964354632,22,6962265744,-2088888
1634938033,-187835,true,6963658267,22,6962265744,-1392523
1634938204,-187834,true,6964354632,22,6953221131,-11133501
1634938261,-187835,true,6963658267,22,6949745563,-13912704
1634938350,-187834,true,6964354632,22,6946271732,-18082900
1634938956,-187832,true,6965747573,22,6962961970,-2785603
1634939118,-187830,true,6967140792,22,6976203511,9062719
1634939798,-187831,true,6966444148,22,6976901132,10456984
1634939937,-187830,true,6967140792,22,6972019254,4878462
1634939981,-187828,true,6968534290,22,6970625059,2090769
1634940100,-187826,true,6969928066,22,6969231143,-696923
1634940321,-187828,true,6968534290,22,6960177482,-8356808
1634940425,-187830,true,6967140792,22,6955307306,-11833486
1634940444,-187828,true,6968534290,22,6955307306,-13226984
1634940831,-187827,true,6969231143,22,6960873499,-8357644
1634940974,-187828,true,6968534290,22,6963658267,-4876023
1634940991,-187829,true,6967837506,22,6962961970,-4875536
1634941322,-187826,true,6969928066,22,6998561999,28633933
1634941552,-187825,true,6970625059,22,7006964894,36339835
1634941856,-187826,true,6969928066,22,7019588158,49660092
1634941874,-187827,true,6969231143,22,7020290116,51058973
1634942166,-187826,true,6969928066,22,7014676411,44748345
1634942371,-187824,true,6971322122,22,7013975013,42652891
1634942532,-187824,true,6971322122,22,7015377878,44055756
1634943059,-187828,true,6968534290,22,7022396414,53862124
1634943103,-187826,true,6969928066,22,7023098654,53170588
1634943214,-187824,true,6971322122,22,7025205794,53883672
1634943397,-187825,true,6970625059,22,7028016298,57391239
1634943557,-187826,true,6969928066,22,7030827926,60899860
1634943636,-187824,true,6971322122,22,7031531009,60208887
1634943685,-187826,true,6969928066,22,7032234162,62306096
1634943731,-187827,true,6969231143,22,7032937385,63706242
1634943883,-187829,true,6967837506,22,7034344043,66506537
1634944084,-187828,true,6968534290,22,7029421971,60887681
1634944215,-187830,true,6967140792,22,7025205794,58065002
1634944312,-187831,true,6966444148,22,7022396414,55952266
1634944736,-187833,true,6965051068,22,7008366357,43315289
1634944793,-187831,true,6966444148,22,7006264268,39820120
1634944829,-187829,true,6967837506,22,7005563712,37726206
1634944980,-187829,true,6967837506,22,6999961782,32124276
1634945144,-187832,true,6965747573,22,6994364331,28616758
1634945328,-187830,true,6967140792,22,6985976547,18835755
1634945384,-187828,true,6968534290,22,6983881173,15346883
1634945439,-187829,true,6967837506,22,6981088319,13250813
1634945961,-187832,true,6965747573,22,6956698437,-9049136
1634946098,-187831,true,6966444148,22,6953916453,-12527695
1634946250,-187829,true,6967837506,22,6952525878,-15311628
1634946296,-187829,true,6967837506,22,6952525878,-15311628
1634946308,-187831,true,6966444148,22,6952525878,-13918270
1634946637,-187830,true,6967140792,22,6951135582,-16005210
1634946685,-187828,true,6968534290,22,6951135582,-17398708
1634946730,-187829,true,6967837506,22,6951830695,-16006811
1634946743,-187831,true,6966444148,22,6951830695,-14613453
1634946969,-187829,true,6967837506,22,6953221131,-14616375
1634946980,-187828,true,6968534290,22,6953221131,-15313159
1634947200,-187826,true,6969928066,22,6963658267,-6269799
1634947223,-187829,true,6967837506,22,6965051068,-2786438
1634947241,-187825,true,6970625059,22,6966444148,-4180911
1634947354,-187822,true,6972716456,22,6976901132,4184676
1634947447,-187819,true,6974808480,22,6983881173,9072693
1634947451,-187821,true,6973413728,22,6984579562,11165834
1634947647,-187817,true,6976203511,22,7000661778,24458267
1634947936,-187814,true,6978296582,22,7020992145,42695563
1634947976,-187811,true,6980390280,22,7020992145,40601865
1634948090,-187813,true,6978994411,22,7023098654,44104243
1634948147,-187809,true,6981786428,22,7023098654,41312226
1634948361,-187807,true,6983182855,22,7023098654,39915799
1634948405,-187804,true,6985278019,22,7022396414,37118395
1634948512,-187806,true,6983881173,22,7020992145,37110972
1634948839,-187803,true,6985976547,22,7015377878,29401331
1634948863,-187800,true,6988072550,22,7014676411,26603861
1634949130,-187800,true,6988072550,22,7004863225,16790675
1634949564,-187801,true,6987373812,22,7018886269,31512457
1634949645,-187797,true,6990169181,22,7021694245,31525064
1634949699,-187795,true,6991567285,22,7021694245,30126960
1634949714,-187793,true,6992965668,22,7021694245,28728577
1634949869,-187797,true,6990169181,22,7026610905,36441724
1634949979,-187794,true,6992266442,22,7030124914,37858472
1634950009,-187793,true,6992965668,22,7030827926,37862258
1634950025,-187791,true,6994364331,22,7031531009,37166678
1634950345,-187794,true,6992266442,22,7028719099,36452657
1634950386,-187790,true,6995063768,22,7028016298,32952530
1634950621,-187788,true,6996462851,22,7032937385,36474534
1634950782,-187786,true,6997862213,22,7039269561,41407348
1634950862,-187788,true,6996462851,22,7041381553,44918702
1634950887,-187784,true,6999261856,22,7042085692,42823836
1634950989,-187782,true,7000661778,22,7044198529,43536751
1634951151,-187780,true,7002061980,22,7046311999,44250019
1634951414,-187783,true,6999961782,22,7048426104,48464322
1634951577,-187779,true,7002762186,22,7041381553,38619367
1634951641,-187777,true,7004162809,22,7039269561,35106752
1634951787,-187775,true,7005563712,22,7034344043,28780331
1634952012,-187776,true,7004863225,22,7026610905,21747680
1634952031,-187776,true,7004863225,22,7025908314,21045089
1634952070,-187774,true,7006264268,22,7023800963,17536695
1634952102,-187773,true,7006964894,22,7022396414,15431520
1634952336,-187774,true,7006264268,22,7016079416,9815148
1634952343,-187773,true,7006964894,22,7015377878,8412984
1634952412,-187771,true,7008366357,22,7015377878,7011521
1634952447,-187768,true,7010469078,22,7015377878,4908800
1634952637,-187769,true,7009768101,22,7016079416,6311315
1634952716,-187768,true,7010469078,22,7018886269,8417191
1634952773,-187766,true,7011871241,22,7021694245,9823004
1634952828,-187764,true,7013273686,22,7023800963,10527277
1634952892,-187763,true,7013975013,22,7030827926,16852913
1634953080,-187761,true,7015377878,22,7052656218,37278340
1634953175,-187760,true,7016079416,22,7062536357,46456941
1634953317,-187759,true,7016781024,22,7068188364,51407340
1634953348,-187759,true,7016781024,22,7069602072,52821048
1634953433,-187757,true,7018184450,22,7075967260,57782810
1634953551,-187757,true,7018184450,22,7084463092,66278642
1634953751,-187757,true,7018184450,22,7075967260,57782810
1634953868,-187757,true,7018184450,22,7063948935,45764485
1634953943,-187756,true,7018886269,22,7057594558,38708289
1634954047,-187756,true,7018886269,22,7054772226,35885957
1634954056,-187755,true,7019588158,22,7054066819,34478661
1634954102,-187755,true,7019588158,22,7051951022,32362864
1634954183,-187756,true,7018886269,22,7044198529,25312260
1634954248,-187759,true,7016781024,22,7039269561,22488537
1634954338,-187758,true,7017482702,22,7032234162,14751460
1634954386,-187758,true,7017482702,22,7028016298,10533596
1634954509,-187757,true,7018184450,22,7020290116,2105666
1634954538,-187760,true,7016079416,22,7017482702,1403286
1634954549,-187760,true,7016079416,22,7016079416,0
1634955141,-187762,true,7014676411,22,6954611845,-60064566
1634955189,-187762,true,7014676411,22,6948355822,-66320589
1634955376,-187765,true,7012572429,22,6926157729,-86414700
1634955464,-187764,true,7013273686,22,6924080298,-89193388
1634955507,-187767,true,7011170124,22,6923387959,-87782165
1634955518,-187766,true,7011871241,22,6923387959,-88483282
1634955594,-187768,true,7010469078,22,6922003489,-88465589
1634955772,-187767,true,7011170124,22,6919927303,-91242821
1634956247,-187769,true,7009768101,22,6924772706,-84995395
1634956255,-187768,true,7010469078,22,6924772706,-85696372
1634956295,-187770,true,7009067194,22,6925465183,-83602011
1634956413,-187769,true,7009768101,22,6926157729,-83610372
1634956512,-187770,true,7009067194,22,6927543030,-81524164
1634956629,-187769,true,7009768101,22,6928928608,-80839493
1634956719,-187771,true,7008366357,22,6929621501,-78744856
1634956758,-187770,true,7009067194,22,6931007495,-78059699
1634956769,-187771,true,7008366357,22,6931007495,-77358862
1634956857,-187770,true,7009067194,22,6933087005,-75980189
1634957073,-187771,true,7008366357,22,6939329280,-69037077
1634957251,-187772,true,7007665591,22,6944188268,-63477323
1634957286,-187773,true,7006964894,22,6944882686,-62082208
1634957347,-187774,true,7006264268,22,6944882686,-61381582
1634957440,-187776,true,7004863225,22,6943493918,-61369307
1634957584,-187778,true,7003462463,22,6939329280,-64133183
1634957908,-187782,true,7000661778,22,6904030553,-96631225
1634957956,-187783,true,6999961782,22,6898509814,-101451968
1634958137,-187786,true,6997862213,22,6878534113,-119328100
1634958238,-187789,true,6995763274,22,6870285234,-125478040
1634958312,-187792,true,6993664965,22,6868911384,-124753581
1634958477,-187792,true,6993664965,22,6872346526,-121318439
1634958622,-187793,true,6992965668,22,6882662265,-110303403
1634958856,-187797,true,6990169181,22,6890926004,-99243177
1634958887,-187800,true,6988072550,22,6892304258,-95768292
1634958904,-187800,true,6988072550,22,6892993488,-95079062
1634958951,-187802,true,6986675145,22,6890926004,-95749141
1634958961,-187806,true,6983881173,22,6891615096,-92266077
1634958995,-187809,true,6981786428,22,6893682788,-88103640
1634959007,-187810,true,6981088319,22,6894372156,-86716163
1634959440,-187812,true,6979692311,22,6877158612,-102533699
1634959475,-187817,true,6976203511,22,6875783387,-100420124
1634959715,-187819,true,6974808480,22,6871659360,-103149120
1634959920,-187819,true,6974808480,22,6873033761,-101774719
1634960077,-187821,true,6973413728,22,6875783387,-97630341
1634960280,-187826,true,6969928066,22,6879221966,-90706100
1634960497,-187829,true,6967837506,22,6884038866,-83798640
1634960522,-187829,true,6967837506,22,6884727270,-83110236
1634960555,-187831,true,6966444148,22,6884727270,-81716878
1634960606,-187836,true,6962961970,22,6884727270,-78234700
1634960610,-187840,true,6960177482,22,6884727270,-75450212
1634960714,-187839,true,6960873499,22,6888859139,-72014360
1634960823,-187840,true,6960177482,22,6893682788,-66494694
1634960847,-187844,true,6957394107,22,6895061593,-62332514
1634960920,-187848,true,6954611845,22,6897820032,-56791813
1634961141,-187847,true,6955307306,22,6905411429,-49895877
1634961685,-187848,true,6954611845,22,6917160024,-37451821
1634961860,-187852,true,6951830695,22,6917160024,-34670671
1634962143,-187855,true,6949745563,22,6918543525,-31202038
1634962619,-187854,true,6950440538,22,6906101970,-44338568
1634962657,-187855,true,6949745563,22,6905411429,-44334134
1634963070,-187858,true,6947661056,22,6906101970,-41559086
1634963122,-187862,true,6944882686,22,6907483259,-37399427
1634963451,-187860,true,6946271732,22,6921311358,-24960374
1634963631,-187861,true,6945577175,22,6926157729,-19419446
1634963679,-187864,true,6943493918,22,6926850345,-16643573
1634963854,-187867,true,6941411287,22,6927543030,-13868257
1634964138,-187866,true,6942105428,22,6927543030,-14562398
1634964464,-187868,true,6940717215,22,6924772706,-15944509
1634965207,-187872,true,6937941622,22,6915085291,-22856331
1634965234,-187877,true,6934473692,22,6915085291,-19388401
1634965326,-187878,true,6933780313,22,6913702481,-20077832
1634965337,-187880,true,6932393765,22,6914393852,-17999913
1634965460,-187881,true,6931700595,22,6926850345,-4850250
1634966075,-187884,true,6929621501,22,6985278019,55656518
1634966157,-187883,true,6930314463,22,6990169181,59854718
1634966217,-187885,true,6928928608,22,6992965668,64037060
1634966247,-187885,true,6928928608,22,6992965668,64037060
1634966567,-187887,true,6927543030,22,6998561999,71018969
1634966698,-187886,true,6928235785,22,6995063768,66827983
1634967286,-187889,true,6926157729,22,6983881173,57723444
1634967337,-187889,true,6926157729,22,6981088319,54930590
1634967431,-187892,true,6924080298,22,6976901132,52820834
1634967848,-187890,true,6925465183,22,6978994411,53529228
1634967869,-187890,true,6925465183,22,6979692311,54227128
1634967929,-187890,true,6925465183,22,6981088319,55623136
1634968186,-187893,true,6923387959,22,6985278019,61890060
1634968230,-187890,true,6925465183,22,6986675145,61209962
1634968527,-187890,true,6925465183,22,6990169181,64703998
1634968622,-187889,true,6926157729,22,6990169181,64011452
1634968715,-187889,true,6926157729,22,6996462851,70305122
1634968774,-187885,true,6928928608,22,6999961782,71033174
1634968883,-187883,true,6930314463,22,7004863225,74548762
1634968928,-187882,true,6931007495,22,7007665591,76658096
1634969222,-187881,true,6931700595,22,7024503344,92802749
1634969385,-187877,true,6934473692,22,7033640679,99166987
1634969435,-187876,true,6935167139,22,7036454557,101287418
1634969443,-187874,true,6936554242,22,7037158203,100603961
1634969560,-187873,true,6937247897,22,7044198529,106950632
1634969886,-187869,true,6940023213,22,7042789900,102766687
1634970013,-187869,true,6940023213,22,7034344043,94320830
1634970125,-187868,true,6940717215,22,7027313566,86596351
1634970290,-187868,true,6940717215,22,7016781024,76063809
1634970310,-187866,true,6942105428,22,7016079416,73973988
1634970394,-187865,true,6942799638,22,7011170124,68370486
1634970470,-187864,true,6943493918,22,7006964894,63470976
1634970538,-187863,true,6944188268,22,7004863225,60674957
1634971209,-187861,true,6945577175,22,7006964894,61387719
1634971413,-187861,true,6945577175,22,7009067194,63490019
1634972033,-187860,true,6946271732,22,7011871241,65599509
1634972070,-187859,true,6946966360,22,7011871241,64904881
1634972096,-187857,true,6948355822,22,7015377878,67022056
1634972445,-187856,true,6949050658,22,7027313566,78262908
1634972473,-187852,true,6951830695,22,7028719099,76888404
1634972551,-187849,true,6953916453,22,7028719099,74802646
1634972729,-187847,true,6955307306,22,7028016298,72708992
1634972870,-187846,true,6956002836,22,7027313566,71310730
1634973197,-187841,true,6959481534,22,7023800963,64319429
1634973282,-187839,true,6960873499,22,7021694245,60820746
1634973324,-187838,true,6961569587,22,7020992145,59422558
1634973436,-187839,true,6960873499,22,7018886269,58012770
1634974426,-187834,true,6964354632,22,7017482702,53128070
1634975431,-187834,true,6964354632,22,6938635416,-25719216
1634975507,-187833,true,6965051068,22,6938635416,-26415652
1634975650,-187832,true,6965747573,22,6940023213,-25724360
1634976225,-187829,true,6967837506,22,6946271732,-21565774
1634976287,-187829,true,6967837506,22,6946966360,-20871146
1634976639,-187828,true,6968534290,22,6951135582,-17398708
1634977195,-187827,true,6969231143,22,6953916453,-15314690
1634977424,-187823,true,6972019254,22,6953916453,-18102801
1634977553,-187823,true,6972019254,22,6953221131,-18798123
1634978232,-187822,true,6972716456,22,6953916453,-18800003
1634978278,-187822,true,6972716456,22,6953916453,-18800003
1634978387,-187818,true,6975505961,22,6953221131,-22284830
1634978494,-187819,true,6974808480,22,6952525878,-22282602
1634978516,-187818,true,6975505961,22,6952525878,-22980083
1634979109,-187817,true,6976203511,22,6968534290,-7669221
1634979457,-187813,true,6978994411,22,6978994411,0
1634979806,-187813,true,6978994411,22,6975505961,-3488450
1634980027,-187813,true,6978994411,22,6967140792,-11853619
1634980310,-187813,true,6978994411,22,6957394107,-21600304
1634980499,-187810,true,6981088319,22,6953916453,-27171866
1634980521,-187811,true,6980390280,22,6953916453,-26473827
1634980664,-187811,true,6980390280,22,6950440538,-29949742
1634981543,-187811,true,6980390280,22,6953916453,-26473827
1634981820,-187808,true,6982484607,22,6954611845,-27872762
1634981925,-187808,true,6982484607,22,6954611845,-27872762
1634982229,-187808,true,6982484607,22,6956002836,-26481771
1634982424,-187807,true,6983182855,22,6956698437,-26484418
1634982457,-187805,true,6984579562,22,6956698437,-27881125
1634982718,-187805,true,6984579562,22,6956698437,-27881125
1634982799,-187806,true,6983881173,22,6956002836,-27878337
1634982858,-187805,true,6984579562,22,6956002836,-28576726
1634982947,-187803,true,6985976547,22,6956002836,-29973711
1634983012,-187803,true,6985976547,22,6956002836,-29973711
1634983183,-187804,true,6985278019,22,6956698437,-28579582
1634983493,-187803,true,6985976547,22,6957394107,-28582440
1634983550,-187800,true,6988072550,22,6957394107,-30678443
1634983725,-187801,true,6987373812,22,6953916453,-33457359
1634983878,-187802,true,6986675145,22,6953916453,-32758692
1634984006,-187801,true,6987373812,22,6956698437,-30675375
1634984029,-187801,true,6987373812,22,6956698437,-30675375
1634984033,-187802,true,6986675145,22,6956698437,-29976708
1634984089,-187803,true,6985976547,22,6956698437,-29278110
1634984501,-187803,true,6985976547,22,6953916453,-32060094
1634984589,-187803,true,6985976547,22,6954611845,-31364702
1634985223,-187804,true,6985278019,22,6973413728,-11864291
1634985287,-187805,true,6984579562,22,6975505961,-9073601
1634985389,-187804,true,6985278019,22,6979692311,-5585708
1634985442,-187804,true,6985278019,22,6981786428,-3491591
1634986557,-187803,true,6985976547,22,6990868198,4891651
1634986665,-187804,true,6985278019,22,6990169181,4891162
1634987178,-187803,true,6985976547,22,6989470234,3493687
1634987246,-187803,true,6985976547,22,6989470234,3493687
1634987390,-187804,true,6985278019,22,6985976547,698528
1634987567,-187805,true,6984579562,22,6981786428,-2793134
1634987633,-187805,true,6984579562,22,6981088319,-3491243
1634987739,-187804,true,6985278019,22,6981786428,-3491591
1634988039,-187804,true,6985278019,22,6988072550,2794531
1634988072,-187805,true,6984579562,22,6988072550,3492988
1634988114,-187806,true,6983881173,22,6988072550,4191377
1634988440,-187807,true,6983182855,22,6991567285,8384430
1634988597,-187808,true,6982484607,22,6991567285,9082678
1634988634,-187809,true,6981786428,22,6991567285,9780857
1634988679,-187810,true,6981088319,22,6990868198,9779879
1634988694,-187811,true,6980390280,22,6990868198,10477918
1634988722,-187811,true,6980390280,22,6991567285,11177005
1634988928,-187814,true,6978296582,22,6979692311,1395729
1634989224,-187814,true,6978296582,22,6971322122,-6974460
1634989260,-187815,true,6977598822,22,6970625059,-6973763
1634989493,-187814,true,6978296582,22,6964354632,-13941950
1634989715,-187816,true,6976901132,22,6956698437,-20202695
1634989731,-187816,true,6976901132,22,6956698437,-20202695
1634989851,-187817,true,6976203511,22,6956698437,-19505074
1634989875,-187817,true,6976203511,22,6957394107,-18809404
1634989883,-187819,true,6974808480,22,6957394107,-17414373
1634990134,-187820,true,6974111069,22,6956698437,-17412632
1634990205,-187821,true,6973413728,22,6956698437,-16715291
1634990329,-187821,true,6973413728,22,6953916453,-19497275
1634990626,-187823,true,6972019254,22,6948355822,-23663432
1634990714,-187825,true,6970625059,22,6946271732,-24353327
1634990744,-187828,true,6968534290,22,6944882686,-23651604
1634990860,-187828,true,6968534290,22,6939329280,-29205010
1634990953,-187831,true,6966444148,22,6934473692,-31970456
1634990970,-187832,true,6965747573,22,6933780313,-31967260
1634991021,-187835,true,6963658267,22,6932393765,-31264502
1634991031,-187835,true,6963658267,22,6932393765,-31264502
1634991082,-187836,true,6962961970,22,6931700595,-31261375
1634991107,-187837,true,6962265744,22,6931007495,-31258249
1634991379,-187839,true,6960873499,22,6933780313,-27093186
1634991603,-187837,true,6962265744,22,6935860656,-26405088
1634991824,-187838,true,6961569587,22,6942799638,-18769949
1634992099,-187839,true,6960873499,22,6944188268,-16685231
1634992347,-187839,true,6960873499,22,6942799638,-18073861
1634992405,-187837,true,6962265744,22,6944882686,-17383058
1634992437,-187839,true,6960873499,22,6944882686,-15990813
1634992673,-187840,true,6960177482,22,6944188268,-15989214
1634992679,-187840,true,6960177482,22,6943493918,-16683564
1634992772,-187838,true,6961569587,22,6943493918,-18075669
1634992976,-187839,true,6960873499,22,6949745563,-11127936
1634992985,-187839,true,6960873499,22,6949745563,-11127936
1634993075,-187839,true,6960873499,22,6953916453,-6957046
1634993240,-187837,true,6962265744,22,6960177482,-2088262
1634993305,-187837,true,6962265744,22,6960177482,-2088262
1634993390,-187839,true,6960873499,22,6963658267,2784768
1634993422,-187839,true,6960873499,22,6960873499,0
1634993545,-187839,true,6960873499,22,6957394107,-3479392
1634993597,-187840,true,6960177482,22,6956698437,-3479045
1634993883,-187842,true,6958785655,22,6942105428,-16680227
1634993910,-187842,true,6958785655,22,6940023213,-18762442
1634994055,-187841,true,6959481534,22,6929621501,-29860033
1634994067,-187842,true,6958785655,22,6928928608,-29857047
1634994591,-187844,true,6957394107,22,6923387959,-34006148
1634994829,-187844,true,6957394107,22,6927543030,-29851077
1634994980,-187843,true,6958089846,22,6929621501,-28468345
1634995291,-187844,true,6957394107,22,6930314463,-27079644
1634995295,-187846,true,6956002836,22,6931007495,-24995341
1634995348,-187846,true,6956002836,22,6930314463,-25688373
1634995359,-187845,true,6956698437,22,6929621501,-27076936
1634995397,-187845,true,6956698437,22,6931007495,-25690942
1634995493,-187846,true,6956002836,22,6934473692,-21529144
1634995620,-187846,true,6956002836,22,6937247897,-18754939
1634995678,-187845,true,6956698437,22,6937941622,-18756815
1634995767,-187847,true,6955307306,22,6933087005,-22220301
1634995861,-187848,true,6954611845,22,6935860656,-18751189
1634995891,-187848,true,6954611845,22,6936554242,-18057603
1634995932,-187847,true,6955307306,22,6937247897,-18059409
1634996014,-187847,true,6955307306,22,6937941622,-17365684
1634996752,-187846,true,6956002836,22,6985976547,29973711
1634996793,-187845,true,6956698437,22,6988072550,31374113
1634996803,-187845,true,6956698437,22,6988072550,31374113
1634997218,-187846,true,6956002836,22,6984579562,28576726
1634997244,-187844,true,6957394107,22,6983881173,26487066
1634997348,-187844,true,6957394107,22,6981088319,23694212
1634997571,-187845,true,6956698437,22,6973413728,16715291
1634997612,-187846,true,6956002836,22,6974111069,18108233
1634997814,-187844,true,6957394107,22,6979692311,22298204
1634997976,-187844,true,6957394107,22,6985278019,27883912
1634998116,-187844,true,6957394107,22,6985976547,28582440
1634998204,-187846,true,6956002836,22,6985976547,29973711
1634998286,-187844,true,6957394107,22,6988072550,30678443
1634998316,-187844,true,6957394107,22,6988072550,30678443
1634998386,-187845,true,6956698437,22,6990169181,33470744
1634998888,-187845,true,6956698437,22,6984579562,27881125
1634998940,-187843,true,6958089846,22,6985278019,27188173
1634999041,-187843,true,6958089846,22,6988072550,29982704
1634999277,-187845,true,6956698437,22,6991567285,34868848
1634999355,-187846,true,6956002836,22,6990868198,34865362
1634999407,-187844,true,6957394107,22,6987373812,29979705
1634999514,-187845,true,6956698437,22,6978994411,22295974
1634999548,-187847,true,6955307306,22,6978994411,23687105
1634999670,-187848,true,6954611845,22,6978994411,24382566
1634999733,-187846,true,6956002836,22,6978994411,22991575
1634999862,-187844,true,6957394107,22,6982484607,25090500
1635000104,-187847,true,6955307306,22,6984579562,29272256
1635000487,-187845,true,6956698437,22,7003462463,46764026
1635000639,-187843,true,6958089846,22,7006264268,48174422
1635000764,-187842,true,6958785655,22,6998561999,39776344
1635000800,-187845,true,6956698437,22,6996462851,39764414
1635001064,-187844,true,6957394107,22,6983182855,25788748
1635001967,-187843,true,6958089846,22,6958089846,0
1635001983,-187842,true,6958785655,22,6957394107,-1391548
1635001998,-187845,true,6956698437,22,6957394107,695670
1635002012,-187845,true,6956698437,22,6958089846,1391409
1635002276,-187838,true,6961569587,22,6983881173,22311586
1635002347,-187836,true,6962961970,22,6990868198,27906228
1635002457,-187839,true,6960873499,22,6998561999,37688500
1635002521,-187839,true,6960873499,22,7000661778,39788279
1635002581,-187833,true,6965051068,22,7002762186,37711118
1635002686,-187832,true,6965747573,22,7006264268,40516695
1635002746,-187835,true,6963658267,22,7008366357,44708090
1635002784,-187834,true,6964354632,22,7009768101,45413469
1635003010,-187828,true,6968534290,22,7009768101,41233811
1635003192,-187827,true,6969231143,22,6999961782,30730639
1635003293,-187830,true,6967140792,22,6995763274,28622482
1635003347,-187830,true,6967140792,22,6994364331,27223539
1635003387,-187824,true,6971322122,22,6994364331,23042209
1635003400,-187824,true,6971322122,22,6994364331,23042209
1635003516,-187826,true,6969928066,22,6999261856,29333790
1635003601,-187827,true,6969231143,22,6997162497,27931354
1635003634,-187820,true,6974111069,22,6996462851,22351782
1635003654,-187820,true,6974111069,22,6995763274,21652205
1635003722,-187824,true,6971322122,22,6993664965,22342843
1635003754,-187826,true,6969928066,22,6992266442,22338376
1635003771,-187819,true,6974808480,22,6991567285,16758805
1635003852,-187819,true,6974808480,22,6989470234,14661754
1635004020,-187823,true,6972019254,22,6983881173,11861919
1635004103,-187824,true,6971322122,22,6981786428,10464306
1635004154,-187819,true,6974808480,22,6979692311,4883831
1635004184,-187819,true,6974808480,22,6978994411,4185931
1635004209,-187823,true,6972019254,22,6977598822,5579568
1635004266,-187826,true,6969928066,22,6974111069,4183003
1635004292,-187820,true,6974111069,22,6972716456,-1394613
1635004334,-187820,true,6974111069,22,6968534290,-5576779
1635004463,-187823,true,6972019254,22,6960177482,-11841772
1635004499,-187825,true,6970625059,22,6959481534,-11143525
1635004620,-187818,true,6975505961,22,6959481534,-16024427
1635004681,-187818,true,6975505961,22,6960177482,-15328479
1635004684,-187820,true,6974111069,22,6960177482,-13933587
1635004806,-187821,true,6973413728,22,6961569587,-11844141
1635004875,-187815,true,6977598822,22,6962265744,-15333078
1635004974,-187815,true,6977598822,22,6961569587,-16029235
1635005110,-187817,true,6976203511,22,6962265744,-13937767
1635005145,-187818,true,6975505961,22,6963658267,-11847694
1635005466,-187811,true,6980390280,22,6978296582,-2093698
1635005629,-187811,true,6980390280,22,6981786428,1396148
1635005704,-187813,true,6978994411,22,6985278019,6283608
1635005714,-187814,true,6978296582,22,6985278019,6981437
1635005923,-187808,true,6982484607,22,6994364331,11879724
1635005961,-187807,true,6983182855,22,6996462851,13279996
1635006116,-187809,true,6981786428,22,6999961782,18175354
1635006218,-187810,true,6981088319,22,7001361844,20273525
1635006230,-187803,true,6985976547,22,7001361844,15385297
1635006426,-187803,true,6985976547,22,7003462463,17485916
1635006502,-187804,true,6985278019,22,7003462463,18184444
1635006582,-187807,true,6983182855,22,7002061980,18879125
1635006652,-187803,true,6985976547,22,6999961782,13985235
1635006699,-187803,true,6985976547,22,6999261856,13285309
1635006797,-187804,true,6985278019,22,6997862213,12584194
1635006926,-187805,true,6984579562,22,7006264268,21684706
1635006973,-187798,true,6989470234,22,7011871241,22401007
1635006987,-187797,true,6990169181,22,7016079416,25910235
1635007072,-187794,true,6992266442,22,7034344043,42077601
1635007147,-187787,true,6997162497,22,7065361795,68199298
1635007207,-187776,true,7004863225,22,7097225971,92362746
1635007255,-187771,true,7008366357,22,7132085972,123719615
1635007264,-187763,true,7013975013,22,7139935191,125960178
1635007385,-187749,true,7023800963,22,7221792057,197991094
1635007499,-187736,true,7032937385,22,7300206164,267268779
1635007649,-187726,true,7039973488,22,7440973109,400999621
1635007665,-187718,true,7045607439,22,7455869201,410261762
1635007775,-187701,true,7057594558,22,7553423352,495828794
1635007804,-187684,true,7069602072,22,7578389572,508787500
1635007841,-187676,true,7075259734,22,7604959077,529699343
1635007882,-187667,true,7081630015,22,7636201851,554571836
1635007923,-187651,true,7092969125,22,7665273165,572304040
1635007959,-187634,true,7105036824,22,7689840096,584803272
1635007981,-187623,true,7112856273,22,7703693580,590837307
1635008107,-187615,true,7118548550,22,7750052361,631503811
1635008113,-187600,true,7129233851,22,7750827366,621593515
1635008116,-187585,true,7139935191,22,7751602449,611667258
1635008153,-187575,true,7147078340,22,7758581683,611503343
1635008229,-187563,true,7155659552,22,7778779231,623119679
1635008309,-187547,true,7167117198,22,7804490316,637373118
1635008331,-187531,true,7178593190,22,7812298320,633705130
1635008382,-187518,true,7187930963,22,7839687898,651756935
1635008390,-187503,true,7198720410,22,7844392887,645672477
1635008431,-187480,true,7215295692,22,7860096586,644800894
1635008494,-187463,true,7227571513,22,7871894988,644323475
1635008537,-187452,true,7235525818,22,7878194708,642668890
1635008560,-187438,true,7245662141,22,7882134594,636472453
1635008586,-187415,true,7262345508,22,7891598359,629252851
1635008601,-187404,true,7270338084,22,7893176758,622838674
1635008672,-187395,true,7276884006,22,7901073487,624189481
1635008690,-187381,true,7287078268,22,7903444046,616365778
1635008753,-187360,true,7302396445,22,7915307515,612911070
1635008779,-187348,true,7311164142,22,7917682344,606518202
1635008793,-187338,true,7318478597,22,7920057887,601579290
1635008862,-187323,true,7329464003,22,7930360142,600896139
1635008962,-187303,true,7344136865,22,7947030562,602893697
1635009010,-187291,true,7352954678,22,7954981170,602026492
1635009044,-187281,true,7360310942,22,7957367903,597056961
1635009072,-187267,true,7370622078,22,7958163640,587541562
1635009095,-187247,true,7385377335,22,7958959456,573582121
1635009117,-187235,true,7394244664,22,7959755352,565510688
1635009144,-187224,true,7402382401,22,7964532399,562149998
1635009152,-187210,true,7412752475,22,7963736026,550983551
1635009180,-187190,true,7427592073,22,7962939732,535347659
1635009253,-187180,true,7435023008,22,7954185751,519162743
1635009269,-187169,true,7443205624,22,7953390412,510184788
1635009272,-187154,true,7454378251,22,7952595153,498216902
1635009345,-187133,true,7470048110,22,7937500321,467452211
1635009349,-187121,true,7479017099,22,7936706651,457689552
1635009412,-187114,true,7484253982,22,7924018708,439764726
1635009484,-187099,true,7495488225,22,7906605898,411117673
1635009502,-187079,true,7510493451,22,7907396559,396903108
1635009523,-187066,true,7520262953,22,7909769015,389506062
1635009638,-187057,true,7527033898,22,7905815317,378781419
1635009689,-187041,true,7539086189,22,7904234391,365148202
1635009706,-187020,true,7554934112,22,7903444046,348509934
1635009733,-187008,true,7564005021,22,7901073487,337068466
1635009748,-186999,true,7570815349,22,7899493510,328678161
1635009779,-186985,true,7581421383,22,7893966075,312544692
1635009804,-186966,true,7595839055,22,7892387519,296548464
1635009816,-186954,true,7604959077,22,7891598359,286639282
1635009827,-186945,true,7611806278,22,7892387519,280581241
1635009846,-186926,true,7626281734,22,7896334502,270052768
1635009852,-186903,true,7643841490,22,7896334502,252493012
1635009885,-186891,true,7653019146,22,7899493510,246474364
1635009953,-186883,true,7659143705,22,7903444046,244300341
1635009990,-186867,true,7671407530,22,7900283459,228875929
1635010036,-186844,true,7689071189,22,7901863595,212792406
1635010045,-186832,true,7698303151,22,7901863595,203560444
1635010081,-186823,true,7705234396,22,7909769015,204534619
1635010130,-186804,true,7719887525,22,7920849892,200962367
1635010153,-186781,true,7737662811,22,7922434142,184771331
1635010202,-186772,true,7744629494,22,7919265960,174636466
1635010345,-186767,true,7748502583,22,7927981509,179478926
1635010382,-186749,true,7762461749,22,7930360142,167898393
1635010442,-186726,true,7780335064,22,7927981509,147646445
1635010456,-186716,true,7788118901,22,7930360142,142241241
1635010478,-186709,true,7793572220,22,7933532762,139960542
1635010505,-186686,true,7811517168,22,7943058239,131541071
1635010512,-186658,true,7833418969,22,7944646930,111227961
1635010532,-186649,true,7840471867,22,7947825265,107353398
1635010557,-186639,true,7848315868,22,7954981170,106665302
1635010595,-186617,true,7865600305,22,7966921998,101321693
1635010618,-186590,true,7886865057,22,7974095097,87230040
1635010654,-186578,true,7896334502,22,7992455704,96121202
1635010675,-186568,true,7904234391,22,8004452783,100218392
1635010706,-186550,true,7918474113,22,8018071244,99597131
1635010755,-186528,true,7935913059,22,8036533108,100620049
1635010763,-186522,true,7940675798,22,8039748204,99072406
1635010765,-186516,true,7945441395,22,8040552179,95110784
1635010834,-186500,true,7958163640,22,8071969986,113806346
1635010850,-186484,true,7970906256,22,8078429823,107523567
1635010886,-186480,true,7974095097,22,8097840367,123745270
1635010910,-186478,true,7975689995,22,8109184716,133494721
1635010974,-186461,true,7989259521,22,8141684786,152425265
1635011038,-186449,true,7998851907,22,8163695936,164844029
1635011120,-186447,true,8000451757,22,8214465536,214013779
1635011165,-186444,true,8002852133,22,8237497117,234644984
1635011217,-186428,true,8015666304,22,8261419333,245753029
1635011226,-186416,true,8025290396,22,8265550869,240260473
1635011240,-186417,true,8024487947,22,8272165624,247677677
1635011270,-186415,true,8026092925,22,8287896892,261803967
1635011328,-186396,true,8041356234,22,8317785594,276429360
1635011335,-186382,true,8052621453,22,8321113208,268491755
1635011468,-186385,true,8050206150,22,8350286669,300080519
1635011509,-186384,true,8051011170,22,8357804934,306793764
1635011572,-186369,true,8063096144,22,8364493518,301397374
1635011581,-186357,true,8072777183,22,8366166501,293389318
1635011632,-186357,true,8072777183,22,8371187456,298410273
1635011688,-186360,true,8070355834,22,8371187456,300831622
1635011696,-186347,true,8080853594,22,8371187456,290333862
1635011726,-186342,true,8084894829,22,8367003117,282108288
1635011762,-186345,true,8082469846,22,8361148557,278678711
1635011816,-186347,true,8080853594,22,8356969237,276115643
1635011845,-186335,true,8090555953,22,8346947389,256391436
1635011867,-186330,true,8094602041,22,8339438891,244836850
1635011895,-186334,true,8091365009,22,8332770341,241405332
1635011914,-186336,true,8089746979,22,8328605206,238858227
1635011951,-186325,true,8098650151,22,8318617373,219967222
1635011955,-186317,true,8105131339,22,8317785594,212654255
1635011985,-186318,true,8104320907,22,8311134359,206813452
1635012127,-186320,true,8102700286,22,8287068186,184367900
1635012156,-186308,true,8112428876,22,8284582562,172153686
1635012162,-186300,true,8118921091,22,8284582562,165661471
1635012210,-186301,true,8118109280,22,8277957878,159848598
1635012255,-186302,true,8117297550,22,8272992841,155695291
1635012289,-186291,true,8126231044,22,8266377424,140146380
1635012305,-186283,true,8132734304,22,8263071699,130337395
1635012374,-186286,true,8130294972,22,8251512071,121217099
1635012377,-186290,true,8127043667,22,8250687002,123643335
1635012428,-186280,true,8135174368,22,8236673450,101499082
1635012496,-186272,true,8141684786,22,8216930122,75245336
1635012505,-186274,true,8140056694,22,8213644171,73587477
1635012565,-186278,true,8136801485,22,8192317500,55516015
1635012642,-186269,true,8144127536,22,8171863307,27735771
1635012676,-186263,true,8149015234,22,8165328757,16313523
1635012721,-186266,true,8146571019,22,8154721257,8150238
1635012743,-186267,true,8145756443,22,8152275329,6518886
1635012760,-186256,true,8154721257,22,8151460183,-3261074
1635012829,-186251,true,8158799433,22,8140870699,-17928734
1635012836,-186256,true,8154721257,22,8139242769,-15478488
1635012854,-186259,true,8152275329,22,8135987886,-16287443
1635012886,-186251,true,8158799433,22,8125418502,-33380931
1635012901,-186247,true,8162063442,22,8122981364,-39082078
1635012948,-186250,true,8159615313,22,8112428876,-47186437
1635012993,-186251,true,8158799433,22,8105131339,-53668094
1635013074,-186240,true,8167778601,22,8087320540,-80458061
1635013108,-186234,true,8172680493,22,8080045589,-92634904
1635013143,-186238,true,8169412238,22,8068742005,-100670233
1635013158,-186241,true,8166961905,22,8064708844,-102253061
1635013182,-186237,true,8170229179,22,8060677699,-109551480
1635013288,-186234,true,8172680493,22,8044573259,-128107234
1635013334,-186237,true,8170229179,22,8046182254,-124046925
1635013369,-186236,true,8171046202,22,8049401210,-121644992
1635013405,-186228,true,8177585328,22,8049401210,-128184118
1635013446,-186224,true,8180856852,22,8051816271,-129040581
1635013460,-186226,true,8179220926,22,8051011170,-128209756
1635013468,-186229,true,8176767651,22,8052621453,-124146198
1635013491,-186227,true,8178403086,22,8051011170,-127391916
1635013517,-186223,true,8181674938,22,8050206150,-131468788
1635013543,-186222,true,8182493106,22,8052621453,-129871653
1635013557,-186222,true,8182493106,22,8053426715,-129066391
1635013612,-186214,true,8189041392,22,8059871712,-129169680
1635013645,-186210,true,8192317500,22,8062289915,-130027585
1635013659,-186209,true,8193136731,22,8061483767,-131652964
1635013751,-186208,true,8193956045,22,8083278093,-110677952
1635013890,-186205,true,8196414478,22,8109184716,-87229762
1635013917,-186205,true,8196414478,22,8113240119,-83174359
1635013969,-186204,true,8197234119,22,8121357011,-75877108
1635014001,-186206,true,8195594918,22,8126231044,-69363874
1635014025,-186203,true,8198053843,22,8129482024,-68571819
1635014037,-186204,true,8197234119,22,8132734304,-64499815
1635014061,-186206,true,8195594918,22,8139242769,-56352149
1635014096,-186210,true,8192317500,22,8146571019,-45746481
1635014118,-186206,true,8195594918,22,8152275329,-43319589
1635014148,-186208,true,8193956045,22,8160431274,-33524771
1635014167,-186210,true,8192317500,22,8166145290,-26172210
1635014230,-186214,true,8189041392,22,8173497761,-15543631
1635014238,-186213,true,8189860296,22,8174315111,-15545185
1635014397,-186216,true,8187403829,22,8193956045,6552216
1635014519,-186218,true,8185766594,22,8204614582,18847988
1635014559,-186222,true,8182493106,22,8208717709,26224603
1635014659,-186224,true,8180856852,22,8209538581,28681729
1635014688,-186226,true,8179220926,22,8211180571,31959645
1635014701,-186229,true,8176767651,22,8211180571,34412920
1635014803,-186233,true,8173497761,22,8214465536,40967775
1635014901,-186232,true,8174315111,22,8219395448,45080337
1635015011,-186235,true,8171863307,22,8221861513,49998206
1635015014,-186236,true,8171046202,22,8221861513,50815311
1635015068,-186240,true,8167778601,22,8210359535,42580934
1635015083,-186244,true,8164512306,22,8208717709,44205403
1635015114,-186251,true,8158799433,22,8203794202,44994769
1635015196,-186249,true,8160431274,22,8195594918,35163644
1635015222,-186252,true,8157983634,22,8194775441,36791807
1635015240,-186256,true,8154721257,22,8193136731,38415474
1635015245,-186262,true,8149830136,22,8192317500,42487364
1635015275,-186261,true,8150645119,22,8189041392,38396273
1635015392,-186266,true,8146571019,22,8175950056,29379037
1635015437,-186269,true,8144127536,22,8171863307,27735771
1635015459,-186275,true,8139242769,22,8168595379,29352610
1635015526,-186271,true,8142498955,22,8159615313,17116358
1635015531,-186275,true,8139242769,22,8158799433,19556664
1635015615,-186277,true,8137615165,22,8145756443,8141278
1635015645,-186282,true,8133547578,22,8141684786,8137208
1635015730,-186280,true,8135174368,22,8122981364,-12193004
1635015760,-186282,true,8133547578,22,8116485902,-17061676
1635015903,-186287,true,8129482024,22,8074391819,-55090205
1635015906,-186293,true,8124606041,22,8073584461,-51021580
1635016052,-186292,true,8125418502,22,8062289915,-63128587
1635016070,-186294,true,8123793662,22,8060677699,-63115963
1635016094,-186299,true,8119732983,22,8055842985,-63889998
1635016239,-186307,true,8113240119,22,8019674939,-93565180
1635016271,-186309,true,8111617714,22,8012460839,-99156875
1635016353,-186313,true,8108373878,22,7994853680,-113520198
1635016382,-186316,true,8105941852,22,7990058447,-115883405
1635016422,-186324,true,8099460016,22,7979678638,-119781378
1635016463,-186326,true,8097840367,22,7965328853,-132511514
1635016471,-186329,true,8095411501,22,7962939732,-132471769
1635016514,-186333,true,8092174146,22,7951799973,-140374173
1635016549,-186341,true,8085703318,22,7943058239,-142645079
1635016554,-186340,true,8086511889,22,7942264012,-144247877
1635016578,-186342,true,8084894829,22,7938294071,-146600758
1635016596,-186344,true,8083278093,22,7935913059,-147365034
1635016611,-186350,true,8078429823,22,7934326115,-144103708
1635016717,-186348,true,8080045589,22,7928774308,-151271281
1635016840,-186348,true,8080045589,22,7932739488,-147306101
1635016905,-186350,true,8078429823,22,7930360142,-148069681
1635017004,-186354,true,8075199258,22,7929567185,-145632073
1635017014,-186351,true,8077622060,22,7929567185,-148054875
1635017081,-186352,true,8076814379,22,7929567185,-147247194
1635017135,-186354,true,8075199258,22,7929567185,-145632073
1635017164,-186359,true,8071162870,22,7929567185,-141595685
1635017211,-186357,true,8072777183,22,7927981509,-144795674
1635017249,-186360,true,8070355834,22,7926396151,-143959683
1635017280,-186362,true,8068742005,22,7926396151,-142345854
1635017351,-186366,true,8065515315,22,7935913059,-129602256
1635017355,-186362,true,8068742005,22,7936706651,-132035354
1635017408,-186363,true,8067935212,22,7943852545,-124082667
1635017443,-186363,true,8067935212,22,7949414910,-118520302
1635017470,-186367,true,8064708844,22,7951799973,-112908871
1635017578,-186364,true,8067128499,22,7967718690,-99409809
1635017682,-186364,true,8067128499,22,7978880750,-88247749
1635017732,-186365,true,8066321867,22,7982870988,-83450879
1635017746,-186371,true,8061483767,22,7982072781,-79410986
1635017767,-186368,true,8063902454,22,7982072781,-81829673
1635017788,-186369,true,8063096144,22,7981274654,-81821490
1635017801,-186370,true,8062289915,22,7980476606,-81813309
1635017872,-186374,true,8059065805,22,7982870988,-76194817
1635017930,-186370,true,8062289915,22,7988460675,-73829240
1635017962,-186371,true,8061483767,22,7993254950,-68228817
1635018001,-186376,true,8057454234,22,7998052102,-59402132
1635018010,-186381,true,8053426715,22,7998851907,-54574808
1635018029,-186377,true,8056648569,22,8002051928,-54596641
1635018067,-186380,true,8054232058,22,8007655045,-46577013
1635018146,-186384,true,8051011170,22,8023685578,-27325592
1635018170,-186389,true,8046986872,22,8026895534,-20091338
1635018186,-186385,true,8050206150,22,8027698224,-22507926
1635018214,-186387,true,8048596350,22,8030106774,-18489576
1635018238,-186390,true,8046182254,22,8033319299,-12862955
1635018300,-186395,true,8042160369,22,8040552179,-1608190
1635018308,-186392,true,8044573259,22,8042160369,-2412890
1635018327,-186393,true,8043768882,22,8042964585,-804297
1635018355,-186398,true,8039748204,22,8045377716,5629512
1635018365,-186404,true,8034926043,22,8046986872,12060829
1635018446,-186400,true,8038140495,22,8048596350,10455855
1635018562,-186400,true,8038140495,22,8060677699,22537204
1635018568,-186404,true,8034926043,22,8061483767,26557724
1635018586,-186409,true,8030909785,22,8063096144,32186359
1635018701,-186402,true,8036533108,22,8088938085,52404977
1635018750,-186399,true,8038944309,22,8101890097,62945788
1635018786,-186405,true,8034122630,22,8108373878,74251248
1635018810,-186409,true,8030909785,22,8112428876,81519091
1635018870,-186403,true,8035729535,22,8122169147,86439612
1635018937,-186402,true,8036533108,22,8134360932,97827824
1635018952,-186406,true,8033319299,22,8137615165,104295866
1635018956,-186410,true,8030106774,22,8138428926,108322152
1635018986,-186404,true,8034926043,22,8144941949,110015906
1635019028,-186401,true,8037336762,22,8149015234,111678472
1635019032,-186404,true,8034926043,22,8149830136,114904093
1635019055,-186404,true,8034926043,22,8154721257,119795214
1635019090,-186399,true,8038944309,22,8158799433,119855124
1635019103,-186398,true,8039748204,22,8158799433,119051229
1635019124,-186402,true,8036533108,22,8162063442,125530334
1635019131,-186402,true,8036533108,22,8162879648,126346540
1635019183,-186400,true,8038140495,22,8164512306,126371811
1635019474,-186399,true,8038944309,22,8161247317,122303008
1635019532,-186402,true,8036533108,22,8154721257,118188149
1635019543,-186403,true,8035729535,22,8153905866,118176331
1635019746,-186400,true,8038140495,22,8144127536,105987041
1635019768,-186396,true,8041356234,22,8143313205,101956971
1635019840,-186399,true,8038944309,22,8141684786,102740477
1635019872,-186399,true,8038944309,22,8139242769,100298460
1635019882,-186394,true,8042964585,22,8138428926,95464341
1635019951,-186391,true,8045377716,22,8135987886,90610170
1635019969,-186390,true,8046182254,22,8134360932,88178678
1635019982,-186390,true,8046182254,22,8134360932,88178678
1635020009,-186385,true,8050206150,22,8135987886,85781736
1635020019,-186382,true,8052621453,22,8135174368,82552915
1635020032,-186382,true,8052621453,22,8135174368,82552915
1635020150,-186378,true,8055842985,22,8145756443,89913458
1635020268,-186371,true,8061483767,22,8155536729,94052962
1635020347,-186367,true,8064708844,22,8165328757,100619913
1635020455,-186367,true,8064708844,22,8169412238,104703394
1635020466,-186364,true,8067128499,22,8168595379,101466880
1635020494,-186355,true,8074391819,22,8167778601,93386782
1635020546,-186351,true,8077622060,22,8166961905,89339845
1635020588,-186350,true,8078429823,22,8165328757,86898934
1635020607,-186347,true,8080853594,22,8164512306,83658712
1635020690,-186339,true,8087320540,22,8160431274,73110734
1635020713,-186336,true,8089746979,22,8159615313,69868334
1635020825,-186336,true,8089746979,22,8155536729,65789750
1635020832,-186333,true,8092174146,22,8155536729,63362583
1635020949,-186328,true,8096221042,22,8149830136,53609094
1635021013,-186327,true,8097030664,22,8145756443,48725779
1635021029,-186328,true,8096221042,22,8144941949,48720907
1635021161,-186325,true,8098650151,22,8138428926,39778775
1635021227,-186320,true,8102700286,22,8133547578,30847292
1635021235,-186317,true,8105131339,22,8132734304,27602965
1635021250,-186317,true,8105131339,22,8131108001,25976662
1635021268,-186312,true,8109184716,22,8131921112,22736396
1635021332,-186306,true,8114051443,22,8134360932,20309489
1635021439,-186303,true,8116485902,22,8131921112,15435210
1635021441,-186304,true,8115674334,22,8131921112,16246778
1635021539,-186299,true,8119732983,22,8137615165,17882182
1635021583,-186293,true,8124606041,22,8140870699,16264658
1635021607,-186291,true,8126231044,22,8141684786,15453742
1635021651,-186291,true,8126231044,22,8146571019,20339975
1635021672,-186286,true,8130294972,22,8149015234,18720262
1635021784,-186282,true,8133547578,22,8161247317,27699739
1635021813,-186281,true,8134360932,22,8162879648,28518716
1635021825,-186282,true,8133547578,22,8162879648,29332070
1635021857,-186278,true,8136801485,22,8164512306,27710821
1635021879,-186276,true,8138428926,22,8166145290,27716364
1635021952,-186272,true,8141684786,22,8171863307,30178521
1635022070,-186270,true,8143313205,22,8182493106,39179901
1635022235,-186269,true,8144127536,22,8175950056,31822520
1635022258,-186267,true,8145756443,22,8176767651,31011208
1635022339,-186265,true,8147385676,22,8178403086,31017410
1635022352,-186264,true,8148200414,22,8177585328,29384914
1635022370,-186263,true,8149015234,22,8175132543,26117309
1635022890,-186263,true,8149015234,22,8116485902,-32529332
1635022990,-186261,true,8150645119,22,8107563122,-43081997
1635023012,-186261,true,8150645119,22,8108373878,-42271241
1635023081,-186261,true,8150645119,22,8103510556,-47134563
1635023094,-186261,true,8150645119,22,8101890097,-48755022
1635023286,-186261,true,8150645119,22,8087320540,-63324579
1635023381,-186262,true,8149830136,22,8081661679,-68168457
1635023473,-186262,true,8149830136,22,8076814379,-73015757
1635023516,-186262,true,8149830136,22,8075199258,-74630878
1635023594,-186262,true,8149830136,22,8071969986,-77860150
1635023607,-186263,true,8149015234,22,8071162870,-77852364
1635023629,-186262,true,8149830136,22,8070355834,-79474302
1635023680,-186263,true,8149015234,22,8067935212,-81080022
1635023697,-186266,true,8146571019,22,8066321867,-80249152
1635023732,-186267,true,8145756443,22,8063902454,-81853989
1635023765,-186267,true,8145756443,22,8062289915,-83466528
1635023957,-186270,true,8143313205,22,8052621453,-90691752
1635023981,-186275,true,8139242769,22,8052621453,-86621316
1635023992,-186276,true,8138428926,22,8052621453,-85807473
1635024016,-186276,true,8138428926,22,8051011170,-87417756
1635024030,-186281,true,8134360932,22,8050206150,-84154782
1635024089,-186285,true,8131108001,22,8047791571,-83316430
1635024147,-186287,true,8129482024,22,8042964585,-86517439
1635024338,-186288,true,8128669157,22,8027698224,-100970933
1635024362,-186294,true,8123793662,22,8023685578,-100108084
1635024408,-186297,true,8121357011,22,8022081082,-99275929
1635024425,-186299,true,8119732983,22,8021278954,-98454029
1635024505,-186298,true,8120544956,22,8022081082,-98463874
1635024553,-186301,true,8118109280,22,8022081082,-96028198
1635024752,-186303,true,8116485902,22,8023685578,-92800324
1635024795,-186305,true,8114862848,22,8022081082,-92781766
1635024883,-186304,true,8115674334,22,8020476906,-95197428
1635024904,-186305,true,8114862848,22,8020476906,-94385942
1635024967,-186307,true,8113240119,22,8023685578,-89554541
1635024986,-186309,true,8111617714,22,8024487947,-87129767
1635025115,-186307,true,8113240119,22,8033319299,-79920820
1635025141,-186309,true,8111617714,22,8037336762,-74280952
1635025248,-186312,true,8109184716,22,8054232058,-54952658
1635025253,-186314,true,8107563122,22,8055037481,-52525641
1635025382,-186312,true,8109184716,22,8058259979,-50924737
1635025459,-186315,true,8106752447,22,8055842985,-50909462
1635025511,-186318,true,8104320907,22,8055842985,-48477922
1635025531,-186320,true,8102700286,22,8055037481,-47662805
1635025567,-186317,true,8105131339,22,8058259979,-46871360
1635025696,-186318,true,8104320907,22,8067128499,-37192408
1635025724,-186321,true,8101890097,22,8068742005,-33148092
1635025758,-186323,true,8100269962,22,8071162870,-29107092
1635025918,-186322,true,8101079989,22,8078429823,-22650166
1635025994,-186323,true,8100269962,22,8082469846,-17800116
1635026028,-186326,true,8097840367,22,8082469846,-15370521
1635026114,-186328,true,8096221042,22,8077622060,-18598982
1635026121,-186327,true,8097030664,22,8077622060,-19408604
1635026203,-186328,true,8096221042,22,8078429823,-17791219
1635026267,-186330,true,8094602041,22,8079237666,-15364375
1635026272,-186332,true,8092983363,22,8079237666,-13745697
1635026354,-186331,true,8093792661,22,8082469846,-11322815
1635026590,-186328,true,8096221042,22,8110806634,14585592
1635026918,-186328,true,8096221042,22,8145756443,49535401
1635026942,-186329,true,8095411501,22,8149015234,53603733
1635027076,-186328,true,8096221042,22,8160431274,64210232
1635027387,-186326,true,8097840367,22,8166145290,68304923
1635027497,-186327,true,8097030664,22,8157167918,60137254
1635027561,-186328,true,8096221042,22,8153090557,56869515
1635027592,-186327,true,8097030664,22,8150645119,53614455
1635027628,-186326,true,8097840367,22,8147385676,49545309
1635027671,-186328,true,8096221042,22,8143313205,47092163
1635027678,-186330,true,8094602041,22,8143313205,48711164
1635027689,-186329,true,8095411501,22,8142498955,47087454
1635027767,-186331,true,8093792661,22,8130294972,36502311
1635027878,-186333,true,8092174146,22,8113240119,21065973
1635027934,-186335,true,8090555953,22,8106752447,16196494
1635027993,-186335,true,8090555953,22,8105131339,14575386
1635028020,-186336,true,8089746979,22,8104320907,14573928
1635028095,-186338,true,8088129272,22,8102700286,14571014
1635028169,-186340,true,8086511889,22,8099460016,12948127
1635028194,-186340,true,8086511889,22,8098650151,12138262
1635028240,-186342,true,8084894829,22,8097840367,12945538
1635028260,-186344,true,8083278093,22,8097030664,13752571
1635028298,-186346,true,8081661679,22,8093792661,12130982
1635028323,-186346,true,8081661679,22,8092983363,11321684
1635028377,-186347,true,8080853594,22,8090555953,9702359
1635028394,-186350,true,8078429823,22,8089746979,11317156
1635028445,-186350,true,8078429823,22,8092983363,14553540
1635028456,-186348,true,8080045589,22,8092983363,12937774
1635028488,-186346,true,8081661679,22,8096221042,14559363
1635028502,-186348,true,8080045589,22,8097840367,17794778
1635028574,-186347,true,8080853594,22,8104320907,23467313
1635028667,-186346,true,8081661679,22,8112428876,30767197
1635028689,-186343,true,8084086420,22,8115674334,31587914
1635028699,-186344,true,8083278093,22,8116485902,33207809
1635028829,-186342,true,8084894829,22,8141684786,56789957
1635028859,-186340,true,8086511889,22,8144941949,58430060
1635028912,-186337,true,8088938085,22,8148200414,59262329
1635028926,-186337,true,8088938085,22,8149015234,60077149
1635028974,-186336,true,8089746979,22,8149830136,60083157
1635029010,-186333,true,8092174146,22,8153090557,60916411
1635029064,-186329,true,8095411501,22,8162879648,67468147
1635029348,-186327,true,8097030664,22,8206255586,109224922
1635029403,-186324,true,8099460016,22,8215286982,115826966
1635029420,-186321,true,8101890097,22,8220217387,118327290
1635029603,-186316,true,8105941852,22,8249862016,143920164
1635029644,-186312,true,8109184716,22,8253162456,143977740
1635029710,-186310,true,8110806634,22,8258115591,147308957
1635029730,-186307,true,8113240119,22,8262245475,149005356
1635029756,-186302,true,8117297550,22,8268030782,150733232
1635029835,-186297,true,8121357011,22,8280441513,159084502
1635029869,-186295,true,8122981364,22,8286239562,163258198
1635029881,-186292,true,8125418502,22,8287896892,162478390
1635029922,-186284,true,8131921112,22,8297847841,165926729
1635029929,-186278,true,8136801485,22,8298677625,161876140
1635029993,-186272,true,8141684786,22,8310303329,168618543
1635030127,-186272,true,8141684786,22,8316122287,174437501
1635030139,-186265,true,8147385676,22,8316953899,169568223
1635030164,-186258,true,8153090557,22,8317785594,164695037
1635030249,-186255,true,8155536729,22,8321113208,165576479
1635030266,-186257,true,8153905866,22,8320281179,166375313
1635030300,-186251,true,8158799433,22,8319449235,160649802
1635030328,-186246,true,8162879648,22,8311965473,149085825
1635030512,-186245,true,8163695936,22,8295358984,131663048
1635030542,-186247,true,8162063442,22,8293700161,131636719
1635030861,-186241,true,8166961905,22,8253987772,87025867
1635030908,-186236,true,8171046202,22,8246562896,75516694
1635030936,-186234,true,8172680493,22,8244913831,72233338
1635030981,-186236,true,8171046202,22,8241616689,70570487
1635031076,-186231,true,8175132543,22,8234202942,59070399
1635031362,-186228,true,8177585328,22,8223505967,45920639
1635031424,-186227,true,8178403086,22,8223505967,45102881
1635031484,-186229,true,8176767651,22,8221861513,45093862
1635031542,-186223,true,8181674938,22,8221039409,39364471
1635031585,-186219,true,8184948099,22,8220217387,35269288
1635031840,-186220,true,8184129686,22,8189041392,4911706
1635031841,-186224,true,8180856852,22,8189041392,8184540
1635031909,-186221,true,8183311355,22,8181674938,-1636417
1635031966,-186218,true,8185766594,22,8174315111,-11451483
1635032003,-186221,true,8183311355,22,8166961905,-16349450
1635032136,-186224,true,8180856852,22,8148200414,-32656438
1635032230,-186221,true,8183311355,22,8132734304,-50577051
1635032267,-186218,true,8185766594,22,8130294972,-55471622
1635032415,-186219,true,8184948099,22,8122981364,-61966735
1635032520,-186221,true,8183311355,22,8119732983,-63578372
1635032558,-186216,true,8187403829,22,8120544956,-66858873
1635032700,-186214,true,8189041392,22,8118109280,-70932112
1635032752,-186216,true,8187403829,22,8117297550,-70106279
1635032754,-186218,true,8185766594,22,8117297550,-68469044
1635032806,-186219,true,8184948099,22,8116485902,-68462197
1635032919,-186218,true,8185766594,22,8119732983,-66033611
1635032923,-186220,true,8184129686,22,8119732983,-64396703
1635033155,-186222,true,8182493106,22,8128669157,-53823949
1635033188,-186221,true,8183311355,22,8127043667,-56267688
1635033278,-186219,true,8184948099,22,8123793662,-61154437
1635033379,-186221,true,8183311355,22,8120544956,-62766399
1635033384,-186223,true,8181674938,22,8120544956,-61129982
1635033492,-186222,true,8182493106,22,8108373878,-74119228
1635033509,-186220,true,8184129686,22,8107563122,-76566564
1635033557,-186224,true,8180856852,22,8105941852,-74915000
1635033588,-186225,true,8180038849,22,8105131339,-74907510
1635033619,-186222,true,8182493106,22,8104320907,-78172199
1635033666,-186218,true,8185766594,22,8101890097,-83876497
1635033703,-186221,true,8183311355,22,8104320907,-78990448
1635033800,-186222,true,8182493106,22,8108373878,-74119228
1635033808,-186219,true,8184948099,22,8108373878,-76574221
1635033829,-186216,true,8187403829,22,8109184716,-78219113
1635033898,-186219,true,8184948099,22,8112428876,-72519223
1635034005,-186220,true,8184129686,22,8114862848,-69266838
1635034049,-186218,true,8185766594,22,8110806634,-74959960
1635034061,-186216,true,8187403829,22,8109995634,-77408195
1635034151,-186220,true,8184129686,22,8102700286,-81429400
1635034154,-186223,true,8181674938,22,8102700286,-78974652
1635034170,-186218,true,8185766594,22,8104320907,-81445687
1635034204,-186215,true,8188222569,22,8102700286,-85522283
1635034302,-186222,true,8182493106,22,8094602041,-87891065
1635034375,-186226,true,8179220926,22,8094602041,-84618885
1635034507,-186225,true,8180038849,22,8091365009,-88673840
1635034515,-186223,true,8181674938,22,8090555953,-91118985
1635034573,-186230,true,8175950056,22,8089746979,-86203077
1635034640,-186233,true,8173497761,22,8083278093,-90219668
1635034662,-186231,true,8175132543,22,8080853594,-94278949
1635034754,-186229,true,8176767651,22,8070355834,-106411817
1635034811,-186237,true,8170229179,22,8063096144,-107133035
1635034932,-186239,true,8168595379,22,8067128499,-101466880
1635034955,-186237,true,8170229179,22,8070355834,-99873345
1635034985,-186233,true,8173497761,22,8073584461,-99913300
1635035020,-186238,true,8169412238,22,8076814379,-92597859
1635035049,-186241,true,8166961905,22,8078429823,-88532082
1635035116,-186241,true,8166961905,22,8077622060,-89339845
1635035158,-186239,true,8168595379,22,8083278093,-85317286
1635035172,-186245,true,8163695936,22,8084894829,-78801107
1635035201,-186248,true,8161247317,22,8088129272,-73118045
1635035206,-186248,true,8161247317,22,8088129272,-73118045
1635035268,-186248,true,8161247317,22,8096221042,-65026275
1635035282,-186254,true,8156352282,22,8097840367,-58511915
1635035310,-186256,true,8154721257,22,8101079989,-53641268
1635035327,-186258,true,8153090557,22,8102700286,-50390271
1635035396,-186258,true,8153090557,22,8109184716,-43905841
1635035430,-186264,true,8148200414,22,8113240119,-34960295
1635035464,-186266,true,8146571019,22,8116485902,-30085117
1635035488,-186268,true,8144941949,22,8119732983,-25208966
1635035533,-186269,true,8144127536,22,8124606041,-19521495
1635035569,-186278,true,8136801485,22,8129482024,-7319461
1635035627,-186276,true,8138428926,22,8136801485,-1627441
1635035641,-186277,true,8137615165,22,8139242769,1627604
1635035708,-186276,true,8138428926,22,8155536729,17107803
1635035896,-186277,true,8137615165,22,8203794202,66179037
1635035982,-186274,true,8140056694,22,8225150751,85094057
1635036020,-186274,true,8140056694,22,8235026362,94969668
1635036040,-186271,true,8142498955,22,8238320867,95821912
1635036055,-186270,true,8143313205,22,8242440851,99127646
1635036059,-186267,true,8145756443,22,8243265095,97508652
1635036108,-186264,true,8148200414,22,8259767297,111566883
1635036161,-186258,true,8153090557,22,8279613552,126522995
1635036184,-186257,true,8153905866,22,8288725682,134819816
1635036201,-186252,true,8157983634,22,8297847841,139864207
1635036353,-186246,true,8162879648,22,8372861777,209982129
1635036376,-186238,true,8169412238,22,8383753030,214340792
1635036421,-186237,true,8170229179,22,8403897194,233668015
1635036459,-186232,true,8174315111,22,8420720965,246405854
1635036495,-186226,true,8179220926,22,8440953954,261733028
1635036500,-186218,true,8185766594,22,8442642229,256875635
1635036563,-186211,true,8191498350,22,8475631171,284132821
1635036587,-186205,true,8196414478,22,8485807524,289393046
1635036619,-186196,true,8203794202,22,8501094968,297300766
1635036704,-186188,true,8210359535,22,8526635267,316275732
1635036705,-186180,true,8216930122,22,8527487931,310557809
1635036727,-186172,true,8223505967,22,8537726546,314220579
1635036766,-186161,true,8232556348,22,8556529280,323972932
1635036779,-186150,true,8241616689,22,8561664481,320047792
1635036787,-186144,true,8246562896,22,8564233237,317670341
1635036868,-186138,true,8251512071,22,8601136881,349624810
1635036923,-186128,true,8259767297,22,8633018438,373251141
1635036962,-186116,true,8269684471,22,8647706316,378021845
1635036988,-186110,true,8274647522,22,8655492366,380844844
1635037022,-186103,true,8280441513,22,8666751259,386309746
1635037052,-186092,true,8289554555,22,8681496529,391941974
1635037063,-186079,true,8300337444,22,8684101239,383763795
1635037120,-186074,true,8304488443,22,8691050952,386562509
1635037132,-186068,true,8309472382,22,8692789249,383316867
1635037155,-186060,true,8316122287,22,8697136513,381014226
1635037250,-186046,true,8327772429,22,8716290317,388517888
1635037267,-186040,true,8332770341,22,8718905466,386135125
1635037322,-186035,true,8336937560,22,8727628296,390690736
1635037330,-186025,true,8345278250,22,8729373908,384095658
1635037368,-186013,true,8355298094,22,8731119871,375821777
1635037386,-186007,true,8360312526,22,8730246846,369934320
1635037405,-186003,true,8363657153,22,8730246846,366589693
1635037410,-185995,true,8370350421,22,8730246846,359896425
1635037421,-185982,true,8381238407,22,8730246846,349008439
1635037482,-185974,true,8387945745,22,8732866182,344920437
1635037548,-185973,true,8388784540,22,8730246846,341462306
1635037555,-185965,true,8395497917,22,8730246846,334748929
1635037558,-185953,true,8405578057,22,8730246846,324668789
1635037596,-185946,true,8411463727,22,8732866182,321402455
1635037612,-185943,true,8413987419,22,8732866182,318878763
1635037639,-185933,true,8422405194,22,8730246846,307841652
1635037649,-185921,true,8432517641,22,8729373908,296856267
1635037661,-185911,true,8440953954,22,8728501058,287547104
1635037702,-185904,true,8446864394,22,8731119871,284255477
1635037714,-185896,true,8453624252,22,8731119871,277495619
1635037737,-185884,true,8463774182,22,8731992983,268218801
1635037788,-185874,true,8472241766,22,8730246846,258005080
1635037824,-185867,true,8478174115,22,8725010531,246836416
1635037833,-185858,true,8485807524,22,8725883032,240075508
1635037917,-185846,true,8495996096,22,8726755620,230759524
1635037930,-185835,true,8505346366,22,8727628296,222281930
1635038046,-185827,true,8512153025,22,8738981022,226827997
1635038057,-185817,true,8520669009,22,8738981022,218312013
1635038141,-185805,true,8530899437,22,8738981022,208081585
1635038179,-185795,true,8539434177,22,8741602979,202168802
1635038193,-185789,true,8544559118,22,8743351387,198792269
1635038244,-185781,true,8551397159,22,8746849252,195452093
1635038283,-185770,true,8560808400,22,8750348517,189540117
1635038303,-185763,true,8566802764,22,8751223551,184420787
1635038309,-185758,true,8571087022,22,8752098674,181011652
1635038322,-185750,true,8577946292,22,8752098674,174152382
1635038383,-185740,true,8586528100,22,8752098674,165570574
1635038407,-185732,true,8593399727,22,8753849181,160449454
1635038420,-185727,true,8597697286,22,8754724566,157027280
1635038516,-185719,true,8604577852,22,8758226981,153649129
1635038546,-185709,true,8613186303,22,8759102804,145916501
1635038617,-185699,true,8621803366,22,8760854712,139051346
1635038622,-185694,true,8626115130,22,8760854712,134739582
1635038631,-185685,true,8633881740,22,8760854712,126972972
1635038636,-185673,true,8644248098,22,8760854712,116606614
1635038651,-185666,true,8650300887,22,8759978714,109677827
1635038654,-185661,true,8654626903,22,8759978714,105351811
1635038672,-185653,true,8661553028,22,8759978714,98425686
1635038733,-185642,true,8671085502,22,8759102804,88017302
1635038813,-185635,true,8677157083,22,8761730797,84573714
1635038836,-185630,true,8681496529,22,8758226981,76730452
1635038891,-185622,true,8688444158,22,8754724566,66280408
1635038905,-185612,true,8697136513,22,8753849181,56712668
1635038967,-185610,true,8698876027,22,8752098674,53222647
1635038993,-185607,true,8701485951,22,8751223551,49737600
1635039017,-185599,true,8708449577,22,8750348517,41898940
1635039049,-185590,true,8716290317,22,8750348517,34058200
1635039074,-185588,true,8718033662,22,8750348517,32314855
1635039103,-185585,true,8720649334,22,8749473569,28824235
1635039126,-185580,true,8725010531,22,8749473569,24463038
1635039147,-185575,true,8729373908,22,8748598709,19224801
1635039166,-185574,true,8730246846,22,8747723937,17477091
1635039168,-185574,true,8730246846,22,8747723937,17477091
1635039171,-185574,true,8730246846,22,8747723937,17477091
1635039190,-185571,true,8732866182,22,8745974655,13108473
1635039213,-185571,true,8732866182,22,8745100145,12233963
1635039283,-185570,true,8733739468,22,8741602979,7863511
1635039374,-185570,true,8733739468,22,8737233488,3494020
1635039386,-185567,true,8736359852,22,8736359852,0
1635039426,-185568,true,8735486304,22,8735486304,0
1635039443,-185569,true,8734612842,22,8731992983,-2619859
1635039466,-185572,true,8731992983,22,8725883032,-6109951
1635039511,-185569,true,8734612842,22,8716290317,-18322525
1635039519,-185572,true,8731992983,22,8715418775,-16574208
1635039577,-185573,true,8731119871,22,8708449577,-22670294
1635039597,-185577,true,8727628296,22,8703226335,-24401961
1635039629,-185580,true,8725010531,22,8695397346,-29613185
1635039631,-185583,true,8722393551,22,8695397346,-26996205
1635039700,-185582,true,8723265790,22,8685838146,-37427644
1635039745,-185586,true,8719777356,22,8679760490,-40016866
1635039804,-185587,true,8718905466,22,8670218480,-48686986
1635039825,-185590,true,8716290317,22,8666751259,-49539058
1635039853,-185589,true,8717161946,22,8664151754,-53010192
1635039867,-185593,true,8713675953,22,8662419184,-51256769
1635039993,-185592,true,8714547320,22,8657223551,-57323769
1635040007,-185592,true,8714547320,22,8656357915,-58189405
1635040042,-185592,true,8714547320,22,8655492366,-59054954
1635040100,-185592,true,8714547320,22,8658089273,-56458047
1635040127,-185594,true,8712804672,22,8659820977,-52983695
1635040141,-185595,true,8711933479,22,8659820977,-52112502
1635040174,-185594,true,8712804672,22,8661553028,-51251644
1635040213,-185595,true,8711933479,22,8662419184,-49514295
1635040223,-185593,true,8713675953,22,8663285425,-50390528
1635040290,-185594,true,8712804672,22,8665884671,-46920001
1635040318,-185590,true,8716290317,22,8665884671,-50405646
1635040356,-185590,true,8716290317,22,8671952610,-44337707
1635040419,-185591,true,8715418775,22,8672819806,-42598969
1635040421,-185594,true,8712804672,22,8671952610,-40852062
1635040438,-185591,true,8715418775,22,8671952610,-43466165
1635040483,-185593,true,8713675953,22,8672819806,-40856147
1635040499,-185593,true,8713675953,22,8675421912,-38254041
1635040586,-185596,true,8711062373,22,8678892601,-32169772
1635040639,-185595,true,8711933479,22,8677157083,-34776396
1635040689,-185597,true,8710191354,22,8678024799,-32166555
1635040743,-185597,true,8710191354,22,8678024799,-32166555
1635040746,-185601,true,8706708148,22,8678024799,-28683349
1635040797,-185600,true,8707578819,22,8678024799,-29554020
1635040876,-185602,true,8705837564,22,8676289454,-29548110
1635040997,-185600,true,8707578819,22,8683232915,-24345904
1635041013,-185603,true,8704967067,22,8684969649,-19997418
1635041036,-185601,true,8706708148,22,8686706730,-20001418
1635041073,-185601,true,8706708148,22,8688444158,-18263990
1635041119,-185600,true,8707578819,22,8689313002,-18265817
1635041124,-185604,true,8704096658,22,8690181934,-13914724
1635041147,-185604,true,8704096658,22,8691050952,-13045706
1635041214,-185604,true,8704096658,22,8693658528,-10438130
1635041451,-185608,true,8700615889,22,8686706730,-13909159
1635041465,-185611,true,8698006226,22,8687575400,-10430826
1635041516,-185611,true,8698006226,22,8688444158,-9562068
1635041591,-185612,true,8697136513,22,8684101239,-13035274
1635041698,-185616,true,8693658528,22,8671952610,-21705918
1635041728,-185618,true,8691920057,22,8670218480,-21701577
1635041743,-185617,true,8692789249,22,8668484696,-24304553
1635041757,-185618,true,8691920057,22,8665018169,-26901888
1635041811,-185620,true,8690181934,22,8658955082,-31226852
1635041815,-185624,true,8686706730,22,8658089273,-28617457
1635041821,-185622,true,8688444158,22,8658089273,-30354885
1635041859,-185622,true,8688444158,22,8653761527,-34682631
1635041934,-185623,true,8687575400,22,8646841632,-40733768
1635041969,-185630,true,8681496529,22,8637335811,-44160718
1635042046,-185629,true,8682364679,22,8628703223,-53661456
1635042089,-185630,true,8681496529,22,8624390166,-57106363
1635042125,-185633,true,8678892601,22,8621803366,-57089235
1635042214,-185637,true,8675421912,22,8615770517,-59651395
1635042251,-185637,true,8675421912,22,8612325070,-63096842
1635042280,-185638,true,8674554456,22,8609741889,-64812567
1635042317,-185642,true,8671085502,22,8607159483,-63926019
1635042321,-185648,true,8665884671,22,8606298853,-59585818
1635042346,-185648,true,8665884671,22,8604577852,-61306819
1635042451,-185650,true,8664151754,22,8594259067,-69892687
1635042479,-185655,true,8659820977,22,8590822222,-68998755
1635042527,-185662,true,8653761527,22,8583094347,-70667180
1635042533,-185662,true,8653761527,22,8582236123,-71525404
1635042592,-185666,true,8650300887,22,8574515971,-75784916
1635042602,-185672,true,8645112523,22,8571944131,-73168392
1635042688,-185680,true,8638199544,22,8550542104,-87657440
1635042694,-185681,true,8637335811,22,8548832252,-88503559
1635042727,-185686,true,8633018438,22,8541142149,-91876289
1635042753,-185690,true,8629566094,22,8533458963,-96107131
1635042789,-185697,true,8623527813,22,8523225465,-100302348
1635042818,-185696,true,8624390166,22,8515558397,-108831769
1635042888,-185700,true,8620941272,22,8501945077,-118996195
1635042895,-185703,true,8618355507,22,8500244943,-118110564
1635042917,-185710,true,8612325070,22,8493447806,-118877264
1635042961,-185710,true,8612325070,22,8479021932,-133303138
1635042999,-185716,true,8607159483,22,8467160199,-139999284
1635043030,-185720,true,8603717480,22,8457006209,-146711271
1635043061,-185728,true,8596837602,22,8449398707,-147438895
1635043151,-185727,true,8597697286,22,8432517641,-165179645
1635043188,-185730,true,8595118493,22,8426617239,-168501254
1635043257,-185733,true,8592540473,22,8413987419,-178553054
1635043275,-185739,true,8587386753,22,8411463727,-175923026
1635043283,-185739,true,8587386753,22,8410622665,-176764088
1635043303,-185742,true,8584811052,22,8407259257,-177551795
1635043304,-185743,true,8583952656,22,8407259257,-176693399
1635043374,-185748,true,8579661967,22,8398856620,-180805347
1635043381,-185749,true,8578804087,22,8398856620,-179947467
1635043387,-185753,true,8575373423,22,8398856620,-176516803
1635043480,-185754,true,8574515971,22,8396337467,-178178504
1635043487,-185759,true,8570229999,22,8395497917,-174732082
1635043508,-185760,true,8569373062,22,8397177100,-172195962
1635043538,-185764,true,8565946170,22,8399696506,-166249664
1635043650,-185767,true,8563376900,22,8408940793,-154436107
1635043674,-185772,true,8559096495,22,8409781687,-149314808
1635043705,-185773,true,8558240671,22,8410622665,-147618006
1635043715,-185777,true,8554818231,22,8411463727,-143354504
1635043757,-185779,true,8553107524,22,8413987419,-139120105
1635043788,-185785,true,8547977455,22,8415670301,-132307154
1635043837,-185785,true,8547977455,22,8423247434,-124730021
1635043877,-185788,true,8545413574,22,8429145477,-116268097
1635043914,-185792,true,8541996263,22,8429988391,-112007872
1635043982,-185797,true,8537726546,22,8440109943,-97616603
1635044030,-185798,true,8536872859,22,8444330842,-92542017
1635044091,-185802,true,8533458963,22,8451088671,-82370292
1635044094,-185803,true,8532605703,22,8451088671,-81517032
1635044205,-185810,true,8526635267,22,8449398707,-77236560
1635044251,-185810,true,8526635267,22,8450243647,-76391620
1635044279,-185814,true,8523225465,22,8450243647,-72981818
1635044288,-185816,true,8521521076,22,8450243647,-71277429
1635044335,-185821,true,8517261593,22,8451088671,-66172922
1635044366,-185821,true,8517261593,22,8451088671,-66172922
1635044376,-185825,true,8513855540,22,8451088671,-62766869
1635044422,-185826,true,8513004240,22,8450243647,-62760593
1635044451,-185831,true,8508749014,22,8449398707,-59350307
1635044483,-185833,true,8507047520,22,8448553852,-58493668
1635044576,-185838,true,8502795272,22,8443486493,-59308779
1635044607,-185842,true,8499395004,22,8441798049,-57596955
1635044609,-185848,true,8494297151,22,8441798049,-52499102
1635044680,-185847,true,8495146581,22,8449398707,-45747874
1635044977,-185850,true,8492598547,22,8472241766,-20356781
1635045056,-185853,true,8490051277,22,8482414049,-7637228
1635045123,-185859,true,8484959028,22,8490900282,5941254
1635045160,-185858,true,8485807524,22,8495146581,9339057
1635045174,-185862,true,8482414049,22,8496845695,14431646
1635045207,-185861,true,8483262291,22,8500244943,16982652
1635045272,-185866,true,8479021932,22,8505346366,26324434
1635045378,-185866,true,8479021932,22,8511301894,32279962
1635045484,-185868,true,8477326382,22,8518965131,41638749
1635045511,-185866,true,8479021932,22,8518965131,39943199
1635045551,-185873,true,8473088990,22,8513004240,39915250
1635045561,-185873,true,8473088990,22,8512153025,39064035
1635045602,-185877,true,8469700602,22,8506196900,36496298
1635045618,-185877,true,8469700602,22,8503645551,33944949
1635045642,-185883,true,8464620559,22,8500244943,35624384
1635045674,-185883,true,8464620559,22,8495996096,31375537
1635045691,-185889,true,8459543564,22,8493447806,33904242
1635045701,-185890,true,8458697694,22,8492598547,33900853
1635045750,-185894,true,8455315061,22,8486656105,31341044
1635045783,-185895,true,8454469614,22,8481565893,27096279
1635045805,-185900,true,8450243647,22,8479021932,28778285
1635045821,-185900,true,8450243647,22,8477326382,27082735
1635045870,-185904,true,8446864394,22,8472241766,25377372
1635045955,-185903,true,8447709081,22,8465467021,17757940
1635045983,-185907,true,8444330842,22,8462927889,18597047
1635046048,-185906,true,8445175275,22,8457006209,11830934
1635046062,-185910,true,8441798049,22,8454469614,12671565
1635046205,-185906,true,8445175275,22,8457851909,12676634
1635046306,-185909,true,8442642229,22,8463774182,21131953
1635046381,-185907,true,8444330842,22,8466313568,21982726
1635046389,-185909,true,8442642229,22,8466313568,23671339
1635046494,-185905,true,8446019792,22,8472241766,26221974
1635046611,-185907,true,8444330842,22,8483262291,38931449
1635046748,-185905,true,8446019792,22,8487504770,41484978
1635046796,-185906,true,8445175275,22,8487504770,42329495
1635046824,-185902,true,8448553852,22,8488353521,39799669
1635046872,-185904,true,8446864394,22,8490051277,43186883
1635046888,-185901,true,8449398707,22,8490900282,41501575
1635046933,-185902,true,8448553852,22,8494297151,45743299
1635046975,-185898,true,8451933780,22,8497695380,45761600
1635047079,-185899,true,8451088671,22,8495146581,44057910
1635047120,-185896,true,8453624252,22,8494297151,40672899
1635047263,-185896,true,8453624252,22,8493447806,39823554
1635047278,-185891,true,8457851909,22,8493447806,35595897
1635047366,-185890,true,8458697694,22,8496845695,38148001
1635047389,-185887,true,8461235557,22,8497695380,36459823
1635047399,-185887,true,8461235557,22,8498545149,37309592
1635047416,-185883,true,8464620559,22,8498545149,33924590
1635047420,-185882,true,8465467021,22,8498545149,33078128
1635047455,-185878,true,8468853716,22,8501945077,33091361
1635047461,-185878,true,8468853716,22,8501945077,33091361
1635047488,-185873,true,8473088990,22,8505346366,32257376
1635047524,-185871,true,8474783693,22,8509599889,34816196
1635047542,-185868,true,8477326382,22,8511301894,33975512
1635047557,-185868,true,8477326382,22,8513855540,36529158
1635047608,-185862,true,8482414049,22,8524077788,41663739
1635047617,-185861,true,8483262291,22,8525782689,42520398
1635047677,-185857,true,8486656105,22,8536872859,50216754
1635047716,-185857,true,8486656105,22,8543704748,57048643
1635047788,-185852,true,8490900282,22,8554818231,63917949
1635047839,-185851,true,8491749372,22,8563376900,71627528
1635047892,-185849,true,8493447806,22,8572801325,79353519
1635048035,-185848,true,8494297151,22,8595118493,100821342
1635048047,-185842,true,8499395004,22,8597697286,98302282
1635048128,-185840,true,8501094968,22,8614047621,112952653
1635048173,-185838,true,8502795272,22,8618355507,115560235
1635048339,-185837,true,8503645551,22,8645977034,142331483
1635048343,-185832,true,8507898225,22,8645977034,138078809
1635048407,-185831,true,8508749014,22,8647706316,138957302
1635048424,-185827,true,8512153025,22,8648571087,136418062
1635048460,-185828,true,8511301894,22,8652031034,140729140
1635048503,-185822,true,8516409952,22,8653761527,137351575
1635048744,-185820,true,8518113320,22,8665018169,146904849
1635048827,-185817,true,8520669009,22,8667617935,146948926
1635048930,-185815,true,8522373228,22,8670218480,147845252
1635048952,-185808,true,8528340679,22,8670218480,141877801
1635048979,-185805,true,8530899437,22,8670218480,139319043
1635049026,-185802,true,8533458963,22,8669351545,135892582
1635049207,-185800,true,8535165740,22,8678892601,143726861
1635049214,-185794,true,8540288120,22,8678892601,138604481
1635049236,-185791,true,8542850463,22,8679760490,136910027
1635049259,-185787,true,8546268116,22,8682364679,136096563
1635049311,-185786,true,8547122742,22,8685838146,138715404
1635049333,-185780,true,8552252298,22,8687575400,135323102
1635049342,-185776,true,8555673712,22,8687575400,131901688
1635049394,-185774,true,8557384933,22,8688444158,131059225
1635049424,-185773,true,8558240671,22,8688444158,130203487
1635049479,-185768,true,8562520647,22,8692789249,130268602
1635049485,-185767,true,8563376900,22,8693658528,130281628
1635049513,-185763,true,8566802764,22,8696266886,129464122
1635049652,-185761,true,8568516210,22,8710191354,141675144
1635049704,-185756,true,8572801325,22,8714547320,141745995
1635049739,-185755,true,8573658606,22,8717161946,143503340
1635049809,-185751,true,8577088583,22,8719777356,142688773
1635049887,-185750,true,8577946292,22,8722393551,144447259
1635049927,-185743,true,8583952656,22,8725883032,141930376
1635049960,-185742,true,8584811052,22,8727628296,142817244
1635050009,-185737,true,8589104316,22,8731992983,142888667
1635050021,-185734,true,8591681305,22,8732866182,141184877
1635050074,-185727,true,8597697286,22,8737233488,139536202
1635050157,-185726,true,8598557056,22,8733739468,135182412
1635050193,-185722,true,8601996995,22,8732866182,130869187
1635050234,-185719,true,8604577852,22,8731992983,127415131
1635050270,-185713,true,8609741889,22,8734612842,124870953
1635050284,-185710,true,8612325070,22,8737233488,124908418
1635050309,-185705,true,8616632094,22,8741602979,124970885
1635050514,-185697,true,8623527813,22,8765236015,141708202
1635050525,-185690,true,8629566094,22,8766112539,136546445
1635050608,-185689,true,8630429050,22,8766989150,136560100
1635050674,-185684,true,8634745128,22,8771373522,136628394
1635050699,-185679,true,8639063364,22,8774005197,134941833
1635050745,-185672,true,8645112523,22,8777515325,132402802
1635050753,-185670,true,8646841632,22,8778393077,131551445
1635051009,-185665,true,8651165917,22,8791569888,140403971
1635051015,-185660,true,8655492366,22,8792449045,136956679
1635051128,-185656,true,8658955082,22,8809169742,150214660
1635051187,-185655,true,8659820977,22,8811812757,151991780
1635051205,-185650,true,8664151754,22,8810931664,146779910
1635051227,-185645,true,8668484696,22,8809169742,140685046
1635051267,-185641,true,8671952610,22,8803886089,131933479
1635051443,-185642,true,8671085502,22,8779270916,108185414
1635051445,-185637,true,8675421912,22,8779270916,103849004
1635051465,-185632,true,8679760490,22,8776637662,96877172
1635051471,-185629,true,8682364679,22,8775760086,93395407
1635051486,-185632,true,8679760490,22,8774005197,94244707
1635051494,-185626,true,8684969649,22,8773127884,88158235
1635051518,-185623,true,8687575400,22,8770496472,82921072
1635051525,-185620,true,8690181934,22,8769619510,79437576
1635051546,-185623,true,8687575400,22,8766112539,78537139
1635051644,-185618,true,8691920057,22,8752098674,60178617
1635051654,-185615,true,8694527894,22,8751223551,56695657
1635051703,-185612,true,8697136513,22,8743351387,46214874
1635051867,-185616,true,8693658528,22,8719777356,26118828
1635051953,-185610,true,8698876027,22,8707578819,8702792
1635052108,-185607,true,8701485951,22,8683232915,-18253036
1635052179,-185604,true,8704096658,22,8678024799,-26071859
1635052408,-185608,true,8700615889,22,8666751259,-33864630
1635052584,-185605,true,8703226335,22,8667617935,-35608400
1635052586,-185601,true,8706708148,22,8667617935,-39090213
1635052627,-185600,true,8707578819,22,8668484696,-39094123
1635052660,-185604,true,8704096658,22,8668484696,-35611962
1635052678,-185601,true,8706708148,22,8666751259,-39956889
1635052768,-185598,true,8709320421,22,8664151754,-45168667
1635052848,-185599,true,8708449577,22,8657223551,-51226026
1635052885,-185604,true,8704096658,22,8655492366,-48604292
1635053015,-185602,true,8705837564,22,8645112523,-60725041
1635053039,-185599,true,8708449577,22,8644248098,-64201479
1635053106,-185599,true,8708449577,22,8640791263,-67658314
1635053133,-185604,true,8704096658,22,8642519508,-61577150
1635053313,-185599,true,8708449577,22,8652031034,-56418543
1635053403,-185597,true,8710191354,22,8655492366,-54698988
1635053421,-185597,true,8710191354,22,8656357915,-53833439
1635053554,-185604,true,8704096658,22,8649435944,-54660714
1635053562,-185599,true,8708449577,22,8649435944,-59013633
1635053606,-185599,true,8708449577,22,8652031034,-56418543
1635053639,-185598,true,8709320421,22,8652896237,-56424184
1635053867,-185599,true,8708449577,22,8691050952,-17398625
1635054098,-185595,true,8711933479,22,8718033662,6100183
1635054136,-185593,true,8713675953,22,8715418775,1742822
1635054201,-185593,true,8713675953,22,8711062373,-2613580
1635054208,-185596,true,8711062373,22,8710191354,-871019
1635054430,-185593,true,8713675953,22,8723265790,9589837
1635054530,-185591,true,8715418775,22,8731119871,15701096
1635054548,-185591,true,8715418775,22,8731119871,15701096
1635054578,-185595,true,8711933479,22,8729373908,17440429
1635054634,-185592,true,8714547320,22,8727628296,13080976
1635054672,-185590,true,8716290317,22,8725883032,9592715
1635054690,-185590,true,8716290317,22,8725010531,8720214
1635054698,-185594,true,8712804672,22,8724138117,11333445
1635054709,-185591,true,8715418775,22,8724138117,8719342
1635054745,-185590,true,8716290317,22,8721521399,5231082
1635054787,-185590,true,8716290317,22,8719777356,3487039
1635054823,-185593,true,8713675953,22,8718033662,4357709
1635054847,-185589,true,8717161946,22,8719777356,2615410
1635054903,-185586,true,8719777356,22,8723265790,3488434
1635054911,-185586,true,8719777356,22,8724138117,4360761
1635055061,-185587,true,8718905466,22,8743351387,24445921
1635055086,-185584,true,8721521399,22,8748598709,27077310
1635055177,-185582,true,8723265790,22,8763483231,40217441
1635055252,-185583,true,8722393551,22,8763483231,41089680
1635055277,-185585,true,8720649334,22,8765236015,44586681
1635055328,-185582,true,8723265790,22,8767865849,44600059
1635055470,-185580,true,8725010531,22,8778393077,53382546
1635055670,-185578,true,8726755620,22,8813575208,86819588
1635055676,-185580,true,8725010531,22,8814456565,89446034
1635055715,-185577,true,8727628296,22,8825922236,98293940
1635055829,-185572,true,8731992983,22,8848013540,116020557
1635055876,-185567,true,8736359852,22,8858636998,122277146
1635055942,-185566,true,8737233488,22,8873708735,136475247
1635055965,-185562,true,8740728906,22,8878146476,137417570
1635056046,-185555,true,8746849252,22,8894140731,147291479
1635056120,-185550,true,8751223551,22,8910163800,158940249
1635056223,-185553,true,8748598709,22,8931572803,182974094
1635056274,-185549,true,8752098674,22,8949452929,197354255
1635056295,-185547,true,8753849181,22,8957510659,203661478
1635056392,-185542,true,8758226981,22,8981727405,223500424
1635056438,-185539,true,8760854712,22,8998808054,237953342
1635056536,-185536,true,8763483231,22,9015921186,252437955
1635056560,-185533,true,8766112539,22,9020430048,254317509
1635056606,-185527,true,8771373522,22,9027648919,256275397
1635056638,-185526,true,8772250659,22,9031260520,259009861
1635056663,-185522,true,8775760086,22,9034873566,259113480
1635056686,-185518,true,8779270916,22,9037584299,258313383
1635056934,-185511,true,8785418250,22,9067456095,282037845
1635056982,-185508,true,8788054139,22,9088334201,300280062
1635057015,-185503,true,8792449045,22,9103796735,311347690
1635057024,-185498,true,8796846149,22,9107438800,310592651
1635057069,-185481,true,8811812757,22,9126583560,314770803
1635057114,-185479,true,8813575208,22,9140283022,326707814
1635057164,-185475,true,8817101167,22,9151257396,334156229
1635057171,-185471,true,8820628536,22,9152172522,331543986
1635057318,-185456,true,8833868745,22,9171411316,337542571
1635057349,-185449,true,8840054308,22,9183341307,343286999
1635057364,-185446,true,8842706590,22,9186096585,343389995
1635057408,-185440,true,8848013540,22,9202645621,354632081
1635057414,-185418,true,8867499622,22,9207247864,339748242
1635057442,-185414,true,8871047154,22,9217380902,346333748
1635057512,-185413,true,8871934259,22,9229370690,357436431
1635057539,-185408,true,8876371114,22,9236756771,360385657
1635057547,-185388,true,8894140731,22,9237680447,343539716
1635057587,-185385,true,8896809240,22,9241376073,344566833
1635057666,-185380,true,8901258534,22,9264507259,363248725
1635057670,-185375,true,8905710054,22,9265433709,359723655
1635057680,-185354,true,8924430759,22,9269140439,344709680
1635057704,-185349,true,8928893867,22,9274703314,345809447
1635057743,-185340,true,8936933086,22,9293270353,356337267
1635057750,-185335,true,8941402447,22,9295129100,353726653
1635057873,-185312,true,8961990310,22,9340784715,378794405
1635057954,-185308,true,8965575644,22,9343587230,378011586
1635057965,-185299,true,8973647890,22,9345456041,371808151
1635057991,-185293,true,8979033425,22,9354805704,375772279
1635058008,-185270,true,8999707935,22,9360419991,360712056
1635058027,-185262,true,9006910222,22,9366974251,360064029
1635058094,-185250,true,9017724461,22,9397934774,380210313
1635058159,-185242,true,9024941166,22,9429940531,404999365
1635058257,-185219,true,9045721379,22,9465840677,420119298
1635058303,-185211,true,9052960490,22,9480997387,428036897
1635058327,-185202,true,9061111414,22,9486687408,425575994
1635058347,-185194,true,9068362841,22,9496178365,427815524
1635058367,-185171,true,9089243034,22,9506629386,417386352
1635058376,-185160,true,9099246202,22,9512334790,413088588
1635058402,-185150,true,9108349544,22,9526613284,418263740
1635058413,-185140,true,9117461994,22,9533283914,415821920
1635058430,-185117,true,9138455240,22,9540913211,402457971
1635058445,-185112,true,9143025381,22,9546639191,403613810
1635058461,-185101,true,9153087739,22,9556190127,403102388
1635058483,-185095,true,9158580965,22,9565750618,407169653
1635058498,-185073,true,9178751014,22,9569577493,390826479
1635058569,-185071,true,9180586856,22,9577235835,396648979
1635058601,-185060,true,9190690552,22,9585858796,395168244
1635058617,-185054,true,9196206345,22,9586817381,390611036
1635058644,-185032,true,9216459256,22,9586817381,370358125
1635058692,-185029,true,9219224471,22,9587776063,368551592
1635058761,-185020,true,9227525092,22,9582983613,355458521
1635058782,-185014,true,9233062992,22,9582983613,349920621
1635058789,-184993,true,9252471826,22,9583941911,331470085
1635058830,-184992,true,9253397073,22,9582983613,329586540
1635058838,-184984,true,9260802382,22,9583941911,323139529
1635058869,-184980,true,9264507259,22,9581067304,316560045
1635058932,-184960,true,9283053886,22,9569577493,286523607
1635058938,-184958,true,9284910590,22,9568620631,283710041
1635058942,-184951,true,9291411978,22,9567663864,276251886
1635058968,-184951,true,9291411978,22,9552368606,260956628
1635059043,-184934,true,9307220021,22,9524708247,217488226
1635059065,-184933,true,9308150743,22,9520899316,212748573
1635059087,-184927,true,9313737029,22,9514237352,200500323
1635059156,-184927,true,9313737029,22,9485738834,172001805
1635059198,-184910,true,9329583055,22,9468680714,139097659
1635059238,-184908,true,9331449065,22,9456380041,124930976
1635059260,-184900,true,9338916838,22,9448818340,109901502
1635059271,-184897,true,9341718793,22,9445984261,104265468
1635059288,-184880,true,9357612426,22,9440318654,82706228
1635059309,-184879,true,9358548187,22,9430883525,72335338
1635059332,-184876,true,9361356033,22,9417690186,56334153
1635059414,-184880,true,9357612426,22,9382910852,25298426
1635059484,-184867,true,9369784624,22,9365101137,-4683487
1635059498,-184867,true,9369784624,22,9360419991,-9364633
1635059560,-184864,true,9372595840,22,9337983040,-34612800
1635059570,-184869,true,9367910948,22,9334248780,-33662168
1635059651,-184854,true,9381972655,22,9317463083,-64509572
1635059680,-184852,true,9383849143,22,9313737029,-70112114
1635059716,-184848,true,9387603246,22,9310943467,-76659779
1635059734,-184852,true,9383849143,22,9311874561,-71974582
1635059857,-184835,true,9399814455,22,9319326669,-80487786
1635059896,-184836,true,9398874568,22,9327717419,-71157149
1635059939,-184830,true,9404515303,22,9336115723,-68399580
1635059992,-184833,true,9401694512,22,9341718793,-59975719
1635060027,-184814,true,9419573818,22,9356676758,-62897060
1635060056,-184814,true,9419573818,22,9363228397,-56345421
1635060104,-184809,true,9424284547,22,9373533100,-50751447
1635060117,-184813,true,9420515775,22,9374470453,-46045322
1635060187,-184796,true,9436543470,22,9381034552,-55508918
1635060248,-184795,true,9437487125,22,9407336939,-30150186
1635060343,-184792,true,9440318654,22,9431826614,-8492040
1635060371,-184796,true,9436543470,22,9440318654,3775184
1635060378,-184787,true,9445039757,22,9442206812,-2832945
1635060418,-184787,true,9445039757,22,9447873553,2833796
1635060433,-184783,true,9448818340,22,9451653269,2834929
1635060497,-184787,true,9445039757,22,9466787262,21747505
1635060510,-184775,true,9456380041,22,9470574544,14194503
1635060550,-184774,true,9457325679,22,9483841970,26516291
1635060648,-184771,true,9460163160,22,9492380843,32217683
1635060747,-184776,true,9455434497,22,9497127983,41693486
1635060814,-184772,true,9459217239,22,9498077696,38860457
1635060964,-184769,true,9462055288,22,9488584840,26529552
1635061001,-184763,true,9467733940,22,9492380843,24646903
1635061051,-184767,true,9463947793,22,9495228842,31281049
1635061089,-184761,true,9469627582,22,9496178365,26550783
1635061176,-184754,true,9476258310,22,9493330081,17071771
1635061204,-184752,true,9478153656,22,9494279414,16125758
1635061260,-184754,true,9476258310,22,9509481660,33223350
1635061271,-184748,true,9481945487,22,9511383651,29438164
1635061365,-184741,true,9488584840,22,9534237243,45652403
1635061399,-184742,true,9487636076,22,9540913211,53277135
1635061442,-184747,true,9482893681,22,9534237243,51343562
1635061482,-184743,true,9486687408,22,9539005315,52317907
1635061543,-184737,true,9492380843,22,9546639191,54258348
1635061579,-184740,true,9489533698,22,9547593855,58060157
1635061620,-184743,true,9486687408,22,9554279176,67591768
1635061738,-184737,true,9492380843,22,9573405898,81025055
1635061740,-184735,true,9494279414,22,9573405898,79126484
1635061747,-184739,true,9490482652,22,9574363238,83880586
1635061758,-184744,true,9485738834,22,9575320675,89581841
1635061795,-184741,true,9488584840,22,9579151378,90566538
1635061962,-184736,true,9493330081,22,9601207678,107877597
1635061985,-184740,true,9489533698,22,9603128016,113594318
1635062010,-184745,true,9484790355,22,9606009242,121218887
1635062061,-184742,true,9487636076,22,9612735466,125099390
1635062091,-184740,true,9489533698,22,9612735466,123201768
1635062139,-184746,true,9483841970,22,9605048737,121206767
1635062164,-184752,true,9478153656,22,9600247653,122093997
1635062289,-184751,true,9479101472,22,9585858796,106757324
1635062293,-184748,true,9481945487,22,9584900306,102954819
1635062324,-184754,true,9476258310,22,9585858796,109600486
1635062375,-184758,true,9472468754,22,9584900306,112431552
1635062420,-184757,true,9473416001,22,9580109293,106693292
1635062480,-184749,true,9480997387,22,9579151378,98153991
1635062526,-184757,true,9473416001,22,9567663864,94247863
1635062556,-184762,true,9468680714,22,9560969178,92288464
1635062586,-184762,true,9468680714,22,9553323843,84643129
1635062671,-184755,true,9475310779,22,9547593855,72283076
1635062797,-184758,true,9472468754,22,9536144186,63675432
1635062824,-184762,true,9468680714,22,9533283914,64603200
1635062875,-184760,true,9470574544,22,9526613284,56038740
1635062896,-184751,true,9479101472,22,9523755872,44654400
1635062938,-184754,true,9476258310,22,9514237352,37979042
1635062983,-184755,true,9475310779,22,9514237352,38926573
1635063037,-184752,true,9478153656,22,9518995422,40841766
1635063053,-184743,true,9486687408,22,9519947321,33259913
1635063062,-184743,true,9486687408,22,9520899316,34211908
1635063109,-184742,true,9487636076,22,9523755872,36119796
1635063161,-184737,true,9492380843,22,9524708247,32327404
1635063255,-184731,true,9498077696,22,9520899316,22821620
1635063332,-184734,true,9495228842,22,9514237352,19008510
1635063348,-184734,true,9495228842,22,9513286023,18057181
1635063410,-184730,true,9499027504,22,9512334790,13307286
1635063432,-184730,true,9499027504,22,9492380843,-6646661
1635063445,-184736,true,9493330081,22,9492380843,-949238
1635063458,-184741,true,9488584840,22,9487636076,-948764
1635063467,-184752,true,9478153656,22,9484790355,6636699
1635063503,-184737,true,9492380843,22,9480049382,-12331461
1635063556,-184739,true,9490482652,22,9467733940,-22748712
1635063587,-184738,true,9491431700,22,9461109177,-30322523
1635063601,-184748,true,9481945487,22,9458271411,-23674076
1635063659,-184733,true,9496178365,22,9444095348,-52083017
1635063663,-184735,true,9494279414,22,9443151033,-51128381
1635063741,-184734,true,9495228842,22,9428054826,-67174016
1635063743,-184745,true,9484790355,22,9428054826,-56735529
1635063766,-184730,true,9499027504,22,9422399973,-76627531
1635063782,-184734,true,9495228842,22,9418631955,-76596887
1635063816,-184735,true,9494279414,22,9412982753,-81296661
1635063818,-184749,true,9480997387,22,9412982753,-68014634
1635063885,-184734,true,9495228842,22,9396055469,-99173373
1635063892,-184739,true,9490482652,22,9394176540,-96306112
1635063917,-184740,true,9489533698,22,9386664580,-102869118
1635063955,-184757,true,9473416001,22,9374470453,-98945548
1635064002,-184741,true,9488584840,22,9363228397,-125356443
1635064047,-184746,true,9483841970,22,9353870317,-129971653
1635064059,-184747,true,9482893681,22,9351999823,-130893858
1635064135,-184761,true,9469627582,22,9345456041,-124171541
1635064174,-184748,true,9481945487,22,9343587230,-138358257
1635064260,-184751,true,9479101472,22,9341718793,-137382679
1635064270,-184753,true,9477205936,22,9341718793,-135487143
1635064325,-184768,true,9463001493,22,9353870317,-109131176
1635064444,-184750,true,9480049382,22,9375407900,-104641482
1635064467,-184754,true,9476258310,22,9377283076,-98975234
1635064499,-184755,true,9475310779,22,9380096542,-95214237
1635064508,-184770,true,9461109177,22,9381034552,-80074625
1635064516,-184755,true,9475310779,22,9381034552,-94276227
1635064542,-184758,true,9472468754,22,9382910852,-89557902
1635064580,-184760,true,9470574544,22,9383849143,-86725401
1635064587,-184775,true,9456380041,22,9383849143,-72530898
1635064613,-184761,true,9469627582,22,9382910852,-86716730
1635064689,-184766,true,9464894188,22,9380096542,-84797646
1635064704,-184769,true,9462055288,22,9378220804,-83834484
1635064763,-184784,true,9447873553,22,9379158626,-68714927
1635064798,-184772,true,9459217239,22,9378220804,-80996435
1635064822,-184777,true,9454489049,22,9376345441,-78143608
1635064842,-184783,true,9448818340,22,9375407900,-73410440
1635064948,-184799,true,9433713073,22,9366974251,-66738822
1635064961,-184789,true,9443151033,22,9368847739,-74303294
1635064964,-184794,true,9438430873,22,9368847739,-69583134
1635064993,-184795,true,9437487125,22,9369784624,-67702501
1635065102,-184806,true,9427112115,22,9374470453,-52641662
1635065142,-184795,true,9437487125,22,9371658675,-65828450
1635065231,-184798,true,9434656445,22,9380096542,-54559903
1635065289,-184800,true,9432769796,22,9386664580,-46105216
1635065327,-184811,true,9422399973,22,9388542006,-33857967
1635065372,-184800,true,9432769796,22,9391358851,-41410945
1635065421,-184804,true,9428997632,22,9394176540,-34821092
1635065445,-184806,true,9427112115,22,9399814455,-27297660
1635065512,-184814,true,9419573818,22,9411100439,-8473379
1635065563,-184805,true,9428054826,22,9425226975,-2827851
1635065576,-184808,true,9425226975,22,9428997632,3770657
1635065593,-184810,true,9423342213,22,9434656445,11314232
1635065613,-184818,true,9415806930,22,9441262686,25455756
1635065742,-184812,true,9421457827,22,9460163160,38705333
1635065762,-184814,true,9419573818,22,9463947793,44373975
1635065786,-184816,true,9417690186,22,9467733940,50043754
1635065833,-184822,true,9412041549,22,9478153656,66112107
1635065945,-184817,true,9416748511,22,9473416001,56667490
1635065957,-184820,true,9413924051,22,9471521602,57597551
1635065971,-184821,true,9412982753,22,9471521602,58538849
1635066119,-184824,true,9410159423,22,9487636076,77476653
1635066208,-184816,true,9417690186,22,9489533698,71843512
1635066231,-184818,true,9415806930,22,9487636076,71829146
1635066312,-184819,true,9414865443,22,9481945487,67080044
1635066412,-184823,true,9411100439,22,9473416001,62315562
1635066417,-184818,true,9415806930,22,9473416001,57609071
1635066494,-184819,true,9414865443,22,9476258310,61392867
1635066530,-184819,true,9414865443,22,9479101472,64236029
1635066567,-184820,true,9413924051,22,9485738834,71814783
1635066629,-184815,true,9418631955,22,9494279414,75647459
1635066688,-184815,true,9418631955,22,9501877497,83245542
1635066720,-184817,true,9416748511,22,9504728345,87979834
1635066751,-184819,true,9414865443,22,9508530807,93665364
1635066783,-184815,true,9418631955,22,9514237352,95605397
1635066804,-184818,true,9415806930,22,9518043618,102236688
1635066846,-184819,true,9414865443,22,9526613284,111747841
1635066882,-184820,true,9413924051,22,9532330681,118406630
1635066923,-184814,true,9419573818,22,9534237243,114663425
1635066955,-184814,true,9419573818,22,9534237243,114663425
1635067033,-184815,true,9418631955,22,9534237243,115605288
1635067113,-184815,true,9418631955,22,9537097800,118465845
1635067127,-184803,true,9429940531,22,9539005315,109064784
1635067161,-184801,true,9431826614,22,9545684622,113858008
1635067178,-184800,true,9432769796,22,9547593855,114824059
1635067256,-184789,true,9443151033,22,9552368606,109217573
1635067413,-184792,true,9440318654,22,9545684622,105365968
1635067464,-184791,true,9441262686,22,9540913211,99650525
1635067486,-184791,true,9441262686,22,9539005315,97742629
1635067514,-184781,true,9450708198,22,9535190666,84482468
1635067553,-184785,true,9446928860,22,9529471554,82542694
1635067611,-184787,true,9445039757,22,9513286023,68246266
1635067621,-184789,true,9443151033,22,9510432608,67281575
1635067647,-184781,true,9450708198,22,9503777967,53069769
1635067671,-184785,true,9446928860,22,9499977406,53048546
1635067681,-184784,true,9447873553,22,9499027504,51153951
1635067721,-184782,true,9449763222,22,9499027504,49264282
1635067745,-184770,true,9461109177,22,9498077696,36968519
1635067800,-184774,true,9457325679,22,9496178365,38852686
1635068094,-184775,true,9456380041,22,9492380843,36000802
1635068110,-184773,true,9458271411,22,9492380843,34109432
1635068160,-184762,true,9468680714,22,9490482652,21801938
1635068288,-184768,true,9463001493,22,9483841970,20840477
1635068443,-184771,true,9460163160,22,9472468754,12305594
1635068470,-184770,true,9461109177,22,9473416001,12306824
1635068517,-184760,true,9470574544,22,9479101472,8526928
1635068642,-184765,true,9465840677,22,9491431700,25591023
1635068673,-184767,true,9463947793,22,9488584840,24637047
1635068676,-184765,true,9465840677,22,9488584840,22744163
1635068705,-184754,true,9476258310,22,9487636076,11377766
1635068709,-184761,true,9469627582,22,9486687408,17059826
1635068723,-184763,true,9467733940,22,9486687408,18953468
1635068793,-184760,true,9470574544,22,9484790355,14215811
1635068806,-184750,true,9480049382,22,9484790355,4740973
1635068834,-184757,true,9473416001,22,9481945487,8529486
1635068851,-184757,true,9473416001,22,9482893681,9477680
1635068900,-184755,true,9475310779,22,9480049382,4738603
1635068982,-184744,true,9485738834,22,9474363343,-11375491
1635069046,-184750,true,9480049382,22,9474363343,-5686039
1635069178,-184750,true,9480049382,22,9477205936,-2843446
1635069180,-184746,true,9483841970,22,9477205936,-6636034
1635069233,-184736,true,9493330081,22,9481945487,-11384594
1635069347,-184742,true,9487636076,22,9494279414,6643338
1635069364,-184741,true,9488584840,22,9496178365,7593525
1635069372,-184737,true,9492380843,22,9496178365,3797522
1635069394,-184727,true,9501877497,22,9497127983,-4749514
1635069420,-184734,true,9495228842,22,9498077696,2848854
1635069481,-184734,true,9495228842,22,9491431700,-3797142
1635069540,-184732,true,9497127983,22,9485738834,-11389149
1635069627,-184726,true,9502827685,22,9482893681,-19934004
1635069678,-184733,true,9496178365,22,9475310779,-20867586
1635069702,-184735,true,9494279414,22,9472468754,-21810660
1635069736,-184733,true,9496178365,22,9471521602,-24656763
1635069803,-184729,true,9499977406,22,9466787262,-33190144
1635069821,-184736,true,9493330081,22,9466787262,-26542819
1635069825,-184736,true,9493330081,22,9466787262,-26542819
1635069845,-184734,true,9495228842,22,9468680714,-26548128
1635069876,-184726,true,9502827685,22,9471521602,-31306083
1635069893,-184733,true,9496178365,22,9474363343,-21815022
1635069896,-184734,true,9495228842,22,9474363343,-20865499
1635069903,-184732,true,9497127983,22,9475310779,-21817204
1635070037,-184726,true,9502827685,22,9492380843,-10446842
1635070078,-184729,true,9499977406,22,9497127983,-2849423
1635070114,-184730,true,9499027504,22,9499027504,0
1635070128,-184727,true,9501877497,22,9499027504,-2849993
1635070209,-184722,true,9506629386,22,9500927404,-5701982
1635070232,-184724,true,9504728345,22,9503777967,-950378
1635070319,-184722,true,9506629386,22,9517091908,10462522
1635070325,-184720,true,9508530807,22,9518043618,9512811
1635070411,-184715,true,9513286023,22,9531377544,18091521
1635070455,-184719,true,9509481660,22,9538051510,28569850
1635070662,-184721,true,9507580049,22,9560013176,52433127
1635070736,-184718,true,9510432608,22,9560013176,49580568
1635070740,-184712,true,9516140294,22,9559057271,42916977
1635070774,-184715,true,9513286023,22,9555234603,41948580
1635070785,-184721,true,9507580049,22,9555234603,47654554
1635070803,-184719,true,9509481660,22,9553323843,43842183
1635070812,-184717,true,9511383651,22,9552368606,40984955
1635070864,-184719,true,9509481660,22,9549503469,40021809
1635070904,-184724,true,9504728345,22,9547593855,42865510
1635070942,-184721,true,9507580049,22,9545684622,38104573
1635070980,-184719,true,9509481660,22,9543775772,34294112
1635071018,-184721,true,9507580049,22,9541867303,34287254
1635071019,-184726,true,9502827685,22,9541867303,39039618
1635071043,-184724,true,9504728345,22,9541867303,37138958
1635071082,-184722,true,9506629386,22,9539959215,33329829
1635071115,-184726,true,9502827685,22,9535190666,32362981
1635071197,-184727,true,9501877497,22,9534237243,32359746
1635071208,-184725,true,9503777967,22,9533283914,29505947
1635071306,-184724,true,9504728345,22,9518995422,14267077
1635071325,-184726,true,9502827685,22,9516140294,13312609
1635071433,-184731,true,9498077696,22,9509481660,11403964
1635071636,-184728,true,9500927404,22,9504728345,3800941
1635071665,-184725,true,9503777967,22,9504728345,950378
1635071694,-184727,true,9501877497,22,9503777967,1900470
1635071714,-184731,true,9498077696,22,9502827685,4749989
1635071733,-184730,true,9499027504,22,9500927404,1899900
1635071739,-184726,true,9502827685,22,9500927404,-1900281
1635071765,-184727,true,9501877497,22,9500927404,-950093
1635071779,-184727,true,9501877497,22,9500927404,-950093
1635071804,-184723,true,9505678818,22,9499977406,-5701412
1635071870,-184715,true,9513286023,22,9508530807,-4755216
1635071934,-184716,true,9512334790,22,9507580049,-4754741
1635071997,-184719,true,9509481660,22,9508530807,-950853
1635072030,-184717,true,9511383651,22,9518043618,6659967
1635072090,-184713,true,9515188775,22,9519947321,4758546
1635072103,-184714,true,9514237352,22,9519947321,5709969
1635072163,-184714,true,9514237352,22,9529471554,15234202
1635072189,-184714,true,9514237352,22,9529471554,15234202
1635072197,-184711,true,9517091908,22,9529471554,12379646
1635072246,-184711,true,9517091908,22,9533283914,16192006
1635072274,-184709,true,9518995422,22,9536144186,17148764
1635072304,-184708,true,9519947321,22,9539959215,20011894
1635072312,-184704,true,9523755872,22,9540913211,17157339
1635072332,-184705,true,9522803591,22,9542821489,20017898
1635072369,-184705,true,9522803591,22,9547593855,24790264
1635072378,-184705,true,9522803591,22,9547593855,24790264
1635072392,-184701,true,9526613284,22,9550458419,23845135
1635072432,-184698,true,9529471554,22,9559057271,29585717
1635072507,-184701,true,9526613284,22,9563837755,37224471
1635072546,-184702,true,9525660718,22,9562881467,37220749
1635072615,-184698,true,9529471554,22,9573405898,43934344
1635072626,-184696,true,9531377544,22,9575320675,43943131
1635072695,-184697,true,9530424501,22,9582983613,52559112
1635072797,-184696,true,9531377544,22,9584900306,53522762
1635072816,-184691,true,9536144186,22,9591611749,55467563
1635072837,-184688,true,9539005315,22,9600247653,61242338
1635072843,-184687,true,9539959215,22,9603128016,63168801
1635072877,-184677,true,9549503469,22,9618504550,69001081
1635072944,-184672,true,9554279176,22,9632942410,78663234
1635072970,-184668,true,9558101460,22,9645472752,87371292
1635072983,-184667,true,9559057271,22,9653191831,94134560
1635073011,-184655,true,9570534450,22,9669615392,99080942
1635073063,-184644,true,9581067304,22,9696726898,115659594
1635073095,-184638,true,9586817381,22,9719053920,132236539
1635073130,-184638,true,9586817381,22,9736563095,149745714
1635073213,-184626,true,9598327892,22,9784386936,186059044
1635073216,-184615,true,9608891333,22,9786343911,177452578
1635073252,-184608,true,9615619575,22,9807896489,192276914
1635073259,-184608,true,9615619575,22,9808877279,193257704
1635073283,-184597,true,9626202047,22,9820654408,194452361
1635073334,-184586,true,9636796165,22,9841298418,204502253
1635073342,-184581,true,9641615527,22,9846220052,204604525
1635073389,-184581,true,9641615527,22,9868891286,227275759
1635073449,-184571,true,9651261482,22,9908443926,257182444
1635073552,-184562,true,9659951093,22,9964084077,304132984
1635073576,-184558,true,9663815653,22,9976047557,312231904
1635073660,-184558,true,9663815653,22,10016029659,352214006
1635073712,-184548,true,9673483819,22,10037084368,363600549
1635073742,-184541,true,9680257289,22,10042103914,361846625
1635073776,-184537,true,9684129973,22,10046121358,361991385
1635073800,-184538,true,9683161657,22,10049135496,365973839
1635073866,-184526,true,9694787844,22,10062207213,367419369
1635073872,-184517,true,9703516644,22,10062207213,358690569
1635073917,-184513,true,9707398633,22,10059189155,351790522
1635073925,-184514,true,9706427990,22,10059189155,352761165
1635073970,-184501,true,9719053920,22,10061201093,342147173
1635073980,-184494,true,9725859299,22,10062207213,336347914
1635074030,-184488,true,9731696274,22,10068246047,336549773
1635074069,-184485,true,9734616075,22,10074288505,339672430
1635074109,-184470,true,9749228224,22,10083358993,334130769
1635074144,-184460,true,9758981841,22,10089410521,330428680
1635074162,-184452,true,9766791760,22,10096475227,329683467
1635074211,-184446,true,9772653300,22,10116687372,344034072
1635074240,-184429,true,9789280108,22,10128834077,339553969
1635074269,-184416,true,9802013810,22,10151140925,349127115
1635074287,-184407,true,9810839152,22,10164345329,353506177
1635074300,-184397,true,9820654408,22,10174514249,353859841
1635074344,-184376,true,9841298418,22,10207123211,365824793
1635074382,-184362,true,9855085195,22,10233694931,378609736
1635074427,-184352,true,9864944716,22,10267520214,402575498
1635074488,-184341,true,9875801583,22,10320015692,444214109
1635074512,-184319,true,9897551175,22,10340675343,443124168
1635074545,-184304,true,9912407898,22,10366558077,454150179
1635074555,-184292,true,9924309332,22,10374854227,450544895
1635074566,-184285,true,9931258433,22,10383157016,451898583
1635074614,-184263,true,9953130158,22,10426855794,473725636
1635074642,-184248,true,9968070309,22,10448774101,480703792
1635074686,-184237,true,9979040670,22,10485407049,506366379
1635074710,-184227,true,9989024203,22,10504296833,515272630
1635074746,-184206,true,10010022144,22,10531642171,521620027
1635074756,-184190,true,10026050197,22,10539016533,512966336
1635074799,-184178,true,10038088077,22,10574908376,536820299
1635074817,-184169,true,10047125970,22,10586546593,539420623
1635074832,-184147,true,10069252872,22,10596078297,526825425
1635074874,-184134,true,10082350757,22,10618352327,536001570
1635074900,-184126,true,10090419462,22,10632164471,541745009
1635074904,-184117,true,10099504473,22,10634291010,534786537
1635074989,-184101,true,10115675805,22,10654514358,538838553
1635074993,-184093,true,10123771178,22,10655579809,531808631
1635074998,-184086,true,10130859945,22,10655579809,524719864
1635075014,-184077,true,10139981367,22,10658776803,518795436
1635075043,-184062,true,10155201990,22,10663040953,507838963
1635075081,-184050,true,10167394937,22,10674776165,507381228
1635075136,-184043,true,10174514249,22,10686524291,512010042
1635075244,-184038,true,10179602524,22,10655579809,475977285
1635075303,-184022,true,10195902109,22,10631101361,435199252
1635075359,-184011,true,10207123211,22,10598197619,391074408
1635075418,-184005,true,10213249016,22,10567508900,354259884
1635075450,-184001,true,10217334929,22,10553780750,336445821
1635075480,-183987,true,10231648499,22,10535855460,304206961
1635075498,-183977,true,10241884753,22,10523220648,281335895
1635075518,-183973,true,10245982121,22,10511652047,265669926
1635075544,-183972,true,10247006720,22,10493798311,246791591
1635075588,-183956,true,10263414232,22,10474927407,211513175
1635075648,-183944,true,10275737106,22,10448774101,173036995
1635075683,-183942,true,10277792356,22,10431027162,153234806
1635075696,-183937,true,10282932280,22,10424770735,141838455
1635075697,-183920,true,10300427257,22,10423728363,123301106
1635075715,-183912,true,10308670483,22,10411228015,102557532
1635075742,-183911,true,10309701350,22,10398742659,89041309
1635075762,-183908,true,10312794570,22,10391466450,78671880
1635075783,-183891,true,10330340353,22,10385233751,54893398
1635075798,-183882,true,10339641379,22,10381080696,41439317
1635075823,-183880,true,10341709411,22,10376929302,35219891
1635075859,-183878,true,10343777856,22,10374854227,31076371
1635075871,-183869,true,10353090981,22,10372779567,19688586
1635075908,-183864,true,10358268562,22,10358268562,0
1635075913,-183866,true,10356197219,22,10356197219,0
1635075945,-183867,true,10355161703,22,10347915988,-7245715
1635075953,-183862,true,10360340319,22,10342743582,-17596737
1635075983,-183866,true,10356197219,22,10320015692,-36181527
1635076059,-183864,true,10358268562,22,10293219841,-65048721
1635076069,-183865,true,10357232838,22,10291161506,-66071332
1635076079,-183859,true,10363448732,22,10288074774,-75373958
1635076081,-183859,true,10363448732,22,10287046070,-76402662
1635076097,-183857,true,10365521525,22,10284988969,-80532556
1635076124,-183853,true,10369668356,22,10284988969,-84679387
1635076157,-183846,true,10376929302,22,10280876002,-96053300
1635076195,-183846,true,10376929302,22,10277792356,-99136946
1635076203,-183842,true,10381080696,22,10276764679,-104316017
1635076213,-183840,true,10383157016,22,10276764679,-106392337
1635076278,-183834,true,10389388468,22,10276764679,-112623789
1635076318,-183835,true,10388349633,22,10273682266,-114667367
1635076339,-183831,true,10392505596,22,10272655001,-119850595
1635076358,-183829,true,10394584201,22,10273682266,-120901935
1635076373,-183822,true,10401862593,22,10275737106,-126125487
1635076384,-183822,true,10401862593,22,10275737106,-126125487
1635076417,-183815,true,10409146082,22,10282932280,-126213802
1635076443,-183811,true,10413310365,22,10293219841,-120090524
1635076478,-183805,true,10419559913,22,10296308116,-123251797
1635076531,-183808,true,10416434670,22,10287046070,-129388600
1635076533,-183803,true,10421643930,22,10287046070,-134597860
1635076537,-183802,true,10422686094,22,10286017468,-136668626
1635076558,-183800,true,10424770735,22,10283960573,-140810162
1635076565,-183804,true,10420601869,22,10281904090,-138697779
1635076602,-183800,true,10424770735,22,10277792356,-146978379
1635076605,-183801,true,10423728363,22,10278820135,-144908228
1635076626,-183800,true,10424770735,22,10280876002,-143894733
1635076631,-183805,true,10419559913,22,10279848017,-139711896
1635076643,-183805,true,10419559913,22,10277792356,-141767557
1635076666,-183806,true,10418518062,22,10276764679,-141753383
1635076742,-183807,true,10417476314,22,10266493565,-150982749
1635076744,-183815,true,10409146082,22,10266493565,-142652517
1635076747,-183817,true,10407064565,22,10265467018,-141597547
1635076777,-183822,true,10401862593,22,10265467018,-136395575
1635076804,-183826,true,10397702888,22,10269573821,-128129067
1635076810,-183836,true,10387310902,22,10270600778,-116710124
1635076819,-183838,true,10385233751,22,10271627838,-113605913
1635076872,-183848,true,10374854227,22,10274709635,-100144592
1635076906,-183855,true,10367594733,22,10272655001,-94939732
1635076951,-183865,true,10357232838,22,10265467018,-91765820
1635076992,-183871,true,10351020673,22,10251106137,-99914536
1635077001,-183880,true,10341709411,22,10247006720,-94702691
1635077014,-183889,true,10332406524,22,10240860667,-91545857
1635077025,-183902,true,10318983794,22,10233694931,-85288863
1635077048,-183909,true,10311763393,22,10221422476,-90340917
1635077054,-183919,true,10301457299,22,10219378498,-82078801
1635077064,-183927,true,10293219841,22,10215291768,-77928073
1635077108,-183939,true,10280876002,22,10197941392,-82934610
1635077127,-183947,true,10272655001,22,10187749057,-84905944
1635077135,-183958,true,10261361857,22,10181638546,-79723311
1635077149,-183967,true,10252131248,22,10174514249,-77616999
1635077179,-183981,true,10237789023,22,10155201990,-82587033
1635077208,-183988,true,10230625436,22,10134912897,-95712539
1635077263,-183999,true,10219378498,22,10094456235,-124922263
1635077283,-184004,true,10214270341,22,10079326657,-134943684
1635077303,-184017,true,10201001080,22,10065226177,-135774903
1635077327,-184021,true,10196921699,22,10048130683,-148791016
1635077342,-184029,true,10188767832,22,10038088077,-150679755
1635077350,-184033,true,10184693343,22,10032067331,-152626012
1635077388,-184052,true,10165361763,22,10001017627,-164344136
1635077406,-184059,true,10158248855,22,9991022108,-167226747
1635077473,-184066,true,10151140925,22,9953130158,-198010767
1635077488,-184069,true,10148096191,22,9945171236,-202924955
1635077511,-184084,true,10132886218,22,9933244784,-199641434
1635077521,-184089,true,10127821294,22,9927286923,-200534371
1635077545,-184092,true,10124783556,22,9918356830,-206426726
1635077564,-184094,true,10122758903,22,9908443926,-214314977
1635077577,-184107,true,10109608523,22,9904481539,-205126984
1635077632,-184107,true,10109608523,22,9884693361,-224915162
1635077685,-184106,true,10110619484,22,9866917804,-243701680
1635077695,-184109,true,10107586905,22,9863958321,-243628584
1635077731,-184124,true,10092437647,22,9854099785,-238337862
1635077736,-184124,true,10092437647,22,9852129261,-240308386
1635077805,-184127,true,10089410521,22,9833428921,-255981600
1635077814,-184130,true,10086384303,22,9831462530,-254921773
1635077878,-184142,true,10074288505,22,9818690571,-255597934
1635077914,-184141,true,10075295934,22,9811820236,-263475698
1635077978,-184145,true,10071266823,22,9802994012,-268272811
1635078000,-184149,true,10067239323,22,9799073794,-268165529
1635078037,-184165,true,10051145424,22,9799073794,-252071630
1635078065,-184165,true,10051145424,22,9801033707,-250111717
1635078085,-184169,true,10047125970,22,9802994012,-244131958
1635078092,-184174,true,10042103914,22,9803974311,-238129603
1635078134,-184188,true,10028055507,22,9804954709,-223100798
1635078176,-184184,true,10032067331,22,9817708800,-214358531
1635078191,-184185,true,10031064225,22,9818690571,-212373654
1635078241,-184186,true,10030061219,22,9827530928,-202530291
1635078258,-184194,true,10022040779,22,9832445677,-189595102
1635078282,-184194,true,10022040779,22,9840314387,-181726392
1635078287,-184195,true,10021038675,22,9841298418,-179740257
1635078319,-184197,true,10019034768,22,9846220052,-172814716
1635078345,-184210,true,10006019136,22,9851144147,-154874989
1635078428,-184211,true,10005018634,22,9865931211,-139087423
1635078498,-184217,true,9999017723,22,9859027821,-139989902
1635078545,-184221,true,9995019116,22,9851144147,-143874969
1635078555,-184233,true,9983032885,22,9849174213,-133858672
1635078570,-184236,true,9980038574,22,9849174213,-130864361
1635078617,-184237,true,9979040670,22,9849174213,-129866457
1635078691,-184239,true,9977045162,22,9850159131,-126886031
1635078695,-184251,true,9965080486,22,9850159131,-114921355
1635078728,-184253,true,9963087769,22,9852129261,-110958508
1635078740,-184256,true,9960099440,22,9853114474,-106984966
1635078782,-184260,true,9956116396,22,9850159131,-105957265
1635078787,-184272,true,9944176819,22,9850159131,-94017688
1635078838,-184276,true,9940200142,22,9860013723,-80186419
1635078876,-184279,true,9937218678,22,9866917804,-70300874
1635078921,-184283,true,9933244784,22,9871852250,-61392534
1635078928,-184292,true,9924309332,22,9872839435,-51469897
1635078953,-184295,true,9921332635,22,9873826719,-47505916
1635078973,-184298,true,9918356830,22,9874814102,-43542728
1635079045,-184299,true,9917365094,22,9880740471,-36624623
1635079046,-184309,true,9907453181,22,9880740471,-26712710
1635079071,-184312,true,9904481539,22,9878764620,-25716919
1635079170,-184314,true,9902500940,22,9869878175,-32622765
1635079185,-184315,true,9901510789,22,9868891286,-32619503
1635079202,-184325,true,9891614722,22,9868891286,-22723436
1635079248,-184327,true,9889636696,22,9867904496,-21732200
1635079291,-184330,true,9886670398,22,9865931211,-20739187
1635079313,-184331,true,9885681830,22,9868891286,-16790544
1635079328,-184340,true,9876789163,22,9868891286,-7897877
1635079377,-184338,true,9878764620,22,9885681830,6917210
1635079403,-184341,true,9875801583,22,9890625659,14824076
1635079414,-184342,true,9874814102,22,9894582503,19768401
1635079418,-184350,true,9866917804,22,9896561519,29643715
1635079457,-184347,true,9869878175,22,9911416757,41538582
1635079476,-184344,true,9872839435,22,9914390479,41551044
1635079579,-184343,true,9873826719,22,9935231533,61404814
1635079625,-184349,true,9867904496,22,9950144816,82240320
1635079686,-184344,true,9872839435,22,9978042866,105203431
1635079712,-184339,true,9877776842,22,9978042866,100266024
1635079727,-184336,true,9880740471,22,9984031189,103290718
1635079767,-184338,true,9878764620,22,9998017921,119253301
1635079805,-184329,true,9887659065,22,10016029659,128370594
1635079826,-184320,true,9896561519,22,10027052802,130491283
1635079847,-184316,true,9900520737,22,10038088077,137567340
1635079887,-184318,true,9898540930,22,10061201093,162660163
1635079944,-184310,true,9906462535,22,10087392941,180930406
1635079971,-184301,true,9915381918,22,10100514423,185132505
1635080102,-184296,true,9920340601,22,10170445461,250104860
1635080189,-184295,true,9921332635,22,10207123211,285790576
1635080216,-184285,true,9931258433,22,10215291768,284033335
1635080221,-184275,true,9941194162,22,10216313297,275119135
1635080239,-184271,true,9945171236,22,10220400436,275229200
1635080264,-184270,true,9946165753,22,10224489209,278323456
1635080286,-184262,true,9954125471,22,10230625436,276499965
1635080321,-184253,true,9963087769,22,10240860667,277772898
1635080372,-184252,true,9964084077,22,10244957626,280873549
1635080395,-184247,true,9969067116,22,10248031420,278964304
1635080449,-184236,true,9980038574,22,10264440574,284402000
1635080495,-184225,true,9991022108,22,10278820135,287798027
1635080538,-184220,true,9996018618,22,10291161506,295142888
1635080566,-184216,true,10000017625,22,10298367480,298349855
1635080616,-184203,true,10013025451,22,10320015692,306990241
1635080620,-184194,true,10022040779,22,10320015692,297974913
1635080720,-184190,true,10026050197,22,10329307422,303257225
1635080811,-184189,true,10027052802,22,10333439765,306386963
1635080820,-184180,true,10036080760,22,10334473109,298392349
1635080863,-184172,true,10044112435,22,10340675343,296562908
1635080907,-184171,true,10045116847,22,10341709411,296592564
1635080948,-184170,true,10046121358,22,10342743582,296622224
1635080991,-184162,true,10054161069,22,10339641379,285480310
1635081017,-184153,true,10063213434,22,10339641379,276427945
1635081041,-184152,true,10064219755,22,10343777856,279558101
1635081042,-184150,true,10066232700,22,10343777856,277545156
1635081106,-184140,true,10076303464,22,10351020673,274717209
1635081146,-184132,true,10084367328,22,10346881300,262513972
1635081224,-184133,true,10083358993,22,10335506556,252147563
1635081338,-184132,true,10084367328,22,10318983794,234616466
1635081370,-184125,true,10091428504,22,10308670483,217241979
1635081415,-184118,true,10098494623,22,10291161506,192666883
1635081548,-184120,true,10096475227,22,10237789023,141313796
1635081559,-184117,true,10099504473,22,10233694931,134190458
1635081578,-184113,true,10103544880,22,10226534209,122989329
1635081613,-184106,true,10110619484,22,10214270341,103650857
1635081641,-184111,true,10105565690,22,10204061686,98495996
1635081717,-184112,true,10104555235,22,10173496900,68941665
1635081777,-184108,true,10108597663,22,10151140925,42543262
1635081786,-184102,true,10114664338,22,10148096191,33431853
1635081853,-184103,true,10113652973,22,10138967470,25314497
1635081890,-184100,true,10116687372,22,10138967470,22280098
1635081916,-184093,true,10123771178,22,10135926388,12155210
1635081951,-184085,true,10131873031,22,10128834077,-3038954
1635081977,-184086,true,10130859945,22,10123771178,-7088767
1635081981,-184084,true,10132886218,22,10122758903,-10127315
1635082029,-184076,true,10140995365,22,10117699041,-23296324
1635082112,-184071,true,10146066877,22,10121746728,-24320149
1635082191,-184074,true,10143023665,22,10125796034,-17227631
1635082216,-184073,true,10144037968,22,10126808614,-17229354
1635082237,-184064,true,10153171254,22,10127821294,-25349960
1635082336,-184059,true,10158248855,22,10133899507,-24349348
1635082418,-184060,true,10157233132,22,10144037968,-13195164
1635082455,-184058,true,10159264680,22,10149111001,-10153679
1635082481,-184050,true,10167394937,22,10152156039,-15238898
1635082502,-184046,true,10171462505,22,10154186572,-17275933
1635082526,-184049,true,10168411677,22,10155201990,-13209687
1635082605,-184050,true,10167394937,22,10160280607,-7114330
1635082628,-184042,true,10175531701,22,10161296635,-14235066
1635082647,-184036,true,10181638546,22,10161296635,-20341911
1635082662,-184038,true,10179602524,22,10162312765,-17289759
1635082716,-184038,true,10179602524,22,10160280607,-19321917
1635082762,-184030,true,10187749057,22,10156217510,-31531547
1635082860,-184023,true,10194882621,22,10151140925,-43741696
1635082924,-184025,true,10192843950,22,10152156039,-40687911
1635082936,-184025,true,10192843950,22,10153171254,-39672696
1635082958,-184015,true,10203041382,22,10156217510,-46823872
1635082986,-184008,true,10210185654,22,10156217510,-53968144
1635083024,-184009,true,10209164738,22,10159264680,-49900058
1635083036,-184009,true,10209164738,22,10160280607,-48884131
1635083058,-184004,true,10214270341,22,10162312765,-51957576
1635083093,-183999,true,10219378498,22,10161296635,-58081863
1635083106,-184001,true,10217334929,22,10161296635,-56038294
1635083112,-184002,true,10216313297,22,10161296635,-55016662
1635083146,-183998,true,10220400436,22,10163328996,-57071440
1635083197,-183994,true,10224489209,22,10167394937,-57094272
1635083223,-183996,true,10222444618,22,10169428518,-53016100
1635083335,-183998,true,10220400436,22,10170445461,-49954975
1635083399,-183995,true,10223466862,22,10171462505,-52004357
1635083498,-183991,true,10227556863,22,10181638546,-45918317
1635083526,-183995,true,10223466862,22,10187749057,-35717805
1635083561,-183998,true,10220400436,22,10194882621,-25517815
1635083596,-183999,true,10219378498,22,10185711813,-33666685
1635083616,-183999,true,10219378498,22,10187749057,-31629441
1635083668,-184001,true,10217334929,22,10197941392,-19393537
1635083727,-184004,true,10214270341,22,10212227793,-2042548
1635083733,-183999,true,10219378498,22,10213249016,-6129482
1635083813,-183997,true,10221422476,22,10230625436,9202960
1635083854,-183999,true,10219378498,22,10235741772,16363274
1635083872,-184000,true,10218356662,22,10239836683,21480021
1635083900,-183996,true,10222444618,22,10243933232,21488614
1635083939,-183994,true,10224489209,22,10249056223,24567014
1635083976,-183993,true,10225511658,22,10256232715,30721057
1635083980,-183994,true,10224489209,22,10257258339,32769130
1635084015,-183989,true,10229602476,22,10266493565,36891089
1635084036,-183987,true,10231648499,22,10271627838,39979339
1635084068,-183985,true,10233694931,22,10278820135,45125204
1635084089,-183986,true,10232671664,22,10280876002,48204338
1635084092,-183983,true,10235741772,22,10281904090,46162318
1635084139,-183984,true,10234718300,22,10289103582,54385282
1635084160,-183986,true,10232671664,22,10294249163,61577499
1635084182,-183988,true,10230625436,22,10300427257,69801821
1635084185,-183986,true,10232671664,22,10301457299,68785635
1635084253,-183985,true,10233694931,22,10321047694,87352763
1635084259,-183984,true,10234718300,22,10323112006,88393706
1635084281,-183985,true,10233694931,22,10329307422,95612491
1635084302,-183983,true,10235741772,22,10333439765,97697993
1635084355,-183983,true,10235741772,22,10346881300,111139528
1635084376,-183982,true,10236765346,22,10353090981,116325635
1635084387,-183984,true,10234718300,22,10355161703,120443403
1635084410,-183980,true,10238812802,22,10361376353,122563551
1635084438,-183977,true,10241884753,22,10368631493,126746740
1635084483,-183975,true,10243933232,22,10388349633,144416401
1635084493,-183975,true,10243933232,22,10395623660,151690428
1635084511,-183972,true,10247006720,22,10403943070,156936350
1635084610,-183967,true,10252131248,22,10424770735,172639487
1635084708,-183961,true,10258284065,22,10445640096,187356031
1635084747,-183960,true,10259309893,22,10452954238,193644345
1635084805,-183954,true,10265467018,22,10465504684,200037666
1635084840,-183949,true,10270600778,22,10469691514,199090736
1635084855,-183942,true,10277792356,22,10471785557,193993201
1635084866,-183941,true,10278820135,22,10472832736,194012601
1635084907,-183936,true,10283960573,22,10478070199,194109626
1635084922,-183931,true,10289103582,22,10478070199,188966617
1635084954,-183925,true,10295278588,22,10477022497,181743909
1635084956,-183922,true,10298367480,22,10477022497,178655017
1635084970,-183920,true,10300427257,22,10477022497,176595240
1635084986,-183915,true,10305578500,22,10475974900,170396400
1635085003,-183914,true,10306609058,22,10475974900,169365842
1635085031,-183915,true,10305578500,22,10473880019,168301519
1635085111,-183916,true,10304548046,22,10459227579,154679533
1635085135,-183912,true,10308670483,22,10453999533,145329050
1635085165,-183910,true,10310732320,22,10447729328,136997008
1635085216,-183910,true,10310732320,22,10439374905,128642585
1635085244,-183911,true,10309701350,22,10435200199,125498849
1635085261,-183907,true,10313825849,22,10432070264,118244415
1635085275,-183905,true,10315888718,22,10429984163,114095445
1635085323,-183905,true,10315888718,22,10420601869,104713151
1635085376,-183907,true,10313825849,22,10407064565,93238716
1635085395,-183902,true,10318983794,22,10402902780,83918986
1635085411,-183900,true,10321047694,22,10398742659,77694965
1635085439,-183901,true,10320015692,22,10392505596,72489904
1635085453,-183901,true,10320015692,22,10388349633,68333941
1635085475,-183897,true,10324144318,22,10383157016,59012698
1635085497,-183894,true,10327241871,22,10377966995,50725124
1635085523,-183890,true,10331373387,22,10376929302,45555915
1635085536,-183889,true,10332406524,22,10373816845,41410321
1635085601,-183888,true,10333439765,22,10348950780,15511015
1635085678,-183883,true,10338607518,22,10336540107,-2067411
1635085757,-183879,true,10342743582,22,10323112006,-19631576
1635085779,-183880,true,10341709411,22,10320015692,-21693719
1635085817,-183878,true,10343777856,22,10313825849,-29952007
1635085819,-183873,true,10348950780,22,10313825849,-35124931
1635085857,-183871,true,10351020673,22,10309701350,-41319323
1635085897,-183874,true,10347915988,22,10305578500,-42337488
1635085920,-183874,true,10347915988,22,10303517694,-44398294
1635085950,-183873,true,10348950780,22,10302487445,-46463335
1635085985,-183872,true,10349985675,22,10298367480,-51618195
1635086034,-183875,true,10346881300,22,10293219841,-53661459
1635086118,-183876,true,10345846715,22,10286017468,-59829247
1635086221,-183871,true,10351020673,22,10288074774,-62945899
1635086228,-183870,true,10352055775,22,10289103582,-62952193
1635086299,-183871,true,10351020673,22,10292190622,-58830051
1635086344,-183872,true,10349985675,22,10287046070,-62939605
1635086502,-183866,true,10356197219,22,10304548046,-51649173
1635086533,-183864,true,10358268562,22,10304548046,-53720516
1635086534,-183865,true,10357232838,22,10304548046,-52684792
1635086578,-183864,true,10358268562,22,10301457299,-56811263
1635086605,-183859,true,10363448732,22,10302487445,-60961287
1635086613,-183857,true,10365521525,22,10303517694,-62003831
1635086633,-183855,true,10367594733,22,10305578500,-62016233
1635086663,-183852,true,10370705323,22,10307639719,-63065604
1635086711,-183847,true,10375891713,22,10311763393,-64128320
1635086728,-183848,true,10374854227,22,10313825849,-61028378
1635086739,-183851,true,10371742393,22,10312794570,-58947823
1635086763,-183851,true,10371742393,22,10311763393,-59979000
1635086774,-183848,true,10374854227,22,10314857232,-59996995
1635086792,-183848,true,10374854227,22,10318983794,-55870433
1635086899,-183848,true,10374854227,22,10349985675,-24868552
1635086958,-183846,true,10376929302,22,10367594733,-9334569
1635086996,-183844,true,10379004791,22,10379004791,0
1635087022,-183844,true,10379004791,22,10385233751,6228960
1635087042,-183845,true,10377966995,22,10388349633,10382638
1635087079,-183845,true,10377966995,22,10394584201,16617206
1635087112,-183842,true,10381080696,22,10403943070,22862374
1635087139,-183840,true,10383157016,22,10412269138,29112122
1635087181,-183839,true,10384195332,22,10424770735,40575403
1635087187,-183836,true,10387310902,22,10425813212,38502310
1635087274,-183835,true,10388349633,22,10442507030,54157397
1635087303,-183835,true,10388349633,22,10445640096,57290463
1635087338,-183835,true,10388349633,22,10449818979,61469346
1635087353,-183835,true,10388349633,22,10451909047,63559414
1635087371,-183834,true,10389388468,22,10452954238,63565770
1635087387,-183834,true,10389388468,22,10455044933,65656465
1635087435,-183834,true,10389388468,22,10459227579,69839111
1635087439,-183833,true,10390427407,22,10460273501,69846094
1635087476,-183831,true,10392505596,22,10465504684,72999088
1635087616,-183831,true,10392505596,22,10472832736,80327140
1635087626,-183832,true,10391466450,22,10472832736,81366286
1635087655,-183832,true,10391466450,22,10480165918,88699468
1635087657,-183832,true,10391466450,22,10480165918,88699468
1635087672,-183832,true,10391466450,22,10481213935,89747485
1635087715,-183832,true,10391466450,22,10483310282,91843832
1635087747,-183832,true,10391466450,22,10486455590,94989140
1635087777,-183832,true,10391466450,22,10488552986,97086536
1635087804,-183833,true,10390427407,22,10489601841,99174434
1635087806,-183832,true,10391466450,22,10490650801,99184351
1635087831,-183832,true,10391466450,22,10492749036,101282586
1635087877,-183832,true,10391466450,22,10495897176,104430726
1635087879,-183832,true,10391466450,22,10495897176,104430726
1635087927,-183832,true,10391466450,22,10499046260,107579810
1635087961,-183831,true,10392505596,22,10501146174,108640578
1635088001,-183830,true,10393544847,22,10501146174,107601327
1635088025,-183830,true,10393544847,22,10500096165,106551318
1635088058,-183827,true,10396663222,22,10496946766,100283544
1635088093,-183826,true,10397702888,22,10494847691,97144803
1635088128,-183825,true,10398742659,22,10490650801,91908142
1635088142,-183824,true,10399782533,22,10491699867,91917334
1635088157,-183821,true,10402902780,22,10489601841,86699061
1635088171,-183821,true,10402902780,22,10489601841,86699061
1635088203,-183818,true,10406023963,22,10488552986,82529023
1635088211,-183817,true,10407064565,22,10489601841,82537276
1635088275,-183812,true,10412269138,22,10489601841,77332703
1635088315,-183812,true,10412269138,22,10488552986,76283848
1635088375,-183806,true,10418518062,22,10500096165,81578103
1635088399,-183804,true,10420601869,22,10507448437,86846568
1635088400,-183797,true,10427898479,22,10507448437,79549958
1635088406,-183794,true,10431027162,22,10509550032,78522870
1635088502,-183784,true,10441462884,22,10544287095,102824211
1635088517,-183782,true,10443551281,22,10549560293,106009012
1635088524,-183776,true,10449818979,22,10551670311,101851332
1635088579,-183772,true,10453999533,22,10575965867,121966334
1635088661,-183760,true,10466551235,22,10607739813,141188578
1635088675,-183761,true,10465504684,22,10608800587,143295903
1635088726,-183757,true,10469691514,22,10619414163,149722649
1635088777,-183751,true,10475974900,22,10631101361,155126461
1635088805,-183744,true,10483310282,22,10637481616,154171334
1635088847,-183744,true,10483310282,22,10648123886,164813604
1635088879,-183740,true,10487504236,22,10655579809,168075573
1635088926,-183735,true,10492749036,22,10669440377,176691341
1635088937,-183727,true,10501146174,22,10674776165,173629991
1635088994,-183724,true,10504296833,22,10698285347,193988514
1635089043,-183719,true,10509550032,22,10716486989,206936957
1635089073,-183713,true,10515857339,22,10725063180,209205841
1635089120,-183706,true,10523220648,22,10734719599,211498951
1635089131,-183703,true,10526377930,22,10740088032,213710102
1635089149,-183696,true,10533748605,22,10747608350,213859745
1635089179,-183689,true,10541124441,22,10755133933,214009492
1635089185,-183681,true,10549560293,22,10757285067,207724774
1635089257,-183678,true,10552725478,22,10777742314,225016836
1635089329,-183673,true,10558002896,22,10780975960,222973064
1635089355,-183667,true,10564339281,22,10780975960,216636679
1635089373,-183662,true,10569622508,22,10779897971,210275463
1635089388,-183659,true,10572793712,22,10780975960,208182248
1635089398,-183654,true,10578081166,22,10780975960,202894794
1635089416,-183648,true,10584429601,22,10783132263,198702662
1635089489,-183639,true,10593959399,22,10788524908,194565509
1635089511,-183636,true,10597137905,22,10788524908,191387003
1635089586,-183634,true,10599257438,22,10789603761,190346323
1635089600,-183629,true,10604558127,22,10791761789,187203662
1635089617,-183622,true,10611983545,22,10793920249,181936704
1635089630,-183619,true,10615167459,22,10797158749,181991290
1635089640,-183616,true,10618352327,22,10794999641,176647314
1635089648,-183622,true,10611983545,22,10779897971,167914426
1635089654,-183630,true,10603497777,22,10770200912,166703135
1635089668,-183648,true,10584429601,22,10751908038,167478437
1635089679,-183657,true,10574908376,22,10740088032,165179656
1635089680,-183660,true,10571736538,22,10739014131,167277593
1635089681,-183663,true,10568565651,22,10739014131,170448480
1635089693,-183670,true,10561170613,22,10729353849,168183236
1635089702,-183671,true,10560114602,22,10725063180,164948578
1635089707,-183672,true,10559058696,22,10721846305,162787609
1635089726,-183675,true,10555891612,22,10712201466,156309854
1635089734,-183679,true,10551670311,22,10711130353,159460042
1635089740,-183678,true,10552725478,22,10710059347,157333869
1635089787,-183667,true,10564339281,22,10718630394,154291113
1635089847,-183661,true,10570679470,22,10721846305,151166835
1635089851,-183663,true,10568565651,22,10721846305,153280654
1635089881,-183664,true,10567508900,22,10710059347,142550447
1635089918,-183656,true,10575965867,22,10706846972,130881105
1635089925,-183654,true,10578081166,22,10706846972,128765806
1635089930,-183657,true,10574908376,22,10706846972,131938596
1635089944,-183653,true,10579138974,22,10708988448,129849474
1635089957,-183642,true,10590781847,22,10711130353,120348506
1635090066,-183634,true,10599257438,22,10744384712,145127274
1635090072,-183635,true,10598197619,22,10746533696,148336077
1635090103,-183631,true,10602437534,22,10752983229,150545695
1635090124,-183619,true,10615167459,22,10755133933,139966474
1635090136,-183613,true,10621538152,22,10756209446,134671294
1635090149,-183615,true,10619414163,22,10757285067,137870904
1635090186,-183610,true,10624724932,22,10769123999,144399067
1635090234,-183598,true,10637481616,22,10783132263,145650647
1635090286,-183590,true,10645994581,22,10802558409,156563828
1635090310,-183592,true,10643865701,22,10807960768,164095067
1635090346,-183588,true,10648123886,22,10809041564,160917678
1635090353,-183576,true,10660908665,22,10809041564,148132899
1635090375,-183569,true,10668373540,22,10812284601,143911061
1635090391,-183573,true,10664107257,22,10812284601,148177344
1635090418,-183569,true,10668373540,22,10814447166,146073626
1635090434,-183556,true,10682250750,22,10817691825,135441075
1635090462,-183549,true,10689730569,22,10825266481,135535912
1635090465,-183552,true,10686524291,22,10826349008,139824717
1635090504,-183548,true,10690799542,22,10829597237,138797695
1635090512,-183537,true,10702565304,22,10828514386,125949082
1635090520,-183531,true,10708988448,22,10827431643,118443195
1635090547,-183534,true,10705776394,22,10845853009,140076615
1635090556,-183530,true,10710059347,22,10862133182,152073835
1635090602,-183516,true,10725063180,22,10915485573,190422393
1635090612,-183511,true,10730426784,22,10922036502,191609718
1635090641,-183512,true,10729353849,22,10942807059,213453210
1635090660,-183511,true,10730426784,22,10941712887,211286103
1635090759,-183501,true,10741162041,22,10930777190,189615149
1635090811,-183501,true,10741162041,22,10938431030,197268989
1635090892,-183504,true,10737940337,22,10931870268,193929931
1635090911,-183504,true,10737940337,22,10927498613,189558276
1635090927,-183497,true,10745459151,22,10924221019,178761868
1635091004,-183500,true,10742236157,22,10902395501,160159344
1635091028,-183505,true,10736866650,22,10896945938,160079288
1635091046,-183505,true,10736866650,22,10893677508,156810858
1635091125,-183499,true,10743310381,22,10870825930,127515549
1635091156,-183505,true,10736866650,22,10855618182,118751532
1635091184,-183511,true,10730426784,22,10836096620,105669836
1635091241,-183513,true,10728281021,22,10803638664,75357643
1635091283,-183509,true,10732572977,22,10783132263,50559286
1635091324,-183514,true,10727208300,22,10762664786,35456486
1635091502,-183520,true,10720774227,22,10674776165,-45998062
1635091537,-183523,true,10717558638,22,10654514358,-63044280
1635091547,-183520,true,10720774227,22,10649188698,-71585529
1635091592,-183526,true,10714344014,22,10633227687,-81116327
1635091650,-183533,true,10706846972,22,10621538152,-85308820
1635091653,-183535,true,10704705924,22,10621538152,-83167772
1635091687,-183530,true,10710059347,22,10615167459,-94891888
1635091702,-183533,true,10706846972,22,10610922453,-95924519
1635091711,-183539,true,10700425111,22,10609861467,-90563644
1635091719,-183540,true,10699355176,22,10608800587,-90554589
1635091763,-183535,true,10704705924,22,10600317364,-104388560
1635091779,-183539,true,10700425111,22,10598197619,-102227492
1635091787,-183545,true,10694007103,22,10596078297,-97928806
1635091827,-183547,true,10691868622,22,10588664008,-103204614
1635091847,-183542,true,10697215626,22,10585488044,-111727582
1635091878,-183548,true,10690799542,22,10578081166,-112718376
1635091907,-183554,true,10684387307,22,10570679470,-113707837
1635091925,-183558,true,10680114620,22,10566452255,-113662365
1635091947,-183556,true,10682250750,22,10561170613,-121080137
1635091977,-183564,true,10673708794,22,10551670311,-122038483
1635092005,-183572,true,10665173668,22,10541124441,-124049227
1635092009,-183574,true,10663040953,22,10540070434,-122970519
1635092044,-183571,true,10666240185,22,10532695335,-133544850
1635092070,-183578,true,10658776803,22,10532695335,-126081468
1635092098,-183585,true,10651318643,22,10532695335,-118623308
1635092103,-183586,true,10650253617,22,10532695335,-117558282
1635092113,-183571,true,10666240185,22,10532695335,-133544850
1635092126,-183561,true,10676911227,22,10533748605,-143162622
1635092142,-183545,true,10694007103,22,10536909046,-157098057
1635092192,-183537,true,10702565304,22,10543232772,-159332532
1635092209,-183525,true,10715415448,22,10546396058,-169019390
1635092238,-183521,true,10719702257,22,10549560293,-170141964
1635092272,-183513,true,10728281021,22,10561170613,-167110408
1635092303,-183512,true,10729353849,22,10571736538,-157617311
1635092349,-183501,true,10741162041,22,10584429601,-156732440
1635092361,-183496,true,10746533696,22,10587605248,-158928448
1635092388,-183495,true,10747608350,22,10595018795,-152589555
1635092416,-183497,true,10745459151,22,10600317364,-145141787
1635092451,-183499,true,10743310381,22,10614106048,-129204333
1635092452,-183501,true,10741162041,22,10614106048,-127055993
1635092568,-183495,true,10747608350,22,10663040953,-84567397
1635092594,-183493,true,10749757979,22,10673708794,-76049185
1635092634,-183490,true,10752983229,22,10691868622,-61114607
1635092706,-183488,true,10755133933,22,10713272686,-41861247
1635092712,-183482,true,10761588627,22,10714344014,-47244613
1635092759,-183485,true,10758360796,22,10730426784,-27934012
1635092789,-183486,true,10757285067,22,10743310381,-13974686
1635092805,-183493,true,10749757979,22,10746533696,-3224283
1635092831,-183487,true,10756209446,22,10754058527,-2150919
1635092853,-183492,true,10750832955,22,10761588627,10755672
1635092866,-183495,true,10747608350,22,10765893908,18285558
1635092907,-183499,true,10743310381,22,10783132263,39821882
1635092910,-183493,true,10749757979,22,10783132263,33374284
1635092984,-183499,true,10743310381,22,10804719028,61408647
1635092992,-183504,true,10737940337,22,10807960768,70020431
1635093009,-183510,true,10731499827,22,10814447166,82947339
1635093021,-183504,true,10737940337,22,10816610164,78669827
1635093074,-183510,true,10731499827,22,10825266481,93766654
1635093101,-183515,true,10726135687,22,10829597237,103461550
1635093185,-183518,true,10722918489,22,10841515752,118597263
1635093191,-183511,true,10730426784,22,10842599904,112173120
1635093202,-183516,true,10725063180,22,10842599904,117536724
1635093225,-183520,true,10720774227,22,10845853009,125078782
1635093232,-183525,true,10715415448,22,10844768532,129353084
1635093278,-183521,true,10719702257,22,10842599904,122897647
1635093329,-183527,true,10713272686,22,10842599904,129327218
1635093341,-183532,true,10707917657,22,10840431709,132514052
1635093355,-183533,true,10706846972,22,10839347774,132500802
1635093409,-183525,true,10715415448,22,10837180230,121764782
1635093421,-183528,true,10712201466,22,10836096620,123895154
1635093463,-183534,true,10705776394,22,10829597237,123820843
1635093486,-183536,true,10703635560,22,10825266481,121630921
1635093513,-183532,true,10707917657,22,10818773594,110855937
1635093529,-183534,true,10705776394,22,10814447166,108670772
1635093614,-183540,true,10699355176,22,10785288998,85933822
1635093621,-183542,true,10697215626,22,10783132263,85916637
1635093634,-183537,true,10702565304,22,10782054058,79488754
1635093653,-183541,true,10698285347,22,10774509638,76224291
1635093695,-183545,true,10694007103,22,10765893908,71886805
1635093732,-183546,true,10692937809,22,10763741052,70803243
1635093805,-183543,true,10696146011,22,10744384712,48238701
1635093817,-183546,true,10692937809,22,10739014131,46076322
1635093844,-183552,true,10686524291,22,10731499827,44975536
1635093906,-183554,true,10684387307,22,10715415448,31028141
1635093965,-183549,true,10689730569,22,10702565304,12834735
1635093985,-183549,true,10689730569,22,10698285347,8554778
1635093991,-183551,true,10687592944,22,10696146011,8553067
1635094007,-183551,true,10687592944,22,10690799542,3206598
1635094109,-183551,true,10687592944,22,10641737247,-45855697
1635094225,-183549,true,10689730569,22,10619414163,-70316406
1635094260,-183551,true,10687592944,22,10605618583,-81974361
1635094292,-183552,true,10686524291,22,10588664008,-97860283
1635094342,-183553,true,10685455746,22,10564339281,-121116465
1635094386,-183556,true,10682250750,22,10541124441,-141126309
1635094391,-183559,true,10679046716,22,10539016533,-140030183
1635094425,-183560,true,10677978918,22,10525325397,-152653521
1635094469,-183561,true,10676911227,22,10513754483,-163156744
1635094511,-183565,true,10672641530,22,10502196289,-170445241
1635094525,-183569,true,10668373540,22,10496946766,-171426774
1635094594,-183573,true,10664107257,22,10472832736,-191274521
1635094618,-183575,true,10661974756,22,10463411897,-198562859
1635094695,-183582,true,10654514358,22,10419559913,-234954445
1635094704,-183587,true,10649188698,22,10415393131,-233795567
1635094727,-183593,true,10642801421,22,10406023963,-236777458
1635094731,-183596,true,10639609219,22,10403943070,-235666149
1635094829,-183601,true,10634291010,22,10353090981,-281200029
1635094843,-183605,true,10630038357,22,10344812234,-285226123
1635094847,-183611,true,10623662566,22,10341709411,-281953155
1635094875,-183612,true,10622600305,22,10329307422,-293292883
1635094951,-183615,true,10619414163,22,10304548046,-314866117
1635094979,-183622,true,10611983545,22,10290132492,-321851053
1635094988,-183628,true,10605618583,22,10288074774,-317543809
1635095022,-183630,true,10603497777,22,10274709635,-328788142
1635095055,-183638,true,10595018795,22,10253156461,-341862334
1635095104,-183644,true,10588664008,22,10224489209,-364174799
1635095175,-183653,true,10579138974,22,10178584665,-400554309
1635095219,-183661,true,10570679470,22,10152156039,-418523431
1635095268,-183671,true,10560114602,22,10126808614,-433305988
1635095292,-183678,true,10552725478,22,10115675805,-437049673
1635095297,-183687,true,10543232772,22,10112641709,-430591063
1635095349,-183695,true,10534801980,22,10084367328,-450434652
1635095353,-183706,true,10523220648,22,10082350757,-440869891
1635095363,-183714,true,10514805858,22,10077311094,-437494764
1635095395,-183726,true,10502196289,22,10058183337,-444012952
1635095417,-183736,true,10491699867,22,10045116847,-446583020
1635095489,-183745,true,10482262056,22,10002017729,-480244327
1635095541,-183751,true,10475974900,22,9991022108,-484952792
1635095585,-183761,true,10465504684,22,9987026698,-478477986
1635095596,-183775,true,10450863961,22,9987026698,-463837263
1635095660,-183782,true,10443551281,22,9986028095,-457523186
1635095694,-183789,true,10436243719,22,9986028095,-450215624
1635095788,-183801,true,10423728363,22,9968070309,-455658054
1635095823,-183816,true,10408105271,22,9959103530,-449001741
1635095867,-183821,true,10402902780,22,9962091559,-440811221
1635095927,-183827,true,10396663222,22,9965080486,-431582736
1635095964,-183836,true,10387310902,22,9963087769,-424223133
1635096077,-183847,true,10375891713,22,9999017723,-376873990
1635096102,-183851,true,10371742393,22,10009021242,-362721151
1635096141,-183855,true,10367594733,22,10019034768,-348559965
1635096183,-183864,true,10358268562,22,10027052802,-331215760
1635096269,-183876,true,10345846715,22,10053155753,-292690962
1635096281,-183880,true,10341709411,22,10056172002,-285537409
1635096320,-183886,true,10335506556,22,10063213434,-272293122
1635096347,-183895,true,10326209250,22,10068246047,-257963203
1635096376,-183912,true,10308670483,22,10073281177,-235389306
1635096388,-183916,true,10304548046,22,10075295934,-229252112
1635096407,-183922,true,10298367480,22,10074288505,-224078975
1635096447,-183932,true,10288074774,22,10071266823,-216807951
1635096517,-183949,true,10270600778,22,10064219755,-206381023
1635096605,-183955,true,10264440574,22,10051145424,-213295150
1635096637,-183962,true,10257258339,22,10045116847,-212141492
1635096641,-183971,true,10248031420,22,10045116847,-202914573
1635096661,-183986,true,10232671664,22,10044112435,-188559229
1635096697,-183992,true,10226534209,22,10042103914,-184430295
1635096726,-183996,true,10222444618,22,10040095795,-182348823
1635096797,-184008,true,10210185654,22,10016029659,-194155995
1635096854,-184026,true,10191824768,22,10006019136,-185805632
1635096922,-184036,true,10181638546,22,9978042866,-203595680
1635096999,-184040,true,10177566909,22,9944176819,-233390090
1635097035,-184053,true,10164345329,22,9930265407,-234079922
1635097155,-184073,true,10144037968,22,9866917804,-277120164
1635097171,-184083,true,10133899507,22,9859027821,-274871686
1635097212,-184085,true,10131873031,22,9843266776,-288606255
1635097236,-184097,true,10119722682,22,9834412264,-285310418
1635097301,-184117,true,10099504473,22,9812801418,-286703055
1635097309,-184126,true,10090419462,22,9808877279,-281542183
1635097334,-184132,true,10084367328,22,9795155145,-289212183
1635097358,-184147,true,10069252872,22,9782430352,-286822520
1635097397,-184168,true,10048130683,22,9763862308,-284268375
1635097435,-184175,true,10041099804,22,9751178168,-289921636
1635097454,-184178,true,10038088077,22,9742406494,-295681583
1635097461,-184191,true,10025047692,22,9739484356,-285563336
1635097471,-184211,true,10005018634,22,9735589536,-269429098
1635097499,-184222,true,9994019714,22,9720997828,-273021886
1635097749,-184220,true,9996018618,22,9673483819,-322534799
1635097753,-184232,true,9984031189,22,9673483819,-310547370
1635097780,-184245,true,9971061029,22,9672516567,-298544462
1635097887,-184257,true,9959103530,22,9664782035,-294321495
1635097901,-184252,true,9964084077,22,9664782035,-299302042
1635097910,-184264,true,9952134945,22,9663815653,-288319292
1635097940,-184278,true,9938212400,22,9665748513,-272463887
1635097998,-184283,true,9933244784,22,9673483819,-259760965
1635098016,-184278,true,9938212400,22,9676386154,-261826246
1635098042,-184290,true,9926294293,22,9680257289,-246037004
1635098079,-184305,true,9911416757,22,9679289360,-232127397
1635098107,-184314,true,9902500940,22,9678321528,-224179412
1635098118,-184310,true,9906462535,22,9678321528,-228141007
1635098166,-184323,true,9893593144,22,9677353793,-216239351
1635098179,-184338,true,9878764620,22,9676386154,-202378466
1635098248,-184342,true,9874814102,22,9684129973,-190684129
1635098282,-184337,true,9879752496,22,9688004206,-191748290
1635098292,-184347,true,9869878175,22,9688973006,-180905169
1635098318,-184361,true,9856070704,22,9684129973,-171940731
1635098344,-184369,true,9848189394,22,9678321528,-169867866
1635098350,-184366,true,9851144147,22,9678321528,-172822619
1635098384,-184375,true,9842282548,22,9678321528,-163961020
1635098424,-184395,true,9822618637,22,9658985195,-163633442
1635098534,-184399,true,9818690571,22,9647401943,-171288628
1635098581,-184396,true,9821636473,22,9634869095,-186767378
1635098606,-184406,true,9811820236,22,9627164667,-184655569
1635098644,-184424,true,9794175727,22,9612735466,-181440261
1635098702,-184429,true,9789280108,22,9587776063,-201504045
1635098745,-184430,true,9788301278,22,9557145746,-231155532
1635098766,-184439,true,9779496210,22,9541867303,-237628907
1635098791,-184457,true,9761909828,22,9525660718,-236249110
1635098805,-184466,true,9753128501,22,9516140294,-236988207
1635098874,-184466,true,9753128501,22,9463947793,-289180708
1635098888,-184475,true,9744355072,22,9452598434,-291756638
1635098911,-184495,true,9724886810,22,9435599910,-289286900
1635098912,-184504,true,9716138787,22,9434656445,-281482342
1635098927,-184505,true,9715167270,22,9423342213,-291825057
1635098933,-184513,true,9707398633,22,9417690186,-289708447
1635098977,-184537,true,9684129973,22,9379158626,-304971347
1635099034,-184542,true,9679289360,22,9347325226,-331964134
1635099047,-184547,true,9674451167,22,9337049335,-337401832
1635099081,-184556,true,9665748513,22,9316531430,-349217083
1635099130,-184579,true,9643543947,22,9284910590,-358633357
1635099141,-184591,true,9631979212,22,9276558347,-355420865
1635099187,-184600,true,9623314764,22,9232139778,-391174986
1635099191,-184610,true,9613696740,22,9228447845,-385248895
1635099219,-184637,true,9587776063,22,9209089406,-378686657
1635099230,-184651,true,9574363238,22,9199885379,-374477859
1635099247,-184661,true,9564794139,22,9186096585,-378697554
1635099273,-184674,true,9552368606,22,9157665198,-394703408
1635099281,-184711,true,9517091908,22,9146683140,-370408768
1635099335,-184724,true,9504728345,22,9108349544,-396378801
1635099389,-184728,true,9500927404,22,9071083622,-429843782
1635099456,-184738,true,9491431700,22,9025843660,-465588040
1635099466,-184773,true,9458271411,22,9018626233,-439645178
1635099477,-184782,true,9449763222,22,9011414578,-438348644
1635099504,-184784,true,9447873553,22,8998808054,-449065499
1635099553,-184789,true,9443151033,22,8985320635,-457830398
1635099587,-184818,true,9415806930,22,8973647890,-442159040
1635099605,-184826,true,9408277673,22,8965575644,-442702029
1635099613,-184828,true,9406396300,22,8965575644,-440820656
1635099638,-184835,true,9399814455,22,8962886509,-436927946
1635099665,-184862,true,9374470453,22,8964679176,-409791277
1635099717,-184870,true,9366974251,22,8957510659,-409463592
1635099726,-184870,true,9366974251,22,8958406410,-408567841
1635099743,-184876,true,9361356033,22,8958406410,-402949623
1635099791,-184902,true,9337049335,22,8957510659,-379538676
1635099868,-184910,true,9329583055,22,8954823943,-374759112
1635099952,-184912,true,9327717419,22,8953928550,-373788869
1635099996,-184917,true,9323054959,22,8945874042,-377180917
1635100033,-184943,true,9298847709,22,8946768630,-352079079
1635100039,-184949,true,9293270353,22,8946768630,-346501723
1635100060,-184952,true,9290482929,22,8952138033,-338344896
1635100123,-184955,true,9287696342,22,8968265585,-319430757
1635100164,-184979,true,9265433709,22,8984422192,-281011517
1635100255,-184983,true,9261728462,22,9019528096,-242200366
1635100358,-184982,true,9262654635,22,9044816898,-217837737
1635100381,-184983,true,9261728462,22,9052055284,-209673178
1635100388,-185006,true,9240452028,22,9052960490,-187491538
1635100489,-185005,true,9241376073,22,9076527633,-164848440
1635100558,-184998,true,9247846977,22,9101066143,-146780834
1635100577,-184997,true,9248771762,22,9105617586,-143154176
1635100587,-185016,true,9231216656,22,9108349544,-122867112
1635100626,-185016,true,9231216656,22,9117461994,-113754662
1635100659,-185012,true,9234909697,22,9124758517,-110151180
1635100706,-185010,true,9236756771,22,9137541485,-99215286
1635100742,-185031,true,9217380902,22,9152172522,-65208380
1635100819,-185024,true,9223835005,22,9187933896,-35901109
1635100837,-185025,true,9222912714,22,9195286816,-27625898
1635100847,-185022,true,9225679864,22,9198965483,-26714381
1635100968,-185042,true,9207247864,22,9259876394,52628530
1635100975,-185037,true,9211852409,22,9263580901,51728492
1635100997,-185039,true,9210010315,22,9274703314,64692999
1635101054,-185035,true,9213694872,22,9305358856,91663984
1635101091,-185054,true,9196206345,22,9323987264,127780919
1635101117,-185051,true,9198965483,22,9336115723,137150240
1635101187,-185054,true,9196206345,22,9366037647,169831302
1635101205,-185051,true,9198965483,22,9372595840,173630357
1635101258,-185067,true,9184259641,22,9394176540,209916899
1635101305,-185062,true,9188852689,22,9404515303,215662614
1635101343,-185065,true,9186096585,22,9409218501,223121916
1635101384,-185061,true,9189771575,22,9413924051,224152476
1635101407,-185079,true,9173245690,22,9414865443,241619753
1635101456,-185075,true,9176915539,22,9415806930,238891391
1635101477,-185077,true,9175080431,22,9419573818,244493387
1635101583,-185071,true,9180586856,22,9438430873,257844017
1635101592,-185087,true,9165910395,22,9442206812,276296417
1635101658,-185078,true,9174163015,22,9449763222,275600207
1635101672,-185079,true,9173245690,22,9445984261,272738571
1635101689,-185074,true,9177833230,22,9444095348,266262118
1635101925,-185087,true,9165910395,22,9424284547,258374152
1635101948,-185084,true,9168660443,22,9420515775,251855332
1635101965,-185084,true,9168660443,22,9417690186,249029743
1635101972,-185078,true,9174163015,22,9419573818,245410803
1635102009,-185089,true,9164077488,22,9421457827,257380339
1635102012,-185080,true,9172328457,22,9422399973,250071516
1635102110,-185076,true,9175997939,22,9417690186,241692247
1635102122,-185068,true,9183341307,22,9416748511,233407204
1635102147,-185078,true,9174163015,22,9414865443,240702428
1635102240,-185067,true,9184259641,22,9400754437,216494796
1635102253,-185066,true,9185178067,22,9399814455,214636388
1635102305,-185059,true,9191609621,22,9397934774,206325153
1635102309,-185069,true,9182423065,22,9396995075,214572010
1635102351,-185058,true,9192528782,22,9392297987,199769205
1635102448,-185060,true,9190690552,22,9358548187,167857635
1635102467,-185055,true,9195286816,22,9352935023,157648207
1635102751,-185058,true,9192528782,22,9283053886,90525104
1635102778,-185051,true,9198965483,22,9276558347,77592864
1635102805,-185053,true,9197125966,22,9270067353,72941387
1635102828,-185047,true,9202645621,22,9266360253,63714632
1635102870,-185053,true,9197125966,22,9255247845,58121879
1635102983,-185042,true,9207247864,22,9231216656,23968792
1635103003,-185037,true,9211852409,22,9233062992,21210583
1635103044,-185026,true,9221990515,22,9242300211,20309696
1635103129,-185021,true,9226602432,22,9271921459,45319027
1635103144,-185001,true,9245073178,22,9278413752,33340574
1635103162,-184996,true,9249696639,22,9283982192,34285553
1635103222,-184979,true,9265433709,22,9316531430,51097721
1635103273,-184966,true,9277486003,22,9339850730,62364727
1635103393,-184945,true,9296988219,22,9423342213,126353994
1635103436,-184944,true,9297917917,22,9457325679,159407762
1635103484,-184932,true,9309081558,22,9492380843,183299285
1635103492,-184919,true,9321190627,22,9498077696,176887069
1635103518,-184901,true,9337983040,22,9516140294,178157254
1635103534,-184899,true,9339850730,22,9530424501,190573771
1635103571,-184888,true,9350129704,22,9563837755,213708051
1635103608,-184875,true,9362292168,22,9598327892,236035724
1635103627,-184855,true,9381034552,22,9615619575,234585023
1635103629,-184854,true,9381972655,22,9617542795,235570140
1635103720,-184836,true,9398874568,22,9717110401,318235833
1635103781,-184826,true,9408277673,22,9770699062,362421389
1635103843,-184807,true,9426169498,22,9820654408,394484910
1635103885,-184807,true,9426169498,22,9855085195,428915697
1635103908,-184793,true,9439374716,22,9864944716,425570000
1635103984,-184788,true,9444095348,22,9867904496,423809148
1635104064,-184770,true,9461109177,22,9883704990,422595813
1635104134,-184773,true,9458271411,22,9883704990,425433579
1635104139,-184758,true,9472468754,22,9883704990,411236236
1635104225,-184748,true,9481945487,22,9902500940,420555453
1635104247,-184731,true,9498077696,22,9901510789,403433093
1635104274,-184730,true,9499027504,22,9902500940,403473436
1635104302,-184718,true,9510432608,22,9903491190,393058582
1635104347,-184710,true,9518043618,22,9899530784,381487166
1635104405,-184692,true,9535190666,22,9899530784,364340118
1635104416,-184694,true,9533283914,22,9899530784,366246870
1635104454,-184682,true,9544730149,22,9894582503,349852354
1635104464,-184674,true,9552368606,22,9894582503,342213897
1635104509,-184661,true,9564794139,22,9886670398,321876259
1635104602,-184667,true,9559057271,22,9853114474,294057203
1635104607,-184657,true,9568620631,22,9851144147,282523516
1635104667,-184650,true,9575320675,22,9835395705,260075030
1635104679,-184639,true,9585858796,22,9828513681,242654885
1635104687,-184646,true,9579151378,22,9827530928,248379550
1635104808,-184639,true,9585858796,22,9780474159,194615363
1635104883,-184638,true,9586817381,22,9758981841,172164460
1635104894,-184630,true,9594489520,22,9758981841,164492321
1635104914,-184637,true,9587776063,22,9759957739,172181676
1635104943,-184631,true,9593530167,22,9759957739,166427572
1635104951,-184623,true,9601207678,22,9757030337,155822659
1635104962,-184617,true,9606969843,22,9753128501,146158658
1635105002,-184622,true,9602167799,22,9756054732,153886933
1635105181,-184616,true,9607930540,22,9750203147,142272607
1635105215,-184608,true,9615619575,22,9748253399,132633824
1635105230,-184601,true,9622352529,22,9748253399,125900870
1635105275,-184607,true,9616581137,22,9745329508,128748371
1635105495,-184602,true,9621390389,22,9723914419,102524030
1635105522,-184596,true,9627164667,22,9721969928,94805261
1635105625,-184588,true,9634869095,22,9726831885,91962790
1635105633,-184593,true,9630053105,22,9727804568,97751463
1635105640,-184588,true,9634869095,22,9726831885,91962790
1635105649,-184580,true,9642579689,22,9726831885,84252196
1635105685,-184580,true,9642579689,22,9720997828,78418139
1635105779,-184588,true,9634869095,22,9720997828,86128733
1635105848,-184585,true,9637759845,22,9698666341,60906496
1635105857,-184579,true,9643543947,22,9697696571,54152624
1635105963,-184577,true,9645472752,22,9670582354,25109602
1635105975,-184584,true,9638723621,22,9667681759,28958138
1635106049,-184581,true,9641615527,22,9633905704,-7709823
1635106068,-184573,true,9649331520,22,9625239523,-24091997
1635106073,-184575,true,9647401943,22,9621390389,-26011554
1635106150,-184582,true,9640651462,22,9591611749,-49039713
1635106337,-184584,true,9638723621,22,9495228842,-143494779
1635106422,-184578,true,9644508301,22,9466787262,-177721039
1635106455,-184582,true,9640651462,22,9449763222,-190888240
1635106481,-184589,true,9633905704,22,9437487125,-196418579
1635106531,-184589,true,9633905704,22,9412982753,-220922951
1635106563,-184586,true,9636796165,22,9402634682,-234161483
1635106646,-184582,true,9640651462,22,9401694512,-238956950
1635106652,-184587,true,9635832582,22,9400754437,-235078145
1635106731,-184584,true,9638723621,22,9399814455,-238909166
1635106773,-184578,true,9644508301,22,9397934774,-246573527
1635106830,-184575,true,9647401943,22,9390419809,-256982134
1635106862,-184575,true,9647401943,22,9385726007,-261675936
1635106935,-184571,true,9651261482,22,9383849143,-267412339
1635106977,-184566,true,9656088078,22,9385726007,-270362071
1635106996,-184563,true,9658985195,22,9385726007,-273259188
1635107035,-184564,true,9658019393,22,9382910852,-275108541
1635107053,-184560,true,9661883180,22,9382910852,-278972328
1635107091,-184550,true,9671549412,22,9398874568,-272674844
1635107116,-184548,true,9673483819,22,9409218501,-264265318
1635107127,-184547,true,9674451167,22,9413924051,-260527116
1635107140,-184545,true,9676386154,22,9418631955,-257754199
1635107152,-184542,true,9679289360,22,9422399973,-256889387
1635107183,-184544,true,9677353793,22,9440318654,-237035139
1635107226,-184546,true,9675418612,22,9454489049,-220929563
1635107284,-184548,true,9673483819,22,9463001493,-210482326
1635107329,-184547,true,9674451167,22,9469627582,-204823585
1635107392,-184553,true,9668648527,22,9485738834,-182909693
1635107509,-184560,true,9661883180,22,9492380843,-169502337
1635107537,-184564,true,9658019393,22,9488584840,-169434553
1635107578,-184567,true,9655122566,22,9483841970,-171280596
1635107609,-184576,true,9646437299,22,9480049382,-166387917
1635107615,-184585,true,9637759845,22,9479101472,-158658373
1635107638,-184592,true,9631016111,22,9476258310,-154757801
1635107649,-184597,true,9626202047,22,9473416001,-152786046
1635107687,-184611,true,9612735466,22,9462055288,-150680178
1635107701,-184621,true,9603128016,22,9458271411,-144856605
1635107737,-184634,true,9590652684,22,9447873553,-142779131
1635107744,-184638,true,9586817381,22,9445984261,-140833120
1635107792,-184652,true,9573405898,22,9432769796,-140636102
1635107856,-184662,true,9563837755,22,9412041549,-151796206
1635107963,-184671,true,9555234603,22,9389480861,-165753742
1635107983,-184669,true,9557145746,22,9380096542,-177049204
1635107991,-184681,true,9545684622,22,9374470453,-171214169
1635107994,-184688,true,9539005315,22,9372595840,-166409475
1635108082,-184695,true,9532330681,22,9332382210,-199948471
1635108119,-184697,true,9530424501,22,9318394829,-212029672
1635108179,-184709,true,9518995422,22,9296058613,-222936809
1635108186,-184717,true,9511383651,22,9294199680,-217183971
1635108191,-184725,true,9503777967,22,9291411978,-212365989
1635108225,-184727,true,9501877497,22,9274703314,-227174183
1635108271,-184743,true,9486687408,22,9254322413,-232364995
1635108337,-184751,true,9479101472,22,9233986298,-245115174
1635108513,-184756,true,9474363343,22,9212773594,-261589749
1635108569,-184758,true,9472468754,22,9210931316,-261537438
1635108604,-184773,true,9458271411,22,9210931316,-247340095
1635108625,-184779,true,9452598434,22,9210931316,-241667118
1635108633,-184785,true,9446928860,22,9210931316,-235997544
1635108693,-184786,true,9445984261,22,9213694872,-232289389
1635108707,-184800,true,9432769796,22,9214616241,-218153555
1635108815,-184805,true,9428054826,22,9214616241,-213438585
1635108846,-184807,true,9426169498,22,9215537703,-210631795
1635108864,-184802,true,9430883525,22,9216459256,-214424269
1635108902,-184816,true,9417690186,22,9221068408,-196621778
1635108943,-184819,true,9414865443,22,9221068408,-193797035
1635108958,-184821,true,9412982753,22,9221068408,-191914345
1635108988,-184825,true,9409218501,22,9221068408,-188150093
1635109032,-184837,true,9397934774,22,9222912714,-175022060
1635109061,-184842,true,9393237216,22,9223835005,-169402211
1635109095,-184846,true,9389480861,22,9226602432,-162878429
1635109099,-184851,true,9384787528,22,9227525092,-157262436
1635109124,-184863,true,9373533100,22,9232139778,-141393322
1635109151,-184868,true,9368847739,22,9235833188,-133014551
1635109243,-184871,true,9366037647,22,9245073178,-120964469
1635109263,-184875,true,9362292168,22,9247846977,-114445191
1635109333,-184892,true,9346390587,22,9224757388,-121633199
1635109585,-184892,true,9346390587,22,9249696639,-96693948
1635109618,-184894,true,9344521589,22,9252471826,-92049763
1635109634,-184897,true,9341718793,22,9256173370,-85545423
1635109666,-184903,true,9336115723,22,9258024697,-78091026
1635109710,-184902,true,9337049335,22,9259876394,-77172941
1635109791,-184901,true,9337983040,22,9269140439,-68842601
1635109868,-184903,true,9336115723,22,9276558347,-59557376
1635109915,-184912,true,9327717419,22,9273775936,-53941483
1635109947,-184913,true,9326784740,22,9271921459,-54863281
1635110035,-184913,true,9326784740,22,9268213618,-58571122
1635110052,-184917,true,9323054959,22,9268213618,-54841341
1635110081,-184921,true,9319326669,22,9268213618,-51113051
1635110105,-184923,true,9317463083,22,9264507259,-52955824
1635110115,-184920,true,9320258602,22,9263580901,-56677701
1635110174,-184923,true,9317463083,22,9268213618,-49249465
1635110194,-184926,true,9314668403,22,9275630784,-39037619
1635110218,-184928,true,9312805749,22,9276558347,-36247402
1635110246,-184926,true,9314668403,22,9280269527,-34398876
1635110278,-184925,true,9315599870,22,9281197554,-34402316
1635110327,-184936,true,9305358856,22,9267286889,-38071967
1635110331,-184936,true,9305358856,22,9267286889,-38071967
1635110371,-184937,true,9304428413,22,9262654635,-41773778
1635110438,-184938,true,9303498063,22,9257098987,-46399076
1635110523,-184945,true,9296988219,22,9256173370,-40814849
1635110566,-184945,true,9296988219,22,9256173370,-40814849
1635110580,-184945,true,9296988219,22,9254322413,-42665806
1635110691,-184947,true,9295129100,22,9241376073,-53753027
1635110791,-184956,true,9286767665,22,9221068408,-65699257
1635110826,-184956,true,9286767665,22,9218302640,-68465025
1635110865,-184957,true,9285839081,22,9214616241,-71222840
1635110872,-184964,true,9279341593,22,9214616241,-64725352
1635110934,-184975,true,9269140439,22,9210010315,-59130124
1635110959,-184979,true,9265433709,22,9204486242,-60947467
1635111013,-184984,true,9260802382,22,9193448035,-67354347
1635111042,-184994,true,9251546671,22,9177833230,-73713441
1635111050,-185011,true,9235833188,22,9174163015,-61670173
1635111077,-185015,true,9232139778,22,9164993895,-67145883
1635111098,-185019,true,9228447845,22,9158580965,-69866880
1635111113,-185025,true,9222912714,22,9156749524,-66163190
1635111139,-185039,true,9210010315,22,9152172522,-57837793
1635111171,-185039,true,9210010315,22,9140283022,-69727293
1635111180,-185042,true,9207247864,22,9137541485,-69706379
1635111267,-185043,true,9206327231,22,9130234741,-76092490
1635111283,-185055,true,9195286816,22,9127496218,-67790598
1635111285,-185052,true,9198045678,22,9126583560,-71462118
1635111322,-185056,true,9194367380,22,9115638775,-78728605
1635111350,-185060,true,9190690552,22,9105617586,-85072966
1635111387,-185075,true,9176915539,22,9079250863,-97664676
1635111432,-185071,true,9180586856,22,9059299464,-121287392
1635111474,-185074,true,9177833230,22,9043008206,-134825024
1635111514,-185078,true,9174163015,22,9029454539,-144708476
1635111529,-185090,true,9163161171,22,9024038762,-139122409
1635111562,-185085,true,9167743668,22,9008711694,-159031974
1635111653,-185093,true,9160412773,22,8970059328,-190353445
1635111659,-185097,true,9156749524,22,8969162412,-187587112
1635111704,-185109,true,9145768563,22,8954823943,-190944620
1635111740,-185106,true,9148512568,22,8942296587,-206215981
1635111751,-185114,true,9141197050,22,8935145968,-206051082
1635111766,-185120,true,9135714251,22,8928001067,-207713184
1635111772,-185134,true,9122933839,22,8924430759,-198503080
1635111813,-185130,true,9126583560,22,8911945921,-214637639
1635111837,-185135,true,9122021636,22,8902148660,-219872976
1635111862,-185138,true,9119285577,22,8895030145,-224255432
1635111913,-185150,true,9108349544,22,8884363044,-223986500
1635111945,-185146,true,9111993431,22,8886140005,-225853426
1635111951,-185154,true,9104707115,22,8885251480,-219455635
1635111964,-185157,true,9101976249,22,8885251480,-216724769
1635111969,-185166,true,9093788565,22,8885251480,-208537085
1635112024,-185162,true,9097426626,22,8882586438,-214840188
1635112047,-185166,true,9093788565,22,8887028619,-206759946
1635112164,-185167,true,9092879277,22,8883474696,-209404581
1635112202,-185176,true,9084699776,22,8883474696,-201225080
1635112209,-185169,true,9091060974,22,8884363044,-206697930
1635112268,-185175,true,9085608246,22,8895919648,-189688598
1635112299,-185176,true,9084699776,22,8905710054,-178989722
1635112331,-185186,true,9075620071,22,8911054816,-164565255
1635112359,-185182,true,9079250863,22,8912837116,-166413747
1635112372,-185188,true,9073805219,22,8915511235,-158293984
1635112437,-185188,true,9073805219,22,8926215734,-147589485
1635112456,-185198,true,9064736402,22,8928893867,-135842535
1635112497,-185194,true,9068362841,22,8938720562,-129642279
1635112514,-185200,true,9062923727,22,8942296587,-120627140
1635112526,-185202,true,9061111414,22,8945874042,-115237372
1635112627,-185209,true,9054771172,22,8975442710,-79328462
1635112632,-185203,true,9060205393,22,8977237888,-82967505
1635112645,-185207,true,9056582217,22,8982625577,-73956640
1635112731,-185209,true,9054771172,22,9013216951,-41554221
1635112751,-185211,true,9052960490,22,9019528096,-33432394
1635112762,-185212,true,9052055284,22,9017724461,-34330823
1635112781,-185217,true,9047530614,22,9024038762,-23491852
1635112868,-185223,true,9042103995,22,9036680631,-5423364
1635112968,-185226,true,9039391906,22,9043912506,4520600
1635113004,-185223,true,9042103995,22,9045721379,3617384
1635113048,-185231,true,9034873566,22,9047530614,12657048
1635113053,-185236,true,9030357484,22,9047530614,17173130
1635113057,-185238,true,9028551684,22,9048435367,19883683
1635113059,-185236,true,9030357484,22,9048435367,18077883
1635113067,-185237,true,9029454539,22,9050245145,20790606
1635113073,-185240,true,9026746244,22,9050245145,23498901
1635113089,-185243,true,9024038762,22,9052055284,28016522
1635113120,-185239,true,9027648919,22,9055676650,28027731
1635113166,-185239,true,9027648919,22,9062923727,35274808
1635113260,-185242,true,9024941166,22,9082883108,57941942
1635113430,-185245,true,9022234225,22,9117461994,95227769
1635113446,-185240,true,9026746244,22,9117461994,90715750
1635113466,-185240,true,9026746244,22,9118373740,91627496
1635113506,-185244,true,9023136448,22,9118373740,95237292
1635113517,-185247,true,9020430048,22,9118373740,97943692
1635113635,-185244,true,9023136448,22,9120197506,97061058
1635113657,-185244,true,9023136448,22,9123846132,100709684
1635113688,-185248,true,9019528096,22,9129321808,109793712
1635113763,-185253,true,9015019684,22,9143025381,128005697
1635113811,-185247,true,9020430048,22,9158580965,138150917
1635113887,-185246,true,9021332091,22,9172328457,150996366
1635113915,-185249,true,9018626233,22,9176915539,158289306
1635113937,-185250,true,9017724461,22,9180586856,162862395
1635114031,-185245,true,9022234225,22,9188852689,166618464
1635114056,-185245,true,9022234225,22,9189771575,167537350
1635114066,-185246,true,9021332091,22,9190690552,169358461
1635114109,-185247,true,9020430048,22,9192528782,172098734
1635114182,-185242,true,9024941166,22,9188852689,163911523
1635114250,-185239,true,9027648919,22,9185178067,157529148
1635114261,-185238,true,9028551684,22,9184259641,155707957
1635114276,-185236,true,9030357484,22,9184259641,153902157
1635114298,-185232,true,9033970169,22,9179668889,145698720
1635114319,-185229,true,9036680631,22,9177833230,141152599
1635114321,-185231,true,9034873566,22,9176915539,142041973
1635114363,-185231,true,9034873566,22,9174163015,139289449
1635114427,-185225,true,9040295846,22,9176915539,136619693
1635114494,-185223,true,9042103995,22,9175997939,133893944
1635114497,-185227,true,9038488058,22,9175997939,137509881
1635114539,-185227,true,9038488058,22,9175997939,137509881
1635114565,-185223,true,9042103995,22,9175997939,133893944
1635114605,-185219,true,9045721379,22,9175080431,129359052
1635114617,-185221,true,9043912506,22,9171411316,127498810
1635114621,-185215,true,9049340211,22,9171411316,122071105
1635114667,-185211,true,9052960490,22,9168660443,115699953
1635114703,-185207,true,9056582217,22,9157665198,101082981
1635114706,-185209,true,9054771172,22,9156749524,101978352
1635114743,-185207,true,9056582217,22,9147597808,91015591
1635114830,-185204,true,9059299464,22,9127496218,68196754
1635114878,-185198,true,9064736402,22,9115638775,50902373
1635114921,-185201,true,9062017525,22,9093788565,31771040
1635114975,-185199,true,9063830019,22,9081066804,17236785
1635115012,-185198,true,9064736402,22,9070176604,5440202
1635115044,-185192,true,9070176604,22,9065642876,-4533728
1635115048,-185190,true,9071990730,22,9063830019,-8160711
1635115110,-185185,true,9076527633,22,9059299464,-17228169
1635115136,-185183,true,9078343029,22,9057487875,-20855154
1635115161,-185179,true,9081974911,22,9052960490,-29014421
1635115187,-185179,true,9081974911,22,9048435367,-33539544
1635115191,-185175,true,9085608246,22,9048435367,-37172879
1635115324,-185175,true,9085608246,22,9024038762,-61569484
1635115334,-185172,true,9088334201,22,9022234225,-66099976
1635115380,-185173,true,9087425458,22,9015921186,-71504272
1635115400,-185171,true,9089243034,22,9014118272,-75124762
1635115432,-185171,true,9089243034,22,9011414578,-77828456
1635115440,-185172,true,9088334201,22,9009612565,-78721636
1635115497,-185174,true,9086516807,22,8999707935,-86808872
1635115506,-185173,true,9087425458,22,8998808054,-88617404
1635115629,-185171,true,9089243034,22,9003308358,-85934676
1635115645,-185171,true,9089243034,22,9002408117,-86834917
1635115649,-185172,true,9088334201,22,9001507967,-86826234
1635115657,-185171,true,9089243034,22,9001507967,-87735067
1635115747,-185175,true,9085608246,22,8993410659,-92197587
1635115902,-185175,true,9085608246,22,8995209431,-90398815
1635115916,-185177,true,9083791397,22,8994310000,-89481397
1635116026,-185175,true,9085608246,22,8981727405,-103880841
1635116109,-185180,true,9081066804,22,8968265585,-112801219
1635116254,-185182,true,9079250863,22,8949452929,-129797934
1635116274,-185183,true,9078343029,22,8945874042,-132468987
1635116337,-185186,true,9075620071,22,8931572803,-144047268
1635116342,-185193,true,9069269677,22,8930679735,-138589942
1635116354,-185196,true,9066549440,22,8928893867,-137655573
1635116355,-185198,true,9064736402,22,8928001067,-136735335
1635116368,-185200,true,9062923727,22,8926215734,-136707993
1635116375,-185205,true,9058393624,22,8925323202,-133070422
1635116398,-185207,true,9056582217,22,8922646140,-133936077
1635116412,-185205,true,9058393624,22,8919969882,-138423742
1635116430,-185209,true,9054771172,22,8914619773,-140151399
1635116507,-185214,true,9050245145,22,8894140731,-156104414
1635116543,-185217,true,9047530614,22,8887028619,-160501995
1635116588,-185215,true,9049340211,22,8882586438,-166753773
1635116589,-185219,true,9045721379,22,8882586438,-163134941
1635116609,-185225,true,9040295846,22,8879922195,-160373651
1635116647,-185229,true,9036680631,22,8880810187,-155870444
1635116671,-185227,true,9038488058,22,8880810187,-157677871
1635116675,-185230,true,9035777053,22,8880810187,-154966866
1635116679,-185235,true,9031260520,22,8880810187,-150450333
1635116698,-185240,true,9026746244,22,8880810187,-145936057
1635116701,-185239,true,9027648919,22,8880810187,-146838732
1635116727,-185245,true,9022234225,22,8879034291,-143199934
1635116741,-185249,true,9018626233,22,8879034291,-139591942
1635116785,-185255,true,9013216951,22,8877258751,-135958200
1635116849,-185252,true,9015921186,22,8876371114,-139550072
1635116926,-185254,true,9014118272,22,8875483565,-138634707
1635117004,-185258,true,9010513526,22,8886140005,-124373521
1635117034,-185264,true,9005109110,22,8887028619,-118080491
1635117123,-185259,true,9009612565,22,8909272872,-100339693
1635117148,-185260,true,9008711694,22,8914619773,-94091921
1635117204,-185267,true,9002408117,22,8928893867,-73514250
1635117276,-185273,true,8997008562,22,8942296587,-54711975
1635117306,-185270,true,8999707935,22,8947663306,-52044629
1635117323,-185273,true,8997008562,22,8950347874,-46660688
1635117357,-185278,true,8992511407,22,8955719425,-36791982
1635117359,-185284,true,8987117789,22,8955719425,-31398364
1635117408,-185281,true,8989814193,22,8962886509,-26927684
1635117427,-185286,true,8985320635,22,8963782798,-21537837
1635117460,-185291,true,8980829322,22,8965575644,-15253678
1635117577,-185297,true,8975442710,22,8964679176,-10763534
1635117618,-185295,true,8977237888,22,8963782798,-13455090
1635117628,-185299,true,8973647890,22,8963782798,-9865092
1635117693,-185303,true,8970059328,22,8961990310,-8069018
1635117723,-185308,true,8965575644,22,8960198181,-5377463
1635117737,-185306,true,8967368849,22,8959302250,-8066599
1635117787,-185309,true,8964679176,22,8955719425,-8959751
1635117815,-185315,true,8959302250,22,8953033247,-6269003
1635117842,-185322,true,8953033247,22,8946768630,-6264617
1635117871,-185321,true,8953928550,22,8939614434,-14314116
1635117890,-185326,true,8949452929,22,8935145968,-14306961
1635117941,-185333,true,8943190817,22,8927108356,-16082461
1635118060,-185338,true,8938720562,22,8896809240,-41911322
1635118069,-185335,true,8941402447,22,8894140731,-47261716
1635118072,-185340,true,8936933086,22,8893251406,-43681680
1635118082,-185347,true,8930679735,22,8890583964,-40095771
1635118127,-185355,true,8923538405,22,8875483565,-48054840
1635118154,-185354,true,8924430759,22,8867499622,-56931137
1635118550,-185358,true,8920861879,22,8773127884,-147733995
1635118593,-185363,true,8916402786,22,8759102804,-157299982
1635118640,-185371,true,8909272872,22,8748598709,-160674163
1635118674,-185368,true,8911945921,22,8738107212,-173838709
1635118698,-185375,true,8905710054,22,8730246846,-175463208
1635118749,-185380,true,8901258534,22,8718905466,-182353068
1635118794,-185390,true,8892362170,22,8708449577,-183912593
1635118835,-185391,true,8891473022,22,8696266886,-195206136
1635118913,-185399,true,8884363044,22,8680628466,-203734578
1635118925,-185405,true,8879034291,22,8677157083,-201877208
1635118948,-185414,true,8871047154,22,8671085502,-199961652
1635118980,-185413,true,8871934259,22,8663285425,-208648834
1635118990,-185421,true,8864839905,22,8661553028,-203286877
1635119015,-185424,true,8862180984,22,8658955082,-203225902
1635119032,-185434,true,8853323676,22,8652896237,-200427439
1635119068,-185432,true,8855094429,22,8652031034,-203063395
1635119190,-185437,true,8850668210,22,8646841632,-203826578
1635119224,-185441,true,8847128827,22,8645977034,-201151793
1635119254,-185450,true,8839170391,22,8645977034,-193193357
1635119259,-185447,true,8841822407,22,8645977034,-195845373
1635119265,-185451,true,8838286562,22,8646841632,-191444930
1635119334,-185457,true,8832985446,22,8647706316,-185279130
1635119340,-185466,true,8825039732,22,8647706316,-177333416
1635119342,-185464,true,8826804829,22,8647706316,-179098513
1635119418,-185468,true,8823274989,22,8649435944,-173839045
1635119511,-185471,true,8820628536,22,8646841632,-173786904
1635119555,-185480,true,8812693938,22,8645977034,-166716904
1635119568,-185478,true,8814456565,22,8647706316,-166750249
1635119634,-185482,true,8810931664,22,8658089273,-152842391
1635119733,-185482,true,8810931664,22,8676289454,-134642210
1635119742,-185488,true,8805646955,22,8677157083,-128489872
1635119771,-185486,true,8807408172,22,8680628466,-126779706
1635119824,-185489,true,8804766478,22,8685838146,-118928332
1635119878,-185487,true,8806527519,22,8697136513,-109391006
1635119907,-185492,true,8802125576,22,8702356099,-99769477
1635119928,-185490,true,8803886089,22,8706708148,-97177941
1635120007,-185492,true,8802125576,22,8714547320,-87578256
1635120014,-185491,true,8803005789,22,8715418775,-87587014
1635120050,-185496,true,8798605606,22,8719777356,-78828250
1635120105,-185494,true,8800365415,22,8725010531,-75354884
1635120159,-185496,true,8798605606,22,8730246846,-68358760
1635120199,-185495,true,8799485467,22,8731119871,-68365596
1635120263,-185500,true,8795087043,22,8733739468,-61347575
1635120289,-185498,true,8796846149,22,8734612842,-62233307
1635120326,-185500,true,8795087043,22,8735486304,-59600739
1635120345,-185499,true,8795966552,22,8740728906,-55237646
1635120375,-185507,true,8788932944,22,8744225722,-44707222
1635120397,-185506,true,8789811838,22,8747723937,-42087901
1635120406,-185507,true,8788932944,22,8750348517,-38584427
1635120467,-185509,true,8787175421,22,8756475598,-30699823
1635120480,-185515,true,8781904961,22,8756475598,-25429363
1635120518,-185516,true,8781026858,22,8754724566,-26302292
1635120607,-185515,true,8781904961,22,8762606971,-19297990
1635120664,-185517,true,8780148843,22,8764359580,-15789263
1635120701,-185524,true,8774005197,22,8760854712,-13150485
1635120739,-185526,true,8772250659,22,8756475598,-15775061
1635120788,-185529,true,8769619510,22,8749473569,-20145941
1635120807,-185532,true,8766989150,22,8747723937,-19265213
1635120930,-185538,true,8761730797,22,8738107212,-23623585
1635120949,-185541,true,8759102804,22,8736359852,-22742952
1635121149,-185539,true,8760854712,22,8759978714,-875998
1635121242,-185542,true,8758226981,22,8782783151,24556170
1635121261,-185544,true,8756475598,22,8788932944,32457346
1635121278,-185545,true,8755600038,22,8795087043,39487005
1635121289,-185539,true,8760854712,22,8799485467,38630755
1635121339,-185535,true,8764359580,22,8819746561,55386981
1635121343,-185537,true,8762606971,22,8821510599,58903628
1635121385,-185535,true,8764359580,22,8845359667,81000087
1635121442,-185525,true,8773127884,22,8882586438,109458554
1635121509,-185517,true,8780148843,22,8921753965,141605122
1635121537,-185518,true,8779270916,22,8939614434,160343518
1635121684,-185515,true,8781904961,22,9044816898,262911937
1635121724,-185504,true,8791569888,22,9074712599,283142711
1635121773,-185496,true,8798605606,22,9111082322,312476716
1635121821,-185496,true,8798605606,22,9147597808,348992202
1635121831,-185491,true,8803005789,22,9154918448,351912659
1635121842,-185480,true,8812693938,22,9163161171,350467233
1635121858,-185472,true,8819746561,22,9173245690,353499129
1635121908,-185470,true,8821510599,22,9199885379,378374780
1635121921,-185465,true,8825922236,22,9205406691,379484455
1635121996,-185455,true,8834752131,22,9235833188,401081057
1635122028,-185446,true,8842706590,22,9248771762,406065172
1635122055,-185446,true,8842706590,22,9262654635,419948045
1635122085,-185440,true,8848013540,22,9278413752,430400212
1635122093,-185427,true,8859522862,22,9282125674,422602812
1635122099,-185416,true,8869273211,22,9284910590,415637379
1635122138,-185416,true,8869273211,22,9296058613,426785402
1635122168,-185412,true,8872821453,22,9302567806,429746353
1635122206,-185401,true,8882586438,22,9306289392,423702954
1635122380,-185391,true,8891473022,22,9294199680,402726658
1635122391,-185390,true,8892362170,22,9293270353,400908183
1635122573,-185386,true,8895919648,22,9275630784,379711136
1635122660,-185371,true,8909272872,22,9264507259,355234387
1635122681,-185359,true,8919969882,22,9263580901,343611019
1635122682,-185357,true,8921753965,22,9263580901,341826936
1635122697,-185351,true,8927108356,22,9260802382,333694026
1635122765,-185337,true,8939614434,22,9249696639,310082205
1635122768,-185327,true,8948558073,22,9249696639,301138566
1635122907,-185325,true,8950347874,22,9237680447,287332573
1635122913,-185321,true,8953928550,22,9237680447,283751897
1635122917,-185306,true,8967368849,22,9237680447,270311598
1635122980,-185297,true,8975442710,22,9221068408,245625698
1635123014,-185294,true,8978135612,22,9215537703,237402091
1635123036,-185292,true,8979931329,22,9214616241,234684912
1635123062,-185279,true,8991612246,22,9212773594,221161348
1635123131,-185269,true,9000607906,22,9215537703,214929797
1635123138,-185267,true,9002408117,22,9215537703,213129586
1635123166,-185264,true,9005109110,22,9216459256,211350146
1635123210,-185252,true,9015921186,22,9218302640,202381454
1635123261,-185242,true,9024941166,22,9221990515,197049349
1635123273,-185240,true,9026746244,22,9221990515,195244271
1635123314,-185238,true,9028551684,22,9224757388,196205704
1635123373,-185224,true,9041199875,22,9230293627,189093752
1635123397,-185211,true,9052960490,22,9233062992,180102502
1635123500,-185208,true,9055676650,22,9245997685,190321035
1635123506,-185205,true,9058393624,22,9246922285,188528661
1635123628,-185193,true,9069269677,22,9245073178,175803501
1635123649,-185182,true,9079250863,22,9245073178,165822315
1635123699,-185182,true,9079250863,22,9244148763,164897900
1635123755,-185180,true,9081066804,22,9243224441,162157637
1635123758,-185169,true,9091060974,22,9243224441,152163467
1635123808,-185159,true,9100156127,22,9243224441,143068314
1635123835,-185159,true,9100156127,22,9245073178,144917051
1635123846,-185155,true,9103796735,22,9246922285,143125550
1635123904,-185142,true,9115638775,22,9258950499,143311724
1635123925,-185131,true,9125670992,22,9260802382,135131390
1635123941,-185131,true,9125670992,22,9262654635,136983643
1635123971,-185126,true,9130234741,22,9270067353,139832612
1635123987,-185113,true,9142111170,22,9273775936,131664766
1635124007,-185100,true,9154003048,22,9277486003,123482955
1635124107,-185099,true,9154918448,22,9296988219,142069771
1635124128,-185094,true,9159496823,22,9300707572,141210749
1635124158,-185080,true,9172328457,22,9306289392,133960935
1635124202,-185067,true,9184259641,22,9315599870,131340229
1635124244,-185065,true,9186096585,22,9319326669,133230084
1635124280,-185061,true,9189771575,22,9323054959,133283384
1635124312,-185049,true,9200805368,22,9325852155,125046787
1635124342,-185035,true,9213694872,22,9327717419,114022547
1635124373,-185033,true,9215537703,22,9331449065,115911362
1635124392,-185026,true,9221990515,22,9334248780,112258265
1635124426,-185015,true,9232139778,22,9341718793,109579015
1635124430,-185000,true,9245997685,22,9343587230,97589545
1635124439,-184997,true,9248771762,22,9345456041,96684279
1635124454,-184991,true,9254322413,22,9348259958,93937545
1635124512,-184978,true,9266360253,22,9359484042,93123789
1635124560,-184961,true,9282125674,22,9372595840,90470166
1635124578,-184959,true,9283982192,22,9376345441,92363249
1635124618,-184953,true,9289553974,22,9385726007,96172033
1635124929,-184943,true,9298847709,22,9458271411,159423702
1635124948,-184928,true,9312805749,22,9460163160,147357411
1635125006,-184929,true,9311874561,22,9468680714,156806153
1635125034,-184924,true,9316531430,22,9471521602,154990172
1635125097,-184918,true,9322122746,22,9477205936,155083190
1635125182,-184908,true,9331449065,22,9491431700,159982635
1635125304,-184908,true,9331449065,22,9515188775,183739710
1635125333,-184906,true,9333315448,22,9519947321,186631873
1635125432,-184901,true,9337983040,22,9543775772,205792732
1635125449,-184893,true,9345456041,22,9546639191,201183150
1635125514,-184893,true,9345456041,22,9562881467,217425426
1635125522,-184890,true,9348259958,22,9565750618,217490660
1635125579,-184884,true,9353870317,22,9579151378,225281061
1635125624,-184875,true,9362292168,22,9588734841,226442673
1635125639,-184875,true,9362292168,22,9589693714,227401546
1635125648,-184874,true,9363228397,22,9589693714,226465317
1635125659,-184869,true,9367910948,22,9591611749,223700801
1635125678,-184864,true,9372595840,22,9592570910,219975070
1635125741,-184865,true,9371658675,22,9595448969,223790294
1635125759,-184863,true,9373533100,22,9597368155,223835055
1635125805,-184855,true,9381034552,22,9601207678,220173126
1635125860,-184849,true,9386664580,22,9605048737,218384157
1635125958,-184852,true,9383849143,22,9596408514,212559371
1635125973,-184853,true,9382910852,22,9595448969,212538117
1635126000,-184848,true,9387603246,22,9595448969,207845723
1635126185,-184845,true,9390419809,22,9588734841,198315032
1635126203,-184844,true,9391358851,22,9586817381,195458530
1635126370,-184840,true,9395115958,22,9568620631,173504673
1635126372,-184834,true,9400754437,22,9568620631,167866194
1635126556,-184829,true,9405455754,22,9541867303,136411549
1635126590,-184828,true,9406396300,22,9540913211,134516911
1635126618,-184823,true,9411100439,22,9543775772,132675333
1635126642,-184817,true,9416748511,22,9544730149,127981638
1635126673,-184815,true,9418631955,22,9537097800,118465845
1635126703,-184815,true,9418631955,22,9528518702,109886747
1635126716,-184814,true,9419573818,22,9525660718,106086900
1635126744,-184810,true,9423342213,22,9518995422,95653209
1635126914,-184806,true,9427112115,22,9498077696,70965581
1635127004,-184806,true,9427112115,22,9484790355,57678240
1635127051,-184805,true,9428054826,22,9478153656,50098830
1635127152,-184801,true,9431826614,22,9466787262,34960648
1635127217,-184795,true,9437487125,22,9462055288,24568163
1635127342,-184793,true,9439374716,22,9450708198,11333482
1635127373,-184791,true,9441262686,22,9453543694,12281008
1635127426,-184786,true,9445984261,22,9450708198,4723937
1635127596,-184781,true,9450708198,22,9450708198,0
1635127668,-184779,true,9452598434,22,9460163160,7564726
1635127724,-184778,true,9453543694,22,9467733940,14190246
1635127737,-184773,true,9458271411,22,9469627582,11356171
1635127919,-184769,true,9462055288,22,9489533698,27478410
1635127937,-184767,true,9463947793,22,9489533698,25585905
1635127964,-184767,true,9463947793,22,9492380843,28433050
1635128019,-184763,true,9467733940,22,9497127983,29394043
1635128026,-184760,true,9470574544,22,9497127983,26553439
1635128036,-184758,true,9472468754,22,9499027504,26558750
1635128105,-184755,true,9475310779,22,9511383651,36072872
1635128188,-184747,true,9482893681,22,9524708247,41814566
1635128312,-184744,true,9485738834,22,9533283914,47545080
1635128337,-184740,true,9489533698,22,9536144186,46610488
1635128382,-184737,true,9492380843,22,9539959215,47578372
1635128506,-184728,true,9500927404,22,9553323843,52396439
1635128521,-184724,true,9504728345,22,9555234603,50506258
1635128565,-184720,true,9508530807,22,9560013176,51482369
1635128580,-184719,true,9509481660,22,9561925275,52443615
1635128633,-184712,true,9516140294,22,9567663864,51523570
1635128677,-184709,true,9518995422,22,9574363238,55367816
1635128707,-184706,true,9521851406,22,9579151378,57299972
1635128722,-184706,true,9521851406,22,9581067304,59215898
1635128735,-184700,true,9527565945,22,9582983613,55417668
1635128790,-184700,true,9527565945,22,9590652684,63086739
1635128847,-184697,true,9530424501,22,9599287725,68863224
1635128856,-184697,true,9530424501,22,9600247653,69823152
1635128946,-184690,true,9537097800,22,9613696740,76598940
1635128954,-184689,true,9538051510,22,9614658109,76606599
1635128988,-184685,true,9541867303,22,9620428347,78561044
1635129028,-184683,true,9543775772,22,9628127384,84351612
1635129139,-184673,true,9553323843,22,9649331520,96007677
1635129219,-184672,true,9554279176,22,9661883180,107604004
1635129259,-184669,true,9557145746,22,9668648527,111502781
1635129344,-184667,true,9559057271,22,9684129973,125072702
1635129364,-184659,true,9566707194,22,9687035502,120328308
1635129439,-184660,true,9565750618,22,9690910898,125160280
1635129472,-184657,true,9568620631,22,9692849177,124228546
1635129519,-184657,true,9568620631,22,9694787844,126167213
1635129643,-184647,true,9578193558,22,9699636207,121442649
1635129687,-184648,true,9577235835,22,9701576231,124340396
1635129709,-184646,true,9579151378,22,9702546389,123395011
1635129750,-184645,true,9580109293,22,9704486995,124377702
1635129953,-184644,true,9581067304,22,9659951093,78883789
1635130010,-184646,true,9579151378,22,9644508301,65356923
1635130040,-184644,true,9581067304,22,9637759845,56692541
1635130137,-184645,true,9580109293,22,9618504550,38395257
1635130278,-184642,true,9582983613,22,9596408514,13424901
1635130323,-184645,true,9580109293,22,9588734841,8625548
1635130425,-184645,true,9580109293,22,9569577493,-10531800
1635130481,-184647,true,9578193558,22,9558101460,-20092098
1635130565,-184647,true,9578193558,22,9541867303,-36326255
1635130699,-184652,true,9573405898,22,9520899316,-52506582
1635130719,-184653,true,9572448653,22,9519947321,-52501332
1635130751,-184654,true,9571491504,22,9523755872,-47735632
1635130771,-184657,true,9568620631,22,9520899316,-47721315
1635130793,-184661,true,9564794139,22,9518043618,-46750521
1635130809,-184663,true,9562881467,22,9516140294,-46741173
1635130930,-184668,true,9558101460,22,9499027504,-59073956
1635131039,-184669,true,9557145746,22,9480049382,-77096364
1635131121,-184670,true,9556190127,22,9462055288,-94134839
1635131137,-184672,true,9554279176,22,9457325679,-96953497
1635131147,-184676,true,9550458419,22,9454489049,-95969370
1635131180,-184679,true,9547593855,22,9443151033,-104442822
1635131192,-184683,true,9543775772,22,9440318654,-103457118
1635131199,-184683,true,9543775772,22,9438430873,-105344899
1635131201,-184687,true,9539959215,22,9438430873,-101528342
1635131202,-184688,true,9539005315,22,9438430873,-100574442
1635131283,-184689,true,9538051510,22,9430883525,-107167985
1635131340,-184689,true,9538051510,22,9426169498,-111882012
1635131367,-184694,true,9533283914,22,9423342213,-109941701
1635131429,-184694,true,9533283914,22,9416748511,-116535403
1635131473,-184697,true,9530424501,22,9408277673,-122146828
1635131486,-184698,true,9529471554,22,9405455754,-124015800
1635131550,-184705,true,9522803591,22,9395115958,-127687633
1635131551,-184707,true,9520899316,22,9395115958,-125783358
1635131588,-184707,true,9520899316,22,9389480861,-131418455
1635131621,-184705,true,9522803591,22,9385726007,-137077584
1635131662,-184708,true,9519947321,22,9377283076,-142664245
1635131673,-184707,true,9520899316,22,9377283076,-143616240
1635131716,-184707,true,9520899316,22,9378220804,-142678512
1635131811,-184703,true,9524708247,22,9387603246,-137105001
1635131830,-184705,true,9522803591,22,9386664580,-136139011
1635131848,-184705,true,9522803591,22,9388542006,-134261585
1635131859,-184704,true,9523755872,22,9389480861,-134275011
1635131880,-184704,true,9523755872,22,9388542006,-135213866
1635131902,-184707,true,9520899316,22,9388542006,-132357310
1635131986,-184707,true,9520899316,22,9395115958,-125783358
1635132062,-184707,true,9520899316,22,9405455754,-115443562
1635132099,-184706,true,9521851406,22,9412041549,-109809857
1635132131,-184708,true,9519947321,22,9414865443,-105081878
1635132155,-184708,true,9519947321,22,9415806930,-104140391
1635132224,-184708,true,9519947321,22,9420515775,-99431546
1635132242,-184708,true,9519947321,22,9421457827,-98489494
1635132309,-184709,true,9518995422,22,9429940531,-89054891
1635132313,-184709,true,9518995422,22,9430883525,-88111897
1635132470,-184707,true,9520899316,22,9466787262,-54112054
1635132576,-184707,true,9520899316,22,9489533698,-31365618
1635132660,-184710,true,9518043618,22,9499977406,-18066212
1635132661,-184712,true,9516140294,22,9499977406,-16162888
1635132669,-184709,true,9518995422,22,9500927404,-18068018
1635132713,-184709,true,9518995422,22,9504728345,-14267077
1635132828,-184712,true,9516140294,22,9519947321,3807027
1635132923,-184713,true,9515188775,22,9528518702,13329927
1635132930,-184711,true,9517091908,22,9529471554,12379646
1635132962,-184711,true,9517091908,22,9531377544,14285636
1635132970,-184714,true,9514237352,22,9532330681,18093329
1635133055,-184715,true,9513286023,22,9544730149,31444126
1635133088,-184712,true,9516140294,22,9549503469,33363175
1635133122,-184712,true,9516140294,22,9555234603,39094309
1635133331,-184715,true,9513286023,22,9573405898,60119875
1635133401,-184716,true,9512334790,22,9576278207,63943417
1635133447,-184714,true,9514237352,22,9578193558,63956206
1635133464,-184713,true,9515188775,22,9578193558,63004783
1635133499,-184717,true,9511383651,22,9579151378,67767727
1635133545,-184719,true,9509481660,22,9577235835,67754175
1635133586,-184718,true,9510432608,22,9577235835,66803227
1635133754,-184720,true,9508530807,22,9576278207,67747400
1635133819,-184724,true,9504728345,22,9575320675,70592330
1635133964,-184732,true,9497127983,22,9550458419,53330436
1635133995,-184730,true,9499027504,22,9544730149,45702645
1635134041,-184733,true,9496178365,22,9539005315,42826950
1635134079,-184739,true,9490482652,22,9536144186,45661534
1635134112,-184744,true,9485738834,22,9533283914,47545080
1635134137,-184741,true,9488584840,22,9528518702,39933862
1635134241,-184744,true,9485738834,22,9516140294,30401460
1635134289,-184748,true,9481945487,22,9508530807,26585320
1635134315,-184753,true,9477205936,22,9504728345,27522409
1635134362,-184750,true,9480049382,22,9497127983,17078601
1635134416,-184753,true,9477205936,22,9493330081,16124145
1635134508,-184756,true,9474363343,22,9488584840,14221497
1635134525,-184757,true,9473416001,22,9486687408,13271407
1635134538,-184752,true,9478153656,22,9485738834,7585178
1635134563,-184755,true,9475310779,22,9484790355,9479576
1635134625,-184758,true,9472468754,22,9481945487,9476733
1635134710,-184760,true,9470574544,22,9478153656,7579112
1635134775,-184756,true,9474363343,22,9477205936,2842593
1635135014,-184759,true,9471521602,22,9473416001,1894399
1635135072,-184761,true,9469627582,22,9473416001,3788419
1635135138,-184762,true,9468680714,22,9472468754,3788040
1635135188,-184757,true,9473416001,22,9472468754,-947247
1635135252,-184759,true,9471521602,22,9476258310,4736708
1635135293,-184762,true,9468680714,22,9477205936,8525222
1635135302,-184762,true,9468680714,22,9477205936,8525222
1635135420,-184757,true,9473416001,22,9477205936,3789935
1635135433,-184758,true,9472468754,22,9478153656,5684902
1635135445,-184756,true,9474363343,22,9479101472,4738129
1635135458,-184756,true,9474363343,22,9479101472,4738129
1635135507,-184750,true,9480049382,22,9481945487,1896105
1635135576,-184747,true,9482893681,22,9495228842,12335161
1635135582,-184745,true,9484790355,22,9497127983,12337628
1635135652,-184743,true,9486687408,22,9512334790,25647382
1635135702,-184732,true,9497127983,22,9526613284,29485301
1635135758,-184727,true,9501877497,22,9549503469,47625972
1635135782,-184724,true,9504728345,22,9560013176,55284831
1635135936,-184720,true,9508530807,22,9622352529,113821722
1635135942,-184712,true,9516140294,22,9625239523,109099229
1635136149,-184705,true,9522803591,22,9725859299,203055708
1635136150,-184702,true,9525660718,22,9725859299,200198581
1635136266,-184698,true,9529471554,22,9767768439,238296885
1635136283,-184688,true,9539005315,22,9773630565,234625250
1635136327,-184683,true,9543775772,22,9789280108,245504336
1635136466,-184679,true,9547593855,22,9824583259,276989404
1635136479,-184673,true,9553323843,22,9827530928,274207085
1635136556,-184663,true,9562881467,22,9845235528,282354061
1635136568,-184659,true,9566707194,22,9847204674,280497480
1635136662,-184654,true,9571491504,22,9861985825,290494321
1635136785,-184647,true,9578193558,22,9874814102,296620544
1635136792,-184638,true,9586817381,22,9875801583,288984202
1635136853,-184635,true,9589693714,22,9889636696,299942982
1635136876,-184630,true,9594489520,22,9890625659,296136139
1635136954,-184623,true,9601207678,22,9891614722,290407044
1635137014,-184616,true,9607930540,22,9892603883,284673343
1635137104,-184611,true,9612735466,22,9899530784,286795318
1635137130,-184607,true,9616581137,22,9899530784,282949647
1635137138,-184602,true,9621390389,22,9900520737,279130348
1635137140,-184595,true,9628127384,22,9900520737,272393353
1635137203,-184591,true,9631979212,22,9909434771,277455559
1635137225,-184584,true,9638723621,22,9914390479,275666858
1635137247,-184578,true,9644508301,22,9918356830,273848529
1635137284,-184571,true,9651261482,22,9923317001,272055519
1635137494,-184566,true,9656088078,22,9950144816,294056738
1635137512,-184561,true,9660917088,22,9950144816,289227728
1635137561,-184556,true,9665748513,22,9948155086,282406573
1635137679,-184550,true,9671549412,22,9957112008,285562596
1635137717,-184546,true,9675418612,22,9957112008,281693396
1635137733,-184542,true,9679289360,22,9955120884,275831524
1635137766,-184536,true,9685098386,22,9952134945,267036559
1635137795,-184532,true,9688973006,22,9953130158,264157152
1635137819,-184529,true,9691879989,22,9952134945,260254956
1635137857,-184524,true,9696726898,22,9953130158,256403260
1635137900,-184518,true,9702546389,22,9956116396,253570007
1635137941,-184514,true,9706427990,22,9955120884,248692894
1635137954,-184511,true,9709340209,22,9955120884,245780675
1635138067,-184505,true,9715167270,22,9965080486,249913216
1635138154,-184502,true,9718082112,22,9950144816,232062704
1635138268,-184500,true,9720025825,22,9933244784,213218959
1635138292,-184498,true,9721969928,22,9930265407,208295479
1635138327,-184494,true,9725859299,22,9925301763,199442464
1635138392,-184491,true,9728777349,22,9911416757,182639408
1635138416,-184489,true,9730723201,22,9908443926,177720725
1635138512,-184488,true,9731696274,22,9890625659,158929385
1635138529,-184485,true,9734616075,22,9885681830,151065755
1635138630,-184480,true,9739484356,22,9869878175,130393819
1635138712,-184478,true,9741432350,22,9857056311,115623961
1635138716,-184476,true,9743380734,22,9856070704,112689970
1635138835,-184473,true,9746304041,22,9835395705,89091664
1635138901,-184465,true,9754103814,22,9831462530,77358716
1635138915,-184462,true,9757030337,22,9829496533,72466196
1635139004,-184458,true,9760933735,22,9827530928,66597193
1635139087,-184453,true,9765815178,22,9822618637,56803459
1635139088,-184448,true,9770699062,22,9822618637,51919575
1635139109,-184446,true,9772653300,22,9822618637,49965337
1635139124,-184443,true,9775585389,22,9821636473,46051084
1635139189,-184437,true,9781452207,22,9819672440,38220233
1635139240,-184431,true,9787322545,22,9819672440,32349895
1635139330,-184428,true,9790259036,22,9828513681,38254645
1635139352,-184425,true,9793196407,22,9829496533,36300126
1635139419,-184420,true,9798093985,22,9834412264,36318279
1635139442,-184415,true,9802994012,22,9836379245,33385233
1635139598,-184412,true,9805935204,22,9842282548,36347344
1635139630,-184409,true,9808877279,22,9844251103,35373824
1635139851,-184403,true,9814764077,22,9846220052,31455975
1635139878,-184398,true,9819672440,22,9846220052,26547612
1635139915,-184395,true,9822618637,22,9843266776,20648139
1635139953,-184391,true,9826548274,22,9842282548,15734274
1635139967,-184387,true,9830479483,22,9842282548,11803065
1635140045,-184382,true,9835395705,22,9841298418,5902713
1635140068,-184379,true,9838346619,22,9840314387,1967768
1635140087,-184376,true,9841298418,22,9838346619,-2951799
1635140143,-184373,true,9844251103,22,9833428921,-10822182
1635140274,-184370,true,9847204674,22,9816727128,-30477546
1635140442,-184368,true,9849174213,22,9788301278,-60872935
1635140517,-184367,true,9850159131,22,9775585389,-74573742
1635140584,-184363,true,9854099785,22,9765815178,-88284607
1635140698,-184359,true,9858042017,22,9758981841,-99060176
1635140714,-184359,true,9858042017,22,9757030337,-101011680
1635140753,-184360,true,9857056311,22,9752153285,-104903026
1635140824,-184357,true,9860013723,22,9745329508,-114684215
1635140849,-184355,true,9861985825,22,9744355072,-117630753
1635140884,-184356,true,9860999725,22,9743380734,-117618991
1635140906,-184358,true,9859027821,22,9742406494,-116621327
1635140962,-184355,true,9861985825,22,9742406494,-119579331
1635141022,-184356,true,9860999725,22,9743380734,-117618991
1635141183,-184361,true,9856070704,22,9730723201,-125347503
1635141267,-184366,true,9851144147,22,9726831885,-124312262
1635141313,-184363,true,9854099785,22,9732669443,-121430342
1635141317,-184365,true,9852129261,22,9733642710,-118486551
1635141540,-184369,true,9848189394,22,9723914419,-124274975
1635141610,-184372,true,9845235528,22,9716138787,-129096741
1635141653,-184369,true,9848189394,22,9714195851,-133993543
1635141666,-184372,true,9845235528,22,9713224528,-132011000
1635141731,-184378,true,9839330454,22,9703516644,-135813810
1635141902,-184379,true,9838346619,22,9693818462,-144528157
1635141923,-184379,true,9838346619,22,9693818462,-144528157
1635141942,-184381,true,9836379245,22,9695757322,-140621923
1635142018,-184387,true,9830479483,22,9695757322,-134722161
1635142038,-184391,true,9826548274,22,9694787844,-131760430
1635142225,-184392,true,9825565717,22,9688973006,-136592711
1635142241,-184395,true,9822618637,22,9688973006,-133645631
1635142275,-184401,true,9816727128,22,9684129973,-132597155
1635142386,-184405,true,9812801418,22,9665748513,-147052905
1635142493,-184408,true,9809858167,22,9647401943,-162456224
1635142645,-184412,true,9805935204,22,9632942410,-172992794
1635142688,-184417,true,9801033707,22,9626202047,-174831660
1635142783,-184421,true,9797114273,22,9609852222,-187262051
1635142861,-184427,true,9791238062,22,9596408514,-194829548
1635142907,-184431,true,9787322545,22,9591611749,-195710796
1635142952,-184436,true,9782430352,22,9584900306,-197530046
1635142966,-184441,true,9777540604,22,9582983613,-194556991
1635142983,-184446,true,9772653300,22,9582025410,-190627890
1635143156,-184451,true,9767768439,22,9549503469,-218264970
1635143192,-184458,true,9760933735,22,9548548614,-212385121
1635143284,-184462,true,9757030337,22,9544730149,-212300188
1635143292,-184468,true,9751178168,22,9543775772,-207402396
1635143502,-184476,true,9743380734,22,9511383651,-231997083
1635143533,-184482,true,9737536751,22,9505678818,-231857933
1635143537,-184486,true,9733642710,22,9504728345,-228914365
1635143569,-184491,true,9728777349,22,9501877497,-226899852
1635143576,-184499,true,9720997828,22,9500927404,-220070424
1635143617,-184504,true,9716138787,22,9495228842,-220909945
1635143905,-184508,true,9712253303,22,9467733940,-244519363
1635143955,-184514,true,9706427990,22,9466787262,-239640728
1635144088,-184520,true,9700606171,22,9464894188,-235711983
1635144105,-184524,true,9696726898,22,9466787262,-229939636
1635144283,-184525,true,9695757322,22,9486687408,-209069914
1635144294,-184529,true,9691879989,22,9487636076,-204243913
1635144513,-184537,true,9684129973,22,9478153656,-205976317
1635144612,-184540,true,9681225315,22,9470574544,-210650771
1635144639,-184544,true,9677353793,22,9467733940,-209619853
1635144707,-184546,true,9675418612,22,9471521602,-203897010
1635144716,-184554,true,9667681759,22,9469627582,-198054177
1635144835,-184561,true,9660917088,22,9444095348,-216821740
1635144842,-184565,true,9657053687,22,9442206812,-214846875
1635144946,-184572,true,9650296453,22,9412982753,-237313700
1635144966,-184580,true,9642579689,22,9411100439,-231479250
1635144985,-184588,true,9634869095,22,9405455754,-229413341
1635145015,-184593,true,9630053105,22,9395115958,-234937147
1635145069,-184599,true,9624277095,22,9377283076,-246994019
1635145140,-184609,true,9614658109,22,9351999823,-262658286
1635145284,-184616,true,9607930540,22,9318394829,-289535711
1635145423,-184618,true,9606009242,22,9305358856,-300650386
1635145458,-184626,true,9598327892,22,9298847709,-299480183
1635145657,-184634,true,9590652684,22,9277486003,-313166681
1635145702,-184642,true,9582983613,22,9279341593,-303642020
1635145718,-184644,true,9581067304,22,9280269527,-300797777
1635145917,-184649,true,9576278207,22,9309081558,-267196649
1635145982,-184656,true,9569577493,22,9322122746,-247454747
1635145987,-184663,true,9562881467,22,9323054959,-239826508
1635146103,-184664,true,9561925275,22,9349194784,-212730491
1635146128,-184669,true,9557145746,22,9354805704,-202340042
1635146298,-184674,true,9552368606,22,9395115958,-157252648
1635146407,-184680,true,9546639191,22,9417690186,-128949005
1635146478,-184681,true,9545684622,22,9430883525,-114801097
1635146616,-184685,true,9541867303,22,9444095348,-97771955
1635146681,-184691,true,9536144186,22,9445039757,-91104429
1635146761,-184698,true,9529471554,22,9445984261,-83487293
1635146809,-184699,true,9528518702,22,9445984261,-82534441
1635147021,-184703,true,9524708247,22,9437487125,-87221122
1635147043,-184707,true,9520899316,22,9436543470,-84355846
1635147106,-184714,true,9514237352,22,9423342213,-90895139
1635147134,-184715,true,9513286023,22,9418631955,-94654068
1635147164,-184720,true,9508530807,22,9412982753,-95548054
1635147211,-184726,true,9502827685,22,9404515303,-98312382
1635147221,-184734,true,9495228842,22,9402634682,-92594160
1635147369,-184735,true,9494279414,22,9381034552,-113244862
1635147543,-184741,true,9488584840,22,9366974251,-121610589
1635147559,-184745,true,9484790355,22,9366037647,-118752708
1635147573,-184753,true,9477205936,22,9364164720,-113041216
1635147589,-184755,true,9475310779,22,9362292168,-113018611
1635147624,-184763,true,9467733940,22,9358548187,-109185753
1635147631,-184767,true,9463947793,22,9357612426,-106335367
1635147710,-184774,true,9457325679,22,9346390587,-110935092
1635147765,-184776,true,9455434497,22,9336115723,-119318774
1635147951,-184785,true,9446928860,22,9298847709,-148081151
1635147968,-184789,true,9443151033,22,9296988219,-146162814
1635148046,-184796,true,9436543470,22,9296058613,-140484857
1635148101,-184798,true,9434656445,22,9295129100,-139527345
1635148115,-184804,true,9428997632,22,9292341119,-136656513
1635148236,-184808,true,9425226975,22,9289553974,-135673001
1635148259,-184813,true,9420515775,22,9289553974,-130961801
1635148434,-184817,true,9416748511,22,9275630784,-141117727
1635148760,-184824,true,9410159423,22,9271921459,-138237964
1635148809,-184828,true,9406396300,22,9273775936,-132620364
1635148831,-184834,true,9400754437,22,9274703314,-126051123
1635148848,-184838,true,9396995075,22,9275630784,-121364291
1635148980,-184845,true,9390419809,22,9269140439,-121279370
1635149023,-184850,true,9385726007,22,9260802382,-124923625
1635149090,-184857,true,9379158626,22,9245997685,-133160941
1635149161,-184859,true,9377283076,22,9229370690,-147912386
1635149374,-184866,true,9370721602,22,9193448035,-177273567
1635149390,-184871,true,9366037647,22,9192528782,-173508865
1635149448,-184878,true,9359484042,22,9187933896,-171550146
1635149460,-184880,true,9357612426,22,9187015195,-170597231
1635149513,-184887,true,9351064717,22,9176915539,-174149178
1635149583,-184893,true,9345456041,22,9163161171,-182294870
1635149727,-184901,true,9337983040,22,9132974085,-205008955
1635149851,-184903,true,9336115723,22,9114727302,-221388421
1635149998,-184909,true,9330516014,22,9114727302,-215788712
1635150008,-184913,true,9326784740,22,9114727302,-212057438
1635150182,-184919,true,9321190627,22,9127496218,-193694409
1635150246,-184920,true,9320258602,22,9134800771,-185457831
1635150271,-184924,true,9316531430,22,9136627823,-179903607
1635150329,-184926,true,9314668403,22,9136627823,-178040580
1635150454,-184931,true,9310012466,22,9149427419,-160585047
1635150507,-184931,true,9310012466,22,9155833940,-154178526
1635150515,-184936,true,9305358856,22,9156749524,-148609332
1635150523,-184938,true,9303498063,22,9157665198,-145832865
1635150545,-184945,true,9296988219,22,9159496823,-137491396
1635150658,-184947,true,9295129100,22,9168660443,-126468657
1635150879,-184951,true,9291411978,22,9174163015,-117248963
1635150982,-184953,true,9289553974,22,9182423065,-107130909
1635151074,-184959,true,9283982192,22,9196206345,-87775847
1635151256,-184960,true,9283053886,22,9221068408,-61985478
1635151407,-184962,true,9281197554,22,9250621609,-30575945
1635151442,-184960,true,9283053886,22,9258950499,-24103387
1635151680,-184964,true,9279341593,22,9315599870,36258277
1635151719,-184962,true,9281197554,22,9323987264,42789710
1635151868,-184965,true,9278413752,22,9348259958,69846206
1635151985,-184963,true,9280269527,22,9365101137,84831610
1635152002,-184963,true,9280269527,22,9366974251,86704724
1635152049,-184960,true,9283053886,22,9373533100,90479214
1635152079,-184957,true,9285839081,22,9375407900,89568819
1635152237,-184955,true,9287696342,22,9388542006,100845664
1635152312,-184955,true,9287696342,22,9393237216,105540874
1635152377,-184953,true,9289553974,22,9396995075,107441101
1635152433,-184950,true,9292341119,22,9397934774,105593655
1635152491,-184947,true,9295129100,22,9405455754,110326654
1635152512,-184946,true,9296058613,22,9407336939,111278326
1635152767,-184945,true,9296988219,22,9425226975,128238756
1635152787,-184942,true,9299777594,22,9425226975,125449381
1635152962,-184941,true,9300707572,22,9421457827,120750255
1635152994,-184941,true,9300707572,22,9420515775,119808203
1635153062,-184940,true,9301637643,22,9419573818,117936175
1635153141,-184939,true,9302567806,22,9418631955,116064149
1635153247,-184940,true,9301637643,22,9417690186,116052543
1635153448,-184941,true,9300707572,22,9412041549,111333977
1635153610,-184941,true,9300707572,22,9410159423,109451851
1635153639,-184941,true,9300707572,22,9407336939,106629367
1635153797,-184943,true,9298847709,22,9401694512,102846803
1635153839,-184945,true,9296988219,22,9401694512,104706293
1635153882,-184945,true,9296988219,22,9402634682,105646463
1635153939,-184944,true,9297917917,22,9401694512,103776595
1635154064,-184944,true,9297917917,22,9408277673,110359756
1635154111,-184944,true,9297917917,22,9410159423,112241506
1635154392,-184944,true,9297917917,22,9415806930,117889013
1635154479,-184943,true,9298847709,22,9418631955,119784246
1635154684,-184943,true,9298847709,22,9428997632,130149923
1635154765,-184942,true,9299777594,22,9431826614,132049020
1635154835,-184941,true,9300707572,22,9435599910,134892338
1635154905,-184938,true,9303498063,22,9435599910,132101847
1635154987,-184937,true,9304428413,22,9436543470,132115057
1635155020,-184936,true,9305358856,22,9435599910,130241054
1635155138,-184937,true,9304428413,22,9433713073,129284660
1635155189,-184934,true,9307220021,22,9432769796,125549775
1635155327,-184933,true,9308150743,22,9429940531,121789788
1635155363,-184933,true,9308150743,22,9429940531,121789788
1635155422,-184933,true,9308150743,22,9428997632,120846889
1635155612,-184929,true,9311874561,22,9424284547,112409986
1635155638,-184928,true,9312805749,22,9423342213,110536464
1635155664,-184927,true,9313737029,22,9421457827,107720798
1635155737,-184926,true,9314668403,22,9418631955,103963552
1635155769,-184921,true,9319326669,22,9416748511,97421842
1635155881,-184920,true,9320258602,22,9412041549,91782947
1635155948,-184919,true,9321190627,22,9412041549,90850922
1635156019,-184919,true,9321190627,22,9407336939,86146312
1635156082,-184916,true,9323987264,22,9402634682,78647418
1635156145,-184917,true,9323054959,22,9396995075,73940116
1635156272,-184917,true,9323054959,22,9385726007,62671048
1635156349,-184917,true,9323054959,22,9381034552,57979593
1635156446,-184913,true,9326784740,22,9371658675,44873935
1635156509,-184913,true,9326784740,22,9368847739,42062999
1635156567,-184913,true,9326784740,22,9367910948,41126208
1635156679,-184912,true,9327717419,22,9364164720,36447301
1635156694,-184908,true,9331449065,22,9363228397,31779332
1635156877,-184905,true,9334248780,22,9365101137,30852357
1635156951,-184902,true,9337049335,22,9371658675,34609340
1635157061,-184900,true,9338916838,22,9380096542,41179704
1635157338,-184893,true,9345456041,22,9402634682,57178641
1635157453,-184891,true,9347325226,22,9406396300,59071074
1635157552,-184889,true,9349194784,22,9409218501,60023717
1635157689,-184886,true,9351999823,22,9410159423,58159600
1635157762,-184880,true,9357612426,22,9410159423,52546997
1635157801,-184877,true,9360419991,22,9409218501,48798510
1635157937,-184873,true,9364164720,22,9406396300,42231580
1635158045,-184870,true,9366974251,22,9412041549,45067298
1635158114,-184864,true,9372595840,22,9418631955,46036115
1635158155,-184861,true,9375407900,22,9416748511,41340611
1635158239,-184859,true,9377283076,22,9414865443,37582367
1635158273,-184858,true,9378220804,22,9412982753,34761949
1635158343,-184855,true,9381034552,22,9410159423,29124871
1635158391,-184852,true,9383849143,22,9408277673,24428530
1635158458,-184851,true,9384787528,22,9403574945,18787417
1635158527,-184851,true,9384787528,22,9397934774,13147246
1635158591,-184847,true,9388542006,22,9392297987,3755981
1635158605,-184845,true,9390419809,22,9390419809,0
1635158734,-184843,true,9392297987,22,9382910852,-9387135
1635158823,-184842,true,9393237216,22,9368847739,-24389477
1635158896,-184840,true,9395115958,22,9353870317,-41245641
1635158909,-184839,true,9396055469,22,9351064717,-44990752
1635158996,-184839,true,9396055469,22,9332382210,-63673259
1635159221,-184841,true,9394176540,22,9309081558,-85094982
1635159276,-184841,true,9394176540,22,9308150743,-86025797
1635159286,-184841,true,9394176540,22,9307220021,-86956519
1635159303,-184842,true,9393237216,22,9307220021,-86017195
1635159350,-184843,true,9392297987,22,9305358856,-86939131
1635159551,-184844,true,9391358851,22,9297917917,-93440934
1635159599,-184845,true,9390419809,22,9291411978,-99007831
1635159609,-184847,true,9388542006,22,9290482929,-98059077
1635159639,-184848,true,9387603246,22,9286767665,-100835581
1635159780,-184853,true,9382910852,22,9284910590,-98000262
1635159905,-184852,true,9383849143,22,9286767665,-97081478
1635159913,-184854,true,9381972655,22,9286767665,-95204990
1635159941,-184856,true,9380096542,22,9284910590,-95185952
1635160481,-184862,true,9374470453,22,9234909697,-139560756
1635160492,-184862,true,9374470453,22,9234909697,-139560756
1635160561,-184864,true,9372595840,22,9233986298,-138609542
1635160846,-184866,true,9370721602,22,9219224471,-151497131
1635160897,-184872,true,9365101137,22,9220146393,-144954744
1635160913,-184872,true,9365101137,22,9220146393,-144954744
1635160945,-184874,true,9363228397,22,9219224471,-144003926
1635161046,-184875,true,9362292168,22,9219224471,-143067697
1635161062,-184881,true,9356676758,22,9220146393,-136530365
1635161213,-184882,true,9355741184,22,9215537703,-140203481
1635161233,-184884,true,9353870317,22,9212773594,-141096723
1635161553,-184888,true,9350129704,22,9178751014,-171378690
1635161670,-184894,true,9344521589,22,9167743668,-176777921
1635161706,-184895,true,9343587230,22,9164993895,-178593335
1635161741,-184897,true,9341718793,22,9160412773,-181306020
1635161969,-184899,true,9339850730,22,9150342362,-189508368
1635162096,-184906,true,9333315448,22,9143025381,-190290067
1635162178,-184908,true,9331449065,22,9145768563,-185680502
1635162194,-184910,true,9329583055,22,9146683140,-182899915
1635162345,-184913,true,9326784740,22,9154918448,-171866292
1635162401,-184919,true,9321190627,22,9158580965,-162609662
1635162465,-184921,true,9319326669,22,9161328814,-157997855
1635162550,-184923,true,9317463083,22,9164993895,-152469188
1635162582,-184925,true,9315599870,22,9166826986,-148772884
1635162652,-184931,true,9310012466,22,9174163015,-135849451
1635162677,-184933,true,9308150743,22,9175997939,-132152804
1635162795,-184934,true,9307220021,22,9183341307,-123878714
1635162838,-184935,true,9306289392,22,9186096585,-120192807
1635162859,-184940,true,9301637643,22,9187015195,-114622448
1635162881,-184941,true,9300707572,22,9189771575,-110935997
1635162905,-184942,true,9299777594,22,9192528782,-107248812
1635162938,-184943,true,9298847709,22,9198045678,-100802031
1635163163,-184947,true,9295129100,22,9226602432,-68526668
1635163297,-184948,true,9294199680,22,9241376073,-52823607
1635163330,-184949,true,9293270353,22,9245073178,-48197175
1635163362,-184949,true,9293270353,22,9251546671,-41723682
1635163481,-184952,true,9290482929,22,9272848651,-17634278
1635163516,-184952,true,9290482929,22,9277486003,-12996926
1635163698,-184950,true,9292341119,22,9313737029,21395910
1635163732,-184950,true,9292341119,22,9320258602,27917483
1635163822,-184951,true,9291411978,22,9336115723,44703745
1635163828,-184949,true,9293270353,22,9337049335,43778982
1635163876,-184947,true,9295129100,22,9344521589,49392489
1635163878,-184946,true,9296058613,22,9345456041,49397428
1635163942,-184947,true,9295129100,22,9354805704,59676604
1635164050,-184946,true,9296058613,22,9372595840,76537227
1635164099,-184944,true,9297917917,22,9378220804,80302887
1635164141,-184944,true,9297917917,22,9382910852,84992935
1635164310,-184946,true,9296058613,22,9397934774,101876161
1635164345,-184946,true,9296058613,22,9399814455,103755842
1635164454,-184945,true,9296988219,22,9405455754,108467535
1635164464,-184945,true,9296988219,22,9405455754,108467535
1635164474,-184946,true,9296058613,22,9405455754,109397141
1635164518,-184947,true,9295129100,22,9404515303,109386203
1635164601,-184945,true,9296988219,22,9401694512,104706293
1635164630,-184945,true,9296988219,22,9401694512,104706293
1635164633,-184947,true,9295129100,22,9400754437,105625337
1635164642,-184947,true,9295129100,22,9400754437,105625337
1635164662,-184946,true,9296058613,22,9400754437,104695824
1635164702,-184947,true,9295129100,22,9398874568,103745468
1635164712,-184950,true,9292341119,22,9397934774,105593655
1635164771,-184950,true,9292341119,22,9395115958,102774839
1635164844,-184949,true,9293270353,22,9390419809,97149456
1635164846,-184949,true,9293270353,22,9390419809,97149456
1635165041,-184950,true,9292341119,22,9388542006,96200887
1635165091,-184949,true,9293270353,22,9392297987,99027634
1635165106,-184947,true,9295129100,22,9392297987,97168887
1635165402,-184948,true,9294199680,22,9380096542,85896862
1635165559,-184950,true,9292341119,22,9358548187,66207068
1635165676,-184950,true,9292341119,22,9346390587,54049468
1635165802,-184948,true,9294199680,22,9335182205,40982525
1635165858,-184949,true,9293270353,22,9332382210,39111857
1635165908,-184949,true,9293270353,22,9330516014,37245661
1635165915,-184949,true,9293270353,22,9329583055,36312702
1635165929,-184944,true,9297917917,22,9328650190,30732273
1635165962,-184947,true,9295129100,22,9324919663,29790563
1635166051,-184947,true,9295129100,22,9319326669,24197569
1635166093,-184947,true,9295129100,22,9318394829,23265729
1635166214,-184942,true,9299777594,22,9318394829,18617235
1635166241,-184946,true,9296058613,22,9318394829,22336216
1635166353,-184945,true,9296988219,22,9324919663,27931444
1635166443,-184944,true,9297917917,22,9331449065,33531148
1635166462,-184939,true,9302567806,22,9332382210,29814404
1635166622,-184943,true,9298847709,22,9337049335,38201626
1635166706,-184941,true,9300707572,22,9337983040,37275468
1635166780,-184942,true,9299777594,22,9333315448,33537854
1635166813,-184937,true,9304428413,22,9335182205,30753792
1635166852,-184940,true,9301637643,22,9337049335,35411692
1635166937,-184935,true,9306289392,22,9343587230,37297838
1635166952,-184933,true,9308150743,22,9344521589,36370846
1635167007,-184928,true,9312805749,22,9348259958,35454209
1635167259,-184932,true,9309081558,22,9351999823,42918265
1635167352,-184927,true,9313737029,22,9355741184,42004155
1635167385,-184925,true,9315599870,22,9357612426,42012556
1635167479,-184921,true,9319326669,22,9362292168,42965499
1635167564,-184925,true,9315599870,22,9365101137,49501267
1635167582,-184921,true,9319326669,22,9366037647,46710978
1635167628,-184918,true,9322122746,22,9367910948,45788202
1635167688,-184914,true,9325852155,22,9368847739,42995584
1635167773,-184916,true,9323987264,22,9363228397,39241133
1635167841,-184911,true,9328650190,22,9360419991,31769801
1635167925,-184908,true,9331449065,22,9357612426,26163361
1635168162,-184902,true,9337049335,22,9354805704,17756369
1635168296,-184906,true,9333315448,22,9355741184,22425736
1635168330,-184901,true,9337983040,22,9355741184,17758144
1635168337,-184898,true,9340784715,22,9356676758,15892043
1635168383,-184892,true,9346390587,22,9357612426,11221839
1635168446,-184898,true,9340784715,22,9349194784,8410069
1635168514,-184896,true,9342652965,22,9340784715,-1868250
1635168531,-184893,true,9345456041,22,9338916838,-6539203
1635168558,-184889,true,9349194784,22,9337983040,-11211744
1635168618,-184893,true,9345456041,22,9340784715,-4671326
1635168669,-184889,true,9349194784,22,9341718793,-7475991
1635168780,-184886,true,9351999823,22,9341718793,-10281030
1635168920,-184882,true,9355741184,22,9342652965,-13088219
1635168989,-184886,true,9351999823,22,9341718793,-10281030
1635169123,-184883,true,9354805704,22,9339850730,-14954974
1635169179,-184879,true,9358548187,22,9339850730,-18697457
1635169219,-184876,true,9361356033,22,9340784715,-20571318
1635169377,-184880,true,9357612426,22,9359484042,1871616
1635169467,-184877,true,9360419991,22,9374470453,14050462
1635169589,-184873,true,9364164720,22,9381972655,17807935
1635169619,-184870,true,9366974251,22,9384787528,17813277
1635169657,-184873,true,9364164720,22,9390419809,26255089
1635169701,-184869,true,9367910948,22,9399814455,31903507
1635169777,-184864,true,9372595840,22,9415806930,43211090
1635169812,-184862,true,9374470453,22,9423342213,48871760
1635169878,-184864,true,9372595840,22,9440318654,67722814
1635169956,-184861,true,9375407900,22,9460163160,84755260
1635170088,-184855,true,9381034552,22,9499977406,118942854
1635170241,-184853,true,9382910852,22,9531377544,148466692
1635170478,-184855,true,9381034552,22,9583941911,202907359
1635170555,-184852,true,9383849143,22,9596408514,212559371
1635170583,-184846,true,9389480861,22,9599287725,209806864
1635170648,-184843,true,9392297987,22,9604088328,211790341
1635170674,-184845,true,9390419809,22,9606009242,215589433
1635170742,-184841,true,9394176540,22,9606969843,212793303
1635170750,-184835,true,9399814455,22,9606969843,207155388
1635170774,-184833,true,9401694512,22,9606969843,205275331
1635170909,-184835,true,9399814455,22,9609852222,210037767
1635170979,-184831,true,9403574945,22,9609852222,206277277
1635171077,-184826,true,9408277673,22,9603128016,194850343
1635171085,-184824,true,9410159423,22,9603128016,192968593
1635171104,-184826,true,9408277673,22,9602167799,193890126
1635171157,-184824,true,9410159423,22,9601207678,191048255
1635171669,-184820,true,9413924051,22,9538051510,124127459
1635171732,-184818,true,9415806930,22,9530424501,114617571
1635171882,-184820,true,9413924051,22,9510432608,96508557
1635171896,-184818,true,9415806930,22,9510432608,94625678
1635171930,-184814,true,9419573818,22,9509481660,89907842
1635171945,-184812,true,9421457827,22,9508530807,87072980
1635172000,-184813,true,9420515775,22,9507580049,87064274
1635172296,-184810,true,9423342213,22,9518995422,95653209
1635172526,-184807,true,9426169498,22,9531377544,105208046
1635172632,-184805,true,9428054826,22,9532330681,104275855
1635172633,-184805,true,9428054826,22,9532330681,104275855
1635172783,-184801,true,9431826614,22,9538051510,106224896
1635172832,-184796,true,9436543470,22,9539959215,103415745
1635172978,-184794,true,9438430873,22,9541867303,103436430
1635173007,-184793,true,9439374716,22,9540913211,101538495
1635173027,-184790,true,9442206812,22,9539959215,97752403
1635173150,-184787,true,9445039757,22,9533283914,88244157
1635173297,-184787,true,9445039757,22,9524708247,79668490
1635173412,-184786,true,9445984261,22,9518995422,73011161
1635173480,-184782,true,9449763222,22,9518043618,68280396
1635173550,-184779,true,9452598434,22,9518995422,66396988
1635173601,-184778,true,9453543694,22,9518995422,65451728
1635173608,-184777,true,9454489049,22,9518995422,64506373
1635173687,-184773,true,9458271411,22,9520899316,62627905
1635173754,-184769,true,9462055288,22,9522803591,60748303
1635173911,-184768,true,9463001493,22,9527565945,64564452
1635173968,-184766,true,9464894188,22,9532330681,67436493
1635174019,-184761,true,9469627582,22,9536144186,66516604
1635174062,-184757,true,9473416001,22,9537097800,63681799
1635174081,-184757,true,9473416001,22,9538051510,64635509
1635174191,-184757,true,9473416001,22,9535190666,61774665
1635174208,-184755,true,9475310779,22,9534237243,58926464
1635174336,-184752,true,9478153656,22,9534237243,56083587
1635174374,-184752,true,9478153656,22,9534237243,56083587
1635174505,-184753,true,9477205936,22,9518995422,41789486
1635174541,-184750,true,9480049382,22,9513286023,33236641
1635174585,-184748,true,9481945487,22,9513286023,31340536
1635174606,-184747,true,9482893681,22,9513286023,30392342
1635174629,-184745,true,9484790355,22,9513286023,28495668
1635174831,-184741,true,9488584840,22,9507580049,18995209
1635174901,-184738,true,9491431700,22,9507580049,16148349
1635174969,-184737,true,9492380843,22,9509481660,17100817
1635174998,-184735,true,9494279414,22,9510432608,16153194
1635175018,-184730,true,9499027504,22,9512334790,13307286
1635175093,-184731,true,9498077696,22,9507580049,9502353
1635175317,-184734,true,9495228842,22,9488584840,-6644002
1635175352,-184732,true,9497127983,22,9487636076,-9491907
1635175424,-184728,true,9500927404,22,9486687408,-14239996
1635175593,-184729,true,9499977406,22,9462055288,-37922118
1635175782,-184732,true,9497127983,22,9432769796,-64358187
1635175808,-184727,true,9501877497,22,9428054826,-73822671
1635175819,-184722,true,9506629386,22,9426169498,-80459888
1635176012,-184722,true,9506629386,22,9409218501,-97410885
1635176144,-184724,true,9504728345,22,9409218501,-95509844
1635176212,-184722,true,9506629386,22,9409218501,-97410885
1635176343,-184718,true,9510432608,22,9404515303,-105917305
1635176345,-184720,true,9508530807,22,9404515303,-104015504
1635176348,-184723,true,9505678818,22,9404515303,-101163515
1635176392,-184720,true,9508530807,22,9404515303,-104015504
1635176394,-184716,true,9512334790,22,9404515303,-107819487
1635176410,-184717,true,9511383651,22,9404515303,-106868348
1635176628,-184720,true,9508530807,22,9408277673,-100253134
1635176692,-184718,true,9510432608,22,9409218501,-101214107
1635176870,-184714,true,9514237352,22,9410159423,-104077929
1635176895,-184717,true,9511383651,22,9411100439,-100283212
1635176897,-184719,true,9509481660,22,9410159423,-99322237
1635176926,-184720,true,9508530807,22,9408277673,-100253134
1635176971,-184720,true,9508530807,22,9403574945,-104955862
1635177174,-184726,true,9502827685,22,9389480861,-113346824
1635177197,-184730,true,9499027504,22,9389480861,-109546643
1635177371,-184730,true,9499027504,22,9379158626,-119868878
1635177463,-184731,true,9498077696,22,9369784624,-128293072
1635177513,-184738,true,9491431700,22,9365101137,-126330563
1635177638,-184742,true,9487636076,22,9353870317,-133765759
1635177692,-184743,true,9486687408,22,9350129704,-136557704
1635177747,-184744,true,9485738834,22,9346390587,-139348247
1635178718,-184755,true,9475310779,22,9233062992,-242247787
1635178733,-184760,true,9470574544,22,9233062992,-237511552
1635179414,-184761,true,9469627582,22,9238604215,-231023367
1635179539,-184762,true,9468680714,22,9239528075,-229152639
1635179723,-184773,true,9458271411,22,9240452028,-217819383
1635179854,-184777,true,9454489049,22,9242300211,-212188838
1635179944,-184779,true,9452598434,22,9245073178,-207525256
1635180088,-184780,true,9451653269,22,9249696639,-201956630
1635180120,-184789,true,9443151033,22,9249696639,-193454394
1635180166,-184793,true,9439374716,22,9249696639,-189678077
1635180185,-184794,true,9438430873,22,9249696639,-188734234
1635180544,-184795,true,9437487125,22,9243224441,-194262684
1635180601,-184803,true,9429940531,22,9243224441,-186716090
1635180789,-184807,true,9426169498,22,9238604215,-187565283
1635180832,-184807,true,9426169498,22,9236756771,-189412727
1635180883,-184808,true,9425226975,22,9234909697,-190317278
1635180928,-184816,true,9417690186,22,9233062992,-184627194
1635180991,-184820,true,9413924051,22,9231216656,-182707395
1635181005,-184821,true,9412982753,22,9231216656,-181766097
1635181057,-184823,true,9411100439,22,9230293627,-180806812
1635181182,-184831,true,9403574945,22,9229370690,-174204255
1635181242,-184835,true,9399814455,22,9228447845,-171366610
1635181367,-184836,true,9398874568,22,9228447845,-170426723
1635181455,-184838,true,9396995075,22,9231216656,-165778419
1635181460,-184846,true,9389480861,22,9231216656,-158264205
1635181598,-184850,true,9385726007,22,9230293627,-155432380
1635181639,-184851,true,9384787528,22,9229370690,-155416838
1635181786,-184853,true,9382910852,22,9228447845,-154463007
1635181858,-184860,true,9376345441,22,9229370690,-146974751
1635181919,-184863,true,9373533100,22,9231216656,-142316444
1635182260,-184861,true,9375407900,22,9277486003,-97921897
1635182333,-184861,true,9375407900,22,9285839081,-89568819
1635182467,-184868,true,9368847739,22,9304428413,-64419326
1635182583,-184871,true,9366037647,22,9320258602,-45779045
1635182791,-184869,true,9367910948,22,9347325226,-20585722
1635182861,-184871,true,9366037647,22,9351064717,-14972930
1635182961,-184877,true,9360419991,22,9353870317,-6549674
1635183186,-184879,true,9358548187,22,9382910852,24362665
1635183325,-184876,true,9361356033,22,9394176540,32820507
1635183359,-184877,true,9360419991,22,9396995075,36575084
1635183371,-184883,true,9354805704,22,9396995075,42189371
1635183467,-184883,true,9354805704,22,9420515775,65710071
1635183507,-184875,true,9362292168,22,9431826614,69534446
1635183574,-184871,true,9366037647,22,9459217239,93179592
1635183586,-184877,true,9360419991,22,9463001493,102581502
1635183609,-184874,true,9363228397,22,9470574544,107346147
1635183652,-184864,true,9372595840,22,9486687408,114091568
1635183667,-184861,true,9375407900,22,9492380843,116972943
1635183703,-184866,true,9370721602,22,9505678818,134957216
1635183780,-184863,true,9373533100,22,9536144186,162611086
1635183914,-184855,true,9381034552,22,9584900306,203865754
1635184032,-184853,true,9382910852,22,9620428347,237517495
1635184063,-184857,true,9379158626,22,9628127384,248968758
1635184164,-184855,true,9381034552,22,9655122566,274088014
1635184176,-184847,true,9388542006,22,9658985195,270443189
1635184201,-184847,true,9388542006,22,9665748513,277206507
1635184252,-184849,true,9386664580,22,9680257289,293592709
1635184264,-184844,true,9391358851,22,9684129973,292771122
1635184283,-184835,true,9399814455,22,9687035502,287221047
1635184322,-184835,true,9399814455,22,9691879989,292065534
1635184368,-184836,true,9398874568,22,9698666341,299791773
1635184461,-184830,true,9404515303,22,9701576231,297060928
1635184663,-184819,true,9414865443,22,9728777349,313911906
1635185033,-184817,true,9416748511,22,9762886019,346137508
1635185088,-184818,true,9415806930,22,9773630565,357823635
1635185269,-184810,true,9423342213,22,9824583259,401241046
1635185368,-184798,true,9434656445,22,9841298418,406641973
1635185559,-184793,true,9439374716,22,9866917804,427543088
1635185562,-184793,true,9439374716,22,9866917804,427543088
1635185739,-184782,true,9449763222,22,9921332635,471569413
1635185808,-184768,true,9463001493,22,9944176819,481175326
1635185833,-184761,true,9469627582,22,9953130158,483502576
1635185896,-184761,true,9469627582,22,9977045162,507417580
1635185906,-184750,true,9480049382,22,9981036578,500987196
1635185907,-184735,true,9494279414,22,9981036578,486757164
1635185957,-184727,true,9501877497,22,10000017625,498140128
1635185982,-184727,true,9501877497,22,10009021242,507143745
1635186006,-184715,true,9513286023,22,10015028156,501742133
1635186028,-184701,true,9526613284,22,10017031262,490417978
1635186063,-184692,true,9535190666,22,10023042983,487852317
1635186120,-184693,true,9534237243,22,10029058313,494821070
1635186229,-184681,true,9545684622,22,10048130683,502446061
1635186304,-184669,true,9557145746,22,10055166485,498020739
1635186314,-184660,true,9565750618,22,10055166485,489415867
1635186352,-184661,true,9564794139,22,10059189155,494395016
1635186391,-184652,true,9573405898,22,10058183337,484777439
1635186421,-184640,true,9584900306,22,10058183337,473283031
1635186474,-184631,true,9593530167,22,10061201093,467670926
1635186481,-184628,true,9596408514,22,10060195074,463786560
1635186492,-184617,true,9606969843,22,10060195074,453225231
1635186500,-184602,true,9621390389,22,10061201093,439810704
1635186560,-184593,true,9630053105,22,10056172002,426118897
1635186603,-184591,true,9631979212,22,10053155753,421176541
1635186646,-184581,true,9641615527,22,10046121358,404505831
1635186694,-184568,true,9654157150,22,10037084368,382927218
1635186773,-184560,true,9661883180,22,10020036672,358153492
1635186785,-184559,true,9662849368,22,10018032965,355183597
1635186892,-184549,true,9672516567,22,9991022108,318505541
1635186934,-184535,true,9686066896,22,9985029592,298962696
1635187028,-184526,true,9694787844,22,9976047557,281259713
1635187110,-184524,true,9696726898,22,9968070309,271343411
1635187145,-184514,true,9706427990,22,9965080486,258652496
1635187158,-184501,true,9719053920,22,9965080486,246026566
1635187386,-184495,true,9724886810,22,9932251559,207364749
1635187394,-184494,true,9725859299,22,9929272480,203413181
1635187402,-184485,true,9734616075,22,9926294293,191678218
1635187476,-184472,true,9747278671,22,9909434771,162156100
1635187554,-184468,true,9751178168,22,9895571961,144393793
1635187603,-184466,true,9753128501,22,9891614722,138486221
1635187614,-184456,true,9762886019,22,9890625659,127739640
1635187633,-184443,true,9775585389,22,9889636696,114051307
1635187658,-184439,true,9779496210,22,9883704990,104208780
1635187688,-184439,true,9779496210,22,9878764620,99268410
1635187744,-184427,true,9791238062,22,9877776842,86538780
1635187753,-184413,true,9804954709,22,9877776842,72822133
1635187791,-184406,true,9811820236,22,9880740471,68920235
1635188156,-184405,true,9812801418,22,9884693361,71891943
1635188247,-184393,true,9824583259,22,9894582503,69999244
1635188264,-184383,true,9834412264,22,9896561519,62149255
1635188379,-184377,true,9840314387,22,9915381918,75067531
1635188386,-184376,true,9841298418,22,9917365094,76066676
1635188388,-184365,true,9852129261,22,9917365094,65235833
1635188614,-184353,true,9863958321,22,9965080486,101122165
1635188729,-184345,true,9871852250,22,9977045162,105192912
1635188771,-184344,true,9872839435,22,9982034682,109195247
1635188899,-184335,true,9881728546,22,9998017921,116289375
1635188945,-184323,true,9893593144,22,10004018232,110425088
1635189019,-184315,true,9901510789,22,10019034768,117523979
1635189148,-184317,true,9899530784,22,10015028156,115497372
1635189175,-184310,true,9906462535,22,10016029659,109567124
1635189216,-184302,true,9914390479,22,10018032965,103642486
1635189294,-184299,true,9917365094,22,10019034768,101669674
1635189380,-184304,true,9912407898,22,10000017625,87609727
1635189597,-184303,true,9913399139,22,9927286923,13887784
1635189667,-184297,true,9919348666,22,9905471988,-13876678
1635189692,-184296,true,9920340601,22,9897551175,-22789426
1635189713,-184301,true,9915381918,22,9890625659,-24756259
1635189754,-184300,true,9916373456,22,9878764620,-37608836
1635189794,-184295,true,9921332635,22,9865931211,-55401424
1635189894,-184293,true,9923317001,22,9832445677,-90871324
1635189922,-184298,true,9918356830,22,9827530928,-90825902
1635190047,-184297,true,9919348666,22,9802994012,-116354654
1635190144,-184292,true,9924309332,22,9776562948,-147746384
1635190154,-184289,true,9927286923,22,9773630565,-153656358
1635190218,-184294,true,9922324768,22,9763862308,-158462460
1635190230,-184294,true,9922324768,22,9761909828,-160414940
1635190508,-184284,true,9932251559,22,9798093985,-134157574
1635190585,-184281,true,9935231533,22,9805935204,-129296329
1635190703,-184286,true,9930265407,22,9818690571,-111574836
1635190795,-184286,true,9930265407,22,9827530928,-102734479
1635190940,-184280,true,9936225056,22,9834412264,-101812792
1635190989,-184278,true,9938212400,22,9840314387,-97898013
1635191010,-184284,true,9932251559,22,9842282548,-89969011
1635191026,-184286,true,9930265407,22,9844251103,-86014304
1635191120,-184279,true,9937218678,22,9856070704,-81147974
1635191137,-184280,true,9936225056,22,9858042017,-78183039
1635191150,-184285,true,9931258433,22,9860999725,-70258708
1635191203,-184288,true,9928279652,22,9872839435,-55440217
1635191321,-184278,true,9938212400,22,9898540930,-39671470
1635191362,-184282,true,9934238109,22,9906462535,-27775574
1635191478,-184287,true,9929272480,22,9929272480,0
1635191631,-184292,true,9924309332,22,9951139831,26830499
1635191638,-184284,true,9932251559,22,9950144816,17893257
1635191666,-184288,true,9928279652,22,9953130158,24850506
1635191711,-184295,true,9921332635,22,9960099440,38766805
1635191736,-184301,true,9915381918,22,9964084077,48702159
1635191776,-184291,true,9925301763,22,9971061029,45759266
1635191901,-184295,true,9921332635,22,9985029592,63696957
1635191965,-184301,true,9915381918,22,9991022108,75640190
1635192206,-184304,true,9912407898,22,9989024203,76616305
1635192416,-184293,true,9923317001,22,9978042866,54725865
1635192441,-184296,true,9920340601,22,9979040670,58700069
1635192469,-184302,true,9914390479,22,9979040670,64650191
1635192477,-184303,true,9913399139,22,9979040670,65641531
1635192560,-184293,true,9923317001,22,9975050052,51733051
1635192609,-184297,true,9919348666,22,9973055341,53706675
1635192632,-184301,true,9915381918,22,9977045162,61663244
1635192690,-184303,true,9913399139,22,9984031189,70632050
1635192732,-184293,true,9923317001,22,9989024203,65707202
1635192821,-184299,true,9917365094,22,9988025400,70660306
1635192832,-184303,true,9913399139,22,9988025400,74626261
1635192865,-184305,true,9911416757,22,9986028095,74611338
1635192881,-184296,true,9920340601,22,9985029592,64688991
1635192908,-184300,true,9916373456,22,9982034682,65661226
1635192911,-184304,true,9912407898,22,9982034682,69626784
1635193028,-184306,true,9910425714,22,9972058135,61632421
1635193144,-184297,true,9919348666,22,9962091559,42742893
1635193160,-184302,true,9914390479,22,9960099440,45708961
1635193190,-184306,true,9910425714,22,9957112008,46686294
1635193242,-184309,true,9907453181,22,9950144816,42691635
1635193316,-184299,true,9917365094,22,9947160370,29795276
1635193621,-184300,true,9916373456,22,9928279652,11906196
1635193659,-184302,true,9914390479,22,9928279652,13889173
1635193757,-184305,true,9911416757,22,9921332635,9915878
1635193805,-184295,true,9921332635,22,9918356830,-2975805
1635193877,-184295,true,9921332635,22,9917365094,-3967541
1635193891,-184300,true,9916373456,22,9917365094,991638
1635194002,-184300,true,9916373456,22,9922324768,5951312
1635194163,-184290,true,9926294293,22,9932251559,5957266
1635194247,-184290,true,9926294293,22,9932251559,5957266
1635194267,-184293,true,9923317001,22,9932251559,8934558
1635194275,-184296,true,9920340601,22,9931258433,10917832
1635194409,-184286,true,9930265407,22,9928279652,-1985755
1635194459,-184290,true,9926294293,22,9927286923,992630
1635194496,-184293,true,9923317001,22,9927286923,3969922
1635194501,-184296,true,9920340601,22,9927286923,6946322
1635194562,-184287,true,9929272480,22,9926294293,-2978187
1635194569,-184290,true,9926294293,22,9927286923,992630
1635194587,-184294,true,9922324768,22,9929272480,6947712
1635194600,-184297,true,9919348666,22,9931258433,11909767
1635194684,-184289,true,9927286923,22,9940200142,12913219
1635194687,-184293,true,9923317001,22,9940200142,16883141
1635194951,-184297,true,9919348666,22,9951139831,31791165
1635194970,-184300,true,9916373456,22,9951139831,34766375
1635195179,-184292,true,9924309332,22,9960099440,35790108
1635195279,-184297,true,9919348666,22,9967073602,47724936
1635195353,-184299,true,9917365094,22,9970064023,52698929
1635195407,-184301,true,9915381918,22,9970064023,54682105
1635195423,-184293,true,9923317001,22,9970064023,46747022
1635195481,-184297,true,9919348666,22,9975050052,55701386
1635195500,-184296,true,9920340601,22,9978042866,57702265
1635195509,-184292,true,9924309332,22,9979040670,54731338
1635195563,-184281,true,9935231533,22,9987026698,51795165
1635195567,-184281,true,9935231533,22,9987026698,51795165
1635195594,-184281,true,9935231533,22,9990023105,54791572
1635195785,-184279,true,9937218678,22,10003017930,65799252
1635195799,-184269,true,9947160370,22,10004018232,56857862
1635195822,-184270,true,9946165753,22,10005018634,58852881
1635195888,-184270,true,9946165753,22,10011023146,64857393
1635195916,-184267,true,9949149901,22,10013025451,63875550
1635195938,-184256,true,9960099440,22,10015028156,54928716
1635196008,-184253,true,9963087769,22,10035077252,71989483
1635196030,-184250,true,9966076994,22,10041099804,75022810
1635196069,-184245,true,9971061029,22,10052150538,81089509
1635196141,-184238,true,9978042866,22,10071266823,93223957
1635196190,-184236,true,9980038574,22,10084367328,104328754
1635196315,-184235,true,9981036578,22,10113652973,132616395
1635196407,-184231,true,9985029592,22,10127821294,142791702
1635196558,-184223,true,9993020412,22,10149111001,156090589
1635196653,-184221,true,9995019116,22,10165361763,170342647
1635196668,-184219,true,9997018220,22,10167394937,170376717
1635196746,-184215,true,10001017627,22,10178584665,177567038
1635196788,-184209,true,10007019738,22,10181638546,174618808
1635196820,-184209,true,10007019738,22,10181638546,174618808
1635196848,-184209,true,10007019738,22,10178584665,171564927
1635196895,-184208,true,10008020440,22,10173496900,165476460
1635196905,-184207,true,10009021242,22,10173496900,164475658
1635196985,-184203,true,10013025451,22,10174514249,161488798
1635197129,-184204,true,10012024248,22,10158248855,146224607
1635197172,-184203,true,10013025451,22,10155201990,142176539
1635197278,-184201,true,10015028156,22,10149111001,134082845
1635197442,-184198,true,10018032965,22,10138967470,120934505
1635197511,-184198,true,10018032965,22,10135926388,117893423
1635197570,-184196,true,10020036672,22,10129846960,109810288
1635197628,-184195,true,10021038675,22,10126808614,105769939
1635197645,-184191,true,10025047692,22,10125796034,100748342
1635197737,-184191,true,10025047692,22,10129846960,104799268
1635197872,-184189,true,10027052802,22,10122758903,95706101
1635197942,-184187,true,10029058313,22,10126808614,97750301
1635197971,-184184,true,10032067331,22,10130859945,98792614
1635198079,-184182,true,10034073845,22,10148096191,114022346
1635198114,-184178,true,10038088077,22,10151140925,113052848
1635198159,-184175,true,10041099804,22,10154186572,113086768
1635198178,-184172,true,10044112435,22,10155201990,111089555
1635198181,-184172,true,10044112435,22,10155201990,111089555
1635198274,-184169,true,10047125970,22,10165361763,118235793
1635198286,-184167,true,10049135496,22,10166378299,117242803
1635198302,-184162,true,10054161069,22,10168411677,114250608
1635198326,-184162,true,10054161069,22,10170445461,116284392
1635198338,-184157,true,10059189155,22,10171462505,112273350
1635198345,-184154,true,10062207213,22,10172479652,110272439
1635198602,-184147,true,10069252872,22,10214270341,145017469
1635198676,-184146,true,10070259797,22,10226534209,156274412
1635198692,-184141,true,10075295934,22,10229602476,154306542
1635198822,-184138,true,10078318825,22,10248031420,169712595
1635198836,-184130,true,10086384303,22,10250081129,163696826
1635198847,-184129,true,10087392941,22,10250081129,162688188
1635198905,-184124,true,10092437647,22,10251106137,158668490
1635198970,-184123,true,10093446890,22,10249056223,155609333
1635199076,-184116,true,10100514423,22,10255207195,154692772
1635199102,-184116,true,10100514423,22,10254181777,153667354
1635199125,-184111,true,10105565690,22,10255207195,149641505
1635199197,-184106,true,10110619484,22,10271627838,161008354
1635199201,-184096,true,10120734654,22,10271627838,150893184
1635199385,-184096,true,10120734654,22,10281904090,161169436
1635199420,-184093,true,10123771178,22,10282932280,159161102
1635199433,-184091,true,10125796034,22,10282932280,157136246
1635199480,-184080,true,10136939980,22,10286017468,149077488
1635199511,-184080,true,10136939980,22,10288074774,151134794
1635199518,-184076,true,10140995365,22,10289103582,148108217
1635199564,-184073,true,10144037968,22,10289103582,145065614
1635199602,-184064,true,10153171254,22,10287046070,133874816
1635199653,-184064,true,10153171254,22,10284988969,131817715
1635199664,-184061,true,10156217510,22,10283960573,127743063
1635199680,-184059,true,10158248855,22,10282932280,124683425
1635199924,-184054,true,10163328996,22,10248031420,84702424
1635200094,-184058,true,10159264680,22,10190805687,31541007
1635200172,-184055,true,10162312765,22,10166378299,4065534
1635200378,-184056,true,10161296635,22,10084367328,-76929307
1635200398,-184053,true,10164345329,22,10077311094,-87034235
1635200515,-184058,true,10159264680,22,10035077252,-124187428
1635200579,-184056,true,10161296635,22,10013025451,-148271184
1635200637,-184057,true,10160280607,22,10001017627,-159262980
1635200717,-184054,true,10163328996,22,9989024203,-174304793
1635200745,-184060,true,10157233132,22,9983032885,-174200247
1635200846,-184058,true,10159264680,22,9958107719,-201156961
1635200885,-184060,true,10157233132,22,9947160370,-210072762
1635200941,-184061,true,10156217510,22,9932251559,-223965951
1635200963,-184068,true,10149111001,22,9925301763,-223809238
1635201035,-184068,true,10149111001,22,9915381918,-233729083
1635201059,-184071,true,10146066877,22,9912407898,-233658979
1635201127,-184071,true,10146066877,22,9904481539,-241585338
1635201149,-184077,true,10139981367,22,9900520737,-239460630
1635201183,-184078,true,10138967470,22,9894582503,-244384967
1635201237,-184081,true,10135926388,22,9884693361,-251233027
1635201290,-184081,true,10135926388,22,9878764620,-257161768
1635201370,-184087,true,10129846960,22,9869878175,-259968785
1635201423,-184087,true,10129846960,22,9865931211,-263915749
1635201474,-184089,true,10127821294,22,9863958321,-263862973
1635201540,-184092,true,10124783556,22,9860999725,-263783831
1635201643,-184099,true,10117699041,22,9853114474,-264584567
1635201671,-184101,true,10115675805,22,9854099785,-261576020
1635201676,-184105,true,10111630546,22,9854099785,-257530761
1635201716,-184107,true,10109608523,22,9857056311,-252552212
1635201747,-184112,true,10104555235,22,9858042017,-246513218
1635201818,-184113,true,10103544880,22,9872839435,-230705445
1635201866,-184115,true,10101524475,22,9881728546,-219795929
1635201897,-184118,true,10098494623,22,9883704990,-214789633
1635201927,-184123,true,10093446890,22,9885681830,-207765060
1635201982,-184123,true,10093446890,22,9889636696,-203810194
1635202120,-184126,true,10090419462,22,9911416757,-179002705
1635202166,-184126,true,10090419462,22,9916373456,-174046006
1635202172,-184131,true,10085375765,22,9916373456,-169002309
1635202185,-184130,true,10086384303,22,9917365094,-169019209
1635202225,-184132,true,10084367328,22,9923317001,-161050327
1635202341,-184135,true,10081342623,22,9939206221,-142136402
1635202344,-184138,true,10078318825,22,9940200142,-138118683
1635202460,-184138,true,10078318825,22,9952134945,-126183880
1635202525,-184139,true,10077311094,22,9956116396,-121194698
1635202527,-184141,true,10075295934,22,9956116396,-119179538
1635202537,-184145,true,10071266823,22,9956116396,-115150427
1635202546,-184145,true,10071266823,22,9957112008,-114154815
1635202588,-184145,true,10071266823,22,9961095450,-110171373
1635202644,-184149,true,10067239323,22,9959103530,-108135793
1635202763,-184153,true,10063213434,22,9957112008,-106101426
1635202802,-184154,true,10062207213,22,9956116396,-106090817
1635202867,-184155,true,10061201093,22,9954125471,-107075622
1635203065,-184159,true,10057177619,22,9950144816,-107032803
1635203130,-184165,true,10051145424,22,9947160370,-103985054
1635203171,-184167,true,10049135496,22,9942188281,-106947215
1635203234,-184169,true,10047125970,22,9936225056,-110900914
1635203299,-184173,true,10043108125,22,9931258433,-111849692
1635203318,-184177,true,10039091885,22,9928279652,-110812233
1635203557,-184183,true,10033070538,22,9895571961,-137498577
1635203657,-184185,true,10031064225,22,9887659065,-143405160
1635203681,-184189,true,10027052802,22,9890625659,-136427143
1635203688,-184194,true,10022040779,22,9890625659,-131415120
1635203705,-184197,true,10019034768,22,9890625659,-128409109
1635203731,-184197,true,10019034768,22,9890625659,-128409109
1635203798,-184204,true,10012024248,22,9890625659,-121398589
1635203835,-184210,true,10006019136,22,9889636696,-116382440
1635203875,-184214,true,10002017729,22,9887659065,-114358664
1635203963,-184215,true,10001017627,22,9880740471,-120277156
1635204087,-184223,true,9993020412,22,9873826719,-119193693
1635204313,-184228,true,9988025400,22,9875801583,-112223817
1635204406,-184232,true,9984031189,22,9880740471,-103290718
1635204443,-184231,true,9985029592,22,9882716718,-102312874
1635204459,-184239,true,9977045162,22,9883704990,-93340172
1635204491,-184244,true,9972058135,22,9883704990,-88353145
1635204623,-184249,true,9967073602,22,9877776842,-89296760
1635204638,-184250,true,9966076994,22,9877776842,-88300152
1635204663,-184261,true,9955120884,22,9875801583,-79319301
1635204824,-184264,true,9952134945,22,9877776842,-74358103
1635204865,-184268,true,9948155086,22,9879752496,-68402590
1635204897,-184269,true,9947160370,22,9880740471,-66419899
1635205001,-184279,true,9937218678,22,9882716718,-54501960
1635205005,-184283,true,9933244784,22,9882716718,-50528066
1635205060,-184288,true,9928279652,22,9881728546,-46551106
1635205092,-184288,true,9928279652,22,9881728546,-46551106
1635205113,-184298,true,9918356830,22,9882716718,-35640112
1635205157,-184300,true,9916373456,22,9883704990,-32668466
1635205169,-184304,true,9912407898,22,9884693361,-27714537
1635205193,-184303,true,9913399139,22,9885681830,-27717309
1635205271,-184308,true,9908443926,22,9890625659,-17818267
1635205344,-184307,true,9909434771,22,9896561519,-12873252
1635205379,-184310,true,9906462535,22,9898540930,-7921605
1635205421,-184307,true,9909434771,22,9899530784,-9903987
1635205604,-184312,true,9904481539,22,9900520737,-3960802
1635205796,-184311,true,9905471988,22,9893593144,-11878844
1635205915,-184313,true,9903491190,22,9897551175,-5940015
1635205938,-184310,true,9906462535,22,9897551175,-8911360
1635205953,-184315,true,9901510789,22,9898540930,-2969859
1635206013,-184313,true,9903491190,22,9898540930,-4950260
1635206106,-184315,true,9901510789,22,9895571961,-5938828
1635206185,-184310,true,9906462535,22,9892603883,-13858652
1635206322,-184313,true,9903491190,22,9880740471,-22750719
1635206367,-184310,true,9906462535,22,9881728546,-24733989
1635206450,-184311,true,9905471988,22,9892603883,-12868105
1635206501,-184307,true,9909434771,22,9897551175,-11883596
1635206556,-184307,true,9909434771,22,9909434771,0
1635206623,-184303,true,9913399139,22,9924309332,10910193
1635206676,-184301,true,9915381918,22,9935231533,19849615
1635206703,-184295,true,9921332635,22,9944176819,22844184
1635206800,-184293,true,9923317001,22,9972058135,48741134
1635206880,-184290,true,9926294293,22,9983032885,56738592
1635206883,-184289,true,9927286923,22,9983032885,55745962
1635206922,-184284,true,9932251559,22,9991022108,58770549
1635207021,-184284,true,9932251559,22,10015028156,82776597
1635207066,-184281,true,9935231533,22,10025047692,89816159
1635207120,-184281,true,9935231533,22,10032067331,96835798
1635207144,-184277,true,9939206221,22,10036080760,96874539
1635207214,-184279,true,9937218678,22,10050140410,112921732
1635207230,-184277,true,9939206221,22,10054161069,114954848
1635207256,-184278,true,9938212400,22,10055166485,116954085
1635207335,-184275,true,9941194162,22,10052150538,110956376
1635207416,-184279,true,9937218678,22,10046121358,108902680
1635207652,-184277,true,9939206221,22,10002017729,62811508
1635207763,-184278,true,9938212400,22,9979040670,40828270
1635207820,-184276,true,9940200142,22,9969067116,28866974
1635207850,-184280,true,9936225056,22,9962091559,25866503
1635207957,-184279,true,9937218678,22,9936225056,-993622
1635208122,-184281,true,9935231533,22,9911416757,-23814776
1635208143,-184279,true,9937218678,22,9908443926,-28774752
1635208277,-184285,true,9931258433,22,9901510789,-29747644
1635208358,-184285,true,9931258433,22,9895571961,-35686472
1635208493,-184287,true,9929272480,22,9879752496,-49519984
1635208498,-184285,true,9931258433,22,9879752496,-51505937
1635208551,-184291,true,9925301763,22,9871852250,-53449513
1635208566,-184292,true,9924309332,22,9870865163,-53444169
1635208582,-184294,true,9922324768,22,9868891286,-53433482
1635208587,-184294,true,9922324768,22,9867904496,-54420272
1635208645,-184297,true,9919348666,22,9862972023,-56376643
1635208667,-184297,true,9919348666,22,9860999725,-58348941
1635208689,-184299,true,9917365094,22,9859027821,-58337273
1635208800,-184296,true,9920340601,22,9859027821,-61312780
1635208917,-184299,true,9917365094,22,9860999725,-56365369
1635208981,-184298,true,9918356830,22,9862972023,-55384807
1635209037,-184300,true,9916373456,22,9863958321,-52415135
1635209132,-184299,true,9917365094,22,9853114474,-64250620
1635209177,-184303,true,9913399139,22,9849174213,-64224926
1635209180,-184302,true,9914390479,22,9849174213,-65216266
1635209187,-184303,true,9913399139,22,9849174213,-64224926
1635209189,-184300,true,9916373456,22,9849174213,-67199243
1635209260,-184306,true,9910425714,22,9841298418,-69127296
1635209310,-184307,true,9909434771,22,9835395705,-74039066
1635209528,-184308,true,9908443926,22,9837362883,-71081043
1635209572,-184308,true,9908443926,22,9836379245,-72064681
1635209613,-184311,true,9905471988,22,9833428921,-72043067
1635209756,-184311,true,9905471988,22,9820654408,-84817580
1635209801,-184312,true,9904481539,22,9815745553,-88735986
1635209819,-184311,true,9905471988,22,9813782699,-91689289
1635209877,-184314,true,9902500940,22,9808877279,-93623661
1635209918,-184315,true,9901510789,22,9802994012,-98516777
1635209923,-184315,true,9901510789,22,9802994012,-98516777
1635209944,-184315,true,9901510789,22,9800053702,-101457087
1635210106,-184319,true,9897551175,22,9796134660,-101416515
1635210128,-184320,true,9896561519,22,9796134660,-100426859
1635210166,-184320,true,9896561519,22,9798093985,-98467534
1635210222,-184319,true,9897551175,22,9802994012,-94557163
1635210291,-184322,true,9894582503,22,9802994012,-91588491
1635210332,-184325,true,9891614722,22,9793196407,-98418315
1635210468,-184328,true,9888647831,22,9763862308,-124785523
1635210507,-184329,true,9887659065,22,9757030337,-130628728
1635210611,-184334,true,9882716718,22,9736563095,-146153623
1635210622,-184337,true,9879752496,22,9734616075,-145136421
1635210630,-184340,true,9876789163,22,9732669443,-144119720
1635210646,-184341,true,9875801583,22,9727804568,-147997015
1635210681,-184346,true,9870865163,22,9721969928,-148895235
1635210785,-184349,true,9867904496,22,9702546389,-165358107
1635210820,-184353,true,9863958321,22,9695757322,-168200999
1635210847,-184354,true,9862972023,22,9694787844,-168184179
1635210858,-184359,true,9858042017,22,9693818462,-164223555
1635210912,-184361,true,9856070704,22,9689941904,-166128800
1635211039,-184365,true,9852129261,22,9674451167,-177678094
1635211046,-184365,true,9852129261,22,9674451167,-177678094
1635211111,-184369,true,9848189394,22,9666715088,-181474306
1635211129,-184370,true,9847204674,22,9664782035,-182422639
1635211135,-184373,true,9844251103,22,9663815653,-180435450
1635211152,-184373,true,9844251103,22,9661883180,-182367923
1635211209,-184378,true,9839330454,22,9657053687,-182276767
1635211315,-184381,true,9836379245,22,9657053687,-179325558
1635211355,-184384,true,9833428921,22,9657053687,-176375234
1635211521,-184386,true,9831462530,22,9653191831,-178270699
1635211553,-184390,true,9827530928,22,9655122566,-172408362
1635211595,-184394,true,9823600899,22,9652226609,-171374290
1635211666,-184397,true,9820654408,22,9652226609,-168427799
1635211680,-184399,true,9818690571,22,9652226609,-166463962
1635211802,-184406,true,9811820236,22,9649331520,-162488716
1635211854,-184411,true,9806915798,22,9648366683,-158549115
1635211893,-184415,true,9802994012,22,9647401943,-155592069
1635211933,-184418,true,9800053702,22,9646437299,-153616403
1635212052,-184426,true,9792217186,22,9643543947,-148673239
1635212077,-184430,true,9788301278,22,9643543947,-144757331
1635212085,-184435,true,9783408595,22,9643543947,-139864648
1635212092,-184438,true,9780474159,22,9643543947,-136930212
1635212118,-184444,true,9774607928,22,9643543947,-131063981
1635212171,-184450,true,9768745216,22,9645472752,-123272464
1635212211,-184454,true,9764838694,22,9647401943,-117436751
1635212251,-184455,true,9763862308,22,9652226609,-111635699
1635212376,-184457,true,9761909828,22,9679289360,-82620468
1635212443,-184462,true,9757030337,22,9688004206,-69026131
1635212605,-184465,true,9754103814,22,9705457444,-48646370
1635212638,-184466,true,9753128501,22,9706427990,-46700511
1635212642,-184467,true,9752153285,22,9706427990,-45725295
1635212683,-184472,true,9747278671,22,9707398633,-39880038
1635212701,-184476,true,9743380734,22,9708369372,-35011362
1635212998,-184474,true,9745329508,22,9733642710,-11686798
1635213100,-184476,true,9743380734,22,9743380734,0
1635213131,-184479,true,9740458305,22,9744355072,3896767
1635213156,-184483,true,9736563095,22,9743380734,6817639
1635213220,-184481,true,9738510505,22,9737536751,-973754
1635213285,-184483,true,9736563095,22,9730723201,-5839894
1635213317,-184487,true,9732669443,22,9728777349,-3892094
1635213386,-184491,true,9728777349,22,9721969928,-6807421
1635213465,-184490,true,9729750226,22,9713224528,-16525698
1635213509,-184492,true,9727804568,22,9708369372,-19435196
1635213536,-184496,true,9723914419,22,9705457444,-18456975
1635213552,-184499,true,9720997828,22,9703516644,-17481184
1635213689,-184497,true,9722942125,22,9696726898,-26215227
1635213734,-184500,true,9720025825,22,9689941904,-30083921
1635213752,-184503,true,9717110401,22,9689941904,-27168497
1635213825,-184506,true,9714195851,22,9688973006,-25222845
1635213849,-184505,true,9715167270,22,9688973006,-26194264
1635213950,-184507,true,9713224528,22,9688004206,-25220322
1635214010,-184510,true,9710311143,22,9687035502,-23275641
1635214299,-184513,true,9707398633,22,9698666341,-8732292
1635214495,-184511,true,9709340209,22,9715167270,5827061
1635214509,-184513,true,9707398633,22,9716138787,8740154
1635214547,-184515,true,9705457444,22,9717110401,11652957
1635214721,-184517,true,9703516644,22,9722942125,19425481
1635214754,-184516,true,9704486995,22,9721969928,17482933
1635214855,-184515,true,9705457444,22,9722942125,17484681
1635214888,-184516,true,9704486995,22,9722942125,18455130
1635214948,-184520,true,9700606171,22,9726831885,26225714
1635215019,-184517,true,9703516644,22,9732669443,29152799
1635215047,-184516,true,9704486995,22,9733642710,29155715
1635215067,-184518,true,9702546389,22,9733642710,31096321
1635215092,-184522,true,9698666341,22,9732669443,34003102
1635215132,-184520,true,9700606171,22,9736563095,35956924
1635215191,-184518,true,9702546389,22,9740458305,37911916
1635215199,-184519,true,9701576231,22,9741432350,39856119
1635215311,-184522,true,9698666341,22,9750203147,51536806
1635215336,-184520,true,9700606171,22,9752153285,51547114
1635215506,-184519,true,9701576231,22,9758006040,56429809
1635215575,-184519,true,9701576231,22,9760933735,59357504
1635215664,-184522,true,9698666341,22,9769722090,71055749
1635215722,-184521,true,9699636207,22,9772653300,73017093
1635215725,-184519,true,9701576231,22,9773630565,72054334
1635215792,-184518,true,9702546389,22,9778518358,75971969
1635215823,-184518,true,9702546389,22,9778518358,75971969
1635215921,-184515,true,9705457444,22,9778518358,73060914
1635215986,-184512,true,9708369372,22,9781452207,73082835
1635215994,-184511,true,9709340209,22,9782430352,73090143
1635216025,-184511,true,9709340209,22,9779496210,70156001
1635216170,-184507,true,9713224528,22,9783408595,70184067
1635216246,-184503,true,9717110401,22,9787322545,70212144
1635216343,-184502,true,9718082112,22,9796134660,78052548
1635216482,-184502,true,9718082112,22,9804954709,86872597
1635216636,-184499,true,9720997828,22,9803974311,82976483
1635216841,-184496,true,9723914419,22,9801033707,77119288
1635216957,-184497,true,9722942125,22,9802994012,80051887
1635217004,-184498,true,9721969928,22,9801033707,79063779
1635217049,-184495,true,9724886810,22,9794175727,69288917
1635217055,-184493,true,9726831885,22,9794175727,67343842
1635217069,-184495,true,9724886810,22,9792217186,67330376
1635217091,-184496,true,9723914419,22,9794175727,70261308
1635217117,-184490,true,9729750226,22,9794175727,64425501
1635217259,-184487,true,9732669443,22,9793196407,60526964
1635217284,-184488,true,9731696274,22,9788301278,56605004
1635217527,-184489,true,9730723201,22,9786343911,55620710
1635217541,-184482,true,9737536751,22,9787322545,49785794
1635217579,-184478,true,9741432350,22,9798093985,56661635
1635217695,-184477,true,9742406494,22,9811820236,69413742
1635217844,-184477,true,9742406494,22,9818690571,76284077
1635217922,-184471,true,9748253399,22,9824583259,76329860
1635217939,-184468,true,9751178168,22,9827530928,76352760
1635217940,-184469,true,9750203147,22,9828513681,78310534
1635218007,-184469,true,9750203147,22,9831462530,81259383
1635218136,-184463,true,9756054732,22,9833428921,77374189
1635218166,-184460,true,9758981841,22,9835395705,76413864
1635218269,-184461,true,9758006040,22,9842282548,84276508
1635218301,-184462,true,9757030337,22,9843266776,86236439
1635218328,-184456,true,9762886019,22,9845235528,82349509
1635218451,-184453,true,9765815178,22,9848189394,82374216
1635218494,-184454,true,9764838694,22,9836379245,71540551
1635218631,-184456,true,9762886019,22,9811820236,48934217
1635218661,-184452,true,9766791760,22,9807896489,41104729
1635218675,-184454,true,9764838694,22,9806915798,42077104
1635218926,-184456,true,9762886019,22,9777540604,14654585
1635218950,-184458,true,9760933735,22,9774607928,13674193
1635218958,-184453,true,9765815178,22,9774607928,8792750
1635219061,-184453,true,9765815178,22,9765815178,0
1635219185,-184454,true,9764838694,22,9757030337,-7808357
1635219233,-184455,true,9763862308,22,9752153285,-11709023
1635219470,-184452,true,9766791760,22,9743380734,-23411026
1635219652,-184452,true,9766791760,22,9758006040,-8785720
1635219735,-184452,true,9766791760,22,9769722090,2930330
1635219886,-184452,true,9766791760,22,9788301278,21509518
1635219925,-184448,true,9770699062,22,9792217186,21518124
1635219943,-184446,true,9772653300,22,9793196407,20543107
1635220183,-184447,true,9771676132,22,9802994012,31317880
1635220336,-184447,true,9771676132,22,9808877279,37201147
1635220354,-184441,true,9777540604,22,9810839152,33298548
1635220455,-184438,true,9780474159,22,9817708800,37234641
1635220468,-184438,true,9780474159,22,9817708800,37234641
1635220489,-184437,true,9781452207,22,9818690571,37238364
1635220502,-184433,true,9785365375,22,9817708800,32343425
1635220554,-184432,true,9786343911,22,9815745553,29401642
1635220823,-184434,true,9784386936,22,9788301278,3914342
1635220886,-184433,true,9785365375,22,9787322545,1957170
1635220931,-184430,true,9788301278,22,9782430352,-5870926
1635221131,-184430,true,9788301278,22,9788301278,0
1635221302,-184431,true,9787322545,22,9790259036,2936491
1635221343,-184430,true,9788301278,22,9789280108,978830
1635221344,-184426,true,9792217186,22,9789280108,-2937078
1635221354,-184426,true,9792217186,22,9788301278,-3915908
1635221465,-184429,true,9789280108,22,9782430352,-6849756
1635221475,-184429,true,9789280108,22,9782430352,-6849756
1635221503,-184425,true,9793196407,22,9782430352,-10766055
1635221667,-184425,true,9793196407,22,9781452207,-11744200
1635221859,-184428,true,9790259036,22,9777540604,-12718432
1635221897,-184429,true,9789280108,22,9774607928,-14672180
1635221927,-184426,true,9792217186,22,9771676132,-20541054
1635221970,-184427,true,9791238062,22,9765815178,-25422884
1635222014,-184431,true,9787322545,22,9760933735,-26388810
1635222024,-184431,true,9787322545,22,9758981841,-28340704
1635222118,-184426,true,9792217186,22,9757030337,-35186849
1635222197,-184427,true,9791238062,22,9755079224,-36158838
1635222377,-184430,true,9788301278,22,9763862308,-24438970
1635222564,-184431,true,9787322545,22,9769722090,-17600455
1635222657,-184426,true,9792217186,22,9765815178,-26402008
1635222816,-184427,true,9791238062,22,9758006040,-33232022
1635222866,-184431,true,9787322545,22,9758006040,-29316505
1635223252,-184431,true,9787322545,22,9773630565,-13691980
1635223265,-184426,true,9792217186,22,9773630565,-18586621
1635223276,-184426,true,9792217186,22,9773630565,-18586621
1635223343,-184430,true,9788301278,22,9781452207,-6849071
1635223430,-184428,true,9790259036,22,9790259036,0
1635223473,-184423,true,9795155145,22,9795155145,0
1635223596,-184423,true,9795155145,22,9816727128,21571983
1635223648,-184427,true,9791238062,22,9823600899,32362837
1635223796,-184425,true,9793196407,22,9842282548,49086141
1635223807,-184420,true,9798093985,22,9843266776,45172791
1635223848,-184421,true,9797114273,22,9844251103,47136830
1635223978,-184426,true,9792217186,22,9837362883,45145697
1635224001,-184426,true,9792217186,22,9836379245,44162059
1635224072,-184421,true,9797114273,22,9834412264,37297991
1635224100,-184422,true,9796134660,22,9833428921,37294261
1635224141,-184426,true,9792217186,22,9831462530,39245344
1635224149,-184425,true,9793196407,22,9831462530,38266123
1635224170,-184420,true,9798093985,22,9831462530,33368545
1635224271,-184420,true,9798093985,22,9823600899,25506914
1635224351,-184423,true,9795155145,22,9820654408,25499263
1635224406,-184422,true,9796134660,22,9817708800,21574140
1635224427,-184420,true,9798093985,22,9817708800,19614815
1635224607,-184419,true,9799073794,22,9819672440,20598646
1635224849,-184420,true,9798093985,22,9837362883,39268898
1635224941,-184418,true,9800053702,22,9846220052,46166350
1635224954,-184416,true,9802013810,22,9848189394,46175584
1635225080,-184416,true,9802013810,22,9859027821,57014011
1635225098,-184419,true,9799073794,22,9860013723,60939929
1635225260,-184419,true,9799073794,22,9868891286,69817492
1635225267,-184416,true,9802013810,22,9867904496,65890686
1635225308,-184416,true,9802013810,22,9864944716,62930906
1635225480,-184419,true,9799073794,22,9850159131,51085337
1635225510,-184421,true,9797114273,22,9847204674,50090401
1635225772,-184417,true,9801033707,22,9835395705,34361998
1635225842,-184417,true,9801033707,22,9831462530,30428823
1635225885,-184419,true,9799073794,22,9830479483,31405689
1635226025,-184421,true,9797114273,22,9826548274,29434001
1635226106,-184417,true,9801033707,22,9821636473,20602766
1635226365,-184418,true,9800053702,22,9827530928,27477226
1635226553,-184419,true,9799073794,22,9825565717,26491923
1635226657,-184419,true,9799073794,22,9825565717,26491923
1635226660,-184415,true,9802994012,22,9825565717,22571705
1635226673,-184413,true,9804954709,22,9823600899,18646190
1635226864,-184415,true,9802994012,22,9813782699,10788687
1635226916,-184416,true,9802013810,22,9812801418,10787608
1635226932,-184412,true,9805935204,22,9812801418,6866214
1635226955,-184410,true,9807896489,22,9812801418,4904929
1635227011,-184412,true,9805935204,22,9813782699,7847495
1635227258,-184413,true,9804954709,22,9817708800,12754091
1635227557,-184408,true,9809858167,22,9819672440,9814273
1635227709,-184407,true,9810839152,22,9825565717,14726565
1635227758,-184410,true,9807896489,22,9826548274,18651785
1635227882,-184411,true,9806915798,22,9825565717,18649919
1635227949,-184408,true,9809858167,22,9828513681,18655514
1635228118,-184407,true,9810839152,22,9837362883,26523731
1635228159,-184409,true,9808877279,22,9839330454,30453175
1635228268,-184408,true,9809858167,22,9843266776,33408609
1635228298,-184405,true,9812801418,22,9844251103,31449685
1635228335,-184404,true,9813782699,22,9845235528,31452829
1635228336,-184406,true,9811820236,22,9845235528,33415292
1635228582,-184407,true,9810839152,22,9853114474,42275322
1635228628,-184404,true,9813782699,22,9853114474,39331775
1635228724,-184401,true,9816727128,22,9855085195,38358067
1635228997,-184404,true,9813782699,22,9826548274,12765575
1635229055,-184406,true,9811820236,22,9820654408,8834172
1635229180,-184403,true,9814764077,22,9807896489,-6867588
1635229576,-184401,true,9816727128,22,9777540604,-39186524
1635229747,-184403,true,9814764077,22,9816727128,1963051
1635229963,-184404,true,9813782699,22,9852129261,38346562
1635230144,-184400,true,9817708800,22,9878764620,61055820
1635230161,-184396,true,9821636473,22,9880740471,59103998
1635230277,-184397,true,9820654408,22,9884693361,64038953
1635230356,-184399,true,9818690571,22,9886670398,67979827
1635230377,-184397,true,9820654408,22,9887659065,67004657
1635230469,-184393,true,9824583259,22,9888647831,64064572
1635230592,-184395,true,9822618637,22,9863958321,41339684
1635230633,-184396,true,9821636473,22,9855085195,33448722
1635230713,-184395,true,9822618637,22,9844251103,21632466
1635230760,-184390,true,9827530928,22,9838346619,10815691
1635231573,-184391,true,9826548274,22,9799073794,-27474480
1635231643,-184392,true,9825565717,22,9799073794,-26491923
1635231666,-184392,true,9825565717,22,9798093985,-27471732
1635231798,-184389,true,9828513681,22,9800053702,-28459979
1635231863,-184391,true,9826548274,22,9800053702,-26494572
1635231885,-184392,true,9825565717,22,9800053702,-25512015
1635231895,-184391,true,9826548274,22,9799073794,-27474480
1635231960,-184388,true,9829496533,22,9798093985,-31402548
1635232007,-184389,true,9828513681,22,9797114273,-31399408
1635232025,-184391,true,9826548274,22,9798093985,-28454289
1635232083,-184391,true,9826548274,22,9797114273,-29434001
1635232134,-184388,true,9829496533,22,9800053702,-29442831
1635232264,-184389,true,9828513681,22,9805935204,-22578477
1635232534,-184393,true,9824583259,22,9815745553,-8837706
1635232657,-184393,true,9824583259,22,9816727128,-7856131
1635232711,-184390,true,9827530928,22,9816727128,-10803800
1635232824,-184390,true,9827530928,22,9818690571,-8840357
1635233005,-184394,true,9823600899,22,9829496533,5895634
1635233159,-184393,true,9824583259,22,9830479483,5896224
1635233208,-184390,true,9827530928,22,9831462530,3931602
1635233276,-184389,true,9828513681,22,9836379245,7865564
1635233314,-184390,true,9827530928,22,9841298418,13767490
1635233458,-184388,true,9829496533,22,9857056311,27559778
1635233505,-184383,true,9834412264,22,9865931211,31518947
1635233543,-184382,true,9835395705,22,9872839435,37443730
1635233565,-184383,true,9834412264,22,9880740471,46328207
1635233597,-184377,true,9840314387,22,9888647831,48333444
1635233732,-184373,true,9844251103,22,9920340601,76089498
1635233873,-184372,true,9845235528,22,9946165753,100930225
1635234074,-184374,true,9843266776,22,9981036578,137769802
1635234150,-184369,true,9848189394,22,9993020412,144831018
1635234185,-184365,true,9852129261,22,9998017921,145888660
1635234472,-184364,true,9853114474,22,10029058313,175943839
1635234581,-184366,true,9851144147,22,10032067331,180923184
1635234583,-184360,true,9857056311,22,10032067331,175011020
1635234720,-184357,true,9860013723,22,10030061219,170047496
1635234872,-184357,true,9860013723,22,10034073845,174060122
1635234898,-184358,true,9859027821,22,10035077252,176049431
1635234906,-184353,true,9863958321,22,10036080760,172122439
1635234944,-184349,true,9867904496,22,10037084368,169179872
1635235081,-184347,true,9869878175,22,10041099804,171221629
1635235100,-184346,true,9870865163,22,10041099804,170234641
1635235209,-184344,true,9872839435,22,10028055507,155216072
1635235219,-184340,true,9876789163,22,10027052802,150263639
1635235311,-184340,true,9876789163,22,10022040779,145251616
1635235408,-184340,true,9876789163,22,10017031262,140242099
1635235442,-184336,true,9880740471,22,10018032965,137292494
1635235638,-184329,true,9887659065,22,10035077252,147418187
1635235891,-184331,true,9885681830,22,10014026753,128344923
1635235920,-184330,true,9886670398,22,10013025451,126355053
1635236004,-184327,true,9889636696,22,10009021242,119384546
1635236061,-184322,true,9894582503,22,10012024248,117441745
1635236178,-184322,true,9894582503,22,10015028156,120445653
1635236187,-184321,true,9895571961,22,10015028156,119456195
1635236234,-184317,true,9899530784,22,10015028156,115497372
1635236254,-184313,true,9903491190,22,10016029659,112538469
1635236284,-184313,true,9903491190,22,10016029659,112538469
1635236338,-184312,true,9904481539,22,10014026753,109545214
1635236433,-184308,true,9908443926,22,10007019738,98575812
1635236472,-184304,true,9912407898,22,10003017930,90610032
1635236634,-184305,true,9911416757,22,9996018618,84601861
1635236674,-184304,true,9912407898,22,9996018618,83610720
1635236967,-184301,true,9915381918,22,9992021210,76639292
1635237084,-184299,true,9917365094,22,9985029592,67664498
1635237823,-184301,true,9915381918,22,9937218678,21836760
1635238027,-184301,true,9915381918,22,9933244784,17862866
1635238108,-184298,true,9918356830,22,9934238109,15881279
1635238176,-184295,true,9921332635,22,9934238109,12905474
1635238184,-184297,true,9919348666,22,9934238109,14889443
1635238311,-184297,true,9919348666,22,9940200142,20851476
1635238472,-184292,true,9924309332,22,9957112008,32802676
1635238562,-184288,true,9928279652,22,9965080486,36800834
1635238667,-184288,true,9928279652,22,9974052647,45772995
1635238842,-184286,true,9930265407,22,9988025400,57759993
1635238859,-184282,true,9934238109,22,9989024203,54786094
1635238919,-184277,true,9939206221,22,9994019714,54813493
1635239101,-184280,true,9936225056,22,10010022144,73797088
1635239144,-184279,true,9937218678,22,10012024248,74805570
1635239149,-184275,true,9941194162,22,10012024248,70830086
1635239269,-184272,true,9944176819,22,10024045288,79868469
1635239554,-184270,true,9946165753,22,10060195074,114029321
1635239926,-184267,true,9949149901,22,10103544880,154394979
1635240059,-184261,true,9955120884,22,10116687372,161566488
1635240062,-184258,true,9958107719,22,10116687372,158579653
1635240097,-184255,true,9961095450,22,10119722682,158627232
1635240122,-184252,true,9964084077,22,10121746728,157662651
1635240341,-184245,true,9971061029,22,10130859945,159798916
1635240383,-184242,true,9974052647,22,10131873031,157820384
1635240445,-184240,true,9976047557,22,10126808614,150761057
1635240585,-184237,true,9979040670,22,10117699041,138658371
1635240670,-184232,true,9984031189,22,10110619484,126588295
1635241131,-184230,true,9986028095,22,10066232700,80204605
1635241391,-184229,true,9987026698,22,10046121358,59094660
1635241569,-184226,true,9990023105,22,10048130683,58107578
1635241627,-184221,true,9995019116,22,10048130683,53111567
1635241659,-184218,true,9998017921,22,10048130683,50112762
1635241758,-184216,true,10000017625,22,10053155753,53138128
1635241965,-184213,true,10003017930,22,10062207213,59189283
1635241992,-184208,true,10008020440,22,10063213434,55192994
1635242179,-184205,true,10011023146,22,10072273950,61250804
1635242205,-184204,true,10012024248,22,10073281177,61256929
1635242229,-184201,true,10015028156,22,10074288505,59260349
1635242324,-184196,true,10020036672,22,10079326657,59289985
1635242337,-184194,true,10022040779,22,10078318825,56278046
1635242618,-184194,true,10022040779,22,10069252872,47212093
1635242883,-184191,true,10025047692,22,10054161069,29113377
1635242899,-184187,true,10029058313,22,10053155753,24097440
1635243289,-184183,true,10033070538,22,10074288505,41217967
1635243512,-184183,true,10033070538,22,10098494623,65424085
1635243635,-184179,true,10037084368,22,10112641709,75557341
1635243641,-184177,true,10039091885,22,10114664338,75572453
1635243653,-184174,true,10042103914,22,10117699041,75595127
1635243704,-184172,true,10044112435,22,10129846960,85734525
1635243990,-184166,true,10050140410,22,10179602524,129462114
1635244015,-184166,true,10050140410,22,10182656710,132516300
1635244053,-184164,true,10052150538,22,10188767832,136617294
1635244170,-184162,true,10054161069,22,10205082092,150921023
1635244290,-184155,true,10061201093,22,10222444618,161243525
1635244370,-184155,true,10061201093,22,10235741772,174540679
1635244385,-184152,true,10064219755,22,10238812802,174593047
1635244431,-184151,true,10065226177,22,10247006720,181780543
1635244499,-184145,true,10071266823,22,10257258339,185991516
1635244510,-184145,true,10071266823,22,10259309893,188043070
1635244644,-184141,true,10075295934,22,10266493565,191197631
1635244722,-184140,true,10076303464,22,10268546966,192243502
1635244738,-184133,true,10083358993,22,10268546966,185187973
1635245002,-184133,true,10083358993,22,10278820135,195461142
1635245027,-184130,true,10086384303,22,10279848017,193463714
1635245218,-184129,true,10087392941,22,10276764679,189371738
1635245266,-184123,true,10093446890,22,10274709635,181262745
1635245307,-184122,true,10094456235,22,10273682266,179226031
1635245501,-184119,true,10097484875,22,10266493565,169008690
1635245511,-184117,true,10099504473,22,10266493565,166989092
1635245526,-184111,true,10105565690,22,10265467018,159901328
1635245795,-184110,true,10106576247,22,10273682266,167106019
1635245888,-184108,true,10108597663,22,10275737106,167139443
1635245968,-184105,true,10111630546,22,10278820135,167189589
1635246043,-184098,true,10118710811,22,10283960573,165249762
1635246110,-184097,true,10119722682,22,10289103582,169380900
1635246138,-184093,true,10123771178,22,10291161506,167390328
1635246157,-184091,true,10125796034,22,10293219841,167423807
1635246178,-184084,true,10132886218,22,10295278588,162392370
1635246243,-184081,true,10135926388,22,10305578500,169652112
1635246275,-184077,true,10139981367,22,10311763393,171782026
1635246295,-184074,true,10143023665,22,10314857232,171833567
1635246366,-184066,true,10151140925,22,10332406524,181265599
1635246452,-184059,true,10158248855,22,10366558077,208309222
1635246496,-184053,true,10164345329,22,10379004791,214659462
1635246502,-184048,true,10169428518,22,10382118804,212690286
1635246530,-184036,true,10181638546,22,10398742659,217104113
1635246577,-184025,true,10192843950,22,10425813212,232969262
1635246646,-184015,true,10203041382,22,10465504684,262463302
1635246706,-184010,true,10208143923,22,10499046260,290902337
1635246712,-183997,true,10221422476,22,10502196289,280773813
1635246764,-183986,true,10232671664,22,10531642171,298970507
1635246779,-183977,true,10241884753,22,10539016533,297131780
1635246872,-183972,true,10247006720,22,10588664008,341657288
1635246928,-183960,true,10259309893,22,10622600305,363290412
1635247042,-183951,true,10268546966,22,10681182632,412635666
1635247131,-183943,true,10276764679,22,10719702257,442937578
1635247211,-183938,true,10281904090,22,10756209446,474305356
1635247216,-183926,true,10294249163,22,10758360796,464111633
1635247287,-183917,true,10303517694,22,10780975960,477458266
1635247344,-183907,true,10313825849,22,10797158749,483332900
1635247478,-183897,true,10324144318,22,10846937594,522793276
1635247518,-183885,true,10336540107,22,10855618182,519078075
1635247528,-183873,true,10348950780,22,10857789414,508838634
1635247632,-183863,true,10359304389,22,10879525635,520221246
1635247633,-183857,true,10365521525,22,10879525635,514004110
1635247680,-183848,true,10374854227,22,10887143588,512289361
1635247686,-183836,true,10387310902,22,10887143588,499832686
1635247704,-183829,true,10394584201,22,10890410058,495825857
1635247720,-183822,true,10401862593,22,10893677508,491814915
1635247755,-183812,true,10412269138,22,10900215349,487946211
1635247835,-183801,true,10423728363,22,10913302804,489574441
1635247980,-183795,true,10429984163,22,10935150157,505165994
1635248001,-183788,true,10437287343,22,10938431030,501143687
1635248018,-183777,true,10448774101,22,10940618826,491844725
1635248035,-183765,true,10461319529,22,10943901339,482581810
1635248064,-183759,true,10467597890,22,10944995730,477397840
1635248132,-183746,true,10481213935,22,10971293950,490080015
1635248148,-183733,true,10494847691,22,10976780694,481933003
1635248207,-183719,true,10509550032,22,10999854999,490304967
1635248222,-183711,true,10517960615,22,11003155286,485194671
1635248340,-183701,true,10528483310,22,11005356027,476872717
1635248353,-183690,true,10540070434,22,11005356027,465285593
1635248405,-183677,true,10553780750,22,11007557208,453776458
1635248477,-183669,true,10562226731,22,11010859805,448633074
1635248497,-183659,true,10572793712,22,11011960891,439167179
1635248551,-183648,true,10584429601,22,11011960891,427531290
1635248682,-183638,true,10595018795,22,11013062087,418043292
1635248811,-183631,true,10602437534,22,11014163394,411725860
1635248825,-183619,true,10615167459,22,11016366337,401198878
1635248865,-183609,true,10625787404,22,11016366337,390578933
1635248889,-183601,true,10634291010,22,11002055080,367764070
1635248901,-183601,true,10634291010,22,10999854999,365563989
1635248927,-183593,true,10642801421,22,10994356721,351555300
1635249011,-183586,true,10650253617,22,10963617115,313363498
1635249014,-183576,true,10660908665,22,10961424720,300516055
1635249018,-183576,true,10660908665,22,10960328688,299420023
1635249031,-183569,true,10668373540,22,10953754791,285381251
1635249035,-183565,true,10672641530,22,10951564369,278922839
1635249077,-183554,true,10684387307,22,10934056751,249669444
1635249092,-183554,true,10684387307,22,10926405972,242018665
1635249130,-183548,true,10690799542,22,10910029467,219229925
1635249146,-183543,true,10696146011,22,10907847789,211701778
1635249157,-183531,true,10708988448,22,10905666546,196678098
1635249174,-183531,true,10708988448,22,10901305370,192316922
1635249189,-183524,true,10716486989,22,10894766876,178279887
1635249267,-183522,true,10718630394,22,10866478687,147848293
1635249280,-183511,true,10730426784,22,10862133182,131706398
1635249381,-183509,true,10732572977,22,10838263948,105690971
1635249523,-183501,true,10741162041,22,10820937457,79775416
1635249547,-183497,true,10745459151,22,10818773594,73314443
1635249578,-183486,true,10757285067,22,10816610164,59325097
1635249617,-183484,true,10759436632,22,10813365829,53929197
1635249767,-183475,true,10769123999,22,10804719028,35595029
1635249778,-183471,true,10773432295,22,10811203481,37771186
1635249782,-183459,true,10786367527,22,10813365829,26998302
1635249822,-183457,true,10788524908,22,10824184063,35659155
1635249830,-183447,true,10799318289,22,10825266481,25948192
1635249867,-183442,true,10804719028,22,10835013119,30294091
1635249874,-183432,true,10815528611,22,10836096620,20568009
1635249878,-183431,true,10816610164,22,10837180230,20570066
1635249892,-183421,true,10827431643,22,10839347774,11916131
1635249922,-183418,true,10830680197,22,10845853009,15172812
1635249923,-183407,true,10842599904,22,10845853009,3253105
1635250018,-183405,true,10844768532,22,10863219395,18450863
1635250087,-183395,true,10855618182,22,10870825930,15207748
1635250094,-183392,true,10858875193,22,10873000204,14125011
1635250134,-183383,true,10868652091,22,10879525635,10873544
1635250151,-183382,true,10869738956,22,10882789819,13050863
1635250244,-183374,true,10878437792,22,10889321126,10883334
1635250269,-183372,true,10880613588,22,10890410058,9796470
1635250281,-183367,true,10886054983,22,10890410058,4355075
1635250290,-183368,true,10884966486,22,10890410058,5443572
1635250368,-183363,true,10890410058,22,10883878098,-6531960
1635250381,-183366,true,10887143588,22,10883878098,-3265490
1635250398,-183365,true,10888232303,22,10883878098,-4354205
1635250415,-183370,true,10882789819,22,10881701649,-1088170
1635250551,-183360,true,10893677508,22,10889321126,-4356382
1635250601,-183362,true,10891499099,22,10895856352,4357253
1635250612,-183360,true,10893677508,22,10898035632,4358124
1635250642,-183363,true,10890410058,22,10906757113,16347055
1635250676,-183348,true,10906757113,22,10917668779,10911666
1635250677,-183348,true,10906757113,22,10917668779,10911666
1635250721,-183344,true,10911120470,22,10932963455,21842985
1635250733,-183345,true,10910029467,22,10937337296,27307829
1635250784,-183330,true,10926405972,22,10954850167,28444195
1635250839,-183330,true,10926405972,22,10973488318,47082346
1635250868,-183326,true,10930777190,22,10983368409,52591219
1635250911,-183329,true,10927498613,22,10997655358,70156745
1635250938,-183319,true,10938431030,22,11008657964,70226934
1635250988,-183318,true,10939524873,22,11029593249,90068376
1635251011,-183317,true,10940618826,22,11038420013,97801187
1635251035,-183320,true,10937337296,22,11047253840,109916544
1635251048,-183309,true,10949374385,22,11051673405,102299020
1635251096,-183306,true,10952659525,22,11074905142,122245617
1635251211,-183301,true,10958136951,22,11141550978,183414027
1635251315,-183302,true,10957041246,22,11207477124,250435878
1635251323,-183291,true,10969100020,22,11211960787,242860767
1635251475,-183290,true,10970196930,22,11278303557,308106627
1635251506,-183286,true,10974585667,22,11289586937,315001270
1635251561,-183286,true,10974585667,22,11300881606,326295939
1635251586,-183274,true,10987762415,22,11309925476,322163061
1635251682,-183271,true,10991059074,22,11330300655,339241581
1635251726,-183266,true,10996555703,22,11340502006,343946303
1635251760,-183263,true,10999854999,22,11354118096,354263097
1635251797,-183256,true,11007557208,22,11370024197,362466989
1635251807,-183252,true,11011960891,22,11373435546,361474655
1635251855,-183249,true,11015264810,22,11382537479,367272669
1635251893,-183249,true,11015264810,22,11389368709,374103899
1635251923,-183241,true,11024080107,22,11397343660,373263553
1635251931,-183237,true,11028490400,22,11399623242,371132842
1635251935,-183233,true,11032902458,22,11400763205,367860747
1635251951,-183232,true,11034005748,22,11405324194,371318446
1635251966,-183224,true,11042836043,22,11408746133,365910090
1635251999,-183219,true,11048358566,22,11413310317,364951751
1635252077,-183213,true,11054989238,22,11422444161,367454923
1635252093,-183210,true,11058306067,22,11427013824,368707757
1635252159,-183200,true,11069369350,22,11444166348,374796998
1635252240,-183194,true,11076012633,22,11465929845,389917212
1635252286,-183184,true,11087093631,22,11477400936,390307305
1635252298,-183176,true,11095966411,22,11477400936,381434525
1635252313,-183166,true,11107067372,22,11478548676,371481304
1635252336,-183162,true,11111510865,22,11477400936,365890071
1635252337,-183158,true,11115956136,22,11477400936,361444800
1635252366,-183154,true,11120403186,22,11472811123,352407937
1635252376,-183145,true,11130415553,22,11470516905,340101352
1635252422,-183143,true,11132641747,22,11463637003,330995256
1635252472,-183139,true,11137095472,22,11457906904,320811432
1635252500,-183134,true,11142665133,22,11451034565,308369432
1635252522,-183126,true,11151582386,22,11441877858,290295472
1635252551,-183125,true,11152697544,22,11436158635,283461091
1635252583,-183122,true,11156043688,22,11429299341,273255653
1635252598,-183118,true,11160506775,22,11425871237,265364462
1635252627,-183109,true,11170555250,22,11419018113,248462863
1635252657,-183106,true,11173906752,22,11408746133,234839381
1635252761,-183102,true,11178376985,22,11376847918,198470933
1635252799,-183100,true,11180612772,22,11367750534,187137762
1635252957,-183092,true,11189560393,22,11326902245,137341852
1635252960,-183089,true,11192917597,22,11325769668,132852071
1635252988,-183086,true,11196275808,22,11318976584,122700776
1635253087,-183083,true,11199635027,22,11285072231,85437204
1635253092,-183074,true,11209718731,22,11283943837,74225106
1635253104,-183072,true,11211960787,22,11279431388,67470601
1635253198,-183069,true,11215324712,22,11251269434,35944722
1635253278,-183069,true,11215324712,22,11243396695,28071983
1635253295,-183062,true,11223177795,22,11243396695,20218900
1635253301,-183060,true,11225422542,22,11243396695,17974153
1635253346,-183058,true,11227667739,22,11242272468,14604729
1635253397,-183058,true,11227667739,22,11235529465,7861726
1635253422,-183050,true,11236653018,22,11240024351,3371333
1635253456,-183047,true,11240024351,22,11240024351,0
1635253510,-183045,true,11242272468,22,11242272468,0
1635253533,-183044,true,11243396695,22,11243396695,0
1635253625,-183035,true,11253519801,22,11247894728,-5625073
1635253782,-183032,true,11256896194,22,11250144420,-6751774
1635253831,-183030,true,11259147686,22,11251269434,-7878252
1635253895,-183031,true,11258021884,22,11237776683,-20245201
1635253907,-183022,true,11268158157,22,11237776683,-30381474
1635253934,-183020,true,11270411902,22,11236653018,-33758884
1635254003,-183018,true,11272666097,22,11232159480,-40506617
1635254076,-183016,true,11274920743,22,11226545085,-48375658
1635254124,-183005,true,11287329359,22,11226545085,-60784274
1635254147,-183004,true,11288458092,22,11225422542,-63035550
1635254156,-183002,true,11290715896,22,11225422542,-65293354
1635254172,-183001,true,11291844968,22,11224300112,-67544856
1635254181,-182995,true,11298621769,22,11224300112,-74321657
1635254250,-182989,true,11305402637,22,11237776683,-67625954
1635254276,-182988,true,11306533177,22,11240024351,-66508826
1635254284,-182988,true,11306533177,22,11241148353,-65384824
1635254301,-182986,true,11308794597,22,11242272468,-66522129
1635254345,-182981,true,11314450125,22,11251269434,-63180691
1635254453,-182985,true,11309925476,22,11244521035,-65404441
1635254521,-182986,true,11308794597,22,11233282696,-75511901
1635254594,-182986,true,11308794597,22,11227667739,-81126858
1635254617,-182983,true,11312187574,22,11226545085,-85642489
1635254627,-182986,true,11308794597,22,11225422542,-83372055
1635254634,-182987,true,11307663830,22,11225422542,-82241288
1635254685,-182988,true,11306533177,22,11218689645,-87843532
1635254734,-182986,true,11308794597,22,11213081983,-95712614
1635254751,-182990,true,11304272210,22,11214203291,-90068919
1635254772,-182993,true,11300881606,22,11211960787,-88920819
1635254807,-182994,true,11299751631,22,11210839703,-88911928
1635254810,-182994,true,11299751631,22,11210839703,-88911928
1635254880,-182995,true,11298621769,22,11217567889,-81053880
1635254922,-182999,true,11294103450,22,11211960787,-82142663
1635254948,-183000,true,11292974152,22,11207477124,-85497028
1635255024,-183003,true,11289586937,22,11190679349,-98907588
1635255054,-183007,true,11285072231,22,11188441549,-96630682
1635255184,-183009,true,11282815555,22,11163855262,-118960293
1635255189,-183011,true,11280559331,22,11162738988,-117820343
1635255192,-183014,true,11277175840,22,11161622826,-115553014
1635255265,-183020,true,11270411902,22,11137095472,-133316430
1635255366,-183025,true,11264778386,22,11122627377,-142151009
1635255400,-183028,true,11261399628,22,11120403186,-140996442
1635255403,-183033,true,11255770617,22,11120403186,-135367431
1635255453,-183038,true,11250144420,22,11117067732,-133076688
1635255513,-183040,true,11247894728,22,11117067732,-130826996
1635255540,-183041,true,11246770051,22,11114844652,-131925399
1635255595,-183047,true,11240024351,22,11108178078,-131846273
1635255615,-183053,true,11233282696,22,11105956776,-127325920
1635255620,-183057,true,11228790506,22,11104846291,-123944215
1635255672,-183058,true,11227667739,22,11107067372,-120600367
1635255699,-183062,true,11223177795,22,11107067372,-116110423
1635255722,-183067,true,11217567889,22,11104846291,-112721598
1635255741,-183072,true,11211960787,22,11101515504,-110445283
1635255786,-183074,true,11209718731,22,11093747550,-115971181
1635255806,-183079,true,11204115553,22,11092638286,-111477267
1635255833,-183085,true,11197395436,22,11097076007,-100319429
1635255844,-183088,true,11194036889,22,11099295533,-94741356
1635255997,-183088,true,11194036889,22,11127077096,-66959793
1635256013,-183088,true,11194036889,22,11125964499,-68072390
1635256029,-183090,true,11191798417,22,11125964499,-65833918
1635256053,-183091,true,11190679349,22,11124852014,-65827335
1635256057,-183093,true,11188441549,22,11125964499,-62477050
1635256120,-183090,true,11191798417,22,11134868387,-56930030
1635256171,-183090,true,11191798417,22,11149352404,-42446013
1635256221,-183093,true,11188441549,22,11149352404,-39089145
1635256328,-183092,true,11189560393,22,11170555250,-19005143
1635256421,-183089,true,11192917597,22,11180612772,-12304825
1635256462,-183089,true,11192917597,22,11189560393,-3357204
1635256484,-183090,true,11191798417,22,11192917597,1119180
1635256638,-183093,true,11188441549,22,11204115553,15674004
1635256665,-183090,true,11191798417,22,11205235964,13437547
1635256697,-183091,true,11190679349,22,11208597871,17918522
1635256734,-183093,true,11188441549,22,11207477124,19035575
1635256739,-183095,true,11186204196,22,11207477124,21272928
1635256777,-183092,true,11189560393,22,11208597871,19037478
1635256785,-183094,true,11187322817,22,11206356488,19033671
1635256806,-183095,true,11186204196,22,11208597871,22393675
1635256859,-183099,true,11181730833,22,11207477124,25746291
1635256870,-183096,true,11185085688,22,11206356488,21270800
1635256883,-183096,true,11185085688,22,11206356488,21270800
1635256922,-183095,true,11186204196,22,11210839703,24635507
1635257014,-183099,true,11181730833,22,11218689645,36958812
1635257084,-183096,true,11185085688,22,11217567889,32482201
1635257125,-183094,true,11187322817,22,11224300112,36977295
1635257263,-183096,true,11185085688,22,11195156293,10070605
1635257273,-183100,true,11180612772,22,11192917597,12304825
1635257305,-183099,true,11181730833,22,11186204196,4473363
1635257362,-183100,true,11180612772,22,11173906752,-6706020
1635257430,-183102,true,11178376985,22,11170555250,-7821735
1635257476,-183108,true,11171672305,22,11160506775,-11165530
1635257542,-183108,true,11171672305,22,11147122868,-24549437
1635257652,-183108,true,11171672305,22,11139323002,-32349303
1635257725,-183109,true,11170555250,22,11129302622,-41252628
1635257776,-183114,true,11164971647,22,11123739640,-41232007
1635257789,-183112,true,11167204753,22,11120403186,-46801567
1635257853,-183114,true,11164971647,22,11098185715,-66785932
1635257874,-183119,true,11159390836,22,11090420091,-68970745
1635257913,-183126,true,11151582386,22,11078227946,-73354440
1635257990,-183123,true,11154928195,22,11052778572,-102149623
1635258010,-183125,true,11152697544,22,11046149225,-106548319
1635258060,-183128,true,11149352404,22,11034005748,-115346656
1635258086,-183134,true,11142665133,22,11031799278,-110865855
1635258096,-183137,true,11139323002,22,11031799278,-107523724
1635258104,-183139,true,11137095472,22,11030696209,-106399263
1635258122,-183143,true,11132641747,22,11026285033,-106356714
1635258261,-183151,true,11123739640,22,10996555703,-127183937
1635258286,-183154,true,11120403186,22,10992158180,-128245006
1635258323,-183153,true,11121515226,22,10988861192,-132654034
1635258332,-183155,true,11119291256,22,10986663749,-132627507
1635258353,-183162,true,11111510865,22,10982270182,-129240683
1635258390,-183165,true,11108178078,22,10978976160,-129201918
1635258411,-183166,true,11107067372,22,10974585667,-132481705
1635258613,-183167,true,11105956776,22,10938431030,-167525746
1635258647,-183173,true,11099295533,22,10926405972,-172889561
1635258783,-183175,true,11097076007,22,10924221019,-172854988
1635258896,-183174,true,11098185715,22,10942807059,-155378656
1635258904,-183173,true,11099295533,22,10943901339,-155394194
1635259028,-183178,true,11093747550,22,10955945652,-137801898
1635259076,-183177,true,11094856925,22,10962520863,-132336062
1635259113,-183182,true,11089311160,22,10968003220,-121307940
1635259149,-183181,true,11090420091,22,10974585667,-115834424
1635259164,-183185,true,11085985032,22,10975683126,-110301906
1635259219,-183182,true,11089311160,22,10973488318,-115822842
1635259239,-183184,true,11087093631,22,10976780694,-110312937
1635259253,-183185,true,11085985032,22,10980074057,-105910975
1635259274,-183188,true,11082659902,22,10982270182,-100389720
1635259308,-183185,true,11085985032,22,10988861192,-97123840
1635259335,-183185,true,11085985032,22,10992158180,-93826852
1635259429,-183184,true,11087093631,22,11007557208,-79536423
1635259470,-183188,true,11082659902,22,11016366337,-66293565
1635259530,-183183,true,11088202340,22,11035109149,-53093191
1635259550,-183184,true,11087093631,22,11040627807,-46465824
1635259597,-183186,true,11084876545,22,11042836043,-42040502
1635259663,-183192,true,11078227946,22,11043940327,-34287619
1635259680,-183189,true,11081551747,22,11046149225,-35402522
1635259741,-183188,true,11082659902,22,11048358566,-34301336
1635259811,-183186,true,11084876545,22,11052778572,-32097973
1635259882,-183190,true,11080443702,22,11060517838,-19925864
1635259901,-183189,true,11081551747,22,11059411897,-22139850
1635259953,-183194,true,11076012633,22,11037316281,-38696352
1635259969,-183195,true,11074905142,22,11036212660,-38692482
1635260105,-183199,true,11070476287,22,11041731870,-28744417
1635260153,-183196,true,11073797762,22,11043940327,-29857435
1635260193,-183198,true,11071583335,22,11045044721,-26538614
1635260226,-183199,true,11070476287,22,11045044721,-25431566
1635260324,-183205,true,11063836326,22,11046149225,-17687101
1635260379,-183202,true,11067155808,22,11040627807,-26528001
1635260385,-183203,true,11066049204,22,11040627807,-25421397
1635260395,-183203,true,11066049204,22,11039523855,-26525349
1635260410,-183206,true,11062730053,22,11038420013,-24310040
1635260452,-183203,true,11066049204,22,11038420013,-27629191
1635260473,-183207,true,11061623890,22,11041731870,-19892020
1635260723,-183206,true,11062730053,22,11056094737,-6635316
1635260737,-183210,true,11058306067,22,11052778572,-5527495
1635260764,-183209,true,11059411897,22,11047253840,-12158057
1635260771,-183214,true,11053883850,22,11045044721,-8839129
1635260867,-183216,true,11051673405,22,11073797762,22124357
1635260905,-183217,true,11050568348,22,11074905142,24336794
1635260906,-183215,true,11052778572,22,11074905142,22126570
1635260948,-183217,true,11050568348,22,11080443702,29875354
1635261043,-183220,true,11047253840,22,11083768168,36514328
1635261069,-183221,true,11046149225,22,11084876545,38727320
1635261146,-183219,true,11048358566,22,11088202340,39843774
1635261251,-183221,true,11046149225,22,11094856925,48707700
1635261295,-183224,true,11042836043,22,11098185715,55349672
1635261317,-183225,true,11041731870,22,11099295533,57563663
1635261338,-183222,true,11045044721,22,11101515504,56470783
1635261391,-183224,true,11042836043,22,11103735918,60899875
1635261432,-183226,true,11040627807,22,11104846291,64218484
1635261459,-183228,true,11038420013,22,11104846291,66426278
1635261494,-183226,true,11040627807,22,11102625655,61997848
1635261568,-183230,true,11036212660,22,11098185715,61973055
1635261585,-183230,true,11036212660,22,11098185715,61973055
1635261595,-183231,true,11035109149,22,11098185715,63076566
1635261678,-183224,true,11042836043,22,11119291256,76455213
1635261720,-183223,true,11043940327,22,11129302622,85362295
1635261728,-183224,true,11042836043,22,11130415553,87579510
1635261767,-183223,true,11043940327,22,11140436935,96496608
1635261770,-183215,true,11052778572,22,11141550978,88772406
1635261793,-183214,true,11053883850,22,11149352404,95468554
1635261902,-183213,true,11054989238,22,11177259259,122270021
1635261958,-183213,true,11054989238,22,11192917597,137928359
1635261963,-183205,true,11063836326,22,11195156293,131319967
1635262024,-183201,true,11068262524,22,11213081983,144819459
1635262034,-183198,true,11071583335,22,11215324712,143741377
1635262054,-183196,true,11073797762,22,11218689645,144891883
1635262111,-183192,true,11078227946,22,11217567889,139339943
1635262156,-183189,true,11081551747,22,11227667739,146115992
1635262188,-183185,true,11085985032,22,11235529465,149544433
1635262202,-183183,true,11088202340,22,11237776683,149574343
1635262214,-183176,true,11095966411,22,11240024351,144057940
1635262226,-183173,true,11099295533,22,11242272468,142976935
1635262256,-183172,true,11100405463,22,11245645487,145240024
1635262337,-183168,true,11104846291,22,11255770617,150924326
1635262376,-183161,true,11112622016,22,11263652021,151030005
1635262440,-183159,true,11114844652,22,11281687387,166842735
1635262458,-183157,true,11117067732,22,11287329359,170261627
1635262477,-183154,true,11120403186,22,11291844968,171441782
1635262493,-183146,true,11129302622,22,11295232860,165930238
1635262542,-183140,true,11135981874,22,11302011694,166029820
1635262588,-183139,true,11137095472,22,11311056469,173960997
1635262594,-183134,true,11142665133,22,11312187574,169522441
1635262604,-183127,true,11150467339,22,11311056469,160589130
1635262643,-183125,true,11152697544,22,11308794597,156097053
1635262667,-183128,true,11149352404,22,11307663830,158311426
1635262794,-183124,true,11153812814,22,11298621769,144808955
1635262822,-183118,true,11160506775,22,11296362383,135855608
1635262887,-183116,true,11162738988,22,11282815555,120076567
1635263078,-183119,true,11159390836,22,11273793363,114402527
1635263092,-183116,true,11162738988,22,11273793363,111054375
1635263187,-183110,true,11169438306,22,11259147686,89709380
1635263248,-183107,true,11172789473,22,11259147686,86358213
1635263285,-183110,true,11169438306,22,11259147686,89709380
1635263300,-183107,true,11172789473,22,11259147686,86358213
1635263328,-183099,true,11181730833,22,11262525768,80794935
1635263403,-183093,true,11188441549,22,11273793363,85351814
1635263440,-183096,true,11185085688,22,11273793363,88707675
1635263464,-183093,true,11188441549,22,11273793363,85351814
1635263562,-183090,true,11191798417,22,11264778386,72979969
1635263609,-183087,true,11195156293,22,11261399628,66243335
1635263653,-183090,true,11191798417,22,11256896194,65097777
1635263795,-183086,true,11196275808,22,11260273601,63997793
1635263837,-183080,true,11202995253,22,11261399628,58404375
1635263939,-183078,true,11205235964,22,11265904864,60668900
1635263968,-183083,true,11199635027,22,11261399628,61764601
1635263984,-183082,true,11200754990,22,11258021884,57266894
1635264076,-183075,true,11208597871,22,11269284973,60687102
1635264169,-183067,true,11217567889,22,11274920743,57352854
1635264193,-183069,true,11215324712,22,11273793363,58468651
1635264270,-183067,true,11217567889,22,11265904864,48336975
1635264335,-183061,true,11224300112,22,11255770617,31470505
1635264384,-183057,true,11228790506,22,11254645153,25854647
1635264389,-183059,true,11226545085,22,11254645153,28100068
1635264446,-183059,true,11226545085,22,11259147686,32602601
1635264487,-183052,true,11234406024,22,11262525768,28119744
1635264673,-183048,true,11238900461,22,11277175840,38275379
1635264705,-183050,true,11236653018,22,11278303557,41650539
1635264764,-183049,true,11237776683,22,11280559331,42782648
1635264789,-183044,true,11243396695,22,11288458092,45061397
1635264824,-183039,true,11249019518,22,11289586937,40567419
1635264897,-183041,true,11246770051,22,11303141895,56371844
1635265078,-183040,true,11247894728,22,11311056469,63161741
1635265403,-183034,true,11254645153,22,11326902245,72257092
1635265433,-183028,true,11261399628,22,11329167739,67768111
1635265576,-183029,true,11260273601,22,11331433686,71160085
1635265649,-183028,true,11261399628,22,11329167739,67768111
1635265665,-183024,true,11265904864,22,11328034935,62130071
1635265710,-183021,true,11269284973,22,11318976584,49691611
1635265766,-183022,true,11268158157,22,11314450125,46291968
1635265822,-183021,true,11269284973,22,11314450125,45165152
1635265932,-183017,true,11273793363,22,11309925476,36132113
1635265958,-183013,true,11278303557,22,11308794597,30491040
1635265975,-183015,true,11276048235,22,11305402637,29354402
1635266013,-183015,true,11276048235,22,11305402637,29354402
1635266030,-183010,true,11281687387,22,11306533177,24845790
1635266044,-183008,true,11283943837,22,11303141895,19198058
1635266077,-183009,true,11282815555,22,11303141895,20326340
1635266156,-183009,true,11282815555,22,11299751631,16936076
1635266202,-183004,true,11288458092,22,11297492020,9033928
1635266208,-182999,true,11294103450,22,11297492020,3388570
1635266230,-183000,true,11292974152,22,11296362383,3388231
1635266256,-182999,true,11294103450,22,11295232860,1129410
1635266284,-182998,true,11295232860,22,11292974152,-2258708
1635266310,-182998,true,11295232860,22,11290715896,-4516964
1635266348,-182999,true,11294103450,22,11287329359,-6774091
1635266361,-182999,true,11294103450,22,11287329359,-6774091
1635266410,-182999,true,11294103450,22,11287329359,-6774091
1635266469,-182998,true,11295232860,22,11287329359,-7903501
1635266475,-183000,true,11292974152,22,11287329359,-5644793
1635266549,-183001,true,11291844968,22,11290715896,-1129072
1635266569,-182999,true,11294103450,22,11294103450,0
1635266618,-182998,true,11295232860,22,11303141895,7909035
1635266702,-182999,true,11294103450,22,11316713128,22609678
1635266727,-182997,true,11296362383,22,11318976584,22614201
1635266735,-182993,true,11300881606,22,11318976584,18094978
1635266806,-182992,true,11302011694,22,11320108482,18096788
1635266874,-182996,true,11297492020,22,11322372617,24880597
1635266897,-182996,true,11297492020,22,11321240493,23748473
1635267017,-182995,true,11298621769,22,11320108482,21486713
1635267038,-182994,true,11299751631,22,11321240493,21488862
1635267092,-182996,true,11297492020,22,11322372617,24880597
1635267150,-182993,true,11300881606,22,11329167739,28286133
1635267172,-182991,true,11303141895,22,11333700086,30558191
1635267306,-182988,true,11306533177,22,11360932270,54399093
1635267596,-182989,true,11305402637,22,11387091177,81688540
1635267651,-182988,true,11306533177,22,11387091177,80558000
1635267747,-182985,true,11309925476,22,11400763205,90837729
1635267799,-182985,true,11309925476,22,11390507646,80582170
1635267819,-182990,true,11304272210,22,11392785862,88513652
1635267842,-182990,true,11304272210,22,11395064533,90792323
1635267902,-182990,true,11304272210,22,11393925140,89652930
1635267923,-182985,true,11309925476,22,11395064533,85139057
1635268051,-182987,true,11307663830,22,11397343660,89679830
1635268127,-182986,true,11308794597,22,11393925140,85130543
1635268194,-182987,true,11307663830,22,11379123401,71459571
1635268258,-182981,true,11314450125,22,11367750534,53300409
1635268280,-182983,true,11312187574,22,11364340890,52153316
1635268311,-182983,true,11312187574,22,11359796290,47608716
1635268395,-182983,true,11312187574,22,11346173391,33985817
1635268443,-182977,true,11318976584,22,11338234246,19257662
1635268459,-182980,true,11315581570,22,11334833456,19251886
1635268586,-182981,true,11314450125,22,11315581570,1131445
1635268728,-182984,true,11311056469,22,11314450125,3393656
1635268733,-182982,true,11313318793,22,11314450125,1131332
1635268905,-182984,true,11311056469,22,11308794597,-2261872
1635268935,-182985,true,11309925476,22,11306533177,-3392299
1635269050,-182984,true,11311056469,22,11297492020,-13564449
1635269181,-182980,true,11315581570,22,11298621769,-16959801
1635269283,-182981,true,11314450125,22,11302011694,-12438431
1635269347,-182981,true,11314450125,22,11304272210,-10177915
1635269396,-182981,true,11314450125,22,11308794597,-5655528
1635269441,-182976,true,11320108482,22,11317844800,-2263682
1635269494,-182975,true,11321240493,22,11328034935,6794442
1635269613,-182973,true,11323504854,22,11345038887,21534033
1635269698,-182973,true,11323504854,22,11357524672,34019818
1635269706,-182968,true,11329167739,22,11358660424,29492685
1635269718,-182969,true,11328034935,22,11358660424,30625489
1635269757,-182971,true,11325769668,22,11351847613,26077945
1635269793,-182974,true,11322372617,22,11351847613,29474996
1635269911,-182969,true,11328034935,22,11349577584,21542649
1635270063,-182969,true,11328034935,22,11350712541,22677606
1635270192,-182970,true,11326902245,22,11348442739,21540494
1635270322,-182974,true,11322372617,22,11340502006,18129389
1635270340,-182968,true,11329167739,22,11338234246,9066507
1635270472,-182968,true,11329167739,22,11318976584,-10191155
1635270549,-182969,true,11328034935,22,11313318793,-14716142
1635270934,-182972,true,11324637204,22,11335966939,11329735
1635271049,-182968,true,11329167739,22,11337100536,7932797
1635271222,-182968,true,11329167739,22,11349577584,20409845
1635271260,-182969,true,11328034935,22,11350712541,22677606
1635271357,-182971,true,11325769668,22,11357524672,31755004
1635271477,-182967,true,11330300655,22,11358660424,28359769
1635271485,-182966,true,11331433686,22,11358660424,27226738
1635271592,-182967,true,11330300655,22,11358660424,28359769
1635271593,-182969,true,11328034935,22,11358660424,30625489
1635271639,-182964,true,11333700086,22,11359796290,26096204
1635271738,-182962,true,11335966939,22,11363204570,27237631
1635271764,-182964,true,11333700086,22,11356389033,22688947
1635271796,-182967,true,11330300655,22,11351847613,21546958
1635271815,-182963,true,11334833456,22,11350712541,15879085
1635271824,-182964,true,11333700086,22,11349577584,15877498
1635271886,-182964,true,11333700086,22,11350712541,17012455
1635272013,-182960,true,11338234246,22,11384814101,46579855
1635272157,-182953,true,11346173391,22,11412169100,65995709
1635272357,-182957,true,11341636056,22,11440733785,99097729
1635272392,-182954,true,11345038887,22,11446455296,101416409
1635272461,-182951,true,11348442739,22,11460198600,111755861
1635272564,-182945,true,11355253507,22,11478548676,123295169
1635272661,-182948,true,11351847613,22,11496928135,145080522
1635272690,-182945,true,11355253507,22,11506128897,150875390
1635272716,-182942,true,11358660424,22,11511883112,153222688
1635272848,-182937,true,11364340890,22,11507279510,142938620
1635272909,-182939,true,11362068363,22,11511883112,149814749
1635273026,-182937,true,11364340890,22,11498077828,133736938
1635273231,-182935,true,11366613872,22,11483140784,116526912
1635273359,-182931,true,11371161200,22,11473958404,102797204
1635273409,-182933,true,11368887309,22,11467076438,98189129
1635273479,-182933,true,11368887309,22,11448744702,79857393
1635273589,-182932,true,11370024197,22,11435015134,64990937
1635273682,-182929,true,11373435546,22,11438445982,65010436
1635273787,-182931,true,11371161200,22,11451034565,79873365
1635273850,-182929,true,11373435546,22,11456761228,83325682
1635273941,-182927,true,11375710347,22,11460198600,84488253
1635273972,-182921,true,11382537479,22,11464783367,82245888
1635274036,-182921,true,11382537479,22,11476253311,93715832
1635274142,-182919,true,11384814101,22,11492330513,107516412
1635274195,-182915,true,11389368709,22,11502677749,113309040
1635274203,-182910,true,11395064533,22,11503828016,108763483
1635274211,-182910,true,11395064533,22,11506128897,111064364
1635274247,-182907,true,11398483394,22,11515337022,116853628
1635274290,-182905,true,11400763205,22,11522247952,121484747
1635274401,-182902,true,11404183776,22,11554553838,150370062
1635274417,-182903,true,11403043471,22,11558020551,154977080
1635274453,-182901,true,11405324194,22,11567270205,161946011
1635274517,-182897,true,11409887008,22,11589267809,179380801
1635274562,-182890,true,11417876325,22,11605503335,187627010
1635274571,-182888,true,11420160015,22,11608985334,188825319
1635274621,-182884,true,11424728764,22,11619437601,194708837
1635274715,-182876,true,11433871747,22,11639206455,205334708
1635274789,-182872,true,11438445982,22,11660174844,221728862
1635274843,-182871,true,11439589826,22,11675342170,235752344
1635274852,-182868,true,11443022046,22,11674174752,231152706
1635274882,-182862,true,11449889576,22,11675342170,225452594
1635274918,-182860,true,11452179669,22,11674174752,221995083
1635275029,-182860,true,11452179669,22,11681181008,229001339
1635275106,-182854,true,11459052694,22,11687022767,227970073
1635275123,-182848,true,11465929845,22,11687022767,221092922
1635275168,-182846,true,11468223146,22,11690529225,222306079
1635275181,-182845,true,11469369968,22,11691698278,222328310
1635275222,-182839,true,11476253311,22,11691698278,215444967
1635275492,-182835,true,11480844501,22,11666006098,185161597
1635275540,-182834,true,11481992585,22,11653181187,171188602
1635275566,-182833,true,11483140784,22,11648521080,165380296
1635275847,-182828,true,11488883503,22,11615952466,127068963
1635275860,-182824,true,11493479746,22,11614790987,121311241
1635275868,-182822,true,11495778557,22,11613629624,117851067
1635275916,-182821,true,11496928135,22,11611307247,114379112
1635275995,-182818,true,11500377558,22,11602022380,101644822
1635276058,-182816,true,11502677749,22,11583474913,80797164
1635276105,-182816,true,11502677749,22,11576527260,73849511
1635276133,-182817,true,11501527596,22,11574212302,72684706
1635276137,-182816,true,11502677749,22,11574212302,71534553
1635276156,-182813,true,11506128897,22,11573054996,66926099
1635276172,-182812,true,11507279510,22,11571897807,64618297
1635276188,-182811,true,11508430238,22,11573054996,64624758
1635276232,-182806,true,11514185604,22,11574212302,60026698
1635276324,-182797,true,11524552517,22,11583474913,58922396
1635276354,-182796,true,11525704972,22,11584633261,58928289
1635276360,-182796,true,11525704972,22,11584633261,58928289
1635276386,-182792,true,11530315946,22,11581158566,50842620
1635276412,-182788,true,11534928764,22,11576527260,41598496
1635276481,-182788,true,11534928764,22,11574212302,39283538
1635276482,-182788,true,11534928764,22,11574212302,39283538
1635276519,-182784,true,11539543428,22,11569583774,30040346
1635276544,-182780,true,11544159938,22,11568426932,24266994
1635276594,-182780,true,11544159938,22,11566113593,21953655
1635276615,-182781,true,11543005637,22,11564957097,21951460
1635276655,-182777,true,11547623532,22,11562644453,15020921
1635276656,-182773,true,11552243274,22,11562644453,10401179
1635276660,-182773,true,11552243274,22,11561488304,9245030
1635276684,-182775,true,11549933172,22,11559176353,9243181
1635276703,-182771,true,11554553838,22,11556864865,2311027
1635276797,-182768,true,11558020551,22,11541851452,-16169099
1635276914,-182769,true,11556864865,22,11531468977,-25395888
1635276936,-182771,true,11554553838,22,11531468977,-23084861
1635276941,-182767,true,11559176353,22,11532622124,-26554229
1635276953,-182763,true,11563800717,22,11533775387,-30025330
1635276955,-182763,true,11563800717,22,11533775387,-30025330
1635276960,-182761,true,11566113593,22,11533775387,-32338206
1635276975,-182760,true,11567270205,22,11532622124,-34648081
1635276998,-182763,true,11563800717,22,11532622124,-31178593
1635277049,-182763,true,11563800717,22,11532622124,-31178593
1635277097,-182759,true,11568426932,22,11536082257,-32344675
1635277211,-182756,true,11571897807,22,11537235865,-34661942
1635277227,-182758,true,11569583774,22,11536082257,-33501517
1635277248,-182758,true,11569583774,22,11534928764,-34655010
1635277288,-182754,true,11574212302,22,11536082257,-38130045
1635277395,-182756,true,11571897807,22,11534928764,-36969043
1635277414,-182758,true,11569583774,22,11536082257,-33501517
1635277445,-182755,true,11573054996,22,11534928764,-38126232
1635277460,-182754,true,11574212302,22,11532622124,-41590178
1635277474,-182755,true,11573054996,22,11531468977,-41586019
1635277489,-182757,true,11570740733,22,11529163030,-41577703
1635277508,-182756,true,11571897807,22,11528010229,-43887578
1635277514,-182752,true,11576527260,22,11528010229,-48517031
1635277545,-182752,true,11576527260,22,11526857543,-49669717
1635277603,-182752,true,11576527260,22,11529163030,-47364230
1635277632,-182750,true,11578842681,22,11532622124,-46220557
1635277673,-182749,true,11580000566,22,11538389589,-41610977
1635277754,-182750,true,11578842681,22,11549933172,-28909509
1635277840,-182750,true,11578842681,22,11562644453,-16198228
1635277871,-182749,true,11580000566,22,11566113593,-13886973
1635277953,-182748,true,11581158566,22,11567270205,-13888361
1635277966,-182750,true,11578842681,22,11563800717,-15041964
1635278025,-182751,true,11577684913,22,11560332271,-17352642
1635278072,-182751,true,11577684913,22,11553398499,-24286414
1635278391,-182746,true,11583474913,22,11603182582,19707669
1635278412,-182750,true,11578842681,22,11602022380,23179699
1635278444,-182751,true,11577684913,22,11604342900,26657987
1635278474,-182749,true,11580000566,22,11602022380,22021814
1635278504,-182750,true,11578842681,22,11599702323,20859642
1635278553,-182750,true,11578842681,22,11607824551,28981870
1635278718,-182749,true,11580000566,22,11635715391,55714825
1635278764,-182750,true,11578842681,22,11642698566,63855885
1635278867,-182756,true,11571897807,22,11598542469,26644662
1635278894,-182760,true,11567270205,22,11584633261,17363056
1635279025,-182766,true,11560332271,22,11558020551,-2311720
1635279091,-182768,true,11558020551,22,11538389589,-19630962
1635279126,-182772,true,11553398499,22,11523400177,-29998322
1635279142,-182775,true,11549933172,22,11514185604,-35747568
1635279160,-182782,true,11541851452,22,11506128897,-35722555
1635279252,-182784,true,11539543428,22,11462490754,-77052674
1635279368,-182788,true,11534928764,22,11412169100,-122759664
1635279381,-182792,true,11530315946,22,11408746133,-121569813
1635279392,-182799,true,11522247952,22,11399623242,-122624710
1635279442,-182807,true,11513034301,22,11352982797,-160051504
1635279476,-182823,true,11494629094,22,11309925476,-184703618
1635279512,-182827,true,11490032392,22,11277175840,-212856552
1635279548,-182831,true,11485437527,22,11245645487,-239792040
1635279574,-182839,true,11476253311,22,11218689645,-257563666
1635279645,-182847,true,11467076438,22,11173906752,-293169686
1635279702,-182848,true,11465929845,22,11160506775,-305423070
1635279728,-182852,true,11461344620,22,11158275008,-303069612
1635279742,-182858,true,11454470219,22,11157159292,-297310927
1635279752,-182868,true,11443022046,22,11156043688,-286978358
1635279792,-182870,true,11440733785,22,11148237580,-292496205
1635279936,-182873,true,11437302251,22,11082659902,-354642349
1635280062,-182880,true,11429299341,22,11029593249,-399706092
1635280142,-182888,true,11420160015,22,11008657964,-411502051
1635280190,-182889,true,11419018113,22,10999854999,-419163114
1635280202,-182894,true,11413310317,22,10997655358,-415654959
1635280227,-182901,true,11405324194,22,10994356721,-410967473
1635280295,-182910,true,11395064533,22,10987762415,-407302118
1635280343,-182912,true,11392785862,22,10999854999,-392930863
1635280515,-182916,true,11388229886,22,11057200347,-331029539
1635280573,-182921,true,11382537479,22,11060517838,-322019641
1635280726,-182930,true,11372298316,22,11078227946,-294070370
1635280766,-182931,true,11371161200,22,11088202340,-282958860
1635280773,-182929,true,11373435546,22,11090420091,-283015455
1635280788,-182934,true,11367750534,22,11097076007,-270674527
1635280909,-182939,true,11362068363,22,11138209181,-223859182
1635280948,-182940,true,11360932270,22,11149352404,-211579866
1635280967,-182940,true,11360932270,22,11154928195,-206004075
1635280997,-182946,true,11354118096,22,11162738988,-191379108
1635281079,-182953,true,11346173391,22,11177259259,-168914132
1635281117,-182954,true,11345038887,22,11183967291,-161071596
1635281157,-182955,true,11343904497,22,11188441549,-155462948
1635281232,-182962,true,11335966939,22,11192917597,-143049342
1635281260,-182969,true,11328034935,22,11191798417,-136236518
1635281279,-182970,true,11326902245,22,11189560393,-137341852
1635281310,-182970,true,11326902245,22,11186204196,-140698049
1635281334,-182976,true,11320108482,22,11183967291,-136141191
1635281355,-182984,true,11311056469,22,11180612772,-130443697
1635281480,-182983,true,11312187574,22,11177259259,-134928315
1635281488,-182982,true,11313318793,22,11177259259,-136059534
1635281540,-182988,true,11306533177,22,11181730833,-124802344
1635281554,-182997,true,11296362383,22,11178376985,-117985398
1635281647,-182998,true,11295232860,22,11166088145,-129144715
1635281678,-182999,true,11294103450,22,11157159292,-136944158
1635281790,-183006,true,11286200739,22,11132641747,-153558992
1635281813,-183016,true,11274920743,22,11128189803,-146730940
1635281937,-183020,true,11270411902,22,11110399825,-160012077
1635281947,-183021,true,11269284973,22,11109288896,-159996077
1635282003,-183029,true,11260273601,22,11102625655,-157647946
1635282014,-183039,true,11249019518,22,11101515504,-147504014
1635282070,-183041,true,11246770051,22,11090420091,-156349960
1635282074,-183041,true,11246770051,22,11089311160,-157458891
1635282096,-183053,true,11233282696,22,11084876545,-148406151
1635282127,-183062,true,11223177795,22,11078227946,-144949849
1635282139,-183064,true,11220933496,22,11076012633,-144920863
1635282149,-183064,true,11220933496,22,11074905142,-146028354
1635282170,-183074,true,11209718731,22,11071583335,-138135396
1635282235,-183083,true,11199635027,22,11061623890,-138011137
1635282275,-183085,true,11197395436,22,11054989238,-142406198
1635282282,-183087,true,11195156293,22,11052778572,-142377721
1635282287,-183097,true,11183967291,22,11050568348,-133398943
1635282299,-183107,true,11172789473,22,11049463401,-123326072
1635282323,-183108,true,11171672305,22,11046149225,-125523080
1635282408,-183109,true,11170555250,22,11032902458,-137652792
1635282434,-183119,true,11159390836,22,11026285033,-133105803
1635282486,-183133,true,11143779400,22,11004255601,-139523799
1635282529,-183134,true,11142665133,22,10998755124,-143910009
1635282566,-183136,true,11140436935,22,11000954985,-139481950
1635282586,-183146,true,11129302622,22,11002055080,-127247542
1635282680,-183156,true,11118179438,22,11003155286,-115024152
1635282765,-183156,true,11118179438,22,11003155286,-115024152
1635282774,-183158,true,11115956136,22,11002055080,-113901056
1635282939,-183171,true,11101515504,22,10983368409,-118147095
1635282996,-183177,true,11094856925,22,10986663749,-108193176
1635283033,-183181,true,11090420091,22,10987762415,-102657676
1635283097,-183187,true,11083768168,22,10988861192,-94906976
1635283248,-183202,true,11067155808,22,10973488318,-93667490
1635283250,-183202,true,11067155808,22,10972391079,-94764729
1635283274,-183206,true,11062730053,22,10965809948,-96920105
1635283330,-183207,true,11061623890,22,10953754791,-107869099
1635283405,-183222,true,11045044721,22,10959232764,-85811957
1635283436,-183226,true,11040627807,22,10950469322,-90158485
1635283625,-183231,true,11035109149,22,10880613588,-154495561
1635283655,-183230,true,11036212660,22,10869738956,-166473704
1635283687,-183243,true,11021875621,22,10858875193,-163000428
1635283717,-183245,true,11019671577,22,10851277020,-168394557
1635283746,-183251,true,11013062087,22,10843684164,-169377923
1635283781,-183250,true,11014163394,22,10833929726,-180233668
1635283885,-183256,true,11007557208,22,10812284601,-195272607
1635283896,-183247,true,11017467973,22,10810122468,-207345505
1635283915,-183252,true,11011960891,22,10805799500,-206161391
1635283967,-183252,true,11011960891,22,10796079141,-215881750
1635283993,-183258,true,11005356027,22,10790682721,-214673306
1635283999,-183257,true,11006456562,22,10788524908,-217931654
1635284064,-183264,true,10998755124,22,10779897971,-218857153
1635284086,-183265,true,10997655358,22,10776664648,-220990710
1635284089,-183273,true,10988861192,22,10776664648,-212196544
1635284090,-183270,true,10992158180,22,10775587089,-216571091
1635284116,-183276,true,10985565193,22,10770200912,-215364281
1635284132,-183276,true,10985565193,22,10769123999,-216441194
1635284156,-183282,true,10978976160,22,10766970498,-212005662
1635284161,-183280,true,10981172065,22,10766970498,-214201567
1635284183,-183283,true,10977878372,22,10769123999,-208754373
1635284225,-183282,true,10978976160,22,10769123999,-209852161
1635284327,-183290,true,10970196930,22,10772355060,-197841870
1635284344,-183288,true,10972391079,22,10774509638,-197881441
1635284402,-183292,true,10968003220,22,10778820089,-189183131
1635284416,-183295,true,10964713477,22,10777742314,-186971163
1635284486,-183302,true,10957041246,22,10788524908,-168516338
1635284494,-183301,true,10958136951,22,10786367527,-171769424
1635284567,-183307,true,10951564369,22,10788524908,-163039461
1635284575,-183310,true,10948279557,22,10788524908,-159754649
1635284587,-183320,true,10937337296,22,10789603761,-147733535
1635284606,-183322,true,10935150157,22,10791761789,-143388368
1635284695,-183327,true,10929684222,22,10798238465,-131445757
1635284719,-183329,true,10927498613,22,10799318289,-128180324
1635284777,-183338,true,10917668779,22,10803638664,-114030115
1635284864,-183336,true,10919852422,22,10820937457,-98914965
1635284881,-183341,true,10914394134,22,10817691825,-96702309
1635284937,-183342,true,10913302804,22,10823101752,-90201052
1635285015,-183349,true,10905666546,22,10836096620,-69569926
1635285041,-183347,true,10907847789,22,10839347774,-68500015
1635285058,-183350,true,10904576089,22,10841515752,-63060337
1635285069,-183350,true,10904576089,22,10842599904,-61976185
1635285117,-183354,true,10900215349,22,10852362148,-47853201
1635285172,-183351,true,10903485740,22,10862133182,-41352558
1635285256,-183355,true,10899125436,22,10878437792,-20687644
1635285284,-183356,true,10898035632,22,10884966486,-13069146
1635285305,-183361,true,10892588249,22,10891499099,-1089150
1635285392,-183356,true,10898035632,22,10916577122,18541490
1635285472,-183356,true,10898035632,22,10944995730,46960098
1635285474,-183355,true,10899125436,22,10944995730,45870294
1635285495,-183360,true,10893677508,22,10947184838,53507330
1635285509,-183357,true,10896945938,22,10949374385,52428447
1635285655,-183361,true,10892588249,22,10974585667,81997418
1635285700,-183360,true,10893677508,22,10983368409,89690901
1635285717,-183364,true,10889321126,22,10986663749,97342623
1635285864,-183359,true,10894766876,22,11021875621,127108745
1635285870,-183359,true,10894766876,22,11022977809,128210933
1635285922,-183356,true,10898035632,22,11036212660,138177028
1635286047,-183357,true,10896945938,22,11053883850,156937912
1635286209,-183351,true,10903485740,22,11076012633,172526893
1635286297,-183350,true,10904576089,22,11080443702,175867613
1635286303,-183348,true,10906757113,22,11078227946,171470833
1635286318,-183349,true,10905666546,22,11077120234,171453688
1635286326,-183345,true,10910029467,22,11077120234,167090767
1635286430,-183344,true,10911120470,22,11091529133,180408663
1635286442,-183342,true,10913302804,22,11091529133,178226329
1635286465,-183343,true,10912211582,22,11094856925,182645343
1635286548,-183340,true,10915485573,22,11101515504,186029931
1635286629,-183342,true,10913302804,22,11100405463,187102659
1635286737,-183342,true,10913302804,22,11089311160,176008356
1635286753,-183344,true,10911120470,22,11087093631,175973161
1635286826,-183336,true,10919852422,22,11077120234,157267812
1635286856,-183339,true,10916577122,22,11073797762,157220640
1635286872,-183338,true,10917668779,22,11070476287,152807508
1635286897,-183340,true,10915485573,22,11067155808,151670235
1635286905,-183339,true,10916577122,22,11067155808,150578686
1635287001,-183343,true,10912211582,22,11053883850,141672268
1635287008,-183342,true,10913302804,22,11052778572,139475768
1635287033,-183341,true,10914394134,22,11048358566,133964432
1635287105,-183339,true,10916577122,22,11037316281,120739159
1635287114,-183341,true,10914394134,22,11036212660,121818526
1635287150,-183344,true,10911120470,22,11016366337,105245867
1635287200,-183342,true,10913302804,22,11004255601,90952797
1635287218,-183343,true,10912211582,22,10999854999,87643417
1635287292,-183342,true,10913302804,22,10989960078,76657274
1635287318,-183341,true,10914394134,22,10984466746,70072612
1635287367,-183337,true,10918760546,22,10977878372,59117826
1635287409,-183337,true,10918760546,22,10972391079,53630533
1635287551,-183332,true,10924221019,22,10980074057,55853038
1635287756,-183329,true,10927498613,22,10997655358,70156745
1635287779,-183324,true,10932963455,22,11000954985,67991530
1635287870,-183323,true,10934056751,22,11006456562,72399811
1635287898,-183319,true,10938431030,22,10997655358,59224328
1635287989,-183317,true,10940618826,22,11003155286,62536460
1635288005,-183313,true,10944995730,22,11002055080,57059350
1635288142,-183314,true,10943901339,22,11025182515,81281176
1635288171,-183309,true,10949374385,22,11026285033,76910648
1635288189,-183308,true,10950469322,22,11026285033,75815711
1635288254,-183305,true,10953754791,22,11025182515,71427724
1635288308,-183305,true,10953754791,22,11029593249,75838458
1635288359,-183302,true,10957041246,22,11015264810,58223564
1635288418,-183299,true,10960328688,22,11018569720,58241032
1635288453,-183294,true,10965809948,22,11019671577,53861629
1635288498,-183294,true,10965809948,22,11019671577,53861629
1635288529,-183287,true,10973488318,22,11020773544,47285226
1635288546,-183286,true,10974585667,22,11014163394,39577727
1635288590,-183283,true,10977878372,22,11010859805,32981433
1635288606,-183284,true,10976780694,22,11010859805,34079111
1635288727,-183278,true,10983368409,22,11009758830,26390421
1635288815,-183277,true,10984466746,22,11020773544,36306798
1635288915,-183274,true,10987762415,22,11025182515,37420100
1635288937,-183275,true,10986663749,22,11026285033,39621284
1635288973,-183268,true,10994356721,22,11032902458,38545737
1635289008,-183266,true,10996555703,22,11032902458,36346755
1635289105,-183264,true,10998755124,22,11046149225,47394101
1635289131,-183264,true,10998755124,22,11049463401,50708277
1635289147,-183258,true,11005356027,22,11046149225,40793198
1635289164,-183256,true,11007557208,22,11047253840,39696632
1635289190,-183253,true,11010859805,22,11049463401,38603596
1635289266,-183254,true,11009758830,22,11062730053,52971223
1635289415,-183243,true,11021875621,22,11079335769,57460148
1635289436,-183242,true,11022977809,22,11084876545,61898736
1635289475,-183239,true,11026285033,22,11095966411,69681378
1635289482,-183240,true,11025182515,22,11095966411,70783896
1635289512,-183231,true,11035109149,22,11099295533,64186384
1635289593,-183229,true,11037316281,22,11113733278,76416997
1635289651,-183226,true,11040627807,22,11123739640,83111833
1635289671,-183226,true,11040627807,22,11127077096,86449289
1635289684,-183217,true,11050568348,22,11129302622,78734274
1635289692,-183216,true,11051673405,22,11131528594,79855189
1635289816,-183215,true,11052778572,22,11154928195,102149623
1635289857,-183216,true,11051673405,22,11161622826,109949421
1635289866,-183208,true,11060517838,22,11161622826,101104988
1635289936,-183206,true,11062730053,22,11177259259,114529206
1635289985,-183205,true,11063836326,22,11185085688,121249362
1635290020,-183207,true,11061623890,22,11194036889,132412999
1635290210,-183199,true,11070476287,22,11251269434,180793147
1635290271,-183197,true,11072690493,22,11259147686,186457193
1635290274,-183195,true,11074905142,22,11259147686,184242544
1635290345,-183195,true,11074905142,22,11269284973,194379831
1635290436,-183182,true,11089311160,22,11292974152,203662992
1635290468,-183181,true,11090420091,22,11298621769,208201678
1635290491,-183179,true,11092638286,22,11303141895,210503609
1635290542,-183180,true,11091529133,22,11313318793,221789660
1635290649,-183169,true,11103735918,22,11335966939,232231021
1635290715,-183168,true,11104846291,22,11349577584,244731293
1635290757,-183166,true,11107067372,22,11359796290,252728918
1635290777,-183167,true,11105956776,22,11366613872,260657096
1635290936,-183154,true,11120403186,22,11411027997,290624811
1635291121,-183152,true,11122627377,22,11451034565,328407188
1635291220,-183150,true,11124852014,22,11465929845,341077831
1635291292,-183151,true,11123739640,22,11472811123,349071483
1635291421,-183138,true,11138209181,22,11481992585,343783404
1635291702,-183136,true,11140436935,22,11496928135,356491200
1635291741,-183135,true,11141550978,22,11496928135,355377157
1635291823,-183134,true,11142665133,22,11496928135,354263002
1635291879,-183120,true,11158275008,22,11496928135,338653127
1635292021,-183116,true,11162738988,22,11495778557,333039569
1635292056,-183115,true,11163855262,22,11498077828,334222566
1635292118,-183114,true,11164971647,22,11500377558,335405911
1635292180,-183100,true,11180612772,22,11492330513,311717741
1635292191,-183098,true,11182849006,22,11491181395,308332389
1635292300,-183098,true,11182849006,22,11484289098,301440092
1635292323,-183098,true,11182849006,22,11483140784,300291778
1635292374,-183083,true,11199635027,22,11481992585,282357558
1635292426,-183078,true,11205235964,22,11494629094,289393130
1635292452,-183074,true,11209718731,22,11502677749,292959018
1635292502,-183073,true,11210839703,22,11506128897,295289194
1635292516,-183057,true,11228790506,22,11506128897,277338391
1635292579,-183053,true,11233282696,22,11504978399,271695703
1635292638,-183049,true,11237776683,22,11503828016,266051333
1635292694,-183046,true,11241148353,22,11501527596,260379243
1635292751,-183032,true,11256896194,22,11500377558,243481364
1635292761,-183030,true,11259147686,22,11500377558,241229872
1635292847,-183026,true,11263652021,22,11500377558,236725537
1635292862,-183024,true,11265904864,22,11496928135,231023271
1635292875,-183013,true,11278303557,22,11495778557,217475000
1635292894,-183012,true,11279431388,22,11493479746,214048358
1635292917,-183012,true,11279431388,22,11492330513,212899125
1635292941,-183009,true,11282815555,22,11490032392,207216837
1635292998,-182996,true,11297492020,22,11488883503,191391483
1635293031,-182994,true,11299751631,22,11488883503,189131872
1635293060,-182994,true,11299751631,22,11492330513,192578882
1635293080,-182989,true,11305402637,22,11498077828,192675191
1635293082,-182977,true,11318976584,22,11499227635,180251051
1635293197,-182974,true,11322372617,22,11504978399,182605782
1635293273,-182973,true,11323504854,22,11507279510,183774656
1635293307,-182969,true,11328034935,22,11498077828,170042893
1635293320,-182955,true,11343904497,22,11494629094,150724597
1635293356,-182955,true,11343904497,22,11481992585,138088088
1635293380,-182956,true,11342770220,22,11478548676,135778456
1635293467,-182950,true,11349577584,22,11484289098,134711514
1635293482,-182939,true,11362068363,22,11485437527,123369164
1635293563,-182937,true,11364340890,22,11480844501,116503611
1635293592,-182937,true,11364340890,22,11478548676,114207786
1635293609,-182931,true,11371161200,22,11478548676,107387476
1635293718,-182921,true,11382537479,22,11477400936,94863457
1635294003,-182919,true,11384814101,22,11483140784,98326683
1635294044,-182920,true,11383675733,22,11480844501,97168768
1635294080,-182914,true,11390507646,22,11483140784,92633138
1635294155,-182906,true,11399623242,22,11470516905,70893663
1635294159,-182906,true,11399623242,22,11469369968,69746726
1635294225,-182908,true,11397343660,22,11462490754,65147094
1635294300,-182904,true,11401903281,22,11455615666,53712385
1635294320,-182893,true,11414451648,22,11449889576,35437928
1635294363,-182894,true,11413310317,22,11439589826,26279509
1635294391,-182895,true,11412169100,22,11431585315,19416215
1635294399,-182892,true,11415593093,22,11430442271,14849178
1635294436,-182886,true,11422444161,22,11424728764,2284603
1635294448,-182888,true,11420160015,22,11423586406,3426391
1635294697,-182886,true,11422444161,22,11396204039,-26240122
1635294817,-182885,true,11423586406,22,11381399339,-42187067
1635294830,-182877,true,11432728474,22,11380261313,-52467161
1635294843,-182880,true,11429299341,22,11379123401,-50175940
1635294974,-182880,true,11429299341,22,11360932270,-68367071
1635295002,-182879,true,11430442271,22,11360932270,-69510001
1635295147,-182872,true,11438445982,22,11360932270,-77513712
1635295166,-182875,true,11435015134,22,11360932270,-74082864
1635295189,-182876,true,11433871747,22,11355253507,-78618240
1635295204,-182876,true,11433871747,22,11354118096,-79753651
1635295238,-182871,true,11439589826,22,11354118096,-85471730
1635295298,-182873,true,11437302251,22,11355253507,-82048744
1635295332,-182873,true,11437302251,22,11355253507,-82048744
1635295390,-182874,true,11436158635,22,11348442739,-87715896
1635295468,-182872,true,11438445982,22,11334833456,-103612526
1635295510,-182876,true,11433871747,22,11328034935,-105836812
1635295759,-182874,true,11436158635,22,11325769668,-110388967
1635295816,-182875,true,11435015134,22,11315581570,-119433564
1635295821,-182873,true,11437302251,22,11315581570,-121720681
1635295873,-182878,true,11431585315,22,11309925476,-121659839
1635295974,-182878,true,11431585315,22,11306533177,-125052138
1635296096,-182878,true,11431585315,22,11312187574,-119397741
1635296133,-182876,true,11433871747,22,11313318793,-120552954
1635296171,-182881,true,11428156526,22,11312187574,-115968952
1635296222,-182882,true,11427013824,22,11313318793,-113695031
1635296235,-182883,true,11425871237,22,11313318793,-112552444
1635296293,-182884,true,11424728764,22,11316713128,-108015636
1635296335,-182889,true,11419018113,22,11322372617,-96645496
1635296426,-182888,true,11420160015,22,11334833456,-85326559
1635296623,-182889,true,11419018113,22,11332566829,-86451284
1635296637,-182888,true,11420160015,22,11332566829,-87593186
1635296651,-182893,true,11414451648,22,11332566829,-81884819
1635296668,-182893,true,11414451648,22,11334833456,-79618192
1635296776,-182894,true,11413310317,22,11352982797,-60327520
1635296806,-182893,true,11414451648,22,11355253507,-59198141
1635296820,-182898,true,11408746133,22,11359796290,-48949843
1635296873,-182896,true,11411027997,22,11375710347,-35317650
1635296891,-182893,true,11414451648,22,11380261313,-34190335
1635296911,-182890,true,11417876325,22,11383675733,-34200592
1635296994,-182894,true,11413310317,22,11399623242,-13687075
1635297031,-182891,true,11416734652,22,11407605373,-9129279
1635297062,-182887,true,11421302031,22,11416734652,-4567379
1635297165,-182885,true,11423586406,22,11443022046,19435640
1635297264,-182893,true,11414451648,22,11457906904,43455256
1635297382,-182894,true,11413310317,22,11478548676,65238359
1635297481,-182890,true,11417876325,22,11500377558,82501233
1635297519,-182889,true,11419018113,22,11508430238,89412125
1635297544,-182893,true,11414451648,22,11514185604,99733956
1635297646,-182891,true,11416734652,22,11534928764,118194112
1635297661,-182887,true,11421302031,22,11538389589,117087558
1635297780,-182886,true,11422444161,22,11551088165,128644004
1635298052,-182889,true,11419018113,22,11569583774,150565661
1635298108,-182888,true,11420160015,22,11576527260,156367245
1635298158,-182883,true,11425871237,22,11582316682,156445445
1635298176,-182882,true,11427013824,22,11583474913,156461089
1635298202,-182884,true,11424728764,22,11585791724,161062960
1635298228,-182881,true,11428156526,22,11586950303,158793777
1635298329,-182877,true,11432728474,22,11592744937,160016463
1635298376,-182877,true,11432728474,22,11589267809,156539335
1635298410,-182881,true,11428156526,22,11588108998,159952472
1635298495,-182878,true,11431585315,22,11584633261,153047946
1635298566,-182876,true,11433871747,22,11580000566,146128819
1635298571,-182876,true,11433871747,22,11580000566,146128819
1635298585,-182879,true,11430442271,22,11578842681,148400410
1635298590,-182876,true,11433871747,22,11578842681,144970934
1635298659,-182872,true,11438445982,22,11576527260,138081278
1635298706,-182871,true,11439589826,22,11576527260,136937434
1635298708,-182874,true,11436158635,22,11576527260,140368625
1635298717,-182870,true,11440733785,22,11576527260,135793475
1635298727,-182868,true,11443022046,22,11576527260,133505214
1635298739,-182868,true,11443022046,22,11575369723,132347677
1635298845,-182870,true,11440733785,22,11575369723,134635938
1635298861,-182866,true,11445310765,22,11575369723,130058958
1635298961,-182865,true,11446455296,22,11561488304,115033008
1635298984,-182865,true,11446455296,22,11560332271,113876975
1635299058,-182868,true,11443022046,22,11556864865,113842819
1635299116,-182864,true,11447599942,22,11554553838,106953896
1635299157,-182862,true,11449889576,22,11552243274,102353698
1635299301,-182863,true,11448744702,22,11539543428,90798726
1635299401,-182864,true,11447599942,22,11534928764,87328822
1635299472,-182860,true,11452179669,22,11531468977,79289308
1635299503,-182857,true,11455615666,22,11529163030,73547364
1635299508,-182858,true,11454470219,22,11528010229,73540010
1635299553,-182857,true,11455615666,22,11529163030,73547364
1635299657,-182850,true,11463637003,22,11531468977,67831974
1635299686,-182845,true,11469369968,22,11531468977,62099009
1635299719,-182846,true,11468223146,22,11530315946,62092800
1635299746,-182846,true,11468223146,22,11530315946,62092800
1635299814,-182841,true,11473958404,22,11536082257,62123853
1635299861,-182837,true,11478548676,22,11540697382,62148706
1635299896,-182838,true,11477400936,22,11541851452,64450516
1635299954,-182838,true,11477400936,22,11544159938,66759002
1635299998,-182833,true,11483140784,22,11544159938,61019154
1635300011,-182828,true,11488883503,22,11544159938,55276435
1635300025,-182829,true,11487734730,22,11544159938,56425208
1635300201,-182829,true,11487734730,22,11558020551,70285821
1635300276,-182824,true,11493479746,22,11567270205,73790459
1635300327,-182819,true,11499227635,22,11569583774,70356139
1635300377,-182818,true,11500377558,22,11573054996,72677438
1635300434,-182819,true,11499227635,22,11571897807,72670172
1635300671,-182813,true,11506128897,22,11574212302,68083405
1635300717,-182808,true,11511883112,22,11570740733,58857621
1635300725,-182806,true,11514185604,22,11570740733,56555129
1635300747,-182806,true,11514185604,22,11570740733,56555129
1635300838,-182803,true,11517640205,22,11573054996,55414791
1635300850,-182796,true,11525704972,22,11574212302,48507330
1635300880,-182794,true,11528010229,22,11578842681,50832452
1635300983,-182793,true,11529163030,22,11591585779,62422749
1635301058,-182788,true,11534928764,22,11596223108,61294344
1635301071,-182783,true,11540697382,22,11598542469,57845087
1635301198,-182780,true,11544159938,22,11624086073,79926135
1635301263,-182779,true,11545314354,22,11629899279,84584925
1635301283,-182773,true,11552243274,22,11632225375,79982101
1635301299,-182768,true,11558020551,22,11635715391,77694840
1635301342,-182766,true,11560332271,22,11646191725,85859454
1635301386,-182763,true,11563800717,22,11653181187,89380470
1635301488,-182757,true,11570740733,22,11671840267,101099534
1635301528,-182752,true,11576527260,22,11678845123,102317863
1635301536,-182750,true,11578842681,22,11680013007,101170326
1635301567,-182748,true,11581158566,22,11684685713,103527147
1635301711,-182744,true,11585791724,22,11699884922,114093198
1635301739,-182740,true,11590426736,22,11702225016,111798280
1635301801,-182738,true,11592744937,22,11702225016,109480079
1635301817,-182737,true,11593904212,22,11702225016,108320804
1635301951,-182735,true,11596223108,22,11710419031,114195923
1635302132,-182734,true,11597382731,22,11706906608,109523877
1635302210,-182734,true,11597382731,22,11709248107,111865376
1635302231,-182731,true,11600862294,22,11708077299,107215005
1635302264,-182729,true,11603182582,22,11705736035,102553453
1635302298,-182728,true,11604342900,22,11703395238,99052338
1635302304,-182727,true,11605503335,22,11703395238,97891903
1635302344,-182723,true,11610146232,22,11704565578,94419346
1635302369,-182719,true,11614790987,22,11705736035,90945048
1635302396,-182718,true,11615952466,22,11705736035,89783569
1635302457,-182718,true,11615952466,22,11706906608,90954142
1635302506,-182716,true,11618275773,22,11704565578,86289805
1635302510,-182713,true,11621761604,22,11704565578,82803974
1635302518,-182712,true,11622923781,22,11704565578,81641797
1635302591,-182711,true,11624086073,22,11718618784,94532711
1635302598,-182707,true,11628736405,22,11719790646,91054241
1635302651,-182705,true,11631062268,22,11726824279,95762011
1635302719,-182704,true,11632225375,22,11735035519,102810144
1635302790,-182704,true,11632225375,22,11737382643,105157268
1635302799,-182700,true,11636878963,22,11737382643,100503680
1635302834,-182699,true,11638042651,22,11736209022,98166371
1635302889,-182700,true,11636878963,22,11735035519,98156556
1635302912,-182701,true,11635715391,22,11733862133,98146742
1635302920,-182697,true,11640370376,22,11732688864,92318488
1635302982,-182694,true,11643862836,22,11731515712,87652876
1635303023,-182694,true,11643862836,22,11729169761,85306925
1635303026,-182695,true,11642698566,22,11729169761,86471195
1635303128,-182690,true,11648521080,22,11730342678,81821598
1635303192,-182688,true,11650850900,22,11730342678,79491778
1635303376,-182690,true,11648521080,22,11712761232,64240152
1635303402,-182691,true,11647356344,22,11715103902,67747558
1635303417,-182686,true,11653181187,22,11717447040,64265853
1635303431,-182683,true,11656677491,22,11718618784,61941293
1635303470,-182683,true,11656677491,22,11713932508,57255017
1635303482,-182684,true,11655511940,22,11711590073,56078133
1635303528,-182681,true,11659008943,22,11706906608,47897665
1635303567,-182679,true,11661340862,22,11703395238,42054376
1635303766,-182677,true,11663673246,22,11701054910,37381664
1635303857,-182677,true,11663673246,22,11708077299,44404053
1635303907,-182673,true,11668339416,22,11711590073,43250657
1635303989,-182671,true,11670673200,22,11719790646,49117446
1635304051,-182669,true,11673007451,22,11724479266,51471815
1635304077,-182667,true,11675342170,22,11726824279,51482109
1635304109,-182662,true,11681181008,22,11729169761,47988753
1635304136,-182660,true,11683517361,22,11730342678,46825317
1635304201,-182658,true,11685854182,22,11733862133,48007951
1635304298,-182657,true,11687022767,22,11740904210,53881443
1635304303,-182654,true,11690529225,22,11740904210,50374985
1635304377,-182654,true,11690529225,22,11735035519,44506294
1635304381,-182654,true,11690529225,22,11735035519,44506294
1635304423,-182654,true,11690529225,22,11732688864,42159639
1635304444,-182649,true,11696375658,22,11736209022,39833364
1635304463,-182649,true,11696375658,22,11737382643,41006985
1635304509,-182647,true,11698715050,22,11742078301,43363251
1635304548,-182646,true,11699884922,22,11742078301,42193379
1635304580,-182642,true,11704565578,22,11743252508,38686930
1635304627,-182642,true,11704565578,22,11743252508,38686930
1635304661,-182640,true,11706906608,22,11744426834,37520226
1635304683,-182640,true,11706906608,22,11742078301,35171693
1635304887,-182638,true,11709248107,22,11719790646,10542539
1635304894,-182638,true,11709248107,22,11718618784,9370677
1635304915,-182637,true,11710419031,22,11716275412,5856381
1635304953,-182636,true,11711590073,22,11712761232,1171159
1635304998,-182632,true,11716275412,22,11710419031,-5856381
1635305021,-182633,true,11715103902,22,11710419031,-4684871
1635305129,-182631,true,11717447040,22,11710419031,-7028009
1635305180,-182631,true,11717447040,22,11702225016,-15222024
1635305201,-182628,true,11720962625,22,11699884922,-21077703
1635305318,-182630,true,11718618784,22,11690529225,-28089559
1635305368,-182631,true,11717447040,22,11680013007,-37434033
1635305451,-182632,true,11716275412,22,11667172698,-49102714
1635305563,-182629,true,11719790646,22,11654346505,-65444141
1635305590,-182631,true,11717447040,22,11654346505,-63100535
1635305614,-182632,true,11716275412,22,11654346505,-61928907
1635305642,-182634,true,11713932508,22,11654346505,-59586003
1635305760,-182630,true,11718618784,22,11657843159,-60775625
1635305902,-182632,true,11716275412,22,11656677491,-59597921
1635305909,-182633,true,11715103902,22,11656677491,-58426411
1635306045,-182633,true,11715103902,22,11656677491,-58426411
1635306136,-182631,true,11717447040,22,11664839614,-52607426
1635306150,-182634,true,11713932508,22,11666006098,-47926410
1635306222,-182635,true,11712761232,22,11671840267,-40920965
1635306236,-182635,true,11712761232,22,11674174752,-38586480
1635306309,-182633,true,11715103902,22,11684685713,-30418189
1635306400,-182633,true,11715103902,22,11698715050,-16388852
1635306413,-182632,true,11716275412,22,11701054910,-15220502
1635306423,-182632,true,11716275412,22,11702225016,-14050396
1635306545,-182631,true,11717447040,22,11703395238,-14051802
1635306569,-182633,true,11715103902,22,11703395238,-11708664
1635306609,-182633,true,11715103902,22,11706906608,-8197294
1635306665,-182633,true,11715103902,22,11710419031,-4684871
1635306677,-182630,true,11718618784,22,11710419031,-8199753
1635306698,-182632,true,11716275412,22,11711590073,-4685339
1635306736,-182633,true,11715103902,22,11709248107,-5855795
1635306744,-182635,true,11712761232,22,11708077299,-4683933
1635306795,-182634,true,11713932508,22,11706906608,-7025900
1635306798,-182637,true,11710419031,22,11706906608,-3512423
1635306804,-182638,true,11709248107,22,11706906608,-2341499
1635306810,-182640,true,11706906608,22,11706906608,0
1635306831,-182636,true,11711590073,22,11705736035,-5854038
1635306985,-182638,true,11709248107,22,11702225016,-7023091
1635307023,-182639,true,11708077299,22,11702225016,-5852283
1635307066,-182641,true,11705736035,22,11703395238,-2340797
1635307086,-182641,true,11705736035,22,11703395238,-2340797
1635307100,-182643,true,11703395238,22,11702225016,-1170222
1635307178,-182641,true,11705736035,22,11708077299,2341264
1635307205,-182641,true,11705736035,22,11712761232,7025197
1635307227,-182638,true,11709248107,22,11717447040,8198933
1635307241,-182638,true,11709248107,22,11720962625,11714518
1635307300,-182629,true,11719790646,22,11742078301,22287655
1635307365,-182623,true,11726824279,22,11780889221,54064942
1635307396,-182619,true,11731515712,22,11800932763,69417051
1635307417,-182618,true,11732688864,22,11813920281,81231417
1635307478,-182607,true,11745601276,22,11848228658,102627382
1635307504,-182602,true,11751475252,22,11862454355,110979103
1635307536,-182599,true,11755001047,22,11879072590,124071543
1635307567,-182598,true,11756176547,22,11895714106,139537559
1635307605,-182588,true,11767938015,22,11915953006,148014991
1635307637,-182584,true,11772645896,22,11935032837,162386941
1635307727,-182581,true,11776178043,22,11987660045,211482002
1635307784,-182580,true,11777355661,22,12020068839,242713178
1635307828,-182572,true,11786780844,22,12044131828,257350984
1635307841,-182568,true,11791496264,22,12051360114,259863850
1635307877,-182562,true,11798572930,22,12074278318,275705388
1635307890,-182561,true,11799752788,22,12081524696,281771908
1635307928,-182550,true,11812739008,22,12109342791,296603783
1635307946,-182546,true,11817464812,22,12122669730,305204918
1635307969,-182539,true,11825739519,22,12139652504,313912985
1635307987,-182537,true,11828104786,22,12154228102,326123316
1635308001,-182527,true,11839938214,22,12166387801,326449587
1635308031,-182521,true,11847043954,22,12189524754,342480800
1635308081,-182512,true,11857710559,22,12229814613,372104054
1635308117,-182509,true,11861268228,22,12254297492,393029264
1635308125,-182498,true,11874322149,22,12257974149,383652000
1635308167,-182493,true,11880260497,22,12272691811,392431314
1635308184,-182485,true,11889768033,22,12281285273,391517240
1635308192,-182483,true,11892146105,22,12283741653,391595548
1635308282,-182475,true,11901663153,22,12287427144,385763991
1635308326,-182470,true,11907615175,22,12289884752,382269577
1635308330,-182464,true,11914761530,22,12291113741,376352211
1635308375,-182463,true,11915953006,22,12294801444,378848438
1635308521,-182455,true,11925489106,22,12312025359,386536253
1635308531,-182451,true,11930260017,22,12314487887,384227870
1635308546,-182444,true,11938613705,22,12318182603,379568898
1635308587,-182441,true,11942195647,22,12326807918,384612271
1635308680,-182431,true,11954143218,22,12342842386,388699168
1635308697,-182426,true,11960121485,22,12345311078,385189593
1635308698,-182418,true,11969692932,22,12345311078,375618146
1635308741,-182416,true,11972086990,22,12350249943,378162953
1635308770,-182408,true,11981668013,22,12346545609,364877596
1635308787,-182404,true,11986461399,22,12346545609,360084210
1635308853,-182398,true,11993655074,22,12335439272,341784198
1635308889,-182397,true,11994854439,22,12328040598,333186159
1635308893,-182390,true,12003253357,22,12328040598,324787241
1635308924,-182385,true,12009256184,22,12318182603,308926419
1635308994,-182378,true,12017665186,22,12294801444,277136258
1635309022,-182375,true,12021270846,22,12287427144,266156298
1635309035,-182366,true,12032094318,22,12284970027,252875709
1635309072,-182362,true,12036907878,22,12277601624,240693746
1635309083,-182354,true,12046540775,22,12275146472,228605697
1635309094,-182351,true,12050155099,22,12275146472,224991373
1635309238,-182337,true,12067036286,22,12307101779,240065493
1635309313,-182331,true,12074278318,22,12321878427,247600109
1635309325,-182324,true,12082732849,22,12324342926,241610077
1635309335,-182321,true,12086358031,22,12326807918,240449887
1635309379,-182306,true,12104500264,22,12339140274,234640010
1635309446,-182300,true,12111764781,22,12352720117,240955336
1635309450,-182293,true,12120245560,22,12352720117,232474557
1635309464,-182291,true,12122669730,22,12353955389,231285659
1635309482,-182277,true,12139652504,22,12353955389,214302885
1635309506,-182273,true,12144509093,22,12355190785,210681692
1635309529,-182267,true,12151797621,22,12357661946,205864325
1635309615,-182266,true,12153012800,22,12363842013,210829213
1635309702,-182252,true,12170038082,22,12388593203,218555121
1635309768,-182247,true,12176124318,22,12408429825,232305507
1635309855,-182239,true,12185868628,22,12432027072,246158444
1635309861,-182236,true,12189524754,22,12433270275,243745521
1635309887,-182222,true,12206601185,22,12440732102,234130917
1635309954,-182220,true,12209042628,22,12448198408,239155780
1635310028,-182215,true,12215148370,22,12444464695,229316325
1635310073,-182212,true,12218813281,22,12439488153,220674872
1635310130,-182199,true,12234707272,22,12422085924,187378652
1635310171,-182194,true,12240825850,22,12422085924,181260074
1635310192,-182190,true,12245722914,22,12414635281,168912367
1635310273,-182186,true,12250621938,22,12404708040,154086102
1635310284,-182171,true,12269010740,22,12402227471,133216731
1635310300,-182168,true,12272691811,22,12400987372,128295561
1635310359,-182163,true,12278829385,22,12393549383,114719998
1635310380,-182161,true,12281285273,22,12389832062,108546789
1635310383,-182146,true,12299720102,22,12389832062,90111960
1635310420,-182143,true,12303410387,22,12384877368,81466981
1635310463,-182140,true,12307101779,22,12381162648,74060869
1635310515,-182137,true,12310794279,22,12377449041,66654762
1635310538,-182124,true,12326807918,22,12373736549,46928631
1635310620,-182123,true,12328040598,22,12358897712,30857114
1635310633,-182122,true,12329273403,22,12357661946,28388543
1635310668,-182120,true,12331739380,22,12350249943,18510563
1635310700,-182114,true,12339140274,22,12340374188,1233914
1635310710,-182119,true,12332972554,22,12337906483,4933929
1635310718,-182119,true,12332972554,22,12336672816,3700262
1635310733,-182119,true,12332972554,22,12332972554,0
1635310777,-182113,true,12340374188,22,12321878427,-18495761
1635310824,-182117,true,12335439272,22,12318182603,-17256669
1635310834,-182117,true,12335439272,22,12318182603,-17256669
1635310839,-182117,true,12335439272,22,12318182603,-17256669
1635310850,-182110,true,12344076671,22,12315719336,-28357335
1635310858,-182115,true,12337906483,22,12314487887,-23418596
1635310888,-182117,true,12335439272,22,12308332490,-27106782
1635311007,-182117,true,12335439272,22,12291113741,-44325531
1635311014,-182111,true,12342842386,22,12289884752,-52957634
1635311044,-182116,true,12336672816,22,12282513402,-54159414
1635311059,-182120,true,12331739380,22,12275146472,-56592908
1635311076,-182122,true,12329273403,22,12269010740,-60262663
1635311101,-182120,true,12331739380,22,12262878075,-68861305
1635311119,-182126,true,12324342926,22,12257974149,-66368777
1635311177,-182128,true,12321878427,22,12244498465,-77379962
1635311192,-182131,true,12318182603,22,12240825850,-77356753
1635311221,-182128,true,12321878427,22,12231037594,-90840833
1635311289,-182136,true,12312025359,22,12216369885,-95655474
1635311356,-182140,true,12307101779,22,12204160231,-102941548
1635311382,-182145,true,12300950074,22,12196840297,-104109777
1635311396,-182142,true,12304640728,22,12191962781,-112677947
1635311415,-182149,true,12296030924,22,12188305923,-107725001
1635311430,-182154,true,12289884752,22,12184650163,-105234589
1635311473,-182155,true,12288655887,22,12178559665,-110096222
1635311502,-182148,true,12297260527,22,12174906827,-122353700
1635311544,-182152,true,12292342852,22,12173689458,-118653394
1635311571,-182156,true,12287427144,22,12170038082,-117389062
1635311635,-182154,true,12289884752,22,12183431819,-106452933
1635311649,-182147,true,12298490253,22,12184650163,-113840090
1635311718,-182151,true,12293572087,22,12185868628,-107703459
1635311746,-182155,true,12288655887,22,12187087214,-101568673
1635311750,-182155,true,12288655887,22,12188305923,-100349964
1635311783,-182149,true,12296030924,22,12193181977,-102848947
1635311792,-182153,true,12291113741,22,12194401295,-96712446
1635311822,-182156,true,12287427144,22,12200499715,-86927429
1635311865,-182155,true,12288655887,22,12210263532,-78392355
1635311897,-182146,true,12299720102,22,12216369885,-83350217
1635311903,-182148,true,12297260527,22,12217591522,-79669005
1635311927,-182150,true,12294801444,22,12224923910,-69877534
1635311987,-182147,true,12298490253,22,12249396999,-49093254
1635312013,-182138,true,12309563323,22,12260425867,-49137456
1635312030,-182141,true,12305871192,22,12265330773,-40540419
1635312044,-182143,true,12303410387,22,12269010740,-34399647
1635312046,-182139,true,12308332490,22,12270237641,-38094849
1635312056,-182130,true,12319414421,22,12272691811,-46722610
1635312083,-182131,true,12318182603,22,12282513402,-35669201
1635312106,-182135,true,12313256561,22,12288655887,-24600674
1635312107,-182133,true,12315719336,22,12288655887,-27063449
1635312125,-182129,true,12320646362,22,12296030924,-24615438
1635312156,-182133,true,12315719336,22,12304640728,-11078608
1635312170,-182137,true,12310794279,22,12309563323,-1230956
1635312193,-182134,true,12314487887,22,12318182603,3694716
1635312218,-182131,true,12318182603,22,12326807918,8625315
1635312288,-182135,true,12313256561,22,12355190785,41934224
1635312323,-182138,true,12309563323,22,12370025171,60461848
1635312424,-182134,true,12314487887,22,12405948511,91460624
1635312444,-182130,true,12319414421,22,12410911635,91497214
1635312458,-182132,true,12316950907,22,12413393941,96443034
1635312466,-182135,true,12313256561,22,12415876744,102620183
1635312480,-182134,true,12314487887,22,12417118332,102630445
1635312488,-182132,true,12316950907,22,12417118332,100167425
1635312516,-182133,true,12315719336,22,12417118332,101398996
1635312534,-182136,true,12312025359,22,12418360044,106334685
1635312557,-182135,true,12313256561,22,12420843840,107587279
1635312558,-182133,true,12315719336,22,12420843840,105124504
1635312602,-182130,true,12319414421,22,12435757053,116342632
1635312603,-182130,true,12319414421,22,12435757053,116342632
1635312638,-182127,true,12323110615,22,12446953712,123843097
1635312662,-182123,true,12328040598,22,12454423752,126383154
1635312705,-182122,true,12329273403,22,12463144464,133871061
1635312724,-182120,true,12331739380,22,12469377283,137637903
1635312735,-182118,true,12334205852,22,12473118470,138912618
1635312782,-182115,true,12337906483,22,12488094448,150187965
1635312832,-182111,true,12342842386,22,12501838222,158995836
1635312849,-182111,true,12342842386,22,12506839707,163997321
1635312866,-182108,true,12346545609,22,12510592134,164046525
1635312870,-182105,true,12350249943,22,12511843194,161593251
1635312914,-182098,true,12358897712,22,12525613105,166715393
1635312941,-182097,true,12360133602,22,12533130352,172996750
1635312962,-182094,true,12363842013,22,12539398170,175556157
1635313005,-182090,true,12368788292,22,12553198407,184410115
1635313029,-182084,true,12376211420,22,12560732209,184520789
1635313053,-182083,true,12377449041,22,12568270533,190821492
1635313117,-182080,true,12381162648,22,12585877554,204714906
1635313168,-182075,true,12387354467,22,12599728943,212374476
1635313172,-182067,true,12397267820,22,12600988916,203721096
1635313187,-182065,true,12399747397,22,12606030068,206282671
1635313268,-182061,true,12404708040,22,12624952355,220244315
1635313331,-182060,true,12405948511,22,12627477472,221528961
1635313354,-182053,true,12414635281,22,12635055852,220420571
1635313368,-182051,true,12417118332,22,12637582990,220464658
1635313379,-182049,true,12419601880,22,12640110633,220508753
1635313443,-182048,true,12420843840,22,12650226261,229382421
1635313457,-182040,true,12430783994,22,12651491284,220707290
1635313491,-182037,true,12434513602,22,12648961365,214447763
1635313499,-182035,true,12437000629,22,12647696596,210695967
1635313522,-182035,true,12437000629,22,12646431952,209431323
1635313532,-182027,true,12446953712,22,12646431952,199478240
1635313600,-182022,true,12453178434,22,12647696596,194518162
1635313636,-182018,true,12458160453,22,12645167436,187006983
1635313675,-182016,true,12460652209,22,12642638781,181986572
1635313760,-182008,true,12470624221,22,12638846748,168222527
1635313780,-182006,true,12473118470,22,12631266094,158147624
1635313822,-182003,true,12476860780,22,12621165627,144304847
1635313824,-182002,true,12478108466,22,12621165627,143057161
1635313831,-181997,true,12484348768,22,12619903636,135554868
1635313838,-181993,true,12489343257,22,12618641772,129298515
1635313880,-181984,true,12500588163,22,12614856936,114268773
1635313920,-181983,true,12501838222,22,12612334343,110496121
1635313942,-181978,true,12508090391,22,12607290671,99200280
1635313947,-181973,true,12514345687,22,12607290671,92944984
1635313954,-181967,true,12521856172,22,12607290671,85434499
1635313975,-181968,true,12520604112,22,12606030068,85425956
1635314026,-181963,true,12526865666,22,12599728943,72863277
1635314074,-181957,true,12534383665,22,12597209375,62825710
1635314111,-181955,true,12536890667,22,12588394855,51504188
1635314130,-181957,true,12534383665,22,12587136141,52752476
1635314159,-181952,true,12540652110,22,12584619092,43966982
1635314189,-181948,true,12545669124,22,12584619092,38949968
1635314218,-181943,true,12551943213,22,12587136141,35192928
1635314253,-181944,true,12550688144,22,12588394855,37706711
1635314265,-181939,true,12556964743,22,12589653694,32688951
1635314334,-181934,true,12563244481,22,12603509240,40264759
1635314351,-181930,true,12568270533,22,12604769591,36499058
1635314399,-181932,true,12565757256,22,12612334343,46577087
1635314404,-181927,true,12572041391,22,12613595577,41554186
1635314444,-181922,true,12578328669,22,12624952355,46623686
1635314450,-181918,true,12583360756,22,12626214850,42854094
1635314483,-181919,true,12582102545,22,12632529220,50426675
1635314522,-181915,true,12587136141,22,12638846748,51710607
1635314529,-181910,true,12593430968,22,12642638781,49207813
1635314539,-181907,true,12597209375,22,12643903045,46693670
1635314605,-181907,true,12597209375,22,12659084077,61874702
1635314753,-181904,true,12600988916,22,12699655998,98667082
1635314796,-181899,true,12607290671,22,12697116447,89825776
1635314835,-181897,true,12609812255,22,12693308074,83495819
1635314846,-181898,true,12608551400,22,12692038870,83487470
1635314859,-181898,true,12608551400,22,12690769793,82218393
1635314894,-181895,true,12612334343,22,12688232020,75897677
1635314917,-181892,true,12616118422,22,12686963324,70844902
1635315029,-181890,true,12618641772,22,12703466276,84824504
1635315047,-181891,true,12617380034,22,12704736622,87356588
1635315114,-181887,true,12622427743,22,12706007096,83579353
1635315253,-181886,true,12623689986,22,12698386159,74696173
1635315262,-181884,true,12626214850,22,12698386159,72171309
1635315341,-181884,true,12626214850,22,12700925963,74711113
1635315428,-181880,true,12631266094,22,12700925963,69659869
1635315463,-181875,true,12637582990,22,12695846863,58263873
1635315502,-181872,true,12641374644,22,12690769793,49395149
1635315515,-181873,true,12640110633,22,12690769793,50659160
1635315524,-181870,true,12643903045,22,12688232020,44328975
1635315583,-181868,true,12646431952,22,12671748859,25316907
1635315638,-181867,true,12647696596,22,12657818295,10121699
1635315718,-181872,true,12641374644,22,12652756433,11381789
1635315768,-181869,true,12645167436,22,12655287111,10119675
1635315797,-181868,true,12646431952,22,12656552640,10120688
1635315826,-181866,true,12648961365,22,12657818295,8856930
1635315899,-181870,true,12643903045,22,12648961365,5058320
1635315923,-181867,true,12647696596,22,12645167436,-2529160
1635315967,-181866,true,12648961365,22,12642638781,-6322584
1635316064,-181866,true,12648961365,22,12636319358,-12642007
1635316118,-181871,true,12642638781,22,12633792473,-8846308
1635316203,-181868,true,12646431952,22,12626214850,-20217102
1635316264,-181868,true,12646431952,22,12616118422,-30313530
1635316282,-181867,true,12647696596,22,12611073236,-36623360
1635316299,-181873,true,12640110633,22,12611073236,-29037397
1635316419,-181870,true,12643903045,22,12608551400,-35351645
1635316482,-181869,true,12645167436,22,12619903636,-25263800
1635316576,-181868,true,12646431952,22,12633792473,-12639479
1635316594,-181875,true,12637582990,22,12637582990,0
1635316631,-181871,true,12642638781,22,12642638781,0
1635316655,-181869,true,12645167436,22,12647696596,2529160
1635316718,-181866,true,12648961365,22,12664148470,15187105
1635316746,-181871,true,12642638781,22,12670481811,27843030
1635316753,-181867,true,12647696596,22,12673016034,25319438
1635316816,-181866,true,12648961365,22,12678086001,29124636
1635316855,-181863,true,12652756433,22,12681889807,29133374
1635316913,-181870,true,12643903045,22,12688232020,44328975
1635316938,-181865,true,12650226261,22,12690769793,40543532
1635316961,-181863,true,12652756433,22,12693308074,40551641
1635316990,-181859,true,12657818295,22,12697116447,39298152
1635317028,-181866,true,12648961365,22,12697116447,48155082
1635317091,-181861,true,12655287111,22,12699655998,44368887
1635317147,-181858,true,12659084077,22,12703466276,44382199
1635317179,-181854,true,12664148470,22,12706007096,41858626
1635317193,-181861,true,12655287111,22,12706007096,50719985
1635317207,-181857,true,12660349985,22,12706007096,45657111
1635317265,-181854,true,12664148470,22,12707277697,43129227
1635317290,-181850,true,12669214889,22,12707277697,38062808
1635317305,-181857,true,12660349985,22,12706007096,45657111
1635317363,-181852,true,12666681426,22,12706007096,39325670
1635317364,-181849,true,12670481811,22,12706007096,35525285
1635317417,-181842,true,12679353809,22,12716175460,36821651
1635317445,-181845,true,12675550764,22,12719990694,44439930
1635317462,-181841,true,12680621745,22,12722534819,41913074
1635317474,-181843,true,12678086001,22,12719990694,41904693
1635317486,-181837,true,12685694754,22,12722534819,36840065
1635317512,-181840,true,12681889807,22,12726351961,44462154
1635317555,-181834,true,12689500843,22,12730170249,40669406
1635317569,-181834,true,12689500843,22,12732716410,43215567
1635317577,-181827,true,12698386159,22,12733989682,35603523
1635317627,-181830,true,12694577405,22,12737810261,43232856
1635317643,-181824,true,12702196056,22,12739084042,36887986
1635317661,-181823,true,12703466276,22,12740357950,36891674
1635317673,-181815,true,12713632606,22,12748004076,34371470
1635317708,-181815,true,12713632606,22,12762033894,48401288
1635317867,-181800,true,12732716410,22,12877404821,144688411
1635317877,-181800,true,12732716410,22,12882556556,149840146
1635317887,-181792,true,12742906149,22,12891577051,148670902
1635317906,-181793,true,12741631986,22,12895444911,153812925
1635317957,-181779,true,12759481870,22,12941949846,182467976
1635318011,-181778,true,12760757819,22,12982130129,221372310
1635318060,-181770,true,12770969999,22,13018529209,247559210
1635318134,-181770,true,12770969999,22,13069398059,298428060
1635318158,-181759,true,12785025092,22,13082473340,297448248
1635318250,-181755,true,12790139869,22,13177002317,386862448
1635318371,-181744,true,12804216059,22,13302774021,498557962
1635318476,-181739,true,12810619448,22,13402914878,592295430
1635318550,-181726,true,12827283249,22,13470093901,642810652
1635318578,-181721,true,12833698174,22,13490313191,656615017
1635318580,-181711,true,12846537649,22,13491662223,645124574
1635318597,-181706,true,12852962202,22,13506510474,653548272
1635318608,-181690,true,12873542372,22,13518671197,645128825
1635318636,-181680,true,12886421709,22,13536256018,649834309
1635318641,-181669,true,12900603863,22,13540317301,639713438
1635318642,-181657,true,12916093105,22,13540317301,624224196
1635318648,-181642,true,12935480812,22,13541671332,606190520
1635318656,-181637,true,12941949846,22,13545734240,603784394
1635318670,-181631,true,12949716958,22,13552508462,602791504
1635318713,-181624,true,12958784480,22,13561998064,603213584
1635318757,-181612,true,12974343577,22,13567423677,593080100
1635318765,-181607,true,12980832046,22,13568780420,587948374
1635318795,-181602,true,12987323760,22,13572851461,585527701
1635318819,-181596,true,12995118103,22,13585071914,589953811
1635318830,-181585,true,13009419882,22,13587789065,578369183
1635318836,-181580,true,13015925893,22,13587789065,571863172
1635318839,-181572,true,13026342279,22,13589147844,562805565
1635318882,-181562,true,13039374485,22,13608185022,568810537
1635318906,-181548,true,13057641480,22,13619075381,561433901
1635318940,-181541,true,13066784571,22,13634063856,567279285
1635318948,-181531,true,13079857237,22,13638154485,558297248
1635318971,-181521,true,13092942982,22,13646339423,553396441
1635318990,-181507,true,13111285022,22,13658626043,547341021
1635318998,-181500,true,13120465675,22,13662724040,542258365
1635319021,-181490,true,13133592047,22,13677760553,544168506
1635319035,-181478,true,13149361028,22,13688706592,539345564
1635319057,-181462,true,13170415792,22,13710624957,540209165
1635319083,-181455,true,13179637850,22,13720225274,540587424
1635319100,-181444,true,13194142702,22,13725714188,531571486
1635319145,-181433,true,13208663518,22,13738072273,529408755
1635319148,-181418,true,13228490389,22,13739446080,510955691
1635319151,-181411,true,13237753110,22,13740820025,503066915
1635319183,-181400,true,13252321922,22,13743568326,491246404
1635319200,-181392,true,13262927491,22,13742194107,479266616
1635319232,-181377,true,13282835814,22,13749066578,466230764
1635319269,-181370,true,13292136589,22,13757318081,465181492
1635319289,-181360,true,13305434708,22,13761445689,456010981
1635319367,-181351,true,13317414391,22,13776590850,459176459
1635319419,-181336,true,13337404502,22,13787615981,450211479
1635319515,-181333,true,13341406123,22,13769704621,428298498
1635319599,-181325,true,13352082984,22,13777968509,425885525
1635319666,-181318,true,13361432247,22,13791752679,430320432
1635319682,-181306,true,13377474787,22,13795890619,418415832
1635319721,-181300,true,13385503279,22,13805550640,420047361
1635319738,-181293,true,13394875943,22,13804170223,409294280
1635319827,-181329,true,13346743486,22,13561998064,215254578
1635319840,-181323,true,13354753535,22,13529489920,174736385
1635319880,-181318,true,13361432247,22,13528137106,166704859
1635319890,-181312,true,13369451111,22,13522727204,153276093
1635319928,-181306,true,13377474787,22,13510562832,133088045
1635319961,-181293,true,13394875943,22,13483570058,88694115
1635319978,-181291,true,13397555052,22,13472788054,75233002
1635320004,-181286,true,13404255169,22,13456631212,52376043
1635320041,-181277,true,13416323825,22,13455285684,38961859
1635320054,-181262,true,13436462404,22,13451249905,14787501
1635320154,-181261,true,13437806051,22,13410958637,-26847414
1635320207,-181257,true,13443181979,22,13382826580,-60355399
1635320216,-181249,true,13453940290,22,13381488431,-72451859
1635320296,-181232,true,13476830295,22,13360096237,-116734058
1635320302,-181230,true,13479525796,22,13357424619,-122101177
1635320312,-181226,true,13484918415,22,13354753535,-130164880
1635320318,-181219,true,13494360690,22,13353418193,-140942497
1635320328,-181203,true,13515967868,22,13354753535,-161214333
1635320349,-181200,true,13520023064,22,13354753535,-165269529
1635320368,-181195,true,13526784427,22,13354753535,-172030892
1635320402,-181186,true,13538963404,22,13364104667,-174858737
1635320459,-181169,true,13561998064,22,13369451111,-192546953
1635320493,-181168,true,13563354264,22,13362768390,-200585874
1635320497,-181163,true,13570137298,22,13361432247,-208705051
1635320523,-181156,true,13579639244,22,13361432247,-218206997
1635320580,-181143,true,13597303371,22,13365441077,-231862294
1635320608,-181141,true,13600022968,22,13364104667,-235918301
1635320627,-181137,true,13605463793,22,13364104667,-241359126
1635320673,-181134,true,13609545840,22,13456631212,-152914628
1635320701,-181130,true,13614990475,22,13526784427,-88206048
1635320725,-181131,true,13613629112,22,13585071914,-28557198
1635320797,-181128,true,13617713609,22,13619075381,1361772
1635320814,-181126,true,13620437288,22,13613629112,-6808176
1635320851,-181123,true,13624523828,22,13616351974,-8171854
1635320862,-181125,true,13621799332,22,13616351974,-5447358
1635320895,-181126,true,13620437288,22,13613629112,-6808176
1635320905,-181125,true,13621799332,22,13614990475,-6808857
1635320907,-181123,true,13624523828,22,13613629112,-10894716
1635320982,-181123,true,13624523828,22,13606824339,-17699489
1635321038,-181126,true,13620437288,22,13609545840,-10891448
1635321106,-181128,true,13617713609,22,13617713609,0
1635321121,-181127,true,13619075381,22,13616351974,-2723407
1635321194,-181130,true,13614990475,22,13597303371,-17687104
1635321230,-181133,true,13610906795,22,13597303371,-13603424
1635321234,-181136,true,13606824339,22,13597303371,-9520968
1635321255,-181137,true,13605463793,22,13597303371,-8160422
1635321272,-181140,true,13601382970,22,13593224996,-8157974
1635321328,-181141,true,13600022968,22,13586430422,-13592546
1635321349,-181146,true,13593224996,22,13582355308,-10869688
1635321382,-181144,true,13595943777,22,13580997208,-14946569
1635321428,-181143,true,13597303371,22,13579639244,-17664127
1635321456,-181144,true,13595943777,22,13578281416,-17662361
1635321564,-181147,true,13591865809,22,13557930278,-33935531
1635321583,-181144,true,13595943777,22,13557930278,-38013499
1635321603,-181143,true,13597303371,22,13557930278,-39373093
1635321611,-181142,true,13598663101,22,13557930278,-40732823
1635321633,-181143,true,13597303371,22,13559286071,-38017300
1635321648,-181140,true,13601382970,22,13559286071,-42096899
1635321653,-181139,true,13602743108,22,13560642000,-42101108
1635321742,-181144,true,13595943777,22,13560642000,-35301777
1635321781,-181152,true,13585071914,22,13560642000,-24429914
1635321805,-181151,true,13586430422,22,13559286071,-27144351
1635321820,-181149,true,13589147844,22,13560642000,-28505844
1635321887,-181157,true,13578281416,22,13545734240,-32547176
1635321941,-181168,true,13563354264,22,13506510474,-56843790
1635321951,-181169,true,13561998064,22,13501109220,-60888844
1635321957,-181169,true,13561998064,22,13497059697,-64938367
1635321988,-181185,true,13540317301,22,13476830295,-63487006
1635322046,-181204,true,13514616406,22,13425718070,-88898336
1635322091,-181209,true,13507861125,22,13386841829,-121019296
1635322126,-181211,true,13505159958,22,13345408945,-159751013
1635322180,-181232,true,13476830295,22,13269560281,-207270014
1635322200,-181252,true,13449904915,22,13237753110,-212151805
1635322203,-181259,true,13440493746,22,13231136219,-209357527
1635322227,-181264,true,13433775515,22,13191504269,-242271246
1635322319,-181274,true,13420349125,22,13103421003,-316928122
1635322324,-181290,true,13398894807,22,13098180945,-300713862
1635322331,-181299,true,13386841829,22,13087707114,-299134715
1635322351,-181302,true,13382826580,22,13064171606,-318654974
1635322382,-181313,true,13368114299,22,13043286688,-324827611
1635322434,-181328,true,13348078161,22,13005517837,-342560324
1635322484,-181337,true,13336070895,22,12960080358,-375990537
1635322600,-181335,true,13338738242,22,12873542372,-465195870
1635322616,-181346,true,13324074430,22,12861961975,-462112455
1635322644,-181361,true,13304104298,22,12837548668,-466555630
1635322721,-181370,true,13292136589,22,12769693029,-522443560
1635322762,-181373,true,13288149745,22,12739084042,-549065703
1635322766,-181382,true,13276196388,22,12736536607,-539659781
1635322921,-181344,true,13326739378,22,12755654791,-571084587
1635322943,-181343,true,13328072052,22,12763310098,-564761954
1635322965,-181345,true,13325406837,22,12763310098,-562096739
1635323028,-181356,true,13310757681,22,12750553805,-560203876
1635323199,-181371,true,13290807508,22,12748004076,-542803432
1635323220,-181377,true,13282835814,22,12742906149,-539929665
1635323226,-181377,true,13282835814,22,12741631986,-541203828
1635323234,-181386,true,13270887237,22,12742906149,-527981088
1635323267,-181398,true,13254972519,22,12746729403,-508243116
1635323332,-181404,true,13247022318,22,12744180440,-502841878
1635323368,-181402,true,13249671855,22,12748004076,-501667779
1635323391,-181410,true,13239076886,22,12754379353,-484697533
1635323393,-181419,true,13227167672,22,12754379353,-472788319
1635323427,-181425,true,13219234148,22,12756930357,-462303791
1635323590,-181421,true,13224522635,22,12802935766,-421586869
1635323740,-181430,true,13212626513,22,12846537649,-366088864
1635323751,-181440,true,13199421151,22,12850391995,-349029156
1635323805,-181445,true,13192823420,22,12865820950,-327002470
1635323870,-181437,true,13203381373,22,12898024129,-305357244
1635323947,-181442,true,13196781663,22,12970452052,-226329611
1635324005,-181454,true,13180955813,22,13021133045,-159822768
1635324024,-181460,true,13173050007,22,13044591017,-128458990
1635324179,-181455,true,13179637850,22,13138846271,-40791579
1635324213,-181462,true,13170415792,22,13151991032,-18424760
1635324269,-181473,true,13155937024,22,13173050007,17112983
1635324274,-181478,true,13149361028,22,13175684749,26323721
1635324380,-181472,true,13157252617,22,13207342784,50090167
1635324438,-181478,true,13149361028,22,13220556072,71195044
1635324476,-181490,true,13133592047,22,13223200315,89608268
1635324589,-181494,true,13128339923,22,13228490389,100150466
1635324606,-181488,true,13136218896,22,13228490389,92271493
1635324637,-181494,true,13128339923,22,13228490389,100150466
1635324646,-181503,true,13116530322,22,13225845087,109314765
1635324682,-181507,true,13111285022,22,13217912357,106627335
1635324686,-181500,true,13120465675,22,13217912357,97446682
1635324873,-181498,true,13123089899,22,13206022182,82932283
1635324905,-181508,true,13109974024,22,13202061167,92087143
1635324919,-181509,true,13108663158,22,13194142702,85479544
1635324942,-181508,true,13109974024,22,13191504269,81530245
1635324981,-181509,true,13108663158,22,13198101341,89438183
1635325067,-181517,true,13098180945,22,13213947776,115766831
1635325117,-181517,true,13098180945,22,13223200315,125019370
1635325159,-181515,true,13100800712,22,13225845087,125044375
1635325280,-181515,true,13100800712,22,13248347020,147546308
1635325350,-181522,true,13091633819,22,13266906767,175272948
1635325357,-181522,true,13091633819,22,13270887237,179253418
1635325496,-181524,true,13089015885,22,13282835814,193819929
1635325639,-181529,true,13082473340,22,13289478560,207005220
1635325706,-181538,true,13070704999,22,13288149745,217444746
1635325827,-181537,true,13072012069,22,13314751307,242739238
1635325880,-181538,true,13070704999,22,13317414391,246709392
1635325909,-181541,true,13066784571,22,13317414391,250629820
1635325913,-181545,true,13061559164,22,13317414391,255855227
1635325921,-181545,true,13061559164,22,13316082782,254523618
1635325930,-181547,true,13058947244,22,13316082782,257135538
1635326051,-181549,true,13056335846,22,13312088756,255752910
1635326116,-181559,true,13043286688,22,13284164097,240877409
1635326177,-181560,true,13041982490,22,13258949408,216966918
1635326199,-181563,true,13038070678,22,13250996822,212926144
1635326216,-181566,true,13034160039,22,13247022318,212862279
1635326312,-181574,true,13023737401,22,13204701711,180964310
1635326347,-181575,true,13022435158,22,13192823420,170388262
1635326357,-181579,true,13017227486,22,13192823420,175595934
1635326363,-181580,true,13015925893,22,13191504269,175578376
1635326387,-181583,true,13012021896,22,13184910496,172888600
1635326442,-181584,true,13010720824,22,13166465458,155744634
1635326521,-181587,true,13006818388,22,13138846271,132027883
1635326524,-181582,true,13013323098,22,13138846271,125523173
1635326599,-181579,true,13017227486,22,13116530322,99302836
1635326628,-181575,true,13022435158,22,13120465675,98030517
1635326632,-181573,true,13025039775,22,13119153760,94113985
1635326686,-181567,true,13032856753,22,13081165223,48308470
1635326711,-181564,true,13036767001,22,13060253139,23486138
1635326715,-181563,true,13038070678,22,13057641480,19570802
1635326754,-181559,true,13043286688,22,13031553598,-11733090
1635326777,-181561,true,13040678422,22,13023737401,-16941021
1635326781,-181558,true,13044591017,22,13021133045,-23457972
1635326834,-181561,true,13040678422,22,12979534093,-61144329
1635326860,-181557,true,13045895476,22,12971749097,-74146379
1635326982,-181564,true,13036767001,22,12892866209,-143900792
1635327092,-181563,true,13038070678,22,12842684458,-195386220
1635327137,-181564,true,13036767001,22,12836265042,-200501959
1635327186,-181561,true,13040678422,22,12838832423,-201845999
1635327275,-181564,true,13036767001,22,12837548668,-199218333
1635327337,-181558,true,13044591017,22,12843968726,-200622291
1635327370,-181555,true,13048504786,22,12847822302,-200682484
1635327431,-181549,true,13056335846,22,12851677034,-204658812
1635327484,-181551,true,13053724971,22,12851677034,-202047937
1635327516,-181554,true,13049809636,22,12841400318,-208409318
1635327537,-181556,true,13047200066,22,12834981543,-212218523
1635327582,-181551,true,13053724971,22,12842684458,-211040513
1635327594,-181548,true,13057641480,22,12846537649,-211103831
1635327600,-181540,true,13068091250,22,12847822302,-220268948
1635327640,-181541,true,13066784571,22,12858104158,-208680413
1635327860,-181533,true,13077241658,22,12939361845,-137879813
1635327881,-181531,true,13079857237,22,12945832820,-134024417
1635327920,-181530,true,13081165223,22,12956193111,-124972112
1635327959,-181534,true,13075934065,22,12969155136,-106778929
1635327993,-181529,true,13082473340,22,12983428342,-99044998
1635328033,-181528,true,13083781587,22,12986025158,-97756429
1635328066,-181526,true,13086398474,22,12987323760,-99074714
1635328138,-181540,true,13068091250,22,12939361845,-128729405
1635328290,-181532,true,13078549383,22,12961376366,-117173017
1635328413,-181532,true,13078549383,22,12958784480,-119764903
1635328458,-181531,true,13079857237,22,12960080358,-119776879
1635328585,-181543,true,13064171606,22,12958784480,-105387126
1635328662,-181541,true,13066784571,22,12951011930,-115772641
1635328756,-181544,true,13062865320,22,12951011930,-111853390
1635328826,-181541,true,13066784571,22,12963968771,-102815800
1635328839,-181554,true,13049809636,22,12963968771,-85840865
1635328844,-181548,true,13057641480,22,12963968771,-93672709
1635328898,-181550,true,13055030343,22,12971749097,-83281246
1635328915,-181545,true,13061559164,22,12974343577,-87215587
1635328938,-181557,true,13045895476,22,12976938575,-68956901
1635328978,-181552,true,13052419729,22,12989921355,-62498374
1635329077,-181554,true,13049809636,22,13038070678,-11738958
1635329192,-181546,true,13060253139,22,13057641480,-2611659
1635329236,-181556,true,13047200066,22,13073319270,26119204
1635329330,-181549,true,13056335846,22,13113907410,57571564
1635329338,-181548,true,13057641480,22,13117841975,60200495
1635329458,-181540,true,13068091250,22,13163832559,95741309
1635329538,-181550,true,13055030343,22,13192823420,137793077
1635329553,-181542,true,13065478023,22,13204701711,139223688
1635329705,-181543,true,13064171606,22,13273541547,209369941
1635329752,-181534,true,13075934065,22,13289478560,213544495
1635329849,-181542,true,13065478023,22,13332070873,266592850
1635329881,-181534,true,13075934065,22,13344074538,268140473
1635330025,-181537,true,13072012069,22,13374799693,302787624
1635330029,-181530,true,13081165223,22,13374799693,293634470
1635330092,-181541,true,13066784571,22,13376137173,309352602
1635330207,-181534,true,13075934065,22,13377474787,301540722
1635330272,-181537,true,13072012069,22,13384164862,312152793
1635330308,-181531,true,13079857237,22,13389519331,309662094
1635330397,-181541,true,13066784571,22,13400234697,333450126
1635330416,-181531,true,13079857237,22,13402914878,323057641
1635330502,-181531,true,13079857237,22,13401574720,321717483
1635330547,-181524,true,13089015885,22,13401574720,312558835
1635330646,-181537,true,13072012069,22,13390858283,318846214
1635330707,-181528,true,13083781587,22,13378812535,295030948
1635330811,-181530,true,13081165223,22,13384164862,302999639
1635330954,-181523,true,13090324786,22,13397555052,307230266
1635331036,-181534,true,13075934065,22,13409617676,333683611
1635331054,-181523,true,13090324786,22,13412299733,321974947
1635331083,-181524,true,13089015885,22,13416323825,327307940
1635331161,-181515,true,13100800712,22,13420349125,319548413
1635331263,-181524,true,13089015885,22,13421691160,332675275
1635331336,-181512,true,13104731345,22,13425718070,320986725
1635331362,-181511,true,13106041819,22,13425718070,319676251
1635331392,-181499,true,13121777722,22,13427060642,305282920
1635331424,-181507,true,13111285022,22,13427060642,315775620
1635331441,-181495,true,13127027220,22,13428403348,301376128
1635331511,-181487,true,13137532518,22,13467400286,329867768
1635331614,-181474,true,13154621561,22,13513265080,358643519
1635331672,-181481,true,13145417009,22,13529489920,384072911
1635331719,-181467,true,13163832559,22,13543025499,379192940
1635331860,-181461,true,13171732834,22,13579639244,407906410
1635331873,-181448,true,13188866364,22,13583713543,394847179
1635331895,-181458,true,13175684749,22,13590506758,414822009
1635331962,-181445,true,13192823420,22,13629974455,437151035
1635331969,-181431,true,13211305383,22,13634063856,422758473
1635331979,-181416,true,13231136219,22,13638154485,407018266
1635332044,-181417,true,13229813238,22,13677760553,447947315
1635332074,-181405,true,13245697748,22,13690075463,444377715
1635332095,-181392,true,13262927491,22,13705142078,442214587
1635332173,-181377,true,13282835814,22,13758693812,475857998
1635332231,-181372,true,13289478560,22,13806931195,517452635
1635332243,-181359,true,13306765252,22,13820744341,513979089
1635332267,-181340,true,13332070873,22,13845642838,513571965
1635332299,-181321,true,13357424619,22,13876135257,518710638
1635332379,-181320,true,13358760361,22,13917824080,559063719
1635332388,-181309,true,13373462347,22,13921999845,548537498
1635332428,-181294,true,13393536589,22,13942897469,549360880
1635332470,-181282,true,13409617676,22,13958242327,548624651
1635332478,-181281,true,13410958637,22,13959638152,548679515
1635332544,-181267,true,13429746188,22,14009980894,580234706
1635332631,-181250,true,13452595030,22,14075979480,623384450
1635332647,-181236,true,13471440910,22,14084427179,612986269
1635332711,-181236,true,13471440910,22,14118268706,646827796
1635332857,-181224,true,13487615533,22,14173434699,685819166
1635332943,-181210,true,13506510474,22,14190452179,683941705
1635332991,-181196,true,13525431884,22,14201808515,676376631
1635332994,-181196,true,13525431884,22,14201808515,676376631
1635333124,-181187,true,13537609643,22,14204649018,667039375
1635333175,-181173,true,13556574621,22,14190452179,633877558
1635333180,-181158,true,13576923723,22,14189033275,612109552
1635333228,-181158,true,13576923723,22,14186195894,609272171
1635333316,-181147,true,13591865809,22,14183359081,591493272
1635333337,-181133,true,13610906795,22,14183359081,572452286
1635333347,-181119,true,13629974455,22,14181940887,551966432
1635333378,-181112,true,13639518300,22,14180522834,541004534
1635333403,-181110,true,13642246340,22,14166350108,524103768
1635333491,-181098,true,13658626043,22,14116857020,458230977
1635333525,-181085,true,13676392914,22,14095698665,419305751
1635333572,-181083,true,13679128329,22,14078794817,399666488
1635333594,-181079,true,13684600802,22,14071757530,387156728
1635333630,-181069,true,13698291562,22,14060505189,362213627
1635333633,-181056,true,13716110030,22,14060505189,344395159
1635333723,-181053,true,13720225274,22,14039431294,319206020
1635333739,-181049,true,13725714188,22,14036623829,310909641
1635333766,-181039,true,13739446080,22,14032413684,292967604
1635333824,-181028,true,13754567030,22,14015585727,261018697
1635333848,-181026,true,13757318081,22,14007179318,249861237
1635333942,-181023,true,13761445689,22,13976398934,214953245
1635333964,-181013,true,13775213329,22,13969412830,194199501
1635333969,-181005,true,13786237357,22,13969412830,183175473
1635334084,-181003,true,13788994743,22,13937321704,148326961
1635334188,-181001,true,13791752679,22,13909476308,117723629
1635334246,-180994,true,13801409803,22,13894185060,92775257
1635334315,-180985,true,13813836041,22,13901133542,87297501
1635334323,-180983,true,13816598947,22,13901133542,84534595
1635334346,-180981,true,13819362405,22,13902523656,83161251
1635334359,-180974,true,13829038861,22,13902523656,73484795
1635334480,-180967,true,13838722093,22,13915040933,76318840
1635334512,-180967,true,13838722093,22,13917824080,79101987
1635334542,-180964,true,13842874125,22,13917824080,74949955
1635334556,-180956,true,13853952301,22,13917824080,63871779
1635334609,-180948,true,13865039342,22,13926176863,61137521
1635334615,-180945,true,13869199270,22,13927569480,58370210
1635334675,-180940,true,13876135257,22,13934534658,58399401
1635334709,-180932,true,13887240051,22,13940109308,52869257
1635334755,-180927,true,13894185060,22,13941503319,47318259
1635334791,-180925,true,13896964036,22,13942897469,45933433
1635334982,-180924,true,13898353732,22,13945686188,47332456
1635335031,-180918,true,13906694830,22,13930355133,23660303
1635335043,-180913,true,13913649568,22,13927569480,13919912
1635335074,-180910,true,13917824080,22,13924784384,6960304
1635335098,-180913,true,13913649568,22,13921999845,8350277
1635335166,-180905,true,13924784384,22,13910867255,-13917129
1635335180,-180900,true,13931748169,22,13906694830,-25053339
1635335201,-180899,true,13933141344,22,13898353732,-34787612
1635335223,-180903,true,13927569480,22,13891406640,-36162840
1635335266,-180893,true,13941503319,22,13890017638,-51485681
1635335325,-180887,true,13949870312,22,13887240051,-62630261
1635335394,-180884,true,13954055692,22,13884463020,-69592672
1635335428,-180887,true,13949870312,22,13885851466,-64018846
1635335535,-180877,true,13963826462,22,13874747782,-89078680
1635335628,-180871,true,13972206853,22,13862266750,-109940103
1635335708,-180870,true,13973604073,22,13860880662,-112723411
1635335828,-180873,true,13969412830,22,13859494713,-109918117
1635335850,-180869,true,13975001434,22,13858108902,-116892532
1635335917,-180865,true,13980592273,22,13866425846,-114166427
1635335954,-180865,true,13980592273,22,13873360446,-107231827
1635335976,-180869,true,13975001434,22,13874747782,-100253652
1635335987,-180864,true,13981990332,22,13874747782,-107242550
1635336113,-180859,true,13988982725,22,13896964036,-92018689
1635336255,-180859,true,13988982725,22,13887240051,-101742674
1635336295,-180866,true,13979194353,22,13883074712,-96119641
1635336340,-180865,true,13980592273,22,13877522870,-103069403
1635336366,-180861,true,13986185349,22,13874747782,-111437567
1635336378,-180864,true,13981990332,22,13874747782,-107242550
1635336387,-180868,true,13976398934,22,13873360446,-103038488
1635336453,-180866,true,13979194353,22,13874747782,-104446571
1635336494,-180863,true,13983388531,22,13878910623,-104477908
1635336518,-180868,true,13976398934,22,13876135257,-100263677
1635336526,-180876,true,13965222844,22,13877522870,-87699974
1635336546,-180874,true,13968016029,22,13880298514,-87717515
1635336609,-180875,true,13966619367,22,13888628775,-77990592
1635336661,-180876,true,13965222844,22,13895574479,-69648365
1635336692,-180883,true,13955451098,22,13896964036,-58487062
1635336694,-180881,true,13958242327,22,13896964036,-61278291
1635336864,-180880,true,13959638152,22,13913649568,-45988584
1635336888,-180882,true,13956846643,22,13916432437,-40414206
1635336892,-180893,true,13941503319,22,13916432437,-25070882
1635336939,-180892,true,13942897469,22,13923392045,-19505424
1635336949,-180891,true,13944291759,22,13927569480,-16722279
1635337045,-180888,true,13948475465,22,13958242327,9766862
1635337053,-180896,true,13937321704,22,13958242327,20920623
1635337069,-180893,true,13941503319,22,13961034115,19530796
1635337089,-180892,true,13942897469,22,13965222844,22325375
1635337108,-180892,true,13942897469,22,13969412830,26515361
1635337158,-180899,true,13933141344,22,13981990332,48848988
1635337215,-180895,true,13938715436,22,13997378214,58662778
1635337246,-180894,true,13940109308,22,14004378303,64268995
1635337291,-180895,true,13938715436,22,14015585727,76870291
1635337344,-180902,true,13928962237,22,14018388985,89426748
1635337363,-180898,true,13934534658,22,14025399581,90864923
1635337383,-180895,true,13938715436,22,14031010583,92295147
1635337448,-180895,true,13938715436,22,14039431294,100715858
1635337451,-180897,true,13935928111,22,14039431294,103503183
1635337503,-180890,true,13945686188,22,14054882392,109196204
1635337625,-180888,true,13948475465,22,14077387078,128911613
1635337657,-180886,true,13951265299,22,14085835622,134570323
1635337690,-180888,true,13948475465,22,14095698665,147223200
1635337702,-180879,true,13961034115,22,14105568615,144534500
1635337761,-180875,true,13966619367,22,14125329252,158709885
1635337808,-180875,true,13966619367,22,14133806569,167187202
1635337910,-180878,true,13962430219,22,14135219950,172789731
1635337917,-180872,true,13970809772,22,14136633472,165823700
1635337952,-180868,true,13976398934,22,14136633472,160234538
1635337995,-180867,true,13977796574,22,14140874886,163078312
1635338093,-180872,true,13970809772,22,14138047135,167237363
1635338116,-180865,true,13980592273,22,14136633472,156041199
1635338123,-180861,true,13986185349,22,14138047135,151861786
1635338184,-180863,true,13983388531,22,14129567275,146178744
1635338189,-180869,true,13975001434,22,14129567275,154565841
1635338289,-180865,true,13980592273,22,14101337791,120745518
1635338365,-180861,true,13986185349,22,14092879949,106694600
1635338407,-180863,true,13983388531,22,14081610716,98222185
1635338412,-180870,true,13973604073,22,14080202696,106598623
1635338425,-180865,true,13980592273,22,14077387078,96794805
1635338457,-180861,true,13986185349,22,14068943601,82758252
1635338465,-180865,true,13980592273,22,14066130234,85537961
1635338527,-180872,true,13970809772,22,14045047909,74238137
1635338532,-180868,true,13976398934,22,14043643544,67244610
1635338538,-180866,true,13979194353,22,14042239320,63044967
1635338585,-180869,true,13975001434,22,14028204801,53203367
1635338633,-180875,true,13966619367,22,14011381892,44762525
1635338680,-180871,true,13972206853,22,13998777952,26571099
1635338696,-180865,true,13980592273,22,14000177829,19585556
1635338815,-180868,true,13976398934,22,13975001434,-1397500
1635338876,-180872,true,13970809772,22,13963826462,-6983310
1635338958,-180868,true,13976398934,22,13941503319,-34895615
1635339004,-180863,true,13983388531,22,13930355133,-53033398
1635339012,-180867,true,13977796574,22,13928962237,-48834337
1635339023,-180869,true,13975001434,22,13926176863,-48824571
1635339042,-180866,true,13979194353,22,13924784384,-54409969
1635339072,-180860,true,13987583967,22,13921999845,-65584122
1635339120,-180863,true,13983388531,22,13923392045,-59996486
1635339136,-180864,true,13981990332,22,13923392045,-58598287
1635339166,-180863,true,13983388531,22,13923392045,-59996486
1635339191,-180859,true,13988982725,22,13921999845,-66982880
1635339214,-180864,true,13981990332,22,13919215863,-62774469
1635339238,-180867,true,13977796574,22,13915040933,-62755641
1635339300,-180866,true,13979194353,22,13902523656,-76670697
1635339415,-180859,true,13988982725,22,13919215863,-69766862
1635339501,-180863,true,13983388531,22,13924784384,-58604147
1635339546,-180865,true,13980592273,22,13923392045,-57200228
1635339752,-180861,true,13986185349,22,13948475465,-37709884
1635339791,-180853,true,13997378214,22,13956846643,-40531571
1635339847,-180855,true,13994579158,22,13979194353,-15384805
1635339863,-180856,true,13993179840,22,13986185349,-6994491
1635339923,-180852,true,13998777952,22,14005778741,7000789
1635339970,-180846,true,14007179318,22,14014184309,7004991
1635339980,-180848,true,14004378303,22,14015585727,11207424
1635340017,-180850,true,14001577847,22,14016987286,15409439
1635340047,-180848,true,14004378303,22,14019790824,15412521
1635340058,-180841,true,14014184309,22,14021192803,7008494
1635340083,-180843,true,14011381892,22,14026802121,15420229
1635340121,-180845,true,14008580036,22,14036623829,28043793
1635340164,-180842,true,14012783031,22,14052071837,39288806
1635340251,-180836,true,14021192803,22,14073164706,51971903
1635340273,-180837,true,14019790824,22,14075979480,56188656
1635340397,-180838,true,14018388985,22,14091470801,73081816
1635340407,-180836,true,14021192803,22,14095698665,74505862
1635340430,-180830,true,14029607622,22,14102747924,73140302
1635340460,-180831,true,14028204801,22,14111211689,83006888
1635340504,-180829,true,14031010583,22,14116857020,85846437
1635340551,-180827,true,14033816925,22,14122504610,88687685
1635340555,-180821,true,14042239320,22,14121092501,78853181
1635340584,-180823,true,14039431294,22,14122504610,83073316
1635340665,-180822,true,14040835237,22,14128154459,87319222
1635340748,-180823,true,14039431294,22,14121092501,81661207
1635340784,-180819,true,14045047909,22,14119680533,74632624
1635340858,-180824,true,14038027491,22,14119680533,81653042
1635340878,-180824,true,14038027491,22,14121092501,83065010
1635340893,-180824,true,14038027491,22,14126741785,88714294
1635340944,-180816,true,14049261845,22,14149361532,100099687
1635341032,-180813,true,14053477045,22,14186195894,132718849
1635341062,-180812,true,14054882392,22,14196129211,141246819
1635341097,-180812,true,14054882392,22,14208910839,154028447
1635341117,-180804,true,14066130234,22,14217438317,151308083
1635341137,-180801,true,14070350495,22,14223126146,152775651
1635341176,-180800,true,14071757530,22,14233085321,161327791
1635341210,-180799,true,14073164706,22,14250174421,177009715
1635341219,-180792,true,14083018877,22,14255875346,172856469
1635341241,-180787,true,14090061795,22,14267284038,177222243
1635341291,-180786,true,14091470801,22,14291557834,200087033
1635341310,-180787,true,14090061795,22,14295845730,205783935
1635341352,-180780,true,14099927798,22,14305855825,205928027
1635341400,-180776,true,14105568615,22,14325897047,220328432
1635341447,-180773,true,14109800709,22,14353140762,243340053
1635341500,-180773,true,14109800709,22,14381874331,272073622
1635341554,-180768,true,14116857020,22,14412106488,295249468
1635341568,-180762,true,14125329252,22,14419313983,293984731
1635341603,-180759,true,14129567275,22,14442402197,312834922
1635341619,-180758,true,14130980232,22,14453960163,322979931
1635341636,-180752,true,14139460940,22,14465527379,326066439
1635341651,-180747,true,14146532084,22,14472761590,326229506
1635341663,-180741,true,14155022126,22,14481447418,326425292
1635341684,-180739,true,14157853272,22,14497384977,339531705
1635341703,-180731,true,14169183519,22,14510437844,341254325
1635341727,-180724,true,14179104924,22,14524954813,345849889
1635341751,-180716,true,14190452179,22,14548212179,357760000
1635341778,-180711,true,14197548824,22,14570049779,372500955
1635341798,-180703,true,14208910839,22,14581709900,372799061
1635341823,-180695,true,14220281947,22,14596298173,376016226
1635341866,-180690,true,14227393510,22,14606518647,379125137
1635341903,-180687,true,14231662155,22,14616746278,385084123
1635341936,-180679,true,14243051471,22,14625518519,382467048
1635341945,-180670,true,14255875346,22,14628443769,372568423
1635342022,-180665,true,14263004709,22,14637223030,374218321
1635342062,-180663,true,14265857453,22,14646007559,380150106
1635342088,-180656,true,14275846549,22,14648936907,373090358
1635342109,-180648,true,14287271224,22,14650401801,363130577
1635342142,-180647,true,14288699951,22,14644543105,355843154
1635342160,-180646,true,14290128821,22,14644543105,354414284
1635342172,-180639,true,14300134913,22,14644543105,344408192
1635342203,-180632,true,14310148011,22,14646007559,335859548
1635342230,-180629,true,14314441485,22,14648936907,334495422
1635342244,-180626,true,14318736247,22,14650401801,331665554
1635342267,-180618,true,14330195246,22,14650401801,320206555
1635342281,-180608,true,14344531891,22,14651866841,307334950
1635342307,-180602,true,14353140762,22,14654797361,301656599
1635342309,-180599,true,14357447135,22,14654797361,297350226
1635342314,-180592,true,14367500364,22,14654797361,287296997
1635342317,-180582,true,14381874331,22,14654797361,272923030
1635342417,-180563,true,14409224499,22,14712059797,302835298
1635342488,-180559,true,14414989054,22,14753309224,338320170
1635342538,-180550,true,14427967735,22,14787279187,359311452
1635342592,-180538,true,14445290821,22,14824291781,379000960
1635342595,-180519,true,14472761590,22,14827256788,354495198
1635342608,-180513,true,14481447418,22,14836155366,354707948
1635342620,-180506,true,14491587472,22,14845059285,353471813
1635342624,-180495,true,14507536191,22,14848028446,340492255
1635342632,-180476,true,14535125332,22,14852483300,317357968
1635342642,-180473,true,14539486306,22,14856939490,317453184
1635342654,-180467,true,14548212179,22,14861397018,313184839
1635342668,-180458,true,14561310808,22,14867342468,306031660
1635342696,-180442,true,14584626387,22,14877752731,293126344
1635342738,-180439,true,14589002213,22,14900084988,311082775
1635342771,-180431,true,14600677500,22,14929913485,329235985
1635342810,-180420,true,14616746278,22,14964290085,347543807
1635342827,-180400,true,14646007559,22,14979261111,333253552
1635342863,-180394,true,14654797361,22,15007747336,352949975
1635342906,-180386,true,14666525303,22,15048320975,381795672
1635342911,-180376,true,14681198430,22,15051330790,370132360
1635342920,-180358,true,14707647062,22,15060363847,352716785
1635342940,-180353,true,14715002356,22,15081462066,366459710
1635343004,-180342,true,14731196954,22,15154023464,422826510
1635343059,-180332,true,14745934782,22,15217801013,471866231
1635343075,-180315,true,14771022936,22,15233025664,462002728
1635343114,-180310,true,14778409924,22,15271153962,492744038
1635343133,-180302,true,14790236791,22,15287960633,497723842
1635343135,-180294,true,14802073123,22,15289489429,487416306
1635343160,-180279,true,14824291781,22,15313970968,489679187
1635343185,-180274,true,14831705410,22,15336958011,505252601
1635343218,-180263,true,14848028446,22,15364588014,516559568
1635343267,-180255,true,14859911027,22,15379959518,520048491
1635343269,-180239,true,14883704725,22,15379959518,496254793
1635343316,-180233,true,14892637180,22,15389189801,496552621
1635343356,-180224,true,14906045916,22,15393807020,487761104
1635343365,-180217,true,14916483279,22,15393807020,477323741
1635343412,-180200,true,14941861597,22,15401505463,459643866
1635343478,-180194,true,14950828956,22,15412289751,461460795
1635343534,-180188,true,14959801696,22,15413830980,454029284
1635343586,-180186,true,14962793806,22,15421539437,458745631
1635343625,-180170,true,14986752240,22,15432337754,445585514
1635343629,-180165,true,14994247115,22,15433880988,439633873
1635343644,-180157,true,15006246712,22,15440055466,433808754
1635343704,-180151,true,15015252711,22,15453957076,438704365
1635343712,-180132,true,15043807382,22,15455502472,411695090
1635343741,-180129,true,15048320975,22,15460139586,411818611
1635343766,-180122,true,15058857961,22,15464778092,405920131
1635343771,-180119,true,15063376070,22,15466324569,402948499
1635343789,-180103,true,15087495556,22,15466324569,378829013
1635343804,-180100,true,15092022257,22,15467871202,375848945
1635343812,-180094,true,15101079735,22,15467871202,366791467
1635343847,-180090,true,15107121073,22,15466324569,359203496
1635343866,-180074,true,15131310604,22,15469417989,338107385
1635343910,-180069,true,15138877772,22,15478701961,339824189
1635343970,-180060,true,15152508213,22,15511239761,358731548
1635344012,-180054,true,15161601992,22,15532969617,371367625
1635344045,-180037,true,15187397345,22,15554729915,367332570
1635344050,-180030,true,15198031713,22,15556285388,358253675
1635344054,-180022,true,15210194395,22,15560952741,350758346
1635344080,-180011,true,15226933977,22,15584310516,357376539
1635344088,-179990,true,15258942535,22,15592104230,333161695
1635344094,-179984,true,15268100190,22,15593663440,325563250
1635344120,-179979,true,15275735767,22,15607703352,331967585
1635344178,-179971,true,15287960633,22,15649898980,361938347
1635344220,-179951,true,15318565619,22,15689070713,370505094
1635344231,-179946,true,15326226434,22,15700056358,373829924
1635344267,-179942,true,15332357844,22,15725195297,392837453
1635344295,-179936,true,15341559559,22,15744075913,402516354
1635344310,-179915,true,15373809072,22,15755100073,381291001
1635344358,-179908,true,15384573967,22,15786640226,402066259
1635344377,-179902,true,15393807020,22,15799273959,405466939
1635344410,-179895,true,15404585918,22,15824571766,419985848
1635344429,-179873,true,15438511615,22,15840403460,401891845
1635344439,-179864,true,15452411835,22,15848325246,395913411
1635344448,-179858,true,15461685600,22,15854665527,392979927
1635344476,-179849,true,15475606684,22,15881640032,406033348
1635344566,-179837,true,15494187630,22,15875288964,381101334
1635344621,-179830,true,15505036815,22,15875288964,370252149
1635344648,-179824,true,15514342164,22,15878464180,364122016
1635344656,-179817,true,15525205462,22,15878464180,353258718
1635344675,-179804,true,15545400343,22,15881640032,336239689
1635344709,-179801,true,15550064429,22,15878464180,328399751
1635344714,-179797,true,15556285388,22,15878464180,322178792
1635344723,-179790,true,15567178055,22,15878464180,311286125
1635344736,-179781,true,15581194121,22,15878464180,297270059
1635344785,-179768,true,15601461831,22,15889582440,288120609
1635344827,-179766,true,15604582280,22,15880052027,275469747
1635344857,-179761,true,15612386131,22,15867353700,254967569
1635344864,-179763,true,15609264122,22,15865767123,256503001
1635344871,-179754,true,15623318081,22,15864180705,240862624
1635344891,-179753,true,15624880413,22,15857836619,232956206
1635344927,-179748,true,15632694415,22,15846740572,214046157
1635344938,-179751,true,15628005545,22,15845156057,217150512
1635344990,-179740,true,15645204949,22,15827736838,182531889
1635345066,-179738,true,15648334146,22,15813498995,165164849
1635345079,-179733,true,15656159879,22,15808755894,152596015
1635345125,-179735,true,15653029116,22,15792955829,139926713
1635345190,-179725,true,15668689191,22,15780327148,111637957
1635345220,-179725,true,15668689191,22,15766131952,97442761
1635345230,-179719,true,15678092755,22,15761403059,83310304
1635345246,-179721,true,15674957607,22,15755100073,80142466
1635345255,-179713,true,15687501963,22,15751949526,64447563
1635345269,-179713,true,15687501963,22,15745650321,58148358
1635345296,-179708,true,15695347283,22,15734632773,39285490
1635345317,-179711,true,15690639620,22,15729913327,39273707
1635345362,-179706,true,15698486509,22,15706337322,7850813
1635345373,-179706,true,15698486509,22,15696916817,-1569692
1635345379,-179701,true,15706337322,22,15696916817,-9420505
1635345423,-179706,true,15698486509,22,15696916817,-1569692
1635345460,-179701,true,15706337322,22,15704766846,-1570476
1635345470,-179705,true,15700056358,22,15703196526,3140168
1635345490,-179700,true,15707907956,22,15700056358,-7851598
1635345491,-179705,true,15700056358,22,15700056358,0
1635345496,-179703,true,15703196526,22,15698486509,-4710017
1635345498,-179703,true,15703196526,22,15700056358,-3140168
1635345523,-179688,true,15726767816,22,15706337322,-20430494
1635345528,-179692,true,15720478682,22,15707907956,-12570726
1635345568,-179686,true,15729913327,22,15726767816,-3145511
1635345620,-179691,true,15722050729,22,15745650321,23599592
1635345682,-179678,true,15742501663,22,15740927570,-1574093
1635345723,-179683,true,15734632773,22,15742501663,7868890
1635345774,-179676,true,15745650321,22,15756675583,11025262
1635345839,-179679,true,15740927570,22,15769285336,28357766
1635345841,-179663,true,15766131952,22,15769285336,3153384
1635345875,-179668,true,15758251251,22,15762979199,4727948
1635345919,-179664,true,15764555497,22,15755100073,-9455424
1635345924,-179669,true,15756675583,22,15753524721,-3150862
1635345936,-179654,true,15780327148,22,15750374488,-29952660
1635345999,-179667,true,15759827076,22,15706337322,-53489754
1635346024,-179666,true,15761403059,22,15695347283,-66055776
1635346034,-179672,true,15751949526,22,15692208684,-59740842
1635346064,-179664,true,15764555497,22,15667122479,-97433018
1635346072,-179679,true,15740927570,22,15660857196,-80070374
1635346106,-179681,true,15737779857,22,15637384693,-100395164
1635346107,-179688,true,15726767816,22,15635821111,-90946705
1635346132,-179676,true,15745650321,22,15628005545,-117644776
1635346166,-179688,true,15726767816,22,15612386131,-114381685
1635346173,-179687,true,15728340493,22,15609264122,-119076371
1635346193,-179693,true,15718906791,22,15603021977,-115884814
1635346206,-179681,true,15737779857,22,15595222806,-142557051
1635346262,-179690,true,15723622935,22,15590545175,-133077760
1635346285,-179692,true,15720478682,22,15585868947,-134609735
1635346290,-179701,true,15706337322,22,15585868947,-120468375
1635346294,-179691,true,15722050729,22,15584310516,-137740213
1635346309,-179705,true,15700056358,22,15582752241,-117304117
1635346314,-179708,true,15695347283,22,15582752241,-112595042
1635346376,-179719,true,15678092755,22,15560952741,-117140014
1635346393,-179714,true,15685933370,22,15556285388,-129647982
1635346407,-179731,true,15659291267,22,15554729915,-104561352
1635346433,-179733,true,15656159879,22,15542291729,-113868150
1635346440,-179738,true,15648334146,22,15537629974,-110704172
1635346471,-179731,true,15659291267,22,15517445187,-141846080
1635346511,-179749,true,15631131302,22,15503486467,-127644835
1635346545,-179751,true,15628005545,22,15498836351,-129169194
1635346565,-179755,true,15621755905,22,15495737049,-126018856
1635346578,-179745,true,15637384693,22,15494187630,-143197063
1635346586,-179760,true,15613947370,22,15494187630,-119759740
1635346634,-179756,true,15620193886,22,15503486467,-116707419
1635346641,-179760,true,15613947370,22,15501936273,-112011097
1635346675,-179753,true,15624880413,22,15491089257,-133791156
1635346702,-179769,true,15599901841,22,15480249831,-119652010
1635346737,-179771,true,15596782329,22,15469417989,-127364340
1635346773,-179776,true,15588986276,22,15457048022,-131938254
1635346783,-179770,true,15598342007,22,15455502472,-142839535
1635346815,-179775,true,15590545175,22,15449321816,-141223359
1635346822,-179776,true,15588986276,22,15447777038,-141209238
1635346835,-179778,true,15585868947,22,15447777038,-138091909
1635346843,-179771,true,15596782329,22,15450866748,-145915581
1635346875,-179776,true,15588986276,22,15464778092,-124208184
1635346901,-179772,true,15595222806,22,15480249831,-114972975
1635346907,-179772,true,15595222806,22,15481797856,-113424950
1635346920,-179764,true,15607703352,22,15486442860,-121260492
1635346953,-179765,true,15606142738,22,15508137978,-98004760
1635346980,-179770,true,15598342007,22,15531416475,-66925532
1635346987,-179770,true,15598342007,22,15536076366,-62265641
1635347006,-179758,true,15617070316,22,15559396801,-57673515
1635347021,-179757,true,15618632023,22,15574963201,-43668822
1635347029,-179758,true,15617070316,22,15579636157,-37434159
1635347065,-179759,true,15615508765,22,15603021977,-12486788
1635347078,-179748,true,15632694415,22,15617070316,-15624099
1635347131,-179741,true,15643640585,22,15681228531,37587946
1635347182,-179741,true,15643640585,22,15734632773,90992188
1635347198,-179741,true,15643640585,22,15750374488,106733903
1635347212,-179732,true,15657725495,22,15761403059,103677564
1635347285,-179727,true,15665555923,22,15849910079,184354156
1635347289,-179727,true,15665555923,22,15854665527,189109604
1635347292,-179725,true,15668689191,22,15859422403,190733212
1635347351,-179715,true,15684364933,22,15908660430,224295497
1635347375,-179710,true,15692208684,22,15932540132,240331448
1635347403,-179709,true,15693777905,22,15959647129,265869224
1635347421,-179709,true,15693777905,22,15969225312,275447407
1635347429,-179700,true,15707907956,22,15974016558,266108602
1635347439,-179696,true,15714192062,22,15983603365,269411303
1635347472,-179694,true,15717335057,22,16005994960,288659903
1635347505,-179692,true,15720478682,22,16020406119,299927437
1635347532,-179684,true,15733059467,22,16026815243,293755776
1635347539,-179678,true,15742501663,22,16028417925,285916262
1635347560,-179677,true,15744075913,22,16044453557,300377644
1635347580,-179675,true,15747224886,22,16060505233,313280347
1635347600,-179665,true,15762979199,22,16078180624,315201425
1635347673,-179658,true,15774016595,22,16144233178,370216583
1635347701,-179653,true,15781905181,22,16170083333,388178152
1635347750,-179655,true,15778749273,22,16187879321,409130048
1635347760,-179654,true,15780327148,22,16192736170,412409022
1635347772,-179652,true,15783483372,22,16197594477,414111105
1635347792,-179653,true,15781905181,22,16208936195,427031014
1635347843,-179645,true,15794535125,22,16239760907,445225782
1635347866,-179643,true,15797694190,22,16246257786,448563596
1635347894,-179638,true,15805594617,22,16259259342,453664725
1635347909,-179638,true,15805594617,22,16262511356,456916739
1635347914,-179632,true,15815080345,22,16262511356,447431011
1635347915,-179629,true,15819825343,22,16262511356,442686013
1635347958,-179623,true,15829319612,22,16285293677,455974065
1635347992,-179620,true,15834068883,22,16290179753,456110870
1635347995,-179613,true,15845156057,22,16290179753,445023696
1635347997,-179609,true,15851495070,22,16290179753,438684683
1635348049,-179592,true,15878464180,22,16295067296,416603116
1635348054,-179584,true,15891171399,22,16296696803,405525404
1635348066,-179576,true,15903888786,22,16299956305,396067519
1635348086,-179568,true,15916616351,22,16306477266,389860915
1635348095,-179549,true,15946885155,22,16311369698,364484543
1635348101,-179538,true,15964435502,22,16314632135,350196633
1635348128,-179528,true,15980407123,22,16329321179,348914056
1635348160,-179523,true,15988398925,22,16340755133,352356208
1635348180,-179506,true,16015600959,22,16348927145,333326186
1635348186,-179497,true,16030020766,22,16352197094,322176328
1635348188,-179487,true,16046058003,22,16352197094,306139091
1635348216,-179481,true,16055688045,22,16370193507,314505462
1635348288,-179468,true,16076572967,22,16412809256,336236289
1635348349,-179458,true,16092656776,22,16457181498,364524722
1635348385,-179449,true,16107145962,22,16480236534,373090572
1635348397,-179444,true,16115201146,22,16486829618,371628472
1635348401,-179428,true,16141004815,22,16485181100,344176285
1635348421,-179423,true,16149076932,22,16490127148,341050216
1635348450,-179412,true,16166849801,22,16513228338,346378537
1635348499,-179406,true,16176552336,22,16536361891,359809555
1635348515,-179391,true,16200834158,22,16538015527,337181369
1635348545,-179385,true,16210557089,22,16552905696,342348607
1635348559,-179377,true,16223530074,22,16561183805,337653731
1635348577,-179372,true,16231643462,22,16571123000,339479538
1635348610,-179354,true,16260885268,22,16587701582,326816314
1635348623,-179350,true,16267390597,22,16599316457,331925860
1635348649,-179341,true,16282037107,22,16630883559,348846452
1635348672,-179336,true,16290179753,22,16652516684,362336931
1635348693,-179318,true,16319527014,22,16669176697,349649683
1635348773,-179322,true,16313000835,22,16705887417,392886582
1635348796,-179315,true,16324423362,22,16719256805,394833443
1635348856,-179308,true,16335853887,22,16751051999,415198112
1635348889,-179289,true,16366919960,22,16764457532,397537572
1635348904,-179286,true,16371830527,22,16771164321,399333794
1635348914,-179278,true,16384932576,22,16774518722,389586146
1635348937,-179269,true,16399684915,22,16782907659,383222744
1635348953,-179248,true,16434158715,22,16792979921,358821206
1635348963,-179245,true,16439089455,22,16791300791,352211336
1635349020,-179245,true,16439089455,22,16776196174,337106719
1635349024,-179238,true,16450600271,22,16774518722,323918451
1635349025,-179222,true,16476940981,22,16774518722,297577741
1635349035,-179221,true,16478588675,22,16772841438,294252763
1635349062,-179221,true,16478588675,22,16767810591,289221916
1635349064,-179214,true,16490127148,22,16767810591,277683443
1635349078,-179200,true,16513228338,22,16764457532,251229194
1635349090,-179199,true,16514879661,22,16766133978,251254317
1635349108,-179195,true,16521486604,22,16762781254,241294650
1635349113,-179192,true,16526443546,22,16762781254,236337708
1635349148,-179176,true,16552905696,22,16766133978,213228282
1635349154,-179177,true,16551250571,22,16767810591,216560020
1635349166,-179171,true,16561183805,22,16767810591,206626786
1635349178,-179168,true,16566152657,22,16766133978,199981321
1635349206,-179161,true,16577752443,22,16762781254,185028811
1635349210,-179165,true,16571123000,22,16762781254,191658254
1635349250,-179169,true,16564496207,22,16739330952,174834745
1635349270,-179163,true,16574437390,22,16742678986,168241596
1635349294,-179154,true,16589360352,22,16746027689,156667337
1635349320,-179155,true,16587701582,22,16759429201,171727619
1635349332,-179155,true,16587701582,22,16757753425,170051843
1635349362,-179155,true,16587701582,22,16741004885,153303303
1635349366,-179147,true,16600976388,22,16739330952,138354564
1635349405,-179151,true,16594337658,22,16732636893,138299235
1635349442,-179148,true,16599316457,22,16732636893,133320436
1635349461,-179145,true,16604296750,22,16729290868,124994118
1635349471,-179137,true,16617584837,22,16727618106,110033269
1635349494,-179137,true,16617584837,22,16729290868,111706031
1635349505,-179135,true,16620908520,22,16727618106,106709586
1635349529,-179134,true,16622570611,22,16719256805,96686194
1635349534,-179125,true,16637536910,22,16715913456,78376546
1635349564,-179130,true,16629220637,22,16700876653,71656016
1635349598,-179128,true,16632546647,22,16685853376,53306729
1635349665,-179127,true,16634209902,22,16674177950,39968048
1635349686,-179118,true,16649186680,22,16677512952,28326272
1635349724,-179121,true,16644192923,22,16674177950,29985027
1635349738,-179115,true,16654181936,22,16672510699,18328763
1635349776,-179110,true,16662510693,22,16667509946,4999253
1635349796,-179099,true,16680848621,22,16664176944,-16671677
1635349824,-179102,true,16675845368,22,16655847354,-19998014
1635349854,-179102,true,16675845368,22,16645857343,-29988025
1635349877,-179097,true,16684184958,22,16650851599,-33333359
1635349879,-179087,true,16700876653,22,16652516684,-48359969
1635349912,-179088,true,16699206732,22,16662510693,-36696039
1635349958,-179088,true,16699206732,22,16672510699,-26696033
1635350045,-179086,true,16702546740,22,16660844608,-41702132
1635350088,-179078,true,16715913456,22,16650851599,-65061857
1635350113,-179081,true,16710899684,22,16649186680,-61713004
1635350123,-179082,true,16709228761,22,16652516684,-56712077
1635350137,-179081,true,16710899684,22,16655847354,-55052330
1635350164,-179078,true,16715913456,22,16649186680,-66726776
1635350180,-179084,true,16705887417,22,16640864584,-65022833
1635350202,-179087,true,16700876653,22,16629220637,-71656016
1635350258,-179088,true,16699206732,22,16617584837,-81621895
1635350292,-179089,true,16697536978,22,16610939465,-86597513
1635350305,-179095,true,16687521962,22,16609278537,-78243425
1635350326,-179098,true,16682516706,22,16602636486,-79880220
1635350340,-179100,true,16679180703,22,16594337658,-84843045
1635350375,-179103,true,16674177950,22,16572780112,-101397838
1635350386,-179111,true,16660844608,22,16564496207,-96348401
1635350415,-179115,true,16654181936,22,16547940818,-106241118
1635350442,-179122,true,16642528670,22,16526443546,-116085124
1635350475,-179131,true,16627557881,22,16495074681,-132483200
1635350525,-179143,true,16607617775,22,16437445711,-170172064
1635350532,-179150,true,16595997091,22,16430872376,-165124715
1635350557,-179155,true,16587701582,22,16414450537,-173251045
1635350575,-179162,true,16576094834,22,16396405470,-179689364
1635350579,-179163,true,16574437390,22,16393126681,-181310709
1635350649,-179167,true,16567809272,22,16339121221,-228688051
1635350667,-179173,true,16557872065,22,16326055804,-231816261
1635350708,-179175,true,16554560987,22,16311369698,-243191289
1635350754,-179177,true,16551250571,22,16293437952,-257812619
1635350757,-179178,true,16549595612,22,16290179753,-259415859
1635350862,-179179,true,16547940818,22,16267390597,-280550221
1635350879,-179182,true,16542977428,22,16267390597,-275586831
1635350960,-179185,true,16538015527,22,16226774942,-311240585
1635351101,-179190,true,16529749000,22,16186260695,-343488305
1635351125,-179194,true,16523138753,22,16186260695,-336878058
1635351194,-179200,true,16513228338,22,16183023928,-330204410
1635351203,-179200,true,16513228338,22,16181405787,-331822551
1635351237,-179203,true,16508275361,22,16178169992,-330105369
1635351278,-179208,true,16500023699,22,16186260695,-313763004
1635351346,-179217,true,16485181100,22,16192736170,-292444930
1635351477,-179214,true,16490127148,22,16321158967,-168968181
1635351487,-179217,true,16485181100,22,16324423362,-160757738
1635351508,-179221,true,16478588675,22,16342389209,-136199466
1635351532,-179228,true,16467058276,22,16357103244,-109955032
1635351625,-179220,true,16480236534,22,16409527187,-70709347
1635351639,-179216,true,16486829618,22,16414450537,-72379081
1635351675,-179219,true,16481884558,22,16425944100,-55940458
1635351710,-179222,true,16476940981,22,16432515463,-44425518
1635351737,-179214,true,16490127148,22,16435802131,-54325017
1635351779,-179213,true,16491776161,22,16437445711,-54330450
1635351866,-179216,true,16486829618,22,16478588675,-8240943
1635351868,-179220,true,16480236534,22,16478588675,-1647859
1635351881,-179215,true,16488478301,22,16483532746,-4945555
1635351952,-179217,true,16485181100,22,16500023699,14842599
1635351958,-179223,true,16475293452,22,16500023699,24730247
1635351968,-179230,true,16463765358,22,16504974201,41208843
1635352003,-179222,true,16476940981,22,16529749000,52808019
1635352111,-179216,true,16486829618,22,16615923245,129093627
1635352158,-179222,true,16476940981,22,16650851599,173910618
1635352189,-179226,true,16470351852,22,16669176697,198824845
1635352237,-179220,true,16480236534,22,16697536978,217300444
1635352250,-179211,true,16495074681,22,16710899684,215825003
1635352276,-179220,true,16480236534,22,16714242031,234005497
1635352290,-179224,true,16473646087,22,16722600824,248954737
1635352322,-179211,true,16495074681,22,16744353253,249278572
1635352330,-179207,true,16501673701,22,16749377062,247703361
1635352335,-179208,true,16500023699,22,16751051999,251028300
1635352340,-179209,true,16498373861,22,16754402377,256028516
1635352365,-179197,true,16518182802,22,16766133978,247951176
1635352402,-179191,true,16528096190,22,16789621829,261525639
1635352432,-179193,true,16524791067,22,16806419008,281627941
1635352454,-179195,true,16521486604,22,16813142584,291655980
1635352471,-179184,true,16539669329,22,16818187031,278517702
1635352484,-179180,true,16546286189,22,16819868850,273582661
1635352496,-179182,true,16542977428,22,16823232992,280255564
1635352561,-179184,true,16539669329,22,16840063797,300394468
1635352580,-179170,true,16562839923,22,16848485514,285645591
1635352586,-179166,true,16569466053,22,16848485514,279019461
1635352616,-179168,true,16566152657,22,16863655217,297502560
1635352632,-179170,true,16562839923,22,16870401691,307561768
1635352685,-179161,true,16577752443,22,16883902737,306150294
1635352729,-179157,true,16584384539,22,16902484319,318099780
1635352763,-179162,true,16576094834,22,16916011040,339916206
1635352808,-179165,true,16571123000,22,16932934666,361811666
1635352835,-179155,true,16587701582,22,16944791276,357089694
1635352880,-179157,true,16584384539,22,16932934666,348550127
1635352945,-179163,true,16574437390,22,16922778460,348341070
1635352964,-179166,true,16569466053,22,16919394412,349928359
1635352969,-179157,true,16584384539,22,16917702641,333318102
1635352971,-179154,true,16589360352,22,16917702641,328342289
1635352992,-179162,true,16576094834,22,16907555572,331460738
1635353132,-179163,true,16574437390,22,16917702641,343265251
1635353172,-179154,true,16589360352,22,16914319608,324959256
1635353193,-179151,true,16594337658,22,16907555572,313217914
1635353227,-179157,true,16584384539,22,16890657312,306272773
1635353234,-179158,true,16582726266,22,16888968415,306242149
1635353278,-179148,true,16599316457,22,16873775940,274459483
1635353303,-179144,true,16605957179,22,16858597132,252639953
1635353354,-179150,true,16595997091,22,16828280467,232283376
1635353382,-179151,true,16594337658,22,16813142584,218804926
1635353406,-179141,true,16610939465,22,16804738534,193799069
1635353416,-179137,true,16617584837,22,16801378091,183793254
1635353433,-179141,true,16610939465,22,16798018319,187078854
1635353437,-179136,true,16619246596,22,16798018319,178771723
1635353446,-179124,true,16639200664,22,16796338685,157138021
1635353455,-179118,true,16649186680,22,16792979921,143793241
1635353465,-179121,true,16644192923,22,16787943035,143750112
1635353501,-179115,true,16654181936,22,16767810591,113628655
1635353528,-179100,true,16679180703,22,16749377062,70196359
1635353529,-179092,true,16692528719,22,16749377062,56848343
1635353551,-179095,true,16687521962,22,16742678986,55157024
1635353599,-179089,true,16697536978,22,16727618106,30081128
1635353607,-179080,true,16712570774,22,16722600824,10030050
1635353614,-179075,true,16720928731,22,16720928731,0
1635353640,-179079,true,16714242031,22,16709228761,-5013270
1635353656,-179078,true,16715913456,22,16700876653,-15036803
1635353675,-179070,true,16729290868,22,16694197972,-35092896
1635353685,-179067,true,16734310157,22,16690859633,-43450524
1635353701,-179077,true,16717585047,22,16685853376,-31731671
1635353708,-179077,true,16717585047,22,16682516706,-35068341
1635353713,-179067,true,16734310157,22,16680848621,-53461536
1635353728,-179062,true,16742678986,22,16677512952,-65166034
1635353732,-179068,true,16732636893,22,16675845368,-56791525
1635353742,-179067,true,16734310157,22,16677512952,-56797205
1635353756,-179059,true,16747702292,22,16679180703,-68521589
1635353767,-179054,true,16756077818,22,16682516706,-73561112
1635353785,-179060,true,16746027689,22,16684184958,-61842731
1635353798,-179056,true,16752727105,22,16679180703,-73546402
1635353803,-179053,true,16757753425,22,16675845368,-81908057
1635353813,-179048,true,16766133978,22,16674177950,-91956028
1635353841,-179054,true,16756077818,22,16669176697,-86901121
1635353932,-179052,true,16759429201,22,16665843361,-93585840
1635353961,-179054,true,16756077818,22,16655847354,-100230464
1635354000,-179051,true,16761105144,22,16644192923,-116912221
1635354018,-179056,true,16752727105,22,16639200664,-113526441
1635354043,-179057,true,16751051999,22,16637536910,-113515089
1635354067,-179058,true,16749377062,22,16627557881,-121819181
1635354138,-179056,true,16752727105,22,16600976388,-151750717
1635354179,-179062,true,16742678986,22,16589360352,-153318634
1635354191,-179063,true,16741004885,22,16586042977,-154961908
1635354216,-179064,true,16739330952,22,16577752443,-161578509
1635354252,-179059,true,16747702292,22,16579410218,-168292074
1635354328,-179059,true,16747702292,22,16581068159,-166634133
1635354355,-179061,true,16744353253,22,16574437390,-169915863
1635354377,-179064,true,16739330952,22,16572780112,-166550840
1635354395,-179069,true,16730963797,22,16569466053,-161497744
1635354406,-179072,true,16725945511,22,16567809272,-158136239
1635354460,-179075,true,16720928731,22,16556216443,-164712288
1635354488,-179077,true,16717585047,22,16549595612,-167989435
1635354495,-179078,true,16715913456,22,16547940818,-167972638
1635354532,-179080,true,16712570774,22,16538015527,-174555247
1635354561,-179086,true,16702546740,22,16526443546,-176103194
1635354594,-179096,true,16685853376,22,16518182802,-167670574
1635354612,-179097,true,16684184958,22,16513228338,-170956620
1635354668,-179103,true,16674177950,22,16495074681,-179103269
1635354676,-179108,true,16665843361,22,16491776161,-174067200
1635354696,-179116,true,16652516684,22,16485181100,-167335584
1635354712,-179120,true,16645857343,22,16476940981,-168916362
1635354734,-179127,true,16634209902,22,16468704982,-165504920
1635354776,-179132,true,16625895291,22,16444021675,-181873616
1635354821,-179141,true,16610939465,22,16414450537,-196488928
1635354873,-179143,true,16607617775,22,16399684915,-207932860
1635354877,-179148,true,16599316457,22,16398045111,-201271346
1635354883,-179153,true,16591019288,22,16394765994,-196253294
1635354885,-179160,true,16579410218,22,16394765994,-184644224
1635354889,-179164,true,16572780112,22,16393126681,-179653431
1635354892,-179171,true,16561183805,22,16391487532,-169696273
1635354897,-179177,true,16551250571,22,16389848547,-161402024
1635354948,-179181,true,16544631726,22,16366919960,-177711766
1635354972,-179182,true,16542977428,22,16373467710,-169509718
1635354984,-179190,true,16529749000,22,16365283431,-164465569
1635354992,-179196,true,16519834621,22,16362010865,-157823756
1635355032,-179203,true,16508275361,22,16342389209,-165886152
1635355092,-179199,true,16514879661,22,16334220465,-180659196
1635355118,-179204,true,16506624698,22,16339121221,-167503477
1635355130,-179208,true,16500023699,22,16340755133,-159268566
1635355157,-179209,true,16498373861,22,16344023448,-154350413
1635355187,-179203,true,16508275361,22,16348927145,-159348216
1635355203,-179203,true,16508275361,22,16350562038,-157713323
1635355214,-179209,true,16498373861,22,16348927145,-149446716
1635355247,-179211,true,16495074681,22,16350562038,-144512643
1635355269,-179208,true,16500023699,22,16350562038,-149461661
1635355370,-179211,true,16495074681,22,16353832314,-141242367
1635355395,-179216,true,16486829618,22,16355467697,-131361921
1635355411,-179218,true,16483532746,22,16357103244,-126429502
1635355444,-179215,true,16488478301,22,16365283431,-123194870
1635355445,-179216,true,16486829618,22,16366919960,-119909658
1635355462,-179218,true,16483532746,22,16373467710,-110065036
1635355465,-179219,true,16481884558,22,16375105056,-106779502
1635355490,-179215,true,16488478301,22,16380018079,-108460222
1635355544,-179213,true,16491776161,22,16414450537,-77325624
1635355554,-179217,true,16485181100,22,16421017302,-64163798
1635355576,-179220,true,16480236534,22,16430872376,-49364158
1635355587,-179214,true,16490127148,22,16439089455,-51037693
1635355626,-179215,true,16488478301,22,16452245331,-36232970
1635355637,-179216,true,16486829618,22,16458827216,-28002402
1635355717,-179214,true,16490127148,22,16518182802,28055654
1635355751,-179208,true,16500023699,22,16538015527,37991828
1635355774,-179207,true,16501673701,22,16551250571,49576870
1635355782,-179209,true,16498373861,22,16556216443,57842582
1635355788,-179209,true,16498373861,22,16561183805,62809944
1635355801,-179203,true,16508275361,22,16569466053,61190692
1635355871,-179204,true,16506624698,22,16597656691,91031993
1635355874,-179206,true,16503323868,22,16599316457,95992589
1635355905,-179207,true,16501673701,22,16620908520,119234819
1635355976,-179203,true,16508275361,22,16649186680,140911319
1635356012,-179201,true,16511577181,22,16675845368,164268187
1635356019,-179201,true,16511577181,22,16679180703,167603522
1635356286,-179196,true,16519834621,22,16814823898,294989277
1635356318,-179190,true,16529749000,22,16829963295,300214295
1635356335,-179189,true,16531401975,22,16838379959,306977984
1635356368,-179190,true,16529749000,22,16848485514,318736514
1635356424,-179187,true,16534708420,22,16858597132,323888712
1635356426,-179181,true,16544631726,22,16858597132,313965406
1635356446,-179181,true,16544631726,22,16856911441,312279715
1635356455,-179182,true,16542977428,22,16856911441,313934013
1635356466,-179180,true,16546286189,22,16858597132,312310943
1635356552,-179175,true,16554560987,22,16868714820,314153833
1635356571,-179177,true,16551250571,22,16860282992,309032421
1635356581,-179181,true,16544631726,22,16860282992,315651266
1635356609,-179177,true,16551250571,22,16863655217,312404646
1635356610,-179172,true,16559527852,22,16863655217,304127365
1635356618,-179170,true,16562839923,22,16863655217,300815294
1635356666,-179172,true,16559527852,22,16868714820,309186968
1635356699,-179167,true,16567809272,22,16875463318,307654046
1635356705,-179159,true,16581068159,22,16877150864,296082705
1635356816,-179154,true,16589360352,22,16936321422,346961070
1635356839,-179154,true,16589360352,22,16949875222,360514870
1635356858,-179148,true,16599316457,22,16961743695,362427238
1635356893,-179142,true,16609278537,22,16971923286,362644749
1635356930,-179139,true,16614261819,22,16975317840,361056021
1635356958,-179140,true,16612600559,22,16975317840,362717281
1635356977,-179135,true,16620908520,22,16973620478,352711958
1635356986,-179129,true,16630883559,22,16973620478,342736919
1635357010,-179125,true,16637536910,22,16973620478,336083568
1635357026,-179123,true,16640864584,22,16975317840,334453256
1635357042,-179119,true,16647521928,22,16971923286,324401358
1635357057,-179112,true,16659178690,22,16971923286,312744596
1635357121,-179104,true,16672510699,22,16990601739,318091040
1635357152,-179101,true,16677512952,22,16990601739,313088787
1635357162,-179095,true,16687521962,22,16990601739,303079777
1635357209,-179089,true,16697536978,22,16995699429,298162451
1635357238,-179082,true,16709228761,22,17000798649,291569888
1635357248,-179079,true,16714242031,22,17004198978,289956947
1635357256,-179073,true,16724273084,22,17005899398,281626314
1635357295,-179066,true,16735983588,22,17016105489,280121901
1635357307,-179059,true,16747702292,22,17017807100,270104808
1635357333,-179056,true,16752727105,22,17024615244,271888139
1635357372,-179052,true,16759429201,22,17024615244,265186043
1635357376,-179047,true,16767810591,22,17026317705,258507114
1635357400,-179039,true,16781229536,22,17031426111,250196575
1635357406,-179037,true,16784585950,22,17033129254,248543304
1635357459,-179029,true,16798018319,22,17056991141,258972822
1635357515,-179023,true,16808099650,22,17068934618,260834968
1635357523,-179015,true,16821550837,22,17068934618,247383781
1635357542,-179014,true,16823232992,22,17067227895,243994903
1635357595,-179008,true,16833329456,22,17075763216,242433760
1635357637,-179003,true,16841747804,22,17079178539,237430735
1635357736,-178994,true,16856911441,22,17068934618,212023177
1635357768,-178992,true,16860282992,22,17063814961,203531969
1635357792,-178985,true,16872088731,22,17045056022,172967291
1635357821,-178982,true,16877150864,22,17033129254,155978390
1635357916,-178978,true,16883902737,22,17022912952,139010215
1635357940,-178978,true,16883902737,22,17017807100,133904363
1635357999,-178975,true,16888968415,22,16985505577,96537162
1635358002,-178979,true,16882214516,22,16983807197,101592681
1635358013,-178978,true,16883902737,22,16977015372,93112635
1635358028,-178979,true,16882214516,22,16966832727,84618211
1635358068,-178976,true,16887279687,22,16951570210,64290523
1635358102,-178976,true,16887279687,22,16939708856,52429169
1635358135,-178972,true,16894035612,22,16927855801,33820189
1635358156,-178973,true,16892346377,22,16916011040,23664663
1635358205,-178968,true,16900794240,22,16895725015,-5069225
1635358225,-178970,true,16897414588,22,16883902737,-13511851
1635358272,-178964,true,16907555572,22,16892346377,-15209195
1635358275,-178965,true,16905864985,22,16892346377,-13518608
1635358292,-178959,true,16916011040,22,16894035612,-21975428
1635358368,-178958,true,16917702641,22,16880526463,-37176178
1635358399,-178957,true,16919394412,22,16878838579,-40555833
1635358424,-178959,true,16916011040,22,16878838579,-37172461
1635358472,-178953,true,16926163185,22,16875463318,-50699867
1635358507,-178956,true,16921086351,22,16865341583,-55744768
1635358533,-178951,true,16929548587,22,16856911441,-72637146
1635358547,-178953,true,16926163185,22,16853540565,-72622620
1635358563,-178951,true,16929548587,22,16851855379,-77693208
1635358604,-178954,true,16924470738,22,16843431979,-81038759
1635358636,-178950,true,16931241541,22,16838379959,-92861582
1635358695,-178953,true,16926163185,22,16848485514,-77677671
1635358719,-178950,true,16931241541,22,16846800833,-84440708
1635358821,-178953,true,16926163185,22,16829963295,-96199890
1635358831,-178949,true,16932934666,22,16828280467,-104654199
1635358884,-178952,true,16927855801,22,16826597807,-101257994
1635358899,-178947,true,16936321422,22,16831646291,-104675131
1635358917,-178948,true,16934627959,22,16838379959,-96248000
1635358960,-178943,true,16943096967,22,16858597132,-84499835
1635358989,-178942,true,16944791276,22,16872088731,-72702545
1635359017,-178943,true,16943096967,22,16883902737,-59194230
1635359127,-178946,true,16938015054,22,16927855801,-10159253
1635359166,-178943,true,16943096967,22,16910937252,-32159715
1635359169,-178942,true,16944791276,22,16910937252,-33854024
1635359204,-178942,true,16944791276,22,16904174568,-40616708
1635359216,-178950,true,16931241541,22,16902484319,-28757222
1635359222,-178945,true,16939708856,22,16899104329,-40604527
1635359234,-178942,true,16944791276,22,16902484319,-42306957
1635359261,-178935,true,16956656189,22,16910937252,-45718937
1635359262,-178940,true,16948180404,22,16910937252,-37243152
1635359285,-178933,true,16960047690,22,16914319608,-45728082
1635359347,-178926,true,16971923286,22,16954960693,-16962593
1635359357,-178919,true,16983807197,22,16958351855,-25455342
1635359397,-178926,true,16971923286,22,16968529410,-3393876
1635359432,-178924,true,16975317840,22,16973620478,-1697362
1635359457,-178922,true,16978713073,22,16978713073,0
1635359481,-178916,true,16988902848,22,16980410945,-8491903
1635359507,-178922,true,16978713073,22,16997398999,18685926
1635359518,-178922,true,16978713073,22,16997398999,18685926
1635359547,-178919,true,16983807197,22,17011001678,27194481
1635359592,-178913,true,16994000029,22,17022912952,28912923
1635359605,-178921,true,16980410945,22,17026317705,45906760
1635359609,-178921,true,16980410945,22,17026317705,45906760
1635359632,-178920,true,16982108986,22,17034832567,52723581
1635359653,-178914,true,16992300799,22,17041647522,49346723
1635359688,-178922,true,16978713073,22,17051875067,73161994
1635359711,-178920,true,16982108986,22,17058696840,76587854
1635359728,-178920,true,16982108986,22,17063814961,81705975
1635359747,-178913,true,16994000029,22,17075763216,81763187
1635359779,-178917,true,16987204128,22,17101394798,114190670
1635359871,-178916,true,16988902848,22,17137343663,148440815
1635359911,-178914,true,16992300799,22,17144199628,151898829
1635359931,-178908,true,17002498729,22,17144199628,141700899
1635359948,-178913,true,16994000029,22,17145914048,151914019
1635359963,-178912,true,16995699429,22,17147628640,151929211
1635360031,-178905,true,17007599988,22,17197426445,189826457
1635360051,-178897,true,17021210831,22,17216353075,195142244
1635360077,-178902,true,17012702778,22,17230130979,217428201
1635360132,-178902,true,17012702778,22,17255994275,243291497
1635360174,-178899,true,17017807100,22,17259445647,241638547
1635360181,-178890,true,17033129254,22,17261171591,228042337
1635360218,-178893,true,17028020337,22,17252543594,224523257
1635360242,-178891,true,17031426111,22,17259445647,228019536
1635360285,-178886,true,17039943528,22,17268077096,228133568
1635360323,-178882,true,17046760528,22,17278440532,231680004
1635360362,-178886,true,17039943528,22,17281896393,241952865
1635360375,-178886,true,17039943528,22,17285352945,245409417
1635360423,-178882,true,17046760528,22,17281896393,235135865
1635360480,-178879,true,17051875067,22,17276712861,224837794
1635360482,-178884,true,17043351687,22,17276712861,233361174
1635360490,-178884,true,17043351687,22,17276712861,233361174
1635360499,-178880,true,17050170050,22,17276712861,226542811
1635360516,-178876,true,17056991141,22,17276712861,219721720
1635360521,-178879,true,17051875067,22,17278440532,226565465
1635360575,-178869,true,17068934618,22,17311299132,242364514
1635360619,-178870,true,17067227895,22,17299186069,231958174
1635360679,-178866,true,17074055810,22,17293997351,219941541
1635360684,-178868,true,17070641511,22,17293997351,223355840
1635360726,-178860,true,17084302805,22,17280168377,195865572
1635360744,-178857,true,17089428608,22,17274985363,185556755
1635360775,-178853,true,17096265405,22,17268077096,171811691
1635360795,-178856,true,17091137551,22,17266350461,175212910
1635360847,-178844,true,17111658200,22,17285352945,173694745
1635360862,-178840,true,17118503890,22,17290539070,172035180
1635360933,-178837,true,17123639955,22,17254268848,130628893
1635360966,-178840,true,17118503890,22,17243919910,125416020
1635360991,-178830,true,17135630100,22,17259445647,123815547
1635361015,-178825,true,17144199628,22,17273258037,129058409
1635361058,-178818,true,17156204169,22,17297456323,141252154
1635361095,-178815,true,17161351545,22,17337284266,175932721
1635361110,-178803,true,17181956497,22,17354629354,172672857
1635361117,-178796,true,17193987475,22,17361572247,167584772
1635361135,-178784,true,17214631612,22,17368517918,153886306
1635361168,-178783,true,17216353075,22,17391110543,174757468
1635361205,-178771,true,17237024066,22,17424183409,187159343
1635361273,-178765,true,17247368866,22,17488769068,241400202
1635361290,-178753,true,17268077096,22,17504515258,236438162
1635361302,-178752,true,17269803903,22,17516772095,246968192
1635361361,-178736,true,17297456323,22,17606331337,308875014
1635361416,-178727,true,17313030262,22,17682197764,369167502
1635361431,-178714,true,17335550711,22,17694579017,359028306
1635361487,-178711,true,17340751896,22,17749514571,408762675
1635361510,-178695,true,17368517918,22,17799280363,430762445
1635361562,-178681,true,17392849654,22,17895651627,502801973
1635361570,-178666,true,17418957199,22,17913555334,494598135
1635361582,-178660,true,17429411187,22,17933270100,503858913
1635361614,-178646,true,17453828230,22,17994343931,540515701
1635361625,-178634,true,17474784347,22,18019552394,544768047
1635361642,-178621,true,17497515202,22,18053820375,556305173
1635361671,-178612,true,17513269266,22,18111682236,598412970
1635361672,-178594,true,17544819960,22,18113493405,568673445
1635361705,-178587,true,17557105019,22,18162463468,605358449
1635361711,-178574,true,17579942955,22,18166096143,586153188
1635361718,-178566,true,17594011833,22,18175181007,581169174
1635361742,-178545,true,17630996229,22,18215208418,584212189
1635361785,-178538,true,17643341629,22,18286382872,643041243
1635361802,-178530,true,17657461244,22,18319326355,661865111
1635361812,-178522,true,17671592158,22,18341321641,669729483
1635361832,-178504,true,17703428076,22,18376201534,672773458
1635361858,-178502,true,17706968938,22,18422197208,715228270
1635361861,-178494,true,17721139472,22,18427724420,706584948
1635361896,-178486,true,17735321347,22,18468308010,732986663
1635361901,-178468,true,17767272075,22,18473849057,706576982
1635361917,-178460,true,17781490868,22,18488633310,707142442
1635361991,-178447,true,17804620681,22,18573872661,769251980
1635362008,-178436,true,17824215559,22,18596173571,771958012
1635362045,-178416,true,17859897877,22,18644584109,784686232
1635362059,-178411,true,17868829612,22,18653908265,785078653
1635362092,-178395,true,17897441192,22,18696859482,799418290
1635362106,-178384,true,17917138224,22,18715564757,798426533
1635362116,-178366,true,17949416500,22,18726796904,777380404
1635362126,-178354,true,17970967651,22,18745532130,774564479
1635362132,-178337,true,18001542749,22,18754906771,753364022
1635362184,-178323,true,18026761296,22,18843257877,816496581
1635362186,-178304,true,18061042986,22,18847026717,785983731
1635362208,-178293,true,18080920070,22,18875317056,794396986
1635362219,-178277,true,18109871249,22,18888533742,778662493
1635362244,-178266,true,18129802071,22,18918778073,788976002
1635362270,-178250,true,18158831520,22,18954756121,795924601
1635362289,-178236,true,18184270416,22,18990802588,806532172
1635362302,-178218,true,18217029939,22,19011702919,794672980
1635362319,-178206,true,18238902402,22,19034529514,795627112
1635362326,-178184,true,18279070148,22,19051667445,772597297
1635362333,-178173,true,18299187181,22,19074542024,775354843
1635362338,-178151,true,18339487692,22,19091715981,752228289
1635362344,0,false,0,0,19106994700,19106994700
1635362355,-178113,true,18409306827,22,19118461763,709154936
1635362379,-178103,true,18427724420,22,19168231949,740507529
1635362388,-178082,true,18466461364,22,19189327550,722866186
1635362405,-178058,true,18510831876,22,19214288648,703456772
1635362420,-178043,true,18538617569,22,19245054578,706437009
1635362436,-178030,true,18562732237,22,19277797357,715065120
1635362452,-178010,true,18599892992,22,19302873536,702980544
1635362460,0,false,0,0,19320253073,19320253073
1635362489,0,false,0,0,19370548572,19370548572
1635362499,-177951,true,18709951210,22,19387989041,678037831
1635362519,0,false,0,0,19420975003,19420975003
1635362526,-177899,true,18807491465,22,19430687433,623195968
1635362532,-177882,true,18839489791,22,19442348760,602858969
1635362552,0,false,0,0,19479322488,19479322488
1635362557,0,false,0,0,19491013004,19491013004
1635362561,0,false,0,0,19498810579,19498810579
1635362587,0,false,0,0,19567172561,19567172561
1635362598,0,false,0,0,19600463379,19600463379
1635362615,0,false,0,0,19663282178,19663282178
1635362621,0,false,0,0,19680986212,19680986212
1635362639,0,false,0,0,19742088875,19742088875
1635362647,0,false,0,0,19763816034,19763816034
1635362668,0,false,0,0,19823193535,19823193535
1635362675,0,false,0,0,19839057641,19839057641
1635362679,0,false,0,0,19850964052,19850964052
1635362685,0,false,0,0,19866850383,19866850383
1635362703,-177546,true,19483218547,22,19910603377,427384830
1635362718,-177515,true,19543707210,22,19946472942,402765732
1635362737,-177501,true,19571086192,22,19996399010,425312818
1635362763,-177482,true,19608304741,22,20064499066,456194325
1635362768,-177464,true,19643629706,22,20080556284,436926578
1635362814,-177445,true,19680986212,22,20187260414,506274202
1635362827,-177437,true,19696736513,22,20203415876,506679363
1635362833,-177423,true,19724329875,22,20209477507,485147632
1635362838,-177411,true,19748012094,22,20215540956,467528862
1635362870,-177393,true,19783588746,22,20270193932,486605186
1635362905,-177387,true,19795461867,22,20298590657,503128790
1635362907,-177372,true,19825175854,22,20298590657,473414803
1635362930,-177359,true,19850964052,22,20320930274,469966222
1635362939,-177342,true,19884737702,22,20339226429,454488727
1635362992,-177333,true,19902641126,22,20424826534,522185408
1635363003,-177322,true,19924544981,22,20435040990,510496009
1635363014,-177310,true,19948467589,22,20443216233,494748644
1635363025,-177296,true,19976413604,22,20449349811,472936207
1635363077,-177304,true,19960439663,22,20437084494,476644831
1635363081,-177300,true,19968425036,22,20435040990,466615954
1635363097,-177293,true,19982407128,22,20426869017,444461889
1635363101,-177287,true,19994399570,22,20426869017,432469447
1635363116,-177297,true,19974416163,22,20424826534,450410371
1635363141,-177300,true,19968425036,22,20392174573,423749537
1635363184,-177283,true,20002398529,22,20398292837,395894308
1635363196,-177278,true,20012401729,22,20386058144,373656415
1635363206,-177291,true,19986403809,22,20377905759,391501950
1635363211,-177283,true,20002398529,22,20375868172,373469643
1635363222,-177274,true,20020407891,22,20369756634,349348743
1635363239,-177263,true,20042441354,22,20335159194,292717840
1635363246,-177277,true,20014402969,22,20329059866,314656897
1635363255,-177267,true,20034426381,22,20337192710,302766329
1635363261,-177259,true,20050459533,22,20329059866,278600333
1635363268,-177250,true,20068512166,22,20320930274,252418108
1635363296,-177251,true,20066505516,22,20322962367,256456851
1635363312,-177239,true,20090598571,22,20322962367,232363796
1635363333,-177226,true,20116732025,22,20314835214,198103189
1635363349,-177212,true,20144913764,22,20314835214,169921450
1635363363,-177214,true,20140885385,22,20306711311,165825926
1635363400,-177207,true,20154988235,22,20280331057,125342822
1635363423,-177201,true,20167084252,22,20264114090,97029838
1635363437,-177194,true,20181205447,22,20247910092,66704645
1635363476,-177201,true,20167084252,22,20189279140,22194888
1635363498,-177192,true,20185241890,22,20161035336,-24206554
1635363534,-177188,true,20193317198,22,20086581054,-106736144
1635363546,-177178,true,20213519604,22,20064499066,-149020538
1635363552,-177181,true,20207456761,22,20054469825,-152986936
1635363587,-177180,true,20209477507,22,19996399010,-213078497
1635363698,-177184,true,20201395736,22,19807342114,-394053622
1635363702,-177177,true,20215540956,22,19801401099,-414139857
1635363726,-177183,true,20203415876,22,19763816034,-439599842
1635363734,-177180,true,20209477507,22,19765792415,-443685092
1635363760,-177184,true,20201395736,22,19742088875,-459306861
1635363772,-177178,true,20213519604,22,19728274938,-485244666
1635363794,-177180,true,20209477507,22,19718413760,-491063747
1635363806,-177184,true,20201395736,22,19712499418,-488896318
1635363811,-177190,true,20189279140,22,19710528366,-478750774
1635363813,-177183,true,20203415876,22,19708557510,-494858366
1635363848,-177198,true,20173134982,22,19643629706,-529505276
1635363870,-177208,true,20152972938,22,19606344106,-546628832
1635363878,-177220,true,20128805082,22,19594584416,-534220666
1635363884,-177229,true,20110698213,22,19584790063,-525908150
1635363895,-177231,true,20106676676,22,19565216040,-541460636
1635363905,-177234,true,20100645879,22,19557391909,-543253970
1635363911,-177241,true,20086581054,22,19557391909,-529189145
1635363929,-177249,true,20070519018,22,19537845270,-532673748
1635363934,-177257,true,20054469825,22,19535891681,-518578144
1635363938,-177263,true,20042441354,22,19537845270,-504596084
1635363977,-177270,true,20028417255,22,19533938287,-494478968
1635364033,-177279,true,20010400689,22,19555436366,-454964323
1635364048,-177283,true,20002398529,22,19573043300,-429355229
1635364074,-177287,true,19994399570,22,19565216040,-429183530
1635364095,-177293,true,19982407128,22,19563259714,-419147414
1635364123,-177296,true,19976413604,22,19586748542,-389665062
1635364146,-177302,true,19964431950,22,19594584416,-369847534
1635364161,-177307,true,19954452728,22,19596543875,-357908853
1635364190,-177317,true,19934509246,22,19573043300,-361465946
1635364217,-177323,true,19922552726,22,19557391909,-365160817
1635364245,-177335,true,19898661195,22,19530032085,-368629110
1635364260,-177346,true,19876785795,22,19516366529,-360419266
1635364302,-177360,true,19848979154,22,19498810579,-350168575
1635364321,-177368,true,19833107114,22,19491013004,-342094110
1635364332,-177389,true,19791503368,22,19483218547,-308284821
1635364346,-177400,true,19769745771,22,19479322488,-290423283
1635364363,-177409,true,19751961893,22,19481270420,-270691473
1635364399,-177410,true,19749986895,22,19481270420,-268716475
1635364408,-177422,true,19726302308,22,19475427208,-250875100
1635364423,-177433,true,19704616389,22,19467638984,-236977405
1635364432,-177439,true,19692797756,22,19463746040,-229051716
1635364442,-177447,true,19677050605,22,19457908084,-219142521
1635364446,-177458,true,19655418831,22,19455962488,-199456343
1635364502,-177473,true,19625959276,22,19430687433,-195271843
1635364510,-177481,true,19610265571,22,19426801878,-183463693
1635364514,-177485,true,19602423426,22,19428744558,-173678868
1635364525,-177493,true,19586748542,22,19426801878,-159946664
1635364554,-177495,true,19582831779,22,19442348760,-140483019
1635364558,-177498,true,19576958105,22,19444292995,-132665110
1635364614,-177498,true,19576958105,22,19473479860,-103478245
1635364632,-177502,true,19569129279,22,19477374751,-91754528
1635364683,-177506,true,19561303583,22,19481270420,-80033163
1635364712,-177509,true,19555436366,22,19485166869,-70269497
1635364719,-177509,true,19555436366,22,19491013004,-64423362
1635364730,-177520,true,19533938287,22,19502710536,-31227751
1635364741,-177523,true,19528079277,22,19512463842,-15615435
1635364767,-177529,true,19516366529,22,19526126665,9760136
1635364797,-177529,true,19516366529,22,19537845270,21478741
1635364809,-177523,true,19528079277,22,19537845270,9765993
1635364844,-177523,true,19528079277,22,19557391909,29312632
1635364857,-177525,true,19524174247,22,19563259714,39085467
1635364871,-177521,true,19531985088,22,19565216040,33230952
1635364897,-177517,true,19539799054,22,19557391909,17592855
1635364919,-177515,true,19543707210,22,19555436366,11729156
1635364930,-177528,true,19518318166,22,19557391909,39073743
1635364946,-177524,true,19526126665,22,19545661580,19534915
1635364954,-177518,true,19537845270,22,19539799054,1953784
1635364966,-177523,true,19528079277,22,19531985088,3905811
1635364987,-177528,true,19518318166,22,19522222025,3903859
1635365036,-177526,true,19522222025,22,19491013004,-31209021
1635365066,-177523,true,19528079277,22,19471532707,-56546570
1635365068,-177532,true,19510512790,22,19471532707,-38980083
1635365070,-177536,true,19502710536,22,19469585748,-33124788
1635365098,-177543,true,19489064098,22,19436517222,-52546876
1635365110,-177557,true,19461799860,22,19420975003,-40824857
1635365170,-177574,true,19428744558,22,19326049729,-102694829
1635365180,-177584,true,19409326495,22,19308664977,-100661518
1635365215,-177589,true,19399624743,22,19283581275,-116043468
1635365219,-177603,true,19372485627,22,19277797357,-94688270
1635365235,-177611,true,19356994610,22,19260456012,-96538598
1635365274,-177623,true,19333781308,22,19179735763,-154045545
1635365279,-177633,true,19314458156,22,19172065787,-142392369
1635365311,-177642,true,19297083832,22,19118461763,-178622069
1635365346,-177651,true,19279725137,22,19068820806,-210904331
1635365367,-177661,true,19260456012,22,19045953088,-214502924
1635365384,-177673,true,19237358481,22,19023112793,-214245688
1635365440,-177685,true,19214288648,22,18950965738,-263322910
1635365451,-177688,true,19208525515,22,18937705367,-270820148
1635365484,-177692,true,19200844025,22,18875317056,-325526969
1635365492,-177702,true,19181653737,22,18862109617,-319544120
1635365498,-177711,true,19164398877,22,18852681391,-311717486
1635365506,-177716,true,19154819552,22,18841373740,-313445812
1635365534,-177719,true,19149074255,22,18798090539,-350983716
1635365557,-177727,true,19133761887,22,18771792940,-361968947
1635365620,-177754,true,19082172986,22,18605473518,-476699468
1635365621,-177758,true,19074542024,22,18603613157,-470928867
1635365628,-177764,true,19063101304,22,18585019771,-478081533
1635365649,-177781,true,19030723180,22,18533057096,-497666084
1635365669,-177802,true,18990802588,22,18477544011,-513258577
1635365680,-177804,true,18987004997,22,18449849856,-537155141
1635365690,-177809,true,18977514342,22,18427724420,-549789922
1635365699,-177828,true,18941493097,22,18403785139,-537707958
1635365702,-177849,true,18901759683,22,18394586007,-507173676
1635365715,-177852,true,18896090289,22,18359671219,-536419070
1635365722,-177860,true,18880980217,22,18341321641,-539658576
1635365741,-177873,true,18856452116,22,18295527893,-560924223
1635365774,-177894,true,18816897091,22,18226140276,-590756815
1635365800,-177895,true,18815015590,22,18178816225,-636199365
1635365810,-177901,true,18803730530,22,18166096143,-637634387
1635365820,-177914,true,18779302784,22,18153384960,-625917824
1635365826,-177934,true,18741783586,22,18144310990,-597472596
1635365830,-177929,true,18751156352,22,18137055080,-614101272
1635365833,-177936,true,18738035791,22,18133428213,-604607578
1635365840,-177958,true,18696859482,22,18120739889,-576119593
1635365867,-177979,true,18657639233,22,18084536435,-573102798
1635365877,-177975,true,18665103409,22,18070075314,-595028095
1635365882,-177981,true,18653908265,22,18062849090,-591059175
1635365896,-178000,true,18618501257,22,18048405312,-570095945
1635365898,-178016,true,18588736961,22,18046600651,-542136310
1635365903,-178009,true,18601752981,22,18039383816,-562369165
1635365905,-178014,true,18592454894,22,18037580058,-554874836
1635365940,-178032,true,18559020248,22,17997942980,-561077268
1635365955,-178047,true,18531203975,22,17981752927,-549451048
1635365965,-178041,true,18542325478,22,17970967651,-571357827
1635365975,-178047,true,18531203975,22,17963781061,-567422914
1635365992,-178073,true,18483087829,22,17951211442,-531876387
1635366004,-178091,true,18449849856,22,17944032752,-505817104
1635366011,-178083,true,18464614903,22,17944032752,-520582151
1635366085,-178082,true,18466461364,22,17969170734,-497290630
1635366101,-178100,true,18433253290,22,17963781061,-469472229
1635366179,-178116,true,18403785139,22,17996143366,-407641773
1635366185,-178103,true,18427724420,22,17996143366,-431581054
1635366208,-178099,true,18435096616,22,18008744446,-426352170
1635366248,-178116,true,18403785139,22,18026761296,-377023843
1635366259,-178131,true,18376201534,22,18026761296,-349440238
1635366268,-178128,true,18381714945,22,18028563973,-353150972
1635366276,-178128,true,18381714945,22,18030366829,-351348116
1635366307,-178148,true,18344990089,22,18041187754,-303802335
1635366349,-178164,true,18315663039,22,18041187754,-274475285
1635366416,-178159,true,18324822702,22,18055625757,-269196945
1635366441,-178158,true,18326655184,22,18062849090,-263806094
1635366465,-178176,true,18293698523,22,18073689510,-220009013
1635366490,-178192,true,18264453470,22,18106249818,-158203652
1635366519,-178184,true,18279070148,22,18146125421,-132944727
1635366548,-178182,true,18282726144,22,18184270416,-98455728
1635366559,-178198,true,18253498632,22,18202462871,-51035761
1635366575,-178214,true,18224317844,22,18227962890,3645046
1635366615,-178201,true,18248023678,22,18322990403,74966725
1635366640,-178197,true,18255323982,22,18361507186,106183204
1635366648,-178213,true,18226140276,22,18372526845,146386569
1635366653,-178223,true,18207924156,22,18378039154,170114998
1635366662,-178213,true,18226140276,22,18390907641,164767365
1635366663,-178210,true,18231608665,22,18392746732,161138067
1635366716,-178218,true,18217029939,22,18477544011,260514072
1635366749,-178235,true,18186088843,22,18492331221,306242378
1635366801,-178223,true,18207924156,22,18547888732,339964576
1635366880,-178214,true,18224317844,22,18648313212,423995368
1635366907,-178221,true,18211565923,22,18693120671,481554748
1635366912,-178234,true,18187907451,22,18700599041,512691590
1635366915,-178218,true,18217029939,22,18704339347,487309408
1635366928,-178201,true,18248023678,22,18728669583,480645905
1635366968,-178189,true,18269933354,22,18807491465,537558111
1635366972,-178195,true,18258975229,22,18815015590,556040361
1635366991,-178176,true,18293698523,22,18837606031,543907508
1635367001,-178160,true,18322990403,22,18847026717,524036314
1635367025,-178163,true,18317494605,22,18865882228,548387623
1635367115,-178168,true,18308338605,22,18947176113,638837508
1635367126,-178157,true,18328487850,22,18947176113,618688263
1635367169,-178136,true,18367016189,22,18983208166,616191977
1635367193,-178135,true,18368852890,22,18981310035,612457145
1635367212,-178148,true,18344990089,22,18994600939,649610850
1635367334,-178126,true,18385391472,22,19162482629,777091157
1635367352,-178108,true,18418513322,22,19170148772,751635450
1635367358,-178103,true,18427724420,22,19175900392,748175972
1635367405,-178118,true,18400104934,22,19204684386,804579452
1635367421,-178106,true,18422197208,22,19216210077,794012869
1635367533,-178086,true,18459076626,22,19260456012,801379386
1635367553,-178083,true,18464614903,22,19268161350,803546447
1635367563,-178098,true,18436940125,22,19275869770,838929645
1635367594,-178084,true,18462768626,22,19277797357,815028731
1635367658,-178066,true,18496029873,22,19322185098,826155225
1635367693,-178062,true,18503429394,22,19345384477,841955083
1635367768,-178061,true,18505279737,22,19378297954,873018217
1635367828,-178044,true,18536763893,22,19382173807,845409914
1635367832,-178019,true,18583161455,22,19380235784,797074329
1635367852,-178007,true,18605473518,22,19364738570,759265052
1635367873,-178000,true,18618501257,22,19358930310,740429053
1635367898,-177980,true,18655773656,22,19368611711,712838055
1635367919,-177955,true,18702469101,22,19382173807,679704706
1635367967,-177936,true,18738035791,22,19420975003,682939212
1635367972,-177929,true,18751156352,22,19424859392,673703040
1635368016,-177908,true,18790573183,22,19457908084,667334901
1635368024,-177882,true,18839489791,22,19471532707,632042916
1635368030,-177868,true,18865882228,22,19477374751,611492523
1635368035,-177864,true,18873429713,22,19481270420,607840707
1635368050,-177847,true,18905540224,22,19492962105,587421881
1635368074,-177826,true,18945281585,22,19508561934,563280349
1635368091,-177815,true,18966131818,22,19533938287,567806469
1635368096,-177815,true,18966131818,22,19539799054,573667236
1635368114,-177805,true,18985106487,22,19553481018,568374531
1635368136,-177781,true,19030723180,22,19561303583,530580403
1635368172,-177767,true,19057383517,22,19567172561,509789044
1635368191,-177766,true,19059289255,22,19567172561,507883306
1635368252,-177756,true,19078357123,22,19588707216,510350093
1635368267,-177733,true,19122285647,22,19598503529,476217882
1635368299,-177722,true,19143330682,22,19616149239,472818557
1635368306,-177722,true,19143330682,22,19623996876,480666194
1635368317,-177715,true,19156735034,22,19635774218,479039184
1635368361,-177691,true,19202764109,22,19675083097,472318988
1635368392,-177676,true,19231588427,22,19708557510,476969083
1635368400,-177676,true,19231588427,22,19718413760,486825333
1635368435,-177668,true,19246979084,22,19751961893,504982809
1635368465,-177645,true,19291295865,22,19773699918,482404053
1635368484,-177629,true,19322185098,22,19789524416,467339318
1635368487,-177629,true,19322185098,22,19791503368,469318270
1635368506,-177626,true,19327982334,22,19799421157,471438823
1635368546,-177612,true,19355059104,22,19815266239,460207135
1635368552,-177600,true,19378297954,22,19815266239,436968285
1635368659,-177608,true,19362802289,22,19783588746,420786457
1635368691,-177606,true,19366675043,22,19767768995,401093952
1635368734,-177595,true,19387989041,22,19753937090,365948049
1635368743,-177584,true,19409326495,22,19751961893,342635398
1635368773,-177591,true,19395745400,22,19734194013,338448613
1635368778,-177589,true,19399624743,22,19730247766,330623023
1635368818,-177579,true,19419033100,22,19694767036,275733936
1635368827,-177566,true,19444292995,22,19688859788,244566793
1635368841,-177574,true,19428744558,22,19675083097,246338539
1635368857,-177572,true,19432630502,22,19657384373,224753871
1635368891,-177562,true,19452071879,22,19620072665,168000786
1635368919,-177549,true,19477374751,22,19596543875,119169124
1635368926,-177557,true,19461799860,22,19592625154,130825294
1635368951,-177556,true,19463746040,22,19573043300,109297260
1635368977,-177544,true,19487115386,22,19561303583,74188197
1635369014,-177530,true,19514415088,22,19543707210,29292122
1635369022,-177537,true,19500760460,22,19539799054,39038594
1635369082,-177543,true,19489064098,22,19500760460,11696362
1635369084,-177533,true,19508561934,22,19498810579,-9751355
1635369089,-177520,true,19533938287,22,19496860893,-37077394
1635369135,-177531,true,19512463842,22,19467638984,-44824858
1635369144,-177530,true,19514415088,22,19461799860,-52615228
1635369157,-177519,true,19535891681,22,19455962488,-79929193
1635369185,-177512,true,19549570908,22,19452071879,-97499029
1635369192,-177514,true,19545661580,22,19452071879,-93589701
1635369198,-177514,true,19545661580,22,19452071879,-93589701
1635369248,-177506,true,19561303583,22,19420975003,-140328580
1635369285,-177499,true,19575000605,22,19405445212,-169555393
1635369299,-177507,true,19559347649,22,19386050436,-173297213
1635369323,-177511,true,19551525865,22,19366675043,-184850822
1635369333,-177513,true,19547616146,22,19358930310,-188685836
1635369345,-177519,true,19535891681,22,19355059104,-180832577
1635369349,-177526,true,19522222025,22,19353123792,-169098233
1635369376,-177527,true,19520269998,22,19335714686,-184555312
1635369380,-177526,true,19522222025,22,19335714686,-186507339
1635369381,-177522,true,19530032085,22,19335714686,-194317399
1635369389,-177525,true,19524174247,22,19337648258,-186525989
1635369401,-177520,true,19533938287,22,19335714686,-198223601
1635369412,-177520,true,19533938287,22,19331848123,-202090164
1635369422,-177513,true,19547616146,22,19331848123,-215768023
1635369473,-177508,true,19557391909,22,19351188673,-206203236
1635369474,-177513,true,19547616146,22,19351188673,-196427473
1635369479,-177513,true,19547616146,22,19351188673,-196427473
1635369482,-177509,true,19555436366,22,19353123792,-202312574
1635369500,-177506,true,19561303583,22,19360866203,-200437380
1635369507,-177502,true,19569129279,22,19362802289,-206326990
1635369517,-177501,true,19571086192,22,19368611711,-202474481
1635369581,-177495,true,19582831779,22,19405445212,-177386567
1635369616,-177493,true,19586748542,22,19420975003,-165773539
1635369699,-177489,true,19594584416,22,19459853875,-134730541
1635369702,-177489,true,19594584416,22,19461799860,-132784556
1635369717,-177487,true,19598503529,22,19465692415,-132811114
1635369763,-177491,true,19590666087,22,19463746040,-126920047
1635369769,-177494,true,19584790063,22,19465692415,-119097648
1635369801,-177493,true,19586748542,22,19485166869,-101581673
1635369837,-177492,true,19588707216,22,19485166869,-103540347
1635369843,-177495,true,19582831779,22,19485166869,-97664910
1635369925,-177499,true,19575000605,22,19508561934,-66438671
1635369991,-177501,true,19571086192,22,19516366529,-54719663
1635370065,-177504,true,19565216040,22,19524174247,-41041793
1635370082,-177507,true,19559347649,22,19518318166,-41029483
1635370092,-177515,true,19543707210,22,19514415088,-29292122
1635370100,-177518,true,19537845270,22,19514415088,-23430182
1635370130,-177511,true,19551525865,22,19541753034,-9772831
1635370137,-177510,true,19553481018,22,19543707210,-9773808
1635370144,-177514,true,19545661580,22,19545661580,0
1635370150,-177514,true,19545661580,22,19545661580,0
1635370182,-177517,true,19539799054,22,19537845270,-1953784
1635370197,-177516,true,19541753034,22,19547616146,5863112
1635370222,-177520,true,19533938287,22,19555436366,21498079
1635370239,-177523,true,19528079277,22,19553481018,25401741
1635370253,-177528,true,19518318166,22,19551525865,33207699
1635370257,-177527,true,19520269998,22,19553481018,33211020
1635370298,-177536,true,19502710536,22,19533938287,31227751
1635370305,-177538,true,19498810579,22,19533938287,35127708
1635370326,-177540,true,19494911401,22,19530032085,35120684
1635370346,-177541,true,19492962105,22,19516366529,23404424
1635370358,-177548,true,19479322488,22,19508561934,29239446
1635370429,-177555,true,19465692415,22,19459853875,-5838540
1635370461,-177562,true,19452071879,22,19440404720,-11667159
1635370513,-177561,true,19454017086,22,19419033100,-34983986
1635370515,-177567,true,19442348760,22,19419033100,-23315660
1635370523,-177571,true,19434573765,22,19413208555,-21365210
1635370527,-177576,true,19424859392,22,19411267428,-13591964
1635370539,-177580,true,19417091391,22,19401564705,-15526686
1635370557,-177586,true,19405445212,22,19386050436,-19394776
1635370586,-177584,true,19409326495,22,19374422875,-34903620
1635370610,-177584,true,19409326495,22,19374422875,-34903620
1635370625,-177583,true,19411267428,22,19376360318,-34907110
1635370654,-177586,true,19405445212,22,19376360318,-29084894
1635370666,-177584,true,19409326495,22,19372485627,-36840868
1635370669,-177586,true,19405445212,22,19370548572,-34896640
1635370685,-177587,true,19403504862,22,19356994610,-46510252
1635370713,-177595,true,19387989041,22,19331848123,-56140918
1635370754,-177591,true,19395745400,22,19308664977,-87080423
1635370783,-177596,true,19386050436,22,19275869770,-110180666
1635370800,-177596,true,19386050436,22,19266234726,-119815710
1635370820,-177603,true,19372485627,22,19248903782,-123581845
1635370829,-177601,true,19376360318,22,19241206145,-135154173
1635370857,-177603,true,19372485627,22,19227742686,-144742941
1635370903,-177604,true,19370548572,22,19202764109,-167784463
1635370952,-177612,true,19355059104,22,19170148772,-184910332
1635370978,-177612,true,19355059104,22,19154819552,-200239552
1635371006,-177615,true,19349253748,22,19128022906,-221230842
1635371038,-177617,true,19345384477,22,19084081203,-261303274
1635371068,-177627,true,19326049729,22,19053572612,-272477117
1635371081,-177627,true,19326049729,22,19038336611,-287713118
1635371118,-177631,true,19318321241,22,18996500399,-321820842
1635371151,-177634,true,19312526903,22,18968028431,-344498472
1635371228,-177645,true,19291295865,22,18901759683,-389536182
1635371263,-177648,true,19285509633,22,18858337761,-427171872
1635371282,-177656,true,19270088166,22,18837606031,-432482135
1635371308,-177665,true,19252753755,22,18798090539,-454663216
1635371371,-177678,true,19227742686,22,18743657764,-484084922
1635371376,-177680,true,19223897714,22,18736162175,-487735539
1635371384,-177688,true,19208525515,22,18726796904,-481728611
1635371399,-177691,true,19202764109,22,18709951210,-492812899
1635371430,-177704,true,19177817982,22,18681908723,-495909259
1635371432,-177705,true,19175900392,22,18680040719,-495859673
1635371436,-177709,true,19168231949,22,18676305271,-491926678
1635371484,-177719,true,19149074255,22,18620363107,-528711148
1635371505,-177731,true,19126110295,22,18596173571,-529936724
1635371543,-177731,true,19126110295,22,18562732237,-563378058
1635371560,-177735,true,19118461763,22,18546034128,-572427635
1635371584,-177743,true,19103173874,22,18531203975,-571969899
1635371627,-177763,true,19065007614,22,18501579236,-563428378
1635371639,-177761,true,19068820806,22,18494180454,-574640352
1635371658,-177764,true,19063101304,22,18486784631,-576316673
1635371684,-177775,true,19042144468,22,18481239705,-560904763
1635371698,-177792,true,19009801939,22,18473849057,-535952882
1635371712,-177789,true,19015505450,22,18472001857,-543503593
1635371718,-177791,true,19011702919,22,18470154841,-541548078
1635371726,-177797,true,19000299889,22,18470154841,-530145048
1635371739,-177816,true,18964235394,22,18460922534,-503312860
1635371761,-177816,true,18964235394,22,18453540010,-510695384
1635371773,-177818,true,18960443116,22,18453540010,-506903106
1635371798,-177823,true,18950965738,22,18448005055,-502960683
1635371804,-177839,true,18920669951,22,18448005055,-472664896
1635371852,-177839,true,18920669951,22,18442471761,-478198190
1635371873,-177838,true,18922562018,22,18449849856,-472712162
1635371886,-177838,true,18922562018,22,18455385364,-467176654
1635371911,-177849,true,18901759683,22,18459076626,-442683057
1635371945,-177853,true,18894200869,22,18446160439,-448040430
1635371976,-177855,true,18890422595,22,18444316008,-446106587
1635372000,-177857,true,18886645077,22,18457230903,-429414174
1635372035,-177869,true,18863995828,22,18472001857,-391993971
1635372049,-177870,true,18862109617,22,18470154841,-391954776
1635372082,-177873,true,18856452116,22,18472001857,-384450259
1635372142,-177878,true,18847026717,22,18481239705,-365787012
1635372149,-177890,true,18824424979,22,18484936138,-339488841
1635372216,-177893,true,18818778781,22,18510831876,-307946905
1635372238,-177905,true,18796210918,22,18510831876,-285379042
1635372279,-177914,true,18779302784,22,18521941152,-257361632
1635372330,-177927,true,18754906771,22,18527498290,-227408481
1635372385,-177928,true,18753031468,22,18549743521,-203287947
1635372405,-177931,true,18747406683,22,18542325478,-205081205
1635372492,-177938,true,18734288746,22,18566444969,-167843777
1635372583,-177951,true,18709951210,22,18588736961,-121214249
1635372626,-177952,true,18708080402,22,18572015460,-136064942
1635372639,-177953,true,18706209781,22,18570158444,-136051337
1635372669,-177963,true,18687513856,22,18544179710,-143334146
1635372676,-177976,true,18663237085,22,18540471431,-122765654
1635372693,-177978,true,18659504997,22,18529351040,-130153957
1635372737,-177978,true,18659504997,22,18510831876,-148673121
1635372748,-177985,true,18646448567,22,18505279737,-141168830
1635372753,-178000,true,18618501257,22,18501579236,-116922021
1635372759,-177999,true,18620363107,22,18496029873,-124333234
1635372805,-178006,true,18607334065,22,18436940125,-170393940
1635372813,-178016,true,18588736961,22,18427724420,-161012541
1635372832,-178031,true,18560876150,22,18420355173,-140520977
1635372840,-178032,true,18559020248,22,18416671654,-142348594
1635372894,-178036,true,18551598495,22,18383553117,-168045378
1635372922,-178041,true,18542325478,22,18350494136,-191831342
1635372949,-178054,true,18518237320,22,18330320699,-187916621
1635372962,-178059,true,18508980978,22,18322990403,-185990575
1635372974,-178066,true,18496029873,22,18319326355,-176703518
1635372995,-178070,true,18488633310,22,18313831656,-174801654
1635373023,-178083,true,18464614903,22,18299187181,-165427722
1635373031,-178086,true,18459076626,22,18301017100,-158059526
1635373071,-178088,true,18455385364,22,18302847202,-152538162
1635373079,-178090,true,18451694841,22,18299187181,-152507660
1635373094,-178095,true,18442471761,22,18302847202,-139624559
1635373170,-178099,true,18435096616,22,18286382872,-148713744
1635373200,-178101,true,18431410149,22,18277242423,-154167726
1635373215,-178103,true,18427724420,22,18271760347,-155964073
1635373239,-178109,true,18416671654,22,18273587523,-143084131
1635373295,-178109,true,18416671654,22,18280898055,-135773599
1635373311,-178112,true,18411147758,22,18284554417,-126593341
1635373337,-178113,true,18409306827,22,18275414882,-133891945
1635373357,-178119,true,18398265108,22,18268106543,-130158565
1635373382,-178122,true,18392746732,22,18255323982,-137422750
1635373396,-178126,true,18385391472,22,18248023678,-137367794
1635373429,-178129,true,18379876958,22,18227962890,-151914068
1635373491,-178132,true,18374364097,22,18215208418,-159155679
1635373507,-178133,true,18372526845,22,18213387080,-159139765
1635373513,-178136,true,18367016189,22,18213387080,-153629109
1635373535,-178136,true,18367016189,22,18209744948,-157271241
1635373539,-178140,true,18359671219,22,18209744948,-149926271
1635373546,-178140,true,18359671219,22,18211565923,-148105296
1635373548,-178142,true,18355999835,22,18211565923,-144433912
1635373631,-178140,true,18359671219,22,18197003224,-162667995
1635373656,-178140,true,18359671219,22,18202462871,-157208348
1635373668,-178142,true,18355999835,22,18204283117,-151716718
1635373682,-178143,true,18354164419,22,18213387080,-140777339
1635373738,-178137,true,18365179671,22,18249848480,-115331191
1635373754,-178138,true,18363343336,22,18253498632,-109844704
1635373777,-178139,true,18361507186,22,18264453470,-97053716
1635373803,-178139,true,18361507186,22,18279070148,-82437038
1635373848,-178128,true,18381714945,22,18315663039,-66051906
1635373868,-178127,true,18383553117,22,18332153731,-51399386
1635373878,-178129,true,18379876958,22,18335820345,-44056613
1635373908,-178133,true,18372526845,22,18337653927,-34872918
1635373923,-178129,true,18379876958,22,18341321641,-38555317
1635373941,-178129,true,18379876958,22,18333986946,-45890012
1635373972,-178129,true,18379876958,22,18337653927,-42223031
1635373976,-178132,true,18374364097,22,18339487692,-34876405
1635374014,-178124,true,18389068734,22,18355999835,-33068899
1635374034,-178125,true,18387230011,22,18365179671,-22050340
1635374038,-178125,true,18387230011,22,18368852890,-18377121
1635374057,-178127,true,18383553117,22,18381714945,-1838172
1635374073,-178119,true,18398265108,22,18392746732,-5518376
1635374088,-178118,true,18400104934,22,18403785139,3680205
1635374157,-178109,true,18416671654,22,18479391766,62720112
1635374181,-178111,true,18412988872,22,18499729263,86740391
1635374210,-178110,true,18414830171,22,18483087829,68257658
1635374223,-178110,true,18414830171,22,18492331221,77501050
1635374269,-178107,true,18420355173,22,18527498290,107143117
1635374290,-178113,true,18409306827,22,18546034128,136727301
1635374337,-178106,true,18422197208,22,18596173571,173976363
1635374365,-178106,true,18422197208,22,18620363107,198165899
1635374391,-178102,true,18429567193,22,18638991852,209424659
1635374403,-178104,true,18425881832,22,18650178043,224296211
1635374432,-178098,true,18436940125,22,18674437827,237497702
1635374451,-178100,true,18433253290,22,18691251546,257998256
1635374479,-178098,true,18436940125,22,18719308057,282367932
1635374485,-178100,true,18433253290,22,18723052106,289798816
1635374492,-178091,true,18449849856,22,18732415505,282565649
1635374533,-178086,true,18459076626,22,18784937138,325860512
1635374581,-178080,true,18470154841,22,18831955879,361801038
1635374618,-178082,true,18466461364,22,18852681391,386220027
1635374688,-178074,true,18481239705,22,18892311638,411071933
1635374765,-178071,true,18486784631,22,18916886384,430101753
1635374802,-178066,true,18496029873,22,18958547261,462517388
1635374909,-178066,true,18496029873,22,19049762469,553732596
1635374967,-178058,true,18510831876,22,19080264959,569433083
1635375019,-178051,true,18523793347,22,19120373610,596580263
1635375029,-178045,true,18534910402,22,19118461763,583551361
1635375106,-178044,true,18536763893,22,19150989162,614225269
1635375144,-178032,true,18559020248,22,19168231949,609211701
1635375170,-178024,true,18573872661,22,19170148772,596276111
1635375176,-178016,true,18588736961,22,19175900392,587163431
1635375188,-178017,true,18586878273,22,19181653737,594775464
1635375200,-178008,true,18603613157,22,19187408809,583795652
1635375228,-177996,true,18625949775,22,19197004432,571054657
1635375255,-177990,true,18637128139,22,19204684386,567556247
1635375298,-177983,true,18650178043,22,19221975517,571797474
1635375310,-177972,true,18670703500,22,19225820104,555116604
1635375345,-177962,true,18689382607,22,19243130265,553747658
1635375353,-177955,true,18702469101,22,19246979084,544509983
1635375370,-177953,true,18706209781,22,19256604498,550394717
1635375416,-177940,true,18730542450,22,19270088166,539545716
1635375437,-177931,true,18747406683,22,19270088166,522681483
1635375479,-177924,true,18760533805,22,19270088166,509554361
1635375499,-177922,true,18764286100,22,19272015175,507729075
1635375524,-177915,true,18777425041,22,19272015175,494590134
1635375546,-177906,true,18794331485,22,19273942376,479610891
1635375556,-177903,true,18799970348,22,19273942376,473972028
1635375570,-177903,true,18799970348,22,19277797357,477827009
1635375645,-177889,true,18826307422,22,19316389602,490082180
1635375729,-177887,true,18830072871,22,19297083832,467010961
1635375760,-177882,true,18839489791,22,19285509633,446019842
1635375793,-177877,true,18848911420,22,19326049729,477138309
1635375816,-177865,true,18871542558,22,19329915132,458372574
1635375885,-177859,true,18882868315,22,19312526903,429658588
1635375953,-177858,true,18884756602,22,19285509633,400753031
1635376037,-177858,true,18884756602,22,19291295865,406539263
1635376110,-177846,true,18907430778,22,19291295865,383865087
1635376138,-177839,true,18920669951,22,19287438184,366768233
1635376250,-177831,true,18935811785,22,19314458156,378646371
1635376283,-177828,true,18941493097,22,19324117317,382624220
1635376326,-177811,true,18973719409,22,19347319016,373599607
1635376329,-177805,true,18985106487,22,19349253748,364147261
1635376365,-177797,true,19000299889,22,19356994610,356694721
1635376429,-177797,true,19000299889,22,19376360318,376060429
1635376458,-177784,true,19025015104,22,19384112025,359096921
1635376499,-177775,true,19042144468,22,19389927840,347783372
1635376507,-177766,true,19059289255,22,19389927840,330638585
1635376516,-177765,true,19061195184,22,19391866833,330671649
1635376543,-177746,true,19097444068,22,19403504862,306060794
1635376622,-177732,true,19124197875,22,19489064098,364866223
1635376657,-177724,true,19139502590,22,19524174247,384671657
1635376673,-177723,true,19141416540,22,19520269998,378853458
1635376712,-177712,true,19162482629,22,19516366529,353883900
1635376734,-177698,true,19189327550,22,19539799054,350471504
1635376815,-177688,true,19208525515,22,19614187821,405662306
1635376826,-177687,true,19210446367,22,19623996876,413550509
1635376866,-177673,true,19237358481,22,19680986212,443627731
1635376900,-177660,true,19262382057,22,19726302308,463920251
1635376929,-177645,true,19291295865,22,19767768995,476473130
1635376954,-177640,true,19300943442,22,19803381240,502437798
1635376990,-177623,true,19333781308,22,19852949148,519167840
1635377002,-177605,true,19368611711,22,19868837068,500225357
1635377021,-177592,true,19393806019,22,19898661195,504855176
1635377064,-177587,true,19403504862,22,19956448173,552943311
1635377075,-177573,true,19430687433,22,19972418921,541731488
1635377104,-177559,true,19457908084,22,20002398529,544490445
1635377119,-177549,true,19477374751,22,20012401729,535026978
1635377121,-177549,true,19477374751,22,20012401729,535026978
1635377137,-177538,true,19498810579,22,20026414614,527604035
1635377248,-177527,true,19520269998,22,20100645879,580375881
1635377277,-177524,true,19526126665,22,20128805082,602678417
1635377327,-177526,true,19522222025,22,20169100960,646878935
1635377379,-177511,true,19551525865,22,20207456761,655930896
1635377399,-177502,true,19569129279,22,20219584266,650454987
1635377403,-177494,true,19584790063,22,20221606225,636816162
1635377428,-177497,true,19578915800,22,20217562510,638646710
1635377435,-177491,true,19590666087,22,20219584266,628918179
1635377460,-177485,true,19602423426,22,20217562510,615139084
1635377468,-177478,true,19616149239,22,20215540956,599391717
1635377481,-177479,true,19614187821,22,20213519604,599331783
1635377525,-177473,true,19625959276,22,20203415876,577456600
1635377535,-177465,true,19641665540,22,20203415876,561750336
1635377546,-177457,true,19657384373,22,20203415876,546031503
1635377560,-177458,true,19655418831,22,20201395736,545976905
1635377587,-177456,true,19659350111,22,20189279140,529929029
1635377637,-177446,true,19679018310,22,20199375798,520357488
1635377701,-177438,true,19694767036,22,20205436217,510669181
1635377719,-177438,true,19694767036,22,20205436217,510669181
1635377733,-177432,true,19706586851,22,20199375798,492788947
1635377741,-177422,true,19726302308,22,20195336529,469034221
1635377746,-177415,true,19740114863,22,20195336529,455221666
1635377762,-177414,true,19742088875,22,20189279140,447190265
1635377783,-177409,true,19751961893,22,20179187528,427225635
1635377797,-177402,true,19765792415,22,20175152296,409359881
1635377823,-177397,true,19775677288,22,20159019434,383342146
1635377844,-177396,true,19777654856,22,20154988235,377333379
1635377879,-177394,true,19781610585,22,20128805082,347194497
1635377960,-177379,true,19811303780,22,20114720553,303416773
1635377970,-177373,true,19823193535,22,20108687344,285493809
1635377983,-177373,true,19823193535,22,20106676676,283483141
1635378037,-177363,true,19843025651,22,20146928255,303902604
1635378069,-177349,true,19870823951,22,20152972938,282148987
1635378123,-177343,true,19882749427,22,20175152296,292402869
1635378135,-177342,true,19884737702,22,20179187528,294449826
1635378187,-177337,true,19894682059,22,20191298068,296616009
1635378211,-177323,true,19922552726,22,20201395736,278843010
1635378248,-177317,true,19934509246,22,20219584266,285075020
1635378257,-177317,true,19934509246,22,20221606225,287096979
1635378268,-177312,true,19944478494,22,20223628385,279149891
1635378283,-177296,true,19976413604,22,20235765596,259351992
1635378304,-177286,true,19996399010,22,20256010471,259611461
1635378322,-177283,true,20002398529,22,20282359090,279960561
1635378366,-177273,true,20022409931,22,20335159194,312749263
1635378389,-177256,true,20056475272,22,20361610768,305135496
1635378403,-177245,true,20078548430,22,20379943550,301395120
1635378420,-177241,true,20086581054,22,20402372700,315791646
1635378434,-177235,true,20098636016,22,20422784256,324148240
1635378441,-177214,true,20140885385,22,20432997691,292112306
1635378519,-177203,true,20163051440,22,20537466926,374415486
1635378522,-177202,true,20165067745,22,20539520672,374452927
1635378551,-177197,true,20175152296,22,20566238076,391085780
1635378606,-177180,true,20209477507,22,20611531339,402053832
1635378608,-177170,true,20229696081,22,20615653852,385957771
1635378662,-177163,true,20243861117,22,20685862852,442001735
1635378676,-177158,true,20253985072,22,20690000231,436015159
1635378716,-177145,true,20280331057,22,20696207852,415876795
1635378778,-177139,true,20292502298,22,20733492708,440990410
1635378784,-177139,true,20292502298,22,20735566058,443063760
1635378809,-177134,true,20302650578,22,20754235534,451584956
1635378830,-177119,true,20333125881,22,20764614727,431488846
1635378868,-177112,true,20347363340,22,20774999111,427635771
1635378875,-177109,true,20353468159,22,20777076611,423608452
1635378913,-177103,true,20365683294,22,20772921819,407238525
1635378917,-177090,true,20392174573,22,20770844735,378670162
1635378953,-177085,true,20402372700,22,20754235534,351862834
1635378962,-177083,true,20406453378,22,20756310957,349857579
1635378999,-177084,true,20404412937,22,20752160318,347747381
1635379009,-177077,true,20418700312,22,20750085309,331384997
1635379049,-177072,true,20428911704,22,20745935915,317024211
1635379065,-177072,true,20428911704,22,20739713378,310801674
1635379070,-177073,true,20426869017,22,20739713378,312844361
1635379103,-177064,true,20445260555,22,20748010508,302749953
1635379143,-177060,true,20453439886,22,20752160318,298720432
1635379152,-177059,true,20455485230,22,20750085309,294600079
1635379157,-177065,true,20443216233,22,20752160318,308944085
1635379171,-177060,true,20453439886,22,20752160318,298720432
1635379212,-177063,true,20447305081,22,20731419567,284114486
1635379222,-177064,true,20445260555,22,20725201384,279940829
1635379229,-177069,true,20435040990,22,20721056966,286015976
1635379264,-177064,true,20445260555,22,20698277473,253016918
1635379270,-177069,true,20435040990,22,20694138438,259097448
1635379274,-177070,true,20432997691,22,20692069231,259071540
1635379279,-177078,true,20416658646,22,20687931438,271272792
1635379285,-177076,true,20420742182,22,20679658334,258916152
1635379343,-177085,true,20402372700,22,20599168748,196796048
1635379413,-177083,true,20406453378,22,20514889261,108435883
1635379433,-177089,true,20394213790,22,20492336417,98122627
1635379440,-177085,true,20402372700,22,20484141531,81768831
1635379461,-177093,true,20386058144,22,20461622489,75564345
1635379490,-177089,true,20394213790,22,20430954595,36740805
1635379534,-177095,true,20381981544,22,20369756634,-12224910
1635379543,-177089,true,20394213790,22,20355503506,-38710284
1635379561,-177096,true,20379943550,22,20329059866,-50883684
1635379569,-177090,true,20392174573,22,20322962367,-69212206
1635379616,-177094,true,20384019742,22,20298590657,-85429085
1635379622,-177087,true,20398292837,22,20292502298,-105790539
1635379647,-177093,true,20386058144,22,20274248174,-111809970
1635379656,-177089,true,20394213790,22,20268167116,-126046674
1635379685,-177091,true,20390135559,22,20245885503,-144250056
1635379696,-177083,true,20406453378,22,20231719050,-174734328
1635379698,-177089,true,20394213790,22,20229696081,-164517709
1635379721,-177085,true,20402372700,22,20203415876,-198956824
1635379741,-177083,true,20406453378,22,20183223567,-223229811
1635379810,-177084,true,20404412937,22,20110698213,-293714724
1635379853,-177094,true,20384019742,22,20074533322,-309486420
1635379865,-177092,true,20388096750,22,20060486768,-327609982
1635379894,-177094,true,20384019742,22,20026414614,-357605128
1635379918,-177095,true,20381981544,22,20004398769,-377582775
1635379961,-177105,true,20361610768,22,19972418921,-389191847
1635380019,-177103,true,20365683294,22,19910603377,-455079917
1635380022,-177106,true,20359574810,22,19908612515,-450962295
1635380055,-177106,true,20359574810,22,19894682059,-464892751
1635380057,-177113,true,20345328807,22,19892692790,-452636017
1635380101,-177114,true,20343294478,22,19850964052,-492330426
1635380108,-177114,true,20343294478,22,19846994455,-496300023
1635380111,-177121,true,20329059866,22,19845009954,-484049912
1635380128,-177128,true,20314835214,22,19835090425,-479744789
1635380174,-177117,true,20337192710,22,19835090425,-502102285
1635380177,-177124,true,20322962367,22,19835090425,-487871942
1635380180,-177133,true,20304680843,22,19835090425,-469590418
1635380191,-177138,true,20294531548,22,19839057641,-455473907
1635380192,-177131,true,20308741983,22,19839057641,-469684342
1635380198,-177133,true,20304680843,22,19843025651,-461655192
1635380211,-177143,true,20284387326,22,19845009954,-439377372
1635380214,-177147,true,20276275599,22,19846994455,-429281144
1635380233,-177135,true,20300620516,22,19860891519,-439728997
1635380251,-177136,true,20298590657,22,19872811034,-425779623
1635380284,-177151,true,20268167116,22,19864863896,-403303220
1635380320,-177160,true,20249934883,22,19866850383,-383084500
1635380351,-177151,true,20268167116,22,19874798315,-393368801
1635380449,-177152,true,20266140502,22,19924544981,-341595521
1635380471,-177166,true,20237789173,22,19934509246,-303279927
1635380472,-177173,true,20223628385,22,19934509246,-289119139
1635380494,-177164,true,20241836933,22,19942484246,-299352687
1635380541,-177168,true,20233742222,22,19956448173,-277294049
1635380551,-177185,true,20199375798,22,19960439663,-238936135
1635380598,-177191,true,20187260414,22,19976413604,-210846810
1635380610,-177181,true,20207456761,22,19984405368,-223051393
1635380656,-177183,true,20203415876,22,20006399209,-197016667
1635380675,-177199,true,20171117870,22,20012401729,-158716141
1635380702,-177205,true,20159019434,22,20026414614,-132604820
1635380708,-177199,true,20171117870,22,20030420097,-140697773
1635380795,-177204,true,20161035336,22,20072526070,-88509266
1635380816,-177216,true,20136857812,22,20080556284,-56301528
1635380856,-177219,true,20130817963,22,20114720553,-16097410
1635380930,-177206,true,20157003734,22,20175152296,18148562
1635380949,-177211,true,20146928255,22,20171117870,24189615
1635380953,-177226,true,20116732025,22,20171117870,54385845
1635381006,-177232,true,20104666209,22,20201395736,96729527
1635381009,-177223,true,20122767648,22,20201395736,78628088
1635381035,-177226,true,20116732025,22,20207456761,90724736
1635381046,-177239,true,20090598571,22,20203415876,112817305
1635381082,-177243,true,20082564340,22,20199375798,116811458
1635381086,-177233,true,20102655944,22,20199375798,96719854
1635381145,-177230,true,20108687344,22,20207456761,98769417
1635381198,-177248,true,20072526070,22,20199375798,126849728
1635381210,-177252,true,20064499066,22,20197356063,132856997
1635381238,-177241,true,20086581054,22,20193317198,106736144
1635381295,-177241,true,20086581054,22,20171117870,84536816
1635381311,-177259,true,20050459533,22,20165067745,114608212
1635381327,-177265,true,20038433467,22,20154988235,116554768
1635381340,-177256,true,20056475272,22,20146928255,90452983
1635381374,-177257,true,20054469825,22,20128805082,74335257
1635381404,-177274,true,20020407891,22,20114720553,94312662
1635381428,-177279,true,20010400689,22,20100645879,90245190
1635381489,-177272,true,20024412172,22,20056475272,32063100
1635381522,-177274,true,20020407891,22,20026414614,6006723
1635381566,-177288,true,19992400330,22,20016404410,24004080
1635381667,-177289,true,19990401290,22,20012401729,22000439
1635381737,-177280,true,20008399849,22,20000398490,-8001359
1635381756,-177280,true,20008399849,22,19982407128,-25992721
1635381781,-177293,true,19982407128,22,19956448173,-25958955
1635381797,-177291,true,19986403809,22,19938496347,-47907462
1635381808,-177288,true,19992400330,22,19928530089,-63870241
1635381819,-177289,true,19990401290,22,19918568813,-71832477
1635381886,-177299,true,19970421879,22,19884737702,-85684177
1635381907,-177298,true,19972418921,22,19872811034,-99607887
1635381942,-177293,true,19982407128,22,19866850383,-115556745
1635382041,-177293,true,19982407128,22,19807342114,-175065014
1635382053,-177302,true,19964431950,22,19807342114,-157089836
1635382115,-177302,true,19964431950,22,19791503368,-172928582
1635382126,-177298,true,19972418921,22,19787545661,-184873260
1635382150,-177300,true,19968425036,22,19777654856,-190770180
1635382172,-177309,true,19950462436,22,19767768995,-182693441
1635382176,-177310,true,19948467589,22,19763816034,-184651555
1635382185,-177306,true,19956448173,22,19759863863,-196584310
1635382193,-177309,true,19950462436,22,19755912483,-194549953
1635382201,-177319,true,19930522942,22,19753937090,-176585852
1635382254,-177319,true,19930522942,22,19736167432,-194355510
1635382270,-177315,true,19938496347,22,19732220791,-206275556
1635382370,-177319,true,19930522942,22,19710528366,-219994576
1635382424,-177327,true,19914585696,22,19702646125,-211939571
1635382437,-177325,true,19918568813,22,19696736513,-221832300
1635382463,-177319,true,19930522942,22,19688859788,-241663154
1635382487,-177320,true,19928530089,22,19679018310,-249511779
1635382499,-177324,true,19920560669,22,19673115785,-247444884
1635382552,-177322,true,19924544981,22,19653453486,-271091495
1635382614,-177318,true,19932515994,22,19625959276,-306556718
1635382668,-177317,true,19934509246,22,19643629706,-290879540
1635382700,-177324,true,19920560669,22,19651488337,-269072332
1635382721,-177324,true,19920560669,22,19649523384,-271037285
1635382739,-177318,true,19932515994,22,19649523384,-282992610
1635382757,-177322,true,19924544981,22,19647558628,-276986353
1635382799,-177320,true,19928530089,22,19667215031,-261315058
1635382811,-177319,true,19930522942,22,19673115785,-257407157
1635382846,-177321,true,19926537435,22,19679018310,-247519125
1635382888,-177323,true,19922552726,22,19696736513,-225816213
1635382910,-177322,true,19924544981,22,19704616389,-219928592
1635382915,-177323,true,19922552726,22,19706586851,-215965875
1635382928,-177323,true,19922552726,22,19708557510,-213995216
1635382965,-177327,true,19914585696,22,19716442115,-198143581
1635382984,-177323,true,19922552726,22,19734194013,-188358713
1635383030,-177322,true,19924544981,22,19763816034,-160728947
1635383053,-177326,true,19916577155,22,19775677288,-140899867
1635383060,-177330,true,19908612515,22,19781610585,-127001930
1635383146,-177323,true,19922552726,22,19827158372,-95394354
1635383183,-177322,true,19924544981,22,19850964052,-73580929
1635383193,-177325,true,19918568813,22,19856919937,-61648876
1635383207,-177332,true,19904631390,22,19868837068,-35794322
1635383223,-177326,true,19916577155,22,19878773473,-37803682
1635383238,-177324,true,19920560669,22,19892692790,-27867879
1635383250,-177326,true,19916577155,22,19906621853,-9955302
1635383255,-177330,true,19908612515,22,19910603377,1990862
1635383264,-177325,true,19918568813,22,19914585696,-3983117
1635383285,-177329,true,19910603377,22,19922552726,11949349
1635383301,-177333,true,19902641126,22,19934509246,31868120
1635383343,-177333,true,19902641126,22,19972418921,69777795
1635383348,-177327,true,19914585696,22,19974416163,59830467
1635383349,-177328,true,19912594437,22,19976413604,63819167
1635383356,-177331,true,19906621853,22,19978411246,71789393
1635383364,-177334,true,19900651061,22,19982407128,81756067
1635383381,-177324,true,19920560669,22,19992400330,71839661
1635383401,-177327,true,19914585696,22,20002398529,87812833
1635383421,-177332,true,19904631390,22,20012401729,107770339
1635383480,-177335,true,19898661195,22,20052464579,153803384
1635383515,-177326,true,19916577155,22,20078548430,161971275
1635383516,-177327,true,19914585696,22,20080556284,165970588
1635383584,-177325,true,19918568813,22,20120755573,202186760
1635383600,-177329,true,19910603377,22,20132831045,222227668
1635383607,-177319,true,19930522942,22,20138871498,208348556
1635383654,-177321,true,19926537435,22,20169100960,242563525
1635383678,-177322,true,19924544981,22,20183223567,258678586
1635383702,-177327,true,19914585696,22,20195336529,280750833
1635383708,-177314,true,19940490197,22,20195336529,254846332
1635383722,-177312,true,19944478494,22,20201395736,256917242
1635383740,-177315,true,19938496347,22,20199375798,260879451
1635383771,-177322,true,19924544981,22,20195336529,270791548
1635383801,-177311,true,19946472942,22,20193317198,246844256
1635383826,-177310,true,19948467589,22,20197356063,248888474
1635383866,-177312,true,19944478494,22,20205436217,260957723
1635383915,-177316,true,19936502697,22,20205436217,268933520
1635383956,-177304,true,19960439663,22,20201395736,240956073
1635383965,-177302,true,19964431950,22,20199375798,234943848
1635383983,-177303,true,19962435707,22,20197356063,234920356
1635384007,-177309,true,19950462436,22,20193317198,242854762
1635384022,-177300,true,19968425036,22,20191298068,222873032
1635384066,-177296,true,19976413604,22,20209477507,233063903
1635384074,-177298,true,19972418921,22,20211498454,239079533
1635384103,-177302,true,19964431950,22,20215540956,251109006
1635384125,-177290,true,19988402449,22,20219584266,231181817
1635384162,-177280,true,20008399849,22,20235765596,227365747
1635384175,-177276,true,20016404410,22,20245885503,229481093
1635384226,-177280,true,20008399849,22,20251959876,243560027
1635384258,-177268,true,20032423139,22,20274248174,241825035
1635384259,-177260,true,20048454687,22,20274248174,225793487
1635384287,-177256,true,20056475272,22,20294531548,238056276
1635384354,-177255,true,20058480920,22,20339226429,280745509
1635384361,-177245,true,20078548430,22,20343294478,264746048
1635384376,-177234,true,20100645879,22,20359574810,258928931
1635384403,-177228,true,20112709282,22,20384019742,271310460
1635384418,-177221,true,20126792403,22,20398292837,271500434
1635384462,-177209,true,20150957842,22,20428911704,277953862
1635384471,-177199,true,20171117870,22,20435040990,263923120
1635384513,-177196,true,20177169811,22,20455485230,278315419
1635384528,-177190,true,20189279140,22,20461622489,272343349
1635384572,-177183,true,20203415876,22,20475949922,272534046
1635384666,-177174,true,20221606225,22,20531306918,309700693
1635384705,-177170,true,20229696081,22,20560069438,330373357
1635384722,-177164,true,20241836933,22,20570351529,328514596
1635384790,-177157,true,20256010471,22,20595049532,339039061
1635384800,-177150,true,20270193932,22,20597109037,326915105
1635384839,-177150,true,20270193932,22,20605349116,335155184
1635384860,-177144,true,20282359090,22,20621839166,339480076
1635384905,-177138,true,20294531548,22,20658990045,364458497
1635384945,-177130,true,20310772857,22,20683794473,373021616
1635384955,-177126,true,20318898385,22,20687931438,369033053
1635385068,-177121,true,20329059866,22,20745935915,416876049
1635385106,-177113,true,20345328807,22,20768767858,423439051
1635385116,-177103,true,20365683294,22,20777076611,411393317
1635385147,-177102,true,20367719862,22,20772921819,405201957
1635385154,-177094,true,20384019742,22,20770844735,386824993
1635385194,-177093,true,20386058144,22,20762538473,376480329
1635385259,-177086,true,20400332666,22,20754235534,353902868
1635385270,-177086,true,20400332666,22,20752160318,351827652
1635385302,-177082,true,20408494024,22,20725201384,316707360
1635385318,-177082,true,20408494024,22,20710699545,302205521
1635385330,-177078,true,20416658646,22,20700347301,283688655
1635385359,-177079,true,20414617184,22,20679658334,265041150
1635385390,-177071,true,20430954595,22,20667254881,236300286
1635385476,-177073,true,20426869017,22,20646598988,219729971
1635385480,-177069,true,20435040990,22,20646598988,211557998
1635385493,-177070,true,20432997691,22,20640406247,207408556
1635385554,-177065,true,20443216233,22,20617715417,174499184
1635385564,-177065,true,20443216233,22,20615653852,172437619
1635385583,-177060,true,20453439886,22,20611531339,158091453
1635385613,-177061,true,20451394746,22,20607409651,156014905
1635385699,-177055,true,20463668651,22,20613592492,149923841
1635385723,-177056,true,20461622489,22,20615653852,154031363
1635385778,-177054,true,20465715018,22,20601228665,135513647
1635385813,-177057,true,20459576531,22,20584755096,125178565
1635385840,-177054,true,20465715018,22,20568294700,102579682
1635385849,-177056,true,20461622489,22,20560069438,98446949
1635385893,-177048,true,20477997517,22,20541574624,63577107
1635385894,-177049,true,20475949922,22,20541574624,65624702
1635385950,-177048,true,20477997517,22,20514889261,36891744
1635385959,-177049,true,20475949922,22,20512837977,36888055
1635385967,-177044,true,20486189945,22,20506685356,20495411
1635386001,-177045,true,20484141531,22,20492336417,8194886
1635386022,-177041,true,20492336417,22,20473902532,-18433885
1635386025,-177045,true,20484141531,22,20473902532,-10238999
1635386029,-177039,true,20496435089,22,20473902532,-22532557
1635386108,-177044,true,20486189945,22,20441172116,-45017829
1635386150,-177035,true,20504634893,22,20449349811,-55285082
1635386167,-177037,true,20500534581,22,20455485230,-45049351
1635386216,-177032,true,20510786898,22,20467761589,-43025309
1635386229,-177033,true,20508736025,22,20473902532,-34833493
1635386232,-177027,true,20521044343,22,20473902532,-47141811
1635386239,-177032,true,20510786898,22,20475949922,-34836976
1635386294,-177027,true,20521044343,22,20473902532,-47141811
1635386307,-177029,true,20516940750,22,20475949922,-40990828
1635386342,-177023,true,20529253992,22,20482093321,-47160671
1635386352,-177028,true,20518992444,22,20482093321,-36899123
1635386362,-177026,true,20523096447,22,20482093321,-41003126
1635386409,-177021,true,20533360048,22,20502584634,-30775414
1635386436,-177008,true,20560069438,22,20516940750,-43128688
1635386450,-177013,true,20549792487,22,20516940750,-32851737
1635386478,-177012,true,20551847466,22,20508736025,-43111441
1635386509,-177010,true,20555958041,22,20510786898,-45171143
1635386510,-177000,true,20576523252,22,20510786898,-65736354
1635386529,-177004,true,20568294700,22,20512837977,-55456723
1635386555,-177004,true,20568294700,22,20502584634,-65710066
1635386568,-177004,true,20568294700,22,20498484732,-69809968
1635386571,-176992,true,20592990233,22,20496435089,-96555144
1635386589,-176997,true,20582696826,22,20496435089,-86261737
1635386620,-176998,true,20580638762,22,20496435089,-84203673
1635386631,-176999,true,20578580904,22,20496435089,-82145815
1635386641,-176989,true,20599168748,22,20498484732,-100684016
1635386668,-176994,true,20588872253,22,20502584634,-86287619
1635386672,-176998,true,20580638762,22,20502584634,-78054128
1635386681,-176998,true,20580638762,22,20504634893,-76003869
1635386686,-176988,true,20601228665,22,20504634893,-96593772
1635386699,-176996,true,20584755096,22,20508736025,-76019071
1635386703,-176998,true,20580638762,22,20510786898,-69851864
1635386740,-177001,true,20574465805,22,20521044343,-53421462
1635386748,-176996,true,20584755096,22,20527201272,-57553824
1635386752,-177003,true,20570351529,22,20527201272,-43150257
1635386801,-177008,true,20560069438,22,20521044343,-39025095
1635386870,-177009,true,20558013637,22,20535413384,-22600253
1635386876,-177008,true,20560069438,22,20537466926,-22602512
1635386893,-177016,true,20543628782,22,20537466926,-6161856
1635386908,-177018,true,20539520672,22,20543628782,4108110
1635386947,-177019,true,20537466926,22,20555958041,18491115
1635386948,-177016,true,20543628782,22,20555958041,12329259
1635386952,-177019,true,20537466926,22,20555958041,18491115
1635386975,-177018,true,20539520672,22,20576523252,37002580
1635386983,-177013,true,20549792487,22,20584755096,34962609
1635387014,-177013,true,20549792487,22,20592990233,43197746
1635387044,-177017,true,20541574624,22,20580638762,39064138
1635387102,-177018,true,20539520672,22,20562125445,22604773
1635387128,-177010,true,20555958041,22,20555958041,0
1635387135,-177011,true,20553902651,22,20555958041,2055390
1635387177,-177017,true,20541574624,22,20560069438,18494814
1635387202,-177018,true,20539520672,22,20562125445,22604773
1635387213,-177012,true,20551847466,22,20564181658,12334192
1635387218,-177016,true,20543628782,22,20564181658,20552876
1635387233,-177023,true,20529253992,22,20564181658,34927666
1635387238,-177024,true,20527201272,22,20566238076,39036804
1635387325,-177015,true,20545683145,22,20568294700,22611555
1635387333,-177016,true,20543628782,22,20570351529,26722747
1635387360,-177020,true,20535413384,22,20578580904,43167520
1635387370,-177021,true,20533360048,22,20586813571,53453523
1635387439,-177008,true,20560069438,22,20632152148,72082710
1635387464,-177008,true,20560069438,22,20652793587,92724149
1635387484,-177010,true,20555958041,22,20667254881,111296840
1635387503,-177008,true,20560069438,22,20679658334,119588896
1635387542,-176994,true,20588872253,22,20708628682,119756429
1635387559,-176995,true,20586813571,22,20718985067,132171496
1635387596,-176997,true,20582696826,22,20737639614,154942788
1635387624,-176996,true,20584755096,22,20750085309,165330213
1635387644,-176984,true,20609470392,22,20760462427,150992035
1635387674,-176985,true,20607409651,22,20774999111,167589460
1635387685,-176987,true,20603288787,22,20781232234,177943447
1635387708,-176986,true,20605349116,22,20793704091,188354975
1635387727,-176974,true,20630089139,22,20799942826,169853687
1635387794,-176976,true,20625963740,22,20820752131,194788391
1635387813,-176978,true,20621839166,22,20826998982,205159816
1635387851,-176976,true,20625963740,22,20843666414,217702674
1635387945,-176966,true,20646598988,22,20837414564,190815576
1635387986,-176966,true,20646598988,22,20845750780,199151792
1635387989,-176967,true,20644534535,22,20847835355,203300820
1635388056,-176967,true,20644534535,22,20870779444,226244909
1635388115,-176954,true,20671388538,22,20895838159,224449621
1635388124,-176956,true,20667254881,22,20900017535,232762654
1635388175,-176958,true,20663122050,22,20912560681,249438631
1635388191,-176956,true,20667254881,22,20916743402,249488521
1635388198,-176943,true,20694138438,22,20918835077,224696639
1635388239,-176943,true,20694138438,22,20920926960,226788522
1635388273,-176945,true,20690000231,22,20925111355,235111124
1635388319,-176941,true,20698277473,22,20931389516,233112043
1635388356,-176925,true,20731419567,22,20937669561,206249994
1635388397,-176930,true,20721056966,22,20929296586,208239620
1635388429,-176934,true,20712770615,22,20920926960,208156345
1635388439,-176933,true,20714841892,22,20918835077,203993185
1635388445,-176924,true,20733492708,22,20916743402,183250694
1635388517,-176923,true,20735566058,22,20943951490,208385432
1635388534,-176924,true,20733492708,22,20939763328,206270620
1635388590,-176922,true,20737639614,22,20933482655,195843041
1635388662,-176915,true,20752160318,22,20914651937,162491619
1635388668,-176918,true,20745935915,22,20912560681,166624766
1635388737,-176919,true,20743861528,22,20908378796,164517268
1635388803,-176916,true,20750085309,22,20923019053,172933744
1635388853,-176913,true,20756310957,22,20910469634,154158677
1635388855,-176918,true,20745935915,22,20910469634,164533719
1635388863,-176920,true,20741787350,22,20908378796,166591446
1635388865,-176920,true,20741787350,22,20906288168,164500818
1635388892,-176914,true,20754235534,22,20902107537,147872003
1635388917,-176916,true,20750085309,22,20895838159,145752850
1635388922,-176918,true,20745935915,22,20891659618,145723703
1635388942,-176912,true,20758386588,22,20908378796,149992208
1635388972,-176900,true,20783310357,22,20904197748,120887391
1635388983,-176900,true,20783310357,22,20902107537,118797180
1635388984,-176901,true,20781232234,22,20902107537,120875303
1635389025,-176904,true,20774999111,22,20891659618,116660507
1635389035,-176894,true,20795783462,22,20889570661,93787199
1635389037,-176894,true,20795783462,22,20889570661,93787199
1635389066,-176896,true,20791624929,22,20874953809,83328880
1635389110,-176899,true,20785388688,22,20864519462,79130774
1635389132,-176889,true,20806183433,22,20860347184,54163751
1635389205,-176889,true,20806183433,22,20831164590,24981157
1635389217,-176891,true,20802022820,22,20824916490,22893670
1635389236,-176895,true,20793704091,22,20812425912,18721821
1635389342,-176886,true,20812425912,22,20770844735,-41581177
1635389423,-176883,true,20818670264,22,20756310957,-62359307
1635389438,-176884,true,20816588606,22,20760462427,-56126179
1635389446,-176888,true,20808264051,22,20760462427,-47801624
1635389460,-176877,true,20831164590,22,20756310957,-74853633
1635389498,-176879,true,20826998982,22,20752160318,-74838664
1635389537,-176881,true,20822834207,22,20758386588,-64447619
1635389590,-176884,true,20816588606,22,20766691189,-49897417
1635389628,-176872,true,20841582255,22,20752160318,-89421937
1635389648,-176874,true,20837414564,22,20750085309,-87329255
1635389693,-176875,true,20835331031,22,20748010508,-87320523
1635389706,-176884,true,20816588606,22,20745935915,-70652691
1635389738,-176876,true,20833247706,22,20760462427,-72785279
1635389855,-176873,true,20839498306,22,20783310357,-56187949
1635389874,-176872,true,20841582255,22,20785388688,-56193567
1635389906,-176876,true,20833247706,22,20793704091,-39543615
1635389960,-176868,true,20849920139,22,20808264051,-41656088
1635390009,-176863,true,20860347184,22,20826998982,-33348202
1635390048,-176862,true,20862433219,22,20839498306,-22934913
1635390052,-176867,true,20852005131,22,20841582255,-10422876
1635390075,-176859,true,20868692575,22,20843666414,-25026161
1635390091,-176854,true,20879129008,22,20854090331,-25038677
1635390183,-176849,true,20889570661,22,20927203866,37633205
1635390184,-176854,true,20879129008,22,20927203866,48074858
1635390201,-176848,true,20891659618,22,20931389516,39729898
1635390215,-176845,true,20897927743,22,20935576003,37648260
1635390262,-176845,true,20897927743,22,20950235304,52307561
1635390286,-176850,true,20887481913,22,20948140490,60658577
1635390351,-176845,true,20897927743,22,20975389418,77461675
1635390368,-176841,true,20906288168,22,20987977798,81689630
1635390384,-176841,true,20906288168,22,20998473886,92185718
1635390394,-176845,true,20897927743,22,21002673791,104746048
1635390413,-176843,true,20902107537,22,21006874536,104766999
1635390440,-176841,true,20906288168,22,21008975223,102687055
1635390459,-176841,true,20906288168,22,21011076121,104787953
1635390469,-176845,true,20897927743,22,21013177228,115249485
1635390508,-176840,true,20908378796,22,21032096654,123717858
1635390593,-176836,true,20916743402,22,21067879837,151136435
1635390620,-176836,true,20916743402,22,21078415883,161672481
1635390647,-176841,true,20906288168,22,21084740041,178451873
1635390666,-176836,true,20916743402,22,21084740041,167996639
1635390690,-176834,true,20920926960,22,21088957199,168030239
1635390699,-176834,true,20920926960,22,21093175202,172248242
1635390705,-176837,true,20914651937,22,21095284519,180632582
1635390725,-176830,true,20929296586,22,21095284519,165987933
1635390735,-176827,true,20935576003,22,21095284519,159708516
1635390740,-176828,true,20933482655,22,21095284519,161801864
1635390787,-176832,true,20925111355,22,21097394048,172282693
1635390819,-176826,true,20937669561,22,21107944855,170275294
1635390838,-176822,true,20946045885,22,21116389299,170343414
1635390866,-176822,true,20946045885,22,21131175207,185129322
1635390915,-176823,true,20943951490,22,21154431125,210479635
1635390976,-176816,true,20958616655,22,21188303612,229686957
1635390997,-176812,true,20967001359,22,21188303612,221302253
1635391003,-176811,true,20969098059,22,21190422443,221324384
1635391006,-176815,true,20960712517,22,21190422443,229709926
1635391034,-176807,true,20977486957,22,21201019773,223532816
1635391049,-176800,true,20992175604,22,21203139875,210964271
1635391083,-176800,true,20992175604,22,21211622403,219446799
1635391113,-176802,true,20987977798,22,21237090355,249112557
1635391158,-176790,true,21013177228,22,21275349627,262172399
1635391184,-176789,true,21015278546,22,21290246841,274968295
1635391194,-176788,true,21017380074,22,21298764217,281384143
1635391202,-176785,true,21023685918,22,21307285001,283599083
1635391220,-176774,true,21046823539,22,21309415729,262592190
1635391227,-176766,true,21063666893,22,21313677825,250010932
1635391241,-176767,true,21061560736,22,21320072568,258511832
1635391309,-176759,true,21078415883,22,21405519366,327103483
1635391317,-176743,true,21112166655,22,21416224266,304057611
1635391366,-176737,true,21124837122,22,21471976108,347138986
1635391398,-176736,true,21126949606,22,21495607095,368657489
1635391425,-176727,true,21145971468,22,21517112377,371140909
1635391477,-176713,true,21175595078,22,21570969759,395374681
1635391495,-176708,true,21186184994,22,21583915577,397730583
1635391502,-176707,true,21188303612,22,21588232576,399928964
1635391514,-176703,true,21196780205,22,21596869164,400088959
1635391539,-176694,true,21215864940,22,21618475755,402610815
1635391586,-176692,true,21220108325,22,21657422105,437313780
1635391626,-176692,true,21220108325,22,21683425310,463316985
1635391656,-176682,true,21241337985,22,21711630682,470292697
1635391661,-176673,true,21260462838,22,21715973226,455510388
1635391678,-176671,true,21264715143,22,21729006067,464290924
1635391716,-176671,true,21264715143,22,21744220935,479505792
1635391730,-176662,true,21283861044,22,21752919929,469058885
1635391772,-176652,true,21305154485,22,21768151541,462997056
1635391776,-176650,true,21309415729,22,21765974944,456559215
1635391810,-176653,true,21303024183,22,21761622402,458598219
1635391811,-176644,true,21322204575,22,21761622402,439417827
1635391821,-176636,true,21339268310,22,21761622402,422354092
1635391852,-176635,true,21341402237,22,21763798564,422396327
1635391878,-176636,true,21339268310,22,21768151541,428883231
1635391917,-176628,true,21356345701,22,21772505389,416159688
1635391925,-176624,true,21364889521,22,21768151541,403262020
1635391949,-176620,true,21373436759,22,21759446457,386009698
1635391967,-176623,true,21367026010,22,21752919929,385893919
1635391977,-176617,true,21379849431,22,21750744854,370895423
1635392012,-176612,true,21390541494,22,21744220935,353679441
1635392020,-176608,true,21399098994,22,21742046731,342947737
1635392073,-176606,true,21403379028,22,21742046731,338667703
1635392079,-176599,true,21418365889,22,21742046731,323680842
1635392096,-176593,true,21431220121,22,21737698974,306478853
1635392099,-176591,true,21435506580,22,21733352086,297845506
1635392106,-176591,true,21435506580,22,21733352086,297845506
1635392116,-176584,true,21450515936,22,21733352086,282836150
1635392186,-176574,true,21471976108,22,21715973226,243997118
1635392253,-176572,true,21476270718,22,21696438618,220167900
1635392278,-176572,true,21476270718,22,21694269191,217998473
1635392294,-176565,true,21491308618,22,21698608262,207299644
1635392359,-176554,true,21514960881,22,21700778123,185817242
1635392399,-176552,true,21519264088,22,21700778123,181514035
1635392414,-176558,true,21506357048,22,21692099981,185742933
1635392434,-176552,true,21519264088,22,21692099981,172835893
1635392473,-176543,true,21538639175,22,21694269191,155630016
1635392489,-176541,true,21542947118,22,21696438618,153491500
1635392496,-176540,true,21545101413,22,21696438618,151337205
1635392510,-176533,true,21560187509,22,21698608262,138420753
1635392527,-176528,true,21570969759,22,21702948201,131978442
1635392598,-176525,true,21577441697,22,21726833384,149391687
1635392602,-176525,true,21577441697,22,21726833384,149391687
1635392632,-176522,true,21583915577,22,21724660918,140745341
1635392667,-176514,true,21601188754,22,21724660918,123472164
1635392680,-176512,true,21605509208,22,21729006067,123496859
1635392743,-176512,true,21605509208,22,21737698974,132189766
1635392754,-176507,true,21616314123,22,21746395358,130081235
1635392788,-176501,true,21629287155,22,21752919929,123632774
1635392801,-176500,true,21631450083,22,21755095221,123645138
1635392918,-176497,true,21637940167,22,21827002020,189061853
1635392931,-176491,true,21650926178,22,21831367639,180441461
1635392943,-176484,true,21666086373,22,21833550776,167464403
1635392951,-176481,true,21672586849,22,21837917704,165330855
1635393002,-176478,true,21679089276,22,21853208834,174119558
1635393060,-176475,true,21685593653,22,21851023731,165430078
1635393100,-176469,true,21698608262,22,21835734131,137125869
1635393116,-176467,true,21702948201,22,21829184721,126236520
1635393120,-176464,true,21709459736,22,21829184721,119724985
1635393122,-176462,true,21713801845,22,21829184721,115382876
1635393125,-176457,true,21724660918,22,21829184721,104523803
1635393129,-176452,true,21735525421,22,21829184721,93659300
1635393144,-176451,true,21737698974,22,21824819539,87120565
1635393183,-176453,true,21733352086,22,21822637275,89285189
1635393192,-176450,true,21739872744,22,21816091793,76219049
1635393198,-176445,true,21750744854,22,21813910402,63165548
1635393202,-176445,true,21750744854,22,21811729229,60984375
1635393229,-176451,true,21737698974,22,21798646770,60947796
1635393244,-176450,true,21739872744,22,21787750716,47877972
1635393246,-176448,true,21744220935,22,21785572159,41351224
1635393267,-176443,true,21755095221,22,21789929491,34834270
1635393281,-176445,true,21750744854,22,21792108484,41363630
1635393306,-176441,true,21759446457,22,21803006718,43560261
1635393309,-176439,true,21763798564,22,21805187019,41388455
1635393314,-176439,true,21763798564,22,21798646770,34848206
1635393330,-176448,true,21744220935,22,21792108484,47887549
1635393342,-176447,true,21746395358,22,21792108484,45713126
1635393365,-176445,true,21750744854,22,21789929491,39184637
1635393370,-176441,true,21759446457,22,21789929491,30483034
1635393391,-176456,true,21726833384,22,21781215698,54382314
1635393396,-176459,true,21720316637,22,21781215698,60899061
1635393411,-176457,true,21724660918,22,21776860108,52199190
1635393431,-176452,true,21735525421,22,21774682640,39157219
1635393439,-176461,true,21715973226,22,21770328357,54355131
1635393469,-176466,true,21705118496,22,21755095221,49976725
1635393498,-176464,true,21709459736,22,21742046731,32586995
1635393525,-176460,true,21718144823,22,21744220935,26076112
1635393562,-176470,true,21696438618,22,21733352086,36913468
1635393572,-176472,true,21692099981,22,21729006067,36906086
1635393582,-176469,true,21698608262,22,21726833384,28225122
1635393617,-176465,true,21707289007,22,21724660918,17371911
1635393634,-176475,true,21685593653,22,21722488669,36895016
1635393635,-176477,true,21681257184,22,21722488669,41231485
1635393693,-176474,true,21687762212,22,21700778123,13015911
1635393733,-176472,true,21692099981,22,21663919981,-28180000
1635393738,-176482,true,21670419807,22,21659587847,-10831960
1635393782,-176488,true,21657422105,22,21603348873,-54073232
1635393831,-176499,true,21633613228,22,21482714243,-150898985
1635393848,-176502,true,21627124442,22,21441937875,-185186567
1635393869,-176514,true,21601188754,22,21392680548,-208508206
1635393888,-176523,true,21581757401,22,21343536377,-238221024
1635393945,-176537,true,21551565590,22,21203139875,-348425715
1635393963,-176543,true,21538639175,22,21156546568,-382092607
1635394003,-176553,true,21517112377,22,21086848515,-430263862
1635394011,-176562,true,21497756655,22,21072093623,-425663032
1635394057,-176564,true,21493457749,22,21019481812,-473975937
1635394088,-176563,true,21495607095,22,20983780832,-511826263
1635394119,-176566,true,21489159702,22,20954425560,-534734142
1635394181,-176576,true,21467682357,22,20870779444,-596902913
1635394193,-176580,true,21459097430,22,20845750780,-613346650
1635394212,-176586,true,21446226477,22,20816588606,-629637871
1635394223,-176591,true,21435506580,22,20804103023,-631403557
1635394271,-176608,true,21399098994,22,20721056966,-678042028
1635394291,-176613,true,21388402654,22,20692069231,-696333423
1635394316,-176618,true,21377711660,22,20646598988,-731112672
1635394325,-176623,true,21367026010,22,20630089139,-736936871
1635394373,-176649,true,21311546671,22,20533360048,-778186623
1635394460,-176652,true,21305154485,22,20406453378,-898701107
1635394472,-176658,true,21292375865,22,20386058144,-906317721
1635394493,-176664,true,21279604910,22,20351433016,-928171894
1635394509,-176689,true,21226474994,22,20320930274,-905544720
1635394540,-176699,true,21205260189,22,20258036072,-947224117
1635394547,-176704,true,21194660739,22,20243861117,-950799622
1635394564,-176713,true,21175595078,22,20205436217,-970158861
1635394581,-176737,true,21124837122,22,20171117870,-953719252
1635394596,-176749,true,21099503787,22,20136857812,-962645975
1635394636,-176761,true,21074200833,22,20048454687,-1025746146
1635394642,-176771,true,21053138218,22,20036429824,-1016708394
1635394648,-176799,true,20994274821,22,20022409931,-971864890
1635394664,-176815,true,20960712517,22,19988402449,-972310068
1635394665,-176828,true,20933482655,22,19986403809,-947078846
1635394728,-176836,true,20916743402,22,19908612515,-1008130887
1635394739,-176864,true,20858261358,22,19894682059,-963579299
1635394751,-176876,true,20833247706,22,19884737702,-948510004
1635394781,-176888,true,20808264051,22,19858905629,-949358422
1635394801,-176898,true,20787467227,22,19841041547,-946425680
1635394833,-176924,true,20733492708,22,19817247766,-916244942
1635394883,-176935,true,20710699545,22,19785567105,-925132440
1635394919,-176952,true,20675523023,22,19730247766,-945275257
1635394941,-176961,true,20656924353,22,19690828674,-966095679
1635394948,-176988,true,20601228665,22,19677050605,-924178060
1635394963,-177002,true,20572408564,22,19649523384,-922885180
1635394978,-177017,true,20541574624,22,19618110854,-923463770
1635394995,-177025,true,20525148757,22,19586748542,-938400215
1635395013,-177050,true,20473902532,22,19555436366,-918466166
1635395023,-177064,true,20445260555,22,19535891681,-909368874
1635395056,-177074,true,20424826534,22,19491013004,-933813530
1635395070,-177078,true,20416658646,22,19471532707,-945125939
1635395073,-177104,true,20363646929,22,19467638984,-896007945
1635395097,-177121,true,20329059866,22,19434573765,-894486101
1635395124,-177132,true,20306711311,22,19399624743,-907086568
1635395139,-177138,true,20294531548,22,19384112025,-910419523
1635395176,-177176,true,20217562510,22,19279725137,-937837373
1635395185,-177194,true,20181205447,22,19272015175,-909190272
1635395223,-177210,true,20148942948,22,19200844025,-948098923
1635395239,-177213,true,20142899474,22,19181653737,-961245737
1635395240,-177241,true,20086581054,22,19181653737,-904927317
1635395252,-177260,true,20048454687,22,19170148772,-878305915
1635395273,-177274,true,20020407891,22,19149074255,-871333636
1635395289,-177281,true,20006399209,22,19124197875,-882201334
1635395313,-177316,true,19936502697,22,19080264959,-856237738
1635395323,-177336,true,19896671527,22,19061195184,-835476343
1635395357,-177347,true,19874798315,22,19002199919,-872598396
1635395358,-177350,true,19868837068,22,19000299889,-868537179
1635395384,-177384,true,19801401099,22,18947176113,-854224986
1635395406,-177410,true,19749986895,22,18901759683,-848227212
1635395447,0,false,0,0,18820660659,18820660659
1635395457,0,false,0,0,18807491465,18807491465
1635395494,0,false,0,0,18758657940,18758657940
1635395510,-177490,true,19592625154,22,18741783586,-850841568
1635395527,-177509,true,19555436366,22,18728669583,-826766783
1635395547,-177513,true,19547616146,22,18713693388,-833922758
1635395556,-177541,true,19492962105,22,18711822206,-781139899
1635395562,-177564,true,19448182048,22,18708080402,-740101646
1635395587,-177579,true,19419033100,22,18698729168,-720303932
1635395620,-177579,true,19419033100,22,18689382607,-729650493
1635395636,-177608,true,19362802289,22,18683776914,-679025375
1635395655,-177630,true,19320253073,22,18670703500,-649549573
1635395715,-177641,true,19299013540,22,18665103409,-633910131
1635395724,-177641,true,19299013540,22,18663237085,-635776455
1635395796,-177669,true,19245054578,22,18638991852,-606062726
1635395826,-177691,true,19202764109,22,18631538119,-571225990
1635395832,-177700,true,19185490260,22,18629675151,-555815109
1635395848,-177699,true,19187408809,22,18622225144,-565183665
1635395879,-177720,true,19147159539,22,18631538119,-515621420
1635395894,-177724,true,19139502590,22,18635264613,-504237977
1635395954,-177725,true,19137588831,22,18640855751,-496733080
1635395968,-177721,true,19145245015,22,18635264613,-509980402
1635395974,-177734,true,19120373610,22,18637128139,-483245471
1635396000,-177736,true,19116550108,22,18640855751,-475694357
1635396009,-177735,true,19118461763,22,18642719837,-475741926
1635396030,-177725,true,19137588831,22,18661370948,-476217883
1635396047,-177738,true,19112727372,22,18687513856,-425213516
1635396075,-177745,true,19099353813,22,18753031468,-346322345
1635396108,-177746,true,19097444068,22,18807491465,-289952603
1635396130,-177744,true,19101263748,22,18830072871,-271190877
1635396147,-177758,true,19074542024,22,18841373740,-233168284
1635396164,-177766,true,19059289255,22,18852681391,-206607864
1635396177,-177771,true,19049762469,22,18862109617,-187652852
1635396190,-177767,true,19057383517,22,18873429713,-183953804
1635396203,-177775,true,19042144468,22,18886645077,-155499391
1635396228,-177783,true,19026917606,22,18907430778,-119486828
1635396278,-177788,true,19017407000,22,18960443116,-56963884
1635396322,-177784,true,19025015104,22,19030723180,5708076
1635396324,-177788,true,19017407000,22,19032626252,15219252
1635396336,-177798,true,18998400049,22,19057383517,58983468
1635396362,-177800,true,18994600939,22,19106994700,112393761
1635396398,-177790,true,19013604089,22,19168231949,154627860
1635396439,-177795,true,19004100139,22,19237358481,233258342
1635396461,-177799,true,18996500399,22,19270088166,273587767
1635396498,-177800,true,18994600939,22,19312526903,317925964
1635396523,-177788,true,19017407000,22,19337648258,320241258
1635396565,-177794,true,19006000549,22,19386050436,380049887
1635396596,-177796,true,19002199919,22,19407385757,405185838
1635396597,-177793,true,19007901149,22,19407385757,399484608
1635396600,-177780,true,19032626252,22,19409326495,376700243
1635396617,-177783,true,19026917606,22,19422917101,395999495
1635396657,-177780,true,19032626252,22,19463746040,431119788
1635396659,-177776,true,19040240444,22,19463746040,423505596
1635396667,-177765,true,19061195184,22,19469585748,408390564
1635396683,-177769,true,19053572612,22,19479322488,425749876
1635396698,-177772,true,19047857683,22,19487115386,439257703
1635396717,-177768,true,19055477969,22,19502710536,447232567
1635396731,-177758,true,19074542024,22,19506611273,432069249
1635396737,-177764,true,19063101304,22,19512463842,449362538
1635396755,-177769,true,19053572612,22,19518318166,464745554
1635396766,-177764,true,19063101304,22,19518318166,455216862
1635396801,-177753,true,19084081203,22,19518318166,434236963
1635396814,-177760,true,19070727688,22,19514415088,443687400
1635396838,-177762,true,19066914115,22,19514415088,447500973
1635396869,-177760,true,19070727688,22,19516366529,445638841
1635396880,-177750,true,19089807000,22,19512463842,422656842
1635396906,-177755,true,19080264959,22,19510512790,430247831
1635396927,-177757,true,19076449479,22,19494911401,418461922
1635396945,-177758,true,19074542024,22,19483218547,408676523
1635396982,-177749,true,19091715981,22,19457908084,366192103
1635397009,-177755,true,19080264959,22,19432630502,352365543
1635397023,-177756,true,19078357123,22,19434573765,356216642
1635397034,-177755,true,19080264959,22,19434573765,354308806
1635397073,-177743,true,19103173874,22,19432630502,329456628
1635397084,-177735,true,19118461763,22,19432630502,314168739
1635397094,-177735,true,19118461763,22,19430687433,312225670
1635397100,-177729,true,19129935709,22,19428744558,298808849
1635397113,-177716,true,19154819552,22,19428744558,273925006
1635397129,-177719,true,19149074255,22,19424859392,275785137
1635397142,-177718,true,19150989162,22,19424859392,273870230
1635397166,-177716,true,19154819552,22,19428744558,273925006
1635397169,-177703,true,19179735763,22,19428744558,249008795
1635397214,-177704,true,19177817982,22,19424859392,247041410
1635397242,-177702,true,19181653737,22,19417091391,235437654
1635397300,-177702,true,19181653737,22,19370548572,188894835
1635397326,-177690,true,19204684386,22,19345384477,140700091
1635397370,-177689,true,19206604854,22,19306734304,100129450
1635397383,-177685,true,19214288648,22,19297083832,82795184
1635397397,-177678,true,19227742686,22,19287438184,59695498
1635397482,-177668,true,19246979084,22,19210446367,-36532717
1635397485,-177670,true,19243130265,22,19206604854,-36525411
1635397529,-177668,true,19246979084,22,19166315317,-80663767
1635397552,-177665,true,19252753755,22,19145245015,-107508740
1635397595,-177655,true,19272015175,22,19120373610,-151641565
1635397619,-177659,true,19264308295,22,19106994700,-157313595
1635397653,-177659,true,19264308295,22,19085989611,-178318684
1635397680,-177659,true,19264308295,22,19074542024,-189766271
1635397698,-177653,true,19275869770,22,19066914115,-208955655
1635397769,-177654,true,19273942376,22,19045953088,-227989288
1635397801,-177650,true,19281653110,22,19047857683,-233795427
1635397803,-177653,true,19275869770,22,19047857683,-228012087
1635397846,-177648,true,19285509633,22,19030723180,-254786453
1635397855,-177648,true,19285509633,22,19026917606,-258592027
1635397875,-177648,true,19285509633,22,19021210672,-264298961
1635397999,-177652,true,19277797357,22,18933918394,-343878963
1635398056,-177644,true,19293224994,22,18916886384,-376338610
1635398065,-177649,true,19283581275,22,18913103574,-370477701
1635398085,-177653,true,19275869770,22,18901759683,-374110087
1635398126,-177656,true,19270088166,22,18884756602,-385331564
1635398140,-177652,true,19277797357,22,18879092308,-398705049
1635398178,-177655,true,19272015175,22,18873429713,-398585462
1635398208,-177658,true,19266234726,22,18879092308,-387142418
1635398226,-177661,true,19260456012,22,18880980217,-379475795
1635398247,-177663,true,19256604498,22,18882868315,-373736183
1635398268,-177668,true,19246979084,22,18884756602,-362222482
1635398285,-177677,true,19229665460,22,18884756602,-344908858
1635398296,-177682,true,19220053512,22,18884756602,-335296910
1635398314,-177682,true,19220053512,22,18888533742,-331519770
1635398357,-177685,true,19214288648,22,18903649859,-310638789
1635398368,-177691,true,19202764109,22,18909321521,-293442588
1635398395,-177691,true,19202764109,22,18918778073,-283986036
1635398422,-177691,true,19202764109,22,18928239354,-274524755
1635398456,-177694,true,19197004432,22,18939599137,-257405295
1635398503,-177700,true,19185490260,22,18949070831,-236419429
1635398512,-177699,true,19187408809,22,18952860834,-234547975
1635398556,-177701,true,19183571902,22,18958547261,-225024641
1635398568,-177705,true,19175900392,22,18956651596,-219248796
1635398723,-177715,true,19156735034,22,18920669951,-236065083
1635398777,-177717,true,19152904261,22,18913103574,-239800687
1635398778,-177725,true,19137588831,22,18913103574,-224485257
1635398797,-177729,true,19129935709,22,18916886384,-213049325
1635398857,-177736,true,19116550108,22,18932025191,-184524917
1635398866,-177736,true,19116550108,22,18933918394,-182631714
1635398904,-177747,true,19095534515,22,18911212453,-184322062
1635398936,-177753,true,19084081203,22,18888533742,-195547461
1635398956,-177764,true,19063101304,22,18875317056,-187784248
1635398983,-177764,true,19063101304,22,18860223595,-202877709
1635398998,-177774,true,19044048683,22,18854566659,-189482024
1635399012,-177778,true,19036432967,22,18848911420,-187521547
1635399043,-177794,true,19006000549,22,18824424979,-181575570
1635399060,-177795,true,19004100139,22,18809372214,-194727925
1635399087,-177806,true,18983208166,22,18784937138,-198271028
1635399093,-177809,true,18977514342,22,18779302784,-198211558
1635399106,-177819,true,18958547261,22,18768039145,-190508116
1635399149,-177822,true,18952860834,22,18721179988,-231680846
1635399168,-177831,true,18935811785,22,18706209781,-229602004
1635399253,-177836,true,18926346719,22,18620363107,-305983612
1635399268,-177845,true,18909321521,22,18607334065,-301987456
1635399326,-177845,true,18909321521,22,18560876150,-348445371
1635399344,-177855,true,18890422595,22,18542325478,-348097117
1635399355,-177858,true,18884756602,22,18527498290,-357258312
1635399358,-177868,true,18865882228,22,18521941152,-343941076
1635399379,-177876,true,18850796311,22,18492331221,-358465090
1635399387,-177890,true,18824424979,22,18479391766,-345033213
1635399431,-177898,true,18809372214,22,18407466080,-401906134
1635399456,-177914,true,18779302784,22,18348659270,-430643514
1635399477,-177929,true,18751156352,22,18299187181,-451969171
1635399508,-177944,true,18723052106,22,18238902402,-484149704
1635399550,-177958,true,18696859482,22,18151569803,-545289679
1635399571,-177975,true,18665103409,22,18106249818,-558853591
1635399601,-177992,true,18633401272,22,18024958800,-608442472
1635399620,-178013,true,18594314140,22,17976359480,-617954660
1635399625,-178030,true,18562732237,22,17967373996,-595358241
1635399629,-178047,true,18531203975,22,17960188843,-571015132
1635399691,-178056,true,18514534228,22,17831346315,-683187913
1635399697,-178074,true,18481239705,22,17817087655,-664152050
1635399716,-178090,true,18451694841,22,17767272075,-684422766
1635399764,-178107,true,18420355173,22,17666291740,-754063433
1635399819,-178113,true,18409306827,22,17602810599,-806496228
1635399845,-178131,true,18376201534,22,17562372678,-813828856
1635399882,-178144,true,18352329186,22,17523779855,-828549331
1635399909,-178157,true,18328487850,22,17490517945,-837969905
1635399923,-178159,true,18324822702,22,17476531825,-848290877
1635399945,-178174,true,18297357445,22,17453828230,-843529215
1635399976,-178188,true,18271760347,22,17420699095,-851061252
1635399981,-178200,true,18249848480,22,17415473930,-834374550
1635400018,-178203,true,18244374620,22,17375466367,-868908253
1635400053,-178215,true,18222495595,22,17342485971,-880009624
1635400065,-178226,true,18202462871,22,17332084121,-870378750
1635400112,-178239,true,18178816225,22,17287081481,-891734744
1635400138,-178242,true,18173363671,22,17255994275,-917369396
1635400172,-178257,true,18146125421,22,17206026878,-940098543
1635400201,-178271,true,18120739889,22,17156204169,-964535720
1635400215,-178287,true,18091771334,22,17130490438,-961280896
1635400249,-178294,true,18079112159,22,17070641511,-1008470648
1635400251,-178311,true,18048405312,22,17067227895,-981177417
1635400256,-178329,true,18015949024,22,17058696840,-957252184
1635400269,-178349,true,17979954932,22,17041647522,-938307410
1635400303,-178356,true,17967373996,22,17004198978,-963175018
1635400311,-178375,true,17933270100,22,16992300799,-940969301
1635400316,-178393,true,17901020859,22,16987204128,-913816731
1635400337,-178409,true,17872403557,22,16973620478,-898783079
1635400350,-178414,true,17863470035,22,16971923286,-891546749
1635400374,-178434,true,17827780581,22,16965136213,-862644368
1635400388,-178453,true,17793941647,22,16958351855,-835589792
1635400412,-178469,true,17765495525,22,16946485756,-819009769
1635400479,-178478,true,17749514571,22,16916011040,-833503531
1635400512,-178496,true,17717595776,22,16921086351,-796509425
1635400538,-178516,true,17682197764,22,16902484319,-779713445
1635400544,-178535,true,17648635161,22,16895725015,-752910146
1635400548,-178547,true,17627470558,22,16892346377,-735124181
1635400575,-178569,true,17588734685,22,16870401691,-718332994
1635400582,-178591,true,17550083933,22,16865341583,-684742350
1635400595,-178609,true,17518523772,22,16853540565,-664983207
1635400603,-178620,true,17499264953,22,16850170362,-649094591
1635400658,0,false,0,0,16776196174,16776196174
1635400663,0,false,0,0,16769487372,16769487372
1635400669,0,false,0,0,16759429201,16759429201
1635400675,0,false,0,0,16751051999,16751051999
1635400685,-178735,true,17299186069,22,16734310157,-564875912
1635400691,-178758,true,17259445647,22,16724273084,-535172563
1635400717,-178781,true,17219796518,22,16674177950,-545618568
1635400726,0,false,0,0,16655847354,16655847354
1635400744,0,false,0,0,16624232868,16624232868
1635400760,0,false,0,0,16592678390,16592678390
1635400771,0,false,0,0,16561183805,16561183805
1635400779,0,false,0,0,16541323296,16541323296
1635400782,0,false,0,0,16534708420,16534708420
1635400823,0,false,0,0,16434158715,16434158715
1635400839,0,false,0,0,16399684915,16399684915
1635400845,0,false,0,0,16391487532,16391487532
1635400856,-179005,true,16838379959,22,16376742567,-461637392
1635400857,-179021,true,16811461438,22,16376742567,-434718871
1635400903,-179030,true,16796338685,22,16317895225,-478443460
1635400919,-179043,true,16774518722,22,16299956305,-474562417
1635400954,-179064,true,16739330952,22,16265764021,-473566931
1635400973,-179080,true,16712570774,22,16244633322,-467937452
1635400994,-179084,true,16705887417,22,16223530074,-482357343
1635401011,-179095,true,16687521962,22,16208936195,-478585767
1635401019,-179114,true,16655847354,22,16202454241,-453393113
1635401026,-179128,true,16632546647,22,16200834158,-431712489
1635401039,-179125,true,16637536910,22,16202454241,-435082669
1635401074,-179150,true,16595997091,22,16150691840,-445305251
1635401077,-179171,true,16561183805,22,16147462186,-413721619
1635401089,-179185,true,16538015527,22,16139390876,-398624651
1635401097,-179187,true,16534708420,22,16139390876,-395317544
1635401136,-179194,true,16523138753,22,16142618916,-380519837
1635401149,-179215,true,16488478301,22,16139390876,-349087425
1635401199,-179231,true,16462119146,22,16128097820,-334021326
1635401214,-179234,true,16457181498,22,16124872684,-332308814
1635401221,-179238,true,16450600271,22,16118424347,-332175924
1635401255,-179254,true,16424301670,22,16107145962,-317155708
1635401359,-179266,true,16404605313,22,16084612861,-319992452
1635401421,-179269,true,16399684915,22,16017202519,-382482396
1635401447,-179269,true,16399684915,22,15997994363,-401690552
1635401466,-179288,true,16368556652,22,15970822234,-397734418
1635401490,-179310,true,16332587206,22,15935726799,-396860407
1635401512,-179323,true,16311369698,22,15900708485,-410661213
1635401546,-179328,true,16303216459,22,15857836619,-445379840
1635401554,-179345,true,16275525920,22,15846740572,-428785348
1635401573,-179368,true,16238137093,22,15818243519,-419893574
1635401611,-179377,true,16223530074,22,15778749273,-444780801
1635401629,-179392,true,16199214236,22,15756675583,-442538653
1635401685,-179416,true,16160384678,22,15685933370,-474451308
1635401691,-179437,true,16126485172,22,15681228531,-445256641
1635401706,-179447,true,16110367552,22,15682796653,-427570899
1635401787,-179456,true,16095875469,22,15626442901,-469432568
1635401794,-179472,true,16070143945,22,15617070316,-453073629
1635401835,-179494,true,16034830253,22,15573405861,-461424392
1635401883,-179508,true,16012398319,22,15511239761,-501158558
1635401907,-179516,true,15999594163,22,15480249831,-519344332
1635401919,-179532,true,15974016558,22,15467871202,-506145356
1635401943,-179551,true,15943696256,22,15433880988,-509815268
1635401948,-179562,true,15926168709,22,15432337754,-493830955
1635401976,-179573,true,15908660430,22,15410748676,-497911754
1635401980,-179590,true,15881640032,22,15407666989,-473973043
1635402014,-179610,true,15849910079,22,15363051709,-486858370
1635402033,-179619,true,15835652290,22,15336958011,-498694279
1635402053,-179627,true,15822989467,22,15309377696,-513611771
1635402084,-179638,true,15805594617,22,15287960633,-517633984
1635402135,-179654,true,15780327148,22,15249790373,-530536775
1635402136,-179658,true,15774016595,22,15249790373,-524226222
1635402149,-179658,true,15774016595,22,15245216351,-528800244
1635402175,-179666,true,15761403059,22,15233025664,-528377395
1635402177,-179674,true,15748799608,22,15233025664,-515773944
1635402192,-179677,true,15744075913,22,15225411436,-518664477
1635402240,-179674,true,15748799608,22,15214757909,-534041699
1635402258,-179678,true,15742501663,22,15214757909,-527743754
1635402302,-179685,true,15731486319,22,15245216351,-486269968
1635402355,-179685,true,15731486319,22,15306316279,-425170040
1635402373,-179681,true,15737779857,22,15330824762,-406955095
1635402407,-179684,true,15733059467,22,15392267793,-340791674
1635402425,-179689,true,15725195297,22,15424623899,-300571398
1635402446,-179691,true,15722050729,22,15463231768,-258818961
1635402474,-179685,true,15731486319,22,15512790885,-218695434
1635402487,-179690,true,15723622935,22,15536076366,-187546569
1635402504,-179692,true,15720478682,22,15568734773,-151743909
1635402509,-179693,true,15718906791,22,15576520698,-142386093
1635402540,-179684,true,15733059467,22,15646769470,-86289997
1635402552,-179683,true,15734632773,22,15676525103,-58107670
1635402555,-179687,true,15728340493,22,15684364933,-43975560
1635402599,-179693,true,15718906791,22,15756675583,37768792
1635402631,-179684,true,15733059467,22,15799273959,66214492
1635402647,-179676,true,15745650321,22,15819825343,74175022
1635402665,-179677,true,15744075913,22,15846740572,102664659
1635402718,-179676,true,15745650321,22,15926168709,180518388
1635402751,-179662,true,15767708566,22,15986800245,219091679
1635402757,-179655,true,15778749273,22,15996394724,217645451
1635402773,-179654,true,15780327148,22,16030020766,249693618
1635402796,-179645,true,15794535125,22,16068537091,274001966
1635402815,-179629,true,15819825343,22,16100704714,280879371
1635402932,-179615,true,15841987501,22,16330954111,488966610
1635402977,-179615,true,15841987501,22,16406245773,564258272
1635402985,-179600,true,15865767123,22,16417733591,551966468
1635402992,-179584,true,15891171399,22,16429229453,538058054
1635403006,-179571,true,15911842321,22,16450600271,538757950
1635403026,-179568,true,15916616351,22,16476940981,560324630
1635403067,-179555,true,15937320372,22,16528096190,590775818
1635403075,-179543,true,15956455678,22,16533055115,576599437
1635403086,-179534,true,15970822234,22,16539669329,568847095
1635403097,-179540,true,15961243094,22,16544631726,583388632
1635403126,-179544,true,15954860192,22,16561183805,606323613
1635403177,-179530,true,15977211521,22,16587701582,610490061
1635403206,-179521,true,15991596765,22,16609278537,617681772
1635403235,-179528,true,15980407123,22,16610939465,630532342
1635403260,-179534,true,15970822234,22,16614261819,643439585
1635403266,-179521,true,15991596765,22,16619246596,627649831
1635403281,-179513,true,16004394521,22,16629220637,624826116
1635403282,-179520,true,15993195925,22,16630883559,637687634
1635403301,-179527,true,15982005164,22,16640864584,658859420
1635403330,-179504,true,16018804239,22,16645857343,627053104
1635403340,-179498,true,16028417925,22,16647521928,619104003
1635403363,-179503,true,16020406119,22,16657512939,637106820
1635403394,-179507,true,16013999559,22,16669176697,655177138
1635403423,-179501,true,16023610361,22,16679180703,655570342
1635403481,-179495,true,16033226931,22,16702546740,669319809
1635403552,-179503,true,16020406119,22,16704216995,683810876
1635403565,-179507,true,16013999559,22,16699206732,685207173
1635403649,-179501,true,16023610361,22,16647521928,623911567
1635403675,-179497,true,16030020766,22,16635873323,605852557
1635403679,-179505,true,16017202519,22,16634209902,617007383
1635403742,-179499,true,16026815243,22,16610939465,584124222
1635403769,-179486,true,16047662608,22,16595997091,548334483
1635403809,-179477,true,16062111283,22,16577752443,515641160
1635403861,-179470,true,16073358135,22,16556216443,482858308
1635403867,-179454,true,16099094805,22,16554560987,455466182
1635403885,-179431,true,16136163482,22,16554560987,418397505
1635403892,-179419,true,16155537532,22,16556216443,400678911
1635403920,-179404,true,16179787809,22,16557872065,378084256
1635403946,-179391,true,16200834158,22,16557872065,357037907
1635403967,-179367,true,16239760907,22,16554560987,314800080
1635404075,-179349,true,16269017336,22,16600976388,331959052
1635404078,-179334,true,16293437952,22,16602636486,309198534
1635404194,-179316,true,16322791083,22,16669176697,346385614
1635404226,-179301,true,16347292416,22,16690859633,343567217
1635404275,-179288,true,16368556652,22,16725945511,357388859
1635404293,-179275,true,16389848547,22,16741004885,351156338
1635404327,-179252,true,16427586694,22,16784585950,356999256
1635404381,-179238,true,16450600271,22,16836696290,386096019
1635404492,-179229,true,16465411735,22,16949875222,484463487
1635404557,-179218,true,16483532746,22,17029723139,546190393
1635404575,-179200,true,16513228338,22,17045056022,531827684
1635404627,-179182,true,16542977428,22,17089428608,546451180
1635404644,-179170,true,16562839923,22,17109947206,547107283
1635404718,-179152,true,16592678390,22,17202586189,609907799
1635404746,-179134,true,16622570611,22,17242195690,619625079
1635404864,-179114,true,16655847354,22,17368517918,712670564
1635404876,-179105,true,16670843614,22,17380679528,709835914
1635404882,-179089,true,16697536978,22,17385894254,688357276
1635404917,-179071,true,16727618106,22,17418957199,691339093
1635404974,-179056,true,16752727105,22,17469542960,716815855
1635405002,-179049,true,16764457532,22,17483523487,719065955
1635405058,-179039,true,16781229536,22,17506265709,725036173
1635405078,-179021,true,16811461438,22,17515020593,703559155
1635405130,-179010,true,16829963295,22,17546574442,716611147
1635405162,-179004,true,16840063797,22,17567641916,727578119
1635405171,-178995,true,16855225919,22,17574670027,719444108
1635405186,-178980,true,16880526463,22,17581700950,701174487
1635405209,-178970,true,16897414588,22,17578185137,680770549
1635405224,-178967,true,16902484319,22,17576427494,673943175
1635405264,-178958,true,16917702641,22,17590493559,672790918
1635405279,-178944,true,16941402826,22,17590493559,649090733
1635405288,-178933,true,16960047690,22,17595771234,635723544
1635405312,-178929,true,16966832727,22,17609852779,643020052
1635405376,-178928,true,16968529410,22,17627470558,658941148
1635405403,-178913,true,16994000029,22,17636286057,642286028
1635405426,-178906,true,17005899398,22,17641577472,635678074
1635405443,-178903,true,17011001678,22,17646870474,635868796
1635405465,-178898,true,17019508880,22,17659226990,639718110
1635405479,-178877,true,17055285613,22,17662759012,607473399
1635405520,-178869,true,17068934618,22,17673359317,604424699
1635405542,-178865,true,17075763216,22,17675126653,599363437
1635405568,-178862,true,17080886457,22,17671592158,590705701
1635405660,-178846,true,17108236382,22,17652165065,543928683
1635405696,-178842,true,17115080703,22,17645105964,530025261
1635405785,-178841,true,17116792211,22,17602810599,486018388
1635405804,-178841,true,17116792211,22,17592252608,475460397
1635405858,-178831,true,17133916708,22,17571155620,437238912
1635405895,-178828,true,17139057397,22,17550083933,411026536
1635405914,-178832,true,17132203488,22,17539557567,407354079
1635405917,-178832,true,17132203488,22,17537803787,405600299
1635405955,-178824,true,17145914048,22,17527284786,381370738
1635405976,-178819,true,17154488720,22,17518523772,364035052
1635405994,-178822,true,17149343403,22,17508016336,358672933
1635406002,-178819,true,17154488720,22,17502764981,348276261
1635406055,-178816,true,17159635581,22,17459064902,299429321
1635406059,-178811,true,17168217115,22,17457319170,289102055
1635406066,-178812,true,17166500465,22,17452083021,285582556
1635406097,-178807,true,17175085432,22,17431154128,256068696
1635406134,-178797,true,17192268249,22,17406768805,214500556
1635406176,-178795,true,17195706874,22,17378941634,183234760
1635406276,-178798,true,17190549194,22,17352894065,162344871
1635406316,-178794,true,17197426445,22,17342485971,145059526
1635406320,-178783,true,17216353075,22,17340751896,124398821
1635406323,-178781,true,17219796518,22,17339017994,119221476
1635406345,-178787,true,17209468255,22,17321688509,112220254
1635406367,-178791,true,17202586189,22,17297456323,94870134
1635406399,-178788,true,17207747481,22,17271530884,63783403
1635406464,-178780,true,17221518498,22,17212910321,-8608177
1635406598,-178784,true,17214631612,22,17089428608,-125203004
1635406644,-178787,true,17209468255,22,17056991141,-152477114
1635406646,-178783,true,17216353075,22,17053580255,-162772820
1635406669,-178778,true,17224962974,22,17033129254,-191833720
1635406741,-178785,true,17212910321,22,16965136213,-247774108
1635406750,-178786,true,17211189202,22,16958351855,-252837347
1635406761,-178780,true,17221518498,22,16949875222,-271643276
1635406802,-178770,true,17238747768,22,16924470738,-314277030
1635406863,-178774,true,17231853992,22,16875463318,-356390674
1635406941,-178774,true,17231853992,22,16826597807,-405256185
1635407005,-178773,true,17233577178,22,16777873793,-455703385
1635407023,-178770,true,17238747768,22,16762781254,-475966514
1635407036,-178775,true,17230130979,22,16751051999,-479078980
1635407056,-178778,true,17224962974,22,16739330952,-485632022
1635407061,-178778,true,17224962974,22,16734310157,-490652817
1635407100,-178781,true,17219796518,22,16687521962,-532274556
1635407157,-178787,true,17209468255,22,16634209902,-575258353
1635407160,-178795,true,17195706874,22,16632546647,-563160227
1635407195,-178794,true,17197426445,22,16599316457,-598109988
1635407280,-178795,true,17195706874,22,16542977428,-652729446
1635407292,-178802,true,17183674693,22,16536361891,-647312802
1635407300,-178811,true,17168217115,22,16533055115,-635162000
1635407340,-178818,true,17156204169,22,16498373861,-657830308
1635407352,-178822,true,17149343403,22,16493425339,-655918064
1635407379,-178833,true,17130490438,22,16478588675,-651901763
1635407380,-178842,true,17115080703,22,16476940981,-638139722
1635407418,-178848,true,17104815248,22,16460473099,-644342149
1635407430,-178853,true,17096265405,22,16455535944,-640729461
1635407457,-178859,true,17086011235,22,16444021675,-641989560
1635407482,-178867,true,17072348575,22,16434158715,-638189860
1635407501,-178871,true,17065521343,22,16425944100,-639577243
1635407506,-178875,true,17058696840,22,16422659404,-636037436
1635407577,-178885,true,17041647522,22,16396405470,-645242052
1635407622,-178900,true,17016105489,22,16384932576,-631172913
1635407686,-178905,true,17007599988,22,16370193507,-637406481
1635407739,-178913,true,16994000029,22,16358738954,-635261075
1635407755,-178924,true,16975317840,22,16347292416,-628025424
1635407775,-178940,true,16948180404,22,16334220465,-613959939
1635407831,-178950,true,16931241541,22,16291808771,-639432770
1635407854,-178962,true,16910937252,22,16275525920,-635411332
1635407873,-178973,true,16892346377,22,16264137607,-628208770
1635407889,-178988,true,16867028117,22,16256007977,-611020140
1635407900,-178999,true,16848485514,22,16246257786,-602227728
1635407907,-179012,true,16826597807,22,16239760907,-586836900
1635407908,-179024,true,16806419008,22,16239760907,-566658101
1635407913,-179046,true,16769487372,22,16233266626,-536220746
1635407923,-179059,true,16747702292,22,16225152427,-522549865
1635407931,-179074,true,16722600824,22,16217042284,-505558540
1635407947,-179083,true,16707558006,22,16204074486,-503483520
1635407962,-179104,true,16672510699,22,16192736170,-479774529
1635407985,-179116,true,16652516684,22,16178169992,-474346692
1635407998,-179130,true,16629220637,22,16171700341,-457520296
1635408032,-179136,true,16619246596,22,16155537532,-463709064
1635408058,-179149,true,16597656691,22,16142618916,-455037775
1635408075,-179157,true,16584384539,22,16136163482,-448221057
1635408084,-179170,true,16562839923,22,16134550027,-428289896
1635408189,-179173,true,16557872065,22,16102314785,-455557280
1635408229,-179189,true,16531401975,22,16100704714,-430697261
1635408239,-179198,true,16516531149,22,16100704714,-415826435
1635408310,-179213,true,16491776161,22,16062111283,-429664878
1635408345,-179219,true,16481884558,22,16042849272,-439035286
1635408357,-179234,true,16457181498,22,16039641184,-417540314
1635408361,-179244,true,16440733364,22,16039641184,-401092180
1635408445,-179255,true,16422659404,22,16015600959,-407058445
1635408490,-179257,true,16419375365,22,16004394521,-414980844
1635408532,-179272,true,16394765994,22,15994795244,-399970750
1635408572,-179279,true,16383294247,22,15989997765,-393296482
1635408581,-179287,true,16370193507,22,15986800245,-383393262
1635408625,-179287,true,16370193507,22,15978809243,-391384264
1635408646,-179300,true,16348927145,22,15978809243,-370117902
1635408662,-179307,true,16337487472,22,15982005164,-355482308
1635408735,-179315,true,16324423362,22,16013999559,-310423803
1635408822,-179313,true,16327688410,22,16076572967,-251115443
1635408833,-179325,true,16308107913,22,16086221323,-221886590
1635408862,-179328,true,16303216459,22,16107145962,-196070497
1635408900,-179326,true,16306477266,22,16194355444,-112121822
1635408934,-179319,true,16317895225,22,16215420742,-102474483
1635408991,-179335,true,16291808771,22,16249507200,-42301571
1635409059,-179336,true,16290179753,22,16311369698,21189945
1635409079,-179338,true,16286922206,22,16324423362,37501156
1635409086,-179332,true,16296696803,22,16329321179,32624376
1635409109,-179345,true,16275525920,22,16350562038,75036118
1635409113,-179349,true,16269017336,22,16353832314,84814978
1635409157,-179350,true,16267390597,22,16394765994,127375397
1635409163,-179339,true,16285293677,22,16399684915,114391238
1635409184,-179346,true,16273898530,22,16422659404,148760874
1635409189,-179349,true,16269017336,22,16427586694,158569358
1635409190,-179350,true,16267390597,22,16427586694,160196097
1635409205,-179341,true,16282037107,22,16440733364,158696257
1635409216,-179351,true,16265764021,22,16447310644,181546623
1635409244,-179351,true,16265764021,22,16476940981,211176960
1635409341,-179350,true,16267390597,22,16551250571,283859974
1635409376,-179337,true,16288550898,22,16569466053,280915155
1635409429,-179347,true,16272271303,22,16600976388,328705085
1635409438,-179348,true,16270644238,22,16605957179,335312941
1635409497,-179349,true,16269017336,22,16630883559,361866223
1635409521,-179337,true,16288550898,22,16642528670,353977772
1635409580,-179348,true,16270644238,22,16657512939,386868701
1635409593,-179347,true,16272271303,22,16662510693,390239390
1635409667,-179351,true,16265764021,22,16655847354,390083333
1635409670,-179340,true,16283665310,22,16655847354,372182044
1635409702,-179352,true,16264137607,22,16644192923,380055316
1635409790,-179353,true,16262511356,22,16576094834,313583478
1635409837,-179355,true,16259259342,22,16541323296,282063954
1635409845,-179345,true,16275525920,22,16536361891,260835971
1635409854,-179357,true,16256007977,22,16531401975,275393998
1635409871,-179360,true,16251132150,22,16519834621,268702471
1635409892,-179365,true,16243009021,22,16508275361,265266340
1635409905,-179354,true,16260885268,22,16495074681,234189413
1635409959,-179366,true,16241384883,22,16439089455,197704572
1635409982,-179369,true,16236513442,22,16416091982,179578540
1635409988,-179371,true,16233266626,22,16411168139,177901513
1635410000,-179361,true,16249507200,22,16402965016,153457816
1635410092,-179369,true,16236513442,22,16334220465,97707023
1635410100,-179375,true,16226774942,22,16329321179,102546237
1635410210,-179378,true,16221907883,22,16247882411,25974528
1635410254,-179368,true,16238137093,22,16221907883,-16229210
1635410259,-179376,true,16225152427,22,16220285855,-4866572
1635410270,-179383,true,16213799362,22,16217042284,3242922
1635410316,-179384,true,16212178144,22,16187879321,-24298823
1635410399,-179373,true,16230020460,22,16147462186,-82558274
1635410409,-179381,true,16217042284,22,16142618916,-74423368
1635410487,-179387,true,16207315463,22,16113589787,-93725676
1635410540,-179389,true,16204074486,22,16102314785,-101759701
1635410555,-179378,true,16221907883,22,16099094805,-122813078
1635410614,-179385,true,16210557089,22,16097485056,-113072033
1635410696,-179386,true,16208936195,22,16103925016,-105011179
1635410701,-179383,true,16213799362,22,16103925016,-109874346
1635410704,-179371,true,16233266626,22,16105535409,-127731217
1635410716,-179377,true,16223530074,22,16107145962,-116384112
1635410786,-179376,true,16225152427,22,16121648194,-103504233
1635410802,-179372,true,16231643462,22,16126485172,-105158290
1635410863,-179359,true,16252757263,22,16145847601,-106909662
1635410893,-179361,true,16249507200,22,16153922139,-95585061
1635410922,-179360,true,16251132150,22,16152306909,-98825241
1635410935,-179355,true,16259259342,22,16150691840,-108567502
1635410936,-179346,true,16273898530,22,16150691840,-123206690
1635410950,-179353,true,16262511356,22,16142618916,-119892440
1635410957,-179355,true,16259259342,22,16141004815,-118254527
1635410981,-179353,true,16262511356,22,16131323601,-131187755
1635410999,-179347,true,16272271303,22,16124872684,-147398619
1635411022,-179354,true,16260885268,22,16118424347,-142460921
1635411052,-179359,true,16252757263,22,16108756677,-144000586
1635411084,-179358,true,16254382539,22,16099094805,-155287734
1635411095,-179353,true,16262511356,22,16097485056,-165026300
1635411129,-179363,true,16246257786,22,16073358135,-172899651
1635411144,-179368,true,16238137093,22,16070143945,-167993148
1635411213,-179367,true,16239760907,22,16030020766,-209740141
1635411217,-179361,true,16249507200,22,16028417925,-221089275
1635411229,-179369,true,16236513442,22,16020406119,-216107323
1635411289,-179375,true,16226774942,22,15988398925,-238376017
1635411326,-179379,true,16220285855,22,15959647129,-260638726
1635411351,-179375,true,16226774942,22,15940507995,-286266947
1635411426,-179385,true,16210557089,22,15884816519,-325740570
1635411471,-179393,true,16197594477,22,15851495070,-346099407
1635411485,-179397,true,16191117058,22,15848325246,-342791812
1635411502,-179393,true,16197594477,22,15843571700,-354022777
1635411528,-179400,true,16186260695,22,15835652290,-350608405
1635411552,-179402,true,16183023928,22,15826154223,-356869705
1635411573,-179409,true,16171700341,22,15816661853,-355038488
1635411619,-179408,true,16173317511,22,15794535125,-378782386
1635411621,-179417,true,16158768801,22,15791376692,-367392109
1635411647,-179420,true,16153922139,22,15777171556,-376750583
1635411659,-179437,true,16126485172,22,15770862265,-355622907
1635411665,-179441,true,16120036190,22,15766131952,-353904238
1635411689,-179447,true,16110367552,22,15753524721,-356842831
1635411778,-179454,true,16099094805,22,15700056358,-399038447
1635411787,-179464,true,16083004561,22,15698486509,-384518052
1635411809,-179470,true,16073358135,22,15687501963,-385856172
1635411819,-179478,true,16060505233,22,15684364933,-376140300
1635411848,-179482,true,16054082636,22,15681228531,-372854105
1635411850,-179494,true,16034830253,22,15681228531,-353601722
1635411888,-179500,true,16025212722,22,15678092755,-347119967
1635411919,-179508,true,16012398319,22,15674957607,-337440712
1635412040,-179505,true,16017202519,22,15715763481,-301439038
1635412057,-179517,true,15997994363,22,15723622935,-274371428
1635412163,-179519,true,15994795244,22,15775593997,-219201247
1635412224,-179521,true,15991596765,22,15813498995,-178097770
1635412231,-179520,true,15993195925,22,15818243519,-174952406
1635412233,-179535,true,15969225312,22,15819825343,-149399969
1635412355,-179536,true,15967628549,22,15895939227,-71689322
1635412369,-179539,true,15962839218,22,15907069723,-55769495
1635412421,-179537,true,15966031946,22,15926168709,-39863237
1635412471,-179548,true,15948479843,22,15945290626,-3189217
1635412488,-179548,true,15948479843,22,15954860192,6380349
1635412590,-179545,true,15953264866,22,16042849272,89584406
1635412598,-179542,true,15958051324,22,16050872301,92820977
1635412633,-179546,true,15951669699,22,16089438728,137769029
1635412662,-179543,true,15956455678,22,16123260358,166804680
1635412697,-179534,true,15970822234,22,16165233278,194411044
1635412712,-179526,true,15983603365,22,16186260695,202657330
1635412785,-179528,true,15980407123,22,16273898530,293491407
1635412835,-179523,true,15988398925,22,16337487472,349088547
1635412879,-179512,true,16005994960,22,16386571069,380576109
1635412917,-179502,true,16022008160,22,16429229453,407221293
1635412955,-179499,true,16026815243,22,16476940981,450125738
1635412995,-179492,true,16038037380,22,16524791067,486753687
1635413015,-179479,true,16058899343,22,16549595612,490696269
1635413031,-179466,true,16079788442,22,16569466053,489677611
1635413069,-179461,true,16087829945,22,16622570611,534740666
1635413084,-179452,true,16102314785,22,16650851599,548536814
1635413115,-179438,true,16124872684,22,16707558006,582685322
1635413118,-179426,true,16144233178,22,16712570774,568337596
1635413212,-179416,true,16160384678,22,16883902737,723518059
1635413249,-179408,true,16173317511,22,16953265367,779947856
1635413256,-179394,true,16195974879,22,16966832727,770857848
1635413293,-179383,true,16213799362,22,17021210831,807411469
1635413360,-179379,true,16220285855,22,17108236382,887950527
1635413462,-179374,true,16228397620,22,17218074711,989677091
1635413488,-179360,true,16251132150,22,17247368866,996236716
1635413516,-179351,true,16265764021,22,17266350461,1000586440
1635413572,-179349,true,16269017336,22,17293997351,1024980015
1635413636,-179345,true,16275525920,22,17318224691,1042698771
1635413714,-179329,true,16301586301,22,17378941634,1077355333
1635413747,-179318,true,16319527014,22,17405028302,1085501288
1635413806,-179311,true,16330954111,22,17460810808,1129856697
1635413839,-179304,true,16342389209,22,17487020366,1144631157
1635413882,-179284,true,16375105056,22,17523779855,1148674799
1635413913,-179273,true,16393126681,22,17550083933,1156957252
1635413998,-179266,true,16404605313,22,17592252608,1187647295
1635414024,-179258,true,16417733591,22,17597530812,1179797221
1635414047,-179239,true,16448955375,22,17597530812,1148575437
1635414069,-179226,true,16470351852,22,17601050494,1130698642
1635414099,-179220,true,16480236534,22,17604570880,1124334346
1635414163,-179210,true,16496724189,22,17615136263,1118412074
1635414202,-179186,true,16536361891,22,17638049685,1101687794
1635414229,-179169,true,16564496207,22,17657461244,1092965037
1635414259,-179160,true,16579410218,22,17678661855,1099251637
1635414375,-179152,true,16592678390,22,17724683878,1132005488
1635414397,-179131,true,16627557881,22,17733547992,1105990111
1635414468,-179115,true,16654181936,22,17779712897,1125530961
1635414567,-179106,true,16669176697,22,17836696254,1167519557
1635414581,-179099,true,16680848621,22,17840263772,1159415151
1635414589,-179075,true,16720928731,22,17845616386,1124687655
1635414640,-179058,true,16749377062,22,17856326433,1106949371
1635414675,-179047,true,16767810591,22,17852755703,1084945112
1635414687,-179039,true,16781229536,22,17850970606,1069741070
1635414698,-179016,true,16819868850,22,17849185688,1029316838
1635414704,-179000,true,16846800833,22,17847400948,1000600115
1635414794,-178994,true,16856911441,22,17801060291,944148850
1635414843,-178987,true,16868714820,22,17772602790,903887970
1635414882,-178964,true,16907555572,22,17749514571,841958999
1635414895,-178946,true,16938015054,22,17742416540,804401486
1635414940,-178942,true,16944791276,22,17719367536,774576260
1635415041,-178935,true,16956656189,22,17678661855,722005666
1635415064,-178916,true,16988902848,22,17666291740,677388892
1635415069,-178904,true,17009300748,22,17662759012,653458264
1635415126,-178897,true,17021210831,22,17636286057,615075226
1635415163,-178889,true,17034832567,22,17618659467,583826900
1635415166,-178868,true,17070641511,22,17616897777,546256266
1635415240,-178853,true,17096265405,22,17609852779,513587374
1635415256,-178846,true,17108236382,22,17608091970,499855588
1635415299,-178836,true,17125352319,22,17602810599,477458280
1635415377,-178815,true,17161351545,22,17590493559,429142014
1635415437,-178800,true,17187111599,22,17578185137,391073538
1635415465,-178795,true,17195706874,22,17562372678,366665804
1635415472,-178785,true,17212910321,22,17557105019,344194698
1635415480,-178766,true,17245644302,22,17555349484,309705182
1635415505,-178754,true,17266350461,22,17544819960,278469499
1635415634,-178744,true,17283624583,22,17523779855,240155272
1635415649,-178734,true,17300915987,22,17525532233,224616246
1635415702,-178715,true,17333817329,22,17530790418,196973089
1635415772,-178710,true,17342485971,22,17529037515,186551544
1635415884,-178703,true,17354629354,22,17522027652,167398298
1635415890,-178696,true,17366781240,22,17522027652,155246412
1635415974,-178679,true,17396328398,22,17527284786,130956388
1635416034,-178674,true,17405028302,22,17522027652,116999350
1635416042,-178666,true,17418957199,22,17520275625,101318426
1635416069,-178658,true,17432897243,22,17518523772,85626529
1635416112,-178640,true,17464303145,22,17513269266,48966121
1635416176,-178635,true,17473037043,22,17508016336,34979293
1635416245,-178626,true,17488769068,22,17516772095,28003027
1635416279,-178620,true,17499264953,22,17516772095,17507142
1635416298,-178606,true,17523779855,22,17516772095,-7007760
1635416372,-178604,true,17527284786,22,17515020593,-12264193
1635416420,-178600,true,17534296752,22,17508016336,-26280416
1635416464,-178597,true,17539557567,22,17501014880,-38542687
1635416558,-178587,true,17557105019,22,17487020366,-70084653
1635416579,-178586,true,17558860730,22,17485271839,-73588891
1635416587,-178583,true,17564128915,22,17485271839,-78857076
1635416597,-178581,true,17567641916,22,17483523487,-84118429
1635416609,-178573,true,17581700950,22,17483523487,-98177463
1635416712,-178573,true,17581700950,22,17485271839,-96429111
1635416725,-178573,true,17581700950,22,17485271839,-96429111
1635416727,-178573,true,17581700950,22,17487020366,-94680584
1635416764,-178566,true,17594011833,22,17488769068,-105242765
1635416865,-178565,true,17595771234,22,17494016224,-101755010
1635416898,-178567,true,17592252608,22,17495765625,-96486983
1635416956,-178570,true,17586975988,22,17494016224,-92959764
1635417025,-178566,true,17594011833,22,17504515258,-89496575
1635417072,-178564,true,17597530812,22,17523779855,-73750957
1635417112,-178568,true,17590493559,22,17530790418,-59703141
1635417145,-178569,true,17588734685,22,17532543497,-56191188
1635417209,-178563,true,17599290565,22,17541311523,-57979042
1635417251,-178562,true,17601050494,22,17557105019,-43945475
1635417301,-178561,true,17602810599,22,17581700950,-21109649
1635417358,-178561,true,17602810599,22,17590493559,-12317040
1635417443,-178556,true,17611613764,22,17606331337,-5282427
1635417468,-178555,true,17613374926,22,17611613764,-1761162
1635417496,-178554,true,17615136263,22,17616897777,1761514
1635417546,-178550,true,17622183375,22,17630996229,8812854
1635417574,-178548,true,17625707988,22,17638049685,12341697
1635417626,-178548,true,17625707988,22,17646870474,21162486
1635417757,-178552,true,17618659467,22,17666291740,47632273
1635417810,-178552,true,17618659467,22,17680429721,61770254
1635417842,-178553,true,17616897777,22,17691040632,74142855
1635417926,-178553,true,17616897777,22,17701657910,84760133
1635417964,-178556,true,17611613764,22,17694579017,82965253
1635417997,-178557,true,17609852779,22,17694579017,84726238
1635418025,-178556,true,17611613764,22,17696348474,84734710
1635418097,-178555,true,17613374926,22,17710510509,97135583
1635418154,-178556,true,17611613764,22,17717595776,105982012
1635418210,-178556,true,17611613764,22,17719367536,107753772
1635418229,-178557,true,17609852779,22,17724683878,114831099
1635418291,-178554,true,17615136263,22,17761942959,146806696
1635418462,-178549,true,17623945593,22,17906391702,282446109
1635418545,-178545,true,17630996229,22,17972764748,341768519
1635418568,-178544,true,17632759329,22,17990745602,357986273
1635418609,-178538,true,17643341629,22,18035776480,392434851
1635418660,-178531,true,17655695674,22,18093580512,437884838
1635418713,-178524,true,17668058370,22,18144310990,476252620
1635418779,-178522,true,17671592158,22,18211565923,539973765
1635418784,-178517,true,17680429721,22,18215208418,534778697
1635418815,-178510,true,17692809736,22,18248023678,555213942
1635418853,-178503,true,17705198419,22,18288211511,583013092
1635418869,-178502,true,17706968938,22,18297357445,590388507
1635418886,-178497,true,17715824194,22,18308338605,592514411
1635418924,-178487,true,17733547992,22,18326655184,593107192
1635418962,-178481,true,17744190781,22,18346824588,602633807
1635418979,-178479,true,17747739797,22,18355999835,608260038
1635419032,-178472,true,17760166942,22,18396425465,636258523
1635419038,-178461,true,17779712897,22,18401944945,622232048
1635419052,-178454,true,17792162430,22,18412988872,620826442
1635419064,-178451,true,17797500613,22,18422197208,624696595
1635419098,-178441,true,17815306125,22,18459076626,643770501
1635419176,-178430,true,17834912763,22,18521941152,687028389
1635419225,-178422,true,17849185688,22,18553453655,704267967
1635419394,-178420,true,17852755703,22,18637128139,784372436
1635419395,-178410,true,17870616495,22,18637128139,766511644
1635419453,-178399,true,17890284005,22,18672570570,782286565
1635419483,-178392,true,17902810961,22,18685645291,782834330
1635419497,-178389,true,17908182342,22,18683776914,775594572
1635419505,-178380,true,17924306154,22,18685645291,761339137
1635419531,-178368,true,17945827156,22,18693120671,747293515
1635419535,-178361,true,17958393004,22,18693120671,734727667
1635419599,-178354,true,17970967651,22,18708080402,737112751
1635419653,-178343,true,17990745602,22,18723052106,732306504
1635419661,-178334,true,18006943751,22,18724924411,717980660
1635419700,-178328,true,18017750619,22,18736162175,718411556
1635419743,-178321,true,18030366829,22,18745532130,715165301
1635419747,-178308,true,18053820375,22,18747406683,693586308
1635419793,-178298,true,18071882321,22,18769915948,698033627
1635419824,-178292,true,18082728162,22,18788694313,705966151
1635419862,-178284,true,18097199409,22,18816897091,719697682
1635419899,-178271,true,18120739889,22,18837606031,716866142
1635419924,-178261,true,18138868785,22,18848911420,710042635
1635419935,-178254,true,18151569803,22,18854566659,702996856
1635419968,-178247,true,18164279715,22,18871542558,707262843
1635419974,-178234,true,18187907451,22,18875317056,687409605
1635419987,-178224,true,18206103546,22,18882868315,676764769
1635420002,-178217,true,18218851642,22,18886645077,667793435
1635420128,-178211,true,18229785686,22,18920669951,690884265
1635420162,-178197,true,18255323982,22,18930132178,674808196
1635420186,-178184,true,18279070148,22,18939599137,660528989
1635420216,-178174,true,18297357445,22,18969925234,672567789
1635420310,-178164,true,18315663039,22,19013604089,697941050
1635420354,-178150,true,18341321641,22,19032626252,691304611
1635420389,-178137,true,18365179671,22,19049762469,684582798
1635420419,-178129,true,18379876958,22,19066914115,687037157
1635420456,-178119,true,18398265108,22,19082172986,683907878
1635420565,-178100,true,18433253290,22,19164398877,731145587
1635420575,-178087,true,18457230903,22,19172065787,714834884
1635420622,-178076,true,18477544011,22,19223897714,746353703
1635420646,-178064,true,18499729263,22,19252753755,753024492
1635420683,-178044,true,18536763893,22,19285509633,748745740
1635420737,-178032,true,18559020248,22,19326049729,767029481
1635420784,-178024,true,18573872661,22,19353123792,779251131
1635420790,-178014,true,18592454894,22,19355059104,762604210
1635420834,-178001,true,18616639593,22,19356994610,740355017
1635420847,-177993,true,18631538119,22,19362802289,731264170
1635420949,-177987,true,18642719837,22,19395745400,753025563
1635420951,-177978,true,18659504997,22,19397684974,738179977
1635420982,-177961,true,18691251546,22,19413208555,721957009
1635421006,-177952,true,18708080402,22,19424859392,716778990
1635421014,-177943,true,18724924411,22,19428744558,703820147
1635421056,-177933,true,18743657764,22,19448182048,704524284
1635421131,-177917,true,18773670119,22,19452071879,678401760
1635421144,-177907,true,18792452240,22,19452071879,659619639
1635421175,-177899,true,18807491465,22,19454017086,646525621
1635421219,-177890,true,18824424979,22,19459853875,635428896
1635421268,-177872,true,18858337761,22,19481270420,622932659
1635421283,-177862,true,18877204587,22,19485166869,607962282
1635421321,-177853,true,18894200869,22,19498810579,604609710
1635421327,-177843,true,18913103574,22,19500760460,587656886
1635421384,-177824,true,18949070831,22,19522222025,573151194
1635421440,-177815,true,18966131818,22,19528079277,561947459
1635421450,-177806,true,18983208166,22,19530032085,546823919
1635421482,-177797,true,19000299889,22,19528079277,527779388
1635421485,-177781,true,19030723180,22,19528079277,497356097
1635421513,-177771,true,19049762469,22,19524174247,474411778
1635421548,-177763,true,19065007614,22,19510512790,445505176
1635421586,-177754,true,19082172986,22,19506611273,424438287
1635421601,-177740,true,19108905400,22,19504660807,395755407
1635421631,-177739,true,19110816290,22,19502710536,391894246
1635421671,-177733,true,19122285647,22,19502710536,380424889
1635421675,-177725,true,19137588831,22,19502710536,365121705
1635421692,-177713,true,19160566572,22,19504660807,344094235
1635421699,-177715,true,19156735034,22,19506611273,349876239
1635421730,-177715,true,19156735034,22,19516366529,359631495
1635421757,-177709,true,19168231949,22,19514415088,346183139
1635421808,-177698,true,19189327550,22,19510512790,321185240
1635421831,-177701,true,19183571902,22,19498810579,315238677
1635421836,-177702,true,19181653737,22,19496860893,315207156
1635421859,-177696,true,19193165607,22,19487115386,293949779
1635421868,-177689,true,19206604854,22,19477374751,270769897
1635421893,-177690,true,19204684386,22,19459853875,255169489
1635421932,-177690,true,19204684386,22,19426801878,222117492
1635421947,-177687,true,19210446367,22,19411267428,200821061
1635421957,-177680,true,19223897714,22,19407385757,183488043
1635421994,-177681,true,19221975517,22,19384112025,162136508
1635421999,-177682,true,19220053512,22,19382173807,162120295
1635422062,-177675,true,19233511586,22,19360866203,127354617
1635422095,-177671,true,19241206145,22,19353123792,111917647
1635422132,-177673,true,19237358481,22,19335714686,98356205
1635422194,-177675,true,19233511586,22,19295154317,61642731
1635422222,-177670,true,19243130265,22,19277797357,34667092
1635422241,-177666,true,19250828672,22,19266234726,15406054
1635422264,-177669,true,19245054578,22,19243130265,-1924313
1635422284,-177672,true,19239282216,22,19223897714,-15384502
1635422331,-177667,true,19248903782,22,19185490260,-63413522
1635422336,-177664,true,19254679030,22,19181653737,-73025293
1635422387,-177666,true,19250828672,22,19141416540,-109412132
1635422399,-177668,true,19246979084,22,19129935709,-117043375
1635422403,-177665,true,19252753755,22,19128022906,-124730849
1635422415,-177663,true,19256604498,22,19116550108,-140054390
1635422421,-177664,true,19254679030,22,19112727372,-141951658
1635422506,-177666,true,19250828672,22,19057383517,-193445155
1635422530,-177664,true,19254679030,22,19042144468,-212534562
1635422578,-177662,true,19258530159,22,19007901149,-250629010
1635422623,-177662,true,19258530159,22,18992701668,-265828491
1635422642,-177664,true,19254679030,22,18987004997,-267674033
1635422646,-177663,true,19256604498,22,18983208166,-273396332
1635422668,-177663,true,19256604498,22,18964235394,-292369104
1635422729,-177671,true,19241206145,22,18916886384,-324319761
1635422746,-177676,true,19231588427,22,18905540224,-326048203
1635422754,-177675,true,19233511586,22,18901759683,-331751903
1635422785,-177676,true,19231588427,22,18890422595,-341165832
1635422789,-177686,true,19212367412,22,18888533742,-323833670
1635422799,-177691,true,19202764109,22,18884756602,-318007507
1635422810,-177689,true,19206604854,22,18880980217,-325624637
1635422851,-177691,true,19202764109,22,18869655593,-333108516
1635422858,-177701,true,19183571902,22,18863995828,-319576074
1635422936,-177710,true,19166315317,22,18807491465,-358823852
1635422989,-177713,true,19160566572,22,18756782261,-403784311
1635422993,-177716,true,19154819552,22,18753031468,-401788084
1635423021,-177725,true,19137588831,22,18736162175,-401426656
1635423050,-177732,true,19124197875,22,18717436314,-406761561
1635423079,-177729,true,19129935709,22,18709951210,-419984499
1635423105,-177736,true,19116550108,22,18698729168,-417820940
1635423121,-177745,true,19099353813,22,18689382607,-409971206
1635423136,-177754,true,19082172986,22,18678172901,-404000085
1635423163,-177754,true,19082172986,22,18678172901,-404000085
1635423173,-177762,true,19066914115,22,18676305271,-390608844
1635423244,-177773,true,19045953088,22,18642719837,-403233251
1635423254,-177778,true,19036432967,22,18640855751,-395577216
1635423356,-177774,true,19044048683,22,18625949775,-418098908
1635423362,-177779,true,19034529514,22,18624087366,-410442148
1635423426,-177783,true,19026917606,22,18627812370,-399105236
1635423484,-177786,true,19021210672,22,18638991852,-382218820
1635423579,-177782,true,19028820298,22,18646448567,-382371731
1635423606,-177790,true,19013604089,22,18659504997,-354099092
1635423638,-177794,true,19006000549,22,18678172901,-327827648
1635423645,-177800,true,18994600939,22,18681908723,-312692216
1635423735,-177794,true,19006000549,22,18732415505,-273585044
1635423753,-177801,true,18992701668,22,18743657764,-249043904
1635423833,-177803,true,18988903698,22,18811253151,-177650547
1635424036,-177808,true,18979412094,22,18950965738,-28446356
1635424211,-177801,true,18992701668,22,19030723180,38021512
1635424230,-177809,true,18977514342,22,19036432967,58918625
1635424258,-177812,true,18971822226,22,19045953088,74130862
1635424309,-177819,true,18958547261,22,19057383517,98836256
1635424352,-177813,true,18969925234,22,19059289255,89364021
1635424374,-177822,true,18952860834,22,19059289255,106428421
1635424403,-177825,true,18947176113,22,19065007614,117831501
1635424409,-177832,true,18933918394,22,19066914115,132995721
1635424450,-177828,true,18941493097,22,19065007614,123514517
1635424501,-177837,true,18924454274,22,19068820806,144366532
1635424521,-177842,true,18914994885,22,19068820806,153825921
1635424554,-177849,true,18901759683,22,19068820806,167061123
1635424634,-177843,true,18913103574,22,19070727688,157624114
1635424733,-177850,true,18899869696,22,19074542024,174672328
1635424872,-177858,true,18884756602,22,18994600939,109844337
1635424913,-177865,true,18871542558,22,18971822226,100279668
1635425004,-177862,true,18877204587,22,18926346719,49142132
1635425041,-177871,true,18860223595,22,18916886384,56662789
1635425053,-177877,true,18848911420,22,18914994885,66083465
1635425105,-177880,true,18843257877,22,18901759683,58501806
1635425204,-177873,true,18856452116,22,18873429713,16977597
1635425365,-177885,true,18833839074,22,18792452240,-41386834
1635425398,-177890,true,18824424979,22,18769915948,-54509031
1635425431,-177894,true,18816897091,22,18747406683,-69490408
1635425462,-177889,true,18826307422,22,18721179988,-105127434
1635425491,-177901,true,18803730530,22,18694989983,-108740547
1635425535,-177907,true,18792452240,22,18655773656,-136678584
1635425562,-177908,true,18790573183,22,18635264613,-155308570
1635425585,-177899,true,18807491465,22,18622225144,-185266321
1635425708,-177910,true,18786815632,22,18577587622,-209228010
1635425758,-177917,true,18773670119,22,18551598495,-222071624
1635425791,-177920,true,18768039145,22,18538617569,-229421576
1635425816,-177915,true,18777425041,22,18533057096,-244367945
1635425894,-177929,true,18751156352,22,18499729263,-251427089
1635425925,-177936,true,18738035791,22,18481239705,-256796086
1635425981,-177939,true,18732415505,22,18444316008,-288099497
1635426014,-177934,true,18741783586,22,18420355173,-321428413
1635426068,-177949,true,18713693388,22,18381714945,-331978443
1635426115,-177955,true,18702469101,22,18352329186,-350139915
1635426172,-177957,true,18698729168,22,18328487850,-370241318
1635426178,-177952,true,18708080402,22,18324822702,-383257700
1635426216,-177965,true,18683776914,22,18315663039,-368113875
1635426244,-177971,true,18672570570,22,18306507954,-366062616
1635426262,-177973,true,18668836616,22,18297357445,-371479171
1635426336,-177966,true,18681908723,22,18301017100,-380891623
1635426356,-177979,true,18657639233,22,18306507954,-351131279
1635426380,-177986,true,18644584109,22,18312000456,-332583653
1635426399,-177986,true,18644584109,22,18317494605,-327089504
1635426425,-177979,true,18657639233,22,18322990403,-334648830
1635426453,-177991,true,18635264613,22,18326655184,-308609429
1635426477,-177997,true,18624087366,22,18326655184,-297432182
1635426515,-177996,true,18625949775,22,18333986946,-291962829
1635426555,-177990,true,18637128139,22,18324822702,-312305437
1635426578,-178001,true,18616639593,22,18321158287,-295481306
1635426613,-178002,true,18614778115,22,18313831656,-300946459
1635426666,-178002,true,18614778115,22,18321158287,-293619828
1635426707,-177996,true,18625949775,22,18321158287,-304791488
1635426729,-178007,true,18605473518,22,18319326355,-286147163
1635426756,-178008,true,18603613157,22,18321158287,-282454870
1635426784,-178008,true,18603613157,22,18321158287,-282454870
1635426792,-178001,true,18616639593,22,18321158287,-295481306
1635426827,-178012,true,18596173571,22,18317494605,-278678966
1635426908,-178012,true,18596173571,22,18324822702,-271350869
1635426945,-178011,true,18598033189,22,18324822702,-273210487
1635426950,-178003,true,18612916824,22,18322990403,-289926421
1635426959,-178013,true,18594314140,22,18322990403,-271323737
1635427078,-178011,true,18598033189,22,18354164419,-243868770
1635427088,-178009,true,18601752981,22,18355999835,-245753146
1635427092,-178006,true,18607334065,22,18355999835,-251334230
1635427104,-178016,true,18588736961,22,18361507186,-227229775
1635427137,-178011,true,18598033189,22,18372526845,-225506344
1635427190,-178008,true,18603613157,22,18396425465,-207187692
1635427200,-178007,true,18605473518,22,18396425465,-209048053
1635427261,-178016,true,18588736961,22,18412988872,-175748089
1635427311,-178009,true,18601752981,22,18424039428,-177713553
1635427313,-178008,true,18603613157,22,18425881832,-177731325
1635427328,-178008,true,18603613157,22,18424039428,-179573729
1635427334,-178019,true,18583161455,22,18424039428,-159122027
1635427384,-178015,true,18590595835,22,18435096616,-155499219
1635427440,-178015,true,18590595835,22,18446160439,-144435396
1635427490,-178015,true,18590595835,22,18466461364,-124134471
1635427629,-178026,true,18570158444,22,18523793347,-46365097
1635427671,-178023,true,18575730049,22,18538617569,-37112480
1635427686,-178022,true,18577587622,22,18546034128,-31553494
1635427742,-178024,true,18573872661,22,18572015460,-1857201
1635427771,-178035,true,18553453655,22,18579445380,25991725
1635427790,-178033,true,18557164531,22,18585019771,27855240
1635427806,-178033,true,18557164531,22,18586878273,29713742
1635427824,-178036,true,18551598495,22,18594314140,42715645
1635427866,-178049,true,18527498290,22,18607334065,79835775
1635427977,-178048,true,18529351040,22,18607334065,77983025
1635428017,-178049,true,18527498290,22,18596173571,68675281
1635428031,-178053,true,18520089144,22,18592454894,72365750
1635428087,-178067,true,18494180454,22,18564588510,70408056
1635428177,-178068,true,18492331221,22,18529351040,37019819
1635428244,-178069,true,18490482173,22,18507130265,16648092
1635428328,-178071,true,18486784631,22,18470154841,-16629790
1635428539,-178083,true,18464614903,22,18396425465,-68189438
1635428605,-178084,true,18462768626,22,18378039154,-84729472
1635428608,-178084,true,18462768626,22,18378039154,-84729472
1635428698,-178087,true,18457230903,22,18350494136,-106736767
1635428734,-178100,true,18433253290,22,18343155773,-90097517
1635428778,-178096,true,18440627698,22,18339487692,-101140006
1635428945,-178095,true,18442471761,22,18337653927,-104817834
1635429029,-178095,true,18442471761,22,18352329186,-90142575
1635429031,-178106,true,18422197208,22,18352329186,-69868022
1635429088,-178104,true,18425881832,22,18348659270,-77222562
1635429209,-178103,true,18427724420,22,18383553117,-44171303
1635429216,-178106,true,18422197208,22,18383553117,-38644091
1635429277,-178113,true,18409306827,22,18383553117,-25753710
1635429333,-178110,true,18414830171,22,18387230011,-27600160
1635429375,-178109,true,18416671654,22,18394586007,-22085647
1635429445,-178107,true,18420355173,22,18405625518,-14729655
1635429470,-178109,true,18416671654,22,18412988872,-3682782
1635429555,-178103,true,18427724420,22,18435096616,7372196
1635429582,-178102,true,18429567193,22,18440627698,11060505
1635429615,-178102,true,18429567193,22,18446160439,16593246
1635429736,-178108,true,18418513322,22,18436940125,18426803
1635429845,-178107,true,18420355173,22,18390907641,-29447532
1635429908,-178107,true,18420355173,22,18359671219,-60683954
1635429947,-178107,true,18420355173,22,18344990089,-75365084
1635429992,-178114,true,18407466080,22,18335820345,-71645735
1635430015,-178113,true,18409306827,22,18324822702,-84484125
1635430044,-178112,true,18411147758,22,18310169439,-100978319
1635430163,-178113,true,18409306827,22,18253498632,-155808195
1635430194,-178119,true,18398265108,22,18238902402,-159362706
1635430208,-178119,true,18398265108,22,18229785686,-168479422
1635430249,-178119,true,18398265108,22,18204283117,-193981991
1635430364,-178122,true,18392746732,22,18117116284,-275630448
1635430401,-178131,true,18376201534,22,18077304428,-298897106
1635430446,-178131,true,18376201534,22,18032169866,-344031668
1635430467,-178132,true,18374364097,22,18010545320,-363818777
1635430575,-178141,true,18357835435,22,17909973160,-447862275
1635430592,-178150,true,18341321641,22,17893862241,-447459400
1635430640,-178152,true,18337653927,22,17850970606,-486683321
1635430671,-178155,true,18332153731,22,17833129450,-499024281
1635430688,-178165,true,18313831656,22,17822433316,-491398340
1635430719,-178175,true,18295527893,22,17802840397,-492687496
1635430806,-178180,true,18286382872,22,17735321347,-551061525
1635430817,-178184,true,18279070148,22,17728228992,-550841156
1635430912,-178192,true,18264453470,22,17664525288,-599928182
1635430917,-178202,true,18246199058,22,17660992913,-585206145
1635430918,-178204,true,18242550365,22,17659226990,-583323375
1635430986,-178205,true,18240726293,22,17616897777,-623828516
1635431009,-178213,true,18226140276,22,17602810599,-623329677
1635431032,-178222,true,18209744948,22,17588734685,-621010263
1635431059,-178224,true,18206103546,22,17571155620,-634947926
1635431061,-178226,true,18202462871,22,17571155620,-631307251
1635431090,-178234,true,18187907451,22,17553594125,-634313326
1635431195,-178239,true,18178816225,22,17529037515,-649778710
1635431241,-178242,true,18173363671,22,17516772095,-656591576
1635431271,-178243,true,18171546516,22,17511518114,-660028402
1635431296,-178250,true,18158831520,22,17513269266,-645562254
1635431321,-178256,true,18147940034,22,17513269266,-634670768
1635431383,-178260,true,18140682672,22,17515020593,-625662079
1635431394,-178262,true,18137055080,22,17516772095,-620282985
1635431485,-178270,true,18122551963,22,17529037515,-593514448
1635431598,-178276,true,18111682236,22,17557105019,-554577217
1635431662,-178285,true,18095389870,22,17564128915,-531260955
1635431697,-178289,true,18088153523,22,17567641916,-520511607
1635431726,-178297,true,18073689510,22,17569398680,-504290830
1635431764,-178307,true,18055625757,22,17562372678,-493253079
1635431786,-178318,true,18035776480,22,17555349484,-480426996
1635431822,-178324,true,18024958800,22,17544819960,-480138840
1635431868,-178333,true,18008744446,22,17530790418,-477954028
1635431966,-178343,true,17990745602,22,17506265709,-484479893
1635431977,-178353,true,17972764748,22,17502764981,-469999767
1635431982,-178360,true,17960188843,22,17501014880,-459173963
1635431983,-178369,true,17944032752,22,17501014880,-443017872
1635431995,-178382,true,17920721831,22,17495765625,-424956206
1635432052,-178396,true,17895651627,22,17452083021,-443568606
1635432116,-178403,true,17883129680,22,17405028302,-478101378
1635432150,-178412,true,17867042908,22,17380679528,-486363380
1635432152,-178424,true,17845616386,22,17378941634,-466674752
1635432181,-178439,true,17818869364,22,17354629354,-464240010
1635432189,-178447,true,17804620681,22,17344220220,-460400461
1635432224,-178455,true,17790383392,22,17319956513,-470426879
1635432272,-178466,true,17770825707,22,17280168377,-490657330
1635432313,-178479,true,17747739797,22,17245644302,-502095495
1635432325,-178487,true,17733547992,22,17231853992,-501694000
1635432341,-178494,true,17721139472,22,17219796518,-501342954
1635432343,-178505,true,17701657910,22,17218074711,-483583199
1635432349,-178517,true,17680429721,22,17212910321,-467519400
1635432384,-178519,true,17676894166,22,17190549194,-486344972
1635432405,-178525,true,17666291740,22,17176802941,-489488799
1635432423,-178536,true,17646870474,22,17166500465,-480370009
1635432490,-178547,true,17627470558,22,17127064854,-500405704
1635432531,-178548,true,17625707988,22,17113369366,-512338622
1635432611,-178553,true,17616897777,22,17106525729,-510372048
1635432646,-178563,true,17599290565,22,17103104937,-496185628
1635432671,-178575,true,17578185137,22,17096265405,-481919732
1635432705,-178577,true,17574670027,22,17094555950,-480114077
1635432720,-178586,true,17558860730,22,17091137551,-467723179
1635432749,-178598,true,17537803787,22,17086011235,-451792552
1635432768,-178610,true,17516772095,22,17079178539,-437593556
1635432803,-178617,true,17504515258,22,17062108750,-442406508
1635432809,-178625,true,17490517945,22,17058696840,-431821105
1635432827,-178641,true,17462556889,22,17045056022,-417500867
1635432842,-178657,true,17434640533,22,17026317705,-408322828
1635432868,-178667,true,17417215478,22,17004198978,-413016500
1635432925,-178676,true,17401547819,22,16970226263,-431321556
1635432947,-178693,true,17371991795,22,16958351855,-413639940
1635432975,-178711,true,17340751896,22,16943096967,-397654929
1635433050,-178720,true,17325153020,22,16904174568,-420978452
1635433099,-178732,true,17304376343,22,16875463318,-428913025
1635433115,-178746,true,17280168377,22,16863655217,-416513160
1635433136,-178759,true,17257719875,22,16848485514,-409234361
1635433209,-178768,true,17242195690,22,16804738534,-437457156
1635433211,-178778,true,17224962974,22,16804738534,-420224440
1635433231,-178789,true,17206026878,22,16798018319,-408008559
1635433253,-178802,true,17183674693,22,16784585950,-399088743
1635433277,-178815,true,17161351545,22,16754402377,-406949168
1635433292,-178824,true,17145914048,22,16744353253,-401560795
1635433339,-178834,true,17128777561,22,16707558006,-421219555
1635433360,-178844,true,17111658200,22,16697536978,-414121222
1635433393,-178853,true,17096265405,22,16674177950,-422087455
1635433396,-178858,true,17087719836,22,16670843614,-416876222
1635433430,-178862,true,17080886457,22,16660844608,-420041849
1635433480,-178870,true,17067227895,22,16632546647,-434681248
1635433517,-178876,true,17056991141,22,16612600559,-444390582
1635433522,-178878,true,17053580255,22,16610939465,-442640790
1635433566,-178887,true,17038239704,22,16569466053,-468773651
1635433619,-178895,true,17024615244,22,16546286189,-478329055
1635433665,-178901,true,17014404049,22,16536361891,-478042158
1635433696,-178900,true,17016105489,22,16541323296,-474782193
1635433717,-178904,true,17009300748,22,16547940818,-461359930
1635433741,-178908,true,17002498729,22,16567809272,-434689457
1635433758,-178910,true,16999098739,22,16577752443,-421346296
1635433770,-178910,true,16999098739,22,16584384539,-414714200
1635433801,-178915,true,16990601739,22,16599316457,-391285282
1635433823,-178923,true,16977015372,22,16604296750,-372718622
1635433856,-178929,true,16966832727,22,16609278537,-357554190
1635433861,-178929,true,16966832727,22,16612600559,-354232168
1635433923,-178931,true,16963439869,22,16650851599,-312588270
1635433978,-178936,true,16954960693,22,16692528719,-262431974
1635434031,-178939,true,16949875222,22,16737657186,-212218036
1635434036,-178938,true,16951570210,22,16741004885,-210565325
1635434088,-178944,true,16941402826,22,16774518722,-166884104
1635434116,-178951,true,16929548587,22,16792979921,-136568666
1635434130,-178955,true,16922778460,22,16799698121,-123080339
1635434172,-178952,true,16927855801,22,16855225919,-72629882
1635434184,-178955,true,16922778460,22,16870401691,-52376769
1635434224,-178961,true,16912628346,22,16902484319,-10144027
1635434276,-178966,true,16904174568,22,16932934666,28760098
1635434302,-178963,true,16909246327,22,16956656189,47409862
1635434463,-178963,true,16909246327,22,17097975032,188728705
1635434519,-178966,true,16904174568,22,17144199628,240025060
1635434627,-178970,true,16897414588,22,17206026878,308612290
1635434672,-178966,true,16904174568,22,17226685470,322510902
1635434711,-178962,true,16910937252,22,17252543594,341606342
1635434720,-178964,true,16907555572,22,17261171591,353616019
1635434750,-178965,true,16905864985,22,17288810189,382945204
1635435048,-178962,true,16910937252,22,17385894254,474957002
1635435077,-178958,true,16917702641,22,17394588939,476886298
1635435105,-178960,true,16914319608,22,17408509482,494189874
1635435160,-178959,true,16916011040,22,17457319170,541308130
1635435196,-178947,true,16936321422,22,17476531825,540210403
1635435241,-178942,true,16944791276,22,17476531825,531740549
1635435268,-178941,true,16946485756,22,17476531825,530046069
1635435282,-178942,true,16944791276,22,17476531825,531740549
1635435304,-178933,true,16960047690,22,17476531825,516484135
1635435343,-178929,true,16966832727,22,17467796180,500963453
1635435354,-178928,true,16968529410,22,17466049575,497520165
1635435362,-178929,true,16966832727,22,17464303145,497470418
1635435395,-178922,true,16978713073,22,17462556889,483843816
1635435452,-178913,true,16994000029,22,17478279478,484279449
1635435535,-178911,true,16997398999,22,17499264953,501865954
1635435623,-178912,true,16995699429,22,17506265709,510566280
1635435670,-178903,true,17011001678,22,17513269266,502267588
1635435674,-178895,true,17024615244,22,17513269266,488654022
1635435684,-178893,true,17028020337,22,17511518114,483497777
1635435779,-178905,true,17007599988,22,17495765625,488165637
1635435814,-178900,true,17016105489,22,17488769068,472663579
1635435820,-178893,true,17028020337,22,17488769068,460748731
1635435848,-178892,true,17029723139,22,17485271839,455548700
1635435919,-178903,true,17011001678,22,17480027306,469025628
1635436058,-178902,true,17012702778,22,17396328398,383625620
1635436088,-178894,true,17026317705,22,17373728994,347411289
1635436099,-178894,true,17026317705,22,17363308404,336990699
1635436116,-178905,true,17007599988,22,17359836263,352236275
1635436216,-178901,true,17014404049,22,17325153020,310748971
1635436268,-178891,true,17031426111,22,17318224691,286798580
1635436323,-178890,true,17033129254,22,17290539070,257409816
1635436352,-178899,true,17017807100,22,17269803903,251996803
1635436379,-178895,true,17024615244,22,17254268848,229653604
1635436398,-178883,true,17045056022,22,17242195690,197139668
1635436404,-178877,true,17055285613,22,17238747768,183462155
1635436448,-178882,true,17046760528,22,17212910321,166149793
1635436473,-178879,true,17051875067,22,17199146187,147271120
1635436474,-178867,true,17072348575,22,17197426445,125077870
1635436497,-178863,true,17079178539,22,17183674693,104496154
1635436550,-178869,true,17068934618,22,17151058337,82123719
1635436579,-178860,true,17084302805,22,17151058337,66755532
1635436602,-178846,true,17108236382,22,17159635581,51399199
1635436702,-178841,true,17116792211,22,17159635581,42843370
1635436838,-178844,true,17111658200,22,17171650930,59992730
1635436858,-178836,true,17125352319,22,17173368095,48015776
1635436924,-178823,true,17147628640,22,17180238473,32609833
1635436927,-178817,true,17157919789,22,17180238473,22318684
1635436982,-178817,true,17157919789,22,17187111599,29191810
1635437029,-178811,true,17168217115,22,17188830311,20613196
1635437072,-178797,true,17192268249,22,17202586189,10317940
1635437118,-178795,true,17195706874,22,17195706874,0
1635437127,-178799,true,17188830311,22,17193987475,5157164
1635437154,-178794,true,17197426445,22,17190549194,-6877251
1635437182,-178788,true,17207747481,22,17187111599,-20635882
1635437219,-178788,true,17207747481,22,17187111599,-20635882
1635437378,-178795,true,17195706874,22,17175085432,-20621442
1635437389,-178790,true,17204306447,22,17175085432,-29221015
1635437405,-178779,true,17223240650,22,17175085432,-48155218
1635437468,-178776,true,17228408139,22,17178520621,-49887518
1635437486,-178781,true,17219796518,22,17169933937,-49862581
1635437511,-178778,true,17224962974,22,17161351545,-63611429
1635437522,-178771,true,17237024066,22,17159635581,-77388485
1635437650,-178767,true,17243919910,22,17178520621,-65399289
1635437689,-178774,true,17231853992,22,17178520621,-53333371
1635437709,-178770,true,17238747768,22,17173368095,-65379673
1635437756,-178762,true,17252543594,22,17178520621,-74022973
1635437809,-178755,true,17264623998,22,17183674693,-80949305
1635437891,-178758,true,17259445647,22,17197426445,-62019202
1635437894,-178754,true,17266350461,22,17197426445,-68924016
1635437970,-178747,true,17278440532,22,17211189202,-67251330
1635438054,-178740,true,17290539070,22,17266350461,-24188609
1635438105,-178744,true,17283624583,22,17302646079,19021496
1635438257,-178739,true,17292268124,22,17411991358,119723234
1635438309,-178732,true,17304376343,22,17446848443,142472100
1635438353,-178724,true,17318224691,22,17471289914,153065223
1635438370,-178727,true,17313030262,22,17480027306,166997044
1635438438,-178726,true,17314761565,22,17513269266,198507701
1635438490,-178722,true,17321688509,22,17523779855,202091346
1635438510,-178716,true,17332084121,22,17529037515,196953394
1635438527,-178718,true,17328618224,22,17532543497,203925273
1635438573,-178718,true,17328618224,22,17543065654,214447430
1635438606,-178718,true,17328618224,22,17553594125,224975901
1635438746,-178714,true,17335550711,22,17571155620,235604909
1635438861,-178719,true,17326885535,22,17560616616,233731081
1635438929,-178718,true,17328618224,22,17541311523,212693299
1635438986,-178718,true,17328618224,22,17523779855,195161631
1635438992,-178715,true,17333817329,22,17522027652,188210323
1635439004,-178720,true,17325153020,22,17518523772,193370752
1635439154,-178716,true,17332084121,22,17487020366,154936245
1635439194,-178716,true,17332084121,22,17480027306,147943185
1635439217,-178714,true,17335550711,22,17474784347,139233636
1635439318,-178721,true,17323420678,22,17450337988,126917310
1635439346,-178727,true,17313030262,22,17445103933,132073671
1635439393,-178725,true,17316493041,22,17434640533,118147492
1635439442,-178723,true,17319956513,22,17413732557,93776044
1635439516,-178729,true,17309568176,22,17391110543,81542367
1635439594,-178733,true,17302646079,22,17375466367,72820288
1635439625,-178730,true,17307837392,22,17368517918,60680526
1635439647,-178726,true,17314761565,22,17363308404,48546839
1635439652,-178731,true,17306106781,22,17359836263,53729482
1635439782,-178738,true,17293997351,22,17321688509,27691158
1635439788,-178741,true,17288810189,22,17318224691,29414502
1635439811,-178741,true,17288810189,22,17299186069,10375880
1635439954,-178745,true,17281896393,22,17245644302,-36252091
1635440088,-178753,true,17268077096,22,17178520621,-89556475
1635440264,-178758,true,17259445647,22,17051875067,-207570580
1635440320,-178757,true,17261171591,22,17016105489,-245066102
1635440328,-178758,true,17259445647,22,17011001678,-248443969
1635440335,-178766,true,17245644302,22,17005899398,-239744904
1635440369,-178770,true,17238747768,22,16990601739,-248146029
1635440384,-178768,true,17242195690,22,16985505577,-256690113
1635440438,-178768,true,17242195690,22,16961743695,-280451995
1635440515,-178777,true,17226685470,22,16907555572,-319129898
1635440628,-178778,true,17224962974,22,16907555572,-317407402
1635440652,-178775,true,17230130979,22,16905864985,-324265994
1635440726,-178773,true,17233577178,22,16909246327,-324330851
1635440735,-178780,true,17221518498,22,16905864985,-315653513
1635440741,-178783,true,17216353075,22,16904174568,-312178507
1635440765,-178780,true,17221518498,22,16899104329,-322414169
1635440797,-178782,true,17218074711,22,16888968415,-329106296
1635440816,-178788,true,17207747481,22,16882214516,-325532965
1635440843,-178788,true,17207747481,22,16880526463,-327221018
1635440865,-178786,true,17211189202,22,16878838579,-332350623
1635440892,-178785,true,17212910321,22,16882214516,-330695805
1635440929,-178787,true,17209468255,22,16887279687,-322188568
1635440958,-178788,true,17207747481,22,16890657312,-317090169
1635440978,-178784,true,17214631612,22,16890657312,-323974300
1635440998,-178784,true,17214631612,22,16888968415,-325663197
1635441009,-178792,true,17200866102,22,16888968415,-311897687
1635441045,-178794,true,17197426445,22,16900794240,-296632205
1635441155,-178789,true,17206026878,22,16941402826,-264624052
1635441191,-178790,true,17204306447,22,16954960693,-249345754
1635441250,-178798,true,17190549194,22,16971923286,-218625908
1635441278,-178800,true,17187111599,22,16977015372,-210096227
1635441317,-178797,true,17192268249,22,16980410945,-211857304
1635441323,-178797,true,17192268249,22,16982108986,-210159263
1635441395,-178805,true,17178520621,22,17002498729,-176021892
1635441420,-178808,true,17173368095,22,17007599988,-165768107
1635441488,-178804,true,17180238473,22,16992300799,-187937674
1635441531,-178805,true,17178520621,22,16982108986,-196411635
1635441537,-178812,true,17166500465,22,16980410945,-186089520
1635441553,-178812,true,17166500465,22,16977015372,-189485093
1635441576,-178809,true,17171650930,22,16973620478,-198030452
1635441662,-178809,true,17171650930,22,16966832727,-204818203
1635441688,-178816,true,17159635581,22,16970226263,-189409318
1635441713,-178816,true,17159635581,22,16973620478,-186015103
1635441782,-178813,true,17164783987,22,16963439869,-201344118
1635441837,-178816,true,17159635581,22,16939708856,-219926725
1635441845,-178823,true,17147628640,22,16936321422,-211307218
1635441883,-178824,true,17145914048,22,16926163185,-219750863
1635441958,-178826,true,17142485380,22,16917702641,-224782739
1635441989,-178829,true,17137343663,22,16904174568,-233169095
1635442096,-178835,true,17127064854,22,16892346377,-234718477
1635442126,-178836,true,17125352319,22,16888968415,-236383904
1635442148,-178838,true,17121927762,22,16887279687,-234648075
1635442167,-178841,true,17116792211,22,16885591128,-231201083
1635442191,-178848,true,17104815248,22,16882214516,-222600732
1635442221,-178850,true,17101394798,22,16878838579,-222556219
1635442317,-178855,true,17092846665,22,16868714820,-224131845
1635442392,-178861,true,17082594546,22,16850170362,-232424184
1635442406,-178870,true,17067227895,22,16848485514,-218742381
1635442523,-178875,true,17058696840,22,16811461438,-247235402
1635442533,-178882,true,17046760528,22,16808099650,-238660878
1635442563,-178890,true,17033129254,22,16794659219,-238470035
1635442571,-178898,true,17019508880,22,16791300791,-228208089
1635442576,-178904,true,17009300748,22,16787943035,-221357713
1635442636,-178916,true,16988902848,22,16737657186,-251245662
1635442678,-178926,true,16971923286,22,16709228761,-262694525
1635442693,-178934,true,16958351855,22,16699206732,-259145123
1635442716,-178941,true,16946485756,22,16684184958,-262300798
1635442741,-178952,true,16927855801,22,16665843361,-262012440
1635442795,-178962,true,16910937252,22,16624232868,-286704384
1635442843,-178970,true,16897414588,22,16584384539,-313030049
1635442867,-178977,true,16885591128,22,16564496207,-321094921
1635442878,-178987,true,16868714820,22,16556216443,-312498377
1635442895,-178998,true,16850170362,22,16541323296,-308847066
1635442932,-179010,true,16829963295,22,16498373861,-331589434
1635442996,-179017,true,16818187031,22,16429229453,-388957578
1635443054,-179025,true,16804738534,22,16388209726,-416528808
1635443082,-179034,true,16789621829,22,16366919960,-422701869
1635443107,-179044,true,16772841438,22,16345657850,-427183588
1635443157,-179050,true,16762781254,22,16299956305,-462824949
1635443234,-179063,true,16741004885,22,16205694894,-535309991
1635443330,-179074,true,16722600824,22,16107145962,-615454862
1635443357,-179085,true,16704216995,22,16081396421,-622820574
1635443413,-179093,true,16690859633,22,16022008160,-668851473
1635443423,-179106,true,16669176697,22,16009196319,-659980378
1635443426,-179120,true,16645857343,22,16005994960,-639862383
1635443464,-179129,true,16630883559,22,15964435502,-666448057
1635443478,-179137,true,16617584837,22,15950074691,-667510146
1635443538,-179145,true,16604296750,22,15924576251,-679720499
1635443553,-179159,true,16581068159,22,15915024849,-666043310
1635443586,-179165,true,16571123000,22,15894349792,-676773208
1635443601,-179171,true,16561183805,22,15883228196,-677955609
1635443621,-179181,true,16544631726,22,15868940435,-675691291
1635443673,-179195,true,16521486604,22,15834068883,-687417721
1635443695,-179199,true,16514879661,22,15822989467,-691890194
1635443716,-179204,true,16506624698,22,15811917803,-694706895
1635443777,-179216,true,16486829618,22,15774016595,-712813023
1635443803,-179231,true,16462119146,22,15759827076,-702292070
1635443831,-179234,true,16457181498,22,15745650321,-711531177
1635443865,-179246,true,16437445711,22,15720478682,-716967029
1635443892,-179258,true,16417733591,22,15709478747,-708254844
1635443947,-179273,true,16393126681,22,15665555923,-727570758
1635444022,-179275,true,16389848547,22,15635821111,-754027436
1635444072,-179279,true,16383294247,22,15643640585,-739653662
1635444177,-179287,true,16370193507,22,15681228531,-688964976
1635444183,-179296,true,16355467697,22,15682796653,-672671044
1635444236,-179296,true,16355467697,22,15695347283,-660120414
1635444281,-179302,true,16345657850,22,15725195297,-620462553
1635444324,-179307,true,16337487472,22,15761403059,-576084413
1635444364,-179317,true,16321158967,22,15797694190,-523464777
1635444439,-179317,true,16321158967,22,15846740572,-474418395
1635444462,-179322,true,16313000835,22,15862594446,-450406389
1635444469,-179328,true,16303216459,22,15867353700,-435862759
1635444539,-179337,true,16288550898,22,15926168709,-362382189
1635444590,-179335,true,16291808771,22,15964435502,-327373269
1635444653,-179340,true,16283665310,22,16013999559,-269665751
1635444689,-179348,true,16270644238,22,16046058003,-224586235
1635444757,-179359,true,16252757263,22,16102314785,-150442478
1635444858,-179358,true,16254382539,22,16173317511,-81065028
1635444905,-179364,true,16244633322,22,16195974879,-48658443
1635444979,-179372,true,16231643462,22,16194355444,-37288018
1635445004,-179384,true,16212178144,22,16191117058,-21061086
1635445045,-179384,true,16212178144,22,16189498109,-22680035
1635445088,-179390,true,16202454241,22,16189498109,-12956132
1635445091,-179397,true,16191117058,22,16191117058,0
1635445116,-179408,true,16173317511,22,16191117058,17799547
1635445145,-179409,true,16171700341,22,16187879321,16178980
1635445161,-179416,true,16160384678,22,16183023928,22639250
1635445187,-179423,true,16149076932,22,16170083333,21006401
1635445274,-179432,true,16134550027,22,16141004815,6454788
1635445304,-179433,true,16132936733,22,16129710630,-3226103
1635445352,-179441,true,16120036190,22,16103925016,-16111174
1635445380,-179449,true,16107145962,22,16089438728,-17707234
1635445415,-179460,true,16089438728,22,16068537091,-20901637
1635445484,-179462,true,16086221323,22,16031623768,-54597555
1635445536,-179470,true,16073358135,22,15997994363,-75363772
1635445638,-179479,true,16058899343,22,15934133386,-124765957
1635445704,-179491,true,16039641184,22,15902298556,-137342628
1635445747,-179494,true,16034830253,22,15883228196,-151602057
1635445776,-179503,true,16020406119,22,15867353700,-153052419
1635445815,-179512,true,16005994960,22,15846740572,-159254388
1635445877,-179526,true,15983603365,22,15822989467,-160613898
1635445941,-179529,true,15978809243,22,15796114578,-182694665
1635445969,-179538,true,15964435502,22,15783483372,-180952130
1635446010,-179546,true,15951669699,22,15769285336,-182384363
1635446020,-179558,true,15932540132,22,15764555497,-167984635
1635446039,-179561,true,15927761326,22,15758251251,-169510075
1635446059,-179568,true,15916616351,22,15748799608,-167816743
1635446100,-179576,true,15903888786,22,15733059467,-170829319
1635446132,-179588,true,15884816519,22,15709478747,-175337772
1635446202,-179590,true,15881640032,22,15671823086,-209816946
1635446262,-179596,true,15872114382,22,15648334146,-223780236
1635446320,-179600,true,15865767123,22,15621755905,-244011218
1635446330,-179610,true,15849910079,22,15617070316,-232839763
1635446340,-179613,true,15845156057,22,15613947370,-231208687
1635446429,-179620,true,15834068883,22,15578078350,-255990533
1635446480,-179626,true,15824571766,22,15545400343,-279171423
1635446498,-179635,true,15810336770,22,15534522914,-275813856
1635446522,-179638,true,15805594617,22,15526757982,-278836635
1635446523,-179647,true,15791376692,22,15525205462,-266171230
1635446531,-179650,true,15786640226,22,15523653096,-262987130
1635446537,-179654,true,15780327148,22,15522100886,-258226262
1635446602,-179651,true,15785061720,22,15508137978,-276923742
1635446630,-179661,true,15769285336,22,15500386235,-268899101
1635446653,-179666,true,15761403059,22,15492638366,-268764693
1635446691,-179672,true,15751949526,22,15478701961,-273247565
1635446731,-179672,true,15751949526,22,15466324569,-285624957
1635446751,-179682,true,15736206236,22,15463231768,-272974468
1635446762,-179681,true,15737779857,22,15464778092,-273001765
1635446770,-179683,true,15734632773,22,15464778092,-269854681
1635446791,-179677,true,15744075913,22,15464778092,-279297821
1635446800,-179683,true,15734632773,22,15466324569,-268308204
1635446849,-179682,true,15736206236,22,15464778092,-271428144
1635446868,-179682,true,15736206236,22,15463231768,-272974468
1635446906,-179678,true,15742501663,22,15449321816,-293179847
1635446950,-179680,true,15739353635,22,15458593727,-280759908
1635446991,-179683,true,15734632773,22,15466324569,-268308204
1635447013,-179682,true,15736206236,22,15474059279,-262146957
1635447016,-179676,true,15745650321,22,15474059279,-271591042
1635447053,-179682,true,15736206236,22,15472512027,-263694209
1635447185,-179684,true,15733059467,22,15484894370,-248165097
1635447193,-179683,true,15734632773,22,15484894370,-249738403
1635447352,-179675,true,15747224886,22,15536076366,-211148520
1635447467,-179677,true,15744075913,22,15632694415,-111381498
1635447495,-179677,true,15744075913,22,15640512326,-103563587
1635447612,-179676,true,15745650321,22,15685933370,-59716951
1635447654,-179663,true,15766131952,22,15714192062,-51939890
1635447671,-179666,true,15761403059,22,15720478682,-40924377
1635447810,-179658,true,15774016595,22,15851495070,77478475
1635447845,-179651,true,15785061720,22,15875288964,90227244
1635447856,-179641,true,15800853887,22,15881640032,80786145
1635447888,-179647,true,15791376692,22,15905479175,114102483
1635447953,-179646,true,15792955829,22,15950074691,157118862
1635448016,-179644,true,15796114578,22,15996394724,200280146
1635448069,-179635,true,15810336770,22,16036433737,226096967
1635448108,-179643,true,15797694190,22,16063717494,266023304
1635448143,-179645,true,15794535125,22,16086221323,291686198
1635448174,-179644,true,15796114578,22,16105535409,309420831
1635448176,-179639,true,15804014216,22,16107145962,303131746
1635448179,-179647,true,15791376692,22,16108756677,317379985
1635448190,-179647,true,15791376692,22,16116812666,325435974
1635448217,-179645,true,15794535125,22,16136163482,341628357
1635448250,-179642,true,15799273959,22,16150691840,351417881
1635448293,-179651,true,15785061720,22,16152306909,367245189
1635448320,-179652,true,15783483372,22,16155537532,372054160
1635448439,-179650,true,15786640226,22,16174934843,388294617
1635448482,-179646,true,15792955829,22,16189498109,396542280
1635448484,-179655,true,15778749273,22,16189498109,410748836
1635448511,-179654,true,15780327148,22,16200834158,420507010
1635448552,-179653,true,15781905181,22,16189498109,407592928
1635448591,-179651,true,15785061720,22,16170083333,385021613
1635448619,-179659,true,15772439351,22,16152306909,379867558
1635448717,-179662,true,15767708566,22,16071750960,304042394
1635448779,-179662,true,15767708566,22,16022008160,254299594
1635448794,-179660,true,15770862265,22,16010797239,239934974
1635448852,-179668,true,15758251251,22,15975613960,217362709
1635448864,-179670,true,15755100073,22,15969225312,214125239
1635448932,-179671,true,15753524721,22,15932540132,179015411
1635448988,-179668,true,15758251251,22,15903888786,145637535
1635449010,-179674,true,15748799608,22,15894349792,145550184
1635449048,-179675,true,15747224886,22,15878464180,131239294
1635449078,-179673,true,15750374488,22,15861008345,110633857
1635449079,-179669,true,15756675583,22,15861008345,104332762
1635449113,-179673,true,15750374488,22,15845156057,94781569
1635449117,-179673,true,15750374488,22,15843571700,93197212
1635449152,-179668,true,15758251251,22,15840403460,82152209
1635449178,-179663,true,15766131952,22,15835652290,69520338
1635449260,-179672,true,15751949526,22,15789797712,37848186
1635449316,-179674,true,15748799608,22,15764555497,15755889
1635449341,-179668,true,15758251251,22,15761403059,3151808
1635449368,-179664,true,15764555497,22,15745650321,-18905176
1635449385,-179671,true,15753524721,22,15740927570,-12597151
1635449470,-179669,true,15756675583,22,15739353635,-17321948
1635449573,-179663,true,15766131952,22,15747224886,-18907066
1635449583,-179658,true,15774016595,22,15751949526,-22067069
1635449684,-179662,true,15767708566,22,15797694190,29985624
1635449745,-179657,true,15775593997,22,15819825343,44231346
1635449848,-179649,true,15788218890,22,15846740572,58521682
1635449906,-179643,true,15797694190,22,15872114382,74420192
1635449926,-179647,true,15791376692,22,15872114382,80737690
1635449958,-179642,true,15799273959,22,15876876493,77602534
1635449984,-179634,true,15811917803,22,15881640032,69722229
1635450020,-179630,true,15818243519,22,15881640032,63396513
1635450022,-179633,true,15813498995,22,15881640032,68141037
1635450074,-179625,true,15826154223,22,15878464180,52309957
1635450102,-179617,true,15838819578,22,15883228196,44408618
1635450164,-179611,true,15848325246,22,15915024849,66699603
1635450172,-179611,true,15848325246,22,15918208013,69882767
1635450193,-179604,true,15859422403,22,15930947037,71524634
1635450330,-179601,true,15864180705,22,15942102046,77921341
1635450363,-179600,true,15865767123,22,15940507995,74740872
1635450394,-179600,true,15865767123,22,15940507995,74740872
1635450423,-179593,true,15876876493,22,15942102046,65225553
1635450442,-179589,true,15883228196,22,15942102046,58873850
1635450547,-179586,true,15887993641,22,15927761326,39767685
1635450563,-179586,true,15887993641,22,15922983953,34990312
1635450599,-179581,true,15895939227,22,15918208013,22268786
1635450673,-179577,true,15902298556,22,15911842321,9543765
1635450703,-179579,true,15899118573,22,15908660430,9541857
1635450816,-179582,true,15894349792,22,15876876493,-17473299
1635450887,-179575,true,15905479175,22,15870527329,-34951846
1635450969,-179572,true,15910251296,22,15867353700,-42897596
1635450981,-179571,true,15911842321,22,15867353700,-44488621
1635451007,-179575,true,15905479175,22,15870527329,-34951846
1635451019,-179569,true,15915024849,22,15867353700,-47671149
1635451107,-179567,true,15918208013,22,15849910079,-68297934
1635451215,-179571,true,15911842321,22,15826154223,-85688098
1635451245,-179572,true,15910251296,22,15819825343,-90425953
1635451268,-179564,true,15922983953,22,15815080345,-107903608
1635451394,-179566,true,15919799833,22,15756675583,-163124250
1635451451,-179573,true,15908660430,22,15729913327,-178747103
1635451472,-179579,true,15899118573,22,15718906791,-180211782
1635451530,-179573,true,15908660430,22,15701626363,-207034067
1635451537,-179574,true,15907069723,22,15696916817,-210152906
1635451592,-179585,true,15889582440,22,15668689191,-220893249
1635451614,-179590,true,15881640032,22,15657725495,-223914537
1635451644,-179595,true,15873701594,22,15637384693,-236316901
1635451676,-179604,true,15859422403,22,15612386131,-247036272
1635451863,-179614,true,15843571700,22,15536076366,-307495334
1635451868,-179619,true,15835652290,22,15532969617,-302682673
1635451888,-179621,true,15832485634,22,15523653096,-308832538
1635452037,-179629,true,15819825343,22,15423081591,-396743752
1635452038,-179643,true,15797694190,22,15423081591,-374612599
1635452047,-179648,true,15789797712,22,15418455592,-371342120
1635452113,-179648,true,15789797712,22,15406126376,-383671336
1635452116,-179652,true,15783483372,22,15404585918,-378897454
1635452195,-179665,true,15762979199,22,15387651036,-375328163
1635452245,-179667,true,15759827076,22,15404585918,-355241158
1635452324,-179667,true,15759827076,22,15418455592,-341371484
1635452383,-179672,true,15751949526,22,15424623899,-327325627
1635452434,-179681,true,15737779857,22,15423081591,-314698266
1635452455,-179683,true,15734632773,22,15426166362,-308466411
1635452694,-179685,true,15731486319,22,15450866748,-280619571
1635452868,-179689,true,15725195297,22,15472512027,-252683270
1635452886,-179698,true,15711049695,22,15477154245,-233895450
1635452891,-179700,true,15707907956,22,15478701961,-229205995
1635452949,-179703,true,15703196526,22,15486442860,-216753666
1635453036,-179709,true,15693777905,22,15466324569,-227453336
1635453152,-179718,true,15679660564,22,15410748676,-268911888
1635453176,-179721,true,15674957607,22,15389189801,-285767806
1635453310,-179722,true,15673390268,22,15321629485,-351760783
1635453319,-179727,true,15665555923,22,15317033916,-348522007
1635453320,-179736,true,15651463970,22,15317033916,-334430054
1635453339,-179737,true,15649898980,22,15304785801,-345113179
1635453409,-179739,true,15646769470,22,15272681078,-374088392
1635453425,-179747,true,15634257685,22,15261994476,-372263209
1635453455,-179757,true,15618632023,22,15245216351,-373415672
1635453522,-179760,true,15613947370,22,15208673527,-405273843
1635453558,-179764,true,15607703352,22,15187397345,-420306007
1635453650,-179772,true,15595222806,22,15125259592,-469963214
1635453674,-179783,true,15578078350,22,15108631785,-469446565
1635453696,-179787,true,15571848676,22,15093531460,-478317216
1635453760,-179793,true,15562508836,22,15040799072,-521709764
1635453763,-179806,true,15542291729,22,15037791363,-504500366
1635453828,-179819,true,15522100886,22,14986752240,-535348646
1635453861,-179820,true,15520548831,22,14955314653,-565234178
1635453910,-179824,true,15514342164,22,14929913485,-584428679
1635453966,-179840,true,15489540303,22,14874777626,-614762677
1635454023,-179856,true,15464778092,22,14807994840,-656783252
1635454091,-179858,true,15461685600,22,14775454686,-686230914
1635454110,-179869,true,15444687946,22,14759211433,-685476513
1635454114,-179883,true,15423081591,22,14757735660,-665345931
1635454214,-179894,true,15406126376,22,14700295444,-705830932
1635454312,-179899,true,15398425623,22,14646007559,-752418064
1635454431,-179910,true,15381497514,22,14594838689,-786658825
1635454457,-179926,true,15356908024,22,14589002213,-767905811
1635454537,-179939,true,15336958011,22,14559854823,-777103188
1635454570,-179942,true,15332357844,22,14551121967,-781235877
1635454602,-179953,true,15315502365,22,14542394348,-773108017
1635454706,-179972,true,15286431990,22,14503184801,-783247189
1635454722,-179982,true,15271153962,22,14500284599,-770869363
1635454759,-179986,true,15265047028,22,14500284599,-764762429
1635454783,-179997,true,15248265546,22,14495935383,-752330163
1635454806,-180011,true,15226933977,22,14491587472,-735346505
1635454820,-180023,true,15208673527,22,14490138459,-718535068
1635455010,-180031,true,15196512062,22,14495935383,-700576679
1635455026,-180044,true,15176770418,22,14491587472,-685182946
1635455038,-180058,true,15155538867,22,14488689590,-666849277
1635455061,-180069,true,15138877772,22,14484343852,-654533920
1635455191,-180075,true,15129797624,22,14458296785,-671500839
1635455197,-180088,true,15110142648,22,14456851100,-653291548
1635455235,-180102,true,15089004306,22,14446735351,-642268955
1635455270,-180114,true,15070909264,22,14436626680,-634282584
1635455314,-180123,true,15057352226,22,14422197990,-635154236
1635455321,-180137,true,15036287734,22,14416430553,-619857181
1635455327,-180153,true,15012250111,22,14413547699,-598702412
1635455361,-180169,true,14988250915,22,14384750850,-603500065
1635455410,-180178,true,14974768232,22,14364627295,-610140937
1635455443,-180191,true,14955314653,22,14347400941,-607913712
1635455446,-180206,true,14932899617,22,14345966344,-586933273
1635455470,-180221,true,14910518177,22,14333061428,-577456749
1635455515,-180232,true,14894126444,22,14310148011,-583978433
1635455558,-180246,true,14873290297,22,14297275315,-576014982
1635455563,-180262,true,14849513248,22,14291557834,-557955414
1635455576,-180273,true,14833188580,22,14290128821,-543059759
1635455645,-180284,true,14816881859,22,14260152536,-556729323
1635455651,-180296,true,14799113152,22,14258726663,-540386489
1635455699,-180305,true,14785800607,22,14243051471,-542749136
1635455703,-180315,true,14771022936,22,14240203287,-530819649
1635455749,-180321,true,14762163423,22,14233085321,-529078102
1635455826,-180331,true,14747409376,22,14241627308,-505782068
1635455847,-180339,true,14735616755,22,14244475776,-491140979
1635455870,-180348,true,14722361329,22,14243051471,-479309858
1635455949,-180350,true,14719417298,22,14268710767,-450706531
1635456003,-180353,true,14715002356,22,14284414199,-430588157
1635456076,-180359,true,14706176444,22,14305855825,-400320619
1635456132,-180370,true,14690009352,22,14324464600,-365544752
1635456173,-180372,true,14687071791,22,14340229392,-346842399
1635456181,-180376,true,14681198430,22,14343097582,-338100848
1635456243,-180380,true,14675327419,22,14378998388,-296329031
1635456270,-180389,true,14662126225,22,14394823197,-267303028
1635456297,-180391,true,14659194240,22,14407783721,-251410519
1635456322,-180397,true,14650401801,22,14422197990,-228203811
1635456369,-180407,true,14635759454,22,14446735351,-189024103
1635456379,-180415,true,14624056113,22,14452514912,-171541201
1635456390,-180420,true,14616746278,22,14459742614,-157003664
1635456401,-180428,true,14605058142,22,14464080971,-140977171
1635456441,-180440,true,14587543459,22,14481447418,-106096041
1635456465,-180450,true,14572963935,22,14494485935,-78478000
1635456517,-180454,true,14567136206,22,14520598198,-46538008
1635456545,-180459,true,14559854823,22,14532218743,-27636080
1635456675,-180465,true,14551121967,22,14600677500,49555533
1635456711,-180473,true,14539486306,22,14612362131,72875825
1635456796,-180475,true,14536578845,22,14632832741,96253896
1635456821,-180480,true,14529312735,22,14628443769,99131034
1635456950,-180481,true,14527859949,22,14654797361,126937412
1635456956,-180487,true,14519146283,22,14656262841,137116558
1635457025,-180487,true,14519146283,22,14665058797,145912514
1635457117,-180491,true,14513340076,22,14673860033,160519957
1635457139,-180492,true,14511888888,22,14676794951,164906063
1635457173,-180497,true,14504635119,22,14684134817,179499698
1635457186,-180499,true,14501734627,22,14685603230,183868603
1635457324,-180501,true,14498834716,22,14716473856,217639140
1635457332,-180501,true,14498834716,22,14717945504,219110788
1635457398,-180507,true,14490138459,22,14731196954,241058495
1635457480,-180509,true,14487240866,22,14731196954,243956088
1635457577,-180510,true,14485792286,22,14715002356,229210070
1635457588,-180510,true,14485792286,22,14712059797,226267511
1635457637,-180514,true,14479999418,22,14713531003,233531585
1635457639,-180515,true,14478551563,22,14713531003,234979440
1635457659,-180512,true,14482895562,22,14716473856,233578294
1635457748,-180506,true,14491587472,22,14740037882,248450410
1635457769,-180508,true,14488689590,22,14740037882,251348292
1635457794,-180505,true,14493036631,22,14745934782,252898151
1635457803,-180501,true,14498834716,22,14751834041,252999325
1635457820,-180490,true,14514791410,22,14756260034,241468624
1635457824,-180485,true,14522050258,22,14756260034,234209776
1635457848,-180484,true,14523502463,22,14763639639,240137176
1635457866,-180480,true,14529312735,22,14765116003,235803268
1635457877,-180469,true,14545302973,22,14769545981,224243008
1635457915,-180471,true,14542394348,22,14779887765,237493417
1635457932,-180469,true,14545302973,22,14787279187,241976214
1635457959,-180464,true,14552577079,22,14802073123,249496044
1635457975,-180453,true,14568592920,22,14810956587,242363667
1635458040,-180452,true,14570049779,22,14843574928,273525149
1635458057,-180450,true,14572963935,22,14852483300,279519365
1635458099,-180444,true,14581709900,22,14874777626,293067726
1635458126,-180431,true,14600677500,22,14888170282,287492782
1635458162,-180428,true,14605058142,22,14907536521,302478379
1635458185,-180426,true,14607979299,22,14919466725,311487426
1635458204,-180421,true,14615284750,22,14928420643,313135893
1635458206,-180410,true,14631369604,22,14929913485,298543881
1635458209,-180407,true,14635759454,22,14931406477,295647023
1635458220,-180402,true,14643078797,22,14937379935,294301138
1635458255,-180396,true,14651866841,22,14958305866,306439025
1635458279,-180385,true,14667991956,22,14973270904,305278948
1635458307,-180383,true,14670925701,22,14988250915,317325214
1635458336,-180378,true,14678262631,22,15006246712,327984081
1635458368,-180373,true,14685603230,22,15025766542,340163312
1635458395,-180361,true,14703235650,22,15045311763,342076113
1635458406,-180357,true,14709117826,22,15052835923,343718097
1635458433,-180350,true,14719417298,22,15070909264,351491966
1635458448,-180342,true,14731196954,22,15081462066,350265112
1635458461,-180328,true,14751834041,22,15093531460,341697419
1635458485,-180320,true,14763639639,22,15114676144,351036505
1635458542,-180307,true,14782843891,22,15160085983,377242092
1635458609,-180301,true,14791715815,22,15191954020,400238205
1635458713,-180281,true,14821327368,22,15291018378,469691010
1635458760,-180272,true,14834671899,22,15333891080,499219181
1635458767,-180256,true,14858425184,22,15340025556,481600372
1635458772,-180245,true,14874777626,22,15343093715,468316089
1635458790,-180225,true,14904555461,22,15363051709,458496248
1635458836,-180216,true,14917974928,22,15404585918,486610990
1635458885,-180198,true,14944850119,22,15450866748,506016629
1635458897,-180187,true,14961297676,22,15461685600,500387924
1635458910,-180170,true,14986752240,22,15474059279,487307039
1635458944,-180159,true,15003245913,22,15505036815,501790902
1635458987,-180145,true,15024264115,22,15543845958,519581843
1635459044,-180137,true,15036287734,22,15598342007,562054273
1635459049,-180121,true,15060363847,22,15601461831,541097984
1635459216,-180106,true,15082970213,22,15800853887,717883674
1635459249,-180096,true,15098059972,22,15840403460,742343488
1635459271,-180089,true,15108631785,22,15867353700,758721915
1635459317,-180073,true,15132823735,22,15919799833,786976098
1635459345,-180059,true,15154023464,22,15956455678,802432214
1635459387,-180050,true,15167667542,22,15986800245,819132703
1635459546,-180045,true,15175252893,22,16078180624,902927731
1635459607,-180031,true,15196512062,22,16089438728,892926666
1635459621,-180016,true,15219322793,22,16091047672,871724879
1635459691,-180009,true,15229979516,22,16081396421,851416905
1635459774,-180008,true,15231502514,22,16062111283,830608769
1635459871,-179992,true,15255891204,22,16055688045,799796841
1635459952,-179979,true,15275735767,22,16026815243,751079476
1635459999,-179972,true,15286431990,22,15996394724,709962734
1635460102,-179970,true,15289489429,22,15932540132,643050703
1635460233,-179954,true,15313970968,22,15865767123,551796155
1635460291,-179939,true,15336958011,22,15861008345,524050334
1635460343,-179931,true,15349231873,22,15859422403,510190530
1635460407,-179927,true,15355372487,22,15854665527,499293040
1635460445,-179914,true,15375346453,22,15849910079,474563626
1635460508,-179901,true,15395346400,22,15838819578,443473178
1635460635,-179896,true,15403045613,22,15849910079,446864466
1635460657,-179893,true,15407666989,22,15853080219,445413230
1635460717,-179882,true,15424623899,22,15848325246,423701347
1635460720,-179869,true,15444687946,22,15848325246,403637300
1635460730,-179865,true,15450866748,22,15843571700,392704952
1635460747,-179864,true,15452411835,22,15835652290,383240455
1635460786,-179858,true,15461685600,22,15816661853,354976253
1635460793,-179846,true,15480249831,22,15815080345,334830514
1635460811,-179843,true,15484894370,22,15808755894,323861524
1635460834,-179843,true,15484894370,22,15799273959,314379589
1635460845,-179839,true,15491089257,22,15794535125,303445868
1635460855,-179827,true,15509688792,22,15788218890,278530098
1635460870,-179824,true,15514342164,22,15781905181,267563017
1635460923,-179822,true,15517445187,22,15759827076,242381889
1635461016,-179817,true,15525205462,22,15723622935,198417473
1635461111,-179805,true,15543845958,22,15681228531,137382573
1635461140,-179802,true,15548509578,22,15665555923,117046345
1635461150,-179803,true,15546954883,22,15657725495,110770612
1635461186,-179802,true,15548509578,22,15629568346,81058768
1635461337,-179793,true,15562508836,22,15518996932,-43511904
1635461366,-179790,true,15567178055,22,15508137978,-59040077
1635461430,-179792,true,15564065087,22,15483346036,-80719051
1635461450,-179792,true,15564065087,22,15475606684,-88458403
1635461581,-179782,true,15579636157,22,15424623899,-155012258
1635461625,-179779,true,15584310516,22,15409207756,-175102760
1635461642,-179778,true,15585868947,22,15409207756,-176661191
1635461834,-179778,true,15585868947,22,15441599472,-144269475
1635461943,-179766,true,15604582280,22,15464778092,-139804188
1635461952,-179764,true,15607703352,22,15464778092,-142925260
1635462020,-179765,true,15606142738,22,15472512027,-133630711
1635462101,-179762,true,15610825049,22,15520548831,-90276218
1635462135,-179751,true,15628005545,22,15539183737,-88821808
1635462195,-179748,true,15632694415,22,15570291647,-62402768
1635462229,-179747,true,15634257685,22,15588986276,-45271409
1635462329,-179745,true,15637384693,22,15620193886,-17190807
1635462401,-179734,true,15654594419,22,15640512326,-14082093
1635462476,-179732,true,15657725495,22,15659291267,1565772
1635462507,-179730,true,15660857196,22,15667122479,6265283
1635462656,-179731,true,15659291267,22,15673390268,14099001
1635462700,-179722,true,15673390268,22,15674957607,1567339
1635462741,-179721,true,15674957607,22,15676525103,1567496
1635462775,-179720,true,15676525103,22,15676525103,0
1635462789,-179721,true,15674957607,22,15676525103,1567496
1635462811,-179710,true,15692208684,22,15679660564,-12548120
1635462815,-179708,true,15695347283,22,15681228531,-14118752
1635462831,-179706,true,15698486509,22,15679660564,-18825945
1635462971,-179709,true,15693777905,22,15662423282,-31354623
1635462992,-179699,true,15709478747,22,15656159879,-53318868
1635463110,-179697,true,15712620800,22,15638948431,-73672369
1635463144,-179696,true,15714192062,22,15628005545,-86186517
1635463196,-179699,true,15709478747,22,15613947370,-95531377
1635463213,-179691,true,15722050729,22,15610825049,-111225680
1635463263,-179693,true,15718906791,22,15598342007,-120564784
1635463283,-179692,true,15720478682,22,15593663440,-126815242
1635463343,-179700,true,15707907956,22,15584310516,-123597440
1635463369,-179693,true,15718906791,22,15579636157,-139270634
1635463459,-179697,true,15712620800,22,15573405861,-139214939
1635463469,-179700,true,15707907956,22,15573405861,-134502095
1635463774,-179708,true,15695347283,22,15598342007,-97005276
1635463837,-179701,true,15706337322,22,15607703352,-98633970
1635463921,-179706,true,15698486509,22,15617070316,-81416193
1635463946,-179710,true,15692208684,22,15621755905,-70452779
1635464041,-179715,true,15684364933,22,15638948431,-45416502
1635464074,-179709,true,15693777905,22,15646769470,-47008435
1635464089,-179713,true,15687501963,22,15649898980,-37602983
1635464122,-179718,true,15679660564,22,15653029116,-26631448
1635464222,-179725,true,15668689191,22,15667122479,-1566712
1635464295,-179722,true,15673390268,22,15679660564,6270296
1635464335,-179728,true,15663989524,22,15685933370,21943846
1635464360,-179733,true,15656159879,22,15690639620,34479741
1635464379,-179740,true,15645204949,22,15692208684,47003735
1635464400,-179737,true,15649898980,22,15700056358,50157378
1635464528,-179736,true,15651463970,22,15748799608,97335638
1635464569,-179739,true,15646769470,22,15748799608,102030138
1635464584,-179744,true,15638948431,22,15756675583,117727152
1635464622,-179740,true,15645204949,22,15770862265,125657316
1635464688,-179737,true,15649898980,22,15797694190,147795210
1635464747,-179735,true,15653029116,22,15819825343,166796227
1635464809,-179739,true,15646769470,22,15841987501,195218031
1635464831,-179734,true,15654594419,22,15848325246,193730827
1635464864,-179732,true,15657725495,22,15851495070,193769575
1635464888,-179729,true,15662423282,22,15856250994,193827712
1635464907,-179733,true,15656159879,22,15861008345,204848466
1635464941,-179730,true,15660857196,22,15868940435,208083239
1635465065,-179728,true,15663989524,22,15908660430,244670906
1635465101,-179727,true,15665555923,22,15921391813,255835890
1635465124,-179733,true,15656159879,22,15929354102,273194223
1635465175,-179728,true,15663989524,22,15945290626,281301102
1635465179,-179725,true,15668689191,22,15945290626,276601435
1635465199,-179723,true,15671823086,22,15954860192,283037106
1635465332,-179729,true,15662423282,22,15974016558,311593276
1635465363,-179725,true,15668689191,22,15969225312,300536121
1635465399,-179721,true,15674957607,22,15966031946,291074339
1635465468,-179718,true,15679660564,22,15975613960,295953396
1635465540,-179718,true,15679660564,22,15969225312,289564748
1635465557,-179713,true,15687501963,22,15967628549,280126586
1635465591,-179709,true,15693777905,22,15958051324,264273419
1635465655,-179703,true,15703196526,22,15958051324,254854798
1635465716,-179705,true,15700056358,22,15935726799,235670441
1635465742,-179700,true,15707907956,22,15927761326,219853370
1635465784,-179695,true,15715763481,22,15916616351,200852870
1635465836,-179692,true,15720478682,22,15902298556,181819874
1635465850,-179694,true,15717335057,22,15899118573,181783516
1635465862,-179689,true,15725195297,22,15895939227,170743930
1635465884,-179683,true,15734632773,22,15892760516,158127743
1635465934,-179680,true,15739353635,22,15880052027,140698392
1635466011,-179680,true,15739353635,22,15873701594,134347959
1635466038,-179673,true,15750374488,22,15870527329,120152841
1635466140,-179672,true,15751949526,22,15815080345,63130819
1635466273,-179672,true,15751949526,22,15767708566,15759040
1635466316,-179674,true,15748799608,22,15753524721,4725113
1635466441,-179671,true,15753524721,22,15712620800,-40903921
1635466534,-179669,true,15756675583,22,15689070713,-67604870
1635466610,-179668,true,15758251251,22,15679660564,-78590687
1635466621,-179670,true,15755100073,22,15681228531,-73871542
1635466736,-179666,true,15761403059,22,15692208684,-69194375
1635466774,-179662,true,15767708566,22,15692208684,-75499882
1635466794,-179660,true,15770862265,22,15692208684,-78653581
1635466808,-179665,true,15762979199,22,15692208684,-70770515
1635466922,-179663,true,15766131952,22,15681228531,-84903421
1635466985,-179663,true,15766131952,22,15673390268,-92741684
1635467006,-179664,true,15764555497,22,15673390268,-91165229
1635467022,-179669,true,15756675583,22,15673390268,-83285315
1635467124,-179671,true,15753524721,22,15667122479,-86402242
1635467151,-179670,true,15755100073,22,15665555923,-89544150
1635467305,-179670,true,15755100073,22,15651463970,-103636103
1635467317,-179673,true,15750374488,22,15649898980,-100475508
1635467354,-179673,true,15750374488,22,15645204949,-105169539
1635467413,-179671,true,15753524721,22,15635821111,-117703610
1635467449,-179672,true,15751949526,22,15628005545,-123943981
1635467478,-179674,true,15748799608,22,15621755905,-127043703
1635467515,-179676,true,15745650321,22,15613947370,-131702951
1635467622,-179675,true,15747224886,22,15579636157,-167588729
1635467698,-179675,true,15747224886,22,15554729915,-192494971
1635467707,-179676,true,15745650321,22,15551619436,-194030885
1635467771,-179676,true,15745650321,22,15540737655,-204912666
1635467943,-179674,true,15748799608,22,15546954883,-201844725
1635468079,-179674,true,15748799608,22,15556285388,-192514220
1635468182,-179676,true,15745650321,22,15562508836,-183141485
1635468244,-179676,true,15745650321,22,15565621493,-180028828
1635468280,-179673,true,15750374488,22,15567178055,-183196433
1635468288,-179673,true,15750374488,22,15568734773,-181639715
1635468473,-179675,true,15747224886,22,15585868947,-161355939
1635468482,-179675,true,15747224886,22,15585868947,-161355939
1635468519,-179674,true,15748799608,22,15576520698,-172278910
1635468615,-179678,true,15742501663,22,15543845958,-198655705
1635468641,-179687,true,15728340493,22,15531416475,-196924018
1635468690,-179687,true,15728340493,22,15509688792,-218651701
1635468822,-179687,true,15728340493,22,15452411835,-275928658
1635468941,-179690,true,15723622935,22,15406126376,-317496559
1635468972,-179701,true,15706337322,22,15395346400,-310990922
1635468994,-179702,true,15704766846,22,15387651036,-317115810
1635468998,-179702,true,15704766846,22,15386112425,-318654421
1635469028,-179701,true,15706337322,22,15384573967,-321763355
1635469038,-179708,true,15695347283,22,15384573967,-310773316
1635469220,-179708,true,15695347283,22,15367661085,-327686198
1635469224,-179707,true,15696916817,22,15367661085,-329255732
1635469228,-179707,true,15696916817,22,15367661085,-329255732
1635469470,-179714,true,15685933370,22,15389189801,-296743569
1635469569,-179713,true,15687501963,22,15435424376,-252077587
1635469623,-179718,true,15679660564,22,15460139586,-219520978
1635469656,-179716,true,15682796653,22,15475606684,-207189969
1635469750,-179726,true,15667122479,22,15477154245,-189968234
1635469806,-179727,true,15665555923,22,15494187630,-171368293
1635469906,-179730,true,15660857196,22,15525205462,-135651734
1635470183,-179731,true,15659291267,22,15528310658,-130980609
1635470274,-179740,true,15645204949,22,15511239761,-133965188
1635470491,-179743,true,15640512326,22,15447777038,-192735288
1635470501,-179747,true,15634257685,22,15444687946,-189569739
1635470514,-179750,true,15629568346,22,15438511615,-191056731
1635470660,-179761,true,15612386131,22,15389189801,-223196330
1635470666,-179767,true,15603021977,22,15387651036,-215370941
1635470795,-179770,true,15598342007,22,15347697103,-250644904
1635470874,-179775,true,15590545175,22,15297135703,-293409472
1635470918,-179786,true,15573405861,22,15269627000,-303778861
1635471068,-179795,true,15559396801,22,15175252893,-384143908
1635471291,-179801,true,15550064429,22,15075430989,-474633440
1635471343,-179806,true,15542291729,22,15048320975,-493970754
1635471400,-179817,true,15525205462,22,15019757737,-505447725
1635471482,-179825,true,15512790885,22,14997246114,-515544771
1635471489,-179832,true,15501936273,22,14995746540,-506189733
1635471503,-179838,true,15492638366,22,14991248715,-501389651
1635471508,-179848,true,15477154245,22,14988250915,-488903330
1635471633,-179859,true,15460139586,22,14931406477,-528733109
1635471634,-179865,true,15450866748,22,14931406477,-519460271
1635471666,-179871,true,15441599472,22,14913500430,-528099042
1635471718,-179880,true,15427708978,22,14888170282,-539538696
1635471733,-179891,true,15410748676,22,14885193095,-525555581
1635471746,-179897,true,15401505463,22,14880728430,-520777033
1635471840,-179902,true,15393807020,22,14850998200,-542808820
1635471856,-179911,true,15379959518,22,14845059285,-534900233
1635471923,-179923,true,15361515557,22,14822809500,-538706057
1635471948,-179930,true,15350766796,22,14815400319,-535366477
1635472042,-179935,true,15343093715,22,14787279187,-555814528
1635472080,-179947,true,15324693965,22,14773977288,-550716677
1635472097,-179958,true,15307846911,22,14768069174,-539777737
1635472109,-179961,true,15303255475,22,14766592515,-536662960
1635472186,-179962,true,15301725303,22,14757735660,-543989643
1635472250,-179970,true,15289489429,22,14756260034,-533229395
1635472350,-179980,true,15274208346,22,14754784555,-519423791
1635472372,-179984,true,15268100190,22,14753309224,-514790966
1635472404,-179986,true,15265047028,22,14751834041,-513212987
1635472442,-179994,true,15252840483,22,14753309224,-499531259
1635472444,-180007,true,15233025664,22,14753309224,-479716440
1635472525,-180011,true,15226933977,22,14762163423,-464770554
1635472529,-180014,true,15222366810,22,14760687354,-461679456
1635472540,-180022,true,15210194395,22,14759211433,-450982962
1635472639,-180038,true,15185878757,22,14751834041,-434044716
1635472652,-180042,true,15179805924,22,14753309224,-426496700
1635472696,-180043,true,15178288095,22,14759211433,-419076662
1635472708,-180051,true,15166150927,22,14760687354,-405463573
1635472745,-180062,true,15149478166,22,14760687354,-388790812
1635472827,-180067,true,15141905699,22,14762163423,-379742276
1635472840,-180069,true,15138877772,22,14762163423,-376714349
1635472850,-180077,true,15126772118,22,14762163423,-364608695
1635472901,-180088,true,15110142648,22,14760687354,-349455294
1635472913,-180093,true,15102589843,22,14760687354,-341902489
1635472970,-180093,true,15102589843,22,14769545981,-333043862
1635472979,-180100,true,15092022257,22,14772500038,-319522219
1635473010,-180109,true,15078446226,22,14773977288,-304468938
1635473042,-180114,true,15070909264,22,14771022936,-299886328
1635473053,-180114,true,15070909264,22,14769545981,-301363283
1635473077,-180122,true,15058857961,22,14766592515,-292265446
1635473150,-180133,true,15042303152,22,14757735660,-284567492
1635473203,-180141,true,15030274722,22,14744460336,-285814386
1635473292,-180143,true,15027269118,22,14722361329,-304907789
1635473343,-180150,true,15016754236,22,14720889240,-295864996
1635473349,-180161,true,15000245713,22,14719417298,-280828415
1635473397,-180167,true,14991248715,22,14716473856,-274774859
1635473427,-180167,true,14991248715,22,14713531003,-277717712
1635473525,-180174,true,14980759037,22,14722361329,-258397708
1635473549,-180186,true,14962793806,22,14722361329,-240432477
1635473596,-180190,true,14956810185,22,14723833565,-232976620
1635473622,-180187,true,14961297676,22,14725305948,-235991728
1635473654,-180188,true,14959801696,22,14731196954,-228604742
1635473668,-180198,true,14944850119,22,14732670074,-212180045
1635473768,-180203,true,14937379935,22,14748884117,-188495818
1635473790,-180200,true,14941861597,22,14751834041,-190027556
1635473838,-180202,true,14938873673,22,14748884117,-189989556
1635473886,-180212,true,14923943013,22,14756260034,-167682979
1635473920,-180216,true,14917974928,22,14762163423,-155811505
1635473925,-180216,true,14917974928,22,14762163423,-155811505
1635474058,-180218,true,14914991780,22,14785800607,-129191173
1635474127,-180229,true,14898595129,22,14812437683,-86157446
1635474210,-180233,true,14892637180,22,14840606658,-52030522
1635474231,-180233,true,14892637180,22,14842090719,-50546461
1635474236,-180235,true,14889659099,22,14843574928,-46084171
1635474240,-180248,true,14870316085,22,14843574928,-26741157
1635474266,-180255,true,14859911027,22,14845059285,-14851742
1635474329,-180255,true,14859911027,22,14846543791,-13367236
1635474346,-180256,true,14858425184,22,14849513248,-8911936
1635474432,-180267,true,14842090719,22,14856939490,14848771
1635474515,-180278,true,14825774210,22,14830222388,4448178
1635474578,-180281,true,14821327368,22,14807994840,-13332528
1635474603,-180283,true,14818363547,22,14800593063,-17770484
1635474626,-180296,true,14799113152,22,14791715815,-7397337
1635474642,-180306,true,14784322175,22,14787279187,2957012
1635474667,-180306,true,14784322175,22,14779887765,-4434410
1635474711,-180304,true,14787279187,22,14771022936,-16256251
1635474724,-180315,true,14771022936,22,14762163423,-8859513
1635474756,-180329,true,14750359005,22,14742986037,-7372968
1635474881,-180331,true,14747409376,22,14653332028,-94077348
1635474929,-180331,true,14747409376,22,14619669774,-127739602
1635474972,-180340,true,14734143341,22,14589002213,-145141128
1635474986,-180350,true,14719417298,22,14575878674,-143538624
1635475127,-180351,true,14717945504,22,14481447418,-236498086
1635475149,-180350,true,14719417298,22,14468420629,-250996669
1635475202,-180358,true,14707647062,22,14438070342,-269576720
1635475207,-180367,true,14694416795,22,14435183161,-259233634
1635475280,-180366,true,14695886237,22,14403462250,-292423987
1635475286,-180365,true,14697355826,22,14402022048,-295333778
1635475298,-180369,true,14691478353,22,14397702305,-293776048
1635475354,-180378,true,14678262631,22,14378998388,-299264243
1635475408,-180377,true,14679730457,22,14373248226,-306482231
1635475425,-180376,true,14681198430,22,14371811045,-309387385
1635475504,-180380,true,14675327419,22,14360318768,-315008651
1635475510,-180389,true,14662126225,22,14358882880,-303243345
1635475574,-180387,true,14665058797,22,14347400941,-317657856
1635475621,-180384,true,14669458755,22,14348835681,-320623074
1635475653,-180387,true,14665058797,22,14356011534,-309047263
1635475706,-180394,true,14654797361,22,14378998388,-275798973
1635475799,-180393,true,14656262841,22,14386189325,-270073516
1635475885,-180392,true,14657728467,22,14397702305,-260026162
1635475925,-180395,true,14653332028,22,14399142076,-254189952
1635475967,-180403,true,14641614636,22,14407783721,-233830915
1635476014,-180404,true,14640150621,22,14419313983,-220836638
1635476066,-180402,true,14643078797,22,14432296558,-210782239
1635476093,-180404,true,14640150621,22,14439514149,-200636472
1635476123,-180413,true,14626981071,22,14445290821,-181690250
1635476138,-180413,true,14626981071,22,14446735351,-180245720
1635476161,-180411,true,14629906613,22,14449624842,-180281771
1635476197,-180414,true,14625518519,22,14448180024,-177338495
1635476230,-180427,true,14606518647,22,14439514149,-167004498
1635476261,-180427,true,14606518647,22,14442402197,-164116450
1635476315,-180424,true,14610901041,22,14449624842,-161276199
1635476334,-180424,true,14610901041,22,14452514912,-158386129
1635476441,-180431,true,14600677500,22,14474208866,-126468634
1635476691,-180432,true,14599217579,22,14500284599,-98932980
1635476711,-180429,true,14603597782,22,14501734627,-101863155
1635476753,-180430,true,14602137568,22,14511888888,-90248680
1635476806,-180436,true,14593379351,22,14524954813,-68424538
1635476878,-180435,true,14594838689,22,14536578845,-58259844
1635476918,-180431,true,14600677500,22,14538032503,-62644997
1635476936,-180432,true,14599217579,22,14539486306,-59731273
1635476944,-180438,true,14590461113,22,14538032503,-52428610
1635476975,-180441,true,14586084850,22,14533671965,-52412885
1635476995,-180440,true,14587543459,22,14529312735,-58230724
1635477016,-180445,true,14580251874,22,14523502463,-56749411
1635477063,-180452,true,14570049779,22,14511888888,-58160891
1635477105,-180457,true,14562766939,22,14498834716,-63932223
1635477115,-180456,true,14564223216,22,14501734627,-62488589
1635477198,-180458,true,14561310808,22,14500284599,-61026209
1635477221,-180463,true,14554032337,22,14495935383,-58096954
1635477312,-180469,true,14545302973,22,14455405559,-89897414
1635477322,-180469,true,14545302973,22,14451069805,-94233168
1635477403,-180473,true,14539486306,22,14414989054,-124497252
1635477424,-180481,true,14527859949,22,14406343087,-121516862
1635477483,-180489,true,14516242890,22,14377560632,-138682258
1635477537,-180489,true,14516242890,22,14351705592,-164537298
1635477653,-180493,true,14510437844,22,14300134913,-210302931
1635477822,-180501,true,14498834716,22,14206069483,-292765233
1635477826,-180509,true,14487240866,22,14203228695,-284012171
1635477828,-180510,true,14485792286,22,14201808515,-283983771
1635477885,-180515,true,14478551563,22,14179104924,-299446639
1635477902,-180525,true,14464080971,22,14173434699,-290646272
1635477939,-180533,true,14452514912,22,14163517263,-288997649
1635478028,-180532,true,14453960163,22,14146532084,-307428079
1635478064,-180539,true,14443846437,22,14132393330,-311453107
1635478069,-180549,true,14429410531,22,14129567275,-299843256
1635478124,-180557,true,14417872196,22,14109800709,-308071487
1635478141,-180558,true,14416430553,22,14109800709,-306629844
1635478175,-180565,true,14406343087,22,14108389870,-297953217
1635478231,-180575,true,14391944664,22,14104158199,-287786465
1635478249,-180583,true,14380436288,22,14101337791,-279098497
1635478276,-180584,true,14378998388,22,14106979172,-272019216
1635478319,-180588,true,14373248226,22,14111211689,-262036537
1635478337,-180594,true,14364627295,22,14112622810,-252004485
1635478349,-180601,true,14354576076,22,14114034072,-240542004
1635478457,-180605,true,14348835681,22,14109800709,-239034972
1635478494,-180609,true,14343097582,22,14116857020,-226240562
1635478612,-180614,true,14335928184,22,14102747924,-233180260
1635478681,-180619,true,14328762369,22,14095698665,-233063704
1635478694,-180622,true,14324464600,22,14094289237,-230175363
1635478754,-180624,true,14321600137,22,14097108235,-224491902
1635478791,-180628,true,14315872929,22,14099927798,-215945131
1635478851,-180633,true,14308717139,22,14099927798,-208789341
1635478877,-180637,true,14302995083,22,14099927798,-203067285
1635478901,-180637,true,14302995083,22,14099927798,-203067285
1635478976,-180639,true,14300134913,22,14098517946,-201616967
1635479041,-180641,true,14297275315,22,14101337791,-195937524
1635479067,-180643,true,14294416289,22,14098517946,-195898343
1635479125,-180645,true,14291557834,22,14092879949,-198677885
1635479151,-180647,true,14288699951,22,14090061795,-198638156
1635479168,-180650,true,14284414199,22,14084427179,-199987020
1635479226,-180652,true,14281557744,22,14070350495,-211207249
1635479251,-180655,true,14277274134,22,14061911239,-215362895
1635479284,-180658,true,14272991808,22,14053477045,-219514763
1635479357,-180664,true,14264431009,22,14042239320,-222191689
1635479411,-180666,true,14261578551,22,14035220307,-226358244
1635479417,-180669,true,14257300933,22,14035220307,-222080626
1635479456,-180671,true,14254449901,22,14035220307,-219229594
1635479466,-180675,true,14248749546,22,14033816925,-214932621
1635479473,-180678,true,14244475776,22,14035220307,-209255469
1635479499,-180680,true,14241627308,22,14039431294,-202196014
1635479525,-180684,true,14235932081,22,14035220307,-200711774
1635479551,-180686,true,14233085321,22,14038027491,-195057830
1635479599,-180690,true,14227393510,22,14039431294,-187962216
1635479670,-180693,true,14223126146,22,14033816925,-189309221
1635479683,-180697,true,14217438317,22,14032413684,-185024633
1635479702,-180699,true,14214595256,22,14031010583,-183584673
1635479874,-180703,true,14208910839,22,14022594922,-186315917
1635479887,-180706,true,14204649018,22,14021192803,-183456215
1635479909,-180709,true,14200388476,22,14023997181,-176391295
1635479940,-180711,true,14197548824,22,14026802121,-170746703
1635480014,-180716,true,14190452179,22,14029607622,-160844557
1635480047,-180720,true,14184777417,22,14031010583,-153766834
1635480200,-180719,true,14186195894,22,14091470801,-94725093
1635480209,-180722,true,14181940887,22,14092879949,-89060938
1635480244,-180724,true,14179104924,22,14108389870,-70715054
1635480294,-180726,true,14176269528,22,14125329252,-50940276
1635480308,-180721,true,14183359081,22,14129567275,-53791806
1635480358,-180723,true,14180522834,22,14149361532,-31161302
1635480376,-180725,true,14177687155,22,14157853272,-19833883
1635480420,-180725,true,14177687155,22,14181940887,4253732
1635480439,-180723,true,14180522834,22,14191871224,11348390
1635480496,-180725,true,14177687155,22,14217438317,39751162
1635480507,-180727,true,14174852043,22,14221703975,46851932
1635480539,-180730,true,14170600438,22,14228816250,58215812
1635480560,-180728,true,14173434699,22,14238779410,65344711
1635480611,-180731,true,14169183519,22,14263004709,93821190
1635480641,-180733,true,14166350108,22,14277274134,110924026
1635480688,-180735,true,14163517263,22,14298705043,135187780
1635480710,-180733,true,14166350108,22,14308717139,142367031
1635480747,-180733,true,14166350108,22,14325897047,159546939
1635480801,-180731,true,14169183519,22,14361754800,192571281
1635480998,-180726,true,14176269528,22,14487240866,310971338
1635481016,-180723,true,14180522834,22,14494485935,313963101
1635481253,-180720,true,14184777417,22,14580251874,395474457
1635481310,-180717,true,14189033275,22,14589002213,399968938
1635481546,-180715,true,14191871224,22,14641614636,449743412
1635481581,-180713,true,14194709740,22,14651866841,457157101
1635481590,-180709,true,14200388476,22,14653332028,452943552
1635481622,-180706,true,14204649018,22,14663592438,458943420
1635481847,-180698,true,14216016716,22,14678262631,462245915
1635481906,-180696,true,14218860061,22,14665058797,446198736
1635481929,-180692,true,14224548458,22,14665058797,440510339
1635481977,-180689,true,14228816250,22,14666525303,437709053
1635482266,-180682,true,14238779410,22,14669458755,430679345
1635482298,-180679,true,14243051471,22,14670925701,427874230
1635482309,-180675,true,14248749546,22,14670925701,422176155
1635482319,-180671,true,14254449901,22,14672392793,417942892
1635482340,-180662,true,14267284038,22,14676794951,409510913
1635482408,-180655,true,14277274134,22,14694416795,417142661
1635482458,-180650,true,14284414199,22,14706176444,421762245
1635482547,-180647,true,14288699951,22,14722361329,433661378
1635482552,-180637,true,14302995083,22,14722361329,419366246
1635482645,-180627,true,14317304516,22,14760687354,443382838
1635482712,-180621,true,14325897047,22,14785800607,459903560
1635482729,-180615,true,14334494734,22,14793194986,458700252
1635482769,-180605,true,14348835681,22,14815400319,466564638
1635482857,-180592,true,14367500364,22,14892637180,525136816
1635482910,-180583,true,14380436288,22,14928420643,547984355
1635482933,-180578,true,14387627944,22,14946344604,558716660
1635482997,-180569,true,14400581990,22,14992747840,592165850
1635483013,-180559,true,14414989054,22,15003245913,588256859
1635483041,-180551,true,14426525082,22,15024264115,597739033
1635483061,-180542,true,14439514149,22,15039295142,599780993
1635483148,-180537,true,14446735351,22,15084478510,637743159
1635483195,-180525,true,14464080971,22,15110142648,646061677
1635483265,-180517,true,14475656287,22,15140391660,664735373
1635483295,-180508,true,14488689590,22,15150993114,662303524
1635483344,-180500,true,14500284599,22,15173735519,673450920
1635483347,-180489,true,14516242890,22,15175252893,659010003
1635483401,-180480,true,14529312735,22,15202591579,673278844
1635483417,-180471,true,14542394348,22,15210194395,667800047
1635483426,-180463,true,14554032337,22,15213236586,659204249
1635483469,-180450,true,14572963935,22,15234548967,661585032
1635483551,-180441,true,14586084850,22,15258942535,672857685
1635483626,-180431,true,14600677500,22,15280318946,679641446
1635483693,-180423,true,14612362131,22,15284903500,672541369
1635483740,-180410,true,14631369604,22,15278791067,647421463
1635483768,-180401,true,14644543105,22,15268100190,623557085
1635483779,-180394,true,14654797361,22,15266573532,611776171
1635483939,-180388,true,14663592438,22,15226933977,563341539
1635483946,-180375,true,14682666550,22,15222366810,539700260
1635484000,-180368,true,14692947501,22,15202591579,509644078
1635484027,-180362,true,14701765473,22,15193473215,491707742
1635484077,-180361,true,14703235650,22,15176770418,473534768
1635484104,-180350,true,14719417298,22,15161601992,442184694
1635484115,-180344,true,14728251157,22,15158570126,430318969
1635484293,-180336,true,14740037882,22,15081462066,341424184
1635484311,-180336,true,14740037882,22,15072416355,332378473
1635484316,-180323,true,14759211433,22,15069402324,310190891
1635484379,-180319,true,14765116003,22,15031777750,266661747
1635484411,-180311,true,14776932231,22,15012250111,235317880
1635484464,-180312,true,14775454686,22,14979261111,203806425
1635484481,-180299,true,14794674306,22,14970276699,175602393
1635484594,-180294,true,14802073123,22,14916483279,114410156
1635484607,-180285,true,14815400319,22,14910518177,95117858
1635484647,-180285,true,14815400319,22,14891148065,75747746
1635484691,-180274,true,14831705410,22,14876265104,44559694
1635484725,-180270,true,14837638982,22,14868829203,31190221
1635484793,-180262,true,14849513248,22,14852483300,2970052
1635485012,-180262,true,14849513248,22,14842090719,-7422529
1635485018,-180254,true,14861397018,22,14840606658,-20790360
1635485183,-180250,true,14867342468,22,14834671899,-32670569
1635485227,-180245,true,14874777626,22,14833188580,-41589046
1635485248,-180247,true,14871803117,22,14831705410,-40097707
1635485273,-180240,true,14882216503,22,14830222388,-51994115
1635485336,-180237,true,14886681614,22,14828739514,-57942100
1635485357,-180233,true,14892637180,22,14828739514,-63897666
1635485369,-180236,true,14888170282,22,14830222388,-57947894
1635485427,-180227,true,14901574997,22,14834671899,-66903098
1635485464,-180224,true,14906045916,22,14836155366,-69890550
1635485465,-180219,true,14913500430,22,14836155366,-77345064
1635485589,-180214,true,14920958672,22,14898595129,-22363543
1635485618,-180204,true,14935886347,22,14904555461,-31330886
1635485791,-180195,true,14949334022,22,15025766542,76432520
1635485828,-180189,true,14958305866,22,15052835923,94530057
1635485855,-180183,true,14967283093,22,15072416355,105133262
1635485949,-180172,true,14983755339,22,15144934232,161178893
1635486002,-180159,true,15003245913,22,15207152812,203906899
1635486010,-180155,true,15009248111,22,15217801013,208552902
1635486026,-180153,true,15012250111,22,15233025664,220775553
1635486085,-180134,true,15040799072,22,15313970968,273171896
1635486115,-180120,true,15061869883,22,15355372487,293502604
1635486119,-180116,true,15067895535,22,15361515557,293620022
1635486156,-180110,true,15076938532,22,15416913901,339975369
1635486165,-180090,true,15107121073,22,15432337754,325216681
1635486219,-180071,true,15135850451,22,15531416475,395566024
1635486247,-180066,true,15143419890,22,15582752241,439332351
1635486274,-180061,true,15150993114,22,15628005545,477012431
1635486302,-180039,true,15184360321,22,15674957607,490597286
1635486324,-180019,true,15214757909,22,15714192062,499434153
1635486331,-180013,true,15223889047,22,15726767816,502878769
1635486352,-180007,true,15233025664,22,15762979199,529953535
1635486429,-179982,true,15271153962,22,15891171399,620017437
1635486439,-179962,true,15301725303,22,15907069723,605344420
1635486499,-179954,true,15313970968,22,16010797239,696826271
1635486579,-179948,true,15323161648,22,16142618916,819457268
1635486650,-179924,true,15359979559,22,16251132150,891152591
1635486655,-179904,true,15390728720,22,16257633578,866904858
1635486700,-179898,true,15399965466,22,16316263598,916298132
1635486731,-179893,true,15407666989,22,16358738954,951071965
1635486743,-179874,true,15436967918,22,16375105056,938137138
1635486790,-179857,true,15463231768,22,16430872376,967640608
1635486798,-179853,true,15469417989,22,16440733364,971315375
1635486816,-179849,true,15475606684,22,16463765358,988158674
1635486846,-179833,true,15500386235,22,16509926188,1009539953
1635486878,-179816,true,15526757982,22,16539669329,1012911347
1635486924,-179812,true,15532969617,22,16592678390,1059708773
1635486946,-179807,true,15540737655,22,16612600559,1071862904
1635486964,-179790,true,15567178055,22,16629220637,1062042582
1635487039,-179772,true,15595222806,22,16699206732,1103983926
1635487121,-179770,true,15598342007,22,16724273084,1125931077
1635487129,-179763,true,15609264122,22,16725945511,1116681389
1635487240,-179745,true,15637384693,22,16764457532,1127072839
1635487270,-179727,true,15665555923,22,16781229536,1115673613
1635487357,-179718,true,15679660564,22,16835012789,1155352225
1635487464,-179712,true,15689070713,22,16850170362,1161099649
1635487524,-179691,true,15722050729,22,16873775940,1151725211
1635487530,-179674,true,15748799608,22,16877150864,1128351256
1635487598,-179667,true,15759827076,22,16909246327,1149419251
1635487720,-179659,true,15772439351,22,16977015372,1204576021
1635487816,-179643,true,15797694190,22,16983807197,1186113007
1635487855,-179628,true,15821407326,22,16973620478,1152213152
1635487900,-179623,true,15829319612,22,16963439869,1134120257
1635488035,-179621,true,15832485634,22,16943096967,1110611333
1635488037,-179606,true,15856250994,22,16943096967,1086845973
1635488043,-179589,true,15883228196,22,16944791276,1061563080
1635488107,-179584,true,15891171399,22,16924470738,1033299339
1635488157,-179582,true,15894349792,22,16894035612,999685820
1635488198,-179566,true,15919799833,22,16855225919,935426086
1635488247,-179551,true,15943696256,22,16787943035,844246779
1635488270,-179547,true,15950074691,22,16771164321,821089630
1635488408,-179539,true,15962839218,22,16677512952,714673734
1635488433,-179521,true,15991596765,22,16654181936,662585171
1635488478,-179503,true,16020406119,22,16622570611,602164492
1635488480,-179500,true,16025212722,22,16620908520,595695798
1635488621,-179486,true,16047662608,22,16559527852,511865244
1635488676,-179469,true,16074965471,22,16544631726,469666255
1635488758,-179449,true,16107145962,22,16546286189,439140227
1635488777,-179445,true,16113589787,22,16549595612,436005825
1635488793,-179430,true,16137777098,22,16552905696,415128598
1635488906,-179413,true,16165233278,22,16567809272,402575994
1635488929,-179394,true,16195974879,22,16572780112,376805233
1635488936,-179391,true,16200834158,22,16572780112,371945954
1635488957,-179377,true,16223530074,22,16572780112,349250038
1635488978,-179359,true,16252757263,22,16576094834,323337571
1635489016,-179341,true,16282037107,22,16586042977,304005870
1635489084,-179341,true,16282037107,22,16589360352,307323245
1635489316,-179330,true,16299956305,22,16604296750,304340445
1635489349,-179313,true,16327688410,22,16607617775,279929365
1635489398,-179294,true,16358738954,22,16604296750,245557796
1635489448,-179293,true,16360374828,22,16592678390,232303562
1635489451,-179279,true,16383294247,22,16592678390,209384143
1635489522,-179262,true,16411168139,22,16576094834,164926695
1635489568,-179243,true,16442377438,22,16571123000,128745562
1635489597,-179245,true,16439089455,22,16552905696,113816241
1635489675,-179231,true,16462119146,22,16529749000,67629854
1635489735,-179215,true,16488478301,22,16513228338,24750037
1635489772,-179197,true,16518182802,22,16506624698,-11558104
1635489905,-179199,true,16514879661,22,16478588675,-36290986
1635489914,-179190,true,16529749000,22,16476940981,-52808019
1635489943,-179177,true,16551250571,22,16478588675,-72661896
1635489948,-179165,true,16571123000,22,16478588675,-92534325
1635490005,-179168,true,16566152657,22,16478588675,-87563982
1635490033,-179162,true,16576094834,22,16480236534,-95858300
1635490122,-179151,true,16594337658,22,16478588675,-115748983
1635490211,-179141,true,16610939465,22,16491776161,-119163304
1635490268,-179144,true,16605957179,22,16491776161,-114181018
1635490307,-179139,true,16614261819,22,16491776161,-122485658
1635490334,-179134,true,16622570611,22,16498373861,-124196750
1635490352,-179125,true,16637536910,22,16498373861,-139163049
1635490403,-179127,true,16634209902,22,16503323868,-130886034
1635490432,-179123,true,16640864584,22,16508275361,-132589223
1635490439,-179120,true,16645857343,22,16509926188,-135931155
1635490469,-179116,true,16652516684,22,16511577181,-140939503
1635490502,-179120,true,16645857343,22,16526443546,-119413797
1635490523,-179118,true,16649186680,22,16528096190,-121090490
1635490529,-179115,true,16654181936,22,16529749000,-124432936
1635490626,-179112,true,16659178690,22,16538015527,-121163163
1635490778,-179116,true,16652516684,22,16564496207,-88020477
1635490926,-179114,true,16655847354,22,16599316457,-56530897
1635490938,-179114,true,16655847354,22,16602636486,-53210868
1635490993,-179112,true,16659178690,22,16615923245,-43255445
1635491071,-179117,true,16650851599,22,16627557881,-23293718
1635491162,-179116,true,16652516684,22,16654181936,1665252
1635491284,-179118,true,16649186680,22,16679180703,29994023
1635491586,-179117,true,16650851599,22,16662510693,11659094
1635491597,-179122,true,16642528670,22,16652516684,9988014
1635491684,-179121,true,16644192923,22,16637536910,-6656013
1635491793,-179121,true,16644192923,22,16619246596,-24946327
1635491897,-179121,true,16644192923,22,16597656691,-46536232
1635491982,-179126,true,16635873323,22,16577752443,-58120880
1635492041,-179124,true,16639200664,22,16569466053,-69734611
1635492147,-179125,true,16637536910,22,16554560987,-82975923
1635492323,-179125,true,16637536910,22,16547940818,-89596092
1635492341,-179130,true,16629220637,22,16547940818,-81279819
1635492410,-179128,true,16632546647,22,16567809272,-64737375
1635492612,-179130,true,16629220637,22,16594337658,-34882979
1635492621,-179131,true,16627557881,22,16594337658,-33220223
1635492826,-179141,true,16610939465,22,16503323868,-107615597
1635492889,-179141,true,16610939465,22,16476940981,-133998484
1635492903,-179148,true,16599316457,22,16468704982,-130611475
1635492958,-179151,true,16594337658,22,16421017302,-173320356
1635493050,-179169,true,16564496207,22,16340755133,-223741074
1635493103,-179170,true,16562839923,22,16304846781,-257993142
1635493141,-179182,true,16542977428,22,16278781188,-264196240
1635493275,-179184,true,16539669329,22,16173317511,-366351818
1635493435,-179200,true,16513228338,22,16062111283,-451117055
1635493498,-179203,true,16508275361,22,16017202519,-491072842
1635493519,-179211,true,16495074681,22,15999594163,-495480518
1635493641,-179212,true,16493425339,22,15991596765,-501828574
1635493661,-179226,true,16470351852,22,15988398925,-481952927
1635493688,-179222,true,16476940981,22,15986800245,-490140736
1635493801,-179227,true,16468704982,22,15983603365,-485101617
1635494001,-179228,true,16467058276,22,16012398319,-454659957
1635494012,-179240,true,16447310644,22,16012398319,-434912325
1635494038,-179234,true,16457181498,22,16015600959,-441580539
1635494077,-179238,true,16450600271,22,16020406119,-430194152
1635494096,-179236,true,16453890555,22,16020406119,-433484436
1635494098,-179247,true,16435802131,22,16020406119,-415396012
1635494238,-179240,true,16447310644,22,16047662608,-399648036
1635494292,-179245,true,16439089455,22,16055688045,-383401410
1635494313,-179245,true,16439089455,22,16055688045,-383401410
1635494922,-179250,true,16430872376,22,16329321179,-101551197
1635495125,-179247,true,16435802131,22,16398045111,-37757020
1635495460,-179253,true,16425944100,22,16345657850,-80286250
1635495520,-179255,true,16422659404,22,16332587206,-90072198
1635495756,-179262,true,16411168139,22,16293437952,-117730187
1635495761,-179261,true,16412809256,22,16293437952,-119371304
1635495829,-179267,true,16402965016,22,16283665310,-119299706
1635495935,-179268,true,16401324884,22,16269017336,-132307548
1635495965,-179275,true,16389848547,22,16260885268,-128963279
1635495981,-179274,true,16391487532,22,16254382539,-137104993
1635496054,-179279,true,16383294247,22,16246257786,-137036461
1635496101,-179281,true,16380018079,22,16246257786,-133760293
1635496137,-179285,true,16373467710,22,16246257786,-127209924
1635496271,-179280,true,16381656081,22,16246257786,-135398295
1635496274,-179286,true,16371830527,22,16246257786,-125572741
1635496341,-179285,true,16373467710,22,16262511356,-110956354
1635496503,-179289,true,16366919960,22,16269017336,-97902624
1635496534,-179286,true,16371830527,22,16265764021,-106066506
1635496616,-179291,true,16363647067,22,16285293677,-78353390
1635496688,-179290,true,16365283431,22,16298326473,-66956958
1635496771,-179290,true,16365283431,22,16311369698,-53913733
1635496940,-179288,true,16368556652,22,16344023448,-24533204
1635496982,-179292,true,16362010865,22,16352197094,-9813771
1635497004,-179292,true,16362010865,22,16353832314,-8178551
1635497123,-179294,true,16358738954,22,16375105056,16366102
1635497143,-179292,true,16362010865,22,16378380241,16369376
1635497238,-179296,true,16355467697,22,16378380241,22912544
1635497268,-179296,true,16355467697,22,16378380241,22912544
1635497291,-179296,true,16355467697,22,16381656081,26188384
1635497349,-179294,true,16358738954,22,16388209726,29470772
1635497421,-179297,true,16353832314,22,16401324884,47492570
1635497611,-179297,true,16353832314,22,16394765994,40933680
1635497849,-179298,true,16352197094,22,16399684915,47487821
1635497951,-179296,true,16355467697,22,16406245773,50778076
1635498340,-179300,true,16348927145,22,16442377438,93450293
1635498355,-179300,true,16348927145,22,16440733364,91806219
1635498462,-179302,true,16345657850,22,16448955375,103297525
1635498558,-179301,true,16347292416,22,16457181498,109889082
1635498600,-179305,true,16340755133,22,16453890555,113135422
1635498629,-179305,true,16340755133,22,16462119146,121364013
1635498825,-179303,true,16344023448,22,16508275361,164251913
1635498889,-179302,true,16345657850,22,16504974201,159316351
1635499193,-179307,true,16337487472,22,16501673701,164186229
1635499318,-179309,true,16334220465,22,16467058276,132837811
1635499362,-179311,true,16330954111,22,16453890555,122936444
1635499436,-179310,true,16332587206,22,16440733364,108146158
1635499475,-179318,true,16319527014,22,16439089455,119562441
1635499537,-179317,true,16321158967,22,16429229453,108070486
1635499568,-179319,true,16317895225,22,16421017302,103122077
1635499579,-179317,true,16321158967,22,16421017302,99858335
1635499695,-179328,true,16303216459,22,16373467710,70251251
1635499707,-179327,true,16304846781,22,16368556652,63709871
1635499772,-179329,true,16301586301,22,16352197094,50610793
1635499870,-179330,true,16299956305,22,16293437952,-6518353
1635499934,-179343,true,16278781188,22,16257633578,-21147610
1635499960,-179340,true,16283665310,22,16243009021,-40656289
1635499977,-179344,true,16277153472,22,16233266626,-43886846
1635500122,-179344,true,16277153472,22,16179787809,-97365663
1635500202,-179357,true,16256007977,22,16165233278,-90774699
1635500249,-179355,true,16259259342,22,16157153085,-102106257
1635500267,-179360,true,16251132150,22,16147462186,-103669964
1635500359,-179361,true,16249507200,22,16113589787,-135917413
1635500377,-179374,true,16228397620,22,16105535409,-122862211
1635500432,-179373,true,16230020460,22,16086221323,-143799137
1635500435,-179371,true,16233266626,22,16084612861,-148653765
1635500495,-179368,true,16238137093,22,16065323866,-172813227
1635500625,-179379,true,16220285855,22,15996394724,-223891131
1635500671,-179379,true,16220285855,22,15967628549,-252657306
1635500691,-179374,true,16228397620,22,15962839218,-265558402
1635500734,-179373,true,16230020460,22,15954860192,-275160268
1635500787,-179385,true,16210557089,22,15945290626,-265266463
1635501010,-179380,true,16218663988,22,15927761326,-290902662
1635501083,-179377,true,16223530074,22,15919799833,-303730241
1635501103,-179375,true,16226774942,22,15916616351,-310158591
1635501267,-179385,true,16210557089,22,15905479175,-305077914
1635501346,-179381,true,16217042284,22,15908660430,-308381854
1635501367,-179376,true,16225152427,22,15913433505,-311718922
1635501457,-179372,true,16231643462,22,15953264866,-278378596
1635501646,-179380,true,16218663988,22,16057293613,-161370375
1635501695,-179376,true,16225152427,22,16065323866,-159828561
1635501772,-179373,true,16230020460,22,16066930398,-163090062
1635501870,-179370,true,16234889953,22,16091047672,-143842281
1635501900,-179380,true,16218663988,22,16094266042,-124397946
1635501947,-179375,true,16226774942,22,16099094805,-127680137
1635501951,-179370,true,16234889953,22,16099094805,-135795148
1635502022,-179371,true,16233266626,22,16113589787,-119676839
1635502086,-179381,true,16217042284,22,16124872684,-92169600
1635502148,-179376,true,16225152427,22,16139390876,-85761551
1635502299,-179378,true,16221907883,22,16123260358,-98647525
1635502351,-179380,true,16218663988,22,16108756677,-109907311
1635502390,-179389,true,16204074486,22,16102314785,-101759701
1635502419,-179384,true,16212178144,22,16099094805,-113083339
1635502459,-179383,true,16213799362,22,16092656776,-121142586
1635502611,-179383,true,16213799362,22,16092656776,-121142586
1635502625,-179394,true,16195974879,22,16094266042,-101708837
1635502845,-179389,true,16204074486,22,16103925016,-100149470
1635502907,-179388,true,16205694894,22,16103925016,-101769878
1635502946,-179387,true,16207315463,22,16102314785,-105000678
1635503002,-179397,true,16191117058,22,16102314785,-88802273
1635503027,-179392,true,16199214236,22,16100704714,-98509522
1635503051,-179391,true,16200834158,22,16097485056,-103349102
1635503095,-179393,true,16197594477,22,16091047672,-106546805
1635503155,-179403,true,16181405787,22,16089438728,-91967059
1635503394,-179397,true,16191117058,22,16102314785,-88802273
1635503586,-179396,true,16192736170,22,16105535409,-87200761
1635503765,-179398,true,16189498109,22,16107145962,-82352147
1635503879,-179410,true,16170083333,22,16097485056,-72598277
1635503964,-179404,true,16179787809,22,16094266042,-85521767
1635503973,-179406,true,16176552336,22,16094266042,-82286294
1635504041,-179409,true,16171700341,22,16105535409,-66164932
1635504106,-179419,true,16155537532,22,16108756677,-46780855
1635504116,-179412,true,16166849801,22,16108756677,-58093124
1635504133,-179413,true,16165233278,22,16107145962,-58087316
1635504149,-179416,true,16160384678,22,16105535409,-54849269
1635504245,-179428,true,16141004815,22,16092656776,-48348039
1635504273,-179422,true,16150691840,22,16089438728,-61253112
1635504290,-179423,true,16149076932,22,16087829945,-61246987
1635504320,-179426,true,16144233178,22,16083004561,-61228617
1635504363,-179439,true,16123260358,22,16076572967,-46687391
1635504393,-179433,true,16132936733,22,16074965471,-57971262
1635504461,-179433,true,16132936733,22,16071750960,-61185773
1635504536,-179435,true,16129710630,22,16071750960,-57959670
1635504570,-179449,true,16107145962,22,16070143945,-37002017
1635504725,-179444,true,16115201146,22,16047662608,-67538538
1635504733,-179445,true,16113589787,22,16046058003,-67531784
1635504848,-179450,true,16105535409,22,16033226931,-72308478
1635504901,-179463,true,16084612861,22,16022008160,-62604701
1635504933,-179460,true,16089438728,22,16013999559,-75439169
1635505138,-179464,true,16083004561,22,15977211521,-105793040
1635505190,-179468,true,16076572967,22,15969225312,-107347655
1635505221,-179481,true,16055688045,22,15964435502,-91252543
1635505242,-179477,true,16062111283,22,15953264866,-108846417
1635505403,-179483,true,16052477389,22,15870527329,-181950060
1635505487,-179489,true,16042849272,22,15826154223,-216695049
1635505526,-179500,true,16025212722,22,15810336770,-214875952
1635505562,-179497,true,16030020766,22,15800853887,-229166879
1635505892,-179500,true,16025212722,22,15772439351,-252773371
1635505981,-179506,true,16015600959,22,15761403059,-254197900
1635506052,-179514,true,16002794241,22,15751949526,-250844715
1635506085,-179511,true,16007595560,22,15747224886,-260370674
1635506168,-179515,true,16001194122,22,15747224886,-253969236
1635506236,-179518,true,15996394724,22,15751949526,-244445198
1635506305,-179524,true,15986800245,22,15755100073,-231700172
1635506335,-179521,true,15991596765,22,15755100073,-236496692
1635506510,-179524,true,15986800245,22,15736206236,-250594009
1635506591,-179530,true,15977211521,22,15715763481,-261448040
1635506601,-179537,true,15966031946,22,15712620800,-253411146
1635506628,-179534,true,15970822234,22,15703196526,-267625708
1635506682,-179539,true,15962839218,22,15673390268,-289448950
1635506735,-179548,true,15948479843,22,15645204949,-303274894
1635506749,-179555,true,15937320372,22,15637384693,-299935679
1635506759,-179553,true,15940507995,22,15631131302,-309376693
1635506794,-179558,true,15932540132,22,15615508765,-317031367
1635506920,-179566,true,15919799833,22,15567178055,-352621778
1635506969,-179569,true,15915024849,22,15550064429,-364960420
1635506997,-179565,true,15921391813,22,15540737655,-380654158
1635507150,-179569,true,15915024849,22,15506587319,-408437530
1635507204,-179575,true,15905479175,22,15494187630,-411291545
1635507252,-179577,true,15902298556,22,15484894370,-417404186
1635507298,-179577,true,15902298556,22,15475606684,-426691872
1635507363,-179583,true,15892760516,22,15463231768,-429528748
1635507447,-179589,true,15883228196,22,15446232415,-436995781
1635507506,-179592,true,15878464180,22,15438511615,-439952565
1635507552,-179593,true,15876876493,22,15440055466,-436821027
1635507638,-179599,true,15867353700,22,15450866748,-416486952
1635507661,-179607,true,15854665527,22,15452411835,-402253692
1635507672,-179614,true,15843571700,22,15452411835,-391159865
1635507695,-179614,true,15843571700,22,15453957076,-389614624
1635507833,-179620,true,15834068883,22,15446232415,-387836468
1635507867,-179628,true,15821407326,22,15444687946,-376719380
1635507881,-179632,true,15815080345,22,15444687946,-370392399
1635507894,-179634,true,15811917803,22,15443143632,-368774171
1635507920,-179641,true,15800853887,22,15440055466,-360798421
1635507951,-179648,true,15789797712,22,15436967918,-352829794
1635508132,-179650,true,15786640226,22,15452411835,-334228391
1635508160,-179652,true,15783483372,22,15455502472,-327980900
1635508178,-179657,true,15775593997,22,15458593727,-317000270
1635508219,-179663,true,15766131952,22,15469417989,-296713963
1635508245,-179663,true,15766131952,22,15475606684,-290525268
1635508287,-179661,true,15769285336,22,15495737049,-273548287
1635508424,-179665,true,15762979199,22,15559396801,-203582398
1635508443,-179670,true,15755100073,22,15568734773,-186365300
1635508497,-179670,true,15755100073,22,15588986276,-166113797
1635508513,-179669,true,15756675583,22,15595222806,-161452777
1635508581,-179674,true,15748799608,22,15620193886,-128605722
1635508606,-179680,true,15739353635,22,15629568346,-109785289
1635508793,-179681,true,15737779857,22,15689070713,-48709144
1635508981,-179683,true,15734632773,22,15682796653,-51836120
1635508995,-179689,true,15725195297,22,15681228531,-43966766
1635509054,-179693,true,15718906791,22,15693777905,-25128886
1635509216,-179693,true,15718906791,22,15689070713,-29836078
1635509250,-179694,true,15717335057,22,15681228531,-36106526
1635509286,-179700,true,15707907956,22,15673390268,-34517688
1635509533,-179703,true,15703196526,22,15676525103,-26671423
1635509604,-179703,true,15703196526,22,15682796653,-20399873
1635509674,-179704,true,15701626363,22,15679660564,-21965799
1635509839,-179710,true,15692208684,22,15712620800,20412116
1635509890,-179714,true,15685933370,22,15723622935,37689565
1635509929,-179715,true,15684364933,22,15718906791,34541858
1635510045,-179718,true,15679660564,22,15698486509,18825945
1635510092,-179725,true,15668689191,22,15693777905,25088714
1635510180,-179729,true,15662423282,22,15685933370,23510088
1635510194,-179728,true,15663989524,22,15684364933,20375409
1635510199,-179730,true,15660857196,22,15682796653,21939457
1635510385,-179738,true,15648334146,22,15634257685,-14076461
1635510439,-179741,true,15643640585,22,15621755905,-21884680
1635510501,-179740,true,15645204949,22,15607703352,-37501597
1635510607,-179743,true,15640512326,22,15598342007,-42170319
1635510920,-179752,true,15626442901,22,15562508836,-63934065
1635510955,-179757,true,15618632023,22,15560952741,-57679282
1635511027,-179757,true,15618632023,22,15559396801,-59235222
1635511059,-179757,true,15618632023,22,15557841017,-60791006
1635511096,-179766,true,15604582280,22,15554729915,-49852365
1635511265,-179769,true,15599901841,22,15550064429,-49837412
1635511354,-179768,true,15601461831,22,15546954883,-54506948
1635511517,-179768,true,15601461831,22,15546954883,-54506948
1635511612,-179776,true,15588986276,22,15553174598,-35811678
1635512056,-179778,true,15585868947,22,15574963201,-10905746
1635512097,-179777,true,15587427534,22,15578078350,-9349184
1635512098,-179776,true,15588986276,22,15578078350,-10907926
1635512140,-179778,true,15585868947,22,15584310516,-1558431
1635512174,-179777,true,15587427534,22,15588986276,1558742
1635512272,-179776,true,15588986276,22,15595222806,6236530
1635512291,-179776,true,15588986276,22,15592104230,3117954
1635512426,-179783,true,15578078350,22,15604582280,26503930
1635512634,-179782,true,15579636157,22,15623318081,43681924
1635512708,-179781,true,15581194121,22,15628005545,46811424
1635512764,-179779,true,15584310516,22,15662423282,78112766
1635512922,-179778,true,15585868947,22,15778749273,192880326
1635512938,-179772,true,15595222806,22,15789797712,194574906
1635512990,-179765,true,15606142738,22,15832485634,226342896
1635513038,-179761,true,15612386131,22,15873701594,261315463
1635513054,-179757,true,15618632023,22,15886405000,267772977
1635513075,-179748,true,15632694415,22,15911842321,279147906
1635513113,-179740,true,15645204949,22,15945290626,300085677
1635513163,-179736,true,15651463970,22,15989997765,338533795
1635513326,-179730,true,15660857196,22,16141004815,480147619
1635513359,-179718,true,15679660564,22,16170083333,490422769
1635513377,-179709,true,15693777905,22,16186260695,492482790
1635513396,-179705,true,15700056358,22,16199214236,499157878
1635513459,-179703,true,15703196526,22,16241384883,538188357
1635513478,-179694,true,15717335057,22,16254382539,537047482
1635513625,-179685,true,15731486319,22,16350562038,619075719
1635513640,-179681,true,15737779857,22,16352197094,614417237
1635513656,-179679,true,15740927570,22,16353832314,612904744
1635513766,-179672,true,15751949526,22,16350562038,598612512
1635513786,-179665,true,15762979199,22,16344023448,581044249
1635513913,-179662,true,15767708566,22,16304846781,537138215
1635513923,-179660,true,15770862265,22,16303216459,532354194
1635513957,-179652,true,15783483372,22,16296696803,513213431
1635514033,-179645,true,15794535125,22,16264137607,469602482
1635514087,-179641,true,15800853887,22,16244633322,443779435
1635514178,-179640,true,15802433972,22,16210557089,408123117
1635514210,-179633,true,15813498995,22,16204074486,390575491
1635514258,-179624,true,15827736838,22,16197594477,369857639
1635514312,-179619,true,15835652290,22,16199214236,363561946
1635514393,-179616,true,15840403460,22,16186260695,345857235
1635514426,-179609,true,15851495070,22,16181405787,329910717
1635514475,-179602,true,15862594446,22,16170083333,307488887
1635514496,-179598,true,15868940435,22,16165233278,296292843
1635514512,-179596,true,15872114382,22,16160384678,288270296
1635514687,-179591,true,15880052027,22,16121648194,241596167
1635514707,-179587,true,15886405000,22,16121648194,235243194
1635514743,-179583,true,15892760516,22,16134550027,241789511
1635514838,-179580,true,15897528821,22,16139390876,241862055
1635514870,-179573,true,15908660430,22,16136163482,227503052
1635514950,-179571,true,15911842321,22,16137777098,225934777
1635514970,-179570,true,15913433505,22,16141004815,227571310
1635515036,-179569,true,15915024849,22,16149076932,234052083
1635515054,-179563,true,15924576251,22,16150691840,226115589
1635515087,-179560,true,15929354102,22,16155537532,226183430
1635515133,-179558,true,15932540132,22,16155537532,222997400
1635515243,-179555,true,15937320372,22,16157153085,219832713
1635515281,-179549,true,15946885155,22,16165233278,218348123
1635515400,-179544,true,15954860192,22,16189498109,234637917
1635515459,-179539,true,15962839218,22,16207315463,244476245
1635515540,-179535,true,15969225312,22,16233266626,264041314
1635515564,-179529,true,15978809243,22,16239760907,260951664
1635515582,-179525,true,15985201725,22,16243009021,257807296
1635515651,-179522,true,15989997765,22,16254382539,264384774
1635515746,-179519,true,15994795244,22,16265764021,270968777
1635515898,-179514,true,16002794241,22,16285293677,282499436
1635515994,-179510,true,16009196319,22,16288550898,279354579
1635516197,-179508,true,16012398319,22,16270644238,258245919
1635516288,-179504,true,16018804239,22,16270644238,251839999
1635516518,-179500,true,16025212722,22,16212178144,186965422
1635516555,-179496,true,16031623768,22,16197594477,165970709
1635516836,-179494,true,16034830253,22,16157153085,122322832
1635517165,-179485,true,16049267375,22,16249507200,200239825
1635517237,-179478,true,16060505233,22,16280409066,219903833
1635517283,-179474,true,16066930398,22,16303216459,236286061
1635517312,-179468,true,16076572967,22,16311369698,234796731
1635517397,-179458,true,16092656776,22,16365283431,272626655
1635517434,-179453,true,16100704714,22,16376742567,276037853
1635517504,-179447,true,16110367552,22,16416091982,305724430
1635517782,-179441,true,16120036190,22,16524791067,404754877
1635517804,-179430,true,16137777098,22,16526443546,388666448
1635517830,-179424,true,16147462186,22,16528096190,380634004
1635517890,-179418,true,16157153085,22,16538015527,380862442
1635518177,-179411,true,16168466486,22,16562839923,394373437
1635518227,-179401,true,16184642230,22,16572780112,388137882
1635518249,-179394,true,16195974879,22,16572780112,376805233
1635518376,-179388,true,16205694894,22,16586042977,380348083
1635518434,-179382,true,16215420742,22,16582726266,367305524
1635518443,-179372,true,16231643462,22,16582726266,351082804
1635518608,-179363,true,16246257786,22,16624232868,377975082
1635518681,-179354,true,16260885268,22,16674177950,413292682
1635518722,-179345,true,16275525920,22,16687521962,411996042
1635518838,-179336,true,16290179753,22,16719256805,429077052
1635518873,-179327,true,16304846781,22,16732636893,427790112
1635518899,-179319,true,16317895225,22,16741004885,423109660
1635518973,-179311,true,16330954111,22,16759429201,428475090
1635519074,-179302,true,16345657850,22,16787943035,442285185
1635519077,-179293,true,16360374828,22,16789621829,429247001
1635519097,-179286,true,16371830527,22,16801378091,429547564
1635519120,-179278,true,16384932576,22,16808099650,423167074
1635519142,-179270,true,16398045111,22,16819868850,421823739
1635519147,-179267,true,16402965016,22,16823232992,420267976
1635519173,-179264,true,16407886398,22,16838379959,430493561
1635519287,-179256,true,16421017302,22,16900794240,479776938
1635519320,-179249,true,16432515463,22,16932934666,500419203
1635519357,-179247,true,16435802131,22,16965136213,529334082
1635519425,-179243,true,16442377438,22,17014404049,572026611
1635519444,-179231,true,16462119146,22,17028020337,565901191
1635519537,-179222,true,16476940981,22,17092846665,615905684
1635519601,-179220,true,16480236534,22,17109947206,629710672
1635519743,-179217,true,16485181100,22,17190549194,705368094
1635519745,-179205,true,16504974201,22,17192268249,687294048
1635519775,-179195,true,16521486604,22,17195706874,674220270
1635519868,-179195,true,16521486604,22,17218074711,696588107
1635519900,-179195,true,16521486604,22,17235300536,713813932
1635519911,-179182,true,16542977428,22,17238747768,695770340
1635520061,-179174,true,16556216443,22,17245644302,689427859
1635520109,-179174,true,16556216443,22,17231853992,675637549
1635520167,-179174,true,16556216443,22,17218074711,661858268
1635520196,-179159,true,16581068159,22,17211189202,630121043
1635520206,-179153,true,16591019288,22,17206026878,615007590
1635520278,-179150,true,16595997091,22,17175085432,579088341
1635520359,-179150,true,16595997091,22,17128777561,532780470
1635520367,-179137,true,16617584837,22,17123639955,506055118
1635520388,-179130,true,16629220637,22,17111658200,482437563
1635520622,-179133,true,16624232868,22,16917702641,293469773
1635520716,-179136,true,16619246596,22,16873775940,254529344
1635520776,-179124,true,16639200664,22,16851855379,212654715
1635520792,-179118,true,16649186680,22,16841747804,192561124
1635520854,-179119,true,16647521928,22,16821550837,174028909
1635520856,-179120,true,16645857343,22,16821550837,175693494
1635520878,-179107,true,16667509946,22,16813142584,145632638
1635520962,-179101,true,16677512952,22,16782907659,105394707
1635520974,-179101,true,16677512952,22,16781229536,103716584
1635520999,-179100,true,16679180703,22,16779551581,100370878
1635521080,-179088,true,16699206732,22,16766133978,66927246
1635521093,-179082,true,16709228761,22,16762781254,53552493
1635521161,-179085,true,16704216995,22,16741004885,36787890
1635521175,-179085,true,16704216995,22,16737657186,33440191
1635521228,-179075,true,16720928731,22,16712570774,-8357957
1635521254,-179069,true,16730963797,22,16705887417,-25076380
1635521415,-179079,true,16714242031,22,16629220637,-85021394
1635521428,-179081,true,16710899684,22,16624232868,-86666816
1635521453,-179072,true,16725945511,22,16614261819,-111683692
1635521534,-179068,true,16732636893,22,16587701582,-144935311
1635521593,-179078,true,16715913456,22,16562839923,-153073533
1635521724,-179080,true,16712570774,22,16504974201,-207596573
1635521817,-179069,true,16730963797,22,16490127148,-240836649
1635521833,-179064,true,16739330952,22,16488478301,-250852651
1635521840,-179073,true,16724273084,22,16486829618,-237443466
1635522019,-179072,true,16725945511,22,16437445711,-288499800
1635522086,-179064,true,16739330952,22,16419375365,-319955587
1635522110,-179059,true,16747702292,22,16416091982,-331610310
1635522152,-179068,true,16732636893,22,16406245773,-326391120
1635522215,-179070,true,16729290868,22,16407886398,-321404470
1635522381,-179056,true,16752727105,22,16468704982,-284022123
1635522560,-179050,true,16762781254,22,16526443546,-236337708
1635522743,-179057,true,16751051999,22,16547940818,-203111181
1635522886,-179057,true,16751051999,22,16552905696,-198146303
1635522925,-179044,true,16772841438,22,16554560987,-218280451
1635522993,-179042,true,16776196174,22,16562839923,-213356251
1635523009,-179051,true,16761105144,22,16564496207,-196608937
1635523092,-179052,true,16759429201,22,16581068159,-178361042
1635523186,-179042,true,16776196174,22,16579410218,-196785956
1635523212,-179041,true,16777873793,22,16576094834,-201778959
1635523237,-179051,true,16761105144,22,16566152657,-194952487
1635523420,-179052,true,16759429201,22,16549595612,-209833589
1635523577,-179043,true,16774518722,22,16542977428,-231541294
1635523709,-179041,true,16777873793,22,16544631726,-233242067
1635523812,-179051,true,16761105144,22,16551250571,-209854573
1635523966,-179052,true,16759429201,22,16557872065,-201557136
1635524186,-179044,true,16772841438,22,16539669329,-233172109
1635524262,-179044,true,16772841438,22,16531401975,-241439463
1635524291,-179054,true,16756077818,22,16529749000,-226328818
1635524403,-179055,true,16754402377,22,16519834621,-234567756
1635524419,-179048,true,16766133978,22,16516531149,-249602829
1635524452,-179047,true,16767810591,22,16509926188,-257884403
1635524570,-179060,true,16746027689,22,16488478301,-257549388
1635524709,-179067,true,16734310157,22,16463765358,-270544799
1635524718,-179061,true,16744353253,22,16462119146,-282234107
1635524757,-179060,true,16746027689,22,16455535944,-290491745
1635524797,-179075,true,16720928731,22,16448955375,-271973356
1635524959,-179087,true,16700876653,22,16353832314,-347044339
1635524991,-179081,true,16710899684,22,16337487472,-373412212
1635525024,-179082,true,16709228761,22,16319527014,-389701747
1635525070,-179099,true,16680848621,22,16295067296,-385781325
1635525200,-179110,true,16662510693,22,16244633322,-417877371
1635525274,-179104,true,16672510699,22,16215420742,-457089957
1635525288,-179108,true,16665843361,22,16212178144,-453665217
1635525309,-179123,true,16640864584,22,16207315463,-433549121
1635525566,-179131,true,16627557881,22,16173317511,-454240370
1635525694,-179126,true,16635873323,22,16153922139,-481951184
1635525895,-179132,true,16625895291,22,16225152427,-400742864
1635526053,-179148,true,16599316457,22,16272271303,-327045154
1635526166,-179157,true,16584384539,22,16295067296,-289317243
1635526210,-179156,true,16586042977,22,16299956305,-286086672
1635526230,-179163,true,16574437390,22,16299956305,-274481085
1635526262,-179178,true,16549595612,22,16301586301,-248009311
1635526601,-179186,true,16536361891,22,16324423362,-211938529
1635526740,-179185,true,16538015527,22,16327688410,-210327117
1635526806,-179190,true,16529749000,22,16321158967,-208590033
1635526815,-179203,true,16508275361,22,16319527014,-188748347
1635526836,-179209,true,16498373861,22,16316263598,-182110263
1635526894,-179210,true,16496724189,22,16309738724,-186985465
1635527211,-179211,true,16495074681,22,16293437952,-201636729
1635527267,-179224,true,16473646087,22,16280409066,-193237021
1635527279,-179228,true,16467058276,22,16277153472,-189904804
1635527298,-179229,true,16465411735,22,16273898530,-191513205
1635527362,-179232,true,16460473099,22,16262511356,-197961743
1635527437,-179246,true,16437445711,22,16244633322,-192812389
1635527746,-179247,true,16435802131,22,16280409066,-155393065
1635527868,-179247,true,16435802131,22,16291808771,-143993360
1635527903,-179250,true,16430872376,22,16293437952,-137434424
1635527918,-179257,true,16419375365,22,16293437952,-125937413
1635527940,-179256,true,16421017302,22,16296696803,-124320499
1635527968,-179256,true,16421017302,22,16299956305,-121060997
1635528032,-179259,true,16416091982,22,16301586301,-114505681
1635528069,-179268,true,16401324884,22,16301586301,-99738583
1635528095,-179268,true,16401324884,22,16306477266,-94847618
1635528159,-179266,true,16404605313,22,16330954111,-73651202
1635528202,-179267,true,16402965016,22,16345657850,-57307166
1635528375,-179274,true,16391487532,22,16388209726,-3277806
1635528405,-179275,true,16389848547,22,16389848547,0
1635528423,-179274,true,16391487532,22,16389848547,-1638985
1635528444,-179276,true,16388209726,22,16388209726,0
1635528513,-179284,true,16375105056,22,16384932576,9827520
1635528539,-179286,true,16371830527,22,16383294247,11463720
1635528578,-179281,true,16380018079,22,16391487532,11469453
1635528585,-179283,true,16376742567,22,16389848547,13105980
1635528632,-179284,true,16375105056,22,16391487532,16382476
1635528715,-179284,true,16375105056,22,16399684915,24579859
1635528732,-179280,true,16381656081,22,16399684915,18028834
1635528756,-179280,true,16381656081,22,16401324884,19668803
1635528795,-179283,true,16376742567,22,16398045111,21302544
1635528890,-179286,true,16371830527,22,16386571069,14740542
1635528962,-179284,true,16375105056,22,16381656081,6551025
1635529090,-179286,true,16371830527,22,16347292416,-24538111
1635529095,-179289,true,16366919960,22,16345657850,-21262110
1635529135,-179294,true,16358738954,22,16335853887,-22885067
1635529142,-179291,true,16363647067,22,16334220465,-29426602
1635529196,-179293,true,16360374828,22,16321158967,-39215861
1635529212,-179294,true,16358738954,22,16324423362,-34315592
1635529232,-179296,true,16355467697,22,16326055804,-29411893
1635529290,-179294,true,16358738954,22,16330954111,-27784843
1635529293,-179295,true,16357103244,22,16329321179,-27782065
1635529443,-179300,true,16348927145,22,16321158967,-27768178
1635529555,-179301,true,16347292416,22,16329321179,-17971237
1635529685,-179299,true,16350562038,22,16335853887,-14708151
1635529724,-179298,true,16352197094,22,16355467697,3270603
1635529783,-179301,true,16347292416,22,16383294247,36001831
1635529969,-179300,true,16348927145,22,16471998887,123071742
1635530019,-179296,true,16355467697,22,16495074681,139606984
1635530083,-179295,true,16357103244,22,16528096190,170992946
1635530171,-179295,true,16357103244,22,16567809272,210706028
1635530305,-179293,true,16360374828,22,16632546647,272171819
1635530371,-179290,true,16365283431,22,16660844608,295561177
1635530452,-179288,true,16368556652,22,16684184958,315628306
1635530541,-179289,true,16366919960,22,16724273084,357353124
1635530570,-179287,true,16370193507,22,16737657186,367463679
1635530611,-179282,true,16378380241,22,16749377062,370996821
1635530701,-179279,true,16383294247,22,16766133978,382839731
1635530993,-179279,true,16383294247,22,16831646291,448352044
1635531209,-179276,true,16388209726,22,16845116322,456906596
1635531309,-179271,true,16396405470,22,16856911441,460505971
1635531321,-179268,true,16401324884,22,16855225919,453901035
1635531329,-179267,true,16402965016,22,16855225919,452260903
1635531341,-179264,true,16407886398,22,16856911441,449025043
1635531388,-179260,true,16414450537,22,16856911441,442460904
1635531401,-179257,true,16419375365,22,16856911441,437536076
1635531451,-179256,true,16421017302,22,16858597132,437579830
1635531490,-179244,true,16440733364,22,16858597132,417863768
1635531542,-179241,true,16445666078,22,16853540565,407874487
1635531549,-179236,true,16453890555,22,16851855379,397964824
1635531759,-179234,true,16457181498,22,16823232992,366051494
1635531778,-179225,true,16471998887,22,16819868850,347869963
1635531824,-179223,true,16475293452,22,16814823898,339530446
1635531919,-179218,true,16483532746,22,16804738534,321205788
1635532021,-179215,true,16488478301,22,16818187031,329708730
1635532048,-179208,true,16500023699,22,16821550837,321527138
1635532107,-179205,true,16504974201,22,16828280467,323306266
1635532121,-179199,true,16514879661,22,16828280467,313400806
1635532163,-179197,true,16518182802,22,16828280467,310097665
1635532204,-179193,true,16524791067,22,16819868850,295077783
1635532227,-179192,true,16526443546,22,16819868850,293425304
1635532235,-179187,true,16534708420,22,16818187031,283478611
1635532273,-179186,true,16536361891,22,16814823898,278462007
1635532301,-179181,true,16544631726,22,16816505381,271873655
1635532363,-179177,true,16551250571,22,16823232992,271982421
1635532433,-179171,true,16561183805,22,16836696290,275512485
1635532562,-179169,true,16564496207,22,16868714820,304218613
1635532614,-179162,true,16576094834,22,16878838579,302743745
1635532738,-179158,true,16582726266,22,16899104329,316378063
1635532757,-179153,true,16591019288,22,16900794240,309774952
1635532777,-179151,true,16594337658,22,16902484319,308146661
1635532801,-179145,true,16604296750,22,16900794240,296497490
1635532810,-179142,true,16609278537,22,16900794240,291515703
1635532859,-179136,true,16619246596,22,16890657312,271410716
1635533025,-179133,true,16624232868,22,16870401691,246168823
1635533032,-179131,true,16627557881,22,16870401691,242843810
1635533131,-179127,true,16634209902,22,16888968415,254758513
1635533199,-179120,true,16645857343,22,16900794240,254936897
1635533291,-179118,true,16649186680,22,16892346377,243159697
1635533310,-179115,true,16654181936,22,16890657312,236475376
1635533374,-179113,true,16657512939,22,16880526463,223013524
1635533385,-179106,true,16669176697,22,16878838579,209661882
1635533398,-179104,true,16672510699,22,16877150864,204640165
1635533463,-179100,true,16679180703,22,16875463318,196282615
1635533556,-179098,true,16682516706,22,16880526463,198009757
1635533692,-179092,true,16692528719,22,16895725015,203196296
1635533768,-179091,true,16694197972,22,16910937252,216739280
1635534041,-179086,true,16702546740,22,16936321422,233774682
1635534044,-179083,true,16707558006,22,16936321422,228763416
1635534087,-179078,true,16715913456,22,16934627959,218714503
1635534127,-179074,true,16722600824,22,16949875222,227274398
1635534168,-179065,true,16737657186,22,16966832727,229175541
1635534194,-179063,true,16741004885,22,16977015372,236010487
1635534268,-179055,true,16754402377,22,17012702778,258300401
1635534277,-179052,true,16759429201,22,17019508880,260079679
1635534367,-179043,true,16774518722,22,17056991141,282472419
1635534371,-179040,true,16779551581,22,17056991141,277439560
1635534376,-179031,true,16794659219,22,17058696840,264037621
1635534410,-179027,true,16801378091,22,17068934618,267556527
1635534448,-179017,true,16818187031,22,17080886457,262699426
1635534453,-179013,true,16824915315,22,17082594546,257679231
1635534477,-179003,true,16841747804,22,17092846665,251098861
1635534494,-178999,true,16848485514,22,17099684829,251199315
1635534522,-178987,true,16868714820,22,17111658200,242943380
1635534623,-178982,true,16877150864,22,17157919789,280768925
1635534683,-178972,true,16894035612,22,17188830311,294794699
1635534719,-178969,true,16899104329,22,17200866102,301761773
1635534846,-178960,true,16914319608,22,17245644302,331324694
1635534899,-178958,true,16917702641,22,17264623998,346921357
1635534970,-178950,true,16931241541,22,17290539070,359297529
1635535010,-178944,true,16941402826,22,17299186069,357783243
1635535030,-178937,true,16953265367,22,17300915987,347650620
1635535058,-178933,true,16960047690,22,17307837392,347789702
1635535214,-178924,true,16975317840,22,17339017994,363700154
1635535296,-178920,true,16982108986,22,17356364817,374255831
1635535315,-178914,true,16992300799,22,17352894065,360593266
1635535332,-178913,true,16994000029,22,17354629354,360629325
1635535427,-178905,true,17007599988,22,17359836263,352236275
1635535430,-178904,true,17009300748,22,17359836263,350535515
1635535478,-178898,true,17019508880,22,17359836263,340327383
1635535519,-178897,true,17021210831,22,17361572247,340361416
1635535591,-178890,true,17033129254,22,17359836263,326707009
1635535796,-178887,true,17038239704,22,17385894254,347654550
1635535830,-178882,true,17046760528,22,17391110543,344350015
1635536032,-178881,true,17048465204,22,17406768805,358303601
1635536070,-178874,true,17060402710,22,17403287974,342885264
1635536101,-178873,true,17062108750,22,17399807838,337699088
1635536206,-178868,true,17070641511,22,17391110543,320469032
1635536252,-178867,true,17072348575,22,17399807838,327459263
1635536366,-178860,true,17084302805,22,17406768805,322466000
1635536405,-178858,true,17087719836,22,17408509482,320789646
1635536445,-178853,true,17096265405,22,17410250333,313984928
1635536607,-178851,true,17099684829,22,17417215478,317530649
1635536654,-178844,true,17111658200,22,17411991358,300333158
1635536669,-178843,true,17113369366,22,17411991358,298621992
1635536760,-178839,true,17120215741,22,17389371606,269155865
1635536781,-178839,true,17120215741,22,17384155838,263940097
1635536811,-178835,true,17127064854,22,17361572247,234507393
1635536812,-178833,true,17130490438,22,17361572247,231081809
1635536841,-178836,true,17125352319,22,17337284266,211931947
1635536848,-178839,true,17120215741,22,17330351085,210135344
1635536863,-178836,true,17125352319,22,17318224691,192872372
1635536910,-178832,true,17132203488,22,17300915987,168712499
1635537270,-178830,true,17135630100,22,17188830311,53200211
1635537378,-178834,true,17128777561,22,17149343403,20565842
1635537422,-178833,true,17130490438,22,17132203488,1713050
1635537440,-178828,true,17139057397,22,17125352319,-13705078
1635537462,-178824,true,17145914048,22,17116792211,-29121837
1635537560,-178826,true,17142485380,22,17082594546,-59890834
1635537568,-178825,true,17144199628,22,17080886457,-63313171
1635537707,-178818,true,17156204169,22,17074055810,-82148359
1635537738,-178816,true,17159635581,22,17087719836,-71915745
1635537740,-178821,true,17151058337,22,17089428608,-61629729
1635537861,-178821,true,17151058337,22,17084302805,-66755532
1635537873,-178816,true,17159635581,22,17082594546,-77041035
1635537970,-178815,true,17161351545,22,17068934618,-92416927
1635538017,-178819,true,17154488720,22,17062108750,-92379970
1635538056,-178819,true,17154488720,22,17055285613,-99203107
1635538085,-178814,true,17163067680,22,17050170050,-112897630
1635538116,-178812,true,17166500465,22,17046760528,-119739937
1635538225,-178814,true,17163067680,22,17036536050,-126531630
1635538310,-178811,true,17168217115,22,17041647522,-126569593
1635538342,-178807,true,17175085432,22,17045056022,-130029410
1635538485,-178805,true,17178520621,22,17051875067,-126645554
1635538495,-178807,true,17175085432,22,17053580255,-121505177
1635538545,-178805,true,17178520621,22,17055285613,-123235008
1635538555,-178802,true,17183674693,22,17055285613,-128389080
1635538611,-178800,true,17187111599,22,17053580255,-133531344
1635538713,-178801,true,17185393060,22,17058696840,-126696220
1635538772,-178799,true,17188830311,22,17067227895,-121602416
1635538849,-178795,true,17195706874,22,17070641511,-125065363
1635538871,-178794,true,17197426445,22,17070641511,-126784934
1635538926,-178798,true,17190549194,22,17075763216,-114785978
1635538937,-178797,true,17192268249,22,17077470792,-114797457
1635538986,-178792,true,17200866102,22,17084302805,-116563297
1635539452,-178791,true,17202586189,22,17082594546,-119991643
1635539554,-178795,true,17195706874,22,17072348575,-123358299
1635539574,-178794,true,17197426445,22,17070641511,-126784934
1635539660,-178790,true,17204306447,22,17063814961,-140491486
1635539760,-178795,true,17195706874,22,17056991141,-138715733
1635539807,-178799,true,17188830311,22,17055285613,-133544698
1635539855,-178799,true,17188830311,22,17060402710,-128427601
1635540016,-178794,true,17197426445,22,17080886457,-116539988
1635540040,-178797,true,17192268249,22,17082594546,-109673703
1635540076,-178801,true,17185393060,22,17087719836,-97673224
1635540140,-178802,true,17183674693,22,17096265405,-87409288
1635540146,-178796,true,17193987475,22,17094555950,-99431525
1635540290,-178799,true,17188830311,22,17096265405,-92564906
1635540441,-178804,true,17180238473,22,17111658200,-68580273
1635540473,-178806,true,17176802941,22,17116792211,-60010730
1635540525,-178800,true,17187111599,22,17123639955,-63471644
1635540572,-178805,true,17178520621,22,17130490438,-48030183
1635540634,-178809,true,17171650930,22,17142485380,-29165550
1635540700,-178812,true,17166500465,22,17154488720,-12011745
1635540768,-178806,true,17176802941,22,17151058337,-25744604
1635540770,-178810,true,17169933937,22,17151058337,-18875600
1635540897,-178813,true,17164783987,22,17145914048,-18869939
1635540934,-178815,true,17161351545,22,17145914048,-15437497
1635540942,-178809,true,17171650930,22,17145914048,-25736882
1635540995,-178814,true,17163067680,22,17139057397,-24010283
1635541013,-178818,true,17156204169,22,17137343663,-18860506
1635541206,-178823,true,17147628640,22,17139057397,-8571243
1635541474,-178817,true,17157919789,22,17139057397,-18862392
1635541530,-178821,true,17151058337,22,17137343663,-13714674
1635541564,-178826,true,17142485380,22,17128777561,-13707819
1635541608,-178830,true,17135630100,22,17116792211,-18837889
1635541709,-178827,true,17140771303,22,17089428608,-51342695
1635541758,-178833,true,17130490438,22,17077470792,-53019646
1635541957,-178838,true,17121927762,22,17034832567,-87095195
1635541992,-178842,true,17115080703,22,17026317705,-88762998
1635542272,-178839,true,17120215741,22,16965136213,-155079528
1635542393,-178846,true,17108236382,22,16934627959,-173608423
1635542415,-178851,true,17099684829,22,16931241541,-168443288
1635542620,-178855,true,17092846665,22,16949875222,-142971443
1635542656,-178851,true,17099684829,22,16951570210,-148114619
1635542677,-178856,true,17091137551,22,16954960693,-136176858
1635542682,-178861,true,17082594546,22,16954960693,-127633853
1635542784,-178862,true,17080886457,22,16977015372,-103871085
1635542833,-178858,true,17087719836,22,16987204128,-100515708
1635542856,-178864,true,17077470792,22,16992300799,-85169993
1635542883,-178868,true,17070641511,22,16997398999,-73242512
1635542918,-178870,true,17067227895,22,17004198978,-63028917
1635542937,-178866,true,17074055810,22,17007599988,-66455822
1635543053,-178869,true,17068934618,22,17045056022,-23878596
1635543193,-178870,true,17067227895,22,17087719836,20491941
1635543325,-178868,true,17070641511,22,17128777561,58136050
1635543392,-178865,true,17075763216,22,17115080703,39317487
1635543425,-178862,true,17080886457,22,17111658200,30771743
1635543573,-178861,true,17082594546,22,17120215741,37621195
1635543659,-178861,true,17082594546,22,17111658200,29063654
1635543689,-178861,true,17082594546,22,17109947206,27352660
1635543735,-178864,true,17077470792,22,17087719836,10249044
1635543806,-178867,true,17072348575,22,17055285613,-17062962
1635543867,-178870,true,17067227895,22,17024615244,-42612651
1635543874,-178871,true,17065521343,22,17021210831,-44310512
1635543890,-178874,true,17060402710,22,17014404049,-45998661
1635543976,-178875,true,17058696840,22,16975317840,-83379000
1635543983,-178878,true,17053580255,22,16970226263,-83353992
1635544079,-178883,true,17045056022,22,16899104329,-145951693
1635544098,-178886,true,17039943528,22,16883902737,-156040791
1635544116,-178890,true,17033129254,22,16872088731,-161040523
1635544211,-178892,true,17029723139,22,16799698121,-230025018
1635544257,-178896,true,17022912952,22,16777873793,-245039159
1635544283,-178899,true,17017807100,22,16767810591,-249996509
1635544364,-178903,true,17011001678,22,16727618106,-283383572
1635544373,-178904,true,17009300748,22,16722600824,-286699924
1635544397,-178909,true,17000798649,22,16707558006,-293240643
1635544440,-178912,true,16995699429,22,16677512952,-318186477
1635544486,-178915,true,16990601739,22,16659178690,-331423049
1635544589,-178916,true,16988902848,22,16615923245,-372979603
1635544605,-178921,true,16980410945,22,16615923245,-364487700
1635544670,-178923,true,16977015372,22,16614261819,-362753553
1635544705,-178927,true,16970226263,22,16614261819,-355964444
1635544781,-178929,true,16966832727,22,16605957179,-360875548
1635544976,-178932,true,16961743695,22,16617584837,-344158858
1635545002,-178934,true,16958351855,22,16619246596,-339105259
1635545137,-178940,true,16948180404,22,16614261819,-333918585
1635545238,-178941,true,16946485756,22,16630883559,-315602197
1635545353,-178945,true,16939708856,22,16655847354,-283861502
1635545399,-178946,true,16938015054,22,16655847354,-282167700
1635545412,-178950,true,16931241541,22,16655847354,-275394187
1635545441,-178950,true,16931241541,22,16655847354,-275394187
1635545485,-178955,true,16922778460,22,16655847354,-266931106
1635545503,-178957,true,16919394412,22,16655847354,-263547058
1635545588,-178961,true,16912628346,22,16647521928,-265106418
1635545745,-178962,true,16910937252,22,16640864584,-270072668
1635545753,-178966,true,16904174568,22,16640864584,-263309984
1635545796,-178967,true,16902484319,22,16637536910,-264947409
1635545925,-178971,true,16895725015,22,16634209902,-261515113
1635546001,-178973,true,16892346377,22,16647521928,-244824449
1635546030,-178979,true,16882214516,22,16652516684,-229697832
1635546130,-178981,true,16878838579,22,16645857343,-232981236
1635546247,-178987,true,16868714820,22,16634209902,-234504918
1635546257,-178989,true,16865341583,22,16632546647,-232794936
1635546311,-178996,true,16853540565,22,16625895291,-227645274
1635546329,-178997,true,16851855379,22,16624232868,-227622511
1635546336,-179002,true,16843431979,22,16622570611,-220861368
1635546353,-179003,true,16841747804,22,16620908520,-220839284
1635546502,-179010,true,16829963295,22,16612600559,-217362736
1635546566,-179011,true,16828280467,22,16607617775,-220662692
1635546584,-179017,true,16818187031,22,16605957179,-212229852
1635546671,-179019,true,16814823898,22,16591019288,-223804610
1635546689,-179027,true,16801378091,22,16589360352,-212017739
1635546699,-179028,true,16799698121,22,16587701582,-211996539
1635546769,-179034,true,16789621829,22,16579410218,-210211611
1635546913,-179036,true,16786264408,22,16569466053,-216798355
1635546918,-179043,true,16774518722,22,16569466053,-205052669
1635546980,-179045,true,16771164321,22,16564496207,-206668114
1635547075,-179050,true,16762781254,22,16557872065,-204909189
1635547096,-179052,true,16759429201,22,16554560987,-204868214
1635547192,-179059,true,16747702292,22,16552905696,-194796596
1635547267,-179059,true,16747702292,22,16571123000,-176579292
1635547453,-179064,true,16739330952,22,16562839923,-176491029
1635547489,-179065,true,16737657186,22,16562839923,-174817263
1635547612,-179069,true,16730963797,22,16571123000,-159840797
1635547678,-179069,true,16730963797,22,16572780112,-158183685
1635547685,-179075,true,16720928731,22,16572780112,-148148619
1635547722,-179075,true,16720928731,22,16574437390,-146491341
1635547781,-179077,true,16717585047,22,16589360352,-128224695
1635547837,-179074,true,16722600824,22,16602636486,-119964338
1635547850,-179080,true,16712570774,22,16605957179,-106613595
1635548058,-179081,true,16710899684,22,16644192923,-66706761
1635548198,-179084,true,16705887417,22,16647521928,-58365489
1635548231,-179082,true,16709228761,22,16652516684,-56712077
1635548290,-179087,true,16700876653,22,16677512952,-23363701
1635548338,-179089,true,16697536978,22,16697536978,0
1635548420,-179091,true,16694197972,22,16722600824,28402852
1635548426,-179089,true,16697536978,22,16724273084,26736106
1635548516,-179095,true,16687521962,22,16746027689,58505727
1635548701,-179098,true,16682516706,22,16772841438,90324732
1635548718,-179100,true,16679180703,22,16772841438,93660735
1635548732,-179099,true,16680848621,22,16772841438,91992817
1635548842,-179106,true,16669176697,22,16777873793,108697096
1635548926,-179110,true,16662510693,22,16782907659,120396966
1635549110,-179110,true,16662510693,22,16798018319,135507626
1635549271,-179108,true,16665843361,22,16782907659,117064298
1635549303,-179114,true,16655847354,22,16781229536,125382182
1635549308,-179115,true,16654181936,22,16781229536,127047600
1635549437,-179116,true,16652516684,22,16794659219,142142535
1635549580,-179112,true,16659178690,22,16811461438,152282748
1635549744,-179113,true,16657512939,22,16840063797,182550858
1635549751,-179112,true,16659178690,22,16841747804,182569114
1635549802,-179111,true,16660844608,22,16846800833,185956225
1635549816,-179107,true,16667509946,22,16850170362,182660416
1635549885,-179111,true,16660844608,22,16855225919,194381311
1635549976,-179110,true,16662510693,22,16860282992,197772299
1635550003,-179106,true,16669176697,22,16863655217,194478520
1635550093,-179101,true,16677512952,22,16872088731,194575779
1635550152,-179102,true,16675845368,22,16878838579,202993211
1635550232,-179100,true,16679180703,22,16885591128,206410425
1635550320,-179096,true,16685853376,22,16883902737,198049361
1635550392,-179091,true,16694197972,22,16887279687,193081715
1635550556,-179091,true,16694197972,22,16894035612,199837640
1635550855,-179089,true,16697536978,22,16902484319,204947341
1635550928,-179085,true,16704216995,22,16904174568,199957573
1635550940,-179079,true,16714242031,22,16904174568,189932537
1635551140,-179081,true,16710899684,22,16929548587,218648903
1635551183,-179080,true,16712570774,22,16936321422,223750648
1635551221,-179075,true,16720928731,22,16941402826,220474095
1635551281,-179072,true,16725945511,22,16932934666,206989155
1635551323,-179074,true,16722600824,22,16931241541,208640717
1635551383,-179074,true,16722600824,22,16924470738,201869914
1635551439,-179071,true,16727618106,22,16919394412,191776306
1635551470,-179067,true,16734310157,22,16916011040,181700883
1635551522,-179068,true,16732636893,22,16914319608,181682715
1635551613,-179068,true,16732636893,22,16910937252,178300359
1635551673,-179064,true,16739330952,22,16909246327,169915375
1635551734,-179060,true,16746027689,22,16910937252,164909563
1635551790,-179062,true,16742678986,22,16912628346,169949360
1635551862,-179063,true,16741004885,22,16900794240,159789355
1635551898,-179059,true,16747702292,22,16892346377,144644085
1635551931,-179056,true,16752727105,22,16885591128,132864023
1635551972,-179059,true,16747702292,22,16875463318,127761026
1635551984,-179059,true,16747702292,22,16872088731,124386439
1635551992,-179055,true,16754402377,22,16870401691,115999314
1635552124,-179051,true,16761105144,22,16843431979,82326835
1635552199,-179053,true,16757753425,22,16850170362,92416937
1635552244,-179053,true,16757753425,22,16848485514,90732089
1635552264,-179049,true,16764457532,22,16850170362,85712830
1635552294,-179044,true,16772841438,22,16851855379,79013941
1635552336,-179046,true,16769487372,22,16853540565,84053193
1635552365,-179045,true,16771164321,22,16855225919,84061598
1635552404,-179041,true,16777873793,22,16855225919,77352126
1635552414,-179036,true,16786264408,22,16855225919,68961511
1635552512,-179037,true,16784585950,22,16860282992,75697042
1635552583,-179037,true,16784585950,22,16863655217,79069267
1635552629,-179032,true,16792979921,22,16863655217,70675296
1635552633,-179027,true,16801378091,22,16861969020,60590929
1635552792,-179030,true,16796338685,22,16853540565,57201880
1635552810,-179030,true,16796338685,22,16853540565,57201880
1635552817,-179025,true,16804738534,22,16853540565,48802031
1635552823,-179019,true,16814823898,22,16855225919,40402021
1635552921,-179025,true,16804738534,22,16840063797,35325263
1635552941,-179026,true,16803058228,22,16838379959,35321731
1635552992,-179021,true,16811461438,22,16836696290,25234852
1635553008,-179015,true,16821550837,22,16833329456,11778619
1635553025,-179020,true,16813142584,22,16829963295,16820711
1635553060,-179021,true,16811461438,22,16821550837,10089399
1635553071,-179018,true,16816505381,22,16818187031,1681650
1635553096,-179014,true,16823232992,22,16811461438,-11771554
1635553250,-179019,true,16814823898,22,16769487372,-45336526
1635553276,-179020,true,16813142584,22,16756077818,-57064766
1635553409,-179017,true,16818187031,22,16710899684,-107287347
1635553411,-179013,true,16824915315,22,16710899684,-114015631
1635553614,-179022,true,16809780460,22,16592678390,-217102070
1635553616,-179024,true,16806419008,22,16591019288,-215399720
1635553625,-179025,true,16804738534,22,16589360352,-215378182
1635553819,-179019,true,16814823898,22,16567809272,-247014626
1635553890,-179026,true,16803058228,22,16542977428,-260080800
1635553918,-179028,true,16799698121,22,16534708420,-264989701
1635554059,-179029,true,16798018319,22,16526443546,-271574773
1635554153,-179024,true,16806419008,22,16521486604,-284932404
1635554671,-179032,true,16792979921,22,16538015527,-254964394
1635554861,-179035,true,16787943035,22,16538015527,-249927508
1635554911,-179038,true,16782907659,22,16534708420,-248199239
1635554922,-179034,true,16789621829,22,16531401975,-258219854
1635555008,-179040,true,16779551581,22,16533055115,-246496466
1635555017,-179041,true,16777873793,22,16533055115,-244818678
1635555047,-179044,true,16772841438,22,16534708420,-238133018
1635555092,-179039,true,16781229536,22,16538015527,-243214009
1635555116,-179044,true,16772841438,22,16539669329,-233172109
1635555141,-179046,true,16769487372,22,16541323296,-228164076
1635555303,-179049,true,16764457532,22,16547940818,-216516714
1635555416,-179044,true,16772841438,22,16561183805,-211657633
1635555427,-179049,true,16764457532,22,16561183805,-203273727
1635555451,-179051,true,16761105144,22,16562839923,-198265221
1635555587,-179055,true,16754402377,22,16572780112,-181622265
1635555600,-179051,true,16761105144,22,16576094834,-185010310
1635555688,-179057,true,16751051999,22,16595997091,-155054908
1635555928,-179060,true,16746027689,22,16592678390,-153349299
1635556078,-179064,true,16739330952,22,16584384539,-154946413
1635556116,-179060,true,16746027689,22,16581068159,-164959530
1635556127,-179065,true,16737657186,22,16581068159,-156589027
1635556163,-179069,true,16730963797,22,16576094834,-154868963
1635556189,-179074,true,16722600824,22,16572780112,-149820712
1635556257,-179072,true,16725945511,22,16559527852,-166417659
1635556386,-179075,true,16720928731,22,16554560987,-166367744
1635556457,-179078,true,16715913456,22,16552905696,-163007760
1635556505,-179083,true,16707558006,22,16547940818,-159617188
1635556575,-179080,true,16712570774,22,16539669329,-172901445
1635556639,-179084,true,16705887417,22,16542977428,-162909989
1635556656,-179086,true,16702546740,22,16546286189,-156260551
1635556691,-179091,true,16694197972,22,16552905696,-141292276
1635556756,-179087,true,16700876653,22,16561183805,-139692848
1635556860,-179091,true,16694197972,22,16576094834,-118103138
1635556936,-179094,true,16689190714,22,16589360352,-99830362
1635556977,-179099,true,16680848621,22,16597656691,-83191930
1635556987,-179095,true,16687521962,22,16599316457,-88205505
1635557091,-179096,true,16685853376,22,16637536910,-48316466
1635557104,-179097,true,16684184958,22,16644192923,-39992035
1635557166,-179100,true,16679180703,22,16672510699,-6670004
1635557197,-179095,true,16687521962,22,16682516706,-5005256
1635557353,-179095,true,16687521962,22,16737657186,50135224
1635557470,-179096,true,16685853376,22,16781229536,95376160
1635557506,-179099,true,16680848621,22,16794659219,113810598
1635557544,-179095,true,16687521962,22,16804738534,117216572
1635557693,-179095,true,16687521962,22,16838379959,150857997
1635557708,-179096,true,16685853376,22,16841747804,155894428
1635557719,-179098,true,16682516706,22,16843431979,160915273
1635557804,-179093,true,16690859633,22,16863655217,172795584
1635557894,-179090,true,16695867392,22,16897414588,201547196
1635557958,-179090,true,16695867392,22,16912628346,216760954
1635558012,-179093,true,16690859633,22,16921086351,230226718
1635558045,-179088,true,16699206732,22,16919394412,220187680
1635558086,-179088,true,16699206732,22,16917702641,218495909
1635558113,-179089,true,16697536978,22,16917702641,220165663
1635558180,-179093,true,16690859633,22,16916011040,225151407
1635558241,-179089,true,16697536978,22,16914319608,216782630
1635558289,-179088,true,16699206732,22,16910937252,211730520
1635558324,-179090,true,16695867392,22,16909246327,213378935
1635558382,-179093,true,16690859633,22,16910937252,220077619
1635558397,-179088,true,16699206732,22,16910937252,211730520
1635558432,-179088,true,16699206732,22,16905864985,206658253
1635558489,-179091,true,16694197972,22,16900794240,206596268
1635558490,-179096,true,16685853376,22,16900794240,214940864
1635558559,-179092,true,16692528719,22,16894035612,201506893
1635558586,-179089,true,16697536978,22,16892346377,194809399
1635558662,-179092,true,16692528719,22,16883902737,191374018
1635558783,-179096,true,16685853376,22,16856911441,171058065
1635558827,-179091,true,16694197972,22,16856911441,162713469
1635558911,-179085,true,16704216995,22,16860282992,156065997
1635558968,-179086,true,16702546740,22,16870401691,167854951
1635559046,-179088,true,16699206732,22,16885591128,186384396
1635559088,-179082,true,16709228761,22,16895725015,186496254
1635559150,-179077,true,16717585047,22,16907555572,189970525
1635559166,-179077,true,16717585047,22,16910937252,193352205
1635559178,-179078,true,16715913456,22,16910937252,195023796
1635559196,-179072,true,16725945511,22,16912628346,186682835
1635559240,-179068,true,16732636893,22,16914319608,181682715
1635559329,-179068,true,16732636893,22,16921086351,188449458
1635559347,-179068,true,16732636893,22,16929548587,196911694
1635559370,-179061,true,16744353253,22,16939708856,195355603
1635559546,-179050,true,16762781254,22,17012702778,249921524
1635559654,-179049,true,16764457532,22,17045056022,280598490
1635559680,-179047,true,16767810591,22,17053580255,285769664
1635559690,-179044,true,16772841438,22,17055285613,282444175
1635559784,-179036,true,16786264408,22,17067227895,280963487
1635559880,-179034,true,16789621829,22,17075763216,286141387
1635559911,-179032,true,16792979921,22,17077470792,284490871
1635559928,-179029,true,16798018319,22,17077470792,279452473
1635560014,-179022,true,16809780460,22,17079178539,269398079
1635560077,-179020,true,16813142584,22,17082594546,269451962
1635560114,-179018,true,16816505381,22,17086011235,269505854
1635560183,-179014,true,16823232992,22,17091137551,267904559
1635560212,-179009,true,16831646291,22,17087719836,256073545
1635560367,-179006,true,16836696290,22,17082594546,245898256
1635560433,-179005,true,16838379959,22,17074055810,235675851
1635560547,-179002,true,16843431979,22,17074055810,230623831
1635560697,-178996,true,16853540565,22,17063814961,210274396
1635560772,-178994,true,16856911441,22,17058696840,201785399
1635560857,-178992,true,16860282992,22,17055285613,195002621
1635560874,-178990,true,16863655217,22,17053580255,189925038
1635560972,-178984,true,16873775940,22,17046760528,172984588
1635561010,-178983,true,16875463318,22,17043351687,167888369
1635561118,-178982,true,16877150864,22,17045056022,167905158
1635561165,-178979,true,16882214516,22,17036536050,154321534
1635561338,-178974,true,16890657312,22,17028020337,137363025
1635561408,-178971,true,16895725015,22,17028020337,132295322
1635561514,-178970,true,16897414588,22,17016105489,118690901
1635561523,-178967,true,16902484319,22,17016105489,113621170
1635561731,-178962,true,16910937252,22,16995699429,84762177
1635561797,-178960,true,16914319608,22,16983807197,69487589
1635561857,-178958,true,16917702641,22,16975317840,57615199
1635561946,-178954,true,16924470738,22,16963439869,38969131
1635561954,-178952,true,16927855801,22,16963439869,35584068
1635561964,-178950,true,16931241541,22,16961743695,30502154
1635561981,-178948,true,16934627959,22,16960047690,25419731
1635562013,-178945,true,16939708856,22,16960047690,20338834
1635562042,-178942,true,16944791276,22,16961743695,16952419
1635562073,-178940,true,16948180404,22,16961743695,13563291
1635562142,-178939,true,16949875222,22,16954960693,5085471
1635562219,-178936,true,16954960693,22,16946485756,-8474937
1635562263,-178935,true,16956656189,22,16944791276,-11864913
1635562323,-178933,true,16960047690,22,16936321422,-23726268
1635562330,-178932,true,16961743695,22,16936321422,-25422273
1635562358,-178930,true,16965136213,22,16929548587,-35587626
1635562383,-178932,true,16961743695,22,16924470738,-37272957
1635562418,-178933,true,16960047690,22,16917702641,-42345049
1635562430,-178933,true,16960047690,22,16917702641,-42345049
1635562452,-178929,true,16966832727,22,16919394412,-47438315
1635562498,-178930,true,16965136213,22,16919394412,-45741801
1635562518,-178930,true,16965136213,22,16921086351,-44049862
1635562689,-178930,true,16965136213,22,16934627959,-30508254
1635562763,-178928,true,16968529410,22,16936321422,-32207988
1635562771,-178929,true,16966832727,22,16936321422,-30511305
1635562811,-178929,true,16966832727,22,16934627959,-32204768
1635562821,-178930,true,16965136213,22,16934627959,-30508254
1635562890,-178929,true,16966832727,22,16929548587,-37284140
1635562980,-178929,true,16966832727,22,16938015054,-28817673
1635563031,-178929,true,16966832727,22,16943096967,-23735760
1635563083,-178931,true,16963439869,22,16938015054,-25424815
1635563100,-178929,true,16966832727,22,16936321422,-30511305
1635563108,-178929,true,16966832727,22,16934627959,-32204768
1635563142,-178930,true,16965136213,22,16927855801,-37280412
1635563179,-178928,true,16968529410,22,16938015054,-30514356
1635563196,-178924,true,16975317840,22,16944791276,-30526564
1635563334,-178924,true,16975317840,22,16982108986,6791146
1635563376,-178923,true,16977015372,22,16992300799,15285427
1635563415,-178921,true,16980410945,22,17000798649,20387704
1635563463,-178918,true,16985505577,22,17009300748,23795171
1635563466,-178916,true,16988902848,22,17009300748,20397900
1635563479,-178916,true,16988902848,22,17005899398,16996550
1635563630,-178913,true,16994000029,22,17036536050,42536021
1635563649,-178909,true,17000798649,22,17039943528,39144879
1635563981,-178903,true,17011001678,22,17199146187,188144509
1635564250,-178902,true,17012702778,22,17297456323,284753545
1635564350,-178897,true,17021210831,22,17319956513,298745682
1635564375,-178895,true,17024615244,22,17330351085,305735841
1635564458,-178890,true,17033129254,22,17354629354,321500100
1635564510,-178890,true,17033129254,22,17370254769,337125515
1635564565,-178887,true,17038239704,22,17384155838,345916134
1635564667,-178885,true,17041647522,22,17382417596,340770074
1635564740,-178881,true,17048465204,22,17382417596,333952392
1635564760,-178881,true,17048465204,22,17382417596,333952392
1635564796,-178879,true,17051875067,22,17382417596,330542529
1635564833,-178876,true,17056991141,22,17384155838,327164697
1635564882,-178869,true,17068934618,22,17385894254,316959636
1635565029,-178868,true,17070641511,22,17394588939,323947428
1635565040,-178867,true,17072348575,22,17394588939,322240364
1635565092,-178863,true,17079178539,22,17415473930,336295391
1635565112,-178858,true,17087719836,22,17418957199,331237363
1635565168,-178854,true,17094555950,22,17439871448,345315498
1635565185,-178852,true,17097975032,22,17446848443,348873411
1635565241,-178848,true,17104815248,22,17467796180,362980932
1635565328,-178842,true,17115080703,22,17497515202,382434499
1635565443,-178839,true,17120215741,22,17532543497,412327756
1635565450,-178836,true,17125352319,22,17534296752,408944433
1635565481,-178833,true,17130490438,22,17543065654,412575216
1635565599,-178826,true,17142485380,22,17590493559,448008179
1635565818,-178822,true,17149343403,22,17664525288,515181885
1635565832,-178820,true,17152773443,22,17666291740,513518297
1635565887,-178816,true,17159635581,22,17676894166,517258585
1635565993,-178810,true,17169933937,22,17657461244,487527307
1635566062,-178811,true,17168217115,22,17639813490,471596375
1635566260,-178808,true,17173368095,22,17602810599,429442504
1635566292,-178805,true,17178520621,22,17595771234,417250613
1635566338,-178799,true,17188830311,22,17586975988,398145677
1635566346,-178799,true,17188830311,22,17585217466,396387155
1635566420,-178796,true,17193987475,22,17569398680,375411205
1635566476,-178793,true,17199146187,22,17553594125,354447938
1635566498,-178787,true,17209468255,22,17548329100,338860845
1635566531,-178786,true,17211189202,22,17541311523,330122321
1635566578,-178783,true,17216353075,22,17532543497,316190422
1635566648,-178779,true,17223240650,22,17520275625,297034975
1635566659,-178773,true,17233577178,22,17518523772,284946594
1635566691,-178773,true,17233577178,22,17509767138,276189960
1635566721,-178770,true,17238747768,22,17501014880,262267112
1635566759,-178769,true,17240471643,22,17487020366,246548723
1635566839,-178764,true,17249093603,22,17460810808,211717205
1635566867,-178765,true,17247368866,22,17453828230,206459364
1635566907,-178762,true,17252543594,22,17445103933,192560339
1635566995,-178761,true,17254268848,22,17422441165,168172317
1635567076,-178755,true,17264623998,22,17398068031,133444033
1635567132,-178755,true,17264623998,22,17382417596,117793598
1635567161,-178752,true,17269803903,22,17371991795,102187892
1635567222,-178753,true,17268077096,22,17354629354,86552258
1635567489,-178747,true,17278440532,22,17273258037,-5182495
1635567509,-178748,true,17276712861,22,17264623998,-12088863
1635567521,-178746,true,17280168377,22,17261171591,-18996786
1635567555,-178746,true,17280168377,22,17254268848,-25899529
1635567591,-178738,true,17293997351,22,17250818512,-43178839
1635567624,-178737,true,17295726750,22,17247368866,-48357884
1635567700,-178735,true,17299186069,22,17261171591,-38014478
1635567784,-178734,true,17300915987,22,17271530884,-29385103
1635567806,-178725,true,17316493041,22,17271530884,-44962157
1635567861,-178723,true,17319956513,22,17274985363,-44971150
1635567966,-178722,true,17321688509,22,17274985363,-46703146
1635568000,-178723,true,17319956513,22,17274985363,-44971150
1635568005,-178716,true,17332084121,22,17274985363,-57098758
1635568126,-178716,true,17332084121,22,17276712861,-55371260
1635568186,-178715,true,17333817329,22,17278440532,-55376797
1635568254,-178717,true,17330351085,22,17266350461,-64000624
1635568730,-178706,true,17349424006,22,17318224691,-31199315
1635568770,-178705,true,17351158949,22,17321688509,-29470440
1635568813,-178702,true,17356364817,22,17325153020,-31211797
1635568847,-178702,true,17356364817,22,17328618224,-27746593
1635568869,-178695,true,17368517918,22,17330351085,-38166833
1635568906,-178696,true,17366781240,22,17335550711,-31230529
1635568946,-178691,true,17375466367,22,17340751896,-34714471
1635569120,-178692,true,17373728994,22,17371991795,-1737199
1635569179,-178684,true,17387632843,22,17380679528,-6953315
1635569203,-178681,true,17392849654,22,17378941634,-13908020
1635569238,-178681,true,17392849654,22,17375466367,-17383287
1635569260,-178684,true,17387632843,22,17377203914,-10428929
1635569277,-178676,true,17401547819,22,17378941634,-22606185
1635569312,-178674,true,17405028302,22,17380679528,-24348774
1635569313,-178672,true,17408509482,22,17380679528,-27829954
1635569406,-178679,true,17396328398,22,17365044735,-31283663
1635569420,-178673,true,17406768805,22,17359836263,-46932542
1635569575,-178672,true,17408509482,22,17319956513,-88552969
1635569584,-178670,true,17411991358,22,17319956513,-92034845
1635569601,-178677,true,17399807838,22,17321688509,-78119329
1635569670,-178673,true,17406768805,22,17326885535,-79883270
1635569890,-178668,true,17415473930,22,17354629354,-60844576
1635570012,-178668,true,17415473930,22,17368517918,-46956012
1635570015,-178674,true,17405028302,22,17368517918,-36510384
1635570046,-178671,true,17410250333,22,17371991795,-38258538
1635570070,-178666,true,17418957199,22,17375466367,-43490832
1635570078,-178666,true,17418957199,22,17377203914,-41753285
1635570130,-178676,true,17401547819,22,17368517918,-33029901
1635570225,-178674,true,17405028302,22,17344220220,-60808082
1635570371,-178671,true,17410250333,22,17342485971,-67764362
1635570425,-178671,true,17410250333,22,17344220220,-66030113
1635570498,-178681,true,17392849654,22,17339017994,-53831660
1635570587,-178679,true,17396328398,22,17321688509,-74639889
1635570650,-178676,true,17401547819,22,17307837392,-93710427
1635570691,-178676,true,17401547819,22,17297456323,-104091496
1635570727,-178687,true,17382417596,22,17288810189,-93607407
1635570744,-178686,true,17384155838,22,17283624583,-100531255
1635570779,-178688,true,17380679528,22,17271530884,-109148644
1635570955,-178690,true,17377203914,22,17204306447,-172897467
1635571211,-178701,true,17358100453,22,17180238473,-177861980
1635571325,-178701,true,17358100453,22,17171650930,-186449523
1635571371,-178702,true,17356364817,22,17168217115,-188147702
1635571471,-178705,true,17351158949,22,17156204169,-194954780
1635571514,-178715,true,17333817329,22,17149343403,-184473926
1635571560,-178716,true,17332084121,22,17142485380,-189598741
1635571579,-178717,true,17330351085,22,17140771303,-189579782
1635571619,-178719,true,17326885535,22,17137343663,-189541872
1635571765,-178730,true,17307837392,22,17137343663,-170493729
1635572014,-178727,true,17313030262,22,17149343403,-163686859
1635572022,-178725,true,17316493041,22,17149343403,-167149638
1635572233,-178728,true,17311299132,22,17159635581,-151663551
1635572411,-178738,true,17293997351,22,17159635581,-134361770
1635572465,-178737,true,17295726750,22,17159635581,-136091169
1635572477,-178735,true,17299186069,22,17161351545,-137834524
1635572508,-178737,true,17295726750,22,17164783987,-130942763
1635572542,-178746,true,17280168377,22,17166500465,-113667912
1635572564,-178744,true,17283624583,22,17168217115,-115407468
1635572584,-178742,true,17287081481,22,17168217115,-118864366
1635572592,-178745,true,17281896393,22,17168217115,-113679278
1635572635,-178756,true,17262897708,22,17164783987,-98113721
1635572670,-178755,true,17264623998,22,17161351545,-103272453
1635572733,-178753,true,17268077096,22,17161351545,-106725551
1635572764,-178755,true,17264623998,22,17156204169,-108419829
1635572996,-178765,true,17247368866,22,17113369366,-133999500
1635573031,-178761,true,17254268848,22,17115080703,-139188145
1635573147,-178760,true,17255994275,22,17065521343,-190472932
1635573190,-178762,true,17252543594,22,17055285613,-197257981
1635573298,-178773,true,17233577178,22,17031426111,-202151067
1635573464,-178770,true,17238747768,22,16985505577,-253242191
1635573550,-178769,true,17240471643,22,16968529410,-271942233
1635573563,-178771,true,17237024066,22,16965136213,-271887853
1635573581,-178782,true,17218074711,22,16961743695,-256331016
1635573624,-178779,true,17223240650,22,16946485756,-276754894
1635573760,-178780,true,17221518498,22,16909246327,-312272171
1635573922,-178783,true,17216353075,22,16856911441,-359441634
1635574021,-178794,true,17197426445,22,16858597132,-338829313
1635574057,-178793,true,17199146187,22,16856911441,-342234746
1635574094,-178795,true,17195706874,22,16851855379,-343851495
1635574205,-178798,true,17190549194,22,16829963295,-360585899
1635574311,-178808,true,17173368095,22,16821550837,-351817258
1635574328,-178807,true,17175085432,22,16819868850,-355216582
1635574367,-178808,true,17173368095,22,16816505381,-356862714
1635574406,-178809,true,17171650930,22,16813142584,-358508346
1635574430,-178819,true,17154488720,22,16809780460,-344708260
1635574484,-178819,true,17154488720,22,16801378091,-353110629
1635574542,-178821,true,17151058337,22,16794659219,-356399118
1635574614,-178822,true,17149343403,22,16798018319,-351325084
1635574636,-178830,true,17135630100,22,16804738534,-330891566
1635574712,-178830,true,17135630100,22,16833329456,-302300644
1635574828,-178831,true,17133916708,22,16853540565,-280376143
1635574893,-178832,true,17132203488,22,16858597132,-273606356
1635574933,-178842,true,17115080703,22,16861969020,-253111683
1635574957,-178842,true,17115080703,22,16863655217,-251425486
1635575003,-178844,true,17111658200,22,16868714820,-242943380
1635575037,-178845,true,17109947206,22,16873775940,-236171266
1635575084,-178854,true,17094555950,22,16880526463,-214029487
1635575090,-178855,true,17092846665,22,16880526463,-212320202
1635575345,-178856,true,17091137551,22,16900794240,-190343311
1635575643,-178856,true,17091137551,22,16910937252,-180200299
1635575998,-178866,true,17074055810,22,16924470738,-149585072
1635576088,-178867,true,17072348575,22,16926163185,-146185390
1635576280,-178868,true,17070641511,22,16939708856,-130932655
1635576286,-178870,true,17067227895,22,16939708856,-127519039
1635576390,-178875,true,17058696840,22,16941402826,-117294014
1635576573,-178875,true,17058696840,22,16944791276,-113905564
1635576633,-178875,true,17058696840,22,16946485756,-112211084
1635576662,-178877,true,17055285613,22,16948180404,-107105209
1635576666,-178882,true,17046760528,22,16948180404,-98580124
1635576703,-178884,true,17043351687,22,16951570210,-91781477
1635576742,-178888,true,17036536050,22,16951570210,-84965840
1635576847,-178890,true,17033129254,22,16954960693,-78168561
1635576874,-178895,true,17024615244,22,16956656189,-67959055
1635576885,-178897,true,17021210831,22,16956656189,-64554642
1635577103,-178901,true,17014404049,22,16966832727,-47571322
1635577156,-178902,true,17012702778,22,16970226263,-42476515
1635577198,-178904,true,17009300748,22,16966832727,-42468021
1635577266,-178904,true,17009300748,22,16966832727,-42468021
1635577407,-178907,true,17004198978,22,16965136213,-39062765
1635577424,-178909,true,17000798649,22,16965136213,-35662436
1635577779,-178911,true,16997398999,22,16956656189,-40742810
1635577931,-178913,true,16994000029,22,16902484319,-91515710
1635577991,-178918,true,16985505577,22,16882214516,-103291061
1635578171,-178921,true,16980410945,22,16829963295,-150447650
1635578243,-178926,true,16971923286,22,16811461438,-160461848
1635578375,-178928,true,16968529410,22,16777873793,-190655617
1635578488,-178932,true,16961743695,22,16749377062,-212366633
1635578502,-178933,true,16960047690,22,16746027689,-214020001
1635578620,-178938,true,16951570210,22,16722600824,-228969386
1635578629,-178938,true,16951570210,22,16720928731,-230641479
1635578691,-178942,true,16944791276,22,16710899684,-233891592
1635578710,-178943,true,16943096967,22,16712570774,-230526193
1635578757,-178948,true,16934627959,22,16712570774,-222057185
1635578796,-178948,true,16934627959,22,16720928731,-213699228
1635579072,-178950,true,16931241541,22,16774518722,-156722819
1635579551,-178953,true,16926163185,22,16764457532,-161705653
1635579674,-178959,true,16916011040,22,16761105144,-154905896
1635579789,-178959,true,16916011040,22,16741004885,-175006155
1635579826,-178962,true,16910937252,22,16734310157,-176627095
1635580051,-178965,true,16905864985,22,16710899684,-194965301
1635580209,-178971,true,16895725015,22,16707558006,-188167009
1635580239,-178971,true,16895725015,22,16709228761,-186496254
1635580355,-178973,true,16892346377,22,16741004885,-151341492
1635580432,-178974,true,16890657312,22,16759429201,-131228111
1635580651,-178978,true,16883902737,22,16813142584,-70760153
1635580843,-178979,true,16882214516,22,16856911441,-25303075
1635580872,-178981,true,16878838579,22,16861969020,-16869559
1635580908,-178982,true,16877150864,22,16868714820,-8436044
1635580979,-178984,true,16873775940,22,16883902737,10126797
1635581168,-178985,true,16872088731,22,16919394412,47305681
1635581177,-178987,true,16868714820,22,16919394412,50679592
1635581242,-178987,true,16868714820,22,16916011040,47296220
1635581283,-178988,true,16867028117,22,16914319608,47291491
1635581383,-178989,true,16865341583,22,16909246327,43904744
1635581445,-178988,true,16867028117,22,16907555572,40527455
1635581563,-178989,true,16865341583,22,16902484319,37142736
1635581580,-178989,true,16865341583,22,16902484319,37142736
1635581625,-178989,true,16865341583,22,16902484319,37142736
1635581668,-178989,true,16865341583,22,16905864985,40523402
1635581700,-178988,true,16867028117,22,16909246327,42218210
1635581802,-178987,true,16868714820,22,16917702641,48987821
1635581888,-178987,true,16868714820,22,16927855801,59140981
1635581933,-178984,true,16873775940,22,16931241541,57465601
1635581963,-178983,true,16875463318,22,16929548587,54085269
1635582023,-178983,true,16875463318,22,16926163185,50699867
1635582061,-178984,true,16873775940,22,16926163185,52387245
1635582110,-178981,true,16878838579,22,16926163185,47324606
1635582208,-178980,true,16880526463,22,16929548587,49022124
1635582275,-178980,true,16880526463,22,16944791276,64264813
1635582496,-178978,true,16883902737,22,16992300799,108398062
1635582536,-178975,true,16888968415,22,16999098739,110130324
1635582639,-178974,true,16890657312,22,17007599988,116942676
1635582665,-178973,true,16892346377,22,17011001678,118655301
1635582871,-178971,true,16895725015,22,17029723139,133998124
1635582945,-178968,true,16900794240,22,17051875067,151080827
1635582969,-178966,true,16904174568,22,17056991141,152816573
1635583082,-178964,true,16907555572,22,17104815248,197259676
1635583164,-178963,true,16909246327,22,17128777561,219531234
1635583181,-178959,true,16916011040,22,17132203488,216192448
1635583245,-178958,true,16917702641,22,17142485380,224782739
1635583293,-178956,true,16921086351,22,17144199628,223113277
1635583399,-178954,true,16924470738,22,17161351545,236880807
1635583620,-178950,true,16931241541,22,17206026878,274785337
1635583673,-178948,true,16934627959,22,17216353075,281725116
1635583729,-178947,true,16936321422,22,17228408139,292086717
1635583869,-178944,true,16941402826,22,17254268848,312866022
1635584049,-178941,true,16946485756,22,17245644302,299158546
1635584083,-178940,true,16948180404,22,17243919910,295739506
1635584181,-178938,true,16951570210,22,17249093603,297523393
1635584243,-178936,true,16954960693,22,17249093603,294132910
1635584461,-178934,true,16958351855,22,17218074711,259722856
1635584521,-178934,true,16958351855,22,17211189202,252837347
1635584681,-178934,true,16958351855,22,17188830311,230478456
1635584965,-178931,true,16963439869,22,17145914048,182474179
1635585026,-178929,true,16966832727,22,17135630100,168797373
1635585029,-178929,true,16966832727,22,17133916708,167083981
1635585188,-178930,true,16965136213,22,17106525729,141389516
1635585200,-178929,true,16966832727,22,17104815248,137982521
1635585308,-178928,true,16968529410,22,17092846665,124317255
1635585539,-178927,true,16970226263,22,17068934618,98708355
1635585585,-178928,true,16968529410,22,17062108750,93579340
1635585653,-178927,true,16970226263,22,17058696840,88470577
1635585792,-178926,true,16971923286,22,17062108750,90185464
1635585875,-178924,true,16975317840,22,17065521343,90203503
1635585900,-178925,true,16973620478,22,17063814961,90194483
1635585903,-178923,true,16977015372,22,17062108750,85093378
1635585954,-178922,true,16978713073,22,17056991141,78278068
1635585976,-178924,true,16975317840,22,17051875067,76557227
1635586051,-178924,true,16975317840,22,17045056022,69738182
1635586363,-178921,true,16980410945,22,17021210831,40799886
1635586451,-178919,true,16983807197,22,17016105489,32298292
1635586492,-178920,true,16982108986,22,17012702778,30593792
1635586577,-178917,true,16987204128,22,16999098739,11894611
1635586617,-178914,true,16992300799,22,16990601739,-1699060
1635586718,-178913,true,16994000029,22,16968529410,-25470619
1635586721,-178913,true,16994000029,22,16968529410,-25470619
1635586814,-178911,true,16997398999,22,16954960693,-42438306
1635587156,-178908,true,17002498729,22,16954960693,-47538036
1635587212,-178907,true,17004198978,22,16953265367,-50933611
1635587580,-178908,true,17002498729,22,16944791276,-57707453
1635587695,-178905,true,17007599988,22,16943096967,-64503021
1635587901,-178903,true,17011001678,22,16941402826,-69598852
1635587927,-178905,true,17007599988,22,16941402826,-66197162
1635588010,-178904,true,17009300748,22,16931241541,-78059207
1635588018,-178901,true,17014404049,22,16931241541,-83162508
1635588045,-178899,true,17017807100,22,16932934666,-84872434
1635588109,-178898,true,17019508880,22,16938015054,-81493826
1635588393,-178896,true,17022912952,22,16956656189,-66256763
1635588651,-178893,true,17028020337,22,16970226263,-57794074
1635588742,-178892,true,17029723139,22,16975317840,-54405299
1635588778,-178892,true,17029723139,22,16977015372,-52707767
1635588870,-178892,true,17029723139,22,16985505577,-44217562
1635588888,-178892,true,17029723139,22,16988902848,-40820291
1635588908,-178890,true,17033129254,22,16992300799,-40828455
1635589010,-178891,true,17031426111,22,16988902848,-42523263
1635589167,-178890,true,17033129254,22,16988902848,-44226406
1635589338,-178890,true,17033129254,22,16977015372,-56113882
1635589403,-178888,true,17036536050,22,16973620478,-62915572
1635589584,-178889,true,17034832567,22,16961743695,-73088872
1635589666,-178889,true,17034832567,22,16958351855,-76480712
1635589731,-178889,true,17034832567,22,16954960693,-79871874
1635589812,-178887,true,17038239704,22,16951570210,-86669494
1635589981,-178888,true,17036536050,22,16936321422,-100214628
1635590046,-178888,true,17036536050,22,16931241541,-105294509
1635590193,-178888,true,17036536050,22,16934627959,-101908091
1635590243,-178886,true,17039943528,22,16936321422,-103622106
1635590293,-178888,true,17036536050,22,16938015054,-98520996
1635590314,-178888,true,17036536050,22,16934627959,-101908091
1635590372,-178891,true,17031426111,22,16924470738,-106955373
1635590396,-178891,true,17031426111,22,16919394412,-112031699
1635590535,-178894,true,17026317705,22,16892346377,-133971328
1635590606,-178894,true,17026317705,22,16882214516,-144103189
1635590686,-178896,true,17022912952,22,16855225919,-167687033
1635590799,-178894,true,17026317705,22,16836696290,-189621415
1635590806,-178897,true,17021210831,22,16831646291,-189564540
1635590811,-178899,true,17017807100,22,16831646291,-186160809
1635590824,-178902,true,17012702778,22,16826597807,-186104971
1635590864,-178904,true,17009300748,22,16819868850,-189431898
1635590876,-178907,true,17004198978,22,16818187031,-186011947
1635590974,-178909,true,17000798649,22,16794659219,-206139430
1635591098,-178911,true,16997398999,22,16767810591,-229588408
1635591122,-178913,true,16994000029,22,16761105144,-232894885
1635591228,-178915,true,16990601739,22,16744353253,-246248486
1635591260,-178917,true,16987204128,22,16744353253,-242850875
1635591318,-178922,true,16978713073,22,16741004885,-237708188
1635591335,-178926,true,16971923286,22,16744353253,-227570033
1635591484,-178927,true,16970226263,22,16767810591,-202415672
1635591566,-178928,true,16968529410,22,16786264408,-182265002
1635591609,-178931,true,16963439869,22,16796338685,-167101184
1635591668,-178934,true,16958351855,22,16804738534,-153613321
1635591701,-178936,true,16954960693,22,16809780460,-145180233
1635591872,-178937,true,16953265367,22,16845116322,-108149045
1635591932,-178940,true,16948180404,22,16856911441,-91268963
1635592079,-178943,true,16943096967,22,16888968415,-54128552
1635592290,-178944,true,16941402826,22,16921086351,-20316475
1635592416,-178946,true,16938015054,22,16924470738,-13544316
1635592424,-178948,true,16934627959,22,16924470738,-10157221
1635592633,-178951,true,16929548587,22,16939708856,10160269
1635592670,-178950,true,16931241541,22,16943096967,11855426
1635592745,-178951,true,16929548587,22,16946485756,16937169
1635592848,-178953,true,16926163185,22,16951570210,25407025
1635592877,-178955,true,16922778460,22,16954960693,32182233
1635593333,-178953,true,16926163185,22,17004198978,78035793
1635593442,-178953,true,16926163185,22,17012702778,86539593
1635593582,-178954,true,16924470738,22,17024615244,100144506
1635593876,-178956,true,16921086351,22,17029723139,108636788
1635593901,-178953,true,16926163185,22,17029723139,103559954
1635593912,-178954,true,16924470738,22,17028020337,103549599
1635594029,-178955,true,16922778460,22,17022912952,100134492
1635594050,-178957,true,16919394412,22,17019508880,100114468
1635594107,-178956,true,16921086351,22,17011001678,89915327
1635594256,-178959,true,16916011040,22,16987204128,71193088
1635594280,-178960,true,16914319608,22,16983807197,69487589
1635594335,-178963,true,16909246327,22,16975317840,66071513
1635594417,-178961,true,16912628346,22,16960047690,47419344
1635594486,-178960,true,16914319608,22,16946485756,32166148
1635594623,-178964,true,16907555572,22,16904174568,-3381004
1635594830,-178968,true,16900794240,22,16841747804,-59046436
1635595033,-178966,true,16904174568,22,16796338685,-107835883
1635595035,-178966,true,16904174568,22,16796338685,-107835883
1635595140,-178969,true,16899104329,22,16794659219,-104445110
1635595194,-178972,true,16894035612,22,16794659219,-99376393
1635595225,-178968,true,16900794240,22,16794659219,-106135021
1635595240,-178968,true,16900794240,22,16792979921,-107814319
1635595244,-178971,true,16895725015,22,16792979921,-102745094
1635595277,-178974,true,16890657312,22,16794659219,-95998093
1635595547,-178969,true,16899104329,22,16829963295,-69141034
1635595723,-178970,true,16897414588,22,16851855379,-45559209
1635595746,-178972,true,16894035612,22,16853540565,-40495047
1635595764,-178975,true,16888968415,22,16855225919,-33742496
1635595913,-178972,true,16894035612,22,16861969020,-32066592
1635596060,-178973,true,16892346377,22,16848485514,-43860863
1635596108,-178976,true,16887279687,22,16841747804,-45531883
1635596152,-178979,true,16882214516,22,16833329456,-48885060
1635596213,-178978,true,16883902737,22,16808099650,-75803087
1635596357,-178981,true,16878838579,22,16791300791,-87537788
1635596378,-178983,true,16875463318,22,16789621829,-85841489
1635596393,-178986,true,16870401691,22,16784585950,-85815741
1635596504,-178984,true,16873775940,22,16774518722,-99257218
1635596554,-178986,true,16870401691,22,16772841438,-97560253
1635596671,-178989,true,16865341583,22,16767810591,-97530992
1635596776,-178991,true,16861969020,22,16766133978,-95835042
1635596881,-178989,true,16865341583,22,16764457532,-100884051
1635597028,-178992,true,16860282992,22,16766133978,-94149014
1635597153,-178994,true,16856911441,22,16774518722,-82392719
1635597161,-178997,true,16851855379,22,16774518722,-77336657
1635597192,-178995,true,16855225919,22,16772841438,-82384481
1635597279,-178998,true,16850170362,22,16761105144,-89065218
1635597319,-179001,true,16845116322,22,16757753425,-87362897
1635597358,-179004,true,16840063797,22,16751051999,-89011798
1635597479,-179000,true,16846800833,22,16749377062,-97423771
1635597494,-179003,true,16841747804,22,16747702292,-94045512
1635597666,-179012,true,16826597807,22,16649186680,-177411127
1635597824,-179017,true,16818187031,22,16584384539,-233802492
1635597858,-179016,true,16819868850,22,16571123000,-248745850
1635597886,-179019,true,16814823898,22,16561183805,-253640093
1635598056,-179026,true,16803058228,22,16486829618,-316228610
1635598099,-179030,true,16796338685,22,16468704982,-327633703
1635598257,-179027,true,16801378091,22,16417733591,-383644500
1635598288,-179031,true,16794659219,22,16401324884,-393334335
1635598396,-179035,true,16787943035,22,16368556652,-419386383
1635598449,-179039,true,16781229536,22,16380018079,-401211457
1635598467,-179035,true,16787943035,22,16383294247,-404648788
1635598487,-179037,true,16784585950,22,16388209726,-396376224
1635598626,-179043,true,16774518722,22,16409527187,-364991535
1635598683,-179044,true,16772841438,22,16414450537,-358390901
1635598706,-179042,true,16776196174,22,16414450537,-361745637
1635598751,-179044,true,16772841438,22,16416091982,-356749456
1635598922,-179051,true,16761105144,22,16425944100,-335161044
1635598955,-179053,true,16757753425,22,16427586694,-330166731
1635599005,-179051,true,16761105144,22,16429229453,-331875691
1635599246,-179056,true,16752727105,22,16380018079,-372709026
1635599409,-179064,true,16739330952,22,16355467697,-383863255
1635599442,-179067,true,16734310157,22,16348927145,-385383012
1635599460,-179067,true,16734310157,22,16345657850,-388652307
1635599550,-179072,true,16725945511,22,16329321179,-396624332
1635599554,-179081,true,16710899684,22,16327688410,-383211274
1635599579,-179084,true,16705887417,22,16321158967,-384728450
1635599641,-179085,true,16704216995,22,16301586301,-402630694
1635599778,-179088,true,16699206732,22,16295067296,-404139436
1635599815,-179097,true,16684184958,22,16295067296,-389117662
1635599944,-179097,true,16684184958,22,16332587206,-351597752
1635600094,-179097,true,16684184958,22,16389848547,-294336411
1635600109,-179099,true,16680848621,22,16394765994,-286082627
1635600383,-179107,true,16667509946,22,16460473099,-207036847
1635600417,-179109,true,16664176944,22,16468704982,-195471962
1635600495,-179109,true,16664176944,22,16495074681,-169102263
1635600499,-179111,true,16660844608,22,16496724189,-164120419
1635600542,-179120,true,16645857343,22,16511577181,-134280162
1635600568,-179121,true,16644192923,22,16513228338,-130964585
1635600641,-179120,true,16645857343,22,16541323296,-104534047
1635600674,-179122,true,16642528670,22,16552905696,-89622974
1635600719,-179130,true,16629220637,22,16564496207,-64724430
1635600739,-179130,true,16629220637,22,16566152657,-63067980
1635600785,-179130,true,16629220637,22,16571123000,-58097637
1635600840,-179131,true,16627557881,22,16577752443,-49805438
1635600885,-179140,true,16612600559,22,16574437390,-38163169
1635600923,-179140,true,16612600559,22,16572780112,-39820447
1635600960,-179140,true,16612600559,22,16572780112,-39820447
1635601117,-179142,true,16609278537,22,16569466053,-39812484
1635601192,-179150,true,16595997091,22,16569466053,-26531038
1635601252,-179151,true,16594337658,22,16569466053,-24871605
1635601470,-179150,true,16595997091,22,16577752443,-18244648
1635601489,-179151,true,16594337658,22,16574437390,-19900268
1635601504,-179158,true,16582726266,22,16571123000,-11603266
1635601572,-179158,true,16582726266,22,16554560987,-28165279
1635601694,-179157,true,16584384539,22,16524791067,-59593472
1635601786,-179159,true,16581068159,22,16509926188,-71141971
1635601853,-179166,true,16569466053,22,16503323868,-66142185
1635602008,-179167,true,16567809272,22,16491776161,-76033111
1635602086,-179169,true,16564496207,22,16481884558,-82611649
1635602118,-179171,true,16561183805,22,16476940981,-84242824
1635602215,-179178,true,16549595612,22,16476940981,-72654631
1635602225,-179179,true,16547940818,22,16475293452,-72647366
1635602351,-179179,true,16547940818,22,16481884558,-66056260
1635602417,-179180,true,16546286189,22,16486829618,-59456571
1635602434,-179186,true,16536361891,22,16490127148,-46234743
1635602810,-179188,true,16533055115,22,16508275361,-24779754
1635602871,-179188,true,16533055115,22,16509926188,-23128927
1635602879,-179188,true,16533055115,22,16511577181,-21477934
1635602880,-179194,true,16523138753,22,16511577181,-11561572
1635602906,-179196,true,16519834621,22,16513228338,-6606283
1635602922,-179195,true,16521486604,22,16511577181,-9909423
1635602957,-179194,true,16523138753,22,16516531149,-6607604
1635602979,-179200,true,16513228338,22,16519834621,6606283
1635603003,-179202,true,16509926188,22,16523138753,13212565
1635603015,-179202,true,16509926188,22,16524791067,14864879
1635603176,-179201,true,16511577181,22,16523138753,11561572
1635603188,-179207,true,16501673701,22,16521486604,19812903
1635603196,-179209,true,16498373861,22,16521486604,23112743
1635603232,-179209,true,16498373861,22,16516531149,18157288
1635603254,-179209,true,16498373861,22,16513228338,14854477
1635603256,-179215,true,16488478301,22,16513228338,24750037
1635603258,-179217,true,16485181100,22,16513228338,28047238
1635603775,-179217,true,16485181100,22,16470351852,-14829248
1635603828,-179216,true,16486829618,22,16473646087,-13183531
1635603917,-179221,true,16478588675,22,16471998887,-6589788
1635603922,-179223,true,16475293452,22,16471998887,-3294565
1635603990,-179224,true,16473646087,22,16465411735,-8234352
1635604176,-179224,true,16473646087,22,16450600271,-23045816
1635604221,-179224,true,16473646087,22,16448955375,-24690712
1635604263,-179224,true,16473646087,22,16447310644,-26335443
1635604294,-179222,true,16476940981,22,16444021675,-32919306
1635604367,-179224,true,16473646087,22,16434158715,-39487372
1635604644,-179226,true,16470351852,22,16375105056,-95246796
1635604795,-179227,true,16468704982,22,16330954111,-137750871
1635604900,-179225,true,16471998887,22,16304846781,-167152106
1635604989,-179226,true,16470351852,22,16301586301,-168765551
1635605019,-179230,true,16463765358,22,16293437952,-170327406
1635605049,-179230,true,16463765358,22,16286922206,-176843152
1635605103,-179230,true,16463765358,22,16273898530,-189866828
1635605242,-179233,true,16458827216,22,16252757263,-206069953
1635605261,-179237,true,16452245331,22,16249507200,-202738131
1635605325,-179238,true,16450600271,22,16239760907,-210839364
1635605418,-179238,true,16450600271,22,16228397620,-222202651
1635605479,-179242,true,16444021675,22,16220285855,-223735820
1635605557,-179245,true,16439089455,22,16212178144,-226911311
1635605608,-179245,true,16439089455,22,16212178144,-226911311
1635605677,-179244,true,16440733364,22,16212178144,-228555220
1635605732,-179246,true,16437445711,22,16204074486,-233371225
1635605781,-179249,true,16432515463,22,16192736170,-239779293
1635605835,-179250,true,16430872376,22,16174934843,-255937533
1635605836,-179250,true,16430872376,22,16174934843,-255937533
1635605961,-179254,true,16424301670,22,16141004815,-283296855
1635605968,-179256,true,16421017302,22,16139390876,-281626426
1635606039,-179257,true,16419375365,22,16123260358,-296115007
1635606189,-179254,true,16424301670,22,16120036190,-304265480
1635606282,-179259,true,16416091982,22,16115201146,-300890836
1635606292,-179261,true,16412809256,22,16113589787,-299219469
1635606315,-179265,true,16406245773,22,16108756677,-297489096
1635606362,-179267,true,16402965016,22,16105535409,-297429607
1635606426,-179275,true,16389848547,22,16092656776,-297191771
1635606428,-179277,true,16386571069,22,16091047672,-295523397
1635606532,-179280,true,16381656081,22,16065323866,-316332215
1635606560,-179282,true,16378380241,22,16060505233,-317875008
1635606768,-179288,true,16368556652,22,16055688045,-312868607
1635606801,-179290,true,16365283431,22,16055688045,-309595386
1635606818,-179293,true,16360374828,22,16055688045,-304686783
1635606941,-179297,true,16353832314,22,16060505233,-293327081
1635607118,-179304,true,16342389209,22,16036433737,-305955472
1635607215,-179307,true,16337487472,22,16038037380,-299450092
1635607272,-179310,true,16332587206,22,16052477389,-280109817
1635607296,-179313,true,16327688410,22,16058899343,-268789067
1635607433,-179318,true,16319527014,22,16087829945,-231697069
1635607512,-179320,true,16316263598,22,16095875469,-220388129
1635607613,-179322,true,16313000835,22,16110367552,-202633283
1635607655,-179325,true,16308107913,22,16113589787,-194518126
1635607715,-179329,true,16301586301,22,16118424347,-183161954
1635607737,-179330,true,16299956305,22,16120036190,-179920115
1635607825,-179334,true,16293437952,22,16123260358,-170177594
1635607864,-179335,true,16291808771,22,16132936733,-158872038
1635607870,-179340,true,16283665310,22,16132936733,-150728577
1635607921,-179340,true,16283665310,22,16150691840,-132973470
1635607937,-179340,true,16283665310,22,16155537532,-128127778
1635608129,-179335,true,16291808771,22,16257633578,-34175193
1635608206,-179339,true,16285293677,22,16282037107,-3256570
1635608456,-179338,true,16286922206,22,16375105056,88182850
1635608485,-179339,true,16285293677,22,16384932576,99638899
1635608505,-179333,true,16295067296,22,16391487532,96420236
1635608553,-179337,true,16288550898,22,16406245773,117694875
1635608629,-179339,true,16285293677,22,16427586694,142293017
1635608696,-179341,true,16282037107,22,16447310644,165273537
1635608781,-179338,true,16286922206,22,16462119146,175196940
1635608801,-179343,true,16278781188,22,16462119146,183337958
1635608896,-179346,true,16273898530,22,16448955375,175056845
1635609010,-179346,true,16273898530,22,16419375365,145476835
1635609026,-179343,true,16278781188,22,16416091982,137310794
1635609183,-179348,true,16270644238,22,16380018079,109373841
1635609385,-179352,true,16264137607,22,16324423362,60285755
1635609445,-179352,true,16264137607,22,16306477266,42339659
1635609532,-179349,true,16269017336,22,16286922206,17904870
1635609551,-179355,true,16259259342,22,16285293677,26034335
1635609667,-179358,true,16254382539,22,16286922206,32539667
1635609693,-179358,true,16254382539,22,16286922206,32539667
1635609822,-179353,true,16262511356,22,16296696803,34185447
1635609852,-179359,true,16252757263,22,16299956305,47199042
1635609910,-179362,true,16247882411,22,16304846781,56964370
1635609944,-179361,true,16249507200,22,16308107913,58600713
1635610133,-179356,true,16257633578,22,16337487472,79853894
1635610225,-179361,true,16249507200,22,16355467697,105960497
1635610561,-179364,true,16244633322,22,16399684915,155051593
1635610619,-179363,true,16246257786,22,16407886398,161628612
1635610640,-179357,true,16256007977,22,16414450537,158442560
1635610751,-179360,true,16251132150,22,16463765358,212633208
1635610822,-179357,true,16256007977,22,16493425339,237417362
1635610934,-179354,true,16260885268,22,16534708420,273823152
1635610940,-179349,true,16269017336,22,16536361891,267344555
1635611058,-179351,true,16265764021,22,16577752443,311988422
1635611082,-179348,true,16270644238,22,16586042977,315398739
1635611136,-179346,true,16273898530,22,16604296750,330398220
1635611278,-179340,true,16283665310,22,16664176944,380511634
1635611463,-179341,true,16282037107,22,16742678986,460641879
1635611477,-179335,true,16291808771,22,16746027689,454218918
1635611599,-179333,true,16295067296,22,16744353253,449285957
1635611700,-179328,true,16303216459,22,16724273084,421056625
1635611797,-179331,true,16298326473,22,16707558006,409231533
1635612101,-179325,true,16308107913,22,16667509946,359402033
1635612162,-179324,true,16309738724,22,16660844608,351105884
1635612237,-179318,true,16319527014,22,16649186680,329659666
1635612307,-179319,true,16317895225,22,16637536910,319641685
1635612317,-179314,true,16326055804,22,16635873323,309817519
1635612372,-179312,true,16329321179,22,16625895291,296574112
1635612444,-179306,true,16339121221,22,16619246596,280125375
1635612480,-179307,true,16337487472,22,16614261819,276774347
1635612513,-179302,true,16345657850,22,16610939465,265281615
1635612831,-179301,true,16347292416,22,16587701582,240409166
1635612869,-179296,true,16355467697,22,16584384539,228916842
1635613510,-179299,true,16350562038,22,16435802131,85240093
1635613674,-179294,true,16358738954,22,16412809256,54070302
1635614005,-179293,true,16360374828,22,16399684915,39310087
1635614038,-179287,true,16370193507,22,16399684915,29491408
1635614113,-179289,true,16366919960,22,16399684915,32764955
1635614258,-179284,true,16375105056,22,16386571069,11466013
1635614370,-179284,true,16375105056,22,16383294247,8189191
1635614711,-179280,true,16381656081,22,16363647067,-18009014
1635614815,-179283,true,16376742567,22,16355467697,-21274870
1635614859,-179277,true,16386571069,22,16352197094,-34373975
1635614956,-179278,true,16384932576,22,16347292416,-37640160
1635614990,-179272,true,16394765994,22,16344023448,-50742546
1635615011,-179273,true,16393126681,22,16340755133,-52371548
1635615083,-179269,true,16399684915,22,16332587206,-67097709
1635615240,-179271,true,16396405470,22,16309738724,-86666746
1635615255,-179266,true,16404605313,22,16306477266,-98128047
1635615415,-179268,true,16401324884,22,16280409066,-120915818
1635615448,-179264,true,16407886398,22,16273898530,-133987868
1635615478,-179267,true,16402965016,22,16267390597,-135574419
1635615511,-179262,true,16411168139,22,16260885268,-150282871
1635615523,-179264,true,16407886398,22,16260885268,-147001130
1635615526,-179260,true,16414450537,22,16259259342,-155191195
1635615556,-179262,true,16411168139,22,16257633578,-153534561
1635615636,-179256,true,16421017302,22,16252757263,-168260039
1635615661,-179261,true,16412809256,22,16252757263,-160051993
1635615677,-179257,true,16419375365,22,16251132150,-168243215
1635615717,-179259,true,16416091982,22,16246257786,-169834196
1635615737,-179253,true,16425944100,22,16244633322,-181310778
1635615849,-179259,true,16416091982,22,16223530074,-192561908
1635615907,-179256,true,16421017302,22,16215420742,-205596560
1635616087,-179257,true,16419375365,22,16215420742,-203954623
1635616119,-179252,true,16427586694,22,16215420742,-212165952
1635616138,-179258,true,16417733591,22,16215420742,-202312849
1635616156,-179256,true,16421017302,22,16215420742,-205596560
1635616207,-179260,true,16414450537,22,16213799362,-200651175
1635616289,-179260,true,16414450537,22,16210557089,-203893448
1635616475,-179267,true,16402965016,22,16197594477,-205370539
1635616642,-179266,true,16404605313,22,16178169992,-226435321
1635616688,-179270,true,16398045111,22,16176552336,-221492775
1635616714,-179270,true,16398045111,22,16174934843,-223110268
1635616767,-179276,true,16388209726,22,16171700341,-216509385
1635616868,-179273,true,16393126681,22,16170083333,-223043348
1635616873,-179277,true,16386571069,22,16170083333,-216487736
1635616932,-179276,true,16388209726,22,16165233278,-222976448
1635616982,-179282,true,16378380241,22,16160384678,-217995563
1635617419,-179280,true,16381656081,22,16118424347,-263231734
1635617591,-179283,true,16376742567,22,16103925016,-272817551
1635617870,-179283,true,16376742567,22,16087829945,-288912622
1635617937,-179289,true,16366919960,22,16084612861,-282307099
1635617962,-179286,true,16371830527,22,16083004561,-288825966
1635618258,-179289,true,16366919960,22,16070143945,-296776015
1635618494,-179288,true,16368556652,22,16062111283,-306445369
1635618514,-179294,true,16358738954,22,16062111283,-296627671
1635618521,-179292,true,16362010865,22,16062111283,-299899582
1635618555,-179296,true,16355467697,22,16062111283,-293356414
1635618557,-179297,true,16353832314,22,16062111283,-291721031
1635618769,-179302,true,16345657850,22,16062111283,-283546567
1635618812,-179301,true,16347292416,22,16062111283,-285181133
1635618837,-179305,true,16340755133,22,16063717494,-277037639
1635618860,-179306,true,16339121221,22,16065323866,-273797355
1635618874,-179311,true,16330954111,22,16066930398,-264023713
1635618947,-179309,true,16334220465,22,16071750960,-262469505
1635618982,-179313,true,16327688410,22,16074965471,-252722939
1635619022,-179315,true,16324423362,22,16076572967,-247850395
1635619145,-179322,true,16313000835,22,16087829945,-225170890
1635619302,-179326,true,16306477266,22,16099094805,-207382461
1635619411,-179331,true,16298326473,22,16107145962,-191180511
1635619453,-179333,true,16295067296,22,16110367552,-184699744
1635619507,-179339,true,16285293677,22,16113589787,-171703890
1635619512,-179342,true,16280409066,22,16115201146,-165207920
1635619548,-179347,true,16272271303,22,16118424347,-153846956
1635619587,-179348,true,16270644238,22,16121648194,-148996044
1635619722,-179354,true,16260885268,22,16144233178,-116652090
1635619786,-179358,true,16254382539,22,16139390876,-114991663
1635619822,-179363,true,16246257786,22,16137777098,-108480688
1635619921,-179364,true,16244633322,22,16137777098,-106856224
1635619967,-179369,true,16236513442,22,16136163482,-100349960
1635620001,-179373,true,16230020460,22,16134550027,-95470433
1635620088,-179377,true,16223530074,22,16131323601,-92206473
1635620156,-179381,true,16217042284,22,16111978589,-105063695
1635620176,-179387,true,16207315463,22,16107145962,-100169501
1635620285,-179391,true,16200834158,22,16095875469,-104958689
1635620311,-179395,true,16194355444,22,16094266042,-100089402
1635620345,-179396,true,16192736170,22,16092656776,-100079394
1635620418,-179402,true,16183023928,22,16086221323,-96802605
1635620496,-179405,true,16178169992,22,16076572967,-101597025
1635620508,-179409,true,16171700341,22,16068537091,-103163250
1635620511,-179410,true,16170083333,22,16068537091,-101546242
1635620613,-179413,true,16165233278,22,16049267375,-115965903
1635620617,-179416,true,16160384678,22,16049267375,-111117303
1635620649,-179419,true,16155537532,22,16046058003,-109479529
1635620931,-179421,true,16152306909,22,16025212722,-127094187
1635620957,-179424,true,16147462186,22,16022008160,-125454026
1635621093,-179426,true,16144233178,22,16049267375,-94965803
1635621194,-179427,true,16142618916,22,16057293613,-85325303
1635621310,-179427,true,16142618916,22,16062111283,-80507633
1635621450,-179430,true,16137777098,22,16074965471,-62811627
1635621482,-179432,true,16134550027,22,16076572967,-57977060
1635621517,-179434,true,16131323601,22,16079788442,-51535159
1635621528,-179434,true,16131323601,22,16079788442,-51535159
1635621930,-179436,true,16128097820,22,16118424347,-9673473
1635622087,-179437,true,16126485172,22,16118424347,-8060825
1635622178,-179436,true,16128097820,22,16116812666,-11285154
1635622258,-179436,true,16128097820,22,16113589787,-14508033
1635622380,-179439,true,16123260358,22,16111978589,-11281769
1635622668,-179440,true,16121648194,22,16095875469,-25772725
1635622677,-179440,true,16121648194,22,16095875469,-25772725
1635622699,-179440,true,16121648194,22,16095875469,-25772725
1635622822,-179442,true,16118424347,22,16092656776,-25767571
1635622858,-179443,true,16116812666,22,16092656776,-24155890
1635622888,-179444,true,16115201146,22,16092656776,-22544370
1635623030,-179445,true,16113589787,22,16091047672,-22542115
1635623033,-179448,true,16108756677,22,16091047672,-17709005
1635623070,-179449,true,16107145962,22,16089438728,-17707234
1635623086,-179449,true,16107145962,22,16089438728,-17707234
1635623178,-179451,true,16103925016,22,16083004561,-20920455
1635623180,-179452,true,16102314785,22,16083004561,-19310224
1635623294,-179450,true,16105535409,22,16097485056,-8050353
1635623399,-179450,true,16105535409,22,16115201146,9665737
1635623484,-179451,true,16103925016,22,16123260358,19335342
1635623506,-179452,true,16102314785,22,16124872684,22557899
1635623604,-179450,true,16105535409,22,16142618916,37083507
1635623624,-179450,true,16105535409,22,16144233178,38697769
1635623644,-179450,true,16105535409,22,16147462186,41926777
1635623735,-179450,true,16105535409,22,16162000716,56465307
1635623817,-179448,true,16108756677,22,16173317511,64560834
1635623852,-179448,true,16108756677,22,16179787809,71031132
1635624059,-179447,true,16110367552,22,16225152427,114784875
1635624129,-179447,true,16110367552,22,16233266626,122899074
1635624223,-179446,true,16111978589,22,16234889953,122911364
1635624231,-179445,true,16113589787,22,16234889953,121300166
1635624277,-179444,true,16115201146,22,16236513442,121312296
1635624302,-179445,true,16113589787,22,16236513442,122923655
1635624316,-179442,true,16118424347,22,16238137093,119712746
1635624329,-179441,true,16120036190,22,16238137093,118100903
1635624386,-179440,true,16121648194,22,16241384883,119736689
1635624501,-179441,true,16120036190,22,16243009021,122972831
1635624504,-179438,true,16124872684,22,16243009021,118136337
1635624634,-179436,true,16128097820,22,16236513442,108415622
1635624644,-179436,true,16128097820,22,16236513442,108415622
1635624695,-179436,true,16128097820,22,16239760907,111663087
1635624732,-179433,true,16132936733,22,16238137093,105200360
1635624743,-179432,true,16134550027,22,16238137093,103587066
1635624755,-179432,true,16134550027,22,16236513442,101963415
1635624910,-179433,true,16132936733,22,16223530074,90593341
1635624922,-179430,true,16137777098,22,16220285855,82508757
1635624951,-179429,true,16139390876,22,16213799362,74408486
1635624959,-179429,true,16139390876,22,16212178144,72787268
1635625021,-179433,true,16132936733,22,16200834158,67897425
1635625088,-179431,true,16136163482,22,16189498109,53334627
1635625109,-179430,true,16137777098,22,16186260695,48483597
1635625229,-179430,true,16137777098,22,16170083333,32306235
1635625549,-179433,true,16132936733,22,16131323601,-1613132
1635625584,-179431,true,16136163482,22,16128097820,-8065662
1635625655,-179430,true,16137777098,22,16123260358,-14516740
1635625669,-179430,true,16137777098,22,16121648194,-16128904
1635625694,-179433,true,16132936733,22,16118424347,-14512386
1635625778,-179433,true,16132936733,22,16099094805,-33841928
1635625814,-179434,true,16131323601,22,16092656776,-38666825
1635625856,-179435,true,16129710630,22,16089438728,-40271902
1635625859,-179439,true,16123260358,22,16089438728,-33821630
1635625922,-179436,true,16128097820,22,16094266042,-33831778
1635625975,-179434,true,16131323601,22,16108756677,-22566924
1635626083,-179431,true,16136163482,22,16132936733,-3226749
1635626133,-179434,true,16131323601,22,16142618916,11295315
1635626205,-179430,true,16137777098,22,16158768801,20991703
1635626285,-179429,true,16139390876,22,16162000716,22609840
1635626335,-179426,true,16144233178,22,16162000716,17767538
1635626419,-179429,true,16139390876,22,16162000716,22609840
1635626469,-179426,true,16144233178,22,16160384678,16151500
1635626529,-179426,true,16144233178,22,16157153085,12919907
1635626533,-179424,true,16147462186,22,16157153085,9690899
1635626572,-179428,true,16141004815,22,16155537532,14532717
1635626595,-179425,true,16145847601,22,16160384678,14537077
1635626635,-179423,true,16149076932,22,16168466486,19389554
1635626706,-179420,true,16153922139,22,16184642230,30720091
1635626721,-179424,true,16147462186,22,16184642230,37180044
1635626733,-179421,true,16152306909,22,16184642230,32335321
1635626808,-179420,true,16153922139,22,16186260695,32338556
1635626915,-179416,true,16160384678,22,16178169992,17785314
1635626940,-179419,true,16155537532,22,16176552336,21014804
1635626990,-179417,true,16158768801,22,16174934843,16166042
1635627138,-179415,true,16162000716,22,16173317511,11316795
1635627371,-179412,true,16166849801,22,16208936195,42086394
1635627386,-179415,true,16162000716,22,16210557089,48556373
1635627490,-179413,true,16165233278,22,16221907883,56674605
1635627562,-179412,true,16166849801,22,16218663988,51814187
1635627736,-179411,true,16168466486,22,16215420742,46954256
1635627766,-179414,true,16163616916,22,16212178144,48561228
1635627776,-179413,true,16165233278,22,16212178144,46944866
1635627802,-179412,true,16166849801,22,16202454241,35604440
1635627902,-179413,true,16165233278,22,16176552336,11319058
1635628055,-179415,true,16162000716,22,16160384678,-1616038
1635628075,-179412,true,16166849801,22,16157153085,-9696716
1635628115,-179411,true,16168466486,22,16152306909,-16159577
1635628225,-179411,true,16168466486,22,16137777098,-30689388
1635628256,-179414,true,16163616916,22,16129710630,-33906286
1635628345,-179413,true,16165233278,22,16108756677,-56476601
1635628439,-179413,true,16165233278,22,16092656776,-72576502
1635628445,-179414,true,16163616916,22,16091047672,-72569244
1635628470,-179416,true,16160384678,22,16089438728,-70945950
1635628524,-179414,true,16163616916,22,16086221323,-77395593
1635628583,-179413,true,16165233278,22,16083004561,-82228717
1635628640,-179413,true,16165233278,22,16076572967,-88660311
1635628666,-179415,true,16162000716,22,16074965471,-87035245
1635628690,-179416,true,16160384678,22,16078180624,-82204054
1635628742,-179415,true,16162000716,22,16084612861,-77387855
1635628801,-179418,true,16157153085,22,16076572967,-80580118
1635628840,-179421,true,16152306909,22,16068537091,-83769818
1635628857,-179421,true,16152306909,22,16070143945,-82162964
1635628858,-179421,true,16152306909,22,16070143945,-82162964
1635628893,-179426,true,16144233178,22,16055688045,-88545133
1635628923,-179432,true,16134550027,22,16039641184,-94908843
1635628928,-179435,true,16129710630,22,16038037380,-91673250
1635628956,-179436,true,16128097820,22,16023610361,-104487459
1635628997,-179442,true,16118424347,22,16001194122,-117230225
1635629132,-179449,true,16107145962,22,15926168709,-180977253
1635629170,-179453,true,16100704714,22,15910251296,-190453418
1635629236,-179452,true,16102314785,22,15892760516,-209554269
1635629246,-179457,true,16094266042,22,15894349792,-199916250
1635629297,-179462,true,16086221323,22,15880052027,-206169296
1635629310,-179465,true,16081396421,22,15875288964,-206107457
1635629321,-179465,true,16081396421,22,15870527329,-210869092
1635629487,-179472,true,16070143945,22,15800853887,-269290058
1635629870,-179476,true,16063717494,22,15731486319,-332231175
1635630273,-179478,true,16060505233,22,15766131952,-294373281
1635630276,-179478,true,16060505233,22,15766131952,-294373281
1635630283,-179485,true,16049267375,22,15767708566,-281558809
1635630349,-179488,true,16044453557,22,15778749273,-265704284
1635630416,-179489,true,16042849272,22,15785061720,-257787552
1635630476,-179488,true,16044453557,22,15800853887,-243599670
1635630515,-179495,true,16033226931,22,15799273959,-233952972
1635630537,-179498,true,16028417925,22,15799273959,-229143966
1635630703,-179500,true,16025212722,22,15796114578,-229098144
1635630768,-179500,true,16025212722,22,15789797712,-235415010
1635630893,-179508,true,16012398319,22,15778749273,-233649046
1635630907,-179508,true,16012398319,22,15777171556,-235226763
1635631085,-179511,true,16007595560,22,15762979199,-244616361
1635631176,-179511,true,16007595560,22,15755100073,-252495487
1635631193,-179519,true,15994795244,22,15753524721,-241270523
1635631243,-179519,true,15994795244,22,15750374488,-244420756
1635631318,-179522,true,15989997765,22,15737779857,-252217908
1635631462,-179523,true,15988398925,22,15707907956,-280490969
1635631530,-179532,true,15974016558,22,15693777905,-280238653
1635631593,-179534,true,15970822234,22,15668689191,-302133043
1635631618,-179536,true,15967628549,22,15665555923,-302072626
1635631650,-179537,true,15966031946,22,15662423282,-303608664
1635631656,-179546,true,15951669699,22,15660857196,-290812503
1635631721,-179549,true,15946885155,22,15638948431,-307936724
1635631767,-179554,true,15938914104,22,15628005545,-310908559
1635631858,-179559,true,15930947037,22,15595222806,-335724231
1635632012,-179571,true,15911842321,22,15537629974,-374212347
1635632114,-179574,true,15907069723,22,15500386235,-406683488
1635632115,-179581,true,15895939227,22,15500386235,-395552992
1635632142,-179584,true,15891171399,22,15489540303,-401631096
1635632201,-179595,true,15873701594,22,15470964931,-402736663
1635632284,-179597,true,15870527329,22,15440055466,-430471863
1635632395,-179600,true,15865767123,22,15426166362,-439600761
1635632423,-179603,true,15861008345,22,15423081591,-437926754
1635632446,-179614,true,15843571700,22,15424623899,-418947801
1635632463,-179614,true,15843571700,22,15426166362,-417405338
1635632476,-179618,true,15837235855,22,15426166362,-411069493
1635632586,-179624,true,15827736838,22,15418455592,-409281246
1635632698,-179635,true,15810336770,22,15418455592,-391881178
1635632760,-179635,true,15810336770,22,15421539437,-388797333
1635632805,-179639,true,15804014216,22,15423081591,-380932625
1635632886,-179646,true,15792955829,22,15412289751,-380666078
1635633002,-179660,true,15770862265,22,15393807020,-377055245
1635633016,-179662,true,15767708566,22,15386112425,-381596141
1635633107,-179668,true,15758251251,22,15363051709,-395199542
1635633128,-179677,true,15744075913,22,15356908024,-387167889
1635633144,-179692,true,15720478682,22,15353837103,-366641579
1635633183,-179694,true,15717335057,22,15346162487,-371172570
1635633210,-179700,true,15707907956,22,15336958011,-370949945
1635633260,-179709,true,15693777905,22,15307846911,-385930994
1635633267,-179724,true,15670256060,22,15301725303,-368530757
1635633294,-179729,true,15662423282,22,15280318946,-382104336
1635633404,-179738,true,15648334146,22,15190434976,-457899170
1635633440,-179747,true,15634257685,22,15172218297,-462039388
1635633457,-179760,true,15613947370,22,15161601992,-452345378
1635633481,-179767,true,15603021977,22,15141905699,-461116278
1635633522,-179777,true,15587427534,22,15107121073,-480306461
1635633541,-179789,true,15568734773,22,15090513206,-478221567
1635633652,-179799,true,15553174598,22,15027269118,-525905480
1635633690,-179804,true,15545400343,22,15007747336,-537653007
1635633707,-179810,true,15536076366,22,15006246712,-529829654
1635633714,-179821,true,15518996932,22,15007747336,-511249596
1635633723,-179825,true,15512790885,22,15009248111,-503542774
1635633756,-179824,true,15514342164,22,15013751336,-500590828
1635633777,-179831,true,15503486467,22,15013751336,-489735131
1635633804,-179841,true,15487991504,22,15019757737,-468233767
1635633914,-179844,true,15483346036,22,15042303152,-441042884
1635633927,-179843,true,15484894370,22,15046816294,-438078076
1635634014,-179851,true,15472512027,22,15058857961,-413654066
1635634050,-179863,true,15453957076,22,15066388896,-387568180
1635634074,-179865,true,15450866748,22,15069402324,-381464424
1635634084,-179864,true,15452411835,22,15069402324,-383009511
1635634093,-179872,true,15440055466,22,15072416355,-367639111
1635634121,-179881,true,15426166362,22,15079954071,-346212291
1635634169,-179880,true,15427708978,22,15110142648,-317566330
1635634217,-179875,true,15435424376,22,15149478166,-285946210
1635634266,-179880,true,15427708978,22,15185878757,-241830221
1635634357,-179889,true,15413830980,22,15240643700,-173187280
1635634378,-179888,true,15415372363,22,15258942535,-156429828
1635634393,-179882,true,15424623899,22,15268100190,-156523709
1635634549,-179890,true,15412289751,22,15344628024,-67661727
1635634671,-179901,true,15395346400,22,15352301873,-43044527
1635634682,-179900,true,15396885935,22,15349231873,-47654062
1635634701,-179897,true,15401505463,22,15341559559,-59945904
1635634718,-179906,true,15387651036,22,15340025556,-47625480
1635634762,-179917,true,15370734771,22,15335424469,-35310302
1635634777,-179913,true,15376883987,22,15333891080,-42992907
1635634801,-179910,true,15381497514,22,15332357844,-49139670
1635635011,-179919,true,15367661085,22,15336958011,-30703074
1635635266,-179926,true,15356908024,22,15370734771,13826747
1635635353,-179922,true,15363051709,22,15395346400,32294691
1635635455,-179918,true,15369197851,22,15419997438,50799587
1635635482,-179927,true,15355372487,22,15426166362,70793875
1635635521,-179937,true,15340025556,22,15435424376,95398820
1635635531,-179934,true,15344628024,22,15435424376,90796352
1635635537,-179930,true,15350766796,22,15436967918,86201122
1635635553,-179939,true,15336958011,22,15438511615,101553604
1635635566,-179950,true,15320097476,22,15436967918,116870442
1635635591,-179947,true,15324693965,22,15441599472,116905507
1635635628,-179945,true,15327759057,22,15440055466,112296409
1635635729,-179952,true,15317033916,22,15427708978,110675062
1635635770,-179964,true,15298665417,22,15423081591,124416174
1635635905,-179961,true,15303255475,22,15409207756,105952281
1635635915,-179959,true,15306316279,22,15407666989,101350710
1635635956,-179967,true,15294076735,22,15383035664,88958929
1635636005,-179980,true,15274208346,22,15353837103,79628757
1635636577,-179979,true,15275735767,22,15096550317,-179185450
1635636595,-179975,true,15281846978,22,15092022257,-189824721
1635636773,-179983,true,15269627000,22,15073923597,-195703403
1635636816,-179993,true,15254365768,22,15073923597,-180442171
1635636928,-179989,true,15260468429,22,15095040813,-165427616
1635636960,-179984,true,15268100190,22,15101079735,-167020455
1635637069,-179990,true,15258942535,22,15125259592,-133682943
1635637115,-179998,true,15246740872,22,15135850451,-110890421
1635637116,-179993,true,15254365768,22,15135850451,-118515317
1635637170,-179989,true,15260468429,22,15147963370,-112505059
1635637216,-179994,true,15252840483,22,15155538867,-97301616
1635637341,-180004,true,15237596029,22,15172218297,-65377732
1635637378,-180000,true,15243691981,22,15176770418,-66921563
1635637458,-179995,true,15251315352,22,15188916085,-62399267
1635637473,-180002,true,15240643700,22,15191954020,-48689680
1635637486,-180012,true,15225411436,22,15193473215,-31938221
1635637540,-180010,true,15228456670,22,15182842037,-45614633
1635637561,-180009,true,15229979516,22,15178288095,-51691421
1635637596,-180016,true,15219322793,22,15176770418,-42552375
1635637741,-180023,true,15208673527,22,15167667542,-41005985
1635637832,-180020,true,15213236586,22,15158570126,-54666460
1635637888,-180019,true,15214757909,22,15150993114,-63764795
1635637915,-180026,true,15204111838,22,15137364036,-66747802
1635637950,-180033,true,15193473215,22,15128284795,-65188420
1635637963,-180029,true,15199551516,22,15123747218,-75804298
1635638002,-180029,true,15199551516,22,15110142648,-89408868
1635638032,-180034,true,15191954020,22,15099569778,-92384242
1635638060,-180040,true,15182842037,22,15092022257,-90819780
1635638084,-180035,true,15190434976,22,15081462066,-108972910
1635638093,-180036,true,15188916085,22,15076938532,-111977553
1635638152,-180040,true,15182842037,22,15063376070,-119465967
1635638278,-180046,true,15173735519,22,15028771845,-144963674
1635638324,-180040,true,15182842037,22,15015252711,-167589326
1635638336,-180038,true,15185878757,22,15012250111,-173628646
1635638371,-180038,true,15185878757,22,14998745839,-187132918
1635638426,-180040,true,15182842037,22,15009248111,-173593926
1635638586,-180031,true,15196512062,22,15027269118,-169242944
1635638641,-180027,true,15202591579,22,15030274722,-172316857
1635638799,-180026,true,15204111838,22,15045311763,-158800075
1635638828,-180024,true,15207152812,22,15061869883,-145282929
1635639005,-180015,true,15220844726,22,15166150927,-54693799
1635639119,-180012,true,15225411436,22,15234548967,9137531
1635639270,-180010,true,15228456670,22,15329291832,100835162
1635639661,-180010,true,15228456670,22,15455502472,227045802
1635639749,-180004,true,15237596029,22,15492638366,255042337
1635639831,-180006,true,15234548967,22,15534522914,299973947
1635639942,-180001,true,15242167765,22,15598342007,356174242
1635639998,-179995,true,15251315352,22,15618632023,367316671
1635640190,-179990,true,15258942535,22,15689070713,430128178
1635640280,-179993,true,15254365768,22,15704766846,450401078
1635640330,-179990,true,15258942535,22,15715763481,456820946
1635640340,-179984,true,15268100190,22,15717335057,449234867
1635640371,-179981,true,15272681078,22,15718906791,446225713
1635640536,-179987,true,15263520675,22,15720478682,456958007
1635640795,-179985,true,15266573532,22,15618632023,352058491
1635641112,-179980,true,15274208346,22,15501936273,227727927
1635641130,-179980,true,15274208346,22,15497286622,223078276
1635641146,-179987,true,15263520675,22,15494187630,230666955
1635641163,-179985,true,15266573532,22,15489540303,222966771
1635641207,-179981,true,15272681078,22,15478701961,206020883
1635641320,-179981,true,15272681078,22,15463231768,190550690
1635641491,-179986,true,15265047028,22,15452411835,187364807
1635641499,-179982,true,15271153962,22,15452411835,181257873
1635641591,-179976,true,15280318946,22,15449321816,169002870
1635641605,-179975,true,15281846978,22,15449321816,167474838
1635641743,-179981,true,15272681078,22,15443143632,170462554
1635641769,-179976,true,15280318946,22,15443143632,162824686
1635641819,-179970,true,15289489429,22,15438511615,149022186
1635641836,-179970,true,15289489429,22,15436967918,147478489
1635641873,-179978,true,15277263340,22,15433880988,156617648
1635641911,-179974,true,15283375162,22,15430794674,147419512
1635641955,-179972,true,15286431990,22,15427708978,141276988
1635642007,-179973,true,15284903500,22,15423081591,138178091
1635642083,-179980,true,15274208346,22,15421539437,147331091
1635642102,-179977,true,15278791067,22,15421539437,142748370
1635642189,-179974,true,15283375162,22,15426166362,142791200
1635642298,-179973,true,15284903500,22,15429251749,144348249
1635642329,-179980,true,15274208346,22,15429251749,155043403
1635642361,-179976,true,15280318946,22,15430794674,150475728
1635642486,-179972,true,15286431990,22,15401505463,115073473
1635642547,-179973,true,15284903500,22,15389189801,104286301
1635642597,-179979,true,15275735767,22,15376883987,101148220
1635642637,-179976,true,15280318946,22,15367661085,87342139
1635642809,-179972,true,15286431990,22,15335424469,48992479
1635642886,-179973,true,15284903500,22,15320097476,35193976
1635642903,-179979,true,15275735767,22,15318565619,42829852
1635643068,-179975,true,15281846978,22,15281846978,0
1635643154,-179970,true,15289489429,22,15260468429,-29021000
1635643163,-179967,true,15294076735,22,15258942535,-35134200
1635643203,-179974,true,15283375162,22,15246740872,-36634290
1635643252,-179971,true,15287960633,22,15231502514,-56458119
1635643410,-179966,true,15295606143,22,15229979516,-65626627
1635643481,-179966,true,15295606143,22,15229979516,-65626627
1635643579,-179973,true,15284903500,22,15214757909,-70145591
1635643647,-179973,true,15284903500,22,15202591579,-82311921
1635643730,-179969,true,15291018378,22,15184360321,-106658057
1635643876,-179970,true,15289489429,22,15163118152,-126371277
1635643902,-179978,true,15277263340,22,15158570126,-118693214
1635643938,-179977,true,15278791067,22,15154023464,-124767603
1635644056,-179972,true,15286431990,22,15135850451,-150581539
1635644109,-179973,true,15284903500,22,15129797624,-155105876
1635644131,-179981,true,15272681078,22,15128284795,-144396283
1635644213,-179980,true,15274208346,22,15113164828,-161043518
1635644228,-179975,true,15281846978,22,15108631785,-173215193
1635644258,-179975,true,15281846978,22,15102589843,-179257135
1635644286,-179980,true,15274208346,22,15096550317,-177658029
1635644348,-179979,true,15275735767,22,15084478510,-191257257
1635644364,-179976,true,15280318946,22,15079954071,-200364875
1635644426,-179977,true,15278791067,22,15073923597,-204867470
1635644511,-179982,true,15271153962,22,15070909264,-200244698
1635644555,-179979,true,15275735767,22,15076938532,-198797235
1635644589,-179975,true,15281846978,22,15081462066,-200384912
1635644641,-179973,true,15284903500,22,15089004306,-195899194
1635644799,-179975,true,15281846978,22,15096550317,-185296661
1635644840,-179973,true,15284903500,22,15096550317,-188353183
1635644967,-179969,true,15291018378,22,15102589843,-188428535
1635644986,-179966,true,15295606143,22,15101079735,-194526408
1635645018,-179969,true,15291018378,22,15099569778,-191448600
1635645034,-179968,true,15292547480,22,15098059972,-194487508
1635645083,-179965,true,15297135703,22,15098059972,-199075731
1635645134,-179963,true,15300195283,22,15096550317,-203644966
1635645189,-179966,true,15295606143,22,15095040813,-200565330
1635645296,-179965,true,15297135703,22,15092022257,-205113446
1635645361,-179965,true,15297135703,22,15089004306,-208131397
1635645449,-179966,true,15295606143,22,15079954071,-215652072
1635645485,-179970,true,15289489429,22,15070909264,-218580165
1635645504,-179970,true,15289489429,22,15067895535,-221593894
1635645531,-179971,true,15287960633,22,15061869883,-226090750
1635645603,-179976,true,15280318946,22,15048320975,-231997971
1635645617,-179981,true,15272681078,22,15046816294,-225864784
1635645640,-179984,true,15268100190,22,15043807382,-224292808
1635645747,-179984,true,15268100190,22,15036287734,-231812456
1635646042,-179988,true,15261994476,22,15046816294,-215178182
1635646067,-179995,true,15251315352,22,15049825807,-201489545
1635646107,-180000,true,15243691981,22,15052835923,-190856058
1635646123,-180007,true,15233025664,22,15052835923,-180189741
1635646131,-180012,true,15225411436,22,15054341207,-171070229
1635646229,-180018,true,15216279385,22,15051330790,-164948595
1635646395,-180022,true,15210194395,22,15052835923,-157358472
1635646454,-180028,true,15201071471,22,15052835923,-148235548
1635646593,-180030,true,15198031713,22,15046816294,-151215419
1635646685,-180033,true,15193473215,22,15039295142,-154178073
1635646698,-180036,true,15188916085,22,15040799072,-148117013
1635646731,-180042,true,15179805924,22,15033280928,-146524996
1635646865,-180045,true,15175252893,22,15007747336,-167505557
1635646867,-180049,true,15169184309,22,15007747336,-161436973
1635647155,-180052,true,15164634464,22,14970276699,-194357765
1635647180,-180057,true,15157054421,22,14967283093,-189771328
1635647295,-180061,true,15150993114,22,14934392907,-216600207
1635647337,-180065,true,15144934232,22,14926927950,-218006282
1635647615,-180070,true,15137364036,22,14873290297,-264073739
1635647772,-180074,true,15131310604,22,14891148065,-240162539
1635647820,-180077,true,15126772118,22,14894126444,-232645674
1635647979,-180081,true,15120722922,22,14897105418,-223617504
1635648014,-180084,true,15116187612,22,14898595129,-217592483
1635648126,-180086,true,15113164828,22,14928420643,-184744185
1635648197,-180089,true,15108631785,22,14956810185,-151821600
1635648283,-180089,true,15108631785,22,14998745839,-109885946
1635648463,-180090,true,15107121073,22,15075430989,-31690084
1635648516,-180092,true,15104100102,22,15098059972,-6040130
1635648625,-180095,true,15099569778,22,15102589843,3020065
1635648651,-180096,true,15098059972,22,15104100102,6040130
1635648694,-180099,true,15093531460,22,15107121073,13589613
1635648808,-180104,true,15085986957,22,15105610512,19623555
1635648875,-180109,true,15078446226,22,15105610512,27164286
1635649060,-180111,true,15075430989,22,15079954071,4523082
1635649077,-180114,true,15070909264,22,15076938532,6029268
1635649103,-180116,true,15067895535,22,15070909264,3013729
1635649193,-180119,true,15063376070,22,15040799072,-22576998
1635649230,-180120,true,15061869883,22,15030274722,-31595161
1635649256,-180123,true,15057352226,22,15022761839,-34590387
1635649281,-180125,true,15054341207,22,15015252711,-39088496
1635649363,-180128,true,15049825807,22,14992747840,-57077967
1635649493,-180129,true,15048320975,22,14962793806,-85527169
1635649509,-180132,true,15043807382,22,14959801696,-84005686
1635649690,-180136,true,15037791363,22,14917974928,-119816435
1635649767,-180139,true,15033280928,22,14904555461,-128725467
1635649803,-180142,true,15028771845,22,14898595129,-130176716
1635650011,-180144,true,15025766542,22,14853968548,-171797994
1635650190,-180150,true,15016754236,22,14805033685,-211720551
1635650285,-180154,true,15010749036,22,14778409924,-232339112
1635650308,-180156,true,15007747336,22,14773977288,-233770048
1635650334,-180159,true,15003245913,22,14768069174,-235176739
1635650486,-180162,true,14998745839,22,14745934782,-252811057
1635650537,-180165,true,14994247115,22,14742986037,-251261078
1635650573,-180167,true,14991248715,22,14740037882,-251210833
1635650651,-180170,true,14986752240,22,14732670074,-254082166
1635650775,-180174,true,14980759037,22,14722361329,-258397708
1635650908,-180177,true,14976265708,22,14713531003,-262734705
1635650934,-180179,true,14973270904,22,14712059797,-261211107
1635650988,-180181,true,14970276699,22,14716473856,-253802843
1635651003,-180184,true,14965786514,22,14717945504,-247841010
1635651027,-180185,true,14964290085,22,14723833565,-240456520
1635651090,-180185,true,14964290085,22,14735616755,-228673330
1635651093,-180186,true,14962793806,22,14737090317,-225703489
1635651192,-180189,true,14958305866,22,14753309224,-204996642
1635651280,-180190,true,14956810185,22,14768069174,-188741011
1635651427,-180187,true,14961297676,22,14822809500,-138488176
1635651476,-180189,true,14958305866,22,14840606658,-117699208
1635651536,-180192,true,14953819271,22,14864369446,-89449825
1635651553,-180192,true,14953819271,22,14871803117,-82016154
1635651594,-180191,true,14955314653,22,14888170282,-67144371
1635651671,-180192,true,14953819271,22,14919466725,-34352546
1635651743,-180194,true,14950828956,22,14947839239,-2989717
1635651757,-180194,true,14950828956,22,14952324039,1495083
1635651803,-180193,true,14952324039,22,14965786514,13462475
1635651829,-180195,true,14949334022,22,14974768232,25434210
1635651901,-180196,true,14947839239,22,14989749740,41910501
1635651932,-180196,true,14947839239,22,14992747840,44908601
1635652027,-180194,true,14950828956,22,15003245913,52416957
1635652099,-180196,true,14947839239,22,15010749036,62909797
1635652165,-180197,true,14946344604,22,15021259713,74915109
1635652281,-180197,true,14946344604,22,15013751336,67406732
1635652322,-180195,true,14949334022,22,15009248111,59914089
1635652422,-180197,true,14946344604,22,15001745738,55401134
1635652526,-180197,true,14946344604,22,14991248715,44904111
1635652556,-180197,true,14946344604,22,14988250915,41906311
1635652655,-180195,true,14949334022,22,14980759037,31425015
1635652785,-180198,true,14944850119,22,14965786514,20936395
1635652816,-180201,true,14940367561,22,14961297676,20930115
1635652941,-180203,true,14937379935,22,14944850119,7470184
1635652971,-180202,true,14938873673,22,14940367561,1493888
1635653018,-180206,true,14932899617,22,14934392907,1493290
1635653025,-180209,true,14928420643,22,14932899617,4478974
1635653042,-180210,true,14926927950,22,14932899617,5971667
1635653072,-180206,true,14932899617,22,14934392907,1493290
1635653120,-180205,true,14934392907,22,14937379935,2987028
1635653176,-180209,true,14928420643,22,14935886347,7465704
1635653222,-180210,true,14926927950,22,14932899617,5971667
1635653246,-180206,true,14932899617,22,14935886347,2986730
1635653412,-180204,true,14935886347,22,14953819271,17932924
1635653421,-180207,true,14931406477,22,14955314653,23908176
1635653704,-180203,true,14937379935,22,15057352226,119972291
1635653770,-180198,true,14944850119,22,15084478510,139628391
1635653905,-180195,true,14949334022,22,15147963370,198629348
1635654054,-180197,true,14946344604,22,15191954020,245609416
1635654257,-180192,true,14953819271,22,15240643700,286824429
1635654464,-180186,true,14962793806,22,15272681078,309887272
1635654906,-180180,true,14971773727,22,15313970968,342197241
1635655033,-180184,true,14965786514,22,15297135703,331349189
1635655268,-180181,true,14970276699,22,15255891204,285614505
1635655326,-180176,true,14977763335,22,15243691981,265928646
1635655495,-180176,true,14977763335,22,15208673527,230910192
1635655652,-180180,true,14971773727,22,15172218297,200444570
1635655736,-180178,true,14974768232,22,15149478166,174709934
1635655896,-180176,true,14977763335,22,15140391660,162628325
1635655925,-180177,true,14976265708,22,15140391660,164125952
1635656077,-180182,true,14968779821,22,15138877772,170097951
1635656180,-180179,true,14973270904,22,15137364036,164093132
1635656395,-180175,true,14979261111,22,15176770418,197509307
1635656406,-180174,true,14980759037,22,15178288095,197529058
1635656434,-180176,true,14977763335,22,15178288095,200524760
1635656448,-180171,true,14985253715,22,15179805924,194552209
1635656493,-180169,true,14988250915,22,15181323905,193072990
1635656628,-180167,true,14991248715,22,15193473215,202224500
1635656644,-180169,true,14988250915,22,15194992563,206741648
1635656667,-180164,true,14995746540,22,15196512062,200765522
1635656726,-180162,true,14998745839,22,15194992563,196246724
1635656775,-180158,true,15004746237,22,15207152812,202406575
1635656813,-180157,true,15006246712,22,15226933977,220687265
1635656817,-180151,true,15015252711,22,15228456670,213203959
1635656833,-180145,true,15024264115,22,15234548967,210284852
1635657594,-180141,true,15030274722,22,15477154245,446879523
1635657664,-180139,true,15033280928,22,15484894370,451613442
1635657679,-180132,true,15043807382,22,15483346036,439538654
1635657749,-180125,true,15054341207,22,15466324569,411983362
1635657778,-180123,true,15057352226,22,15464778092,407425866
1635657924,-180120,true,15061869883,22,15449321816,387451933
1635657934,-180113,true,15072416355,22,15449321816,376905461
1635658018,-180105,true,15084478510,22,15440055466,355576956
1635658040,-180102,true,15089004306,22,15438511615,349507309
1635658096,-180098,true,15095040813,22,15443143632,348102819
1635658250,-180089,true,15108631785,22,15453957076,345325291
1635658377,-180081,true,15120722922,22,15463231768,342508846
1635658582,-180079,true,15123747218,22,15469417989,345670771
1635658874,-180075,true,15129797624,22,15483346036,353548412
1635658982,-180067,true,15141905699,22,15477154245,335248546
1635659082,-180059,true,15154023464,22,15461685600,307662136
1635659099,-180057,true,15157054421,22,15453957076,296902655
1635659172,-180055,true,15160085983,22,15433880988,273795005
1635659182,-180050,true,15167667542,22,15430794674,263127132
1635659238,-180045,true,15175252893,22,15415372363,240119470
1635659261,-180044,true,15176770418,22,15409207756,232437338
1635659305,-180042,true,15179805924,22,15399965466,220159542
1635659504,-180037,true,15187397345,22,15364588014,177190669
1635659510,-180035,true,15190434976,22,15363051709,172616733
1635659607,-180035,true,15190434976,22,15347697103,157262127
1635659752,-180034,true,15191954020,22,15323161648,131207628
1635659780,-180030,true,15198031713,22,15318565619,120533906
1635659826,-180028,true,15201071471,22,15312439724,111368253
1635659892,-180028,true,15201071471,22,15301725303,100653832
1635659953,-180028,true,15201071471,22,15291018378,89946907
1635660033,-180024,true,15207152812,22,15283375162,76222350
1635660159,-180022,true,15210194395,22,15266573532,56379137
1635660222,-180022,true,15210194395,22,15258942535,48748140
1635660260,-180021,true,15211715414,22,15254365768,42650354
1635660341,-180018,true,15216279385,22,15237596029,21316644
1635660379,-180017,true,15217801013,22,15229979516,12178503
1635660482,-180017,true,15217801013,22,15211715414,-6085599
1635660584,-180018,true,15216279385,22,15181323905,-34955480
1635660653,-180016,true,15219322793,22,15161601992,-57720801
1635660694,-180015,true,15220844726,22,15149478166,-71366560
1635660780,-180016,true,15219322793,22,15128284795,-91037998
1635660923,-180016,true,15219322793,22,15101079735,-118243058
1635661022,-180015,true,15220844726,22,15070909264,-149935462
1635661048,-180014,true,15222366810,22,15066388896,-155977914
1635661095,-180014,true,15222366810,22,15057352226,-165014584
1635661116,-180014,true,15222366810,22,15054341207,-168025603
1635661164,-180010,true,15228456670,22,15048320975,-180135695
1635661205,-180008,true,15231502514,22,15046816294,-184686220
1635661224,-180007,true,15233025664,22,15045311763,-187713901
1635661290,-180008,true,15231502514,22,15037791363,-193711151
1635661520,-180001,true,15242167765,22,15090513206,-151654559
1635661566,-179999,true,15245216351,22,15102589843,-142626508
1635661647,-180002,true,15240643700,22,15120722922,-119920778
1635661786,-180001,true,15242167765,22,15144934232,-97233533
1635661854,-179993,true,15254365768,22,15161601992,-92763776
1635661889,-179992,true,15255891204,22,15172218297,-83672907
1635662000,-179996,true,15249790373,22,15198031713,-51758660
1635662061,-179996,true,15249790373,22,15207152812,-42637561
1635662127,-179993,true,15254365768,22,15217801013,-36564755
1635662271,-179992,true,15255891204,22,15225411436,-30479768
1635662432,-179998,true,15246740872,22,15214757909,-31982963
1635662457,-179998,true,15246740872,22,15213236586,-33504286
1635662479,-179994,true,15252840483,22,15213236586,-39603897
1635662520,-179994,true,15252840483,22,15211715414,-41125069
1635662534,-180001,true,15242167765,22,15208673527,-33494238
1635662577,-180000,true,15243691981,22,15208673527,-35018454
1635662926,-179995,true,15251315352,22,15219322793,-31992559
1635663058,-179993,true,15254365768,22,15239119788,-15245980
1635663233,-179997,true,15248265546,22,15260468429,12202883
1635663268,-179996,true,15249790373,22,15263520675,13730302
1635663424,-179990,true,15258942535,22,15277263340,18320805
1635663475,-179989,true,15260468429,22,15281846978,21378549
1635663526,-179991,true,15257416793,22,15298665417,41248624
1635663799,-179987,true,15263520675,22,15389189801,125669126
1635664126,-179979,true,15275735767,22,15467871202,192135435
1635664305,-179979,true,15275735767,22,15515893598,240157831
1635664353,-179981,true,15272681078,22,15528310658,255629580
1635664364,-179978,true,15277263340,22,15531416475,254153135
1635664501,-179971,true,15287960633,22,15536076366,248115733
1635664537,-179968,true,15292547480,22,15536076366,243528886
1635664588,-179971,true,15287960633,22,15536076366,248115733
1635664629,-179968,true,15292547480,22,15534522914,241975434
1635664858,-179962,true,15301725303,22,15523653096,221927793
1635664900,-179959,true,15306316279,22,15522100886,215784607
1635665189,-179964,true,15298665417,22,15509688792,211023375
1635665415,-179965,true,15297135703,22,15463231768,166096065
1635665494,-179960,true,15304785801,22,15447777038,142991237
1635665585,-179961,true,15303255475,22,15430794674,127539199
1635665803,-179968,true,15292547480,22,15390728720,98181240
1635666072,-179969,true,15291018378,22,15349231873,58213495
1635666103,-179964,true,15298665417,22,15346162487,47497070
1635666146,-179965,true,15297135703,22,15346162487,49026784
1635666227,-179968,true,15292547480,22,15349231873,56684393
1635666287,-179970,true,15289489429,22,15343093715,53604286
1635666340,-179966,true,15295606143,22,15336958011,41351868
1635666377,-179968,true,15292547480,22,15333891080,41343600
1635666434,-179973,true,15284903500,22,15327759057,42855557
1635666463,-179976,true,15280318946,22,15324693965,44375019
1635666619,-179974,true,15283375162,22,15304785801,21410639
1635666674,-179977,true,15278791067,22,15298665417,19874350
1635666695,-179982,true,15271153962,22,15295606143,24452181
1635666810,-179984,true,15268100190,22,15274208346,6108156
1635666867,-179981,true,15272681078,22,15271153962,-1527116
1635666909,-179983,true,15269627000,22,15269627000,0
1635666995,-179986,true,15265047028,22,15261994476,-3052552
1635667081,-179987,true,15263520675,22,15251315352,-12205323
1635667126,-179983,true,15269627000,22,15246740872,-22886128
1635667182,-179983,true,15269627000,22,15257416793,-12210207
1635667188,-179986,true,15265047028,22,15255891204,-9155824
1635667211,-179986,true,15265047028,22,15254365768,-10681260
1635667323,-179984,true,15268100190,22,15245216351,-22883839
1635667401,-179986,true,15265047028,22,15243691981,-21355047
1635667404,-179989,true,15260468429,22,15243691981,-16776448
1635667521,-179989,true,15260468429,22,15239119788,-21348641
1635667740,-179986,true,15265047028,22,15249790373,-15256655
1635667827,-179987,true,15263520675,22,15243691981,-19828694
1635667897,-179991,true,15257416793,22,15239119788,-18297005
1635667984,-179989,true,15260468429,22,15240643700,-19824729
1635668089,-179986,true,15265047028,22,15233025664,-32021364
1635668189,-179986,true,15265047028,22,15239119788,-25927240
1635668197,-179989,true,15260468429,22,15240643700,-19824729
1635668514,-179985,true,15266573532,22,15306316279,39742747
1635668638,-179980,true,15274208346,22,15318565619,44357273
1635668678,-179979,true,15275735767,22,15327759057,52023290
1635668803,-179982,true,15271153962,22,15338491707,67337745
1635669125,-179978,true,15277263340,22,15343093715,65830375
1635669214,-179973,true,15284903500,22,15330824762,45921262
1635669259,-179972,true,15286431990,22,15323161648,36729658
1635669293,-179974,true,15283375162,22,15312439724,29064562
1635669324,-179973,true,15284903500,22,15301725303,16821803
1635669335,-179968,true,15292547480,22,15301725303,9177823
1635669422,-179969,true,15291018378,22,15274208346,-16810032
1635669489,-179971,true,15287960633,22,15257416793,-30543840
1635669530,-179969,true,15291018378,22,15246740872,-44277506
1635669626,-179965,true,15297135703,22,15231502514,-65633189
1635669736,-179966,true,15295606143,22,15210194395,-85411748
1635669747,-179968,true,15292547480,22,15208673527,-83873953
1635669788,-179966,true,15295606143,22,15198031713,-97574430
1635669828,-179967,true,15294076735,22,15188916085,-105160650
1635669955,-179970,true,15289489429,22,15155538867,-133950562
1635670174,-179973,true,15284903500,22,15105610512,-179292988
1635670179,-179971,true,15287960633,22,15105610512,-182350121
1635670290,-179972,true,15286431990,22,15102589843,-183842147
1635670298,-179975,true,15281846978,22,15104100102,-177746876
1635670604,-179976,true,15280318946,22,15095040813,-185278133
1635670667,-179974,true,15283375162,22,15092022257,-191352905
1635670768,-179975,true,15281846978,22,15090513206,-191333772
1635671092,-179978,true,15277263340,22,15084478510,-192784830
1635671162,-179980,true,15274208346,22,15078446226,-195762120
1635671251,-179979,true,15275735767,22,15072416355,-203319412
1635671255,-179980,true,15274208346,22,15073923597,-200284749
1635671256,-179983,true,15269627000,22,15073923597,-195703403
1635671271,-179983,true,15269627000,22,15073923597,-195703403
1635671788,-179980,true,15274208346,22,15122234994,-151973352
1635671943,-179982,true,15271153962,22,15143419890,-127734072
1635671971,-179986,true,15265047028,22,15140391660,-124655368
1635672061,-179988,true,15261994476,22,15129797624,-132196852
1635672078,-179986,true,15265047028,22,15134337017,-130710011
1635672135,-179990,true,15258942535,22,15140391660,-118550875
1635672222,-179993,true,15254365768,22,15131310604,-123055164
1635672315,-179994,true,15252840483,22,15120722922,-132117561
1635672693,-179997,true,15248265546,22,15069402324,-178863222
1635672737,-180004,true,15237596029,22,15061869883,-175726146
1635672956,-180008,true,15231502514,22,15049825807,-181676707
1635673265,-180010,true,15228456670,22,15022761839,-205694831
1635673306,-180013,true,15223889047,22,15019757737,-204131310
1635673690,-180018,true,15216279385,22,15046816294,-169463091
1635673820,-180022,true,15210194395,22,15061869883,-148324512
1635673897,-180023,true,15208673527,22,15070909264,-137764263
1635673923,-180025,true,15205632249,22,15073923597,-131708652
1635674249,-180031,true,15196512062,22,15095040813,-101471249
1635674421,-180033,true,15193473215,22,15128284795,-65188420
1635674535,-180033,true,15193473215,22,15140391660,-53081555
1635674667,-180034,true,15191954020,22,15154023464,-37930556
1635674696,-180037,true,15187397345,22,15154023464,-33373881
1635674740,-180040,true,15182842037,22,15155538867,-27303170
1635674812,-180038,true,15185878757,22,15157054421,-28824336
1635674867,-180040,true,15182842037,22,15161601992,-21240045
1635674994,-180043,true,15178288095,22,15166150927,-12137168
1635675011,-180046,true,15173735519,22,15166150927,-7584592
1635675027,-180046,true,15173735519,22,15166150927,-7584592
1635675107,-180047,true,15172218297,22,15169184309,-3033988
1635675155,-180050,true,15167667542,22,15169184309,1516767
1635675251,-180053,true,15163118152,22,15146448725,-16669427
1635675291,-180049,true,15169184309,22,15150993114,-18191195
1635675403,-180049,true,15169184309,22,15160085983,-9098326
1635675512,-180052,true,15164634464,22,15141905699,-22728765
1635675529,-180054,true,15161601992,22,15138877772,-22724220
1635675558,-180051,true,15166150927,22,15134337017,-31813910
1635675586,-180054,true,15161601992,22,15126772118,-34829874
1635675661,-180059,true,15154023464,22,15111653662,-42369802
1635675914,-180062,true,15149478166,22,15072416355,-77061811
1635676036,-180059,true,15154023464,22,15076938532,-77084932
1635676059,-180062,true,15149478166,22,15075430989,-74047177
1635676113,-180066,true,15143419890,22,15075430989,-67988901
1635676251,-180070,true,15137364036,22,15016754236,-120609800
1635676293,-180070,true,15137364036,22,14998745839,-138618197
1635676317,-180074,true,15131310604,22,15000245713,-131064891
1635676347,-180076,true,15128284795,22,14998745839,-129538956
1635676507,-180076,true,15128284795,22,15000245713,-128039082
1635676584,-180075,true,15129797624,22,15000245713,-129551911
1635676603,-180079,true,15123747218,22,15000245713,-123501505
1635676736,-180083,true,15117699231,22,14997246114,-120453117
1635676911,-180084,true,15116187612,22,14977763335,-138424277
1635677088,-180083,true,15117699231,22,14979261111,-138438120
1635677137,-180088,true,15110142648,22,14985253715,-124888933
1635677353,-180090,true,15107121073,22,15010749036,-96372037
1635677370,-180090,true,15107121073,22,15013751336,-93369737
1635677836,-180084,true,15116187612,22,15188916085,72728473
1635677846,-180091,true,15105610512,22,15191954020,86343508
1635677881,-180092,true,15104100102,22,15199551516,95451414
1635677904,-180093,true,15102589843,22,15202591579,100001736
1635677995,-180091,true,15105610512,22,15216279385,110668873
1635678032,-180096,true,15098059972,22,15220844726,122784754
1635678220,-180098,true,15095040813,22,15216279385,121238572
1635678334,-180098,true,15095040813,22,15201071471,106030658
1635678385,-180096,true,15098059972,22,15190434976,92375004
1635678442,-180100,true,15092022257,22,15176770418,84748161
1635678479,-180100,true,15092022257,22,15169184309,77162052
1635678528,-180099,true,15093531460,22,15157054421,63522961
1635678736,-180098,true,15095040813,22,15098059972,3019159
1635678831,-180101,true,15090513206,22,15085986957,-4526249
1635678858,-180103,true,15087495556,22,15084478510,-3017046
1635679293,-180102,true,15089004306,22,15054341207,-34663099
1635679310,-180101,true,15090513206,22,15055846641,-34666565
1635679494,-180104,true,15085986957,22,15075430989,-10555968
1635679529,-180104,true,15085986957,22,15070909264,-15077693
1635679570,-180100,true,15092022257,22,15076938532,-15083725
1635679705,-180099,true,15093531460,22,15076938532,-16592928
1635679798,-180103,true,15087495556,22,15087495556,0
1635679893,-180103,true,15087495556,22,15096550317,9054761
1635680065,-180099,true,15093531460,22,15114676144,21144684
1635680427,-180099,true,15093531460,22,15122234994,28703534
1635680718,-180102,true,15089004306,22,15138877772,49873466
1635680858,-180102,true,15089004306,22,15143419890,54415584
1635680925,-180097,true,15096550317,22,15137364036,40813719
1635680936,-180097,true,15096550317,22,15135850451,39300134
1635680963,-180101,true,15090513206,22,15131310604,40797398
1635681014,-180103,true,15087495556,22,15120722922,33227366
1635681133,-180099,true,15093531460,22,15105610512,12079052
1635681180,-180099,true,15093531460,22,15101079735,7548275
1635681223,-180106,true,15082970213,22,15096550317,13580104
1635681347,-180108,true,15079954071,22,15082970213,3016142
1635681462,-180103,true,15087495556,22,15064882408,-22613148
1635681526,-180103,true,15087495556,22,15054341207,-33154349
1635681621,-180107,true,15081462066,22,15040799072,-40662994
1635681753,-180108,true,15079954071,22,15030274722,-49679349
1635681823,-180103,true,15087495556,22,15031777750,-55717806
1635681909,-180105,true,15084478510,22,15022761839,-61716671
1635682032,-180110,true,15076938532,22,15006246712,-70691820
1635682553,-180112,true,15073923597,22,14922450768,-151472829
1635682562,-180108,true,15079954071,22,14920958672,-158995399
1635682641,-180110,true,15076938532,22,14891148065,-185790467
1635682661,-180114,true,15070909264,22,14885193095,-185716169
1635682822,-180117,true,15066388896,22,14885193095,-181195801
1635682979,-180112,true,15073923597,22,14898595129,-175328468
1635683026,-180114,true,15070909264,22,14903065154,-167844110
1635683046,-180119,true,15063376070,22,14904555461,-158820609
1635683134,-180121,true,15060363847,22,14912009229,-148354618
1635683232,-180116,true,15067895535,22,14937379935,-130515600
1635683236,-180117,true,15066388896,22,14937379935,-129008961
1635683437,-180123,true,15057352226,22,14956810185,-100542041
1635683549,-180128,true,15049825807,22,14976265708,-73560099
1635683575,-180122,true,15058857961,22,14977763335,-81094626
1635683646,-180124,true,15055846641,22,14974768232,-81078409
1635683834,-180130,true,15046816294,22,14967283093,-79533201
1635683874,-180134,true,15040799072,22,14965786514,-75012558
1635684081,-180130,true,15046816294,22,14919466725,-127349569
1635684106,-180132,true,15043807382,22,14910518177,-133289205
1635684137,-180138,true,15034784256,22,14900084988,-134699268
1635684162,-180143,true,15027269118,22,14895615857,-131653261
1635684220,-180139,true,15033280928,22,14885193095,-148087833
1635684373,-180141,true,15030274722,22,14864369446,-165905276
1635684617,-180149,true,15018255912,22,14843574928,-174680984
1635684640,-180153,true,15012250111,22,14836155366,-176094745
1635684771,-180149,true,15018255912,22,14827256788,-190999124
1635684792,-180150,true,15016754236,22,14830222388,-186531848
1635684844,-180155,true,15009248111,22,14834671899,-174576212
1635684901,-180156,true,15007747336,22,14839122746,-168624590
1635684945,-180153,true,15012250111,22,14834671899,-177578212
1635685039,-180157,true,15006246712,22,14828739514,-177507198
1635685075,-180162,true,14998745839,22,14825774210,-172971629
1635685181,-180165,true,14994247115,22,14815400319,-178846796
1635685200,-180161,true,15000245713,22,14813918927,-186326786
1635685252,-180161,true,15000245713,22,14819845383,-180400330
1635685472,-180164,true,14995746540,22,14846543791,-149202749
1635685524,-180165,true,14994247115,22,14850998200,-143248915
1635685620,-180164,true,14995746540,22,14859911027,-135835513
1635685658,-180163,true,14997246114,22,14858425184,-138820930
1635685705,-180167,true,14991248715,22,14856939490,-134309225
1635686023,-180169,true,14988250915,22,14873290297,-114960618
1635686123,-180168,true,14989749740,22,14867342468,-122407272
1635686358,-180169,true,14988250915,22,14809475640,-178775275
1635686374,-180174,true,14980759037,22,14806514189,-174244848
1635686613,-180180,true,14971773727,22,14731196954,-240576773
1635686617,-180180,true,14971773727,22,14729723982,-242049745
1635686677,-180190,true,14956810185,22,14695886237,-260923948
1635686704,-180195,true,14949334022,22,14682666550,-266667472
1635686756,-180209,true,14928420643,22,14656262841,-272157802
1635686852,-180210,true,14926927950,22,14602137568,-324790382
1635686869,-180215,true,14919466725,22,14590461113,-329005612
1635686916,-180221,true,14910518177,22,14555487740,-355030437
1635686985,-180235,true,14889659099,22,14516242890,-373416209
1635687004,-180237,true,14886681614,22,14504635119,-382046495
1635687092,-180241,true,14880728430,22,14471314458,-409413972
1635687140,-180245,true,14874777626,22,14452514912,-422262714
1635687150,-180258,true,14855453945,22,14446735351,-408718594
1635687154,-180260,true,14852483300,22,14443846437,-408636863
1635687385,-180270,true,14837638982,22,14292986990,-544651992
1635687400,-180276,true,14828739514,22,14281557744,-547181770
1635687411,-180289,true,14809475640,22,14277274134,-532201506
1635687444,-180290,true,14807994840,22,14265857453,-542137387
1635687538,-180296,true,14799113152,22,14234508630,-564604522
1635687577,-180303,true,14788757915,22,14225970913,-562787002
1635687625,-180315,true,14771022936,22,14223126146,-547896790
1635687630,-180318,true,14766592515,22,14223126146,-543466369
1635687632,-180322,true,14760687354,22,14223126146,-537561208
1635687718,-180324,true,14757735660,22,14233085321,-524650339
1635687722,-180336,true,14740037882,22,14233085321,-506952561
1635687732,-180338,true,14737090317,22,14235932081,-501158236
1635687742,-180343,true,14729723982,22,14237355674,-492368308
1635687777,-180343,true,14729723982,22,14248749546,-480974436
1635687859,-180357,true,14709117826,22,14265857453,-443260373
1635687978,-180357,true,14709117826,22,14305855825,-403262001
1635688034,-180363,true,14700295444,22,14308717139,-391578305
1635688090,-180362,true,14701765473,22,14328762369,-373003104
1635688188,-180372,true,14687071791,22,14373248226,-313823565
1635688278,-180373,true,14685603230,22,14414989054,-270614176
1635688561,-180376,true,14681198430,22,14536578845,-144619585
1635688597,-180375,true,14682666550,22,14538032503,-144634047
1635688598,-180385,true,14667991956,22,14538032503,-129959453
1635688605,-180386,true,14666525303,22,14540940254,-125585049
1635688615,-180390,true,14660660159,22,14543848588,-116811571
1635688694,-180381,true,14673860033,22,14575878674,-97981359
1635688828,-180392,true,14657728467,22,14622593854,-35134613
1635688906,-180395,true,14653332028,22,14621131741,-32200287
1635689002,-180397,true,14650401801,22,14669458755,19056954
1635689067,-180387,true,14665058797,22,14698825561,33766764
1635689120,-180395,true,14653332028,22,14722361329,69029301
1635689187,-180395,true,14653332028,22,14748884117,95552089
1635689462,-180398,true,14648936907,22,14802073123,153136216
1635689520,-180388,true,14663592438,22,14818363547,154771109
1635689595,-180397,true,14650401801,22,14816881859,166480058
1635689670,-180398,true,14648936907,22,14806514189,157577282
1635689672,-180403,true,14641614636,22,14806514189,164899553
1635689898,-180395,true,14653332028,22,14791715815,138383787
1635689948,-180405,true,14638686752,22,14779887765,141201013
1635689970,-180408,true,14634296024,22,14773977288,139681264
1635690033,-180414,true,14625518519,22,14760687354,135168835
1635690085,-180405,true,14638686752,22,14751834041,113147289
1635690181,-180412,true,14628443769,22,14760687354,132243585
1635690224,-180413,true,14626981071,22,14762163423,135182352
1635690269,-180417,true,14621131741,22,14765116003,143984262
1635690420,-180407,true,14635759454,22,14771022936,135263482
1635690552,-180414,true,14625518519,22,14779887765,154369246
1635690646,-180414,true,14625518519,22,14788757915,163239396
1635690777,-180419,true,14618207953,22,14800593063,182385110
1635690805,-180407,true,14635759454,22,14802073123,166313669
1635690868,-180414,true,14625518519,22,14810956587,185438068
1635690923,-180415,true,14624056113,22,14815400319,191344206
1635690942,-180420,true,14616746278,22,14818363547,201617269
1635690963,-180409,true,14632832741,22,14822809500,189976759
1635690998,-180414,true,14625518519,22,14828739514,203220995
1635691236,-180413,true,14626981071,22,14842090719,215109648
1635691276,-180418,true,14619669774,22,14849513248,229843474
1635691290,-180406,true,14637223030,22,14856939490,219716460
1635691334,-180411,true,14629906613,22,14876265104,246358491
1635691358,-180403,true,14641614636,22,14886681614,245066978
1635691563,-180401,true,14644543105,22,15010749036,366205931
1635691568,-180389,true,14662126225,22,15013751336,351625111
1635691723,-180389,true,14662126225,22,15163118152,500991927
1635691808,-180380,true,14675327419,22,15245216351,569888932
1635692043,-180379,true,14676794951,22,15387651036,710856085
1635692089,-180369,true,14691478353,22,15415372363,723894010
1635692140,-180372,true,14687071791,22,15446232415,759160624
1635692218,-180364,true,14698825561,22,15472512027,773686466
1635692221,-180363,true,14700295444,22,15472512027,772216583
1635692233,-180352,true,14716473856,22,15475606684,759132828
1635692256,-180355,true,14712059797,22,15477154245,765094448
1635692309,-180348,true,14722361329,22,15475606684,753245355
1635692427,-180345,true,14726778479,22,15486442860,759664381
1635692480,-180334,true,14742986037,22,15477154245,734168208
1635692496,-180334,true,14742986037,22,15470964931,727978894
1635692576,-180327,true,14753309224,22,15443143632,689834408
1635692592,-180322,true,14760687354,22,15433880988,673193634
1635692712,-180315,true,14771022936,22,15349231873,578208937
1635692877,-180310,true,14778409924,22,15294076735,515666811
1635692901,-180304,true,14787279187,22,15286431990,499152803
1635693035,-180297,true,14797633389,22,15249790373,452156984
1635693093,-180288,true,14810956587,22,15234548967,423592380
1635693107,-180281,true,14821327368,22,15231502514,410175146
1635693117,-180273,true,14833188580,22,15228456670,395268090
1635693181,-180269,true,14839122746,22,15216279385,377156639
1635693273,-180262,true,14849513248,22,15190434976,340921728
1635693289,-180255,true,14859911027,22,15187397345,327486318
1635693312,-180247,true,14871803117,22,15185878757,314075640
1635693355,-180235,true,14889659099,22,15184360321,294701222
1635693474,-180224,true,14906045916,22,15181323905,275277989
1635693580,-180217,true,14916483279,22,15213236586,296753307
1635693753,-180210,true,14926927950,22,15249790373,322862423
1635693883,-180201,true,14940367561,22,15268100190,327732629
1635693915,-180190,true,14956810185,22,15271153962,314343777
1635693984,-180185,true,14964290085,22,15278791067,314500982
1635694080,-180177,true,14976265708,22,15297135703,320869995
1635694270,-180168,true,14989749740,22,15321629485,331879745
1635694291,-180161,true,15000245713,22,15326226434,325980721
1635694371,-180154,true,15010749036,22,15355372487,344623451
1635694526,-180145,true,15024264115,22,15404585918,380321803
1635694637,-180131,true,15045311763,22,15474059279,428747516
1635694665,-180125,true,15054341207,22,15501936273,447595066
1635694816,-180111,true,15075430989,22,15637384693,561953704
1635694991,-180099,true,15093531460,22,15785061720,691530260
1635695079,-180083,true,15117699231,22,15857836619,740137388
1635695114,-180077,true,15126772118,22,15886405000,759632882
1635695119,-180065,true,15144934232,22,15891171399,746237167
1635695144,-180051,true,15166150927,22,15911842321,745691394
1635695150,-180038,true,15185878757,22,15916616351,730737594
1635695193,-180031,true,15196512062,22,15948479843,751967781
1635695293,-180023,true,15208673527,22,15982005164,773331637
1635695307,-180011,true,15226933977,22,15986800245,759866268
1635695420,-179997,true,15248265546,22,16028417925,780152379
1635695431,-179998,true,15246740872,22,16036433737,789692865
1635695470,-179989,true,15260468429,22,16044453557,783985128
1635695529,-179974,true,15283375162,22,16055688045,772312883
1635695563,-179959,true,15306316279,22,16052477389,746161110
1635695587,-179961,true,15303255475,22,16050872301,747616826
1635695663,-179950,true,15320097476,22,16062111283,742013807
1635695693,-179936,true,15341559559,22,16066930398,725370839
1635695720,-179919,true,15367661085,22,16066930398,699269313
1635695725,-179920,true,15366124473,22,16066930398,700805925
1635696114,-179908,true,15384573967,22,16144233178,759659211
1635696146,-179893,true,15407666989,22,16157153085,749486096
1635696178,-179876,true,15433880988,22,16170083333,736202345
1635696357,-179875,true,15435424376,22,16236513442,801089066
1635696412,-179861,true,15457048022,22,16251132150,794084128
1635696513,-179846,true,15480249831,22,16283665310,803415479
1635696517,-179828,true,15508137978,22,16283665310,775527332
1635696542,-179825,true,15512790885,22,16290179753,777388868
1635696568,-179813,true,15531416475,22,16295067296,763650821
1635696594,-179798,true,15554729915,22,16299956305,745226390
1635696614,-179781,true,15581194121,22,16306477266,725283145
1635696682,-179783,true,15578078350,22,16301586301,723507951
1635696830,-179774,true,15592104230,22,16272271303,680167073
1635696928,-179759,true,15615508765,22,16262511356,647002591
1635697043,-179744,true,15638948431,22,16225152427,586203996
1635697130,-179746,true,15635821111,22,16194355444,558534333
1635697204,-179738,true,15648334146,22,16166849801,518515655
1635697502,-179725,true,15668689191,22,16001194122,332504931
1635697542,-179710,true,15692208684,22,15983603365,291394681
1635697575,-179714,true,15685933370,22,15972419316,286485946
1635697890,-179707,true,15696916817,22,15895939227,199022410
1635697924,-179696,true,15714192062,22,15897528821,183336759
1635697937,-179682,true,15736206236,22,15897528821,161322585
1635698010,-179685,true,15731486319,22,15902298556,170812237
1635698039,-179677,true,15744075913,22,15903888786,159812873
1635698060,-179672,true,15751949526,22,15903888786,151939260
1635698152,-179663,true,15766131952,22,15908660430,142528478
1635698170,-179667,true,15759827076,22,15911842321,152015245
1635698234,-179662,true,15767708566,22,15922983953,155275387
1635698282,-179658,true,15774016595,22,15930947037,156930442
1635698385,-179649,true,15788218890,22,15946885155,158666265
1635698630,-179654,true,15780327148,22,15964435502,184108354
1635698734,-179648,true,15789797712,22,15967628549,177830837
1635698772,-179644,true,15796114578,22,15969225312,173110734
1635698815,-179635,true,15810336770,22,15966031946,155695176
1635698941,-179641,true,15800853887,22,15951669699,150815812
1635698977,-179634,true,15811917803,22,15948479843,136562040
1635699054,-179628,true,15821407326,22,15935726799,114319473
1635699137,-179622,true,15830902544,22,15913433505,82530961
1635699140,-179628,true,15821407326,22,15913433505,92026179
1635699166,-179621,true,15832485634,22,15910251296,77765662
1635699310,-179614,true,15843571700,22,15895939227,52367527
1635699324,-179605,true,15857836619,22,15894349792,36513173
1635699642,-179607,true,15854665527,22,15867353700,12688173
1635699948,-179599,true,15867353700,22,15875288964,7935264
1635699972,-179591,true,15880052027,22,15880052027,0
1635700037,-179582,true,15894349792,22,15892760516,-1589276
1635700066,-179585,true,15889582440,22,15894349792,4767352
1635700194,-179580,true,15897528821,22,15878464180,-19064641
1635700617,-179576,true,15903888786,22,15770862265,-133026521
1635700649,-179568,true,15916616351,22,15761403059,-155213292
1635700759,-179570,true,15913433505,22,15726767816,-186665689
1635700805,-179566,true,15919799833,22,15712620800,-207179033
1635700856,-179563,true,15924576251,22,15696916817,-227659434
1635700903,-179557,true,15934133386,22,15678092755,-256040631
1635700998,-179562,true,15926168709,22,15643640585,-282528124
1635701085,-179559,true,15930947037,22,15607703352,-323243685
1635701119,-179557,true,15934133386,22,15598342007,-335791379
1635701180,-179551,true,15943696256,22,15584310516,-359385740
1635701226,-179558,true,15932540132,22,15573405861,-359134271
1635701343,-179557,true,15934133386,22,15532969617,-401163769
1635701492,-179556,true,15935726799,22,15481797856,-453928943
1635701677,-179553,true,15940507995,22,15396885935,-543622060
1635701714,-179561,true,15927761326,22,15379959518,-547801808
1635701755,-179562,true,15926168709,22,15361515557,-564653152
1635701836,-179564,true,15922983953,22,15323161648,-599822305
1635701896,-179567,true,15918208013,22,15301725303,-616482710
1635701926,-179576,true,15903888786,22,15294076735,-609812051
1635702079,-179582,true,15894349792,22,15251315352,-643034440
1635702273,-179590,true,15881640032,22,15211715414,-669924618
1635702278,-179594,true,15875288964,22,15210194395,-665094569
1635702444,-179603,true,15861008345,22,15179805924,-681202421
1635702468,-179610,true,15849910079,22,15176770418,-673139661
1635702532,-179617,true,15838819578,22,15179805924,-659013654
1635702581,-179620,true,15834068883,22,15181323905,-652744978
1635702676,-179629,true,15819825343,22,15184360321,-635465022
1635702681,-179632,true,15815080345,22,15184360321,-630720024
1635702719,-179639,true,15804014216,22,15187397345,-616616871
1635702809,-179641,true,15800853887,22,15187397345,-613456542
1635702862,-179649,true,15788218890,22,15188916085,-599302805
1635702895,-179653,true,15781905181,22,15190434976,-591470205
1635702908,-179661,true,15769285336,22,15191954020,-577331316
1635702965,-179666,true,15761403059,22,15194992563,-566410496
1635702995,-179673,true,15750374488,22,15196512062,-553862426
1635703019,-179679,true,15740927570,22,15198031713,-542895857
1635703257,-179688,true,15726767816,22,15228456670,-498311146
1635703281,-179694,true,15717335057,22,15228456670,-488878387
1635703406,-179703,true,15703196526,22,15223889047,-479307479
1635703420,-179710,true,15692208684,22,15220844726,-471363958
1635703444,-179721,true,15674957607,22,15217801013,-457156594
1635703662,-179729,true,15662423282,22,15164634464,-497788818
1635703757,-179739,true,15646769470,22,15138877772,-507891698
1635703819,-179747,true,15634257685,22,15120722922,-513534763
1635703872,-179759,true,15615508765,22,15107121073,-508387692
1635703893,-179768,true,15601461831,22,15102589843,-498871988
1635703977,-179780,true,15582752241,22,15076938532,-505813709
1635704000,-179788,true,15570291647,22,15070909264,-499382383
1635704044,-179801,true,15550064429,22,15055846641,-494217788
1635704067,-179810,true,15536076366,22,15048320975,-487755391
1635704140,-179819,true,15522100886,22,15021259713,-500841173
1635704167,-179824,true,15514342164,22,15012250111,-502092053
1635704259,-179836,true,15495737049,22,15006246712,-489490337
1635704264,-179842,true,15486442860,22,15006246712,-480196148
1635704272,-179849,true,15475606684,22,15007747336,-467859348
1635704356,-179850,true,15474059279,22,15019757737,-454301542
1635704485,-179856,true,15464778092,22,15049825807,-414952285
1635704496,-179862,true,15455502472,22,15046816294,-408686178
1635704596,-179870,true,15443143632,22,15055846641,-387296991
1635704760,-179872,true,15440055466,22,15075430989,-364624477
1635704852,-179879,true,15429251749,22,15085986957,-343264792
1635704875,-179886,true,15418455592,22,15089004306,-329451286
1635704968,-179894,true,15406126376,22,15099569778,-306556598
1635705028,-179899,true,15398425623,22,15110142648,-288282975
1635705383,-179906,true,15387651036,22,15084478510,-303172526
1635705412,-179912,true,15378421676,22,15087495556,-290926120
1635705456,-179920,true,15366124473,22,15085986957,-280137516
1635705554,-179926,true,15356908024,22,15081462066,-275445958
1635705623,-179934,true,15344628024,22,15081462066,-263165958
1635705711,-179940,true,15335424469,22,15076938532,-258485937
1635705758,-179947,true,15324693965,22,15073923597,-250770368
1635705808,-179951,true,15318565619,22,15078446226,-240119393
1635705881,-179959,true,15306316279,22,15079954071,-226362208
1635706182,-179964,true,15298665417,22,15090513206,-208152211
1635706186,-179970,true,15289489429,22,15090513206,-198976223
1635706280,-179975,true,15281846978,22,15090513206,-191333772
1635706295,-179981,true,15272681078,22,15090513206,-182167872
1635706415,-179987,true,15263520675,22,15092022257,-171498418
1635706429,-179992,true,15255891204,22,15092022257,-163868947
1635706441,-179997,true,15248265546,22,15092022257,-156243289
1635706471,-180005,true,15236072421,22,15090513206,-145559215
1635706497,-180012,true,15225411436,22,15089004306,-136407130
1635706520,-180017,true,15217801013,22,15087495556,-130305457
1635706589,-180018,true,15216279385,22,15107121073,-109158312
1635706899,-180022,true,15210194395,22,15193473215,-16721180
1635707047,-180028,true,15201071471,22,15228456670,27385199
1635707101,-180034,true,15191954020,22,15240643700,48689680
1635707137,-180034,true,15191954020,22,15242167765,50213745
1635707591,-180037,true,15187397345,22,15228456670,41059325
1635707707,-180044,true,15176770418,22,15199551516,22781098
1635707780,-180049,true,15169184309,22,15179805924,10621615
1635707960,-180049,true,15169184309,22,15150993114,-18191195
1635708058,-180051,true,15166150927,22,15155538867,-10612060
1635708146,-180057,true,15157054421,22,15167667542,10613121
1635708172,-180061,true,15150993114,22,15170701227,19708113
1635708279,-180057,true,15157054421,22,15185878757,28824336
1635708334,-180059,true,15154023464,22,15191954020,37930556
1635708375,-180064,true,15146448725,22,15194992563,48543838
1635708383,-180066,true,15143419890,22,15194992563,51572673
1635708399,-180062,true,15149478166,22,15196512062,47033896
1635708411,-180063,true,15147963370,22,15198031713,50068343
1635708720,-180065,true,15144934232,22,15234548967,89614735
1635708850,-180067,true,15141905699,22,15240643700,98738001
1635709007,-180063,true,15147963370,22,15233025664,85062294
1635709025,-180062,true,15149478166,22,15233025664,83547498
1635709041,-180065,true,15144934232,22,15233025664,88091432
1635709091,-180067,true,15141905699,22,15229979516,88073817
1635709197,-180061,true,15150993114,22,15229979516,78986402
1635709201,-180060,true,15152508213,22,15229979516,77471303
1635709207,-180063,true,15147963370,22,15229979516,82016146
1635709211,-180064,true,15146448725,22,15229979516,83530791
1635709244,-180061,true,15150993114,22,15225411436,74418322
1635709267,-180063,true,15147963370,22,15219322793,71359423
1635709428,-180069,true,15138877772,22,15166150927,27273155
1635709524,-180073,true,15132823735,22,15135850451,3026716
1635709543,-180070,true,15137364036,22,15129797624,-7566412
1635709754,-180072,true,15134337017,22,15063376070,-70960947
1635709811,-180078,true,15125259592,22,15046816294,-78443298
1635709891,-180081,true,15120722922,22,15021259713,-99463209
1635710034,-180079,true,15123747218,22,14970276699,-153470519
1635710167,-180081,true,15120722922,22,14931406477,-189316445
1635710272,-180087,true,15111653662,22,14926927950,-184725712
1635710461,-180091,true,15105610512,22,14917974928,-187635584
1635710529,-180089,true,15108631785,22,14916483279,-192148506
1635710538,-180092,true,15104100102,22,14916483279,-187616823
1635710840,-180098,true,15095040813,22,14900084988,-194955825
1635710930,-180100,true,15092022257,22,14900084988,-191937269
1635711123,-180098,true,15095040813,22,14904555461,-190485352
1635711226,-180098,true,15095040813,22,14920958672,-174082141
1635711522,-180100,true,15092022257,22,14971773727,-120248530
1635711722,-180100,true,15092022257,22,15010749036,-81273221
1635711724,-180097,true,15096550317,22,15012250111,-84300206
1635711815,-180096,true,15098059972,22,15025766542,-72293430
1635711892,-180096,true,15098059972,22,15058857961,-39202011
1635711947,-180094,true,15101079735,22,15081462066,-19617669
1635712020,-180090,true,15107121073,22,15111653662,4532589
1635712028,-180087,true,15111653662,22,15114676144,3022482
1635712079,-180086,true,15113164828,22,15131310604,18145776
1635712112,-180083,true,15117699231,22,15141905699,24206468
1635712330,-180078,true,15125259592,22,15210194395,84934803
1635712347,-180076,true,15128284795,22,15214757909,86473114
1635712449,-180077,true,15126772118,22,15229979516,103207398
1635712510,-180076,true,15128284795,22,15237596029,109311234
1635712541,-180076,true,15128284795,22,15240643700,112358905
1635712583,-180078,true,15125259592,22,15245216351,119956759
1635712665,-180079,true,15123747218,22,15252840483,129093265
1635712720,-180077,true,15126772118,22,15258942535,132170417
1635712743,-180076,true,15128284795,22,15254365768,126080973
1635712765,-180075,true,15129797624,22,15251315352,121517728
1635713007,-180077,true,15126772118,22,15202591579,75819461
1635713393,-180075,true,15129797624,22,15149478166,19680542
1635713543,-180074,true,15131310604,22,15143419890,12109286
1635713664,-180073,true,15132823735,22,15170701227,37877492
1635713710,-180074,true,15131310604,22,15181323905,50013301
1635713727,-180070,true,15137364036,22,15181323905,43959869
1635713913,-180068,true,15140391660,22,15193473215,53081555
1635713950,-180068,true,15140391660,22,15194992563,54600903
1635714114,-180070,true,15137364036,22,15201071471,63707435
1635714310,-180066,true,15143419890,22,15208673527,65253637
1635714468,-180065,true,15144934232,22,15214757909,69823677
1635714478,-180065,true,15144934232,22,15213236586,68302354
1635714543,-180067,true,15141905699,22,15202591579,60685880
1635714703,-180064,true,15146448725,22,15193473215,47024490
1635714793,-180062,true,15149478166,22,15196512062,47033896
1635714844,-180063,true,15147963370,22,15191954020,43990650
1635714961,-180065,true,15144934232,22,15179805924,34871692
1635715105,-180062,true,15149478166,22,15163118152,13639986
1635715137,-180061,true,15150993114,22,15161601992,10608878
1635715155,-180062,true,15149478166,22,15157054421,7576255
1635715220,-180064,true,15146448725,22,15143419890,-3028835
1635715274,-180062,true,15149478166,22,15132823735,-16654431
1635715333,-180066,true,15143419890,22,15120722922,-22696968
1635715397,-180071,true,15135850451,22,15105610512,-30239939
1635715462,-180074,true,15131310604,22,15092022257,-39288347
1635715503,-180073,true,15132823735,22,15081462066,-51361669
1635715667,-180076,true,15128284795,22,15040799072,-87485723
1635715761,-180077,true,15126772118,22,15024264115,-102508003
1635715842,-180079,true,15123747218,22,15009248111,-114499107
1635715879,-180077,true,15126772118,22,15006246712,-120525406
1635716309,-180081,true,15120722922,22,14973270904,-147452018
1635716374,-180083,true,15117699231,22,14970276699,-147422532
1635716558,-180087,true,15111653662,22,14961297676,-150355986
1635716563,-180085,true,15114676144,22,14961297676,-153378468
1635716705,-180088,true,15110142648,22,14988250915,-121891733
1635716756,-180090,true,15107121073,22,14998745839,-108375234
1635716885,-180087,true,15111653662,22,15052835923,-58817739
1635716964,-180085,true,15114676144,22,15084478510,-30197634
1635717058,-180087,true,15111653662,22,15108631785,-3021877
1635717072,-180087,true,15111653662,22,15111653662,0
1635717094,-180087,true,15111653662,22,15117699231,6045569
1635717242,-180087,true,15111653662,22,15152508213,40854551
1635717268,-180088,true,15110142648,22,15160085983,49943335
1635717316,-180090,true,15107121073,22,15163118152,55997079
1635717441,-180091,true,15105610512,22,15170701227,65090715
1635717498,-180092,true,15104100102,22,15167667542,63567440
1635717627,-180095,true,15099569778,22,15150993114,51423336
1635717796,-180097,true,15096550317,22,15096550317,0
1635717908,-180098,true,15095040813,22,15066388896,-28651917
1635717947,-180099,true,15093531460,22,15063376070,-30155390
1635718017,-180098,true,15095040813,22,15060363847,-34676966
1635718038,-180096,true,15098059972,22,15060363847,-37696125
1635718080,-180092,true,15104100102,22,15058857961,-45242141
1635718245,-180093,true,15102589843,22,15066388896,-36200947
1635718300,-180092,true,15104100102,22,15067895535,-36204567
1635718341,-180090,true,15107121073,22,15082970213,-24150860
1635718380,-180086,true,15113164828,22,15096550317,-16614511
1635718612,-180083,true,15117699231,22,15175252893,57553662
1635718921,-180082,true,15119211001,22,15231502514,112291513
1635718954,-180079,true,15123747218,22,15234548967,110801749
1635718978,-180075,true,15129797624,22,15236072421,106274797
1635719008,-180073,true,15132823735,22,15239119788,106296053
1635719053,-180073,true,15132823735,22,15239119788,106296053
1635719214,-180068,true,15140391660,22,15274208346,133816686
1635719281,-180063,true,15147963370,22,15274208346,126244976
1635719302,-180061,true,15150993114,22,15277263340,126270226
1635719327,-180060,true,15152508213,22,15281846978,129338765
1635719510,-180053,true,15163118152,22,15312439724,149321572
1635719545,-180049,true,15169184309,22,15321629485,152445176
1635719612,-180048,true,15170701227,22,15327759057,157057830
1635719672,-180049,true,15169184309,22,15333891080,164706771
1635719683,-180044,true,15176770418,22,15335424469,158654051
1635719705,-180042,true,15179805924,22,15336958011,157152087
1635719796,-180042,true,15179805924,22,15363051709,183245785
1635719887,-180042,true,15179805924,22,15390728720,210922796
1635719889,-180039,true,15184360321,22,15392267793,207907472
1635720109,-180035,true,15190434976,22,15481797856,291362880
1635720133,-180034,true,15191954020,22,15489540303,297586283
1635720164,-180033,true,15193473215,22,15500386235,306913020
1635720358,-180030,true,15198031713,22,15531416475,333384762
1635720558,-180025,true,15205632249,22,15581194121,375561872
1635720654,-180024,true,15207152812,22,15599901841,392749029
1635720656,-180021,true,15211715414,22,15601461831,389746417
1635720887,-180017,true,15217801013,22,15612386131,394585118
1635721055,-180012,true,15225411436,22,15606142738,380731302
1635721088,-180011,true,15226933977,22,15606142738,379208761
1635721115,-180007,true,15233025664,22,15606142738,373117074
1635721117,-180004,true,15237596029,22,15606142738,368546709
1635721152,-179999,true,15245216351,22,15604582280,359365929
1635721272,-179998,true,15246740872,22,15601461831,354720959
1635721296,-179994,true,15252840483,22,15599901841,347061358
1635721457,-179992,true,15255891204,22,15596782329,340891125
1635721506,-179987,true,15263520675,22,15595222806,331702131
1635721686,-179987,true,15263520675,22,15593663440,330142765
1635721716,-179985,true,15266573532,22,15593663440,327089908
1635721840,-179982,true,15271153962,22,15570291647,299137685
1635722020,-179978,true,15277263340,22,15536076366,258813026
1635722225,-179980,true,15274208346,22,15503486467,229278121
1635722228,-179977,true,15278791067,22,15503486467,224695400
1635722287,-179975,true,15281846978,22,15492638366,210791388
1635722303,-179971,true,15287960633,22,15489540303,201579670
1635722371,-179974,true,15283375162,22,15474059279,190684117
1635722440,-179972,true,15286431990,22,15455502472,169070482
1635722489,-179969,true,15291018378,22,15450866748,159848370
1635722582,-179963,true,15300195283,22,15443143632,142948349
1635722619,-179963,true,15300195283,22,15438511615,138316332
1635722638,-179960,true,15304785801,22,15440055466,135269665
1635722720,-179956,true,15310908634,22,15446232415,135323781
1635722729,-179950,true,15320097476,22,15447777038,127679562
1635722786,-179949,true,15321629485,22,15453957076,132327591
1635722861,-179944,true,15329291832,22,15464778092,135486260
1635723078,-179940,true,15335424469,22,15494187630,158763161
1635723128,-179933,true,15346162487,22,15501936273,155773786
1635723140,-179932,true,15347697103,22,15505036815,157339712
1635723227,-179927,true,15355372487,22,15518996932,163624445
1635723418,-179922,true,15363051709,22,15554729915,191678206
1635723450,-179915,true,15373809072,22,15557841017,184031945
1635724081,-179914,true,15375346453,22,15582752241,207405788
1635724360,-179908,true,15384573967,22,15601461831,216887864
1635724896,-179903,true,15392267793,22,15631131302,238863509
1635724919,-179896,true,15403045613,22,15632694415,229648802
1635724929,-179894,true,15406126376,22,15634257685,228131309
1635725059,-179890,true,15412289751,22,15643640585,231350834
1635725184,-179884,true,15421539437,22,15643640585,222101148
1635725219,-179883,true,15423081591,22,15637384693,214303102
1635725258,-179883,true,15423081591,22,15631131302,208049711
1635725284,-179881,true,15426166362,22,15626442901,200276539
1635725342,-179880,true,15427708978,22,15607703352,179994374
1635725511,-179880,true,15427708978,22,15548509578,120800600
1635725525,-179878,true,15430794674,22,15542291729,111497055
1635725584,-179876,true,15433880988,22,15528310658,94429670
1635725636,-179874,true,15436967918,22,15515893598,78925680
1635725771,-179870,true,15443143632,22,15481797856,38654224
1635725897,-179867,true,15447777038,22,15449321816,1544778
1635726045,-179864,true,15452411835,22,15412289751,-40122084
1635726080,-179862,true,15455502472,22,15404585918,-50916554
1635726186,-179858,true,15461685600,22,15398425623,-63259977
1635726236,-179855,true,15466324569,22,15404585918,-61738651
1635726533,-179853,true,15469417989,22,15427708978,-41709011
1635726757,-179852,true,15470964931,22,15427708978,-43255953
1635726808,-179850,true,15474059279,22,15426166362,-47892917
1635727162,-179847,true,15478701961,22,15415372363,-63329598
1635727249,-179844,true,15483346036,22,15413830980,-69515056
1635727269,-179844,true,15483346036,22,15415372363,-67973673
1635727303,-179843,true,15484894370,22,15416913901,-67980469
1635727341,-179842,true,15486442860,22,15418455592,-67987268
1635727372,-179839,true,15491089257,22,15418455592,-72633665
1635727397,-179839,true,15491089257,22,15419997438,-71091819
1635727405,-179837,true,15494187630,22,15419997438,-74190192
1635727521,-179835,true,15497286622,22,15426166362,-71120260
1635727612,-179831,true,15503486467,22,15432337754,-71148713
1635727759,-179833,true,15500386235,22,15443143632,-57242603
1635727899,-179832,true,15501936273,22,15440055466,-61880807
1635727959,-179831,true,15503486467,22,15438511615,-64974852
1635727975,-179829,true,15506587319,22,15438511615,-68075704
1635727992,-179834,true,15498836351,22,15436967918,-61868433
1635728165,-179835,true,15497286622,22,15432337754,-64948868
1635728250,-179833,true,15500386235,22,15427708978,-72677257
1635728284,-179829,true,15506587319,22,15426166362,-80420957
1635728465,-179833,true,15500386235,22,15412289751,-88096484
1635728686,-179833,true,15500386235,22,15395346400,-105039835
1635728832,-179833,true,15500386235,22,15396885935,-103500300
1635728896,-179831,true,15503486467,22,15396885935,-106600532
1635728907,-179835,true,15497286622,22,15396885935,-100400687
1635728985,-179838,true,15492638366,22,15396885935,-95752431
1635729129,-179840,true,15489540303,22,15390728720,-98811583
1635729137,-179839,true,15491089257,22,15389189801,-101899456
1635729176,-179843,true,15484894370,22,15387651036,-97243334
1635729220,-179845,true,15481797856,22,15389189801,-92608055
1635729238,-179846,true,15480249831,22,15389189801,-91060030
1635729348,-179845,true,15481797856,22,15392267793,-89530063
1635729355,-179848,true,15477154245,22,15392267793,-84886452
1635729519,-179850,true,15474059279,22,15396885935,-77173344
1635729544,-179851,true,15472512027,22,15398425623,-74086404
1635729729,-179849,true,15475606684,22,15421539437,-54067247
1635729758,-179852,true,15470964931,22,15421539437,-49425494
1635730222,-179854,true,15467871202,22,15460139586,-7731616
1635730268,-179855,true,15466324569,22,15461685600,-4638969
1635730345,-179853,true,15469417989,22,15467871202,-1546787
1635730365,-179856,true,15464778092,22,15469417989,4639897
1635730401,-179856,true,15464778092,22,15478701961,13923869
1635730464,-179855,true,15466324569,22,15495737049,29412480
1635730676,-179845,true,15481797856,22,15609264122,127466266
1635730694,-179846,true,15480249831,22,15618632023,138382192
1635730721,-179844,true,15483346036,22,15632694415,149348379
1635730759,-179840,true,15489540303,22,15651463970,161923667
1635730846,-179828,true,15508137978,22,15714192062,206054084
1635730978,-179826,true,15511239761,22,15829319612,318079851
1635731022,-179823,true,15515893598,22,15867353700,351460102
1635731039,-179817,true,15525205462,22,15881640032,356434570
1635731060,-179804,true,15545400343,22,15897528821,352128478
1635731110,-179803,true,15546954883,22,15937320372,390365489
1635731169,-179801,true,15550064429,22,15986800245,436735816
1635731209,-179795,true,15559396801,22,16026815243,467418442
1635731267,-179783,true,15578078350,22,16074965471,496887121
1635731315,-179782,true,15579636157,22,16100704714,521068557
1635731478,-179781,true,15581194121,22,16152306909,571112788
1635731507,-179775,true,15590545175,22,16163616916,573071741
1635731549,-179763,true,15609264122,22,16179787809,570523687
1635731589,-179763,true,15609264122,22,16195974879,586710757
1635731607,-179759,true,15615508765,22,16204074486,588565721
1635731627,-179754,true,15623318081,22,16212178144,588860063
1635731652,-179742,true,15642076377,22,16223530074,581453697
1635731750,-179738,true,15648334146,22,16272271303,623937157
1635731764,-179733,true,15656159879,22,16278781188,622621309
1635731778,-179727,true,15665555923,22,16285293677,619737754
1635731855,-179714,true,15685933370,22,16313000835,627067465
1635731863,-179710,true,15692208684,22,16316263598,624054914
1635731906,-179706,true,15698486509,22,16329321179,630834670
1635731954,-179699,true,15709478747,22,16362010865,652532118
1635731985,-179683,true,15734632773,22,16388209726,653576953
1635732090,-179677,true,15744075913,22,16468704982,724629069
1635732131,-179672,true,15751949526,22,16491776161,739826635
1635732177,-179664,true,15764555497,22,16514879661,750324164
1635732281,-179649,true,15788218890,22,16576094834,787875944
1635732320,-179641,true,15800853887,22,16600976388,800122501
1635732349,-179634,true,15811917803,22,16612600559,800682756
1635732367,-179626,true,15824571766,22,16619246596,794674830
1635732370,-179613,true,15845156057,22,16620908520,775752463
1635732384,-179607,true,15854665527,22,16627557881,772892354
1635732394,-179601,true,15864180705,22,16629220637,765039932
1635732466,-179596,true,15872114382,22,16637536910,765422528
1635732545,-179583,true,15892760516,22,16649186680,756426164
1635732571,-179577,true,15902298556,22,16650851599,748553043
1635732670,-179570,true,15913433505,22,16652516684,739083179
1635732730,-179566,true,15919799833,22,16642528670,722728837
1635732761,-179552,true,15942102046,22,16644192923,702090877
1635732817,-179545,true,15953264866,22,16649186680,695921814
1635732859,-179537,true,15966031946,22,16642528670,676496724
1635732951,-179530,true,15977211521,22,16617584837,640373316
1635732953,-179516,true,15999594163,22,16615923245,616329082
1635733019,-179508,true,16012398319,22,16605957179,593558860
1635733058,-179500,true,16025212722,22,16607617775,582405053
1635733113,-179492,true,16038037380,22,16620908520,582871140
1635733126,-179478,true,16060505233,22,16624232868,563727635
1635733176,-179468,true,16076572967,22,16635873323,559300356
1635733198,-179460,true,16089438728,22,16637536910,548098182
1635733225,-179452,true,16102314785,22,16644192923,541878138
1635733382,-179442,true,16118424347,22,16672510699,554086352
1635733410,-179433,true,16132936733,22,16685853376,552916643
1635733419,-179424,true,16147462186,22,16689190714,541728528
1635733427,-179416,true,16160384678,22,16692528719,532144041
1635733462,-179401,true,16184642230,22,16707558006,522915776
1635733535,-179393,true,16197594477,22,16724273084,526678607
1635733547,-179383,true,16213799362,22,16729290868,515491506
1635733572,-179376,true,16225152427,22,16737657186,512504759
1635733604,-179361,true,16249507200,22,16752727105,503219905
1635733621,-179352,true,16264137607,22,16759429201,495291594
1635733637,-179342,true,16280409066,22,16767810591,487401525
1635733744,-179331,true,16298326473,22,16811461438,513134965
1635733747,-179316,true,16322791083,22,16813142584,490351501
1635733881,-179307,true,16337487472,22,16853540565,516053093
1635733918,-179297,true,16353832314,22,16863655217,509822903
1635734209,-179283,true,16376742567,22,16980410945,603668378
1635734229,-179267,true,16402965016,22,16992300799,589335783
1635734272,-179257,true,16419375365,22,17017807100,598431735
1635734287,-179247,true,16435802131,22,17024615244,588813113
1635734356,-179234,true,16457181498,22,17046760528,589579030
1635734389,-179219,true,16481884558,22,17055285613,573401055
1635734442,-179210,true,16496724189,22,17070641511,573917322
1635734561,-179200,true,16513228338,22,17096265405,583037067
1635734626,-179187,true,16534708420,22,17101394798,566686378
1635734662,-179173,true,16557872065,22,17108236382,550364317
1635734690,-179163,true,16574437390,22,17120215741,545778351
1635734743,-179150,true,16595997091,22,17149343403,553346312
1635734756,-179135,true,16620908520,22,17156204169,535295649
1635734896,-179118,true,16649186680,22,17212910321,563723641
1635734908,-179108,true,16665843361,22,17218074711,552231350
1635734961,-179097,true,16684184958,22,17230130979,545946021
1635735011,-179085,true,16704216995,22,17240471643,536254648
1635735063,-179076,true,16719256805,22,17262897708,543640903
1635735148,-179065,true,16737657186,22,17297456323,559799137
1635735209,-179054,true,16756077818,22,17323420678,567342860
1635735290,-179042,true,16776196174,22,17365044735,588848561
1635735294,-179034,true,16789621829,22,17366781240,577159411
1635735406,-179026,true,16803058228,22,17422441165,619382937
1635735444,-179016,true,16819868850,22,17441615435,621746585
1635735454,-179006,true,16836696290,22,17446848443,610152153
1635735462,-178999,true,16848485514,22,17450337988,601852474
1635735522,-178990,true,16863655217,22,17481775309,618120092
1635735580,-178979,true,16882214516,22,17504515258,622300742
1635735588,-178970,true,16897414588,22,17504515258,607100670
1635735618,-178964,true,16907555572,22,17502764981,595209409
1635735667,-178957,true,16919394412,22,17501014880,581620468
1635735732,-178949,true,16932934666,22,17485271839,552337173
1635735793,-178939,true,16949875222,22,17476531825,526656603
1635735808,-178934,true,16958351855,22,17473037043,514685188
1635735826,-178928,true,16968529410,22,17471289914,502760504
1635735884,-178923,true,16977015372,22,17462556889,485541517
1635735916,-178914,true,16992300799,22,17457319170,465018371
1635735922,-178910,true,16999098739,22,17453828230,454729491
1635735927,-178908,true,17002498729,22,17452083021,449584292
1635736081,-178906,true,17005899398,22,17370254769,364355371
1635736158,-178897,true,17021210831,22,17354629354,333418523
1635736196,-178894,true,17026317705,22,17339017994,312700289
1635736303,-178892,true,17029723139,22,17300915987,271192848
1635736315,-178888,true,17036536050,22,17295726750,259190700
1635736326,-178882,true,17046760528,22,17290539070,243778542
1635736374,-178881,true,17048465204,22,17271530884,223065680
1635736378,-178883,true,17045056022,22,17269803903,224747881
1635736425,-178880,true,17050170050,22,17249093603,198923553
1635736428,-178873,true,17062108750,22,17247368866,185260116
1635736468,-178871,true,17065521343,22,17230130979,164609636
1635736536,-178871,true,17065521343,22,17211189202,145667859
1635736541,-178867,true,17072348575,22,17209468255,137119680
1635736544,-178859,true,17086011235,22,17207747481,121736246
1635736764,-178859,true,17086011235,22,17145914048,59902813
1635736833,-178857,true,17089428608,22,17132203488,42774880
1635736835,-178855,true,17092846665,22,17132203488,39356823
1635736884,-178845,true,17109947206,22,17121927762,11980556
1635737227,-178846,true,17108236382,22,17004198978,-104037404
1635737229,-178846,true,17108236382,22,17002498729,-105737653
1635737232,-178844,true,17111658200,22,17002498729,-109159471
1635737267,-178834,true,17128777561,22,16995699429,-133078132
1635737310,-178834,true,17128777561,22,16988902848,-139874713
1635737346,-178834,true,17128777561,22,16980410945,-148366616
1635737518,-178833,true,17130490438,22,16954960693,-175529745
1635737539,-178825,true,17144199628,22,16954960693,-189238935
1635737592,-178826,true,17142485380,22,16946485756,-195999624
1635737635,-178827,true,17140771303,22,16939708856,-201062447
1635737659,-178827,true,17140771303,22,16939708856,-201062447
1635737694,-178821,true,17151058337,22,16939708856,-211349481
1635737718,-178822,true,17149343403,22,16938015054,-211328349
1635737742,-178824,true,17145914048,22,16939708856,-206205192
1635737781,-178825,true,17144199628,22,16943096967,-201102661
1635737789,-178819,true,17154488720,22,16943096967,-211391753
1635737871,-178816,true,17159635581,22,16948180404,-211455177
1635737903,-178816,true,17159635581,22,16956656189,-202979392
1635737955,-178816,true,17159635581,22,16970226263,-189409318
1635738041,-178809,true,17171650930,22,16994000029,-177650901
1635738154,-178810,true,17169933937,22,16999098739,-170835198
1635738330,-178812,true,17166500465,22,16982108986,-184391479
1635738362,-178812,true,17166500465,22,16982108986,-184391479
1635738466,-178806,true,17176802941,22,16983807197,-192995744
1635738500,-178808,true,17173368095,22,16988902848,-184465247
1635738515,-178808,true,17173368095,22,16990601739,-182766356
1635738566,-178809,true,17171650930,22,16988902848,-182748082
1635738646,-178803,true,17181956497,22,17004198978,-177757519
1635738794,-178803,true,17181956497,22,17043351687,-138604810
1635738828,-178804,true,17180238473,22,17046760528,-133477945
1635738863,-178804,true,17180238473,22,17050170050,-130068423
1635738884,-178800,true,17187111599,22,17051875067,-135236532
1635738945,-178799,true,17188830311,22,17063814961,-125015350
1635738953,-178801,true,17185393060,22,17067227895,-118165165
1635738971,-178800,true,17187111599,22,17075763216,-111348383
1635738977,-178796,true,17193987475,22,17079178539,-114808936
1635739018,-178794,true,17197426445,22,17092846665,-104579780
1635739148,-178795,true,17195706874,22,17151058337,-44648537
1635739186,-178794,true,17197426445,22,17169933937,-27492508
1635739213,-178790,true,17204306447,22,17176802941,-27503506
1635739241,-178789,true,17206026878,22,17190549194,-15477684
1635739272,-178792,true,17200866102,22,17195706874,-5159228
1635739280,-178796,true,17193987475,22,17197426445,3438970
1635739314,-178794,true,17197426445,22,17204306447,6880002
1635739324,-178796,true,17193987475,22,17206026878,12039403
1635739355,-178800,true,17187111599,22,17212910321,25798722
1635739418,-178804,true,17180238473,22,17223240650,43002177
1635739421,-178801,true,17185393060,22,17223240650,37847590
1635739438,-178804,true,17180238473,22,17228408139,48169666
1635739453,-178808,true,17173368095,22,17231853992,58485897
1635739486,-178814,true,17163067680,22,17228408139,65340459
1635739543,-178812,true,17166500465,22,17230130979,63630514
1635739574,-178814,true,17163067680,22,17230130979,67063299
1635739606,-178818,true,17156204169,22,17230130979,73926810
1635739621,-178824,true,17145914048,22,17226685470,80771422
1635739649,-178822,true,17149343403,22,17221518498,72175095
1635739696,-178826,true,17142485380,22,17212910321,70424941
1635739790,-178833,true,17130490438,22,17185393060,54902622
1635739817,-178839,true,17120215741,22,17173368095,53152354
1635739833,-178838,true,17121927762,22,17164783987,42856225
1635739867,-178842,true,17115080703,22,17144199628,29118925
1635739934,-178850,true,17101394798,22,17106525729,5130931
1635739985,-178853,true,17096265405,22,17077470792,-18794613
1635740235,-178848,true,17104815248,22,17011001678,-93813570
1635740436,-178851,true,17099684829,22,16987204128,-112480701
1635740576,-178857,true,17089428608,22,16963439869,-125988739
1635740641,-178860,true,17084302805,22,16965136213,-119166592
1635740643,-178855,true,17092846665,22,16965136213,-127710452
1635740682,-178858,true,17087719836,22,16965136213,-122583623
1635740832,-178864,true,17077470792,22,16992300799,-85169993
1635740936,-178863,true,17079178539,22,17005899398,-73279141
1635741056,-178859,true,17086011235,22,17005899398,-80111837
1635741096,-178862,true,17080886457,22,17009300748,-71585709
1635741140,-178867,true,17072348575,22,17019508880,-52839695
1635741209,-178868,true,17070641511,22,17019508880,-51132631
1635741244,-178863,true,17079178539,22,17012702778,-66475761
1635741468,-178869,true,17068934618,22,16978713073,-90221545
1635741549,-178874,true,17060402710,22,16978713073,-81689637
1635741728,-178874,true,17060402710,22,16982108986,-78293724
1635741759,-178869,true,17068934618,22,16982108986,-86825632
1635741836,-178874,true,17060402710,22,16978713073,-81689637
1635741870,-178879,true,17051875067,22,16975317840,-76557227
1635741897,-178880,true,17050170050,22,16973620478,-76549572
1635742012,-178874,true,17060402710,22,16963439869,-96962841
1635742066,-178876,true,17056991141,22,16954960693,-102030448
1635742087,-178880,true,17050170050,22,16953265367,-96904683
1635742091,-178881,true,17048465204,22,16953265367,-95199837
1635742147,-178876,true,17056991141,22,16954960693,-102030448
1635742231,-178875,true,17058696840,22,16963439869,-95256971
1635742237,-178879,true,17051875067,22,16963439869,-88435198
1635742273,-178880,true,17050170050,22,16968529410,-81640640
1635742410,-178874,true,17060402710,22,16978713073,-81689637
1635742423,-178876,true,17056991141,22,16978713073,-78278068
1635742465,-178880,true,17050170050,22,16973620478,-76549572
1635742475,-178880,true,17050170050,22,16975317840,-74852210
1635742495,-178875,true,17058696840,22,16973620478,-85076362
1635742793,-178876,true,17056991141,22,16971923286,-85067855
1635742842,-178879,true,17051875067,22,16970226263,-81648804
1635743017,-178879,true,17051875067,22,16970226263,-81648804
1635743112,-178874,true,17060402710,22,16975317840,-85084870
1635743169,-178876,true,17056991141,22,16977015372,-79975769
1635743275,-178880,true,17050170050,22,16973620478,-76549572
1635743371,-178880,true,17050170050,22,16973620478,-76549572
1635743394,-178875,true,17058696840,22,16973620478,-85076362
1635743404,-178876,true,17056991141,22,16973620478,-83370663
1635743489,-178880,true,17050170050,22,16975317840,-74852210
1635743510,-178881,true,17048465204,22,16975317840,-73147364
1635743766,-178877,true,17055285613,22,16982108986,-73176627
1635743774,-178878,true,17053580255,22,16980410945,-73169310
1635743816,-178881,true,17048465204,22,16971923286,-76541918
1635744002,-178884,true,17043351687,22,16910937252,-132414435
1635744185,-178883,true,17045056022,22,16856911441,-188144581
1635744294,-178884,true,17043351687,22,16841747804,-201603883
1635744382,-178888,true,17036536050,22,16811461438,-225074612
1635744429,-178891,true,17031426111,22,16796338685,-235087426
1635744543,-178894,true,17026317705,22,16737657186,-288660519
1635744549,-178898,true,17019508880,22,16734310157,-285198723
1635744753,-178904,true,17009300748,22,16652516684,-356784064
1635744801,-178909,true,17000798649,22,16644192923,-356605726
1635744888,-178911,true,16997398999,22,16637536910,-359862089
1635744900,-178917,true,16987204128,22,16634209902,-352994226
1635744901,-178923,true,16977015372,22,16634209902,-342805470
1635744943,-178928,true,16968529410,22,16627557881,-340971529
1635745040,-178934,true,16958351855,22,16599316457,-359035398
1635745049,-178940,true,16948180404,22,16595997091,-352183313
1635745225,-178946,true,16938015054,22,16533055115,-404959939
1635745256,-178952,true,16927855801,22,16524791067,-403064734
1635745392,-178958,true,16917702641,22,16480236534,-437466107
1635745420,-178964,true,16907555572,22,16475293452,-432262120
1635745547,-178970,true,16897414588,22,16450600271,-446814317
1635745608,-178975,true,16888968415,22,16439089455,-449878960
1635745663,-178982,true,16877150864,22,16417733591,-459417273
1635745700,-178987,true,16868714820,22,16404605313,-464109507
1635745717,-178995,true,16855225919,22,16396405470,-458820449
1635745787,-179001,true,16845116322,22,16366919960,-478196362
1635745792,-179008,true,16833329456,22,16365283431,-468046025
1635745920,-179010,true,16829963295,22,16348927145,-481036150
1635746004,-179017,true,16818187031,22,16342389209,-475797822
1635746027,-179020,true,16813142584,22,16340755133,-472387451
1635746068,-179029,true,16798018319,22,16335853887,-462164432
1635746281,-179032,true,16792979921,22,16329321179,-463658742
1635746380,-179039,true,16781229536,22,16334220465,-447009071
1635746397,-179043,true,16774518722,22,16334220465,-440298257
1635746542,-179049,true,16764457532,22,16368556652,-395900880
1635746785,-179048,true,16766133978,22,16442377438,-323756540
1635747095,-179051,true,16761105144,22,16514879661,-246225483
1635747286,-179054,true,16756077818,22,16557872065,-198205753
1635747301,-179059,true,16747702292,22,16559527852,-188174440
1635747601,-179058,true,16749377062,22,16508275361,-241101701
1635747739,-179062,true,16742678986,22,16483532746,-259146240
1635747761,-179065,true,16737657186,22,16480236534,-257420652
1635747818,-179074,true,16722600824,22,16470351852,-252248972
1635747825,-179074,true,16722600824,22,16468704982,-253895842
1635747829,-179077,true,16717585047,22,16468704982,-248880065
1635747978,-179079,true,16714242031,22,16462119146,-252122885
1635747987,-179087,true,16700876653,22,16460473099,-240403554
1635748002,-179086,true,16702546740,22,16460473099,-242073641
1635748050,-179090,true,16695867392,22,16455535944,-240331448
1635748106,-179094,true,16689190714,22,16444021675,-245169039
1635748212,-179099,true,16680848621,22,16458827216,-222021405
1635748216,-179099,true,16680848621,22,16458827216,-222021405
1635748223,-179103,true,16674177950,22,16462119146,-212058804
1635748477,-179108,true,16665843361,22,16493425339,-172418022
1635748812,-179114,true,16655847354,22,16513228338,-142619016
1635748830,-179111,true,16660844608,22,16511577181,-149267427
1635748875,-179114,true,16655847354,22,16511577181,-144270173
1635748902,-179120,true,16645857343,22,16508275361,-137581982
1635748953,-179126,true,16635873323,22,16514879661,-120993662
1635748990,-179123,true,16640864584,22,16523138753,-117725831
1635749021,-179126,true,16635873323,22,16526443546,-109429777
1635749036,-179130,true,16629220637,22,16526443546,-102777091
1635749195,-179132,true,16625895291,22,16561183805,-64711486
1635749247,-179129,true,16630883559,22,16577752443,-53131116
1635749337,-179132,true,16625895291,22,16591019288,-34876003
1635749368,-179136,true,16619246596,22,16595997091,-23249505
1635749383,-179140,true,16612600559,22,16599316457,-13284102
1635749449,-179137,true,16617584837,22,16614261819,-3323018
1635749616,-179139,true,16614261819,22,16649186680,34924861
1635749652,-179144,true,16605957179,22,16657512939,51555760
1635749786,-179147,true,16600976388,22,16692528719,91552331
1635749890,-179144,true,16605957179,22,16699206732,93249553
1635750001,-179146,true,16602636486,22,16699206732,96570246
1635750025,-179151,true,16594337658,22,16699206732,104869074
1635750074,-179153,true,16591019288,22,16699206732,108187444
1635750360,-179150,true,16595997091,22,16730963797,134966706
1635750379,-179151,true,16594337658,22,16732636893,138299235
1635750399,-179156,true,16586042977,22,16730963797,144920820
1635750561,-179160,true,16579410218,22,16729290868,149880650
1635750711,-179158,true,16582726266,22,16719256805,136530539
1635750759,-179160,true,16579410218,22,16725945511,146535293
1635750814,-179164,true,16572780112,22,16720928731,148148619
1635750827,-179168,true,16566152657,22,16717585047,151432390
1635750902,-179167,true,16567809272,22,16707558006,139748734
1635750929,-179170,true,16562839923,22,16700876653,138036730
1635751060,-179176,true,16552905696,22,16665843361,112937665
1635751111,-179180,true,16546286189,22,16652516684,106230495
1635751119,-179179,true,16547940818,22,16650851599,102910781
1635751402,-179182,true,16542977428,22,16592678390,49700962
1635751515,-179184,true,16539669329,22,16582726266,43056937
1635751555,-179184,true,16539669329,22,16579410218,39740889
1635751597,-179184,true,16539669329,22,16576094834,36425505
1635751632,-179185,true,16538015527,22,16571123000,33107473
1635751685,-179189,true,16531401975,22,16559527852,28125877
1635751717,-179188,true,16533055115,22,16557872065,24816950
1635751777,-179186,true,16536361891,22,16557872065,21510174
1635751876,-179186,true,16536361891,22,16556216443,19854552
1635752217,-179188,true,16533055115,22,16566152657,33097542
1635752336,-179187,true,16534708420,22,16577752443,43044023
1635752717,-179184,true,16539669329,22,16625895291,86225962
1635752789,-179184,true,16539669329,22,16635873323,96203994
1635753027,-179186,true,16536361891,22,16644192923,107831032
1635753056,-179182,true,16542977428,22,16645857343,102879915
1635753236,-179179,true,16547940818,22,16652516684,104575866
1635753269,-179179,true,16547940818,22,16652516684,104575866
1635753294,-179181,true,16544631726,22,16642528670,97896944
1635753338,-179177,true,16551250571,22,16627557881,76307310
1635753539,-179172,true,16559527852,22,16644192923,84665071
1635753896,-179171,true,16561183805,22,16647521928,86338123
1635753966,-179173,true,16557872065,22,16645857343,87985278
1635754145,-179168,true,16566152657,22,16635873323,69720666
1635754187,-179164,true,16572780112,22,16639200664,66420552
1635754224,-179162,true,16576094834,22,16649186680,73091846
1635754266,-179162,true,16576094834,22,16647521928,71427094
1635754387,-179157,true,16584384539,22,16627557881,43173342
1635754412,-179156,true,16586042977,22,16622570611,36527634
1635754420,-179154,true,16589360352,22,16620908520,31548168
1635754480,-179156,true,16586042977,22,16615923245,29880268
1635754570,-179151,true,16594337658,22,16610939465,16601807
1635754631,-179149,true,16597656691,22,16607617775,9961084
1635754678,-179149,true,16597656691,22,16599316457,1659766
1635754832,-179151,true,16594337658,22,16571123000,-23214658
1635754853,-179149,true,16597656691,22,16567809272,-29847419
1635755077,-179150,true,16595997091,22,16533055115,-62941976
1635755203,-179151,true,16594337658,22,16518182802,-76154856
1635755284,-179154,true,16589360352,22,16504974201,-84386151
1635755389,-179151,true,16594337658,22,16490127148,-104210510
1635755445,-179151,true,16594337658,22,16481884558,-112453100
1635755495,-179150,true,16595997091,22,16475293452,-120703639
1635755549,-179152,true,16592678390,22,16468704982,-123973408
1635755601,-179150,true,16595997091,22,16467058276,-128938815
1635755611,-179150,true,16595997091,22,16467058276,-128938815
1635755626,-179150,true,16595997091,22,16465411735,-130585356
1635755770,-179154,true,16589360352,22,16450600271,-138760081
1635755818,-179153,true,16591019288,22,16447310644,-143708644
1635755868,-179153,true,16591019288,22,16444021675,-146997613
1635755870,-179153,true,16591019288,22,16444021675,-146997613
1635755871,-179156,true,16586042977,22,16444021675,-142021302
1635755974,-179154,true,16589360352,22,16453890555,-135469797
1635756065,-179154,true,16589360352,22,16460473099,-128887253
1635756171,-179154,true,16589360352,22,16470351852,-119008500
1635756200,-179155,true,16587701582,22,16476940981,-110760601
1635756252,-179152,true,16592678390,22,16491776161,-100902229
1635756383,-179149,true,16597656691,22,16526443546,-71213145
1635756499,-179149,true,16597656691,22,16554560987,-43095704
1635756568,-179149,true,16597656691,22,16592678390,-4978301
1635756699,-179144,true,16605957179,22,16692528719,86571540
1635756856,-179139,true,16614261819,22,16789621829,175360010
1635757001,-179136,true,16619246596,22,16875463318,256216722
1635757044,-179136,true,16619246596,22,16900794240,281547644
1635757155,-179135,true,16620908520,22,16939708856,318800336
1635757210,-179131,true,16627557881,22,16961743695,334185814
1635757409,-179128,true,16632546647,22,17036536050,403989403
1635757428,-179129,true,16630883559,22,17039943528,409059969
1635757464,-179126,true,16635873323,22,17045056022,409182699
1635757489,-179121,true,16644192923,22,17043351687,399158764
1635757557,-179121,true,16644192923,22,17026317705,382124782
1635757651,-179123,true,16640864584,22,17004198978,363334394
1635757700,-179121,true,16644192923,22,16995699429,351506506
1635757807,-179115,true,16654181936,22,16982108986,327927050
1635757902,-179116,true,16652516684,22,16968529410,316012726
1635758002,-179116,true,16652516684,22,16971923286,319406602
1635758194,-179114,true,16655847354,22,16956656189,300808835
1635758218,-179110,true,16662510693,22,16953265367,290754674
1635758452,-179113,true,16657512939,22,16887279687,229766748
1635758838,-179116,true,16652516684,22,16803058228,150541544
1635758896,-179114,true,16655847354,22,16792979921,137132567
1635759183,-179107,true,16667509946,22,16782907659,115397713
1635759284,-179110,true,16662510693,22,16803058228,140547535
1635759386,-179110,true,16662510693,22,16814823898,152313205
1635759396,-179108,true,16665843361,22,16816505381,150662020
1635759630,-179101,true,16677512952,22,16838379959,160867007
1635759640,-179103,true,16674177950,22,16840063797,165885847
1635760085,-179102,true,16675845368,22,16870401691,194556323
1635760255,-179099,true,16680848621,22,16877150864,196302243
1635760320,-179092,true,16692528719,22,16882214516,189685797
1635760330,-179094,true,16689190714,22,16882214516,193023802
1635760341,-179093,true,16690859633,22,16883902737,193043104
1635760444,-179090,true,16695867392,22,16894035612,198168220
1635760561,-179084,true,16705887417,22,16892346377,186458960
1635760679,-179087,true,16700876653,22,16867028117,166151464
1635760799,-179085,true,16704216995,22,16868714820,164497825
1635761090,-179083,true,16707558006,22,16816505381,108947375
1635761118,-179077,true,16717585047,22,16811461438,93876391
1635761222,-179081,true,16710899684,22,16792979921,82080237
1635761385,-179080,true,16712570774,22,16769487372,56916598
1635761388,-179079,true,16714242031,22,16769487372,55245341
1635761550,-179076,true,16719256805,22,16739330952,20074147
1635761614,-179080,true,16712570774,22,16722600824,10030050
1635761631,-179081,true,16710899684,22,16717585047,6685363
1635761635,-179081,true,16710899684,22,16715913456,5013772
1635761718,-179077,true,16717585047,22,16684184958,-33400089
1635761889,-179083,true,16707558006,22,16642528670,-65029336
1635761903,-179084,true,16705887417,22,16639200664,-66686753
1635761907,-179082,true,16709228761,22,16639200664,-70028097
1635761932,-179081,true,16710899684,22,16634209902,-76689782
1635762228,-179085,true,16704216995,22,16571123000,-133093995
1635762297,-179087,true,16700876653,22,16557872065,-143004588
1635762376,-179085,true,16704216995,22,16554560987,-149656008
1635762492,-179083,true,16707558006,22,16547940818,-159617188
1635762519,-179087,true,16700876653,22,16546286189,-154590464
1635762527,-179088,true,16699206732,22,16544631726,-154575006
1635762899,-179086,true,16702546740,22,16554560987,-147985753
1635762989,-179084,true,16705887417,22,16554560987,-151326430
1635763591,-179088,true,16699206732,22,16556216443,-142990289
1635763646,-179089,true,16697536978,22,16552905696,-144631282
1635763733,-179087,true,16700876653,22,16547940818,-152935835
1635763964,-179085,true,16704216995,22,16552905696,-151311299
1635764120,-179088,true,16699206732,22,16564496207,-134710525
1635764163,-179088,true,16699206732,22,16566152657,-133054075
1635764392,-179085,true,16704216995,22,16579410218,-124806777
1635764475,-179082,true,16709228761,22,16574437390,-134791371
1635764600,-179086,true,16702546740,22,16574437390,-128109350
1635764720,-179086,true,16702546740,22,16567809272,-134737468
1635764729,-179084,true,16705887417,22,16566152657,-139734760
1635764791,-179081,true,16710899684,22,16557872065,-153027619
1635764809,-179085,true,16704216995,22,16557872065,-146344930
1635764946,-179086,true,16702546740,22,16534708420,-167838320
1635765109,-179084,true,16705887417,22,16504974201,-200913216
1635765176,-179081,true,16710899684,22,16493425339,-217474345
1635765228,-179084,true,16705887417,22,16485181100,-220706317
1635765253,-179084,true,16705887417,22,16481884558,-224002859
1635765407,-179082,true,16709228761,22,16471998887,-237229874
1635765476,-179079,true,16714242031,22,16467058276,-247183755
1635765717,-179083,true,16707558006,22,16450600271,-256957735
1635765774,-179083,true,16707558006,22,16453890555,-253667451
1635765917,-179083,true,16707558006,22,16462119146,-245438860
1635765942,-179081,true,16710899684,22,16462119146,-248780538
1635766033,-179085,true,16704216995,22,16458827216,-245389779
1635766038,-179086,true,16702546740,22,16458827216,-243719524
1635766144,-179088,true,16699206732,22,16447310644,-251896088
1635766156,-179089,true,16697536978,22,16445666078,-251870900
1635766372,-179094,true,16689190714,22,16425944100,-263246614
1635766386,-179095,true,16687521962,22,16425944100,-261577862
1635766581,-179100,true,16679180703,22,16419375365,-259805338
1635766729,-179103,true,16674177950,22,16406245773,-267932177
1635766754,-179111,true,16660844608,22,16402965016,-257879592
1635766862,-179114,true,16655847354,22,16391487532,-264359822
1635766875,-179118,true,16649186680,22,16391487532,-257699148
1635766910,-179121,true,16644192923,22,16389848547,-254344376
1635766939,-179129,true,16630883559,22,16389848547,-241035012
1635767015,-179131,true,16627557881,22,16391487532,-236070349
1635767144,-179134,true,16622570611,22,16411168139,-211402472
1635767310,-179135,true,16620908520,22,16447310644,-173597876
1635767327,-179140,true,16612600559,22,16450600271,-162000288
1635767350,-179140,true,16612600559,22,16455535944,-157064615
1635767393,-179142,true,16609278537,22,16463765358,-145513179
1635767436,-179144,true,16605957179,22,16471998887,-133958292
1635767484,-179149,true,16597656691,22,16478588675,-119068016
1635767597,-179149,true,16597656691,22,16514879661,-82777030
1635767742,-179151,true,16594337658,22,16552905696,-41431962
1635767753,-179153,true,16591019288,22,16556216443,-34802845
1635767797,-179155,true,16587701582,22,16566152657,-21548925
1635767825,-179153,true,16591019288,22,16577752443,-13266845
1635767832,-179153,true,16591019288,22,16581068159,-9951129
1635767855,-179155,true,16587701582,22,16591019288,3317706
1635767887,-179155,true,16587701582,22,16609278537,21576955
1635767929,-179155,true,16587701582,22,16624232868,36531286
1635768053,-179156,true,16586042977,22,16657512939,71469962
1635768365,-179157,true,16584384539,22,16715913456,131528917
1635768488,-179157,true,16584384539,22,16727618106,143233567
1635768542,-179158,true,16582726266,22,16735983588,153257322
1635768641,-179159,true,16581068159,22,16749377062,168308903
1635768695,-179161,true,16577752443,22,16756077818,178325375
1635768764,-179162,true,16576094834,22,16752727105,176632271
1635768811,-179163,true,16574437390,22,16749377062,174939672
1635768859,-179163,true,16574437390,22,16747702292,173264902
1635769020,-179165,true,16571123000,22,16744353253,173230253
1635769092,-179163,true,16574437390,22,16744353253,169915863
1635769198,-179166,true,16569466053,22,16739330952,169864899
1635769270,-179165,true,16571123000,22,16735983588,164860588
1635769293,-179166,true,16569466053,22,16732636893,163170840
1635769335,-179166,true,16569466053,22,16724273084,154807031
1635769473,-179169,true,16564496207,22,16692528719,128032512
1635769484,-179170,true,16562839923,22,16692528719,129688796
1635769533,-179170,true,16562839923,22,16685853376,123013453
1635769582,-179168,true,16566152657,22,16679180703,113028046
1635769639,-179169,true,16564496207,22,16667509946,103013739
1635769686,-179170,true,16562839923,22,16655847354,93007431
1635769730,-179170,true,16562839923,22,16644192923,81353000
1635769973,-179169,true,16564496207,22,16586042977,21546770
1635769994,-179170,true,16562839923,22,16581068159,18228236
1635770035,-179170,true,16562839923,22,16572780112,9940189
1635770123,-179171,true,16561183805,22,16549595612,-11588193
1635770198,-179171,true,16561183805,22,16531401975,-29781830
1635770435,-179172,true,16559527852,22,16503323868,-56203984
1635770479,-179173,true,16557872065,22,16496724189,-61147876
1635770502,-179173,true,16557872065,22,16495074681,-62797384
1635770655,-179173,true,16557872065,22,16488478301,-69393764
1635770725,-179174,true,16556216443,22,16485181100,-71035343
1635770762,-179175,true,16554560987,22,16483532746,-71028241
1635770796,-179175,true,16554560987,22,16481884558,-72676429
1635770842,-179175,true,16554560987,22,16478588675,-75972312
1635770958,-179176,true,16552905696,22,16476940981,-75964715
1635770971,-179176,true,16552905696,22,16478588675,-74317021
1635770973,-179176,true,16552905696,22,16478588675,-74317021
1635771090,-179176,true,16552905696,22,16491776161,-61129535
1635771112,-179176,true,16552905696,22,16495074681,-57831015
1635771150,-179177,true,16551250571,22,16501673701,-49576870
1635771201,-179176,true,16552905696,22,16509926188,-42979508
1635771302,-179175,true,16554560987,22,16524791067,-29769920
1635771337,-179174,true,16556216443,22,16528096190,-28120253
1635771403,-179175,true,16554560987,22,16533055115,-21505872
1635771438,-179175,true,16554560987,22,16531401975,-23159012
1635771823,-179175,true,16554560987,22,16528096190,-26464797
1635772060,-179175,true,16554560987,22,16475293452,-79267535
1635772136,-179175,true,16554560987,22,16455535944,-99025043
1635772313,-179175,true,16554560987,22,16440733364,-113827623
1635772459,-179175,true,16554560987,22,16442377438,-112183549
1635772639,-179174,true,16556216443,22,16455535944,-100680499
1635772841,-179174,true,16556216443,22,16485181100,-71035343
1635772951,-179173,true,16557872065,22,16506624698,-51247367
1635773187,-179173,true,16557872065,22,16523138753,-34733312
1635773396,-179172,true,16559527852,22,16519834621,-39693231
1635773449,-179172,true,16559527852,22,16523138753,-36389099
1635773457,-179172,true,16559527852,22,16526443546,-33084306
1635773744,-179168,true,16566152657,22,16599316457,33163800
1635773751,-179164,true,16572780112,22,16600976388,28196276
1635773927,-179161,true,16577752443,22,16670843614,93091171
1635773970,-179160,true,16579410218,22,16689190714,109780496
1635774148,-179152,true,16592678390,22,16806419008,213740618
1635774268,-179147,true,16600976388,22,16890657312,289680924
1635774307,-179142,true,16609278537,22,16917702641,308424104
1635774331,-179141,true,16610939465,22,16931241541,320302076
1635774341,-179133,true,16624232868,22,16936321422,312088554
1635774600,-179132,true,16625895291,22,16971923286,346027995
1635774648,-179128,true,16632546647,22,16975317840,342771193
1635774884,-179126,true,16635873323,22,16990601739,354728416
1635774911,-179118,true,16649186680,22,16987204128,338017448
1635774926,-179117,true,16650851599,22,16983807197,332955598
1635775015,-179116,true,16652516684,22,16951570210,299053526
1635775058,-179118,true,16649186680,22,16934627959,285441279
1635775080,-179111,true,16660844608,22,16926163185,265318577
1635775182,-179111,true,16660844608,22,16888968415,228123807
1635775362,-179111,true,16660844608,22,16840063797,179219189
1635775521,-179113,true,16657512939,22,16819868850,162355911
1635775860,-179105,true,16670843614,22,16777873793,107030179
1635775949,-179108,true,16665843361,22,16766133978,100290617
1635776014,-179108,true,16665843361,22,16756077818,90234457
1635776136,-179110,true,16662510693,22,16766133978,103623285
1635776151,-179103,true,16674177950,22,16767810591,93632641
1635776228,-179103,true,16674177950,22,16776196174,102018224
1635776338,-179103,true,16674177950,22,16786264408,112086458
1635776411,-179106,true,16669176697,22,16791300791,122124094
1635776442,-179102,true,16675845368,22,16792979921,117134553
1635776500,-179103,true,16674177950,22,16794659219,120481269
1635776555,-179102,true,16675845368,22,16796338685,120493317
1635776699,-179103,true,16674177950,22,16804738534,130560584
1635776785,-179099,true,16680848621,22,16813142584,132293963
1635776814,-179100,true,16679180703,22,16821550837,142370134
1635776859,-179099,true,16680848621,22,16831646291,150797670
1635776898,-179101,true,16677512952,22,16840063797,162550845
1635776935,-179097,true,16684184958,22,16843431979,159247021
1635777009,-179097,true,16684184958,22,16843431979,159247021
1635777119,-179096,true,16685853376,22,16841747804,155894428
1635777154,-179098,true,16682516706,22,16840063797,157547091
1635777275,-179094,true,16689190714,22,16838379959,149189245
1635777478,-179094,true,16689190714,22,16841747804,152557090
1635777598,-179093,true,16690859633,22,16835012789,144153156
1635777642,-179095,true,16687521962,22,16826597807,139075845
1635777915,-179092,true,16692528719,22,16782907659,90378940
1635778067,-179091,true,16694197972,22,16766133978,71936006
1635778146,-179090,true,16695867392,22,16759429201,63561809
1635778316,-179091,true,16694197972,22,16742678986,48481014
1635778371,-179087,true,16700876653,22,16737657186,36780533
1635778423,-179087,true,16700876653,22,16734310157,33433504
1635778587,-179085,true,16704216995,22,16725945511,21728516
1635778692,-179087,true,16700876653,22,16722600824,21724171
1635778776,-179083,true,16707558006,22,16719256805,11698799
1635778962,-179082,true,16709228761,22,16714242031,5013270
1635779053,-179082,true,16709228761,22,16684184958,-25043803
1635779077,-179084,true,16705887417,22,16675845368,-30042049
1635779119,-179080,true,16712570774,22,16665843361,-46727413
1635779230,-179082,true,16709228761,22,16632546647,-76682114
1635779329,-179081,true,16710899684,22,16602636486,-108263198
1635779350,-179083,true,16707558006,22,16597656691,-109901315
1635779387,-179079,true,16714242031,22,16589360352,-124881679
1635779446,-179082,true,16709228761,22,16574437390,-134791371
1635779481,-179081,true,16710899684,22,16566152657,-144747027
1635779510,-179084,true,16705887417,22,16559527852,-146359565
1635779614,-179079,true,16714242031,22,16538015527,-176226504
1635779667,-179082,true,16709228761,22,16526443546,-182785215
1635779677,-179082,true,16709228761,22,16524791067,-184437694
1635779746,-179084,true,16705887417,22,16508275361,-197612056
1635779754,-179081,true,16710899684,22,16506624698,-204274986
1635779776,-179084,true,16705887417,22,16501673701,-204213716
1635779827,-179085,true,16704216995,22,16488478301,-215738694
1635779836,-179087,true,16700876653,22,16486829618,-214047035
1635779925,-179085,true,16704216995,22,16480236534,-223980461
1635780224,-179089,true,16697536978,22,16450600271,-246936707
1635780251,-179089,true,16697536978,22,16448955375,-248581603
1635780308,-179091,true,16694197972,22,16445666078,-248531894
1635780390,-179087,true,16700876653,22,16444021675,-256854978
1635780436,-179090,true,16695867392,22,16439089455,-256777937
1635780478,-179089,true,16697536978,22,16435802131,-261734847
1635780571,-179092,true,16692528719,22,16427586694,-264942025
1635780573,-179088,true,16699206732,22,16427586694,-271620038
1635780591,-179092,true,16692528719,22,16425944100,-266584619
1635780722,-179092,true,16692528719,22,16421017302,-271511417
1635780763,-179095,true,16687521962,22,16417733591,-269788371
1635780845,-179091,true,16694197972,22,16414450537,-279747435
1635780881,-179095,true,16687521962,22,16416091982,-271429980
1635781072,-179094,true,16689190714,22,16424301670,-264889044
1635781118,-179097,true,16684184958,22,16425944100,-258240858
1635781129,-179096,true,16685853376,22,16427586694,-258266682
1635781228,-179103,true,16674177950,22,16427586694,-246591256
1635781362,-179104,true,16672510699,22,16435802131,-236708568
1635781394,-179107,true,16667509946,22,16439089455,-228420491
1635781460,-179111,true,16660844608,22,16435802131,-225042477
1635781473,-179118,true,16649186680,22,16435802131,-213384549
1635781717,-179123,true,16640864584,22,16419375365,-221489219
1635781729,-179127,true,16634209902,22,16417733591,-216476311
1635781760,-179131,true,16627557881,22,16416091982,-211465899
1635781849,-179135,true,16620908520,22,16407886398,-213022122
1635781920,-179139,true,16614261819,22,16398045111,-216216708
1635782001,-179143,true,16607617775,22,16388209726,-219408049
1635782234,-179148,true,16599316457,22,16345657850,-253658607
1635782378,-179152,true,16592678390,22,16316263598,-276414792
1635782512,-179156,true,16586042977,22,16309738724,-276304253
1635782552,-179157,true,16584384539,22,16308107913,-276276626
1635782690,-179162,true,16576094834,22,16296696803,-279398031
1635782741,-179164,true,16572780112,22,16303216459,-269563653
1635783454,-179169,true,16564496207,22,16254382539,-310113668
1635783463,-179171,true,16561183805,22,16254382539,-306801266
1635783491,-179176,true,16552905696,22,16251132150,-301773546
1635783596,-179178,true,16549595612,22,16260885268,-288710344
1635783710,-179181,true,16544631726,22,16265764021,-278867705
1635783736,-179182,true,16542977428,22,16269017336,-273960092
1635783765,-179186,true,16536361891,22,16273898530,-262463361
1635783985,-179190,true,16529749000,22,16303216459,-226532541
1635784064,-179194,true,16523138753,22,16313000835,-210137918
1635784130,-179196,true,16519834621,22,16321158967,-198675654
1635784272,-179200,true,16513228338,22,16335853887,-177374451
1635784469,-179204,true,16506624698,22,16337487472,-169137226
1635784488,-179208,true,16500023699,22,16335853887,-164169812
1635784519,-179211,true,16495074681,22,16330954111,-164120570
1635784525,-179215,true,16488478301,22,16330954111,-157524190
1635784559,-179218,true,16483532746,22,16335853887,-147678859
1635784755,-179220,true,16480236534,22,16357103244,-123133290
1635784840,-179222,true,16476940981,22,16358738954,-118202027
1635785048,-179227,true,16468704982,22,16368556652,-100148330
1635785246,-179230,true,16463765358,22,16380018079,-83747279
1635785502,-179233,true,16458827216,22,16373467710,-85359506
1635785532,-179235,true,16455535944,22,16368556652,-86979292
1635785562,-179240,true,16447310644,22,16362010865,-85299779
1635785684,-179245,true,16439089455,22,16339121221,-99968234
1635785824,-179246,true,16437445711,22,16344023448,-93422263
1635785946,-179247,true,16435802131,22,16352197094,-83605037
1635786083,-179251,true,16429229453,22,16362010865,-67218588
1635786275,-179253,true,16425944100,22,16386571069,-39373031
1635786456,-179254,true,16424301670,22,16414450537,-9851133
1635786478,-179255,true,16422659404,22,16419375365,-3284039
1635786527,-179259,true,16416091982,22,16427586694,11494712
1635786578,-179261,true,16412809256,22,16440733364,27924108
1635786644,-179262,true,16411168139,22,16444021675,32853536
1635786708,-179262,true,16411168139,22,16445666078,34497939
1635786769,-179265,true,16406245773,22,16447310644,41064871
1635786809,-179268,true,16401324884,22,16448955375,47630491
1635786829,-179267,true,16402965016,22,16447310644,44345628
1635786925,-179267,true,16402965016,22,16445666078,42701062
1635787060,-179270,true,16398045111,22,16440733364,42688253
1635787253,-179270,true,16398045111,22,16432515463,34470352
1635787308,-179269,true,16399684915,22,16425944100,26259185
1635787324,-179270,true,16398045111,22,16421017302,22972191
1635787414,-179273,true,16393126681,22,16416091982,22965301
1635787581,-179271,true,16396405470,22,16419375365,22969895
1635787594,-179271,true,16396405470,22,16421017302,24611832
1635787658,-179271,true,16396405470,22,16419375365,22969895
1635787692,-179273,true,16393126681,22,16419375365,26248684
1635788032,-179272,true,16394765994,22,16432515463,37749469
1635788048,-179272,true,16394765994,22,16432515463,37749469
1635788101,-179272,true,16394765994,22,16434158715,39392721
1635788172,-179274,true,16391487532,22,16437445711,45958179
1635788249,-179274,true,16391487532,22,16445666078,54178546
1635788351,-179273,true,16393126681,22,16445666078,52539397
1635788391,-179273,true,16393126681,22,16445666078,52539397
1635788418,-179275,true,16389848547,22,16445666078,55817531
1635788438,-179273,true,16393126681,22,16444021675,50894994
1635788507,-179272,true,16394765994,22,16439089455,44323461
1635788509,-179273,true,16393126681,22,16439089455,45962774
1635788554,-179276,true,16388209726,22,16432515463,44305737
1635788619,-179275,true,16389848547,22,16425944100,36095553
1635788630,-179275,true,16389848547,22,16422659404,32810857
1635788906,-179268,true,16401324884,22,16496724189,95399305
1635789350,-179269,true,16399684915,22,16614261819,214576904
1635789472,-179268,true,16401324884,22,16654181936,252857052
1635789557,-179268,true,16401324884,22,16674177950,272853066
1635789700,-179261,true,16412809256,22,16665843361,253034105
1635789759,-179263,true,16409527187,22,16662510693,252983506
1635789785,-179262,true,16411168139,22,16660844608,249676469
1635789858,-179262,true,16411168139,22,16659178690,248010551
1635789873,-179256,true,16421017302,22,16659178690,238161388
1635790032,-179258,true,16417733591,22,16650851599,233118008
1635790064,-179256,true,16421017302,22,16647521928,226504626
1635790153,-179258,true,16417733591,22,16630883559,213149968
1635790184,-179253,true,16425944100,22,16624232868,198288768
1635790335,-179256,true,16421017302,22,16592678390,171661088
1635790660,-179256,true,16421017302,22,16531401975,110384673
1635790777,-179255,true,16422659404,22,16508275361,85615957
1635790960,-179249,true,16432515463,22,16478588675,46073212
1635791111,-179254,true,16424301670,22,16453890555,29588885
1635791217,-179254,true,16424301670,22,16439089455,14787785
1635791261,-179254,true,16424301670,22,16430872376,6570706
1635791316,-179249,true,16432515463,22,16429229453,-3286010
1635791494,-179251,true,16429229453,22,16421017302,-8212151
1635791819,-179250,true,16430872376,22,16411168139,-19704237
1635791863,-179250,true,16430872376,22,16409527187,-21345189
1635791934,-179244,true,16440733364,22,16422659404,-18073960
1635792046,-179246,true,16437445711,22,16439089455,1643744
1635792177,-179246,true,16437445711,22,16457181498,19735787
1635792265,-179244,true,16440733364,22,16458827216,18093852
1635792300,-179238,true,16450600271,22,16458827216,8226945
1635792328,-179241,true,16445666078,22,16458827216,13161138
1635792539,-179240,true,16447310644,22,16455535944,8225300
1635792597,-179241,true,16445666078,22,16453890555,8224477
1635792614,-179236,true,16453890555,22,16452245331,-1645224
1635792845,-179240,true,16447310644,22,16414450537,-32860107
1635793262,-179241,true,16445666078,22,16347292416,-98373662
1635793279,-179242,true,16444021675,22,16344023448,-99998227
1635793310,-179237,true,16452245331,22,16340755133,-111490198
1635793407,-179241,true,16445666078,22,16332587206,-113078872
1635793562,-179242,true,16444021675,22,16313000835,-131020840
1635793666,-179242,true,16444021675,22,16326055804,-117965871
1635793925,-179235,true,16455535944,22,16360374828,-95161116
1635794066,-179238,true,16450600271,22,16386571069,-64029202
1635794087,-179239,true,16448955375,22,16388209726,-60745649
1635794177,-179241,true,16445666078,22,16399684915,-45981163
1635794547,-179237,true,16452245331,22,16391487532,-60757799
1635794599,-179240,true,16447310644,22,16380018079,-67292565
1635794625,-179241,true,16445666078,22,16375105056,-70561022
1635794649,-179243,true,16442377438,22,16370193507,-72183931
1635794716,-179240,true,16447310644,22,16357103244,-90207400
1635794741,-179242,true,16444021675,22,16350562038,-93459637
1635794801,-179242,true,16444021675,22,16339121221,-104900454
1635794867,-179245,true,16439089455,22,16327688410,-111401045
1635795061,-179242,true,16444021675,22,16285293677,-158727998
1635795142,-179246,true,16437445711,22,16278781188,-158664523
1635795543,-179247,true,16435802131,22,16275525920,-160276211
1635795791,-179249,true,16432515463,22,16282037107,-150478356
1635795820,-179247,true,16435802131,22,16282037107,-153765024
1635795874,-179250,true,16430872376,22,16282037107,-148835269
1635796041,-179252,true,16427586694,22,16272271303,-155315391
1635796147,-179256,true,16421017302,22,16264137607,-156879695
1635796327,-179251,true,16429229453,22,16295067296,-134162157
1635796378,-179254,true,16424301670,22,16298326473,-125975197
1635796411,-179255,true,16422659404,22,16301586301,-121073103
1635796619,-179257,true,16419375365,22,16319527014,-99848351
1635796677,-179253,true,16425944100,22,16324423362,-101520738
1635797761,-179255,true,16422659404,22,16393126681,-29532723
1635797904,-179255,true,16422659404,22,16384932576,-37726828
1635798248,-179258,true,16417733591,22,16362010865,-55722726
1635798257,-179253,true,16425944100,22,16363647067,-62297033
1635798299,-179256,true,16421017302,22,16363647067,-57370235
1635798344,-179257,true,16419375365,22,16365283431,-54091934
1635798394,-179261,true,16412809256,22,16353832314,-58976942
1635798463,-179258,true,16417733591,22,16335853887,-81879704
1635798536,-179261,true,16412809256,22,16339121221,-73688035
1635798803,-179260,true,16414450537,22,16353832314,-60618223
1635798879,-179263,true,16409527187,22,16342389209,-67137978
1635799200,-179263,true,16409527187,22,16280409066,-129118121
1635799289,-179266,true,16404605313,22,16267390597,-137214716
1635799419,-179267,true,16402965016,22,16241384883,-161580133
1635799422,-179271,true,16396405470,22,16241384883,-155020587
1635799484,-179271,true,16396405470,22,16218663988,-177741482
1635799555,-179275,true,16389848547,22,16194355444,-195493103
1635799622,-179277,true,16386571069,22,16170083333,-216487736
1635799636,-179280,true,16381656081,22,16165233278,-216422803
1635799805,-179279,true,16383294247,22,16149076932,-234217315
1635799838,-179282,true,16378380241,22,16149076932,-229303309
1635799983,-179282,true,16378380241,22,16152306909,-226073332
1635800162,-179284,true,16375105056,22,16152306909,-222798147
1635800213,-179290,true,16365283431,22,16153922139,-211361292
1635800232,-179294,true,16358738954,22,16157153085,-201585869
1635800267,-179295,true,16357103244,22,16160384678,-196718566
1635800298,-179298,true,16352197094,22,16162000716,-190196378
1635800382,-179303,true,16344023448,22,16170083333,-173940115
1635800407,-179307,true,16337487472,22,16171700341,-165787131
1635800455,-179309,true,16334220465,22,16174934843,-159285622
1635800543,-179311,true,16330954111,22,16179787809,-151166302
1635800558,-179317,true,16321158967,22,16178169992,-142988975
1635800590,-179320,true,16316263598,22,16183023928,-133239670
1635800594,-179321,true,16314632135,22,16183023928,-131608207
1635800614,-179320,true,16316263598,22,16186260695,-130002903
1635800842,-179324,true,16309738724,22,16218663988,-91074736
1635800880,-179325,true,16308107913,22,16223530074,-84577839
1635800923,-179325,true,16308107913,22,16228397620,-79710293
1635801000,-179325,true,16308107913,22,16233266626,-74841287
1635801186,-179330,true,16299956305,22,16243009021,-56947284
1635801193,-179331,true,16298326473,22,16244633322,-53693151
1635801225,-179330,true,16299956305,22,16246257786,-53698519
1635801289,-179329,true,16301586301,22,16251132150,-50454151
1635801298,-179334,true,16293437952,22,16252757263,-40680689
1635801438,-179335,true,16291808771,22,16267390597,-24418174
1635801466,-179336,true,16290179753,22,16269017336,-21162417
1635801640,-179335,true,16291808771,22,16246257786,-45550985
1635801662,-179340,true,16283665310,22,16243009021,-40656289
1635801690,-179342,true,16280409066,22,16239760907,-40648159
1635801704,-179343,true,16278781188,22,16238137093,-40644095
1635801725,-179343,true,16278781188,22,16234889953,-43891235
1635801728,-179348,true,16270644238,22,16233266626,-37377612
1635801809,-179346,true,16273898530,22,16241384883,-32513647
1635801908,-179346,true,16273898530,22,16254382539,-19515991
1635802004,-179345,true,16275525920,22,16270644238,-4881682
1635802149,-179350,true,16267390597,22,16293437952,26047355
1635802243,-179346,true,16273898530,22,16304846781,30948251
1635802253,-179344,true,16277153472,22,16308107913,30954441
1635802284,-179343,true,16278781188,22,16313000835,34219647
1635802383,-179348,true,16270644238,22,16329321179,58676941
1635802425,-179345,true,16275525920,22,16334220465,58694545
1635802498,-179343,true,16278781188,22,16342389209,63608021
1635802551,-179343,true,16278781188,22,16347292416,68511228
1635802626,-179349,true,16269017336,22,16362010865,92993529
1635802683,-179347,true,16272271303,22,16362010865,89739562
1635802695,-179346,true,16273898530,22,16360374828,86476298
1635802720,-179346,true,16273898530,22,16357103244,83204714
1635803027,-179347,true,16272271303,22,16406245773,133974470
1635803066,-179343,true,16278781188,22,16404605313,125824125
1635803461,-179343,true,16278781188,22,16407886398,129105210
1635803619,-179343,true,16278781188,22,16411168139,132386951
1635803666,-179344,true,16277153472,22,16404605313,127451841
1635803745,-179339,true,16285293677,22,16399684915,114391238
1635803779,-179340,true,16283665310,22,16396405470,112740160
1635803795,-179338,true,16286922206,22,16396405470,109483264
1635803813,-179338,true,16286922206,22,16394765994,107843788
1635803877,-179334,true,16293437952,22,16393126681,99688729
1635804544,-179332,true,16296696803,22,16534708420,238011617
1635804653,-179331,true,16298326473,22,16549595612,251269139
1635804718,-179331,true,16298326473,22,16549595612,251269139
1635804810,-179326,true,16306477266,22,16544631726,238154460
1635804877,-179325,true,16308107913,22,16539669329,231561416
1635804929,-179324,true,16309738724,22,16534708420,224969696
1635805024,-179326,true,16306477266,22,16528096190,221618924
1635805039,-179322,true,16313000835,22,16526443546,213442711
1635805160,-179322,true,16313000835,22,16518182802,205181967
1635805206,-179322,true,16313000835,22,16509926188,196925353
1635805259,-179323,true,16311369698,22,16501673701,190304003
1635805464,-179320,true,16316263598,22,16465411735,149148137
1635805648,-179321,true,16314632135,22,16440733364,126101229
1635806066,-179322,true,16313000835,22,16350562038,37561203
1635806336,-179325,true,16308107913,22,16317895225,9787312
1635806459,-179321,true,16314632135,22,16309738724,-4893411
1635806568,-179322,true,16313000835,22,16304846781,-8154054
1635806620,-179323,true,16311369698,22,16306477266,-4892432
1635806691,-179323,true,16311369698,22,16308107913,-3261785
1635806714,-179320,true,16316263598,22,16309738724,-6524874
1635806779,-179323,true,16311369698,22,16313000835,1631137
1635806830,-179323,true,16311369698,22,16316263598,4893900
1635806888,-179322,true,16313000835,22,16317895225,4894390
1635806943,-179318,true,16319527014,22,16321158967,1631953
1635807140,-179318,true,16319527014,22,16330954111,11427097
1635807207,-179318,true,16319527014,22,16334220465,14693451
1635807256,-179316,true,16322791083,22,16335853887,13062804
1635807468,-179312,true,16329321179,22,16327688410,-1632769
1635807525,-179312,true,16329321179,22,16326055804,-3265375
1635807533,-179312,true,16329321179,22,16324423362,-4897817
1635807559,-179312,true,16329321179,22,16321158967,-8162212
1635807563,-179309,true,16334220465,22,16321158967,-13061498
1635807570,-179310,true,16332587206,22,16322791083,-9796123
1635807605,-179307,true,16337487472,22,16329321179,-8166293
1635807640,-179304,true,16342389209,22,16334220465,-8168744
1635807676,-179301,true,16347292416,22,16339121221,-8171195
1635807679,-179302,true,16345657850,22,16339121221,-6536629
1635807760,-179301,true,16347292416,22,16337487472,-9804944
1635807781,-179299,true,16350562038,22,16337487472,-13074566
1635807884,-179294,true,16358738954,22,16357103244,-1635710
1635808007,-179294,true,16358738954,22,16375105056,16366102
1635808052,-179293,true,16360374828,22,16381656081,21281253
1635808058,-179289,true,16366919960,22,16381656081,14736121
1635808136,-179286,true,16371830527,22,16391487532,19657005
1635808235,-179289,true,16366919960,22,16388209726,21289766
1635808392,-179290,true,16365283431,22,16401324884,36041453
1635808806,-179288,true,16368556652,22,16380018079,11461427
1635808870,-179285,true,16373467710,22,16370193507,-3274203
1635808953,-179288,true,16368556652,22,16357103244,-11453408
1635809113,-179289,true,16366919960,22,16352197094,-14722866
1635809145,-179286,true,16371830527,22,16353832314,-17998213
1635809225,-179283,true,16376742567,22,16345657850,-31084717
1635809246,-179286,true,16371830527,22,16344023448,-27807079
1635809267,-179288,true,16368556652,22,16340755133,-27801519
1635809324,-179285,true,16373467710,22,16334220465,-39247245
1635809387,-179283,true,16376742567,22,16327688410,-49054157
1635809552,-179286,true,16371830527,22,16304846781,-66983746
1635809718,-179287,true,16370193507,22,16282037107,-88156400
1635809804,-179284,true,16375105056,22,16273898530,-101206526
1635809807,-179281,true,16380018079,22,16272271303,-107746776
1635809940,-179284,true,16375105056,22,16262511356,-112593700
1635809973,-179284,true,16375105056,22,16269017336,-106087720
1635810120,-179278,true,16384932576,22,16304846781,-80085795
1635810471,-179278,true,16384932576,22,16402965016,18032440
1635810617,-179280,true,16381656081,22,16444021675,62365594
1635810683,-179281,true,16380018079,22,16458827216,78809137
1635810816,-179275,true,16389848547,22,16476940981,87092434
1635810925,-179276,true,16388209726,22,16465411735,77202009
1635810946,-179279,true,16383294247,22,16462119146,78824899
1635811004,-179281,true,16380018079,22,16450600271,70582192
1635811048,-179276,true,16388209726,22,16442377438,54167712
1635811089,-179277,true,16386571069,22,16432515463,45944394
1635811153,-179280,true,16381656081,22,16419375365,37719284
1635811201,-179280,true,16381656081,22,16419375365,37719284
1635811205,-179274,true,16391487532,22,16419375365,27887833
1635811220,-179275,true,16389848547,22,16417733591,27885044
1635811231,-179277,true,16386571069,22,16416091982,29520913
1635811285,-179278,true,16384932576,22,16409527187,24594611
1635811359,-179274,true,16391487532,22,16416091982,24604450
1635811446,-179274,true,16391487532,22,16421017302,29529770
1635811544,-179274,true,16391487532,22,16427586694,36099162
1635811574,-179275,true,16389848547,22,16430872376,41023829
1635811607,-179270,true,16398045111,22,16427586694,29541583
1635811776,-179270,true,16398045111,22,16467058276,69013165
1635811780,-179270,true,16398045111,22,16467058276,69013165
1635811802,-179271,true,16396405470,22,16470351852,73946382
1635811817,-179267,true,16402965016,22,16471998887,69033871
1635811898,-179270,true,16398045111,22,16481884558,83839447
1635811926,-179272,true,16394765994,22,16485181100,90415106
1635812066,-179274,true,16391487532,22,16504974201,113486669
1635812068,-179269,true,16399684915,22,16504974201,105289286
1635812097,-179273,true,16393126681,22,16498373861,105247180
1635812247,-179276,true,16388209726,22,16468704982,80495256
1635812372,-179279,true,16383294247,22,16435802131,52507884
1635812538,-179274,true,16391487532,22,16404605313,13117781
1635812548,-179278,true,16384932576,22,16401324884,16392308
1635812584,-179281,true,16380018079,22,16389848547,9830468
1635812655,-179283,true,16376742567,22,16366919960,-9822607
1635812699,-179278,true,16384932576,22,16355467697,-29464879
1635812714,-179281,true,16380018079,22,16352197094,-27820985
1635812792,-179283,true,16376742567,22,16340755133,-35987434
1635812818,-179284,true,16375105056,22,16335853887,-39251169
1635812874,-179279,true,16383294247,22,16327688410,-55605837
1635812878,-179281,true,16380018079,22,16326055804,-53962275
1635812908,-179283,true,16376742567,22,16319527014,-57215553
1635812975,-179285,true,16373467710,22,16308107913,-65359797
1635813111,-179280,true,16381656081,22,16303216459,-78439622
1635813317,-179283,true,16376742567,22,16291808771,-84933796
1635813341,-179285,true,16373467710,22,16290179753,-83287957
1635813394,-179287,true,16370193507,22,16286922206,-83271301
1635813575,-179282,true,16378380241,22,16278781188,-99599053
1635813600,-179285,true,16373467710,22,16277153472,-96314238
1635813653,-179287,true,16370193507,22,16275525920,-94667587
1635813963,-179289,true,16366919960,22,16270644238,-96275722
1635814024,-179284,true,16375105056,22,16270644238,-104460818
1635814077,-179286,true,16371830527,22,16272271303,-99559224
1635814117,-179288,true,16368556652,22,16273898530,-94658122
1635814137,-179289,true,16366919960,22,16273898530,-93021430
1635814190,-179284,true,16375105056,22,16273898530,-101206526
1635814252,-179286,true,16371830527,22,16273898530,-97931997
1635814362,-179288,true,16368556652,22,16269017336,-99539316
1635814376,-179293,true,16360374828,22,16269017336,-91357492
1635814427,-179291,true,16363647067,22,16267390597,-96256470
1635814445,-179293,true,16360374828,22,16267390597,-92984231
1635814486,-179295,true,16357103244,22,16265764021,-91339223
1635814498,-179297,true,16353832314,22,16267390597,-86441717
1635814695,-179292,true,16362010865,22,16277153472,-84857393
1635814721,-179296,true,16355467697,22,16278781188,-76686509
1635814758,-179298,true,16352197094,22,16280409066,-71788028
1635814953,-179301,true,16347292416,22,16288550898,-58741518
1635815325,-179297,true,16353832314,22,16313000835,-40831479
1635815369,-179300,true,16348927145,22,16316263598,-32663547
1635815496,-179300,true,16348927145,22,16313000835,-35926310
1635815519,-179303,true,16344023448,22,16313000835,-31022613
1635815537,-179299,true,16350562038,22,16311369698,-39192340
1635815949,-179301,true,16347292416,22,16301586301,-45706115
1635815962,-179302,true,16345657850,22,16303216459,-42441391
1635816026,-179305,true,16340755133,22,16273898530,-66856603
1635816294,-179304,true,16342389209,22,16174934843,-167454366
1635816562,-179311,true,16330954111,22,16084612861,-246341250
1635816577,-179311,true,16330954111,22,16078180624,-252773487
1635816581,-179314,true,16326055804,22,16076572967,-249482837
1635816739,-179312,true,16329321179,22,16018804239,-310516940
1635816775,-179319,true,16317895225,22,16005994960,-311900265
1635817104,-179319,true,16317895225,22,15974016558,-343878667
1635817159,-179321,true,16314632135,22,15982005164,-332626971
1635817213,-179319,true,16317895225,22,15989997765,-327897460
1635817270,-179326,true,16306477266,22,15999594163,-306883103
1635817289,-179323,true,16311369698,22,16002794241,-308575457
1635817384,-179326,true,16306477266,22,16018804239,-287673027
1635817410,-179326,true,16306477266,22,16025212722,-281264544
1635817497,-179333,true,16295067296,22,16047662608,-247404688
1635817502,-179332,true,16296696803,22,16049267375,-247429428
1635817641,-179334,true,16293437952,22,16089438728,-203999224
1635817743,-179333,true,16295067296,22,16116812666,-178254630
1635817788,-179340,true,16283665310,22,16121648194,-162017116
1635817816,-179338,true,16286922206,22,16124872684,-162049522
1635817917,-179341,true,16282037107,22,16137777098,-144260009
1635818148,-179341,true,16282037107,22,16145847601,-136189506
1635818153,-179347,true,16272271303,22,16145847601,-126423702
1635818208,-179344,true,16277153472,22,16142618916,-134534556
1635818568,-179348,true,16270644238,22,16099094805,-171549433
1635818696,-179348,true,16270644238,22,16099094805,-171549433
1635818737,-179355,true,16259259342,22,16102314785,-156944557
1635818756,-179354,true,16260885268,22,16102314785,-158570483
1635818771,-179355,true,16259259342,22,16103925016,-155334326
1635818821,-179360,true,16251132150,22,16099094805,-152037345
1635818839,-179367,true,16239760907,22,16100704714,-139056193
1635818844,-179367,true,16239760907,22,16100704714,-139056193
1635818855,-179370,true,16234889953,22,16099094805,-135795148
1635819010,-179375,true,16226774942,22,16066930398,-159844544
1635819064,-179385,true,16210557089,22,16058899343,-151657746
1635819211,-179384,true,16212178144,22,16034830253,-177347891
1635819243,-179387,true,16207315463,22,16023610361,-183705102
1635819289,-179393,true,16197594477,22,16017202519,-180391958
1635819459,-179400,true,16186260695,22,15982005164,-204255531
1635819467,-179400,true,16186260695,22,15980407123,-205853572
1635819557,-179402,true,16183023928,22,15959647129,-223376799
1635819872,-179408,true,16173317511,22,15924576251,-248741260
1635819890,-179414,true,16163616916,22,15924576251,-239040665
1635820000,-179412,true,16166849801,22,15919799833,-247049968
1635820057,-179413,true,16165233278,22,15915024849,-250208429
1635820071,-179420,true,16153922139,22,15913433505,-240488634
1635820345,-179424,true,16147462186,22,15950074691,-197387495
1635820460,-179422,true,16150691840,22,15954860192,-195831648
1635820596,-179423,true,16149076932,22,15958051324,-191025608
1635820663,-179429,true,16139390876,22,15961243094,-178147782
1635820722,-179433,true,16132936733,22,15962839218,-170097515
1635820801,-179430,true,16137777098,22,15982005164,-155771934
1635820839,-179430,true,16137777098,22,15988398925,-149378173
1635820935,-179434,true,16131323601,22,16028417925,-102905676
1635821031,-179437,true,16126485172,22,16058899343,-67585829
1635821101,-179432,true,16134550027,22,16074965471,-59584556
1635821162,-179431,true,16136163482,22,16091047672,-45115810
1635821195,-179434,true,16131323601,22,16100704714,-30618887
1635821269,-179436,true,16128097820,22,16126485172,-1612648
1635821399,-179432,true,16134550027,22,16173317511,38767484
1635821445,-179430,true,16137777098,22,16191117058,53339960
1635821467,-179433,true,16132936733,22,16200834158,67897425
1635821713,-179435,true,16129710630,22,16277153472,147442842
1635821819,-179431,true,16136163482,22,16282037107,145873625
1635821822,-179430,true,16137777098,22,16282037107,144260009
1635821851,-179433,true,16132936733,22,16282037107,149100374
1635821905,-179436,true,16128097820,22,16282037107,153939287
1635821914,-179432,true,16134550027,22,16282037107,147487080
1635821949,-179432,true,16134550027,22,16278781188,144231161
1635822010,-179436,true,16128097820,22,16273898530,145800710
1635822027,-179439,true,16123260358,22,16270644238,147383880
1635822087,-179435,true,16129710630,22,16260885268,131174638
1635822149,-179435,true,16129710630,22,16246257786,116547156
1635822385,-179439,true,16123260358,22,16195974879,72714521
1635822627,-179443,true,16116812666,22,16144233178,27420512
1635822748,-179439,true,16123260358,22,16126485172,3224814
1635822836,-179439,true,16123260358,22,16115201146,-8059212
1635822850,-179445,true,16113589787,22,16115201146,1611359
1635822901,-179448,true,16108756677,22,16111978589,3221912
1635823262,-179444,true,16115201146,22,16111978589,-3222557
1635823264,-179445,true,16113589787,22,16111978589,-1611198
1635823375,-179449,true,16107145962,22,16144233178,37087216
1635823470,-179451,true,16103925016,22,16178169992,74244976
1635823535,-179442,true,16118424347,22,16199214236,80789889
1635823618,-179442,true,16118424347,22,16226774942,108350595
1635823682,-179446,true,16111978589,22,16246257786,134279197
1635823707,-179448,true,16108756677,22,16254382539,145625862
1635823790,-179439,true,16123260358,22,16278781188,155520830
1635823857,-179438,true,16124872684,22,16296696803,171824119
1635823873,-179440,true,16121648194,22,16298326473,176678279
1635823880,-179437,true,16126485172,22,16298326473,171841301
1635823970,-179432,true,16134550027,22,16303216459,168666432
1635823982,-179434,true,16131323601,22,16299956305,168632704
1635824044,-179434,true,16131323601,22,16309738724,178415123
1635824052,-179432,true,16134550027,22,16309738724,175188697
1635824240,-179424,true,16147462186,22,16319527014,172064828
1635824447,-179426,true,16144233178,22,16283665310,139432132
1635824506,-179427,true,16142618916,22,16275525920,132907004
1635824532,-179425,true,16145847601,22,16270644238,124796637
1635824614,-179421,true,16152306909,22,16252757263,100450354
1635824641,-179424,true,16147462186,22,16246257786,98795600
1635824677,-179426,true,16144233178,22,16238137093,93903915
1635824680,-179424,true,16147462186,22,16236513442,89051256
1635824880,-179420,true,16153922139,22,16233266626,79344487
1635824954,-179424,true,16147462186,22,16231643462,84181276
1635825181,-179426,true,16144233178,22,16218663988,74430810
1635825374,-179424,true,16147462186,22,16212178144,64715958
1635825406,-179420,true,16153922139,22,16208936195,55014056
1635825510,-179422,true,16150691840,22,16210557089,59865249
1635825522,-179422,true,16150691840,22,16210557089,59865249
1635825594,-179421,true,16152306909,22,16207315463,55008554
1635825706,-179417,true,16158768801,22,16202454241,43685440
1635825935,-179418,true,16157153085,22,16220285855,63132770
1635825946,-179419,true,16155537532,22,16220285855,64748323
1635826003,-179417,true,16158768801,22,16223530074,64761273
1635826051,-179413,true,16165233278,22,16226774942,61541664
1635826064,-179415,true,16162000716,22,16226774942,64774226
1635826176,-179416,true,16160384678,22,16213799362,53414684
1635826433,-179417,true,16158768801,22,16153922139,-4846662
1635826553,-179412,true,16166849801,22,16142618916,-24230885
1635826582,-179414,true,16163616916,22,16144233178,-19383738
1635826623,-179413,true,16165233278,22,16145847601,-19385677
1635826749,-179410,true,16170083333,22,16139390876,-30692457
1635827114,-179405,true,16178169992,22,16150691840,-27478152
1635827129,-179406,true,16176552336,22,16152306909,-24245427
1635827462,-179405,true,16178169992,22,16208936195,30766203
1635827590,-179402,true,16183023928,22,16200834158,17810230
1635827664,-179397,true,16191117058,22,16189498109,-1618949
1635827734,-179399,true,16187879321,22,16179787809,-8091512
1635827786,-179399,true,16187879321,22,16173317511,-14561810
1635827812,-179398,true,16189498109,22,16168466486,-21031623
1635828004,-179392,true,16199214236,22,16139390876,-59823360
1635828031,-179394,true,16195974879,22,16134550027,-61424852
1635828055,-179394,true,16195974879,22,16131323601,-64651278
1635828259,-179394,true,16195974879,22,16126485172,-69489707
1635828263,-179388,true,16205694894,22,16126485172,-79209722
1635828276,-179389,true,16204074486,22,16124872684,-79201802
1635828362,-179389,true,16204074486,22,16120036190,-84038296
1635828420,-179388,true,16205694894,22,16118424347,-87270547
1635828769,-179383,true,16213799362,22,16147462186,-66337176
1635828818,-179386,true,16208936195,22,16150691840,-58244355
1635828823,-179388,true,16205694894,22,16150691840,-55003054
1635828919,-179389,true,16204074486,22,16158768801,-45305685
1635828929,-179385,true,16210557089,22,16160384678,-50172411
1635829075,-179389,true,16204074486,22,16158768801,-45305685
1635829278,-179391,true,16200834158,22,16155537532,-45296626
1635829297,-179393,true,16197594477,22,16155537532,-42056945
1635829377,-179390,true,16202454241,22,16152306909,-50147332
1635829401,-179393,true,16197594477,22,16152306909,-45287568
1635829549,-179396,true,16192736170,22,16150691840,-42044330
1635829620,-179397,true,16191117058,22,16147462186,-43654872
1635829653,-179393,true,16197594477,22,16147462186,-50132291
1635829698,-179397,true,16191117058,22,16142618916,-48498142
1635829856,-179401,true,16184642230,22,16121648194,-62994036
1635830061,-179403,true,16181405787,22,16100704714,-80701073
1635830114,-179399,true,16187879321,22,16095875469,-92003852
1635830174,-179403,true,16181405787,22,16089438728,-91967059
1635830240,-179406,true,16176552336,22,16083004561,-93547775
1635830293,-179406,true,16176552336,22,16078180624,-98371712
1635830311,-179402,true,16183023928,22,16076572967,-106450961
1635830335,-179405,true,16178169992,22,16074965471,-103204521
1635830403,-179407,true,16174934843,22,16065323866,-109610977
1635830587,-179408,true,16173317511,22,16044453557,-128863954
1635830658,-179404,true,16179787809,22,16042849272,-136938537
1635830799,-179406,true,16176552336,22,16047662608,-128889728
1635830833,-179409,true,16171700341,22,16047662608,-124037733
1635830875,-179410,true,16170083333,22,16047662608,-122420725
1635830927,-179405,true,16178169992,22,16049267375,-128902617
1635830965,-179408,true,16173317511,22,16047662608,-125654903
1635831154,-179413,true,16165233278,22,16041245148,-123988130
1635831355,-179415,true,16162000716,22,16033226931,-128773785
1635831408,-179415,true,16162000716,22,16044453557,-117547159
1635831430,-179418,true,16157153085,22,16047662608,-109490477
1635831445,-179422,true,16150691840,22,16050872301,-99819539
1635831673,-179422,true,16150691840,22,16084612861,-66078979
1635831790,-179420,true,16153922139,22,16128097820,-25824319
1635831815,-179422,true,16150691840,22,16137777098,-12914742
1635831911,-179425,true,16145847601,22,16174934843,29087242
1635832143,-179421,true,16152306909,22,16270644238,118337329
1635832173,-179415,true,16162000716,22,16283665310,121664594
1635832452,-179414,true,16163616916,22,16373467710,209850794
1635832688,-179418,true,16157153085,22,16409527187,252374102
1635832709,-179413,true,16165233278,22,16411168139,245934861
1635832765,-179410,true,16170083333,22,16412809256,242725923
1635832781,-179409,true,16171700341,22,16412809256,241108915
1635832867,-179414,true,16163616916,22,16412809256,249192340
1635832999,-179410,true,16170083333,22,16404605313,234521980
1635833178,-179407,true,16174934843,22,16388209726,213274883
1635833276,-179406,true,16176552336,22,16380018079,203465743
1635833358,-179410,true,16170083333,22,16373467710,203384377
1635833395,-179406,true,16176552336,22,16370193507,193641171
1635833486,-179403,true,16181405787,22,16360374828,178969041
1635833670,-179402,true,16183023928,22,16344023448,160999520
1635833802,-179406,true,16176552336,22,16340755133,164202797
1635833898,-179403,true,16181405787,22,16340755133,159349346
1635833956,-179400,true,16186260695,22,16340755133,154494438
1635834134,-179399,true,16187879321,22,16340755133,152875812
1635834377,-179403,true,16181405787,22,16339121221,157715434
1635834470,-179399,true,16187879321,22,16339121221,151241900
1635834536,-179395,true,16194355444,22,16337487472,143132028
1635834727,-179396,true,16192736170,22,16330954111,138217941
1635834786,-179400,true,16186260695,22,16339121221,152860526
1635834801,-179396,true,16192736170,22,16340755133,148018963
1635834845,-179393,true,16197594477,22,16344023448,146428971
1635834940,-179391,true,16200834158,22,16352197094,151362936
1635835230,-179393,true,16197594477,22,16376742567,179148090
1635835236,-179386,true,16208936195,22,16380018079,171081884
1635835401,-179384,true,16212178144,22,16368556652,156378508
1635835541,-179383,true,16213799362,22,16365283431,151484069
1635835802,-179387,true,16207315463,22,16332587206,125271743
1635836005,-179383,true,16213799362,22,16313000835,99201473
1635836229,-179381,true,16217042284,22,16303216459,86174175
1635836234,-179380,true,16218663988,22,16303216459,84552471
1635836511,-179383,true,16213799362,22,16330954111,117154749
1635836535,-179378,true,16221907883,22,16334220465,112312582
1635836590,-179376,true,16225152427,22,16339121221,113968794
1635836962,-179374,true,16228397620,22,16355467697,127070077
1635837024,-179376,true,16225152427,22,16358738954,133586527
1635837032,-179371,true,16233266626,22,16358738954,125472328
1635837201,-179368,true,16238137093,22,16357103244,118966151
1635837267,-179367,true,16239760907,22,16350562038,110801131
1635837373,-179369,true,16236513442,22,16352197094,115683652
1635837526,-179364,true,16244633322,22,16355467697,110834375
1635837560,-179362,true,16247882411,22,16355467697,107585286
1635837705,-179361,true,16249507200,22,16358738954,109231754
1635837874,-179363,true,16246257786,22,16360374828,114117042
1635838003,-179358,true,16254382539,22,16365283431,110900892
1635838024,-179357,true,16256007977,22,16365283431,109275454
1635838199,-179356,true,16257633578,22,16362010865,104377287
1635838361,-179359,true,16252757263,22,16342389209,89631946
1635838432,-179354,true,16260885268,22,16332587206,71701938
1635838881,-179353,true,16262511356,22,16285293677,22782321
1635839233,-179353,true,16262511356,22,16267390597,4879241
1635839433,-179355,true,16259259342,22,16262511356,3252014
1635839683,-179351,true,16265764021,22,16256007977,-9756044
1635839699,-179350,true,16267390597,22,16257633578,-9757019
1635839905,-179349,true,16269017336,22,16269017336,0
1635840068,-179352,true,16264137607,22,16282037107,17899500
1635840235,-179346,true,16273898530,22,16293437952,19539422
1635840281,-179345,true,16275525920,22,16295067296,19541376
1635840514,-179344,true,16277153472,22,16306477266,29323794
1635840635,-179346,true,16273898530,22,16283665310,9766780
1635840658,-179341,true,16282037107,22,16280409066,-1628041
1635840770,-179340,true,16283665310,22,16264137607,-19527703
1635840896,-179341,true,16282037107,22,16244633322,-37403785
1635841028,-179343,true,16278781188,22,16223530074,-55251114
1635841313,-179337,true,16288550898,22,16199214236,-89336662
1635841648,-179336,true,16290179753,22,16208936195,-81243558
1635841697,-179336,true,16290179753,22,16210557089,-79622664
1635841966,-179338,true,16286922206,22,16218663988,-68258218
1635842152,-179332,true,16296696803,22,16217042284,-79654519
1635842246,-179331,true,16298326473,22,16215420742,-82905731
1635842265,-179332,true,16296696803,22,16215420742,-81276061
1635842356,-179334,true,16293437952,22,16210557089,-82880863
1635842494,-179328,true,16303216459,22,16202454241,-100762218
1635842946,-179328,true,16303216459,22,16181405787,-121810672
1635843118,-179328,true,16303216459,22,16174934843,-128281616
1635843175,-179330,true,16299956305,22,16173317511,-126638794
1635843595,-179324,true,16309738724,22,16187879321,-121859403
1635843613,-179323,true,16311369698,22,16187879321,-123490377
1635844253,-179325,true,16308107913,22,16173317511,-134790402
1635844273,-179327,true,16304846781,22,16171700341,-133146440
1635844499,-179324,true,16309738724,22,16160384678,-149354046
1635844526,-179326,true,16306477266,22,16162000716,-144476550
1635844623,-179327,true,16304846781,22,16166849801,-137996980
1635844720,-179330,true,16299956305,22,16171700341,-128255964
1635845205,-179330,true,16299956305,22,16192736170,-107220135
1635845360,-179331,true,16298326473,22,16202454241,-95872232
1635845517,-179333,true,16295067296,22,16205694894,-89372402
1635845572,-179336,true,16290179753,22,16204074486,-86105267
1635845620,-179336,true,16290179753,22,16204074486,-86105267
1635845660,-179337,true,16288550898,22,16204074486,-84476412
1635845980,-179339,true,16285293677,22,16204074486,-81219191
1635846057,-179341,true,16282037107,22,16202454241,-79582866
1635846109,-179340,true,16283665310,22,16200834158,-82831152
1635846250,-179342,true,16280409066,22,16189498109,-90910957
1635846287,-179344,true,16277153472,22,16189498109,-87655363
1635846340,-179346,true,16273898530,22,16189498109,-84400421
1635846347,-179346,true,16273898530,22,16189498109,-84400421
1635846385,-179345,true,16275525920,22,16191117058,-84408862
1635846406,-179348,true,16270644238,22,16189498109,-81146129
1635846439,-179351,true,16265764021,22,16184642230,-81121791
1635846538,-179349,true,16269017336,22,16191117058,-77900278
1635846660,-179351,true,16265764021,22,16171700341,-94063680
1635846738,-179354,true,16260885268,22,16153922139,-106963129
1635846740,-179357,true,16256007977,22,16153922139,-102085838
1635847020,-179358,true,16254382539,22,16105535409,-148847130
1635847030,-179360,true,16251132150,22,16105535409,-145596741
1635847052,-179362,true,16247882411,22,16102314785,-145567626
1635847116,-179366,true,16241384883,22,16095875469,-145509414
1635847125,-179366,true,16241384883,22,16094266042,-147118841
1635847721,-179372,true,16231643462,22,15951669699,-279973763
1635847775,-179377,true,16223530074,22,15943696256,-279833818
1635847783,-179380,true,16218663988,22,15942102046,-276561942
1635847932,-179381,true,16217042284,22,15922983953,-294058331
1635848034,-179385,true,16210557089,22,15907069723,-303487366
1635848081,-179389,true,16204074486,22,15907069723,-297004763
1635848253,-179391,true,16200834158,22,15903888786,-296945372
1635848292,-179392,true,16199214236,22,15903888786,-295325450
1635848318,-179397,true,16191117058,22,15903888786,-287228272
1635848450,-179401,true,16184642230,22,15907069723,-277572507
1635848579,-179403,true,16181405787,22,15911842321,-269563466
1635848684,-179404,true,16179787809,22,15916616351,-263171458
1635848717,-179409,true,16171700341,22,15916616351,-255083990
1635848755,-179413,true,16165233278,22,15916616351,-248616927
1635848816,-179415,true,16162000716,22,15916616351,-245384365
1635848899,-179416,true,16160384678,22,15918208013,-242176665
1635848902,-179421,true,16152306909,22,15918208013,-234098896
1635849199,-179425,true,16145847601,22,15916616351,-229231250
1635849313,-179428,true,16141004815,22,15903888786,-237116029
1635849324,-179430,true,16137777098,22,15905479175,-232297923
1635850206,-179436,true,16128097820,22,15799273959,-328823861
1635850369,-179441,true,16120036190,22,15794535125,-325501065
1635850501,-179444,true,16115201146,22,15796114578,-319086568
1635850521,-179446,true,16111978589,22,15796114578,-315864011
1635850622,-179453,true,16100704714,22,15794535125,-306169589
1635850669,-179457,true,16094266042,22,15794535125,-299730917
1635850765,-179460,true,16089438728,22,15781905181,-307533547
1635850805,-179462,true,16086221323,22,15775593997,-310627326
1635850824,-179469,true,16074965471,22,15772439351,-302526120
1635851069,-179472,true,16070143945,22,15774016595,-296127350
1635851087,-179474,true,16066930398,22,15774016595,-292913803
1635851144,-179475,true,16065323866,22,15775593997,-289729869
1635851372,-179481,true,16055688045,22,15797694190,-257993855
1635851375,-179483,true,16052477389,22,15797694190,-254783199
1635851500,-179486,true,16047662608,22,15808755894,-238906714
1635851559,-179488,true,16044453557,22,15804014216,-240439341
1635851602,-179496,true,16031623768,22,15802433972,-229189796
1635851846,-179500,true,16025212722,22,15785061720,-240151002
1635851939,-179502,true,16022008160,22,15780327148,-241681012
1635851962,-179503,true,16020406119,22,15788218890,-232187229
1635851994,-179510,true,16009196319,22,15791376692,-217819627
1635852126,-179508,true,16012398319,22,15797694190,-214704129
1635852161,-179509,true,16010797239,22,15799273959,-211523280
1635852176,-179511,true,16007595560,22,15799273959,-208321601
1635852242,-179519,true,15994795244,22,15799273959,-195521285
1635852269,-179517,true,15997994363,22,15799273959,-198720404
1635852358,-179519,true,15994795244,22,15802433972,-192361272
1635852426,-179521,true,15991596765,22,15807175176,-184421589
1635852495,-179528,true,15980407123,22,15822989467,-157417656
1635852499,-179526,true,15983603365,22,15822989467,-160613898
1635852516,-179527,true,15982005164,22,15829319612,-152685552
1635852630,-179531,true,15975613960,22,15840403460,-135210500
1635852922,-179540,true,15961243094,22,15819825343,-141417751
1635853197,-179537,true,15966031946,22,15797694190,-168337756
1635853269,-179538,true,15964435502,22,15810336770,-154098732
1635853340,-179541,true,15959647129,22,15830902544,-128744585
1635853382,-179548,true,15948479843,22,15837235855,-111243988
1635853437,-179539,true,15962839218,22,15856250994,-106588224
1635853612,-179541,true,15959647129,22,15903888786,-55758343
1635853627,-179544,true,15954860192,22,15911842321,-43017871
1635853786,-179552,true,15942102046,22,15946885155,4783109
1635853839,-179546,true,15951669699,22,15956455678,4785979
1635853959,-179549,true,15946885155,22,15967628549,20743394
1635854012,-179552,true,15942102046,22,15977211521,35109475
1635854069,-179559,true,15930947037,22,15997994363,67047326
1635854503,-179552,true,15942102046,22,15969225312,27123266
1635854778,-179555,true,15937320372,22,15986800245,49479873
1635854963,-179558,true,15932540132,22,15983603365,51063233
1635854990,-179565,true,15921391813,22,15982005164,60613351
1635855022,-179558,true,15932540132,22,15980407123,47866991
1635855056,-179561,true,15927761326,22,15978809243,51047917
1635855065,-179565,true,15921391813,22,15978809243,57417430
1635855132,-179572,true,15910251296,22,15978809243,68557947
1635855192,-179564,true,15922983953,22,15977211521,54227568
1635855233,-179567,true,15918208013,22,15974016558,55808545
1635855359,-179572,true,15910251296,22,15962839218,52587922
1635855391,-179580,true,15897528821,22,15959647129,62118308
1635855531,-179573,true,15908660430,22,15943696256,35035826
1635855625,-179575,true,15905479175,22,15930947037,25467862
1635855645,-179581,true,15895939227,22,15927761326,31822099
1635855656,-179588,true,15884816519,22,15926168709,41352190
1635855697,-179580,true,15897528821,22,15918208013,20679192
1635855800,-179584,true,15891171399,22,15897528821,6357422
1635855888,-179588,true,15884816519,22,15881640032,-3176487
1635856115,-179594,true,15875288964,22,15846740572,-28548392
1635856269,-179587,true,15886405000,22,15830902544,-55502456
1635856444,-179590,true,15881640032,22,15821407326,-60232706
1635856487,-179594,true,15875288964,22,15818243519,-57045445
1635856544,-179597,true,15870527329,22,15816661853,-53865476
1635856582,-179589,true,15883228196,22,15815080345,-68147851
1635856705,-179592,true,15878464180,22,15816661853,-61802327
1635856787,-179597,true,15870527329,22,15815080345,-55446984
1635856988,-179600,true,15865767123,22,15810336770,-55430353
1635857027,-179592,true,15878464180,22,15813498995,-64965185
1635857267,-179596,true,15872114382,22,15797694190,-74420192
1635857271,-179600,true,15865767123,22,15797694190,-68072933
1635857333,-179603,true,15861008345,22,15794535125,-66473220
1635857558,-179596,true,15872114382,22,15783483372,-88631010
1635857711,-179601,true,15864180705,22,15758251251,-105929454
1635857791,-179607,true,15854665527,22,15733059467,-121606060
1635857845,-179611,true,15848325246,22,15715763481,-132561765
1635857917,-179607,true,15854665527,22,15689070713,-165594814
1635857943,-179614,true,15843571700,22,15681228531,-162343169
1635858068,-179619,true,15835652290,22,15645204949,-190447341
1635858193,-179623,true,15829319612,22,15607703352,-221616260
1635858226,-179618,true,15837235855,22,15596782329,-240453526
1635858289,-179625,true,15826154223,22,15579636157,-246518066
1635858303,-179630,true,15818243519,22,15576520698,-241722821
1635858379,-179631,true,15816661853,22,15556285388,-260376465
1635858524,-179626,true,15824571766,22,15522100886,-302470880
1635858675,-179633,true,15813498995,22,15508137978,-305361017
1635858743,-179638,true,15805594617,22,15506587319,-299007298
1635858871,-179640,true,15802433972,22,15501936273,-300497699
1635858925,-179635,true,15810336770,22,15500386235,-309950535
1635859184,-179641,true,15800853887,22,15491089257,-309764630
1635859196,-179646,true,15792955829,22,15489540303,-303415526
1635859305,-179646,true,15792955829,22,15498836351,-294119478
1635859375,-179642,true,15799273959,22,15506587319,-292686640
1635859414,-179646,true,15792955829,22,15509688792,-283267037
1635859438,-179651,true,15785061720,22,15511239761,-273821959
1635859689,-179653,true,15781905181,22,15532969617,-248935564
1635859693,-179650,true,15786640226,22,15532969617,-253670609
1635859866,-179655,true,15778749273,22,15551619436,-227129837
1635859940,-179660,true,15770862265,22,15557841017,-213021248
1635860003,-179660,true,15770862265,22,15562508836,-208353429
1635860053,-179655,true,15778749273,22,15567178055,-211571218
1635860115,-179659,true,15772439351,22,15568734773,-203704578
1635860190,-179665,true,15762979199,22,15562508836,-200470363
1635860223,-179666,true,15761403059,22,15562508836,-198894223
1635860232,-179665,true,15762979199,22,15562508836,-200470363
1635860355,-179669,true,15756675583,22,15564065087,-192610496
1635860369,-179674,true,15748799608,22,15564065087,-184734521
1635860425,-179675,true,15747224886,22,15564065087,-183159799
1635860634,-179674,true,15748799608,22,15565621493,-183178115
1635860720,-179679,true,15740927570,22,15565621493,-175306077
1635860802,-179683,true,15734632773,22,15559396801,-175235972
1635860829,-179684,true,15733059467,22,15557841017,-175218450
1635860887,-179684,true,15733059467,22,15562508836,-170550631
1635860899,-179689,true,15725195297,22,15564065087,-161130210
1635860959,-179690,true,15723622935,22,15570291647,-153331288
1635861001,-179688,true,15726767816,22,15571848676,-154919140
1635861022,-179688,true,15726767816,22,15573405861,-153361955
1635861028,-179694,true,15717335057,22,15571848676,-145486381
1635861180,-179699,true,15709478747,22,15560952741,-148526006
1635861258,-179700,true,15707907956,22,15554729915,-153178041
1635861352,-179707,true,15696916817,22,15536076366,-160840451
1635861379,-179711,true,15690639620,22,15531416475,-159223145
1635861431,-179716,true,15682796653,22,15518996932,-163799721
1635861636,-179718,true,15679660564,22,15477154245,-202506319
1635861663,-179723,true,15671823086,22,15474059279,-197763807
1635861802,-179727,true,15665555923,22,15447777038,-217778885
1635861829,-179732,true,15657725495,22,15440055466,-217670029
1635861848,-179734,true,15654594419,22,15435424376,-219170043
1635861999,-179740,true,15645204949,22,15407666989,-237537960
1635862013,-179745,true,15637384693,22,15407666989,-229717704
1635862051,-179750,true,15629568346,22,15395346400,-234221946
1635862294,-179755,true,15621755905,22,15336958011,-284797894
1635862392,-179761,true,15612386131,22,15335424469,-276961662
1635862476,-179764,true,15607703352,22,15349231873,-258471479
1635862538,-179768,true,15601461831,22,15359979559,-241482272
1635862618,-179768,true,15601461831,22,15370734771,-230727060
1635862631,-179773,true,15593663440,22,15373809072,-219854368
1635862713,-179776,true,15588986276,22,15381497514,-207488762
1635862813,-179780,true,15582752241,22,15393807020,-188945221
1635862877,-179781,true,15581194121,22,15399965466,-181228655
1635862907,-179785,true,15574963201,22,15401505463,-173457738
1635862929,-179789,true,15568734773,22,15403045613,-165689160
1635863149,-179791,true,15565621493,22,15472512027,-93109466
1635863246,-179792,true,15564065087,22,15494187630,-69877457
1635863392,-179795,true,15559396801,22,15497286622,-62110179
1635863481,-179798,true,15554729915,22,15495737049,-58992866
1635863685,-179800,true,15551619436,22,15503486467,-48132969
1635863737,-179800,true,15551619436,22,15505036815,-46582621
1635863867,-179804,true,15545400343,22,15512790885,-32609458
1635863918,-179806,true,15542291729,22,15512790885,-29500844
1635863922,-179809,true,15537629974,22,15512790885,-24839089
1635864001,-179810,true,15536076366,22,15509688792,-26387574
1635864031,-179814,true,15529863489,22,15509688792,-20174697
1635864211,-179815,true,15528310658,22,15511239761,-17070897
1635864274,-179818,true,15523653096,22,15511239761,-12413335
1635864284,-179818,true,15523653096,22,15511239761,-12413335
1635864294,-179822,true,15517445187,22,15511239761,-6205426
1635864363,-179823,true,15515893598,22,15511239761,-4653837
1635864378,-179826,true,15511239761,22,15509688792,-1550969
1635864453,-179828,true,15508137978,22,15500386235,-7751743
1635864514,-179832,true,15501936273,22,15491089257,-10847016
1635864537,-179833,true,15500386235,22,15487991504,-12394731
1635864602,-179835,true,15497286622,22,15478701961,-18584661
1635864768,-179835,true,15497286622,22,15460139586,-37147036
1635864812,-179837,true,15494187630,22,15455502472,-38685158
1635864901,-179836,true,15495737049,22,15444687946,-51049103
1635865000,-179838,true,15492638366,22,15432337754,-60300612
1635865056,-179838,true,15492638366,22,15426166362,-66472004
1635865125,-179840,true,15489540303,22,15416913901,-72626402
1635865542,-179839,true,15491089257,22,15396885935,-94203322
1635865978,-179841,true,15487991504,22,15396885935,-91105569
1635866055,-179843,true,15484894370,22,15395346400,-89547970
1635866107,-179844,true,15483346036,22,15395346400,-87999636
1635866169,-179843,true,15484894370,22,15393807020,-91087350
1635866204,-179845,true,15481797856,22,15393807020,-87990836
1635866378,-179845,true,15481797856,22,15396885935,-84911921
1635866397,-179846,true,15480249831,22,15398425623,-81824208
1635866586,-179845,true,15481797856,22,15399965466,-81832390
1635866595,-179847,true,15478701961,22,15398425623,-80276338
1635866617,-179849,true,15475606684,22,15392267793,-83338891
1635866837,-179853,true,15469417989,22,15347697103,-121720886
1635867013,-179856,true,15464778092,22,15312439724,-152338368
1635867133,-179858,true,15461685600,22,15291018378,-170667222
1635867245,-179859,true,15460139586,22,15269627000,-190512586
1635867247,-179863,true,15453957076,22,15269627000,-184330076
1635867292,-179866,true,15449321816,22,15260468429,-188853387
1635867316,-179868,true,15446232415,22,15255891204,-190341211
1635867347,-179869,true,15444687946,22,15248265546,-196422400
1635867372,-179873,true,15438511615,22,15243691981,-194819634
1635867521,-179874,true,15436967918,22,15229979516,-206988402
1635867578,-179876,true,15433880988,22,15233025664,-200855324
1635867605,-179878,true,15430794674,22,15234548967,-196245707
1635867634,-179881,true,15426166362,22,15234548967,-191617395
1635867827,-179884,true,15421539437,22,15245216351,-176323086
1635867901,-179886,true,15418455592,22,15249790373,-168665219
1635867947,-179887,true,15416913901,22,15251315352,-165598549
1635867987,-179891,true,15410748676,22,15249790373,-160958303
1635868048,-179893,true,15407666989,22,15249790373,-157876616
1635868185,-179895,true,15404585918,22,15249790373,-154795545
1635868193,-179897,true,15401505463,22,15249790373,-151715090
1635868197,-179900,true,15396885935,22,15249790373,-147095562
1635868327,-179905,true,15389189801,22,15223889047,-165300754
1635868431,-179911,true,15379959518,22,15199551516,-180408002
1635868500,-179913,true,15376883987,22,15184360321,-192523666
1635868515,-179916,true,15372271845,22,15181323905,-190947940
1635868544,-179921,true,15364588014,22,15175252893,-189335121
1635868562,-179925,true,15358443715,22,15170701227,-187742488
1635868591,-179927,true,15355372487,22,15163118152,-192254335
1635868684,-179930,true,15350766796,22,15137364036,-213402760
1635868738,-179935,true,15343093715,22,15120722922,-222370793
1635868756,-179937,true,15340025556,22,15119211001,-220814555
1635868883,-179940,true,15335424469,22,15061869883,-273554586
1635868913,-179944,true,15329291832,22,15048320975,-280970857
1635868936,-179950,true,15320097476,22,15037791363,-282306113
1635869072,-179952,true,15317033916,22,14997246114,-319787802
1635869184,-179954,true,15313970968,22,14980759037,-333211931
1635869207,-179957,true,15309377696,22,14977763335,-331614361
1635869249,-179963,true,15300195283,22,14971773727,-328421556
1635869558,-179962,true,15301725303,22,14980759037,-320966266
1635869573,-179961,true,15303255475,22,14980759037,-322496438
1635869596,-179964,true,15298665417,22,14982257113,-316408304
1635869620,-179970,true,15289489429,22,14982257113,-307232316
1635869694,-179972,true,15286431990,22,14983755339,-302676651
1635869749,-179976,true,15280318946,22,14992747840,-287571106
1635869818,-179981,true,15272681078,22,14998745839,-273935239
1635869823,-179987,true,15263520675,22,14998745839,-264774836
1635869907,-179989,true,15260468429,22,14995746540,-264721889
1635870299,-179994,true,15252840483,22,14929913485,-322926998
1635870348,-179999,true,15245216351,22,14917974928,-327241423
1635870406,-180005,true,15236072421,22,14904555461,-331516960
1635870518,-180008,true,15231502514,22,14882216503,-349286011
1635870616,-180014,true,15222366810,22,14856939490,-365427320
1635870653,-180019,true,15214757909,22,14855453945,-359303964
1635870683,-180025,true,15205632249,22,14853968548,-351663701
1635870866,-180029,true,15199551516,22,14843574928,-355976588
1635870917,-180034,true,15191954020,22,14843574928,-348379092
1635870964,-180039,true,15184360321,22,14843574928,-340785393
1635871125,-180044,true,15176770418,22,14859911027,-316859391
1635871150,-180047,true,15172218297,22,14861397018,-310821279
1635871189,-180051,true,15166150927,22,14864369446,-301781481
1635871198,-180056,true,15158570126,22,14865855883,-292714243
1635871498,-180057,true,15157054421,22,14965786514,-191267907
1635871557,-180059,true,15154023464,22,14979261111,-174762353
1635871577,-180063,true,15147963370,22,14982257113,-165706257
1635871578,-180068,true,15140391660,22,14982257113,-158134547
1635871584,-180070,true,15137364036,22,14985253715,-152110321
1635871600,-180070,true,15137364036,22,14991248715,-146115321
1635871682,-180070,true,15137364036,22,15027269118,-110094918
1635871760,-180074,true,15131310604,22,15058857961,-72452643
1635871839,-180075,true,15129797624,22,15090513206,-39284418
1635871960,-180076,true,15128284795,22,15129797624,1512829
1635872155,-180076,true,15128284795,22,15170701227,42416432
1635872404,-180081,true,15120722922,22,15182842037,62119115
1635872514,-180082,true,15119211001,22,15188916085,69705084
1635872525,-180082,true,15119211001,22,15188916085,69705084
1635872631,-180082,true,15119211001,22,15185878757,66667756
1635872760,-180087,true,15111653662,22,15185878757,74225095
1635872798,-180087,true,15111653662,22,15185878757,74225095
1635872866,-180088,true,15110142648,22,15185878757,75736109
1635872946,-180088,true,15110142648,22,15190434976,80292328
1635873012,-180092,true,15104100102,22,15193473215,89373113
1635873036,-180092,true,15104100102,22,15198031713,93931611
1635873053,-180092,true,15104100102,22,15199551516,95451414
1635873080,-180092,true,15104100102,22,15204111838,100011736
1635873137,-180095,true,15099569778,22,15211715414,112145636
1635873159,-180096,true,15098059972,22,15213236586,115176614
1635873196,-180096,true,15098059972,22,15217801013,119741041
1635873201,-180095,true,15099569778,22,15217801013,118231235
1635873295,-180097,true,15096550317,22,15220844726,124294409
1635873406,-180096,true,15098059972,22,15223889047,125829075
1635873518,-180096,true,15098059972,22,15223889047,125829075
1635873536,-180095,true,15099569778,22,15225411436,125841658
1635873691,-180097,true,15096550317,22,15228456670,131906353
1635873785,-180098,true,15095040813,22,15208673527,113632714
1635874064,-180100,true,15092022257,22,15140391660,48369403
1635874084,-180099,true,15093531460,22,15135850451,42318991
1635874136,-180103,true,15087495556,22,15123747218,36251662
1635874346,-180104,true,15085986957,22,15081462066,-4524891
1635874406,-180107,true,15081462066,22,15078446226,-3015840
1635874817,-180104,true,15085986957,22,15101079735,15092778
1635874860,-180107,true,15081462066,22,15105610512,24148446
1635874990,-180107,true,15081462066,22,15114676144,33214078
1635875023,-180110,true,15076938532,22,15117699231,40760699
1635875065,-180108,true,15079954071,22,15122234994,42280923
1635875070,-180112,true,15073923597,22,15122234994,48311397
1635875088,-180112,true,15073923597,22,15123747218,49823621
1635875122,-180114,true,15070909264,22,15126772118,55862854
1635875176,-180112,true,15073923597,22,15132823735,58900138
1635875233,-180116,true,15067895535,22,15137364036,69468501
1635875400,-180114,true,15070909264,22,15117699231,46789967
1635875517,-180114,true,15070909264,22,15099569778,28660514
1635875595,-180112,true,15073923597,22,15089004306,15080709
1635875661,-180116,true,15067895535,22,15082970213,15074678
1635875707,-180115,true,15069402324,22,15076938532,7536208
1635875773,-180114,true,15070909264,22,15070909264,0
1635875803,-180112,true,15073923597,22,15067895535,-6028062
1635875837,-180115,true,15069402324,22,15064882408,-4519916
1635875841,-180114,true,15070909264,22,15063376070,-7533194
1635875880,-180113,true,15072416355,22,15063376070,-9040285
1635875917,-180108,true,15079954071,22,15063376070,-16578001
1635875991,-180110,true,15076938532,22,15063376070,-13562462
1635876007,-180107,true,15081462066,22,15063376070,-18085996
1635876076,-180107,true,15081462066,22,15061869883,-19592183
1635876110,-180103,true,15087495556,22,15061869883,-25625673
1635876337,-180105,true,15084478510,22,15079954071,-4524439
1635876387,-180102,true,15089004306,22,15085986957,-3017349
1635876487,-180104,true,15085986957,22,15095040813,9053856
1635876496,-180101,true,15090513206,22,15096550317,6037111
1635876601,-180103,true,15087495556,22,15098059972,10564416
1635876659,-180101,true,15090513206,22,15099569778,9056572
1635876824,-180102,true,15089004306,22,15102589843,13585537
1635877017,-180098,true,15095040813,22,15096550317,1509504
1635877077,-180100,true,15092022257,22,15093531460,1509203
1635877204,-180097,true,15096550317,22,15089004306,-7546011
1635877253,-180098,true,15095040813,22,15084478510,-10562303
1635877428,-180093,true,15102589843,22,15064882408,-37707435
1635877556,-180094,true,15101079735,22,15055846641,-45233094
1635877580,-180092,true,15104100102,22,15054341207,-49758895
1635877661,-180092,true,15104100102,22,15049825807,-54274295
1635877688,-180086,true,15113164828,22,15048320975,-64843853
1635877711,-180088,true,15110142648,22,15046816294,-63326354
1635877810,-180087,true,15111653662,22,15040799072,-70854590
1635877876,-180087,true,15111653662,22,15034784256,-76869406
1635878019,-180082,true,15119211001,22,15025766542,-93444459
1635878062,-180083,true,15117699231,22,15022761839,-94937392
1635878168,-180083,true,15117699231,22,15018255912,-99443319
1635878186,-180083,true,15117699231,22,15016754236,-100944995
1635878390,-180080,true,15122234994,22,15006246712,-115988282
1635878584,-180082,true,15119211001,22,14994247115,-124963886
1635878617,-180086,true,15113164828,22,14989749740,-123415088
1635878730,-180088,true,15110142648,22,14974768232,-135374416
1635878863,-180085,true,15114676144,22,14959801696,-154874448
1635879010,-180088,true,15110142648,22,14943355783,-166786865
1635879028,-180091,true,15105610512,22,14941861597,-163748915
1635879089,-180094,true,15101079735,22,14937379935,-163699800
1635879167,-180094,true,15101079735,22,14935886347,-165193388
1635879227,-180097,true,15096550317,22,14931406477,-165143840
1635879232,-180100,true,15092022257,22,14931406477,-160615780
1635879353,-180103,true,15087495556,22,14920958672,-166536884
1635879355,-180103,true,15087495556,22,14920958672,-166536884
1635879401,-180105,true,15084478510,22,14917974928,-166503582
1635879411,-180108,true,15079954071,22,14917974928,-161979143
1635879436,-180110,true,15076938532,22,14917974928,-158963604
1635879523,-180110,true,15076938532,22,14917974928,-158963604
1635879555,-180112,true,15073923597,22,14920958672,-152964925
1635879564,-180115,true,15069402324,22,14922450768,-146951556
1635879593,-180119,true,15063376070,22,14919466725,-143909345
1635879660,-180118,true,15064882408,22,14929913485,-134968923
1635879726,-180119,true,15063376070,22,14937379935,-125996135
1635879794,-180122,true,15058857961,22,14947839239,-111018722
1635880033,-180125,true,15054341207,22,14982257113,-72084094
1635880067,-180124,true,15055846641,22,14985253715,-70592926
1635880095,-180127,true,15051330790,22,14991248715,-60082075
1635880223,-180129,true,15048320975,22,15013751336,-34569639
1635880361,-180132,true,15043807382,22,15031777750,-12029632
1635880655,-180130,true,15046816294,22,15066388896,19572602
1635880821,-180132,true,15043807382,22,15066388896,22581514
1635881055,-180134,true,15040799072,22,15064882408,24083336
1635881162,-180136,true,15037791363,22,15052835923,15044560
1635881176,-180136,true,15037791363,22,15051330790,13539427
1635881207,-180137,true,15036287734,22,15051330790,15043056
1635881254,-180139,true,15033280928,22,15052835923,19554995
1635881302,-180138,true,15034784256,22,15046816294,12032038
1635881509,-180139,true,15033280928,22,15016754236,-16526692
1635881571,-180139,true,15033280928,22,15007747336,-25533592
1635881752,-180141,true,15030274722,22,14986752240,-43522482
1635881857,-180141,true,15030274722,22,14977763335,-52511387
1635881871,-180144,true,15025766542,22,14976265708,-49500834
1635882004,-180144,true,15025766542,22,14971773727,-53992815
1635882080,-180146,true,15022761839,22,14980759037,-42002802
1635882311,-180144,true,15025766542,22,15000245713,-25520829
1635882345,-180145,true,15024264115,22,15003245913,-21018202
1635882683,-180145,true,15024264115,22,15048320975,24056860
1635882769,-180146,true,15022761839,22,15058857961,36096122
1635882801,-180145,true,15024264115,22,15061869883,37605768
1635882864,-180147,true,15021259713,22,15064882408,43622695
1635882894,-180146,true,15022761839,22,15066388896,43627057
1635882970,-180147,true,15021259713,22,15064882408,43622695
1635883001,-180146,true,15022761839,22,15061869883,39108044
1635883093,-180149,true,15018255912,22,15046816294,28560382
1635883184,-180148,true,15019757737,22,15036287734,16529997
1635883188,-180150,true,15016754236,22,15034784256,18030020
1635883220,-180149,true,15018255912,22,15031777750,13521838
1635883340,-180151,true,15015252711,22,15019757737,4505026
1635883376,-180151,true,15015252711,22,15015252711,0
1635883493,-180152,true,15013751336,22,15004746237,-9005099
1635883550,-180151,true,15015252711,22,15000245713,-15006998
1635883585,-180154,true,15010749036,22,14997246114,-13502922
1635883742,-180154,true,15010749036,22,14982257113,-28491923
1635883804,-180155,true,15009248111,22,14979261111,-29987000
1635883809,-180155,true,15009248111,22,14979261111,-29987000
1635884094,-180157,true,15006246712,22,14985253715,-20992997
1635884170,-180158,true,15004746237,22,14983755339,-20990898
1635884214,-180159,true,15003245913,22,14983755339,-19490574
1635884287,-180159,true,15003245913,22,14979261111,-23984802
1635884507,-180163,true,14997246114,22,14964290085,-32956029
1635884555,-180163,true,14997246114,22,14961297676,-35948438
1635884614,-180165,true,14994247115,22,14953819271,-40427844
1635884648,-180164,true,14995746540,22,14949334022,-46412518
1635884748,-180169,true,14988250915,22,14937379935,-50870980
1635884768,-180169,true,14988250915,22,14934392907,-53858008
1635884877,-180171,true,14985253715,22,14919466725,-65786990
1635884895,-180170,true,14986752240,22,14917974928,-68777312
1635884936,-180174,true,14980759037,22,14912009229,-68749808
1635884948,-180175,true,14979261111,22,14910518177,-68742934
1635884991,-180178,true,14974768232,22,14898595129,-76173103
1635885281,-180173,true,14982257113,22,14914991780,-67265333
1635885315,-180176,true,14977763335,22,14925435407,-52327928
1635885468,-180174,true,14980759037,22,14967283093,-13475944
1635885486,-180176,true,14977763335,22,14971773727,-5989608
1635885514,-180168,true,14989749740,22,14980759037,-8990703
1635885569,-180171,true,14985253715,22,15001745738,16492023
1635885753,-180169,true,14988250915,22,15072416355,84165440
1635885880,-180171,true,14985253715,22,15117699231,132445516
1635886036,-180161,true,15000245713,22,15182842037,182596324
1635886042,-180163,true,14997246114,22,15185878757,188632643
1635886055,-180160,true,15001745738,22,15190434976,188689238
1635886108,-180158,true,15004746237,22,15217801013,213054776
1635886116,-180146,true,15022761839,22,15223889047,201127208
1635886145,-180146,true,15022761839,22,15242167765,219405926
1635886235,-180141,true,15030274722,22,15286431990,256157268
1635886292,-180139,true,15033280928,22,15309377696,276096768
1635886309,-180127,true,15051330790,22,15318565619,267234829
1635886331,-180127,true,15051330790,22,15329291832,277961042
1635886374,-180123,true,15057352226,22,15343093715,285741489
1635886577,-180119,true,15063376070,22,15441599472,378223402
1635886626,-180106,true,15082970213,22,15467871202,384900989
1635886804,-180105,true,15084478510,22,15574963201,490484691
1635886833,-180100,true,15092022257,22,15585868947,493846690
1635887230,-180088,true,15110142648,22,15862594446,752451798
1635887338,-180074,true,15131310604,22,15934133386,802822782
1635887404,-180072,true,15134337017,22,15948479843,814142826
1635887538,-180068,true,15140391660,22,15975613960,835222300
1635887769,-180060,true,15152508213,22,15996394724,843886511
1635887901,-180047,true,15172218297,22,15961243094,789024797
1635887951,-180045,true,15175252893,22,15956455678,781202785
1635888033,-180042,true,15179805924,22,15927761326,747955402
1635888082,-180034,true,15191954020,22,15910251296,718297276
1635888293,-180024,true,15207152812,22,15853080219,645927407
1635888419,-180022,true,15210194395,22,15849910079,639715684
1635888552,-180020,true,15213236586,22,15824571766,611335180
1635888567,-180013,true,15223889047,22,15821407326,597518279
1635888575,-180003,true,15239119788,22,15819825343,580705555
1635888639,-180004,true,15237596029,22,15808755894,571159865
1635888763,-180002,true,15240643700,22,15785061720,544418020
1635888928,-179993,true,15254365768,22,15767708566,513342798
1635888990,-179983,true,15269627000,22,15756675583,487048583
1635889017,-179983,true,15269627000,22,15750374488,480747488
1635889213,-179981,true,15272681078,22,15725195297,452514219
1635889239,-179972,true,15286431990,22,15725195297,438763307
1635889324,-179963,true,15300195283,22,15709478747,409283464
1635889419,-179962,true,15301725303,22,15704766846,403041543
1635889478,-179960,true,15304785801,22,15703196526,398410725
1635889568,-179952,true,15317033916,22,15695347283,378313367
1635889638,-179943,true,15330824762,22,15690639620,359814858
1635889815,-179942,true,15332357844,22,15660857196,328499352
1635889938,-179941,true,15333891080,22,15640512326,306621246
1635889954,-179934,true,15344628024,22,15635821111,291193087
1635889958,-179927,true,15355372487,22,15634257685,278885198
1635890139,-179931,true,15349231873,22,15564065087,214833214
1635890380,-179933,true,15346162487,22,15486442860,140280373
1635890430,-179926,true,15356908024,22,15467871202,110963178
1635890435,-179918,true,15369197851,22,15466324569,97126718
1635890538,-179922,true,15363051709,22,15432337754,69286045
1635890552,-179925,true,15358443715,22,15427708978,69265263
1635890765,-179917,true,15370734771,22,15361515557,-9219214
1635890808,-179910,true,15381497514,22,15350766796,-30730718
1635891230,-179913,true,15376883987,22,15309377696,-67506291
1635891348,-179915,true,15373809072,22,15307846911,-65962161
1635891433,-179907,true,15386112425,22,15306316279,-79796146
1635891476,-179899,true,15398425623,22,15303255475,-95170148
1635891550,-179903,true,15392267793,22,15297135703,-95132090
1635891609,-179906,true,15387651036,22,15291018378,-96632658
1635891823,-179899,true,15398425623,22,15271153962,-127271661
1635891896,-179892,true,15409207756,22,15266573532,-142634224
1635891963,-179896,true,15403045613,22,15255891204,-147154409
1635891977,-179899,true,15398425623,22,15252840483,-145585140
1635892106,-179894,true,15406126376,22,15231502514,-174623862
1635892199,-179887,true,15416913901,22,15211715414,-205198487
1635892260,-179892,true,15409207756,22,15194992563,-214215193
1635892288,-179895,true,15404585918,22,15188916085,-215669833
1635892344,-179890,true,15412289751,22,15175252893,-237036858
1635892411,-179884,true,15421539437,22,15160085983,-261453454
1635892675,-179889,true,15413830980,22,15104100102,-309730878
1635892720,-179892,true,15409207756,22,15096550317,-312657439
1635892818,-179886,true,15418455592,22,15079954071,-338501521
1635892870,-179880,true,15427708978,22,15073923597,-353785381
1635892920,-179884,true,15421539437,22,15069402324,-352137113
1635893135,-179887,true,15416913901,22,15046816294,-370097607
1635893211,-179881,true,15426166362,22,15043807382,-382358980
1635893215,-179875,true,15435424376,22,15043807382,-391616994
1635893446,-179879,true,15429251749,22,15034784256,-394467493
1635893550,-179881,true,15426166362,22,15040799072,-385367290
1635893679,-179874,true,15436967918,22,15042303152,-394664766
1635893796,-179873,true,15438511615,22,15028771845,-409739770
1635894137,-179876,true,15433880988,22,15055846641,-378034347
1635894537,-179880,true,15427708978,22,15081462066,-346246912
1635894562,-179874,true,15436967918,22,15081462066,-355505852
1635894650,-179875,true,15435424376,22,15096550317,-338874059
1635894667,-179878,true,15430794674,22,15101079735,-329714939
1635894691,-179883,true,15423081591,22,15105610512,-317471079
1635894716,-179876,true,15433880988,22,15105610512,-328270476
1635894758,-179881,true,15426166362,22,15098059972,-328106390
1635894811,-179886,true,15418455592,22,15090513206,-327942386
1635894855,-179892,true,15409207756,22,15081462066,-327745690
1635894871,-179889,true,15413830980,22,15078446226,-335384754
1635894919,-179897,true,15401505463,22,15064882408,-336623055
1635894945,-179904,true,15390728720,22,15057352226,-333376494
1635895188,-179912,true,15378421676,22,14992747840,-385673836
1635895252,-179910,true,15381497514,22,14976265708,-405231806
1635895510,-179917,true,15370734771,22,14912009229,-458725542
1635895567,-179924,true,15359979559,22,14897105418,-462874141
1635895642,-179930,true,15350766796,22,14898595129,-452171667
1635895684,-179930,true,15350766796,22,14903065154,-447701642
1635895957,-179935,true,15343093715,22,14949334022,-393759693
1635895967,-179942,true,15332357844,22,14950828956,-381528888
1635896074,-179949,true,15321629485,22,14968779821,-352849664
1635896177,-179958,true,15307846911,22,14985253715,-322593196
1635896268,-179964,true,15298665417,22,14997246114,-301419303
1635896304,-179974,true,15283375162,22,14997246114,-286129048
1635896314,-179981,true,15272681078,22,14997246114,-275434964
1635896435,-179984,true,15268100190,22,15021259713,-246840477
1635896658,-179988,true,15261994476,22,15027269118,-234725358
1635896770,-179999,true,15245216351,22,15019757737,-225458614
1635896772,-180005,true,15236072421,22,15019757737,-216314684
1635897188,-180009,true,15229979516,22,15046816294,-183163222
1635897371,-180012,true,15225411436,22,15051330790,-174080646
1635897418,-180021,true,15211715414,22,15051330790,-160384624
1635897430,-180027,true,15202591579,22,15046816294,-155775285
1635897708,-180033,true,15193473215,22,15001745738,-191727477
1635897990,-180037,true,15187397345,22,14943355783,-244041562
1635898115,-180045,true,15175252893,22,14919466725,-255786168
1635898123,-180051,true,15166150927,22,14917974928,-248175999
1635898300,-180060,true,15152508213,22,14864369446,-288138767
1635898350,-180064,true,15146448725,22,14855453945,-290994780
1635898504,-180072,true,15134337017,22,14852483300,-281853717
1635898705,-180078,true,15125259592,22,14849513248,-275746344
1635898752,-180085,true,15114676144,22,14843574928,-271101216
1635898778,-180089,true,15108631785,22,14846543791,-262087994
1635898799,-180097,true,15096550317,22,14848028446,-248521871
1635898865,-180100,true,15092022257,22,14855453945,-236568312
1635898883,-180105,true,15084478510,22,14856939490,-227539020
1635899057,-180109,true,15078446226,22,14876265104,-202181122
1635899097,-180117,true,15066388896,22,14883704725,-182684171
1635899123,-180119,true,15063376070,22,14891148065,-172228005
1635899255,-180123,true,15057352226,22,14925435407,-131916819
1635899298,-180126,true,15052835923,22,14932899617,-119936306
1635899344,-180129,true,15048320975,22,14938873673,-109447302
1635899401,-180129,true,15048320975,22,14950828956,-97492019
1635899436,-180133,true,15042303152,22,14958305866,-83997286
1635899530,-180136,true,15037791363,22,14973270904,-64520459
1635899553,-180139,true,15033280928,22,14977763335,-55517593
1635899701,-180139,true,15033280928,22,14989749740,-43531188
1635899821,-180144,true,15025766542,22,14985253715,-40512827
1635899828,-180147,true,15021259713,22,14983755339,-37504374
1635899868,-180150,true,15016754236,22,14977763335,-38990901
1635899926,-180152,true,15013751336,22,14968779821,-44971515
1635899932,-180158,true,15004746237,22,14967283093,-37463144
1635899978,-180161,true,15000245713,22,14961297676,-38948037
1635899981,-180164,true,14995746540,22,14961297676,-34448864
1635900108,-180165,true,14994247115,22,14938873673,-55373442
1635900130,-180170,true,14986752240,22,14932899617,-53852623
1635900188,-180173,true,14982257113,22,14923943013,-58314100
1635900254,-180175,true,14979261111,22,14912009229,-67251882
1635900292,-180176,true,14977763335,22,14903065154,-74698181
1635900344,-180179,true,14973270904,22,14895615857,-77655047
1635900430,-180181,true,14970276699,22,14885193095,-85083604
1635900461,-180182,true,14968779821,22,14879240506,-89539315
1635900529,-180183,true,14967283093,22,14868829203,-98453890
1635900556,-180186,true,14962793806,22,14865855883,-96937923
1635900628,-180188,true,14959801696,22,14858425184,-101376512
1635900654,-180189,true,14958305866,22,14855453945,-102851921
1635900680,-180190,true,14956810185,22,14852483300,-104326885
1635900768,-180193,true,14952324039,22,14850998200,-101325839
1635900850,-180194,true,14950828956,22,14852483300,-98345656
1635901174,-180195,true,14949334022,22,14855453945,-93880077
1635901269,-180197,true,14946344604,22,14821327368,-125017236
1635901290,-180200,true,14941861597,22,14810956587,-130905010
1635901333,-180202,true,14938873673,22,14800593063,-138280610
1635901379,-180208,true,14929913485,22,14791715815,-138197670
1635901460,-180209,true,14928420643,22,14775454686,-152965957
1635901541,-180213,true,14922450768,22,14750359005,-172091763
1635901588,-180215,true,14919466725,22,14737090317,-182376408
1635901605,-180222,true,14909027275,22,14731196954,-177830321
1635901611,-180225,true,14904555461,22,14729723982,-174831479
1635901619,-180228,true,14900084988,22,14729723982,-170361006
1635901669,-180230,true,14897105418,22,14716473856,-180631562
1635901768,-180237,true,14886681614,22,14691478353,-195203261
1635901789,-180240,true,14882216503,22,14685603230,-196613273
1635901875,-180243,true,14877752731,22,14665058797,-212693934
1635901953,-180243,true,14877752731,22,14643078797,-234673934
1635902237,-180249,true,14868829203,22,14605058142,-263771061
1635902308,-180251,true,14865855883,22,14597757803,-268098080
1635902385,-180254,true,14861397018,22,14591920159,-269476859
1635902391,-180254,true,14861397018,22,14591920159,-269476859
1635902593,-180257,true,14856939490,22,14610901041,-246038449
1635902636,-180258,true,14855453945,22,14613823368,-241630577
1635902690,-180260,true,14852483300,22,14615284750,-237198550
1635902726,-180260,true,14852483300,22,14613823368,-238659932
1635902766,-180265,true,14845059285,22,14609440097,-235619188
1635902817,-180268,true,14840606658,22,14606518647,-234088011
1635902882,-180271,true,14836155366,22,14603597782,-232557584
1635902940,-180274,true,14831705410,22,14602137568,-229567842
1635902966,-180280,true,14822809500,22,14602137568,-220671932
1635902993,-180282,true,14819845383,22,14600677500,-219167883
1635903004,-180286,true,14813918927,22,14599217579,-214701348
1635903024,-180289,true,14809475640,22,14597757803,-211717837
1635903031,-180295,true,14800593063,22,14597757803,-202835260
1635903106,-180298,true,14796153773,22,14589002213,-207151560
1635903316,-180298,true,14796153773,22,14609440097,-186713676
1635903614,-180302,true,14790236791,22,14599217579,-191019212
1635903643,-180307,true,14782843891,22,14600677500,-182166391
1635903650,-180310,true,14778409924,22,14603597782,-174812142
1635903670,-180310,true,14778409924,22,14609440097,-168969827
1635903746,-180311,true,14776932231,22,14628443769,-148488462
1635903807,-180317,true,14768069174,22,14638686752,-129382422
1635903866,-180319,true,14765116003,22,14648936907,-116179096
1635903885,-180317,true,14768069174,22,14651866841,-116202333
1635903927,-180317,true,14768069174,22,14662126225,-105942949
1635903943,-180322,true,14760687354,22,14665058797,-95628557
1635903963,-180325,true,14756260034,22,14672392793,-83867241
1635904007,-180321,true,14762163423,22,14687071791,-75091632
1635904034,-180319,true,14765116003,22,14690009352,-75106651
1635904118,-180324,true,14757735660,22,14698825561,-58910099
1635904191,-180328,true,14751834041,22,14694416795,-57417246
1635904195,-180325,true,14756260034,22,14694416795,-61843239
1635904206,-180324,true,14757735660,22,14695886237,-61849423
1635904230,-180330,true,14748884117,22,14698825561,-50058556
1635904330,-180334,true,14742986037,22,14707647062,-35338975
1635904432,-180334,true,14742986037,22,14703235650,-39750387
1635904459,-180333,true,14744460336,22,14703235650,-41224686
1635904468,-180339,true,14735616755,22,14703235650,-32381105
1635904495,-180344,true,14728251157,22,14703235650,-25015507
1635904517,-180344,true,14728251157,22,14704705973,-23545184
1635904662,-180343,true,14729723982,22,14692947501,-36776481
1635904694,-180350,true,14719417298,22,14691478353,-27938945
1635904798,-180355,true,14712059797,22,14685603230,-26456567
1635904911,-180355,true,14712059797,22,14678262631,-33797166
1635904975,-180354,true,14713531003,22,14672392793,-41138210
1635905002,-180361,true,14703235650,22,14669458755,-33776895
1635905068,-180365,true,14697355826,22,14667991956,-29363870
1635905107,-180364,true,14698825561,22,14672392793,-26432768
1635905118,-180362,true,14701765473,22,14672392793,-29372680
1635905127,-180368,true,14692947501,22,14672392793,-20554708
1635905276,-180369,true,14691478353,22,14678262631,-13215722
1635905427,-180366,true,14695886237,22,14703235650,7349413
1635905469,-180365,true,14697355826,22,14701765473,4409647
1635905630,-180372,true,14687071791,22,14690009352,2937561
1635905667,-180374,true,14684134817,22,14690009352,5874535
1635905702,-180373,true,14685603230,22,14687071791,1468561
1635905716,-180372,true,14687071791,22,14685603230,-1468561
1635905758,-180379,true,14676794951,22,14681198430,4403479
1635905788,-180382,true,14672392793,22,14678262631,5869838
1635905840,-180382,true,14672392793,22,14670925701,-1467092
1635905932,-180382,true,14672392793,22,14657728467,-14664326
1635905946,-180390,true,14660660159,22,14654797361,-5862798
1635906010,-180392,true,14657728467,22,14646007559,-11720908
1635906024,-180391,true,14659194240,22,14644543105,-14651135
1635906041,-180389,true,14662126225,22,14643078797,-19047428
1635906201,-180394,true,14654797361,22,14646007559,-8789802
1635906302,-180395,true,14653332028,22,14638686752,-14645276
1635906326,-180395,true,14653332028,22,14635759454,-17572574
1635906404,-180394,true,14654797361,22,14635759454,-19037907
1635906428,-180399,true,14647472160,22,14637223030,-10249130
1635906434,-180401,true,14644543105,22,14637223030,-7320075
1635906445,-180400,true,14646007559,22,14635759454,-10248105
1635906466,-180399,true,14647472160,22,14634296024,-13176136
1635906558,-180402,true,14643078797,22,14624056113,-19022684
1635906614,-180404,true,14640150621,22,14618207953,-21942668
1635906633,-180403,true,14641614636,22,14615284750,-26329886
1635906668,-180403,true,14641614636,22,14610901041,-30713595
1635906692,-180405,true,14638686752,22,14609440097,-29246655
1635906855,-180407,true,14635759454,22,14603597782,-32161672
1635906861,-180406,true,14637223030,22,14603597782,-33625248
1635906898,-180406,true,14637223030,22,14599217579,-38005451
1635906905,-180409,true,14632832741,22,14597757803,-35074938
1635906955,-180411,true,14629906613,22,14589002213,-40904400
1635907375,-180411,true,14629906613,22,14494485935,-135420678
1635907402,-180410,true,14631369604,22,14493036631,-138332973
1635907427,-180413,true,14626981071,22,14490138459,-136842612
1635907459,-180414,true,14625518519,22,14488689590,-136828929
1635907517,-180414,true,14625518519,22,14485792286,-139726233
1635907717,-180415,true,14624056113,22,14461188589,-162867524
1635907761,-180420,true,14616746278,22,14455405559,-161340719
1635907789,-180422,true,14613823368,22,14451069805,-162753563
1635907935,-180422,true,14613823368,22,14449624842,-164198526
1635907980,-180422,true,14613823368,22,14449624842,-164198526
1635908002,-180425,true,14609440097,22,14449624842,-159815255
1635908063,-180426,true,14607979299,22,14445290821,-162688478
1635908086,-180426,true,14607979299,22,14440958101,-167021198
1635908158,-180426,true,14607979299,22,14440958101,-167021198
1635908261,-180427,true,14606518647,22,14442402197,-164116450
1635908306,-180428,true,14605058142,22,14442402197,-162655945
1635908464,-180427,true,14606518647,22,14471314458,-135204189
1635908567,-180425,true,14609440097,22,14487240866,-122199231
1635908610,-180426,true,14607979299,22,14498834716,-109144583
1635908698,-180425,true,14609440097,22,14522050258,-87389839
1635908727,-180428,true,14605058142,22,14522050258,-83007884
1635908773,-180428,true,14605058142,22,14511888888,-93169254
1635908818,-180430,true,14602137568,22,14508986945,-93150623
1635908929,-180433,true,14597757803,22,14501734627,-96023176
1635908952,-180436,true,14593379351,22,14500284599,-93094752
1635908974,-180439,true,14589002213,22,14501734627,-87267586
1635909004,-180441,true,14586084850,22,14500284599,-85800251
1635909037,-180444,true,14581709900,22,14494485935,-87223965
1635909046,-180447,true,14577336261,22,14493036631,-84299630
1635909070,-180449,true,14574421231,22,14493036631,-81384600
1635909072,-180451,true,14571506784,22,14493036631,-78470153
1635909120,-180452,true,14570049779,22,14491587472,-78462307
1635909148,-180456,true,14564223216,22,14490138459,-74084757
1635909182,-180458,true,14561310808,22,14487240866,-74069942
1635909190,-180461,true,14556943289,22,14487240866,-69702423
1635909202,-180461,true,14556943289,22,14485792286,-71151003
1635909299,-180465,true,14551121967,22,14466973932,-84148035
1635909325,-180467,true,14548212179,22,14462634708,-85577471
1635909333,-180468,true,14546757503,22,14459742614,-87014889
1635909417,-180471,true,14542394348,22,14445290821,-97103527
1635909492,-180475,true,14536578845,22,14422197990,-114380855
1635909583,-180478,true,14532218743,22,14387627944,-144590799
1635909800,-180480,true,14529312735,22,14357447135,-171865600
1635909880,-180482,true,14526407309,22,14345966344,-180440965
1635910040,-180487,true,14519146283,22,14318736247,-200410036
1635910063,-180490,true,14514791410,22,14314441485,-200349925
1635910348,-180492,true,14511888888,22,14280129731,-231759157
1635910368,-180494,true,14508986945,22,14280129731,-228857214
1635910380,-180499,true,14501734627,22,14280129731,-221604896
1635910399,-180503,true,14495935383,22,14277274134,-218661249
1635910575,-180501,true,14498834716,22,14304425383,-194409333
1635910632,-180503,true,14495935383,22,14311579026,-184356357
1635910692,-180508,true,14488689590,22,14318736247,-169953343
1635910741,-180512,true,14482895562,22,14320168120,-162727442
1635910804,-180511,true,14484343852,22,14330195246,-154148606
1635910839,-180514,true,14479999418,22,14335928184,-144071234
1635910930,-180519,true,14472761590,22,14351705592,-121055998
1635910946,-180522,true,14468420629,22,14353140762,-115279867
1635911029,-180520,true,14471314458,22,14363190976,-108123482
1635911043,-180523,true,14466973932,22,14364627295,-102346637
1635911056,-180527,true,14461188589,22,14364627295,-96561294
1635911094,-180530,true,14456851100,22,14366063757,-90787343
1635911136,-180530,true,14456851100,22,14366063757,-90787343
1635911307,-180533,true,14452514912,22,14361754800,-90760112
1635911413,-180536,true,14448180024,22,14347400941,-100779083
1635911444,-180539,true,14443846437,22,14343097582,-100748855
1635911653,-180538,true,14445290821,22,14323032297,-122258524
1635911688,-180541,true,14440958101,22,14318736247,-122221854
1635911699,-180544,true,14436626680,22,14315872929,-120753751
1635911820,-180547,true,14432296558,22,14310148011,-122148547
1635911824,-180549,true,14429410531,22,14310148011,-119262520
1635911827,-180553,true,14423640210,22,14308717139,-114923071
1635911846,-180555,true,14420755914,22,14310148011,-110607903
1635911886,-180556,true,14419313983,22,14314441485,-104872498
1635911931,-180556,true,14419313983,22,14317304516,-102009467
1635912018,-180560,true,14413547699,22,14321600137,-91947562
1635912072,-180563,true,14409224499,22,14325897047,-83327452
1635912183,-180563,true,14409224499,22,14333061428,-76163071
1635912402,-180560,true,14413547699,22,14367500364,-46047335
1635912654,-180563,true,14409224499,22,14396262679,-12961820
1635912765,-180566,true,14404902596,22,14397702305,-7200291
1635912798,-180565,true,14406343087,22,14397702305,-8640782
1635912818,-180563,true,14409224499,22,14399142076,-10082423
1635912932,-180565,true,14406343087,22,14412106488,5763401
1635913001,-180567,true,14403462250,22,14422197990,18735740
1635913018,-180567,true,14403462250,22,14425082574,21620324
1635913144,-180563,true,14409224499,22,14453960163,44735664
1635913388,-180564,true,14407783721,22,14488689590,80905869
1635913405,-180565,true,14406343087,22,14491587472,85244385
1635913566,-180564,true,14407783721,22,14513340076,105556355
1635913591,-180561,true,14412106488,22,14516242890,104136402
1635913647,-180562,true,14410665422,22,14524954813,114289391
1635913776,-180563,true,14409224499,22,14533671965,124447466
1635913901,-180561,true,14412106488,22,14542394348,130287860
1635914004,-180556,true,14419313983,22,14552577079,133263096
1635914044,-180557,true,14417872196,22,14554032337,136160141
1635914229,-180560,true,14413547699,22,14523502463,109954764
1635914402,-180560,true,14413547699,22,14497384977,83837278
1635914928,-180557,true,14417872196,22,14417872196,0
1635915018,-180558,true,14416430553,22,14414989054,-1441499
1635915051,-180560,true,14413547699,22,14416430553,2882854
1635915162,-180561,true,14412106488,22,14416430553,4324065
1635915183,-180559,true,14414989054,22,14417872196,2883142
1635915450,-180560,true,14413547699,22,14422197990,8650291
1635915499,-180564,true,14407783721,22,14422197990,14414269
1635915524,-180565,true,14406343087,22,14422197990,15854903
1635915602,-180563,true,14409224499,22,14417872196,8647697
1635915789,-180566,true,14404902596,22,14406343087,1440491
1635915815,-180570,true,14399142076,22,14404902596,5760520
1635915993,-180570,true,14399142076,22,14386189325,-12952751
1635916038,-180568,true,14402022048,22,14381874331,-20147717
1635916054,-180569,true,14400581990,22,14376123019,-24458971
1635916155,-180572,true,14396262679,22,14363190976,-33071703
1635916174,-180574,true,14393383858,22,14361754800,-31629058
1635916209,-180571,true,14397702305,22,14356011534,-41690771
1635916379,-180574,true,14393383858,22,14304425383,-88958475
1635916452,-180578,true,14387627944,22,14294416289,-93211655
1635916487,-180580,true,14384750850,22,14288699951,-96050899
1635916524,-180578,true,14387627944,22,14282985900,-104642044
1635916655,-180579,true,14386189325,22,14278701861,-107487464
1635916672,-180582,true,14381874331,22,14278701861,-103172470
1635916680,-180584,true,14378998388,22,14277274134,-101724254
1635916701,-180582,true,14381874331,22,14275846549,-106027782
1635916797,-180583,true,14380436288,22,14275846549,-104589739
1635916810,-180585,true,14377560632,22,14275846549,-101714083
1635916863,-180587,true,14374685551,22,14274419107,-100266444
1635916874,-180584,true,14378998388,22,14274419107,-104579281
1635916925,-180585,true,14377560632,22,14275846549,-101714083
1635916983,-180586,true,14376123019,22,14281557744,-94565275
1635917017,-180585,true,14377560632,22,14285842640,-91717992
1635917097,-180582,true,14381874331,22,14295845730,-86028601
1635917124,-180581,true,14383312519,22,14301564927,-81747592
1635917373,-180582,true,14381874331,22,14361754800,-20119531
1635917375,-180581,true,14383312519,22,14361754800,-21557719
1635917433,-180577,true,14389066707,22,14373248226,-15818481
1635917476,-180577,true,14389066707,22,14378998388,-10068319
1635917511,-180577,true,14389066707,22,14380436288,-8630419
1635917534,-180577,true,14389066707,22,14381874331,-7192376
1635917566,-180576,true,14390505613,22,14386189325,-4316288
1635917581,-180576,true,14390505613,22,14389066707,-1438906
1635917685,-180576,true,14390505613,22,14403462250,12956637
1635917731,-180575,true,14391944664,22,14410665422,18720758
1635918066,-180574,true,14393383858,22,14435183161,41799303
1635918137,-180574,true,14393383858,22,14443846437,50462579
1635918271,-180573,true,14394823197,22,14456851100,62027903
1635918298,-180573,true,14394823197,22,14459742614,64919417
1635918357,-180571,true,14397702305,22,14462634708,64932403
1635918375,-180571,true,14397702305,22,14464080971,66378666
1635918390,-180570,true,14399142076,22,14465527379,66385303
1635918559,-180568,true,14402022048,22,14484343852,82321804
1635918778,-180563,true,14409224499,22,14519146283,109921784
1635919367,-180561,true,14412106488,22,14584626387,172519899
1635919572,-180560,true,14413547699,22,14589002213,175454514
1635919763,-180558,true,14416430553,22,14571506784,155076231
1635919875,-180554,true,14422197990,22,14561310808,139112818
1635919918,-180553,true,14423640210,22,14556943289,133303079
1635920198,-180554,true,14422197990,22,14533671965,111473975
1635920237,-180552,true,14425082574,22,14530765667,105683093
1635920329,-180549,true,14429410531,22,14524954813,95544282
1635920544,-180550,true,14427967735,22,14490138459,62170724
1635920594,-180551,true,14426525082,22,14484343852,57818770
1635920675,-180553,true,14423640210,22,14477103852,53463642
1635920683,-180550,true,14427967735,22,14475656287,47688552
1635920922,-180549,true,14429410531,22,14452514912,23104381
1635920945,-180550,true,14427967735,22,14449624842,21657107
1635920984,-180550,true,14427967735,22,14448180024,20212289
1635921047,-180548,true,14430853472,22,14445290821,14437349
1635921265,-180547,true,14432296558,22,14438070342,5773784
1635921345,-180549,true,14429410531,22,14427967735,-1442796
1635921369,-180550,true,14427967735,22,14425082574,-2885161
1635921446,-180549,true,14429410531,22,14416430553,-12979978
1635921577,-180551,true,14426525082,22,14404902596,-21622486
1635921737,-180554,true,14422197990,22,14386189325,-36008665
1635921996,-180555,true,14420755914,22,14345966344,-74789570
1635922004,-180555,true,14420755914,22,14344531891,-76224023
1635922053,-180558,true,14416430553,22,14335928184,-80502369
1635922142,-180562,true,14410665422,22,14318736247,-91929175
1635922200,-180562,true,14410665422,22,14315872929,-94792493
1635922242,-180562,true,14410665422,22,14314441485,-96223937
1635922257,-180566,true,14404902596,22,14314441485,-90461111
1635922371,-180567,true,14403462250,22,14324464600,-78997650
1635922458,-180568,true,14402022048,22,14325897047,-76125001
1635922511,-180568,true,14402022048,22,14327329637,-74692411
1635922614,-180571,true,14397702305,22,14341663415,-56038890
1635922690,-180571,true,14397702305,22,14353140762,-44561543
1635922698,-180569,true,14400581990,22,14354576076,-46005914
1635922934,-180567,true,14403462250,22,14390505613,-12956637
1635923079,-180570,true,14399142076,22,14412106488,12964412
1635923567,-180570,true,14399142076,22,14445290821,46148745
1635923703,-180568,true,14402022048,22,14443846437,41824389
1635923946,-180567,true,14403462250,22,14438070342,34608092
1635924129,-180570,true,14399142076,22,14426525082,27383006
1635924271,-180570,true,14399142076,22,14436626680,37484604
1635924538,-180568,true,14402022048,22,14448180024,46157976
1635924642,-180565,true,14406343087,22,14453960163,47617076
1635924682,-180566,true,14404902596,22,14455405559,50502963
1635924840,-180566,true,14404902596,22,14464080971,59178375
1635924878,-180564,true,14407783721,22,14466973932,59190211
1635925059,-180562,true,14410665422,22,14468420629,57755207
1635925287,-180563,true,14409224499,22,14448180024,38955525
1635925493,-180563,true,14409224499,22,14430853472,21628973
1635925763,-180560,true,14413547699,22,14410665422,-2882277
1635925915,-180558,true,14416430553,22,14407783721,-8646832
1635926067,-180557,true,14417872196,22,14406343087,-11529109
1635927197,-180557,true,14417872196,22,14404902596,-12969600
1635927212,-180554,true,14422197990,22,14402022048,-20175942
1635927222,-180552,true,14425082574,22,14400581990,-24500584
1635927259,-180554,true,14422197990,22,14399142076,-23055914
1635927274,-180556,true,14419313983,22,14399142076,-20171907
1635927277,-180553,true,14423640210,22,14397702305,-25937905
1635927373,-180551,true,14426525082,22,14393383858,-33141224
1635927539,-180552,true,14425082574,22,14387627944,-37454630
1635927683,-180554,true,14422197990,22,14383312519,-38885471
1635927848,-180551,true,14426525082,22,14377560632,-48964450
1635927849,-180549,true,14429410531,22,14377560632,-51849899
1635928053,-180551,true,14426525082,22,14367500364,-59024718
1635928055,-180553,true,14423640210,22,14366063757,-57576453
1635928565,-180553,true,14423640210,22,14304425383,-119214827
1635929012,-180552,true,14425082574,22,14271564652,-153517922
1635929103,-180555,true,14420755914,22,14274419107,-146336807
1635929198,-180558,true,14416430553,22,14271564652,-144865901
1635929337,-180558,true,14416430553,22,14261578551,-154852002
1635929354,-180559,true,14414989054,22,14258726663,-156262391
1635929561,-180561,true,14412106488,22,14260152536,-151953952
1635929645,-180563,true,14409224499,22,14258726663,-150497836
1635929691,-180563,true,14409224499,22,14254449901,-154774598
1635929754,-180564,true,14407783721,22,14250174421,-157609300
1635929785,-180567,true,14403462250,22,14247324813,-156137437
1635929815,-180571,true,14397702305,22,14243051471,-154650834
1635929857,-180571,true,14397702305,22,14238779410,-158922895
1635930005,-180572,true,14396262679,22,14224548458,-171714221
1635930049,-180574,true,14393383858,22,14228816250,-164567608
1635930075,-180579,true,14386189325,22,14230239131,-155950194
1635930161,-180578,true,14387627944,22,14238779410,-148848534
1635930378,-180579,true,14386189325,22,14247324813,-138864512
1635930392,-180581,true,14383312519,22,14247324813,-135987706
1635930492,-180585,true,14377560632,22,14248749546,-128811086
1635930520,-180586,true,14376123019,22,14243051471,-133071548
1635930557,-180589,true,14371811045,22,14241627308,-130183737
1635930616,-180592,true,14367500364,22,14238779410,-128720954
1635930730,-180598,true,14358882880,22,14234508630,-124374250
1635930829,-180599,true,14357447135,22,14233085321,-124361814
1635930907,-180601,true,14354576076,22,14234508630,-120067446
1635930953,-180604,true,14350270565,22,14228816250,-121454315
1635931022,-180609,true,14343097582,22,14217438317,-125659265
1635931131,-180610,true,14341663415,22,14203228695,-138434720
1635931241,-180612,true,14338795513,22,14191871224,-146924289
1635931255,-180614,true,14335928184,22,14190452179,-145476005
1635931527,-180618,true,14330195246,22,14166350108,-163845138
1635931638,-180619,true,14328762369,22,14164933614,-163828755
1635931752,-180621,true,14325897047,22,14159269057,-166627990
1635931776,-180622,true,14324464600,22,14157853272,-166611328
1635931796,-180627,true,14317304516,22,14156437628,-160866888
1635931859,-180628,true,14315872929,22,14150776468,-165096461
1635931871,-180630,true,14313010184,22,14150776468,-162233716
1635931986,-180633,true,14308717139,22,14147946737,-160770402
1635932161,-180637,true,14302995083,22,14140874886,-162120197
1635932231,-180637,true,14302995083,22,14140874886,-162120197
1635932388,-180638,true,14301564927,22,14139460940,-162103987
1635932522,-180639,true,14300134913,22,14135219950,-164914963
1635932538,-180643,true,14294416289,22,14133806569,-160609720
1635932890,-180644,true,14292986990,22,14123916861,-169070129
1635932902,-180645,true,14291557834,22,14123916861,-167640973
1635933090,-180646,true,14290128821,22,14108389870,-181738951
1635933133,-180650,true,14284414199,22,14105568615,-178845584
1635933168,-180651,true,14282985900,22,14104158199,-178827701
1635933218,-180653,true,14280129731,22,14098517946,-181611785
1635933282,-180654,true,14278701861,22,14091470801,-187231060
1635933363,-180659,true,14271564652,22,14087244206,-184320446
1635933420,-180660,true,14270137638,22,14091470801,-178666837
1635933428,-180661,true,14268710767,22,14091470801,-177239966
1635933499,-180662,true,14267284038,22,14094289237,-172994801
1635933506,-180667,true,14260152536,22,14094289237,-165863299
1635933518,-180669,true,14257300933,22,14095698665,-161602268
1635933530,-180671,true,14254449901,22,14097108235,-157341666
1635933651,-180670,true,14255875346,22,14111211689,-144663657
1635933667,-180674,true,14250174421,22,14112622810,-137551611
1635933828,-180677,true,14245900223,22,14119680533,-126219690
1635933857,-180679,true,14243051471,22,14121092501,-121958970
1635934052,-180680,true,14241627308,22,14122504610,-119122698
1635934117,-180684,true,14235932081,22,14133806569,-102125512
1635934278,-180687,true,14231662155,22,14157853272,-73808883
1635934389,-180689,true,14228816250,22,14162101052,-66715198
1635934407,-180689,true,14228816250,22,14162101052,-66715198
1635934976,-180693,true,14223126146,22,14200388476,-22737670
1635935112,-180695,true,14220281947,22,14203228695,-17053252
1635935159,-180697,true,14217438317,22,14193290411,-24147906
1635935187,-180697,true,14217438317,22,14193290411,-24147906
1635935312,-180701,true,14211752763,22,14186195894,-25556869
1635935323,-180705,true,14206069483,22,14186195894,-19873589
1635935381,-180705,true,14206069483,22,14180522834,-25546649
1635935462,-180706,true,14204649018,22,14173434699,-31214319
1635935503,-180710,true,14198968579,22,14172017498,-26951081
1635935518,-180713,true,14194709740,22,14170600438,-24109302
1635935601,-180714,true,14193290411,22,14167766743,-25523668
1635935788,-180713,true,14194709740,22,14157853272,-36856468
1635935932,-180716,true,14190452179,22,14139460940,-50991239
1635936177,-180721,true,14183359081,22,14122504610,-60854471
1635936299,-180722,true,14181940887,22,14114034072,-67906815
1635936406,-180722,true,14181940887,22,14106979172,-74961715
1635936407,-180725,true,14177687155,22,14106979172,-70707983
1635936463,-180730,true,14170600438,22,14102747924,-67852514
1635936540,-180731,true,14169183519,22,14097108235,-72075284
1635936704,-180731,true,14169183519,22,14087244206,-81939313
1635936723,-180734,true,14164933614,22,14087244206,-77689408
1635936770,-180736,true,14162101052,22,14085835622,-76265430
1635936781,-180737,true,14160684984,22,14085835622,-74849362
1635936787,-180737,true,14160684984,22,14085835622,-74849362
1635936942,-180740,true,14156437628,22,14085835622,-70602006
1635937100,-180741,true,14155022126,22,14104158199,-50863927
1635937104,-180740,true,14156437628,22,14104158199,-52279429
1635937262,-180740,true,14156437628,22,14118268706,-38168922
1635937293,-180743,true,14152191546,22,14116857020,-35334526
1635937481,-180743,true,14152191546,22,14143703202,-8488344
1635937486,-180742,true,14153606765,22,14143703202,-9903563
1635937588,-180742,true,14153606765,22,14146532084,-7074681
1635937605,-180743,true,14152191546,22,14147946737,-4244809
1635937668,-180746,true,14147946737,22,14150776468,2829731
1635937674,-180745,true,14149361532,22,14150776468,1414936
1635937682,-180745,true,14149361532,22,14149361532,0
1635937756,-180748,true,14145117572,22,14147946737,2829165
1635937769,-180751,true,14140874886,22,14147946737,7071851
1635937809,-180751,true,14140874886,22,14147946737,7071851
1635937840,-180752,true,14139460940,22,14149361532,9900592
1635937856,-180754,true,14136633472,22,14147946737,11313265
1635937990,-180756,true,14133806569,22,14142288973,8482404
1635938203,-180755,true,14135219950,22,14136633472,1413522
1635938290,-180755,true,14135219950,22,14118268706,-16951244
1635938342,-180756,true,14133806569,22,14106979172,-26827397
1635938348,-180759,true,14129567275,22,14104158199,-25409076
1635938454,-180762,true,14125329252,22,14070350495,-54978757
1635938482,-180764,true,14122504610,22,14061911239,-60593371
1635938568,-180766,true,14119680533,22,14038027491,-81653042
1635938583,-180769,true,14115445476,22,14035220307,-80225169
1635938630,-180772,true,14111211689,22,14026802121,-84409568
1635938676,-180773,true,14109800709,22,14018388985,-91411724
1635938789,-180775,true,14106979172,22,13986185349,-120793823
1635938821,-180778,true,14102747924,22,13975001434,-127746490
1635938873,-180781,true,14098517946,22,13958242327,-140275619
1635938888,-180783,true,14095698665,22,13951265299,-144433366
1635939015,-180783,true,14095698665,22,13928962237,-166736428
1635939028,-180785,true,14092879949,22,13924784384,-168095565
1635939058,-180788,true,14088652930,22,13916432437,-172220493
1635939061,-180789,true,14087244206,22,13916432437,-170811769
1635939076,-180791,true,14084427179,22,13912258342,-172168837
1635939091,-180794,true,14080202696,22,13908085499,-172117197
1635939113,-180797,true,14075979480,22,13902523656,-173455824
1635939139,-180796,true,14077387078,22,13902523656,-174863422
1635939415,-180796,true,14077387078,22,13921999845,-155387233
1635939419,-180798,true,14074572023,22,13921999845,-152572178
1635939435,-180800,true,14071757530,22,13926176863,-145580667
1635939533,-180798,true,14074572023,22,13949870312,-124701711
1635939668,-180796,true,14077387078,22,13986185349,-91201729
1635939729,-180798,true,14074572023,22,14000177829,-74394194
1635939905,-180800,true,14071757530,22,14026802121,-44955409
1635940013,-180798,true,14074572023,22,14043643544,-30928479
1635940105,-180797,true,14075979480,22,14043643544,-32335936
1635940135,-180799,true,14073164706,22,14043643544,-29521162
1635940170,-180802,true,14068943601,22,14045047909,-23895692
1635940202,-180802,true,14068943601,22,14045047909,-23895692
1635940302,-180801,true,14070350495,22,14050666771,-19683724
1635940457,-180805,true,14064723762,22,14022594922,-42128840
1635940575,-180809,true,14059099279,22,14000177829,-58921450
1635940689,-180810,true,14057693509,22,13988982725,-68710784
1635940709,-180810,true,14057693509,22,13986185349,-71508160
1635940754,-180812,true,14054882392,22,13979194353,-75688039
1635940797,-180816,true,14049261845,22,13973604073,-75657772
1635940950,-180817,true,14047857059,22,13954055692,-93801367
1635940966,-180817,true,14047857059,22,13952660426,-95196633
1635941031,-180820,true,14043643544,22,13945686188,-97957356
1635941070,-180824,true,14038027491,22,13940109308,-97918183
1635941166,-180826,true,14035220307,22,13927569480,-107650827
1635941322,-180826,true,14035220307,22,13917824080,-117396227
1635941352,-180830,true,14029607622,22,13916432437,-113175185
1635941381,-180834,true,14023997181,22,13917824080,-106173101
1635941397,-180835,true,14022594922,22,13917824080,-104770842
1635941494,-180833,true,14025399581,22,13917824080,-107575501
1635941533,-180836,true,14021192803,22,13916432437,-104760366
1635941576,-180841,true,14014184309,22,13908085499,-106098810
1635941590,-180843,true,14011381892,22,13905304299,-106077593
1635941787,-180843,true,14011381892,22,13891406640,-119975252
1635941902,-180845,true,14008580036,22,13884463020,-124117016
1635941966,-180851,true,14000177829,22,13877522870,-122654959
1635942041,-180854,true,13995978616,22,13858108902,-137869714
1635942096,-180854,true,13995978616,22,13852567044,-143411572
1635942216,-180856,true,13993179840,22,13840105965,-153073875
1635942266,-180863,true,13983388531,22,13822126415,-161262116
1635942340,-180865,true,13980592273,22,13801409803,-179182470
1635942350,-180866,true,13979194353,22,13798649935,-180544418
1635942360,-180870,true,13973604073,22,13795890619,-177713454
1635942391,-180877,true,13963826462,22,13784858871,-178967591
1635942457,-180879,true,13961034115,22,13771081591,-189952524
1635942477,-180880,true,13959638152,22,13768327788,-191310364
1635942503,-180884,true,13954055692,22,13762821833,-191233859
1635942514,-180891,true,13944291759,22,13760069682,-184222077
1635942634,-180894,true,13940109308,22,13732578417,-207530891
1635942693,-180895,true,13938715436,22,13717481641,-221233795
1635942738,-180901,true,13930355133,22,13703771701,-226583432
1635942819,-180907,true,13921999845,22,13690075463,-231924382
1635942826,-180910,true,13917824080,22,13690075463,-227748617
1635942888,-180908,true,13920607784,22,13699661391,-220946393
1635942898,-180914,true,13912258342,22,13701031357,-211226985
1635942937,-180917,true,13908085499,22,13707883243,-200202256
1635942984,-180920,true,13903913908,22,13710624957,-193288951
1635943042,-180919,true,13905304299,22,13714738556,-190565743
1635943144,-180922,true,13901133542,22,13731205297,-169928245
1635943198,-180925,true,13896964036,22,13743568326,-153395710
1635943222,-180928,true,13892795780,22,13747691809,-145103971
1635943235,-180926,true,13895574479,22,13750441485,-145132994
1635943351,-180929,true,13891406640,22,13772458699,-118947941
1635943356,-180932,true,13887240051,22,13772458699,-114781352
1635943422,-180936,true,13881686544,22,13786237357,-95449187
1635943427,-180934,true,13884463020,22,13787615981,-96847039
1635943461,-180938,true,13878910623,22,13798649935,-80260688
1635943479,-180941,true,13874747782,22,13805550640,-69197142
1635943519,-180941,true,13874747782,22,13819362405,-55385377
1635943548,-180941,true,13874747782,22,13823508628,-51239154
1635943611,-180944,true,13870586190,22,13847027402,-23558788
1635943677,-180942,true,13873360446,22,13869199270,-4161176
1635943686,-180941,true,13874747782,22,13870586190,-4161592
1635943922,-180940,true,13876135257,22,13880298514,4163257
1635944079,-180943,true,13871973249,22,13877522870,5549621
1635944094,-180942,true,13873360446,22,13877522870,4162424
1635944105,-180942,true,13873360446,22,13876135257,2774811
1635944155,-180941,true,13874747782,22,13870586190,-4161592
1635944330,-180942,true,13873360446,22,13894185060,20824614
1635944463,-180941,true,13874747782,22,13896964036,22216254
1635944528,-180939,true,13877522870,22,13898353732,20830862
1635944573,-180940,true,13876135257,22,13901133542,24998285
1635944691,-180941,true,13874747782,22,13905304299,30556517
1635944787,-180941,true,13874747782,22,13903913908,29166126
1635944830,-180940,true,13876135257,22,13903913908,27778651
1635944854,-180939,true,13877522870,22,13905304299,27781429
1635944964,-180943,true,13871973249,22,13884463020,12489771
1635945055,-180943,true,13871973249,22,13888628775,16655526
1635945084,-180945,true,13869199270,22,13884463020,15263750
1635945223,-180944,true,13870586190,22,13884463020,13876830
1635945334,-180946,true,13867812489,22,13887240051,19427562
1635945417,-180944,true,13870586190,22,13895574479,24988289
1635945422,-180947,true,13866425846,22,13895574479,29148633
1635945451,-180947,true,13866425846,22,13896964036,30538190
1635945699,-180948,true,13865039342,22,13930355133,65315791
1635945741,-180946,true,13867812489,22,13937321704,69509215
1635945799,-180949,true,13863652977,22,13945686188,82033211
1635945809,-180949,true,13863652977,22,13948475465,84822488
1635945905,-180950,true,13862266750,22,13975001434,112734684
1635946057,-180948,true,13865039342,22,13990381624,125342282
1635946079,-180950,true,13862266750,22,13987583967,125317217
1635946083,-180950,true,13862266750,22,13987583967,125317217
1635946257,-180950,true,13862266750,22,13991780662,129513912
1635946327,-180948,true,13865039342,22,13986185349,121146007
1635946678,-180947,true,13866425846,22,14018388985,151963139
1635946683,-180947,true,13866425846,22,14018388985,151963139
1635946830,-180946,true,13867812489,22,14046452414,178639925
1635946875,-180942,true,13873360446,22,14054882392,181521946
1635946887,-180939,true,13877522870,22,14056287881,178765011
1635946916,-180939,true,13877522870,22,14060505189,182982319
1635946932,-180938,true,13878910623,22,14061911239,183000616
1635947146,-180936,true,13881686544,22,14090061795,208375251
1635947154,-180934,true,13884463020,22,14090061795,205598775
1635947205,-180934,true,13884463020,22,14090061795,205598775
1635947242,-180934,true,13884463020,22,14085835622,201372602
1635947266,-180935,true,13883074712,22,14081610716,198536004
1635947391,-180933,true,13885851466,22,14060505189,174653723
1635947411,-180934,true,13884463020,22,14054882392,170419372
1635947500,-180934,true,13884463020,22,14042239320,157776300
1635947591,-180934,true,13884463020,22,14026802121,142339101
1635947618,-180931,true,13888628775,22,14021192803,132564028
1635947652,-180931,true,13888628775,22,14014184309,125555534
1635947708,-180931,true,13888628775,22,14000177829,111549054
1635947740,-180931,true,13888628775,22,13991780662,103151887
1635947799,-180927,true,13894185060,22,13979194353,85009293
1635947867,-180927,true,13894185060,22,13965222844,71037784
1635947936,-180926,true,13895574479,22,13952660426,57085947
1635947959,-180924,true,13898353732,22,13949870312,51516580
1635948020,-180921,true,13902523656,22,13942897469,40373813
1635948027,-180919,true,13905304299,22,13941503319,36199020
1635948044,-180915,true,13910867255,22,13940109308,29242053
1635948117,-180911,true,13916432437,22,13958242327,41809890
1635948140,-180905,true,13924784384,22,13965222844,40438460
1635948226,-180903,true,13927569480,22,13987583967,60014487
1635948320,-180899,true,13933141344,22,14009980894,76839550
1635948349,-180895,true,13938715436,22,14014184309,75468873
1635948360,-180889,true,13947080757,22,14016987286,69906529
1635948367,-180887,true,13949870312,22,14016987286,67116974
1635948495,-180887,true,13949870312,22,14016987286,67116974
1635948569,-180883,true,13955451098,22,14029607622,74156524
1635948632,-180876,true,13965222844,22,14040835237,75612393
1635948890,-180877,true,13963826462,22,14081610716,117784254
1635949130,-180878,true,13962430219,22,14049261845,86831626
1635949253,-180878,true,13962430219,22,14028204801,65774582
1635949270,-180871,true,13972206853,22,14025399581,53192728
1635949313,-180872,true,13970809772,22,14023997181,53187409
1635949440,-180876,true,13965222844,22,14012783031,47560187
1635949459,-180877,true,13963826462,22,14008580036,44753574
1635949505,-180870,true,13973604073,22,13998777952,25173879
1635949609,-180871,true,13972206853,22,13977796574,5589721
1635949793,-180874,true,13968016029,22,13942897469,-25118560
1635950038,-180875,true,13966619367,22,13906694830,-59924537
1635950185,-180868,true,13976398934,22,13890017638,-86381296
1635950357,-180870,true,13973604073,22,13878910623,-94693450
1635950397,-180874,true,13968016029,22,13876135257,-91880772
1635950507,-180876,true,13965222844,22,13869199270,-96023574
1635950743,-180868,true,13976398934,22,13909476308,-66922626
1635950778,-180868,true,13976398934,22,13913649568,-62749366
1635950823,-180872,true,13970809772,22,13917824080,-52985692
1635950934,-180873,true,13969412830,22,13924784384,-44628446
1635951035,-180867,true,13977796574,22,13931748169,-46048405
1635951051,-180866,true,13979194353,22,13934534658,-44659695
1635951189,-180868,true,13976398934,22,13966619367,-9779567
1635951208,-180869,true,13975001434,22,13970809772,-4191662
1635951232,-180861,true,13986185349,22,13977796574,-8388775
1635951320,-180858,true,13990381624,22,14004378303,13996679
1635951382,-180862,true,13984786870,22,14022594922,37808052
1635951409,-180862,true,13984786870,22,14029607622,44820752
1635951448,-180855,true,13994579158,22,14031010583,36431425
1635951545,-180854,true,13995978616,22,14029607622,33629006
1635951663,-180858,true,13990381624,22,14028204801,37823177
1635951853,-180858,true,13990381624,22,14049261845,58880221
1635951869,-180851,true,14000177829,22,14050666771,50488942
1635951890,-180850,true,14001577847,22,14053477045,51899198
1635951944,-180851,true,14000177829,22,14059099279,58921450
1635951985,-180850,true,14001577847,22,14057693509,56115662
1635951988,-180843,true,14011381892,22,14057693509,46311617
1635952046,-180844,true,14009980894,22,14053477045,43496151
1635952058,-180847,true,14005778741,22,14053477045,47698304
1635952135,-180848,true,14004378303,22,14049261845,44883542
1635952226,-180841,true,14014184309,22,14040835237,26650928
1635952346,-180842,true,14012783031,22,14033816925,21033894
1635952501,-180846,true,14007179318,22,14036623829,29444511
1635952518,-180847,true,14005778741,22,14036623829,30845088
1635952575,-180839,true,14016987286,22,14038027491,21040205
1635952601,-180841,true,14014184309,22,14038027491,23843182
1635952607,-180844,true,14009980894,22,14038027491,28046597
1635952626,-180846,true,14007179318,22,14033816925,26637607
1635952838,-180840,true,14015585727,22,14011381892,-4203835
1635952916,-180842,true,14012783031,22,14005778741,-7004290
1635953199,-180845,true,14008580036,22,13976398934,-32181102
1635953212,-180847,true,14005778741,22,13975001434,-30777307
1635953242,-180843,true,14011381892,22,13973604073,-37777819
1635953244,-180845,true,14008580036,22,13973604073,-34975963
1635953260,-180849,true,14002978005,22,13972206853,-30771152
1635953319,-180851,true,14000177829,22,13968016029,-32161800
1635953326,-180849,true,14002978005,22,13966619367,-36358638
1635953397,-180850,true,14001577847,22,13962430219,-39147628
1635953452,-180852,true,13998777952,22,13968016029,-30761923
1635953658,-180851,true,14000177829,22,14002978005,2800176
1635953837,-180848,true,14004378303,22,14033816925,29438622
1635953878,-180848,true,14004378303,22,14040835237,36456934
1635954006,-180851,true,14000177829,22,14054882392,54704563
1635954098,-180847,true,14005778741,22,14066130234,60351493
1635954106,-180844,true,14009980894,22,14066130234,56149340
1635954167,-180844,true,14009980894,22,14078794817,68813923
1635954255,-180843,true,14011381892,22,14112622810,101240918
1635954369,-180836,true,14021192803,22,14143703202,122510399
1635954432,-180833,true,14025399581,22,14159269057,133869476
1635954602,-180832,true,14026802121,22,14193290411,166488290
1635954760,-180831,true,14028204801,22,14225970913,197766112
1635954792,-180824,true,14038027491,22,14234508630,196481139
1635954849,-180822,true,14040835237,22,14250174421,209339184
1635954893,-180819,true,14045047909,22,14270137638,225089729
1635955034,-180816,true,14049261845,22,14327329637,278067792
1635955084,-180809,true,14059099279,22,14340229392,281130113
1635955120,-180805,true,14064723762,22,14345966344,281242582
1635955304,-180803,true,14067536847,22,14371811045,304274198
1635955366,-180800,true,14071757530,22,14386189325,314431795
1635955637,-180798,true,14074572023,22,14414989054,340417031
1635955717,-180797,true,14075979480,22,14410665422,334685942
1635955851,-180798,true,14074572023,22,14384750850,310178827
1635955939,-180796,true,14077387078,22,14368937114,291550036
1635956069,-180794,true,14080202696,22,14343097582,262894886
1635956092,-180794,true,14080202696,22,14335928184,255725488
1635956163,-180794,true,14080202696,22,14313010184,232807488
1635956241,-180787,true,14090061795,22,14297275315,207213520
1635956282,-180787,true,14090061795,22,14281557744,191495949
1635956304,-180787,true,14090061795,22,14280129731,190067936
1635956382,-180787,true,14090061795,22,14274419107,184357312
1635956409,-180780,true,14099927798,22,14271564652,171636854
1635956423,-180779,true,14101337791,22,14270137638,168799847
1635956506,-180778,true,14102747924,22,14263004709,160256785
1635956525,-180776,true,14105568615,22,14261578551,156009936
1635956583,-180768,true,14116857020,22,14264431009,147573989
1635956608,-180766,true,14119680533,22,14267284038,147603505
1635956648,-180765,true,14121092501,22,14272991808,151899307
1635956653,-180762,true,14125329252,22,14272991808,147662556
1635956684,-180754,true,14136633472,22,14277274134,140640662
1635956930,-180751,true,14140874886,22,14302995083,162120197
1635956953,-180749,true,14143703202,22,14302995083,159291881
1635957027,-180747,true,14146532084,22,14314441485,167909401
1635957039,-180738,true,14159269057,22,14315872929,156603872
1635957191,-180737,true,14160684984,22,14318736247,158051263
1635957423,-180739,true,14157853272,22,14304425383,146572111
1635957475,-180738,true,14159269057,22,14301564927,142295870
1635957533,-180729,true,14172017498,22,14295845730,123828232
1635957539,-180729,true,14172017498,22,14294416289,122398791
1635957586,-180731,true,14169183519,22,14277274134,108090615
1635957611,-180731,true,14169183519,22,14270137638,100954119
1635957636,-180727,true,14174852043,22,14261578551,86726508
1635957700,-180724,true,14179104924,22,14258726663,79621739
1635957753,-180725,true,14177687155,22,14254449901,76762746
1635957800,-180726,true,14176269528,22,14250174421,73904893
1635958043,-180721,true,14183359081,22,14244475776,61116695
1635958275,-180719,true,14186195894,22,14240203287,54007393
1635958316,-180721,true,14183359081,22,14240203287,56844206
1635958477,-180720,true,14184777417,22,14247324813,62547396
1635958578,-180715,true,14191871224,22,14253024598,61153374
1635959053,-180714,true,14193290411,22,14196129211,2838800
1635959061,-180716,true,14190452179,22,14196129211,5677032
1635959082,-180715,true,14191871224,22,14193290411,1419187
1635959174,-180711,true,14197548824,22,14187614514,-9934310
1635959237,-180711,true,14197548824,22,14174852043,-22696781
1635959250,-180713,true,14194709740,22,14172017498,-22692242
1635959476,-180714,true,14193290411,22,14121092501,-72197910
1635959505,-180710,true,14198968579,22,14118268706,-80699873
1635959697,-180711,true,14197548824,22,14088652930,-108895894
1635959914,-180712,true,14196129211,22,14060505189,-135624022
1635959984,-180713,true,14194709740,22,14067536847,-127172893
1635960007,-180710,true,14198968579,22,14067536847,-131431732
1635960048,-180709,true,14200388476,22,14064723762,-135664714
1635960084,-180708,true,14201808515,22,14064723762,-137084753
1635960209,-180711,true,14197548824,22,14067536847,-130011977
1635960226,-180708,true,14201808515,22,14067536847,-134271668
1635960769,-180707,true,14203228695,22,14077387078,-125841617
1635960814,-180705,true,14206069483,22,14077387078,-128682405
1635960854,-180708,true,14201808515,22,14074572023,-127236492
1635960996,-180703,true,14208910839,22,14080202696,-128708143
1635961066,-180700,true,14213173939,22,14088652930,-124521009
1635961148,-180697,true,14217438317,22,14099927798,-117510519
1635961222,-180700,true,14213173939,22,14104158199,-109015740
1635961439,-180696,true,14218860061,22,14155022126,-63837935
1635961538,-180693,true,14223126146,22,14176269528,-46856618
1635961553,-180689,true,14228816250,22,14179104924,-49711326
1635961569,-180692,true,14224548458,22,14183359081,-41189377
1635961829,-180692,true,14224548458,22,14176269528,-48278930
1635961898,-180692,true,14224548458,22,14170600438,-53948020
1635961962,-180689,true,14228816250,22,14163517263,-65298987
1635962008,-180692,true,14224548458,22,14159269057,-65279401
1635962049,-180692,true,14224548458,22,14155022126,-69526332
1635962316,-180691,true,14225970913,22,14123916861,-102054052
1635962369,-180687,true,14231662155,22,14115445476,-116216679
1635962380,-180691,true,14225970913,22,14114034072,-111936841
1635962444,-180694,true,14221703975,22,14104158199,-117545776
1635962581,-180697,true,14217438317,22,14099927798,-117510519
1635962629,-180694,true,14221703975,22,14097108235,-124595740
1635962679,-180699,true,14214595256,22,14092879949,-121715307
1635962705,-180702,true,14210331730,22,14091470801,-118860929
1635962735,-180706,true,14204649018,22,14090061795,-114587223
1635962847,-180702,true,14210331730,22,14081610716,-128721014
1635962920,-180708,true,14201808515,22,14077387078,-124421437
1635962978,-180713,true,14194709740,22,14081610716,-113099024
1635963050,-180717,true,14189033275,22,14074572023,-114461252
1635963067,-180714,true,14193290411,22,14071757530,-121532881
1635963226,-180720,true,14184777417,22,14063317430,-121459987
1635963282,-180726,true,14176269528,22,14059099279,-117170249
1635963329,-180729,true,14172017498,22,14057693509,-114323989
1635963428,-180725,true,14177687155,22,14053477045,-124210110
1635963468,-180729,true,14172017498,22,14049261845,-122755653
1635963501,-180735,true,14163517263,22,14046452414,-117064849
1635963604,-180737,true,14160684984,22,14038027491,-122657493
1635963677,-180734,true,14164933614,22,14038027491,-126906123
1635963734,-180737,true,14160684984,22,14039431294,-121253690
1635963772,-180743,true,14152191546,22,14038027491,-114164055
1635963798,-180743,true,14152191546,22,14036623829,-115567717
1635964013,-180741,true,14155022126,22,14021192803,-133829323
1635964081,-180746,true,14147946737,22,14021192803,-126753934
1635964117,-180751,true,14140874886,22,14015585727,-125289159
1635964130,-180753,true,14138047135,22,14011381892,-126665243
1635964293,-180753,true,14138047135,22,13980592273,-157454862
1635964410,-180759,true,14129567275,22,13966619367,-162947908
1635964597,-180765,true,14121092501,22,13947080757,-174011744
1635964897,-180766,true,14119680533,22,13910867255,-208813278
1635964908,-180767,true,14118268706,22,13909476308,-208792398
1635964934,-180773,true,14109800709,22,13905304299,-204496410
1635965097,-180780,true,14099927798,22,13887240051,-212687747
1635965124,-180783,true,14095698665,22,13883074712,-212623953
1635965289,-180786,true,14091470801,22,13848412105,-243058696
1635965299,-180792,true,14083018877,22,13847027402,-235991475
1635965457,-180800,true,14071757530,22,13817980607,-253776923
1635965668,-180801,true,14070350495,22,13782102313,-288248182
1635965684,-180802,true,14068943601,22,13780724241,-288219360
1635966009,-180809,true,14059099279,22,13733951675,-325147604
1635966107,-180817,true,14047857059,22,13736698603,-311158456
1635966160,-180818,true,14046452414,22,13739446080,-307006334
1635966364,-180816,true,14049261845,22,13758693812,-290568033
1635966674,-180820,true,14043643544,22,13784858871,-258784673
1635966734,-180825,true,14036623829,22,13788994743,-247629086
1635966870,-180829,true,14031010583,22,13804170223,-226840360
1635967006,-180830,true,14029607622,22,13816598947,-213008675
1635967025,-180834,true,14023997181,22,13817980607,-206016574
1635967128,-180840,true,14015585727,22,13820744341,-194841386
1635967245,-180843,true,14011381892,22,13817980607,-193401285
1635967398,-180845,true,14008580036,22,13811073689,-197506347
1635967416,-180849,true,14002978005,22,13809692719,-193285286
1635967427,-180854,true,13995978616,22,13809692719,-186285897
1635967548,-180858,true,13990381624,22,13794511168,-195870456
1635967723,-180860,true,13987583967,22,13771081591,-216502376
1635967803,-180862,true,13984786870,22,13779346306,-205440564
1635967932,-180868,true,13976398934,22,13765574535,-210824399
1635968038,-180870,true,13973604073,22,13754567030,-219037043
1635968091,-180872,true,13970809772,22,13749066578,-221743194
1635968183,-180874,true,13968016029,22,13740820025,-227196004
1635968362,-180879,true,13961034115,22,13731205297,-229828818
1635968372,-180881,true,13958242327,22,13731205297,-227037030
1635968478,-180883,true,13955451098,22,13725714188,-229736910
1635968501,-180886,true,13951265299,22,13724341753,-226923546
1635968594,-180892,true,13942897469,22,13716110030,-226787439
1635968681,-180896,true,13937321704,22,13695552315,-241769389
1635968711,-180901,true,13930355133,22,13687337859,-243017274
1635968786,-180902,true,13928962237,22,13680496242,-248465995
1635968815,-180908,true,13920607784,22,13676392914,-244214870
1635968874,-180910,true,13917824080,22,13670923724,-246900356
1635968983,-180917,true,13908085499,22,13646339423,-261746076
1635969049,-180917,true,13908085499,22,13642246340,-265839159
1635969061,-180924,true,13898353732,22,13642246340,-256107392
1635969178,-180928,true,13892795780,22,13632700586,-260095194
1635969182,-180934,true,13884463020,22,13631337453,-253125567
1635969237,-180935,true,13883074712,22,13625886280,-257188432
1635969379,-180943,true,13871973249,22,13614990475,-256982774
1635969416,-180948,true,13865039342,22,13614990475,-250048867
1635969429,-180954,true,13856723230,22,13614990475,-241732755
1635969433,-180956,true,13853952301,22,13613629112,-240323189
1635969441,-180960,true,13848412105,22,13613629112,-234782993
1635969496,-180965,true,13841489976,22,13610906795,-230583181
1635969563,-180971,true,13833187988,22,13606824339,-226363649
1635969587,-180973,true,13830421765,22,13605463793,-224957972
1635969645,-180978,true,13823508628,22,13595943777,-227564851
1635969698,-180984,true,13815217425,22,13589147844,-226069581
1635969700,-180991,true,13805550640,22,13589147844,-216402796
1635969800,-180992,true,13804170223,22,13582355308,-221814915
1635969842,-180997,true,13797270208,22,13583713543,-213556665
1635970016,-181000,true,13793131855,22,13595943777,-197188078
1635970023,-181006,true,13784858871,22,13595943777,-188915094
1635970026,-181006,true,13784858871,22,13595943777,-188915094
1635970064,-181010,true,13779346306,22,13595943777,-183402529
1635970071,-181013,true,13775213329,22,13594584318,-180629011
1635970236,-181017,true,13769704621,22,13617713609,-151991012
1635970355,-181017,true,13769704621,22,13629974455,-139730166
1635970522,-181022,true,13762821833,22,13653163958,-109657875
1635970553,-181024,true,13760069682,22,13659991905,-100077777
1635970635,-181029,true,13753191710,22,13670923724,-82267986
1635970701,-181030,true,13751816529,22,13677760553,-74055976
1635970810,-181035,true,13744942683,22,13676392914,-68549769
1635970835,-181038,true,13740820025,22,13675025412,-65794613
1635971011,-181044,true,13732578417,22,13661357904,-71220513
1635971067,-181044,true,13732578417,22,13651798778,-80779639
1635971220,-181049,true,13725714188,22,13629974455,-95739733
1635971429,-181052,true,13721597297,22,13605463793,-116133504
1635971606,-181057,true,13714738556,22,13597303371,-117435185
1635971656,-181058,true,13713367219,22,13591865809,-121501410
1635971687,-181063,true,13706512592,22,13589147844,-117364748
1635971699,-181067,true,13701031357,22,13587789065,-113242292
1635971740,-181073,true,13692813615,22,13582355308,-110458307
1635971743,-181074,true,13691444471,22,13580997208,-110447263
1635971766,-181080,true,13683232478,22,13579639244,-103593234
1635971796,-181083,true,13679128329,22,13575566167,-103562162
1635971878,-181088,true,13672290817,22,13564710599,-107580218
1635971969,-181088,true,13672290817,22,13547088813,-125202004
1635972029,-181094,true,13664090313,22,13534902527,-129187786
1635972221,-181097,true,13659991905,22,13525431884,-134560021
1635972294,-181101,true,13654529274,22,13521375066,-133154208
1635972331,-181101,true,13654529274,22,13517319465,-137209809
1635972348,-181106,true,13647704057,22,13515967868,-131736189
1635972385,-181107,true,13646339423,22,13511913888,-134425535
1635972392,-181110,true,13642246340,22,13511913888,-130332452
1635972456,-181108,true,13644974926,22,13514616406,-130358520
1635972551,-181110,true,13642246340,22,13521375066,-120871274
1635972578,-181111,true,13640882252,22,13524079476,-116802776
1635972606,-181114,true,13636790805,22,13528137106,-108653699
1635972720,-181110,true,13642246340,22,13551153346,-91092994
1635972755,-181112,true,13639518300,22,13559286071,-80232229
1635972766,-181113,true,13638154485,22,13559286071,-78868414
1635973142,-181122,true,13625886280,22,13541671332,-84214948
1635973162,-181122,true,13625886280,22,13540317301,-85568979
1635973187,-181124,true,13623161512,22,13538963404,-84198108
1635973271,-181125,true,13621799332,22,13533549172,-88250160
1635973466,-181134,true,13609545840,22,13503809577,-105736263
1635973493,-181133,true,13610906795,22,13505159958,-105746837
1635973512,-181135,true,13608185022,22,13506510474,-101674548
1635973618,-181135,true,13608185022,22,13488964295,-119220727
1635973702,-181141,true,13600022968,22,13493011389,-107011579
1635973811,-181141,true,13600022968,22,13493011389,-107011579
1635973891,-181144,true,13595943777,22,13491662223,-104281554
1635974024,-181144,true,13595943777,22,13487615533,-108328244
1635974081,-181151,true,13586430422,22,13476830295,-109600127
1635974260,-181155,true,13580997208,22,13435118893,-145878315
1635974284,-181159,true,13575566167,22,13428403348,-147162819
1635974312,-181161,true,13572851461,22,13420349125,-152502336
1635974353,-181169,true,13561998064,22,13402914878,-159083186
1635974439,-181177,true,13551153346,22,13337404502,-213748844
1635974493,-181183,true,13543025499,22,13301443876,-241581623
1635974710,-181188,true,13536256018,22,13138846271,-397409747
1635974741,-181197,true,13524079476,22,13119153760,-404925716
1635974774,-181206,true,13511913888,22,13092942982,-418970906
1635974829,-181211,true,13505159958,22,13056335846,-448824112
1635974860,-181217,true,13497059697,22,13035463455,-461596242
1635974890,-181224,true,13487615533,22,13019831061,-467784472
1635974928,-181232,true,13476830295,22,13001616962,-475213333
1635975017,-181235,true,13472788054,22,12970452052,-502336002
1635975034,-181241,true,13464707210,22,12963968771,-500738439
1635975036,-181246,true,13457976876,22,12962672504,-495304372
1635975076,-181256,true,13444526298,22,12939361845,-505164453
1635975139,-181261,true,13437806051,22,12912219052,-525586999
1635975211,-181267,true,13429746188,22,12881268429,-548477759
1635975253,-181275,true,13419007224,22,12865820950,-553186274
1635975273,-181284,true,13406936154,22,12860675908,-546260246
1635975362,-181289,true,13400234697,22,12847822302,-552412395
1635975368,-181296,true,13390858283,22,12845253123,-545605160
1635975427,-181304,true,13380150416,22,12837548668,-542601748
1635975437,-181313,true,13368114299,22,12837548668,-530565631
1635975475,-181317,true,13362768390,22,12841400318,-521368072
1635975535,-181320,true,13358760361,22,12849107085,-509653276
1635975580,-181327,true,13349412968,22,12847822302,-501590666
1635975596,-181336,true,13337404502,22,12847822302,-489582200
1635975611,-181339,true,13333404080,22,12850391995,-483012085
1635975616,-181343,true,13328072052,22,12850391995,-477680057
1635975660,-181348,true,13321410015,22,12855532923,-465877092
1635975718,-181352,true,13316082782,22,12877404821,-438677961
1635975759,-181355,true,13312088756,22,12892866209,-419222547
1635975763,-181362,true,13302774021,22,12892866209,-409907812
1635975808,-181363,true,13301443876,22,12905764879,-395678997
1635975817,-181369,true,13293465802,22,12908346161,-385119641
1635975885,-181370,true,13292136589,22,12930307913,-361828676
1635975992,-181378,true,13281507663,22,12960080358,-321427305
1635976013,-181382,true,13276196388,22,12966561694,-309634694
1635976075,-181388,true,13268233457,22,12984726685,-283506772
1635976092,-181390,true,13265580209,22,12992519469,-273060740
1635976139,-181394,true,13260275303,22,13022435158,-237840145
1635976260,-181395,true,13258949408,22,13095561702,-163387706
1635976313,-181398,true,13254972519,22,13130965722,-124006797
1635976348,-181399,true,13253647154,22,13151991032,-101656122
1635976355,-181404,true,13247022318,22,13154621561,-92400757
1635976479,-181408,true,13241724833,22,13190185251,-51539582
1635976482,-181412,true,13236429467,22,13191504269,-44925198
1635976529,-181415,true,13232459333,22,13196781663,-35677670
1635976613,-181420,true,13225845087,22,13199421151,-26423936
1635976661,-181426,true,13217912357,22,13192823420,-25088937
1635976747,-181430,true,13212626513,22,13180955813,-31670700
1635976765,-181433,true,13208663518,22,13178320018,-30343500
1635976843,-181437,true,13203381373,22,13173050007,-30331366
1635976920,-181441,true,13198101341,22,13170415792,-27685549
1635977046,-181445,true,13192823420,22,13142788319,-50035101
1635977158,-181448,true,13188866364,22,13107352423,-81513941
1635977159,-181453,true,13182273909,22,13107352423,-74921486
1635977184,-181457,true,13177002317,22,13092942982,-84059335
1635977200,-181461,true,13171732834,22,13083781587,-87951247
1635977203,-181469,true,13161200188,22,13082473340,-78726848
1635977241,-181477,true,13150675964,22,13056335846,-94340118
1635977273,-181480,true,13146731550,22,13044591017,-102140533
1635977276,-181485,true,13140160156,22,13043286688,-96873468
1635977288,-181493,true,13129652757,22,13039374485,-90278272
1635977305,-181498,true,13123089899,22,13034160039,-88929860
1635977309,-181503,true,13116530322,22,13031553598,-84976724
1635977337,-181509,true,13108663158,22,13023737401,-84925757
1635977371,-181517,true,13098180945,22,13014624431,-83556514
1635977415,-181523,true,13090324786,22,13005517837,-84806949
1635977422,-181528,true,13083781587,22,13005517837,-78263750
1635977447,-181537,true,13072012069,22,12993818721,-78193348
1635977456,-181547,true,13058947244,22,12991220347,-67726897
1635977487,-181554,true,13049809636,22,12983428342,-66381294
1635977506,-181553,true,13051114617,22,12979534093,-71580524
1635977528,-181558,true,13044591017,22,12974343577,-70247440
1635977568,-181567,true,13032856753,22,12966561694,-66295059
1635977594,-181574,true,13023737401,22,12958784480,-64952921
1635977650,-181574,true,13023737401,22,12945832820,-77904581
1635977730,-181579,true,13017227486,22,12927722240,-89505246
1635977764,-181589,true,13004217415,22,12919968320,-84249095
1635977777,-181597,true,12993818721,22,12916093105,-77725616
1635977805,-181600,true,12989921355,22,12904474431,-85446924
1635977869,-181606,true,12982130129,22,12879980431,-102149698
1635977947,-181616,true,12969155136,22,12852962202,-116192934
1635977989,-181623,true,12960080358,22,12838832423,-121247935
1635978067,-181624,true,12958784480,22,12809338514,-149445966
1635978078,-181628,true,12953602261,22,12805496481,-148105780
1635978107,-181638,true,12940655781,22,12802935766,-137720015
1635978262,-181639,true,12939361845,22,12800375563,-138986282
1635978316,-181639,true,12939361845,22,12792698025,-146663820
1635978366,-181638,true,12940655781,22,12787582225,-153073556
1635978403,-181645,true,12931600944,22,12783746717,-147854227
1635978423,-181647,true,12929015012,22,12777356761,-151658251
1635978464,-181645,true,12931600944,22,12770969999,-160630945
1635978479,-181642,true,12935480812,22,12769693029,-165787783
1635978504,-181652,true,12922552443,22,12760757819,-161794624
1635978544,-181652,true,12922552443,22,12750553805,-171998638
1635978565,-181652,true,12922552443,22,12744180440,-178372003
1635978623,-181654,true,12919968320,22,12717447077,-202521243
1635978658,-181665,true,12905764879,22,12707277697,-198487182
1635978662,-181666,true,12904474431,22,12706007096,-198467335
1635978686,-181666,true,12904474431,22,12707277697,-197196734
1635978713,-181661,true,12910927959,22,12708548424,-202379535
1635978732,-181667,true,12903184113,22,12707277697,-195906416
1635978780,-181670,true,12899313932,22,12706007096,-193306836
1635978875,-181670,true,12899313932,22,12700925963,-198387969
1635978890,-181666,true,12904474431,22,12699655998,-204818433
1635978931,-181672,true,12896734456,22,12695846863,-200887593
1635978972,-181674,true,12894155496,22,12692038870,-202116626
1635978986,-181676,true,12891577051,22,12690769793,-200807258
1635979015,-181674,true,12894155496,22,12680621745,-213533751
1635979026,-181682,true,12883844812,22,12676818319,-207026493
1635979032,-181688,true,12876117210,22,12674283335,-201833875
1635979041,-181690,true,12873542372,22,12673016034,-200526338
1635979080,-181686,true,12878692562,22,12660349985,-218342577
1635979092,-181695,true,12867107532,22,12655287111,-211820421
1635979164,-181702,true,12858104158,22,12618641772,-239462386
1635979192,-181707,true,12851677034,22,12607290671,-244386363
1635979232,-181710,true,12847822302,22,12585877554,-261944748
1635979298,-181723,true,12831131819,22,12540652110,-290479709
1635979313,-181734,true,12817026039,22,12531877164,-285148875
1635979333,-181743,true,12805496481,22,12520604112,-284892369
1635979356,-181749,true,12797815872,22,12500588163,-297227709
1635979382,-181768,true,12773524320,22,12475613219,-297911101
1635979462,-181780,true,12758206050,22,12403467694,-354738356
1635979473,-181791,true,12744180440,22,12394788738,-349391702
1635979484,-181798,true,12735263081,22,12384877368,-350385713
1635979511,-181816,true,12712361370,22,12366314905,-346046465
1635979555,-181826,true,12699655998,22,12344076671,-355579327
1635979596,-181837,true,12685694754,22,12312025359,-373669395
1635979633,-181847,true,12673016034,22,12276373987,-396642047
1635979662,-181864,true,12651491284,22,12251847001,-399644283
1635979702,-181876,true,12636319358,22,12221257166,-415062192
1635979739,-181884,true,12626214850,22,12193181977,-433032873
1635979765,-181892,true,12616118422,22,12170038082,-446080340
1635979776,-181907,true,12597209375,22,12159090522,-438118853
1635979798,-181919,true,12582102545,22,12142080556,-440021989
1635979829,-181926,true,12573298595,22,12120245560,-453053035
1635979830,-181934,true,12563244481,22,12119033656,-444210825
1635979843,-181948,true,12545669124,22,12109342791,-436326333
1635979860,-181960,true,12530624102,22,12098449830,-432174272
1635979864,-181967,true,12521856172,22,12094821020,-427035152
1635979882,-181975,true,12511843194,22,12082732849,-429110345
1635979967,-181992,true,12490592191,22,12017665186,-472927005
1635980077,-182003,true,12476860780,22,11951752748,-525108032
1635980098,-182010,true,12468130470,22,11941001547,-527128923
1635980130,-182017,true,12459406269,22,11921912174,-537494095
1635980180,-182028,true,12445709141,22,11914761530,-530947611
1635980259,-182040,true,12430783994,22,11888579175,-542204819
1635980382,-182046,true,12423328133,22,11899283177,-524044956
1635980401,-182052,true,12415876744,22,11900473105,-515403639
1635980416,-182064,true,12400987372,22,11899283177,-501704195
1635980474,-182075,true,12387354467,22,11894524654,-492829813
1635980497,-182075,true,12387354467,22,11906424532,-480929935
1635980560,-182077,true,12384877368,22,11937419963,-447457405
1635980590,-182087,true,12372499299,22,11949362756,-423136543
1635980614,-182093,true,12365078397,22,11960121485,-404956912
1635980652,-182095,true,12362605753,22,11973284199,-389321554
1635980677,-182095,true,12362605753,22,11986461399,-376144354
1635980718,-182104,true,12351484968,22,12005654128,-345830840
1635980762,-182109,true,12345311078,22,12026080075,-319231003
1635980905,-182108,true,12346545609,22,12120245560,-226300049
1635980910,-182111,true,12342842386,22,12122669730,-220172656
1635980925,-182119,true,12332972554,22,12133584498,-199388056
1635980943,-182123,true,12328040598,22,12149367626,-178672972
1635980992,-182116,true,12336672816,22,12193181977,-143490839
1635981035,-182119,true,12332972554,22,12233483924,-99488630
1635981073,-182127,true,12323110615,22,12259199947,-63910668
1635981085,-182132,true,12316950907,22,12267783962,-49166945
1635981147,-182127,true,12323110615,22,12319414421,-3696194
1635981211,-182128,true,12321878427,22,12361369616,39491189
1635981223,-182137,true,12310794279,22,12367551537,56757258
1635981250,-182140,true,12307101779,22,12392310152,85208373
1635981269,-182135,true,12313256561,22,12404708040,91451479
1635981362,-182136,true,12312025359,22,12459406269,147380910
1635981371,-182144,true,12302180169,22,12464390779,162210610
1635981400,-182151,true,12293572087,22,12464390779,170818692
1635981420,-182146,true,12299720102,22,12468130470,168410368
1635981516,-182145,true,12300950074,22,12486845763,185895689
1635981555,-182154,true,12289884752,22,12498088420,208203668
1635981621,-182159,true,12283741653,22,12504338715,220597062
1635981631,-182153,true,12291113741,22,12505589148,214475407
1635981643,-182154,true,12289884752,22,12508090391,218205639
1635981653,-182160,true,12282513402,22,12510592134,228078732
1635981682,-182162,true,12280057268,22,12515597122,235539854
1635981699,-182156,true,12287427144,22,12515597122,228169978
1635981720,-182154,true,12289884752,22,12518100367,228215615
1635981755,-182160,true,12282513402,22,12521856172,239342770
1635981805,-182162,true,12280057268,22,12526865666,246808398
1635981844,-182158,true,12284970027,22,12519352177,234382150
1635981863,-182161,true,12281285273,22,12513094378,231809105
1635981934,-182168,true,12272691811,22,12514345687,241653876
1635981967,-182168,true,12272691811,22,12518100367,245408556
1635981990,-182162,true,12280057268,22,12516848682,236791414
1635982113,-182167,true,12273919080,22,12513094378,239175298
1635982160,-182175,true,12264104362,22,12505589148,241484786
1635982168,-182175,true,12264104362,22,12504338715,240234353
1635982194,-182167,true,12273919080,22,12508090391,234171311
1635982207,-182169,true,12271464665,22,12510592134,239127469
1635982256,-182172,true,12267783962,22,12519352177,251568215
1635982339,-182175,true,12264104362,22,12508090391,243986029
1635982400,-182169,true,12271464665,22,12499338229,227873564
1635982431,-182173,true,12266557306,22,12495589178,229031872
1635982455,-182179,true,12259199947,22,12486845763,227645816
1635982493,-182179,true,12259199947,22,12484348768,225148821
1635982518,-182172,true,12267783962,22,12483100458,215316496
1635982535,-182174,true,12265330773,22,12480604213,215273440
1635982544,-182175,true,12264104362,22,12478108466,214004104
1635982617,-182175,true,12264104362,22,12453178434,189074072
1635982656,-182168,true,12272691811,22,12439488153,166796342
1635982690,-182168,true,12272691811,22,12427055504,154363693
1635982776,-182165,true,12276373987,22,12412152726,135778739
1635982815,-182160,true,12282513402,22,12397267820,114754418
1635982825,-182151,true,12293572087,22,12394788738,101216651
1635982927,-182148,true,12297260527,22,12372499299,75238772
1635983108,-182148,true,12297260527,22,12318182603,20922076
1635983135,-182149,true,12296030924,22,12304640728,8609804
1635983138,-182142,true,12304640728,22,12303410387,-1230341
1635983139,-182140,true,12307101779,22,12303410387,-3691392
1635983284,-182138,true,12309563323,22,12278829385,-30733938
1635983298,-182137,true,12310794279,22,12277601624,-33192655
1635983333,-182131,true,12318182603,22,12264104362,-54078241
1635983487,-182133,true,12315719336,22,12222479291,-93240045
1635983515,-182133,true,12315719336,22,12216369885,-99349451
1635983623,-182132,true,12316950907,22,12195620735,-121330172
1635983629,-182125,true,12325575360,22,12193181977,-132393383
1635983653,-182127,true,12323110615,22,12185868628,-137241987
1635983660,-182129,true,12320646362,22,12183431819,-137214543
1635983664,-182128,true,12321878427,22,12182213598,-139664829
1635983681,-182120,true,12331739380,22,12178559665,-153179715
1635983702,-182122,true,12329273403,22,12173689458,-155583945
1635983728,-182117,true,12335439272,22,12172472211,-162967061
1635983857,-182115,true,12337906483,22,12161522462,-176384021
1635983917,-182106,true,12349015042,22,12163954888,-185060154
1635983967,-182108,true,12346545609,22,12151797621,-194747988
1635984072,-182109,true,12345311078,22,12116610213,-228700865
1635984095,-182107,true,12347780264,22,12110553725,-237226539
1635984190,-182101,true,12355190785,22,12088775424,-266415361
1635984198,-182104,true,12351484968,22,12086358031,-265126937
1635984247,-182101,true,12355190785,22,12081524696,-273666089
1635984307,-182101,true,12355190785,22,12089984301,-265206484
1635984332,-182099,true,12357661946,22,12092402419,-265259527
1635984338,-182107,true,12347780264,22,12092402419,-255377845
1635984474,-182105,true,12350249943,22,12103289935,-246960008
1635984636,-182111,true,12342842386,22,12100869641,-241972745
1635984645,-182107,true,12347780264,22,12099659675,-248120589
1635984744,-182115,true,12337906483,22,12083941122,-253965361
1635984770,-182115,true,12337906483,22,12073071011,-264835472
1635984821,-182123,true,12328040598,22,12053770507,-274270091
1635984884,-182124,true,12326807918,22,12046540775,-280267143
1635984890,-182136,true,12312025359,22,12045336242,-266689117
1635985031,-182139,true,12308332490,22,12009256184,-299076306
1635985045,-182151,true,12293572087,22,11999653101,-293918986
1635985072,-182158,true,12284970027,22,11993655074,-291314953
1635985111,-182170,true,12270237641,22,11984064466,-286173175
1635985196,-182172,true,12267783962,22,11950557692,-317226270
1635985235,-182182,true,12255522922,22,11931453043,-324069879
1635985248,-182188,true,12248172181,22,11924296676,-323875505
1635985258,-182198,true,12235930743,22,11918336316,-317594427
1635985298,-182203,true,12229814613,22,11890957010,-338857603
1635985316,-182217,true,12212705707,22,11880260497,-332445210
1635985379,-182223,true,12205380647,22,11841122208,-364258439
1635985461,-182233,true,12193181977,22,11796213570,-396968407
1635985474,-182237,true,12188305923,22,11790317232,-397988691
1635985487,-182249,true,12173689458,22,11784423841,-389265617
1635985512,-182257,true,12163954888,22,11765584781,-398370107
1635985571,-182273,true,12144509093,22,11718618784,-425890309
1635985600,-182279,true,12137224937,22,11694036734,-443188203
1635985609,-182292,true,12121457584,22,11685854182,-435603402
1635985663,-182298,true,12114187255,22,11655511940,-458675315
1635985687,-182316,true,12092402419,22,11635715391,-456687028
1635985702,-182322,true,12085149516,22,11627573648,-457575868
1635985722,-182337,true,12067036286,22,11619437601,-447598685
1635985812,-182339,true,12064623241,22,11591585779,-473037462
1635985834,-182355,true,12045336242,22,11582316682,-463019560
1635985842,-182360,true,12039315380,22,11581158566,-458156814
1635985948,-182376,true,12020068839,22,11551088165,-468980674
1635985955,-182380,true,12015262013,22,11547623532,-467638481
1635985962,-182395,true,11997253530,22,11545314354,-451939176
1635985973,-182402,true,11988858811,22,11539543428,-449315383
1635986028,-182416,true,11972086990,22,11525704972,-446382018
1635986050,-182420,true,11967299352,22,11519943848,-447355504
1635986076,-182433,true,11951752748,22,11511883112,-439869636
1635986095,-182438,true,11945778664,22,11506128897,-439649767
1635986150,-182449,true,11932646188,22,11501527596,-431118592
1635986173,-182454,true,11926681655,22,11502677749,-424003906
1635986257,-182467,true,11911187816,22,11503828016,-407359800
1635986288,-182476,true,11900473105,22,11503828016,-396645089
1635986331,-182484,true,11890957010,22,11502677749,-388279261
1635986349,-182486,true,11888579175,22,11506128897,-382450278
1635986367,-182499,true,11873134835,22,11506128897,-367005938
1635986493,-182503,true,11868386768,22,11538389589,-329997179
1635986532,-182511,true,11858896330,22,11547623532,-311272798
1635986571,-182513,true,11856524907,22,11555709294,-300815613
1635986669,-182526,true,11841122208,22,11568426932,-272695276
1635986724,-182532,true,11834020021,22,11582316682,-251703339
1635986777,-182536,true,11829287596,22,11596223108,-233064488
1635986784,-182537,true,11828104786,22,11597382731,-230722055
1635986814,-182546,true,11817464812,22,11607824551,-209640261
1635986864,-182552,true,11810376814,22,11626411006,-183965808
1635986923,-182552,true,11810376814,22,11654346505,-156030309
1635986927,-182554,true,11808015093,22,11655511940,-152503153
1635987015,-182562,true,11798572930,22,11694036734,-104536196
1635987022,-182564,true,11796213570,22,11696375658,-99837912
1635987039,-182564,true,11796213570,22,11705736035,-90477535
1635987097,-182564,true,11796213570,22,11732688864,-63524706
1635987112,-182568,true,11791496264,22,11740904210,-50592054
1635987150,-182571,true,11787959522,22,11763232016,-24727506
1635987171,-182571,true,11787959522,22,11775000543,-12958979
1635987196,-182569,true,11790317232,22,11789138318,-1178914
1635987230,-182570,true,11789138318,22,11808015093,18876775
1635987261,-182570,true,11789138318,22,11822192507,33054189
1635987295,-182570,true,11789138318,22,11836386943,47248625
1635987348,-182568,true,11791496264,22,11860082220,68585956
1635987364,-182570,true,11789138318,22,11867200048,78061730
1635987483,-182570,true,11789138318,22,11927874323,138736005
1635987550,-182569,true,11790317232,22,11968496082,178178850
1635987557,-182568,true,11791496264,22,11972086990,180590726
1635987580,-182570,true,11789138318,22,11981668013,192529695
1635987608,-182574,true,11784423841,22,11990057697,205633856
1635987687,-182577,true,11780889221,22,12015262013,234372792
1635987730,-182577,true,11780889221,22,12026080075,245190854
1635987743,-182578,true,11779711250,22,12028485412,248774162
1635987774,-182579,true,11778533397,22,12034500857,255967460
1635987799,-182580,true,11777355661,22,12030891229,253535568
1635987833,-182576,true,11782067310,22,12038111569,256044259
1635987864,-182577,true,11780889221,22,12044131828,263242607
1635987896,-182578,true,11779711250,22,12048950204,269238954
1635987904,-182579,true,11778533397,22,12050155099,271621702
1635987915,-182577,true,11780889221,22,12053770507,272881286
1635987947,-182574,true,11784423841,22,12063416899,278993058
1635987971,-182573,true,11785602284,22,12071863825,286261541
1635988001,-182572,true,11786780844,22,12081524696,294743852
1635988052,-182571,true,11787959522,22,12086358031,298398509
1635988062,-182568,true,11791496264,22,12088775424,297279160
1635988100,-182567,true,11792675413,22,12096030503,303355090
1635988106,-182564,true,11796213570,22,12096030503,299816933
1635988156,-182561,true,11799752788,22,12100869641,301116853
1635988186,-182555,true,11806834410,22,12104500264,297665854
1635988197,-182553,true,11809195894,22,12105710715,296514821
1635988218,-182548,true,11815101673,22,12108131978,293030305
1635988219,-182545,true,11818646558,22,12108131978,289485420
1635988273,-182540,true,11824557064,22,12112975957,288418893
1635988327,-182537,true,11828104786,22,12120245560,292140774
1635988456,-182530,true,11836386943,22,12149367626,312980683
1635988518,-182528,true,11838754339,22,12153012800,314258461
1635988613,-182522,true,11845859368,22,12170038082,324178714
1635988663,-182516,true,11852968660,22,12178559665,325591005
1635988669,-182509,true,11861268228,22,12179777521,318509293
1635988710,-182507,true,11863640600,22,12182213598,318572998
1635988722,-182503,true,11868386768,22,12180995498,312608730
1635988737,-182500,true,11871947640,22,12179777521,307829881
1635988786,-182494,true,11879072590,22,12176124318,297051728
1635988818,-182489,true,11885013314,22,12174906827,289893513
1635988862,-182480,true,11895714106,22,12162738614,267024508
1635988879,-182474,true,11902853319,22,12159090522,256237203
1635988950,-182466,true,11912378935,22,12146938116,234559181
1635988967,-182463,true,11915953006,22,12143294764,227341758
1635988989,-182452,true,11929067110,22,12139652504,210585394
1635989089,-182446,true,11936226340,22,12132371261,196144921
1635989149,-182439,true,11944584206,22,12128732277,184148071
1635989206,-182438,true,11945778664,22,12122669730,176891066
1635989233,-182428,true,11957729820,22,12123881997,166152177
1635989313,-182421,true,11966102742,22,12121457584,155354842
1635989343,-182411,true,11978074231,22,12119033656,140959425
1635989375,-182406,true,11984064466,22,12125094385,141029919
1635989420,-182396,true,11996053925,22,12137224937,141171012
1635989437,-182388,true,12005654128,22,12139652504,133998376
1635989451,-182381,true,12014060607,22,12140866469,126805862
1635989488,-182379,true,12016463539,22,12140866469,124402930
1635989491,-182370,true,12027282683,22,12140866469,113583786
1635989507,-182364,true,12034500857,22,12140866469,106365612
1635989573,-182359,true,12040519311,22,12142080556,101561245
1635989647,-182356,true,12044131828,22,12156659069,112527241
1635989696,-182348,true,12053770507,22,12165171283,111400776
1635989751,-182341,true,12062210678,22,12178559665,116348987
1635989766,-182334,true,12070656759,22,12182213598,111556839
1635989861,-182331,true,12074278318,22,12196840297,122561979
1635989899,-182324,true,12082732849,22,12201719765,118986916
1635989925,-182319,true,12088775424,22,12205380647,116605223
1635990080,-182312,true,12097240106,22,12233483924,136243818
1635990087,-182309,true,12100869641,22,12233483924,132614283
1635990127,-182301,true,12110553725,22,12228591753,118038028
1635990175,-182297,true,12115398673,22,12218813281,103414608
1635990280,-182295,true,12117821874,22,12195620735,77798861
1635990331,-182291,true,12122669730,22,12190743706,68073976
1635990448,-182284,true,12131158145,22,12199279787,68121642
1635990476,-182280,true,12136011336,22,12201719765,65708429
1635990506,-182281,true,12134797857,22,12202939937,68142080
1635990543,-182277,true,12139652504,22,12201719765,62067261
1635990559,-182273,true,12144509093,22,12200499715,55990622
1635990593,-182271,true,12146938116,22,12198059981,51121865
1635990700,-182273,true,12144509093,22,12182213598,37704505
1635990701,-182271,true,12146938116,22,12182213598,35275482
1635990768,-182270,true,12148152810,22,12174906827,26754017
1635990812,-182269,true,12149367626,22,12170038082,20670456
1635990882,-182271,true,12146938116,22,12159090522,12152406
1635990936,-182270,true,12148152810,22,12151797621,3644811
1635990945,-182269,true,12149367626,22,12150582562,1214936
1635990976,-182266,true,12153012800,22,12155443524,2430724
1635991116,-182264,true,12155443524,22,12187087214,31643690
1635991194,-182262,true,12157874735,22,12202939937,45065202
1635991262,-182260,true,12160306431,22,12207821845,47515414
1635991390,-182258,true,12162738614,22,12216369885,53631271
1635991430,-182257,true,12163954888,22,12221257166,57302278
1635991453,-182254,true,12167604439,22,12222479291,54874852
1635991481,-182252,true,12170038082,22,12229814613,59776531
1635991580,-182248,true,12174906827,22,12253072185,78165358
1635991593,-182244,true,12179777521,22,12256748475,76970954
1635991599,-182240,true,12184650163,22,12257974149,73323986
1635991623,-182239,true,12185868628,22,12262878075,77009447
1635991664,-182234,true,12191962781,22,12271464665,79501884
1635991815,-182229,true,12198059981,22,12308332490,110272509
1635991828,-182228,true,12199279787,22,12312025359,112745572
1635991941,-182227,true,12200499715,22,12315719336,115219621
1635991954,-182223,true,12205380647,22,12318182603,112801956
1635991956,-182220,true,12209042628,22,12319414421,110371793
1635991982,-182218,true,12211484558,22,12325575360,114090802
1635992017,-182215,true,12215148370,22,12334205852,119057482
1635992068,-182215,true,12215148370,22,12345311078,130162708
1635992156,-182214,true,12216369885,22,12365078397,148708512
1635992170,-182210,true,12221257166,22,12368788292,147531126
1635992292,-182208,true,12223701539,22,12393549383,169847844
1635992343,-182207,true,12224923910,22,12403467694,178543784
1635992366,-182204,true,12228591753,22,12410911635,182319882
1635992439,-182199,true,12234707272,22,12429541040,194833768
1635992537,-182195,true,12239601889,22,12453178434,213576545
1635992590,-182192,true,12243274137,22,12468130470,224856333
1635992657,-182189,true,12246947487,22,12485597203,238649716
1635992664,-182184,true,12253072185,22,12486845763,233773578
1635992736,-182180,true,12257974149,22,12503088406,245114257
1635992803,-182179,true,12259199947,22,12515597122,256397175
1635992840,-182179,true,12259199947,22,12523108358,263908411
1635992945,-182172,true,12267783962,22,12529371165,261587203
1635993088,-182169,true,12271464665,22,12524360669,252896004
1635993096,-182167,true,12273919080,22,12524360669,250441589
1635993142,-182165,true,12276373987,22,12526865666,250491679
1635993185,-182158,true,12284970027,22,12534383665,249413638
1635993237,-182149,true,12296030924,22,12550688144,254657220
1635993250,-182145,true,12300950074,22,12553198407,252248333
1635993307,-182140,true,12307101779,22,12558220440,251118661
1635993371,-182134,true,12314487887,22,12564500806,250012919
1635993500,-182126,true,12324342926,22,12579586502,255243576
1635993521,-182122,true,12329273403,22,12582102545,252829142
1635993552,-182118,true,12334205852,22,12589653694,255447842
1635993707,-182110,true,12344076671,22,12638846748,294770077
1635993738,-182100,true,12356426304,22,12648961365,292535061
1635993750,-182096,true,12361369616,22,12652756433,291386817
1635993830,-182092,true,12366314905,22,12679353809,313038904
1635993852,-182082,true,12378686786,22,12690769793,312083007
1635993861,-182073,true,12389832062,22,12694577405,304745343
1635993923,-182071,true,12392310152,22,12723807073,331496921
1635993959,-182068,true,12396028217,22,12740357950,344329733
1635994010,-182061,true,12404708040,22,12760757819,356049779
1635994031,-182052,true,12415876744,22,12768416188,352539444
1635994053,-182051,true,12417118332,22,12772247096,355128764
1635994071,-182049,true,12419601880,22,12776079153,356477273
1635994139,-182040,true,12430783994,22,12785025092,354241098
1635994171,-182030,true,12443220373,22,12790139869,346919496
1635994217,-182027,true,12446953712,22,12797815872,350862160
1635994324,-182024,true,12450688172,22,12814463018,363774846
1635994343,-182016,true,12460652209,22,12818307741,357655532
1635994427,-182006,true,12473118470,22,12829848834,356730364
1635994451,-182005,true,12474365782,22,12829848834,355483052
1635994488,-182002,true,12478108466,22,12832414932,354306466
1635994511,-181995,true,12486845763,22,12833698174,346852411
1635994541,-181985,true,12499338229,22,12836265042,336926813
1635994654,-181982,true,12503088406,22,12841400318,338311912
1635994687,-181980,true,12505589148,22,12841400318,335811170
1635994719,-181972,true,12515597122,22,12845253123,329656001
1635994839,-181959,true,12531877164,22,12859389969,327512805
1635994919,-181953,true,12539398170,22,12882556556,343158386
1635994972,-181946,true,12548178383,22,12894155496,345977113
1635994988,-181939,true,12556964743,22,12896734456,339769713
1635995009,-181927,true,12572041391,22,12900603863,328562472
1635995119,-181924,true,12575813381,22,12921260317,345446936
1635995127,-181918,true,12583360756,22,12922552443,339191687
1635995167,-181910,true,12593430968,22,12934187394,340756426
1635995183,-181897,true,12609812255,22,12941949846,332137591
1635995215,-181890,true,12618641772,22,12952307031,333665259
1635995301,-181884,true,12626214850,22,12978236269,352021419
1635995347,-181876,true,12636319358,22,12992519469,356200111
1635995375,-181862,true,12654021709,22,13001616962,347595253
1635995424,-181855,true,12662882182,22,13017227486,354345304
1635995441,-181847,true,12673016034,22,13023737401,350721367
1635995496,-181837,true,12685694754,22,13049809636,364114882
1635995615,-181821,true,12706007096,22,13104731345,398724249
1635995632,-181815,true,12713632606,22,13111285022,397652416
1635995822,-181810,true,12719990694,22,13171732834,451742140
1635995840,-181800,true,12732716410,22,13180955813,448239403
1635995866,-181785,true,12751828860,22,13191504269,439675409
1635995917,-181777,true,12762033894,22,13212626513,450592619
1635996028,-181772,true,12768416188,22,13256298016,487881828
1635996108,-181762,true,12781190351,22,13277524008,496333657
1635996157,-181747,true,12800375563,22,13285492514,485116951
1635996203,-181742,true,12806777031,22,13292136589,485359558
1635996245,-181739,true,12810619448,22,13297454241,486834793
1635996247,-181731,true,12820871531,22,13297454241,476582710
1635996279,-181717,true,12838832423,22,13300113865,461281442
1635996322,-181711,true,12846537649,22,13302774021,456236372
1635996361,-181708,true,12850391995,22,13301443876,451051881
1635996371,-181700,true,12860675908,22,13300113865,439437957
1635996420,-181686,true,12878692562,22,13294795149,416102587
1635996478,-181683,true,12882556556,22,13280179645,397623089
1635996610,-181681,true,12885133196,22,13243049006,357915810
1635997127,-181679,true,12887710352,22,13002917123,115206771
1635997199,-181670,true,12899313932,22,12978236269,78922337
1635997350,-181667,true,12903184113,22,12932894104,29709991
1635997385,-181666,true,12904474431,22,12925137083,20662652
1635997387,-181665,true,12905764879,22,12925137083,19372204
1635997492,-181655,true,12918676453,22,12907055455,-11620998
1635997499,-181652,true,12922552443,22,12905764879,-16787564
1635997532,-181650,true,12925137083,22,12904474431,-20662652
1635997540,-181650,true,12925137083,22,12904474431,-20662652
1635997559,-181642,true,12935480812,22,12904474431,-31006381
1635997610,-181640,true,12938068038,22,12904474431,-33593607
1635997654,-181639,true,12939361845,22,12904474431,-34887414
1635997660,-181639,true,12939361845,22,12904474431,-34887414
1635997758,-181630,true,12951011930,22,12903184113,-47827817
1635998285,-181628,true,12953602261,22,12891577051,-62025210
1635998422,-181626,true,12956193111,22,12885133196,-71059915
1635998475,-181626,true,12956193111,22,12883844812,-72348299
1635998527,-181616,true,12969155136,22,12882556556,-86598580
1635998553,-181614,true,12971749097,22,12881268429,-90480668
1635998587,-181613,true,12973046272,22,12879980431,-93065841
1635998710,-181611,true,12975641011,22,12890288023,-85352988
1635998752,-181604,true,12984726685,22,12898024129,-86702556
1635998828,-181602,true,12987323760,22,12912219052,-75104708
1635999055,-181601,true,12988622493,22,12952307031,-36315462
1635999088,-181599,true,12991220347,22,12956193111,-35027236
1635999128,-181591,true,13001616962,22,12969155136,-32461826
1635999189,-181588,true,13005517837,22,12989921355,-15596482
1635999288,-181585,true,13009419882,22,13022435158,13015276
1635999367,-181584,true,13010720824,22,13047200066,36479242
1635999401,-181578,true,13018529209,22,13057641480,39112271
1635999447,-181575,true,13022435158,22,13072012069,49576911
1635999555,-181573,true,13025039775,22,13099490763,74450988
1635999594,-181574,true,13023737401,22,13106041819,82304418
1635999614,-181568,true,13031553598,22,13109974024,78420426
1635999931,-181566,true,13034160039,22,13144102598,109942559
1635999962,-181564,true,13036767001,22,13148046223,111279222
1636000015,-181564,true,13036767001,22,13149361028,112594027
1636000025,-181559,true,13043286688,22,13149361028,106074340
1636000141,-181556,true,13047200066,22,13140160156,92960090
1636000150,-181554,true,13049809636,22,13138846271,89036635
1636000250,-181553,true,13051114617,22,13130965722,79851105
1636000295,-181549,true,13056335846,22,13121777722,65441876
1636000351,-181548,true,13057641480,22,13111285022,53643542
1636000683,-181548,true,13057641480,22,13039374485,-18266995
1636000711,-181548,true,13057641480,22,13040678422,-16963058
1636000866,-181544,true,13062865320,22,13006818388,-56046932
1636000997,-181543,true,13064171606,22,12982130129,-82041477
1636001081,-181544,true,13062865320,22,12966561694,-96303626
1636001310,-181546,true,13060253139,22,12922552443,-137700696
1636001439,-181543,true,13064171606,22,12904474431,-159697175
1636001550,-181546,true,13060253139,22,12859389969,-200863170
1636001668,-181548,true,13057641480,22,12806777031,-250864449
1636001699,-181553,true,13051114617,22,12795256692,-255857925
1636001870,-181555,true,13048504786,22,12735263081,-313241705
1636002038,-181559,true,13043286688,22,12692038870,-351247818
1636002048,-181562,true,13039374485,22,12689500843,-349873642
1636002236,-181567,true,13032856753,22,12642638781,-390217972
1636002382,-181568,true,13031553598,22,12636319358,-395234240
1636002470,-181570,true,13028947678,22,12655287111,-373660567
1636002579,-181573,true,13025039775,22,12659084077,-365955698
1636002732,-181579,true,13017227486,22,12655287111,-361940375
1636002745,-181582,true,13013323098,22,12655287111,-358035987
1636002780,-181587,true,13006818388,22,12654021709,-352796679
1636002924,-181591,true,13001616962,22,12645167436,-356449526
1636003069,-181597,true,12993818721,22,12645167436,-348651285
1636003120,-181599,true,12991220347,22,12645167436,-346052911
1636003161,-181606,true,12982130129,22,12636319358,-345810771
1636003182,-181611,true,12975641011,22,12630003093,-345637918
1636003262,-181622,true,12961376366,22,12608551400,-352824966
1636003373,-181626,true,12956193111,22,12578328669,-377864442
1636003381,-181634,true,12945832820,22,12577070962,-368761858
1636003528,-181639,true,12939361845,22,12558220440,-381141405
1636003586,-181651,true,12923844698,22,12550688144,-373156554
1636003610,-181656,true,12917384714,22,12546923690,-370461024
1636003633,-181664,true,12907055455,22,12541906175,-365149280
1636003768,-181672,true,12896734456,22,12508090391,-388644065
1636003801,-181684,true,12881268429,22,12499338229,-381930200
1636003809,-181689,true,12874829727,22,12496838737,-377990990
1636003816,-181697,true,12864534496,22,12495589178,-368945318
1636003858,-181705,true,12854247498,22,12483100458,-371147040
1636003896,-181716,true,12840116306,22,12470624221,-369492085
1636003933,-181720,true,12834981543,22,12463144464,-371837079
1636004084,-181726,true,12827283249,22,12438244329,-389038920
1636004141,-181734,true,12817026039,22,12430783994,-386242045
1636004162,-181745,true,12802935766,22,12430783994,-372151772
1636004191,-181748,true,12799095653,22,12428298210,-370797443
1636004288,-181752,true,12793977295,22,12420843840,-373133455
1636004349,-181757,true,12787582225,22,12417118332,-370463893
1636004357,-181763,true,12779912360,22,12415876744,-364035616
1636004513,-181767,true,12774801673,22,12403467694,-371333979
1636004575,-181771,true,12769693029,22,12404708040,-364984989
1636004585,-181775,true,12764586429,22,12403467694,-361118735
1636004596,-181781,true,12756930357,22,12402227471,-354702886
1636004720,-181787,true,12749278877,22,12392310152,-356968725
1636004833,-181791,true,12744180440,22,12398507547,-345672893
1636004875,-181795,true,12739084042,22,12398507547,-340576495
1636005003,-181800,true,12732716410,22,12400987372,-331729038
1636005038,-181805,true,12726351961,22,12404708040,-321643921
1636005111,-181808,true,12722534819,22,12403467694,-319067125
1636005124,-181812,true,12717447077,22,12403467694,-313979383
1636005189,-181817,true,12711090261,22,12402227471,-308862790
1636005248,-181822,true,12704736622,22,12399747397,-304989225
1636005287,-181824,true,12702196056,22,12400987372,-301208684
1636005510,-181829,true,12695846863,22,12404708040,-291138823
1636005527,-181834,true,12689500843,22,12405948511,-283552332
1636005579,-181839,true,12683157996,22,12408429825,-274728171
1636005847,-181840,true,12681889807,22,12428298210,-253591597
1636005867,-181844,true,12676818319,22,12429541040,-247277279
1636005879,-181851,true,12667948094,22,12432027072,-235921022
1636005996,-181856,true,12661616020,22,12451933241,-209682779
1636006100,-181857,true,12660349985,22,12458160453,-202189532
1636006276,-181860,true,12656552640,22,12493090435,-163462205
1636006353,-181867,true,12647696596,22,12516848682,-130847914
1636006482,-181871,true,12642638781,22,12560732209,-81906572
1636006502,-181872,true,12641374644,22,12565757256,-75617388
1636006529,-181877,true,12635055852,22,12572041391,-63014461
1636006619,-181884,true,12626214850,22,12593430968,-32783882
1636006934,-181888,true,12621165627,22,12652756433,31590806
1636006998,-181889,true,12619903636,22,12660349985,40446349
1636007082,-181894,true,12613595577,22,12659084077,45488500
1636007485,-181903,true,12602249015,22,12622427743,20178728
1636007533,-181908,true,12595949780,22,12614856936,18907156
1636007553,-181909,true,12594690311,22,12613595577,18905266
1636007869,-181916,true,12585877554,22,12528118353,-57759201
1636007903,-181927,true,12572041391,22,12523108358,-48933033
1636008020,-181933,true,12564500806,22,12501838222,-62662584
1636008108,-181933,true,12564500806,22,12500588163,-63912643
1636008111,-181939,true,12556964743,22,12500588163,-56376580
1636008134,-181949,true,12544414682,22,12499338229,-45076453
1636008167,-181955,true,12536890667,22,12484348768,-52541899
1636008216,-181955,true,12536890667,22,12480604213,-56286454
1636008253,-181959,true,12531877164,22,12475613219,-56263945
1636008305,-181968,true,12520604112,22,12470624221,-49979891
1636008422,-181971,true,12516848682,22,12461898275,-54950407
1636008425,-181971,true,12516848682,22,12461898275,-54950407
1636008709,-181974,true,12513094378,22,12494339744,-18754634
1636008728,-181981,true,12504338715,22,12496838737,-7499978
1636008775,-181983,true,12501838222,22,12501838222,0
1636008875,-181980,true,12505589148,22,12514345687,8756539
1636008916,-181981,true,12504338715,22,12519352177,15013462
1636008992,-181986,true,12498088420,22,12515597122,17508702
1636008996,-181986,true,12498088420,22,12515597122,17508702
1636009071,-181984,true,12500588163,22,12533130352,32542189
1636009139,-181984,true,12500588163,22,12540652110,40063947
1636009175,-181988,true,12495589178,22,12543160366,47571188
1636009179,-181989,true,12494339744,22,12543160366,48820622
1636009195,-181988,true,12495589178,22,12543160366,47571188
1636009250,-181988,true,12495589178,22,12545669124,50079946
1636009280,-181993,true,12489343257,22,12546923690,57580433
1636009537,-181989,true,12494339744,22,12589653694,95313950
1636009782,-181986,true,12498088420,22,12627477472,129389052
1636009934,-181986,true,12498088420,22,12651491284,153402864
1636009938,-181990,true,12493090435,22,12652756433,159665998
1636010010,-181986,true,12498088420,22,12670481811,172393391
1636010074,-181980,true,12505589148,22,12690769793,185180645
1636010125,-181977,true,12509341200,22,12704736622,195395422
1636010182,-181978,true,12508090391,22,12731443266,223352875
1636010239,-181971,true,12516848682,22,12746729403,229880721
1636010756,-181967,true,12521856172,22,12840116306,318260134
1636010949,-181964,true,12525613105,22,12855532923,329919818
1636011095,-181966,true,12523108358,22,12849107085,325998727
1636011336,-181959,true,12531877164,22,12840116306,308239142
1636011389,-181954,true,12538144356,22,12838832423,300688067
1636011401,-181950,true,12543160366,22,12837548668,294388302
1636011577,-181950,true,12543160366,22,12834981543,291821177
1636012223,-181943,true,12551943213,22,12823435834,271492621
1636012228,-181939,true,12556964743,22,12823435834,266471091
1636012593,-181935,true,12561988283,22,12758206050,196217767
1636012641,-181935,true,12561988283,22,12749278877,187290594
1636012750,-181932,true,12565757256,22,12728897359,163140103
1636012834,-181929,true,12569527360,22,12712361370,142834010
1636013568,-181926,true,12573298595,22,12623689986,50391391
1636013608,-181927,true,12572041391,22,12623689986,51648595
1636013648,-181924,true,12575813381,22,12624952355,49138974
1636013776,-181921,true,12579586502,22,12626214850,46628348
1636013950,-181918,true,12583360756,22,12631266094,47905338
1636014036,-181919,true,12582102545,22,12633792473,51689928
1636014110,-181916,true,12585877554,22,12632529220,46651666
1636014155,-181913,true,12589653694,22,12632529220,42875526
1636014197,-181911,true,12592171751,22,12627477472,35305721
1636014253,-181913,true,12589653694,22,12621165627,31511933
1636014386,-181908,true,12595949780,22,12619903636,23953856
1636014464,-181903,true,12602249015,22,12636319358,34070343
1636014497,-181901,true,12604769591,22,12638846748,34077157
1636014583,-181902,true,12603509240,22,12647696596,44187356
1636014602,-181895,true,12612334343,22,12650226261,37891918
1636015094,-181890,true,12618641772,22,12742906149,124264377
1636015197,-181888,true,12621165627,22,12769693029,148527402
1636015543,-181891,true,12617380034,22,12716175460,98795426
1636015661,-181885,true,12624952355,22,12690769793,65817438
1636015689,-181883,true,12627477472,22,12684426312,56948840
1636015699,-181881,true,12630003093,22,12680621745,50618652
1636015753,-181885,true,12624952355,22,12667948094,42995739
1636015777,-181878,true,12633792473,22,12665414885,31622412
1636015793,-181877,true,12635055852,22,12660349985,25294133
1636015831,-181877,true,12635055852,22,12647696596,12640744
1636015976,-181883,true,12627477472,22,12594690311,-32787161
1636015994,-181879,true,12632529220,22,12589653694,-42875526
1636016012,-181880,true,12631266094,22,12580844461,-50421633
1636016019,-181881,true,12630003093,22,12577070962,-52932131
1636016083,-181890,true,12618641772,22,12548178383,-70463389
1636016157,-181887,true,12622427743,22,12526865666,-95562077
1636016172,-181889,true,12619903636,22,12524360669,-95542967
1636016208,-181891,true,12617380034,22,12518100367,-99279667
1636016252,-181899,true,12607290671,22,12511843194,-95447477
1636016297,-181895,true,12612334343,22,12505589148,-106745195
1636016415,-181899,true,12607290671,22,12474365782,-132924889
1636016439,-181901,true,12604769591,22,12468130470,-136639121
1636016484,-181908,true,12595949780,22,12459406269,-136543511
1636016528,-181903,true,12602249015,22,12449443228,-152805787
1636016580,-181906,true,12598469096,22,12438244329,-160224767
1636016676,-181905,true,12599728943,22,12417118332,-182610611
1636016818,-181910,true,12593430968,22,12404708040,-188722928
1636016838,-181904,true,12600988916,22,12403467694,-197521222
1636016967,-181906,true,12598469096,22,12413393941,-185075155
1636017362,-181905,true,12599728943,22,12454423752,-145305191
1636017396,-181910,true,12593430968,22,12455669194,-137761774
1636017411,-181904,true,12600988916,22,12455669194,-145319722
1636017422,-181904,true,12600988916,22,12455669194,-145319722
1636017497,-181904,true,12600988916,22,12461898275,-139090641
1636017553,-181907,true,12597209375,22,12474365782,-122843593
1636017722,-181901,true,12604769591,22,12510592134,-94177457
1636017735,-181901,true,12604769591,22,12513094378,-91675213
1636017743,-181902,true,12603509240,22,12514345687,-89163553
1636017945,-181905,true,12599728943,22,12534383665,-65345278
1636017990,-181901,true,12604769591,22,12533130352,-71639239
1636018031,-181901,true,12604769591,22,12530624102,-74145489
1636018062,-181902,true,12603509240,22,12529371165,-74138075
1636018183,-181909,true,12594690311,22,12516848682,-77841629
1636018246,-181905,true,12599728943,22,12510592134,-89136809
1636018396,-181906,true,12598469096,22,12510592134,-87876962
1636018530,-181907,true,12597209375,22,12488094448,-109114927
1636018662,-181915,true,12587136141,22,12454423752,-132712389
1636018686,-181911,true,12592171751,22,12448198408,-143973343
1636018800,-181912,true,12590912660,22,12419601880,-171310780
1636019433,-181913,true,12589653694,22,12358897712,-230755982
1636019620,-181921,true,12579586502,22,12358897712,-220688790
1636019658,-181922,true,12578328669,22,12358897712,-219430957
1636019713,-181923,true,12577070962,22,12358897712,-218173250
1636019786,-181924,true,12575813381,22,12365078397,-210734984
1636020272,-181931,true,12567013832,22,12402227471,-164786361
1636020415,-181932,true,12565757256,22,12412152726,-153604530
1636020505,-181935,true,12561988283,22,12427055504,-134932779
1636020528,-181938,true,12558220440,22,12430783994,-127436446
1636020656,-181945,true,12549433201,22,12446953712,-102479489
1636020872,-181946,true,12548178383,22,12464390779,-83787604
1636020947,-181948,true,12545669124,22,12465637218,-80031906
1636021118,-181952,true,12540652110,22,12466883782,-73768328
1636021183,-181959,true,12531877164,22,12469377283,-62499881
1636021353,-181960,true,12530624102,22,12469377283,-61246819
1636021399,-181962,true,12528118353,22,12464390779,-63727574
1636021404,-181966,true,12523108358,22,12463144464,-59963894
1636021451,-181972,true,12515597122,22,12463144464,-52452658
1636021488,-181973,true,12514345687,22,12461898275,-52447412
1636021498,-181975,true,12511843194,22,12461898275,-49944919
1636021603,-181978,true,12508090391,22,12451933241,-56157150
1636021718,-181988,true,12495589178,22,12412152726,-83436452
1636021733,-181986,true,12498088420,22,12408429825,-89658595
1636021786,-181990,true,12493090435,22,12381162648,-111927787
1636021888,-181992,true,12490592191,22,12377449041,-113143150
1636021903,-182000,true,12480604213,22,12379924655,-100679558
1636021942,-181998,true,12483100458,22,12374973923,-108126535
1636021960,-182000,true,12480604213,22,12363842013,-116762200
1636021961,-182006,true,12473118470,22,12363842013,-109276457
1636021965,-182017,true,12459406269,22,12362605753,-96800516
1636021974,-182019,true,12456914761,22,12361369616,-95545145
1636022037,-182011,true,12466883782,22,12353955389,-112928393
1636022127,-182016,true,12460652209,22,12340374188,-120278021
1636022178,-182026,true,12448198408,22,12334205852,-113992556
1636022447,-182029,true,12444464695,22,12288655887,-155808808
1636022508,-182022,true,12453178434,22,12289884752,-163293682
1636022638,-182027,true,12446953712,22,12324342926,-122610786
1636022751,-182039,true,12432027072,22,12336672816,-95354256
1636022762,-182043,true,12427055504,22,12335439272,-91616232
1636022843,-182038,true,12433270275,22,12321878427,-111391848
1636022925,-182046,true,12423328133,22,12323110615,-100217518
1636022968,-182056,true,12410911635,22,12319414421,-91497214
1636022996,-182060,true,12405948511,22,12316950907,-88997604
1636023036,-182053,true,12414635281,22,12312025359,-102609922
1636023054,-182059,true,12407189106,22,12310794279,-96394827
1636023110,-182068,true,12396028217,22,12309563323,-86464894
1636023189,-182072,true,12391071045,22,12309563323,-81507722
1636023203,-182063,true,12402227471,22,12309563323,-92664148
1636023210,-182069,true,12394788738,22,12308332490,-86456248
1636023414,-182073,true,12389832062,22,12325575360,-64256702
1636023677,-182075,true,12387354467,22,12330506330,-56848137
1636023907,-182066,true,12398507547,22,12366314905,-32192642
1636024092,-182071,true,12392310152,22,12384877368,-7432784
1636024241,-182074,true,12388593203,22,12357661946,-30931257
1636024365,-182077,true,12384877368,22,12334205852,-50671516
1636024395,-182070,true,12393549383,22,12329273403,-64275980
1636024517,-182079,true,12382400764,22,12288655887,-93744877
1636024527,-182084,true,12376211420,22,12284970027,-91241393
1636024539,-182090,true,12368788292,22,12281285273,-87503019
1636024569,-182082,true,12378686786,22,12270237641,-108449145
1636024585,-182092,true,12366314905,22,12264104362,-102210543
1636024610,-182097,true,12360133602,22,12251847001,-108286601
1636024642,-182102,true,12353955389,22,12240825850,-113129539
1636024695,-182095,true,12362605753,22,12222479291,-140126462
1636024790,-182105,true,12350249943,22,12185868628,-164381315
1636024939,-182110,true,12344076671,22,12129945151,-214131520
1636024973,-182116,true,12336672816,22,12116610213,-220062603
1636025027,-182110,true,12344076671,22,12100869641,-243207030
1636025117,-182122,true,12329273403,22,12077900964,-251372439
1636025145,-182129,true,12320646362,22,12068242990,-252403372
1636025186,-182135,true,12313256561,22,12052565250,-260691311
1636025371,-182131,true,12318182603,22,11997253530,-320929073
1636025442,-182142,true,12304640728,22,11984064466,-320576262
1636025476,-182151,true,12293572087,22,11978074231,-315497856
1636025481,-182159,true,12283741653,22,11976876543,-306865110
1636025488,-182156,true,12287427144,22,11973284199,-314142945
1636025490,-182170,true,12270237641,22,11973284199,-296953442
1636025526,-182181,true,12256748475,22,11964906251,-291842224
1636025557,-182188,true,12248172181,22,11955338632,-292833549
1636025612,-182184,true,12253072185,22,11938613705,-314458480
1636025669,-182196,true,12238378052,22,11933839453,-304538599
1636025672,-182203,true,12229814613,22,11933839453,-295975160
1636025761,-182209,true,12222479291,22,11915953006,-306526285
1636025841,-182204,true,12228591753,22,11900473105,-328118648
1636025875,-182218,true,12211484558,22,11889768033,-321716525
1636025906,-182225,true,12202939937,22,11883824932,-319115005
1636025947,-182231,true,12195620735,22,11875509581,-320111154
1636026074,-182227,true,12200499715,22,11848228658,-352271057
1636026198,-182240,true,12184650163,22,11828104786,-356545377
1636026370,-182245,true,12178559665,22,11828104786,-350454879
1636026486,-182251,true,12171255086,22,11841122208,-330132878
1636026543,-182246,true,12177341931,22,11839938214,-337403717
1636026577,-182258,true,12162738614,22,11837570582,-325168032
1636026695,-182265,true,12154228102,22,11835203423,-319024679
1636026706,-182272,true,12145723544,22,11835203423,-310520121
1636026851,-182269,true,12149367626,22,11836386943,-312980683
1636027015,-182281,true,12134797857,22,11851783482,-283014375
1636027039,-182289,true,12125094385,22,11858896330,-266198055
1636027047,-182297,true,12115398673,22,11861268228,-254130445
1636027065,-182291,true,12122669730,22,11864826964,-257842766
1636027079,-182299,true,12112975957,22,11868386768,-244589189
1636027120,-182307,true,12103289935,22,11875509581,-227780354
1636027131,-182313,true,12096030503,22,11877884802,-218145701
1636027176,-182308,true,12102079728,22,11881448523,-220631205
1636027508,-182319,true,12088775424,22,11877884802,-210890622
1636027602,-182326,true,12080316665,22,11896903677,-183412988
1636027605,-182333,true,12071863825,22,11896903677,-174960148
1636027628,-182329,true,12076693294,22,11898093368,-178599926
1636027645,-182337,true,12067036286,22,11898093368,-168942918
1636027895,-182340,true,12063416899,22,11937419963,-125996936
1636028028,-182346,true,12056181382,22,11945778664,-110402718
1636028112,-182339,true,12064623241,22,11946973242,-117649999
1636028202,-182346,true,12056181382,22,11954143218,-102038164
1636028214,-182352,true,12048950204,22,11955338632,-93611572
1636028283,-182359,true,12040519311,22,11956534166,-83985145
1636028417,-182355,true,12045336242,22,11964906251,-80429991
1636028472,-182359,true,12040519311,22,11960121485,-80397826
1636028577,-182362,true,12036907878,22,11961317497,-75590381
1636028618,-182364,true,12034500857,22,11960121485,-74379372
1636028667,-182369,true,12028485412,22,11957729820,-70755592
1636028747,-182374,true,12022472973,22,11952947923,-69525050
1636028759,-182377,true,12018866952,22,11951752748,-67114204
1636028765,-182378,true,12017665186,22,11951752748,-65912438
1636028776,-182384,true,12010457110,22,11950557692,-59899418
1636028890,-182389,true,12004453682,22,11939807566,-64646116
1636028986,-182394,true,11998453256,22,11919528150,-78925106
1636029000,-182398,true,11993655074,22,11917144602,-76510472
1636029196,-182404,true,11986461399,22,11886201816,-100259583
1636029220,-182408,true,11981668013,22,11881448523,-100219490
1636029270,-182412,true,11976876543,22,11873134835,-103741708
1636029341,-182416,true,11972086990,22,11854153957,-117933033
1636029354,-182422,true,11964906251,22,11851783482,-113122769
1636029450,-182425,true,11961317497,22,11842306320,-119011177
1636029679,-182428,true,11957729820,22,11829287596,-128442224
1636029711,-182431,true,11954143218,22,11825739519,-128403699
1636029747,-182438,true,11945778664,22,11821010406,-124768258
1636029781,-182441,true,11942195647,22,11815101673,-127093974
1636029813,-182449,true,11932646188,22,11812739008,-119907180
1636029981,-182450,true,11931453043,22,11838754339,-92698704
1636030153,-182458,true,11921912174,22,11852968660,-68943514
1636030324,-182461,true,11918336316,22,11863640600,-54695716
1636030630,-182468,true,11909996817,22,11851783482,-58213335
1636030635,-182468,true,11909996817,22,11851783482,-58213335
1636030638,-182475,true,11901663153,22,11851783482,-49879671
1636031001,-182477,true,11899283177,22,11786780844,-112502333
1636031122,-182485,true,11889768033,22,11769114809,-120653224
1636031318,-182484,true,11890957010,22,11726824279,-164132731
1636031349,-182490,true,11883824932,22,11718618784,-165206148
1636031558,-182493,true,11880260497,22,11668339416,-211921081
1636031626,-182500,true,11871947640,22,11660174844,-211772796
1636031667,-182501,true,11870760564,22,11660174844,-210585720
1636031774,-182506,true,11864826964,22,11648521080,-216305884
1636031824,-182508,true,11862454355,22,11643862836,-218591519
1636031919,-182516,true,11852968660,22,11633388597,-219580063
1636032134,-182517,true,11851783482,22,11618275773,-233507709
1636032164,-182522,true,11845859368,22,11615952466,-229906902
1636032188,-182524,true,11843490551,22,11612468378,-231022173
1636032258,-182532,true,11834020021,22,11603182582,-230837439
1636032296,-182535,true,11830470525,22,11595063602,-235406923
1636032366,-182541,true,11823374726,22,11578842681,-244532045
1636032382,-182542,true,11822192507,22,11576527260,-245665247
1636032409,-182552,true,11810376814,22,11569583774,-240793040
1636032449,-182555,true,11806834410,22,11559176353,-247658057
1636032472,-182562,true,11798572930,22,11549933172,-248639758
1636032498,-182563,true,11797393191,22,11539543428,-257849763
1636032513,-182570,true,11789138318,22,11534928764,-254209554
1636032671,-182576,true,11782067310,22,11463637003,-318430307
1636032681,-182583,true,11773823161,22,11461344620,-312478541
1636032690,-182586,true,11770291720,22,11457906904,-312384816
1636032712,-182594,true,11760879723,22,11448744702,-312135021
1636032730,-182595,true,11759703753,22,11448744702,-310959051
1636032740,-182601,true,11752650399,22,11447599942,-305050457
1636032771,-182601,true,11752650399,22,11441877858,-310772541
1636032794,-182608,true,11744426834,22,11437302251,-307124583
1636032829,-182611,true,11740904210,22,11425871237,-315032973
1636032936,-182618,true,11732688864,22,11391646697,-341042167
1636032967,-182619,true,11731515712,22,11381399339,-350116373
1636032974,-182627,true,11722134721,22,11379123401,-343011320
1636032994,-182631,true,11717447040,22,11372298316,-345148724
1636033015,-182640,true,11706906608,22,11364340890,-342565718
1636033123,-182643,true,11703395238,22,11329167739,-374227499
1636033180,-182651,true,11694036734,22,11318976584,-375060150
1636033211,-182654,true,11690529225,22,11314450125,-376079100
1636033250,-182662,true,11681181008,22,11307663830,-373517178
1636033253,-182666,true,11676509704,22,11306533177,-369976527
1636033293,-182674,true,11667172698,22,11299751631,-367421067
1636033318,-182678,true,11662506996,22,11296362383,-366144613
1636033366,-182687,true,11652015986,22,11292974152,-359041834
1636033384,-182695,true,11642698566,22,11291844968,-350853598
1636033466,-182707,true,11628736405,22,11271538943,-357197462
1636033482,-182713,true,11621761604,22,11267031454,-354730150
1636033502,-182724,true,11608985334,22,11263652021,-345333313
1636033528,-182729,true,11603182582,22,11258021884,-345160698
1636033590,-182743,true,11586950303,22,11237776683,-349173620
1636033616,-182746,true,11583474913,22,11237776683,-345698230
1636033708,-182755,true,11573054996,22,11205235964,-367819032
1636033735,-182763,true,11563800717,22,11200754990,-363045727
1636033818,-182775,true,11549933172,22,11176141645,-373791527
1636033826,-182781,true,11543005637,22,11171672305,-371333332
1636033835,-182791,true,11531468977,22,11169438306,-362030671
1636033871,-182800,true,11521095843,22,11154928195,-366167648
1636033902,-182815,true,11503828016,22,11143779400,-360048616
1636033967,-182818,true,11500377558,22,11124852014,-375525544
1636034022,-182829,true,11487734730,22,11105956776,-381777954
1636034061,-182840,true,11475105800,22,11088202340,-386903460
1636034068,-182855,true,11457906904,22,11083768168,-374138736
1636034117,-182862,true,11449889576,22,11057200347,-392689229
1636034139,-182875,true,11435015134,22,11043940327,-391074807
1636034182,-182889,true,11419018113,22,11013062087,-405956026
1636034260,-182905,true,11400763205,22,10961424720,-439338485
1636034330,-182912,true,11392785862,22,10930777190,-462008672
1636034362,-182926,true,11376847918,22,10917668779,-459179139
1636034402,-182940,true,11360932270,22,10899125436,-461806834
1636034414,-182953,true,11346173391,22,10894766876,-451406515
1636034448,-182958,true,11340502006,22,10888232303,-452269703
1636034512,-182969,true,11328034935,22,10865392147,-462642788
1636034541,-182981,true,11314450125,22,10851277020,-463173105
1636034549,-182993,true,11300881606,22,10850192001,-450689605
1636034640,-182995,true,11298621769,22,10831763265,-466858504
1636034681,-183003,true,11289586937,22,10826349008,-463237929
1636034708,-183014,true,11277175840,22,10823101752,-454074088
1636034724,-183029,true,11260273601,22,10822019550,-438254051
1636034753,-183032,true,11256896194,22,10819855471,-437040723
1636034847,-183040,true,11247894728,22,10817691825,-430202903
1636034867,-183050,true,11236653018,22,10817691825,-418961193
1636034901,-183064,true,11220933496,22,10813365829,-407567667
1636034928,-183070,true,11214203291,22,10811203481,-402999810
1636034986,-183081,true,11201875066,22,10809041564,-392833502
1636035002,-183093,true,11188441549,22,10809041564,-379399985
1636035017,-183106,true,11173906752,22,10809041564,-364865188
1636035151,-183117,true,11161622826,22,10804719028,-356903798
1636035173,-183129,true,11148237580,22,10803638664,-344598916
1636035218,-183139,true,11137095472,22,10798238465,-338857007
1636035233,-183151,true,11123739640,22,10796079141,-327660499
1636035344,-183164,true,11109288896,22,10769123999,-340164897
1636035368,-183176,true,11095966411,22,10761588627,-334377784
1636035439,-183186,true,11084876545,22,10740088032,-344788513
1636035489,-183195,true,11074905142,22,10729353849,-345551293
1636035493,-183206,true,11062730053,22,10727208300,-335521753
1636035599,-183217,true,11050568348,22,10694007103,-356561245
1636035604,-183225,true,11041731870,22,10691868622,-349863248
1636035620,-183236,true,11029593249,22,10685455746,-344137503
1636035685,-183245,true,11019671577,22,10671574372,-348097205
1636035726,-183253,true,11010859805,22,10661974756,-348885049
1636035728,-183260,true,11003155286,22,10660908665,-342246621
1636035760,-183268,true,10994356721,22,10659842681,-334514040
1636035773,-183272,true,10989960078,22,10659842681,-330117397
1636035799,-183276,true,10985565193,22,10660908665,-324656528
1636035815,-183282,true,10978976160,22,10660908665,-318067495
1636035827,-183288,true,10972391079,22,10661974756,-310416323
1636035828,-183292,true,10968003220,22,10661974756,-306028464
1636035859,-183300,true,10959232764,22,10657711032,-301521732
1636035953,-183309,true,10949374385,22,10650253617,-299120768
1636036009,-183315,true,10942807059,22,10654514358,-288292701
1636036012,-183316,true,10941712887,22,10654514358,-287198529
1636036047,-183324,true,10932963455,22,10659842681,-273120774
1636036072,-183332,true,10924221019,22,10661974756,-262246263
1636036080,-183337,true,10918760546,22,10663040953,-255719593
1636036112,-183340,true,10915485573,22,10675843642,-239641931
1636036143,-183345,true,10910029467,22,10690799542,-219229925
1636036347,-183351,true,10903485740,22,10797158749,-106326991
1636036429,-183358,true,10895856352,22,10817691825,-78164527
1636036464,-183358,true,10895856352,22,10830680197,-65176155
1636036472,-183361,true,10892588249,22,10833929726,-58658523
1636036531,-183368,true,10884966486,22,10849107090,-35859396
1636036593,-183375,true,10877350057,22,10856703744,-20646313
1636036650,-183376,true,10876262430,22,10865392147,-10870283
1636036653,-183378,true,10874087504,22,10865392147,-8695357
1636036669,-183383,true,10868652091,22,10864305717,-4346374
1636036696,-183390,true,10861047077,22,10863219395,2172318
1636036724,-183393,true,10857789414,22,10861047077,3257663
1636036726,-183395,true,10855618182,22,10861047077,5428895
1636036762,-183399,true,10851277020,22,10871913013,20635993
1636036825,-183405,true,10844768532,22,10890410058,45641526
1636036872,-183407,true,10842599904,22,10899125436,56525532
1636036953,-183412,true,10837180230,22,10904576089,67395859
1636036959,-183416,true,10832846441,22,10904576089,71729648
1636036990,-183419,true,10829597237,22,10905666546,76069309
1636037041,-183420,true,10828514386,22,10898035632,69521246
1636037283,-183420,true,10828514386,22,10868652091,40137705
1636037318,-183424,true,10824184063,22,10861047077,36863014
1636037451,-183425,true,10823101752,22,10865392147,42290395
1636037550,-183428,true,10819855471,22,10868652091,48796620
1636037585,-183429,true,10818773594,22,10865392147,46618553
1636037620,-183432,true,10815528611,22,10870825930,55297319
1636037744,-183434,true,10813365829,22,10874087504,60721675
1636037838,-183435,true,10812284601,22,10892588249,80303648
1636037952,-183434,true,10813365829,22,10902395501,89029672
1636037963,-183436,true,10811203481,22,10902395501,91192020
1636037989,-183436,true,10811203481,22,10903485740,92282259
1636038028,-183439,true,10807960768,22,10902395501,94434733
1636038224,-183439,true,10807960768,22,10905666546,97705778
1636038308,-183442,true,10804719028,22,10874087504,69368476
1636038334,-183443,true,10803638664,22,10864305717,60667053
1636038456,-183445,true,10801478261,22,10825266481,23788220
1636038492,-183446,true,10800398221,22,10817691825,17293604
1636038535,-183445,true,10801478261,22,10801478261,0
1636038605,-183445,true,10801478261,22,10774509638,-26968623
1636038629,-183448,true,10798238465,22,10762664786,-35573679
1636038651,-183452,true,10793920249,22,10742236157,-51684092
1636038659,-183454,true,10791761789,22,10737940337,-53821452
1636038661,-183461,true,10784210577,22,10735793071,-48417506
1636038687,-183467,true,10777742314,22,10718630394,-59111920
1636038712,-183470,true,10774509638,22,10700425111,-74084527
1636038735,-183473,true,10771277932,22,10683318975,-87958957
1636038749,-183480,true,10763741052,22,10675843642,-87897410
1636038767,-183488,true,10755133933,22,10666240185,-88893748
1636038785,-183493,true,10749757979,22,10654514358,-95243621
1636038794,-183497,true,10745459151,22,10649188698,-96270453
1636038843,-183512,true,10729353849,22,10601377396,-127976453
1636038857,-183520,true,10720774227,22,10593959399,-126814828
1636038872,-183526,true,10714344014,22,10584429601,-129914413
1636038908,-183531,true,10708988448,22,10558002896,-150985552
1636038943,-183542,true,10697215626,22,10531642171,-165573455
1636038985,-183551,true,10687592944,22,10502196289,-185396655
1636039016,-183555,true,10683318975,22,10477022497,-206296478
1636039061,-183560,true,10677978918,22,10436243719,-241735199
1636039111,-183572,true,10665173668,22,10392505596,-272668072
1636039129,-183579,true,10657711032,22,10376929302,-280781730
1636039152,-183579,true,10657711032,22,10369668356,-288042676
1636039161,-183582,true,10654514358,22,10366558077,-287956281
1636039222,-183589,true,10647059180,22,10342743582,-304315598
1636039245,-183593,true,10642801421,22,10328274595,-314526826
1636039308,-183591,true,10644930088,22,10308670483,-336259605
1636039358,-183592,true,10643865701,22,10290132492,-353733209
1636039420,-183600,true,10635354439,22,10269573821,-365780618
1636039461,-183601,true,10634291010,22,10268546966,-365744044
1636039573,-183597,true,10638545365,22,10289103582,-349441783
1636039605,-183599,true,10636417975,22,10295278588,-341139387
1636039682,-183603,true,10632164471,22,10306609058,-325555413
1636039729,-183608,true,10626849983,22,10322079798,-304770185
1636039752,-183608,true,10626849983,22,10328274595,-298575388
1636039806,-183611,true,10623662566,22,10338607518,-285055048
1636040014,-183618,true,10616228975,22,10418518062,-197710913
1636040038,-183624,true,10609861467,22,10425813212,-184048255
1636040045,-183627,true,10606679145,22,10425813212,-180865933
1636040099,-183629,true,10604558127,22,10443551281,-161006846
1636040107,-183634,true,10599257438,22,10448774101,-150483337
1636040144,-183639,true,10593959399,22,10463411897,-130547502
1636040164,-183637,true,10596078297,22,10465504684,-130573613
1636040252,-183639,true,10593959399,22,10475974900,-117984499
1636040311,-183643,true,10589722875,22,10483310282,-106412593
1636040442,-183648,true,10584429601,22,10469691514,-114738087
1636040556,-183649,true,10583371264,22,10446684660,-136686604
1636040562,-183651,true,10581254907,22,10444595636,-136659271
1636040566,-183657,true,10574908376,22,10443551281,-131357095
1636040621,-183668,true,10563282953,22,10438331072,-124951881
1636040636,-183672,true,10559058696,22,10438331072,-120727624
1636040675,-183679,true,10551670311,22,10428941269,-122729042
1636040690,-183685,true,10545341524,22,10425813212,-119528312
1636040721,-183699,true,10530589112,22,10416434670,-114154442
1636040733,-183703,true,10526377930,22,10416434670,-109943260
1636040762,-183711,true,10517960615,22,10402902780,-115057835
1636040778,-183718,true,10510600987,22,10395623660,-114977327
1636040823,-183732,true,10495897176,22,10381080696,-114816480
1636040874,-183736,true,10491699867,22,10365521525,-126178342
1636041000,-183746,true,10481213935,22,10301457299,-179756636
1636041074,-183754,true,10472832736,22,10257258339,-215574397
1636041085,-183767,true,10459227579,22,10249056223,-210171356
1636041240,-183772,true,10453999533,22,10179602524,-274397009
1636041261,-183784,true,10441462884,22,10171462505,-270000379
1636041308,-183794,true,10431027162,22,10138967470,-292059692
1636041341,-183808,true,10416434670,22,10111630546,-304804124
1636041457,-183818,true,10406023963,22,10037084368,-368939595
1636041488,-183831,true,10392505596,22,10015028156,-377477440
1636041517,-183842,true,10381080696,22,9989024203,-392056493
1636041622,-183853,true,10369668356,22,9950144816,-419523540
1636041632,-183864,true,10358268562,22,9941194162,-417074400
1636041745,-183870,true,10352055775,22,9939206221,-412849554
1636041764,-183880,true,10341709411,22,9937218678,-404490733
1636041777,-183888,true,10333439765,22,9936225056,-397214709
1636041804,-183899,true,10322079798,22,9937218678,-384861120
1636041854,-183904,true,10316920306,22,9948155086,-368765220
1636041973,-183918,true,10302487445,22,9944176819,-358310626
1636041992,-183927,true,10293219841,22,9943182500,-350037341
1636042066,-183941,true,10278820135,22,9930265407,-348554728
1636042091,-183950,true,10269573821,22,9917365094,-352208727
1636042156,-183970,true,10249056223,22,9882716718,-366339505
1636042168,-183979,true,10239836683,22,9879752496,-360084187
1636042234,-183992,true,10226534209,22,9882716718,-343817491
1636042296,-183996,true,10222444618,22,9884693361,-337751257
1636042319,-184012,true,10206102601,22,9888647831,-317454770
1636042338,-184018,true,10199981082,22,9888647831,-311333251
1636042346,-184028,true,10189786708,22,9888647831,-301138877
1636042413,-184030,true,10187749057,22,9907453181,-280295876
1636042433,-184046,true,10171462505,22,9907453181,-264009324
1636042552,-184045,true,10172479652,22,9927286923,-245192729
1636042559,-184051,true,10166378299,22,9927286923,-239091376
1636042603,-184049,true,10168411677,22,9926294293,-242117384
1636042671,-184058,true,10159264680,22,9922324768,-236939912
1636042688,-184055,true,10162312765,22,9922324768,-239987997
1636042846,-184058,true,10159264680,22,9961095450,-198169230
1636042879,-184053,true,10164345329,22,9977045162,-187300167
1636042915,-184062,true,10155201990,22,9988025400,-167176590
1636042970,-184060,true,10157233132,22,10007019738,-150213394
1636042986,-184065,true,10152156039,22,10018032965,-134123074
1636043084,-184060,true,10157233132,22,10089410521,-67822611
1636043168,-184059,true,10158248855,22,10133899507,-24349348
1636043181,-184054,true,10163328996,22,10144037968,-19291028
1636043187,-184059,true,10158248855,22,10149111001,-9137854
1636043241,-184050,true,10167394937,22,10191824768,24429831
1636043311,-184045,true,10172479652,22,10244957626,72477974
1636043331,-184038,true,10179602524,22,10266493565,86891041
1636043567,-184040,true,10177566909,22,10412269138,234702229
1636043580,-184028,true,10189786708,22,10420601869,230815161
1636043625,-184022,true,10195902109,22,10433113472,237211363
1636043687,-184015,true,10203041382,22,10446684660,243643278
1636043731,-184021,true,10196921699,22,10460273501,263351802
1636043784,-184011,true,10207123211,22,10472832736,265709525
1636043821,-184010,true,10208143923,22,10486455590,278311667
1636043833,-184002,true,10216313297,22,10490650801,274337504
1636043866,-184011,true,10207123211,22,10502196289,295073078
1636043996,-184001,true,10217334929,22,10536909046,319574117
1636044107,-184000,true,10218356662,22,10555891612,337534950
1636044162,-183995,true,10223466862,22,10556947201,333480339
1636044184,-184008,true,10210185654,22,10555891612,345705958
1636044208,-184000,true,10218356662,22,10555891612,337534950
1636044215,-184001,true,10217334929,22,10553780750,336445821
1636044265,-183991,true,10227556863,22,10555891612,328334749
1636044272,-184000,true,10218356662,22,10556947201,338590539
1636044296,-183988,true,10230625436,22,10562226731,331601295
1636044302,-183987,true,10231648499,22,10563282953,331634454
1636044340,-183976,true,10242908941,22,10569622508,326713567
1636044353,-183985,true,10233694931,22,10571736538,338041607
1636044408,-183974,true,10244957626,22,10582313033,337355407
1636044414,-183976,true,10242908941,22,10583371264,340462323
1636044440,-183966,true,10253156461,22,10586546593,333390132
1636044495,-183974,true,10244957626,22,10599257438,354299812
1636044536,-183961,true,10258284065,22,10613044744,354760679
1636044546,-183961,true,10258284065,22,10617290598,359006533
1636044595,-183948,true,10271627838,22,10645994581,374366743
1636044625,-183953,true,10266493565,22,10660908665,394415100
1636044647,-183936,true,10283960573,22,10672641530,388680957
1636044680,-183934,true,10286017468,22,10694007103,407989635
1636044756,-183920,true,10300427257,22,10733646234,433218977
1636044825,-183922,true,10298367480,22,10783132263,484764783
1636044828,-183904,true,10316920306,22,10785288998,468368692
1636044865,-183901,true,10320015692,22,10813365829,493350137
1636044911,-183882,true,10339641379,22,10839347774,499706395
1636044951,-183886,true,10335506556,22,10859961081,524454525
1636044990,-183866,true,10356197219,22,10880613588,524416369
1636044996,-183863,true,10359304389,22,10883878098,524573709
1636044999,-183844,true,10379004791,22,10886054983,507050192
1636045093,-183845,true,10377966995,22,10947184838,569217843
1636045118,-183821,true,10402902780,22,10964713477,561810697
1636045240,-183817,true,10407064565,22,11016366337,609301772
1636045261,-183796,true,10428941269,22,11025182515,596241246
1636045287,-183798,true,10426855794,22,11024080107,597224313
1636045364,-183779,true,10446684660,22,11025182515,578497855
1636045383,-183780,true,10445640096,22,11027387662,581747566
1636045429,-183759,true,10467597890,22,11034005748,566407858
1636045481,-183752,true,10474927407,22,11032902458,557975051
1636045483,-183728,true,10500096165,22,11032902458,532806293
1636045486,-183727,true,10501146174,22,11031799278,530653104
1636045557,-183713,true,10515857339,22,11009758830,493901491
1636045576,-183708,true,10521116319,22,11005356027,484239708
1636045587,-183689,true,10541124441,22,11006456562,465332121
1636045762,-183693,true,10536909046,22,10939524873,402615827
1636045868,-183682,true,10548505443,22,10907847789,359342346
1636045881,-183679,true,10551670311,22,10904576089,352905778
1636045914,-183662,true,10569622508,22,10893677508,324055000
1636045968,-183661,true,10570679470,22,10874087504,303408034
1636046083,-183646,true,10586546593,22,10841515752,254969159
1636046109,-183640,true,10592900109,22,10835013119,242113010
1636046174,-183619,true,10615167459,22,10824184063,209016604
1636046181,-183609,true,10625787404,22,10825266481,199479077
1636046223,-183595,true,10640673180,22,10826349008,185675828
1636046300,-183590,true,10645994581,22,10823101752,177107171
1636046372,-183572,true,10665173668,22,10813365829,148192161
1636046444,-183564,true,10673708794,22,10830680197,156971403
1636046466,-183549,true,10689730569,22,10836096620,146366051
1636046505,-183542,true,10697215626,22,10832846441,135630815
1636046520,-183524,true,10716486989,22,10835013119,118526130
1636046631,-183514,true,10727208300,22,10875174913,147966613
1636046673,-183504,true,10737940337,22,10891499099,153558762
1636046726,-183496,true,10746533696,22,10908938573,162404877
1636046788,-183480,true,10763741052,22,10934056751,170315699
1636046893,-183469,true,10775587089,22,10975683126,200096037
1636046907,-183458,true,10787446163,22,10980074057,192627894
1636046992,-183451,true,10794999641,22,11028490400,233490759
1636047065,-183433,true,10814447166,22,11071583335,257136169
1636047207,-183417,true,10831763265,22,11189560393,357797128
1636047469,-183407,true,10842599904,22,11335966939,493367035
1636047488,-183398,true,10852362148,22,11343904497,491542349
1636047597,-183381,true,10870825930,22,11390507646,519681716
1636047636,-183368,true,10884966486,22,11407605373,522638887
1636047681,-183358,true,10895856352,22,11427013824,531157472
1636047720,-183348,true,10906757113,22,11447599942,540842829
1636047721,-183335,true,10920944408,22,11447599942,526655534
1636047766,-183331,true,10925313441,22,11451034565,525721124
1636047829,-183323,true,10934056751,22,11465929845,531873094
1636047850,-183316,true,10941712887,22,11470516905,528804018
1636047888,-183301,true,10958136951,22,11476253311,518116360
1636047928,-183292,true,10968003220,22,11485437527,517434307
1636047961,-183279,true,10982270182,22,11499227635,516957453
1636048010,-183268,true,10994356721,22,11504978399,510621678
1636048154,-183252,true,11011960891,22,11528010229,516049338
1636048184,-183244,true,11020773544,22,11534928764,514155220
1636048364,-183229,true,11037316281,22,11614790987,577474706
1636048399,-183217,true,11050568348,22,11626411006,575842658
1636048500,-183198,true,11071583335,22,11675342170,603758835
1636048581,-183189,true,11081551747,22,11717447040,635895293
1636048621,-183172,true,11100405463,22,11737382643,636977180
1636048626,-183159,true,11114844652,22,11742078301,627233649
1636048640,-183140,true,11135981874,22,11752650399,616668525
1636048678,-183132,true,11144893778,22,11775000543,630106765
1636048686,-183122,true,11156043688,22,11778533397,622489709
1636048714,-183108,true,11171672305,22,11798572930,626900625
1636048744,-183090,true,11191798417,22,11817464812,625666395
1636048772,-183078,true,11205235964,22,11837570582,632334618
1636048844,-183072,true,11211960787,22,11856524907,644564120
1636048892,-183062,true,11223177795,22,11860082220,636904425
1636048933,-183045,true,11242272468,22,11867200048,624927580
1636048970,-183035,true,11253519801,22,11873134835,619615034
1636049003,-183029,true,11260273601,22,11887390436,627116835
1636049034,-183019,true,11271538943,22,11889768033,618229090
1636049146,-183002,true,11290715896,22,11900473105,609757209
1636049182,-182992,true,11302011694,22,11899283177,597271483
1636049227,-182991,true,11303141895,22,11900473105,597331210
1636049229,-182982,true,11313318793,22,11900473105,587154312
1636049234,-182968,true,11329167739,22,11900473105,571305366
1636049301,-182963,true,11334833456,22,11896903677,562070221
1636049401,-182962,true,11335966939,22,11877884802,541917863
1636049421,-182956,true,11342770220,22,11871947640,529177420
1636049434,-182941,true,11359796290,22,11871947640,512151350
1636049496,-182935,true,11366613872,22,11858896330,492282458
1636049566,-182937,true,11364340890,22,11838754339,474413449
1636049592,-182929,true,11373435546,22,11831653572,458218026
1636049609,-182915,true,11389368709,22,11822192507,432823798
1636049699,-182910,true,11395064533,22,11775000543,379936010
1636049748,-182913,true,11391646697,22,11758527900,366881203
1636049809,-182907,true,11398483394,22,11755001047,356517653
1636049889,-182894,true,11413310317,22,11738556381,325246064
1636049920,-182889,true,11419018113,22,11733862133,314844020
1636050004,-182890,true,11417876325,22,11722134721,304258396
1636050085,-182883,true,11425871237,22,11708077299,282206062
1636050244,-182866,true,11445310765,22,11690529225,245218460
1636050400,-182855,true,11457906904,22,11673007451,215100547
1636050528,-182855,true,11457906904,22,11688191469,230284565
1636050572,-182850,true,11463637003,22,11696375658,232738655
1636050670,-182835,true,11480844501,22,11703395238,222550737
1636050745,-182823,true,11494629094,22,11702225016,207595922
1636050801,-182820,true,11498077828,22,11698715050,200637222
1636051052,-182817,true,11501527596,22,11647356344,145828748
1636051079,-182805,true,11515337022,22,11645027222,129690200
1636051209,-182791,true,11531468977,22,11631062268,99593291
1636051261,-182789,true,11533775387,22,11622923781,89148394
1636051271,-182784,true,11539543428,22,11621761604,82218176
1636051484,-182770,true,11555709294,22,11590426736,34717442
1636051664,-182758,true,11569583774,22,11570740733,1156959
1636051683,-182758,true,11569583774,22,11570740733,1156959
1636051764,-182754,true,11574212302,22,11580000566,5788264
1636051833,-182741,true,11589267809,22,11583474913,-5792896
1636051897,-182732,true,11599702323,22,11575369723,-24332600
1636051924,-182733,true,11598542469,22,11570740733,-27801736
1636051977,-182731,true,11600862294,22,11551088165,-49774129
1636052017,-182722,true,11611307247,22,11534928764,-76378483
1636052042,-182716,true,11618275773,22,11525704972,-92570801
1636052117,-182721,true,11612468378,22,11486586071,-125882307
1636052186,-182723,true,11610146232,22,11439589826,-170556406
1636052206,-182717,true,11617114062,22,11423586406,-193527656
1636052213,-182715,true,11619437601,22,11417876325,-201561276
1636052227,-182723,true,11610146232,22,11407605373,-202540859
1636052255,-182727,true,11605503335,22,11388229886,-217273449
1636052303,-182721,true,11612468378,22,11355253507,-257214871
1636052372,-182720,true,11613629624,22,11309925476,-303704148
1636052512,-182728,true,11604342900,22,11224300112,-380042788
1636052547,-182735,true,11596223108,22,11209718731,-386504377
1636052823,-182731,true,11600862294,22,11068262524,-532599770
1636052876,-182736,true,11595063602,22,11060517838,-534545764
1636052971,-182744,true,11585791724,22,11045044721,-540747003
1636053010,-182752,true,11576527260,22,11040627807,-535899453
1636053137,-182749,true,11580000566,22,11050568348,-529432218
1636053146,-182753,true,11575369723,22,11050568348,-524801375
1636053181,-182761,true,11566113593,22,11056094737,-510018856
1636053366,-182766,true,11560332271,22,11099295533,-461036738
1636053384,-182762,true,11564957097,22,11098185715,-466771382
1636053581,-182767,true,11559176353,22,11077120234,-482056119
1636053599,-182775,true,11549933172,22,11076012633,-473920539
1636053613,-182783,true,11540697382,22,11076012633,-464684749
1636053929,-182779,true,11545314354,22,11073797762,-471516592
1636054034,-182785,true,11538389589,22,11110399825,-427989764
1636054042,-182796,true,11525704972,22,11112622016,-413082956
1636054101,-182803,true,11517640205,22,11131528594,-386111611
1636054111,-182791,true,11531468977,22,11132641747,-398827230
1636054186,-182796,true,11525704972,22,11142665133,-383039839
1636054228,-182810,true,11509581081,22,11146008267,-363572814
1636054281,-182819,true,11499227635,22,11154928195,-344299440
1636054388,-182811,true,11508430238,22,11196275808,-312154430
1636054430,-182817,true,11501527596,22,11211960787,-289566809
1636054498,-182834,true,11481992585,22,11235529465,-246463120
1636054503,-182844,true,11470516905,22,11236653018,-233863887
1636054566,-182837,true,11478548676,22,11256896194,-221652482
1636054634,-182842,true,11472811123,22,11278303557,-194507566
1636054650,-182855,true,11457906904,22,11282815555,-175091349
1636054667,-182868,true,11443022046,22,11286200739,-156821307
1636054783,-182865,true,11446455296,22,11314450125,-132005171
1636054791,-182875,true,11435015134,22,11315581570,-119433564
1636054888,-182886,true,11422444161,22,11318976584,-103467577
1636054966,-182896,true,11411027997,22,11304272210,-106755787
1636055035,-182892,true,11415593093,22,11288458092,-127135001
1636055158,-182900,true,11406464726,22,11269284973,-137179753
1636055178,-182912,true,11392785862,22,11267031454,-125754408
1636055208,-182920,true,11383675733,22,11270411902,-113263831
1636055302,-182912,true,11392785862,22,11283943837,-108842025
1636055306,-182917,true,11387091177,22,11283943837,-103147340
1636055363,-182926,true,11376847918,22,11291844968,-85002950
1636055421,-182936,true,11365477324,22,11298621769,-66855555
1636055614,-182933,true,11368887309,22,11290715896,-78171413
1636055706,-182936,true,11365477324,22,11290715896,-74761428
1636055717,-182944,true,11356389033,22,11291844968,-64544065
1636055727,-182955,true,11343904497,22,11290715896,-53188601
1636055772,-182952,true,11347308008,22,11290715896,-56592112
1636056039,-182958,true,11340502006,22,11287329359,-53172647
1636056090,-182966,true,11331433686,22,11282815555,-48618131
1636056094,-182976,true,11320108482,22,11281687387,-38421095
1636056123,-182973,true,11323504854,22,11274920743,-48584111
1636056136,-182977,true,11318976584,22,11268158157,-50818427
1636056454,-182989,true,11305402637,22,11149352404,-156050233
1636056494,-183000,true,11292974152,22,11148237580,-144736572
1636056603,-182997,true,11296362383,22,11122627377,-173735006
1636056626,-183002,true,11290715896,22,11118179438,-172536458
1636056683,-183014,true,11277175840,22,11108178078,-168997762
1636056718,-183025,true,11264778386,22,11103735918,-161042468
1636056807,-183021,true,11269284973,22,11092638286,-176646687
1636056931,-183026,true,11263652021,22,11078227946,-185424075
1636057070,-183037,true,11251269434,22,11076012633,-175256801
1636057233,-183049,true,11237776683,22,11088202340,-149574343
1636057301,-183046,true,11241148353,22,11092638286,-148510067
1636057334,-183051,true,11235529465,22,11093747550,-141781915
1636057362,-183062,true,11223177795,22,11093747550,-129430245
1636057576,-183070,true,11214203291,22,11088202340,-126000951
1636057875,-183066,true,11218689645,22,11072690493,-145999152
1636057944,-183071,true,11213081983,22,11067155808,-145926175
1636057990,-183081,true,11201875066,22,11070476287,-131398779
1636058050,-183089,true,11192917597,22,11076012633,-116904964
1636058131,-183086,true,11196275808,22,11070476287,-125799521
1636058178,-183091,true,11190679349,22,11069369350,-121309999
1636058203,-183101,true,11179494822,22,11072690493,-106804329
1636058231,-183111,true,11168321474,22,11076012633,-92308841
1636058356,-183106,true,11173906752,22,11077120234,-96786518
1636058392,-183109,true,11170555250,22,11076012633,-94542617
1636058436,-183119,true,11159390836,22,11076012633,-83378203
1636058457,-183124,true,11153812814,22,11074905142,-78907672
1636058494,-183115,true,11163855262,22,11078227946,-85627316
1636058594,-183114,true,11164971647,22,11090420091,-74551556
1636058611,-183120,true,11158275008,22,11092638286,-65636722
1636058688,-183122,true,11156043688,22,11099295533,-56748155
1636058754,-183111,true,11168321474,22,11105956776,-62364698
1636058871,-183110,true,11169438306,22,11110399825,-59038481
1636058891,-183113,true,11166088145,22,11108178078,-57910067
1636058960,-183115,true,11163855262,22,11107067372,-56787890
1636059018,-183105,true,11175024142,22,11122627377,-52396765
1636059131,-183104,true,11176141645,22,11120403186,-55738459
1636059220,-183109,true,11170555250,22,11124852014,-45703236
1636059366,-183110,true,11169438306,22,11150467339,-18970967
1636059458,-183101,true,11179494822,22,11156043688,-23451134
1636059497,-183099,true,11181730833,22,11154928195,-26802638
1636059537,-183103,true,11177259259,22,11154928195,-22331064
1636059639,-183106,true,11173906752,22,11158275008,-15631744
1636059673,-183096,true,11185085688,22,11159390836,-25694852
1636059861,-183094,true,11187322817,22,11173906752,-13416065
1636059873,-183098,true,11182849006,22,11172789473,-10059533
1636059880,-183105,true,11175024142,22,11171672305,-3351837
1636059932,-183097,true,11183967291,22,11171672305,-12294986
1636059965,-183089,true,11192917597,22,11177259259,-15658338
1636059991,-183093,true,11188441549,22,11181730833,-6710716
1636060038,-183093,true,11188441549,22,11195156293,6714744
1636060044,-183085,true,11197395436,22,11198515175,1119739
1636060109,-183078,true,11205235964,22,11219811514,14575550
1636060398,-183081,true,11201875066,22,11290715896,88840830
1636060412,-183083,true,11199635027,22,11294103450,94468423
1636060418,-183083,true,11199635027,22,11296362383,96727356
1636060515,-183077,true,11206356488,22,11328034935,121678447
1636060548,-183079,true,11204115553,22,11334833456,130717903
1636060677,-183078,true,11205235964,22,11376847918,171611954
1636060719,-183078,true,11205235964,22,11390507646,185271682
1636060736,-183072,true,11211960787,22,11396204039,184243252
1636061029,-183070,true,11214203291,22,11492330513,278127222
1636061059,-183068,true,11216446244,22,11500377558,283931314
1636061068,-183067,true,11217567889,22,11502677749,285109860
1636061093,-183060,true,11225422542,22,11509581081,284158539
1636061127,-183057,true,11228790506,22,11516488556,287698050
1636061288,-183055,true,11231036376,22,11555709294,324672918
1636061346,-183053,true,11233282696,22,11570740733,337458037
1636061476,-183044,true,11243396695,22,11611307247,367910552
1636061487,-183041,true,11246770051,22,11608985334,362215283
1636061848,-183041,true,11246770051,22,11608985334,362215283
1636061851,-183038,true,11250144420,22,11607824551,357680131
1636061896,-183031,true,11258021884,22,11605503335,347481451
1636062154,-183029,true,11260273601,22,11547623532,287349931
1636062238,-183032,true,11256896194,22,11528010229,271114035
1636062506,-183033,true,11255770617,22,11478548676,222778059
1636062548,-183030,true,11259147686,22,11473958404,214810718
1636062750,-183031,true,11258021884,22,11415593093,157571209
1636062790,-183035,true,11253519801,22,11405324194,151804393
1636062901,-183034,true,11254645153,22,11389368709,134723556
1636062963,-183030,true,11259147686,22,11382537479,123389793
1636063151,-183029,true,11260273601,22,11367750534,107476933
1636063190,-183031,true,11258021884,22,11365477324,107455440
1636063224,-183029,true,11260273601,22,11366613872,106340271
1636063229,-183023,true,11267031454,22,11365477324,98445870
1636063348,-183022,true,11268158157,22,11349577584,81419427
1636063592,-183026,true,11263652021,22,11339368069,75716048
1636063895,-183024,true,11265904864,22,11326902245,60997381
1636064227,-183018,true,11272666097,22,11296362383,23696286
1636064352,-183012,true,11279431388,22,11288458092,9026704
1636064438,-183017,true,11273793363,22,11281687387,7894024
1636064487,-183015,true,11276048235,22,11277175840,1127605
1636064645,-183010,true,11281687387,22,11268158157,-13529230
1636064685,-183006,true,11286200739,22,11265904864,-20295875
1636064719,-183010,true,11281687387,22,11263652021,-18035366
1636064801,-183010,true,11281687387,22,11252394561,-29292826
1636064873,-183006,true,11286200739,22,11241148353,-45052386
1636064908,-183004,true,11288458092,22,11233282696,-55175396
1636064948,-183008,true,11283943837,22,11228790506,-55153331
1636064998,-183007,true,11285072231,22,11224300112,-60772119
1636065185,-183003,true,11289586937,22,11201875066,-87711871
1636065314,-183001,true,11291844968,22,11187322817,-104522151
1636065435,-183004,true,11288458092,22,11177259259,-111198833
1636065480,-183003,true,11289586937,22,11172789473,-116797464
1636065547,-182999,true,11294103450,22,11163855262,-130248188
1636065555,-182997,true,11296362383,22,11162738988,-133623395
1636065720,-183003,true,11289586937,22,11143779400,-145807537
1636065740,-183003,true,11289586937,22,11141550978,-148035959
1636065916,-183001,true,11291844968,22,11125964499,-165880469
1636066113,-182998,true,11295232860,22,11110399825,-184833035
1636066191,-183003,true,11289586937,22,11104846291,-184740646
1636066205,-183004,true,11288458092,22,11103735918,-184722174
1636066238,-183001,true,11291844968,22,11101515504,-190329464
1636066244,-182997,true,11296362383,22,11101515504,-194846879
1636066446,-183002,true,11290715896,22,11084876545,-205839351
1636066494,-183004,true,11288458092,22,11084876545,-203581547
1636066774,-183005,true,11287329359,22,11047253840,-240075519
1636066784,-183002,true,11290715896,22,11046149225,-244566671
1636066854,-183009,true,11282815555,22,11037316281,-245499274
1636067025,-183011,true,11280559331,22,11006456562,-274102769
1636067216,-183016,true,11274920743,22,10931870268,-343050475
1636067250,-183014,true,11277175840,22,10913302804,-363873036
1636067477,-183024,true,11265904864,22,10825266481,-440638383
1636067517,-183030,true,11259147686,22,10811203481,-447944205
1636067641,-183036,true,11252394561,22,10770200912,-482193649
1636067701,-183034,true,11254645153,22,10750832955,-503812198
1636067748,-183045,true,11242272468,22,10734719599,-507552869
1636067803,-183050,true,11236653018,22,10727208300,-509444718
1636068005,-183053,true,11233282696,22,10719702257,-513580439
1636068051,-183050,true,11236653018,22,10718630394,-518022624
1636068122,-183061,true,11224300112,22,10719702257,-504597855
1636068162,-183065,true,11219811514,22,10725063180,-494748334
1636068199,-183071,true,11213081983,22,10725063180,-488018803
1636068239,-183069,true,11215324712,22,10727208300,-488116412
1636068293,-183080,true,11202995253,22,10729353849,-473641404
1636068351,-183085,true,11197395436,22,10731499827,-465895609
1636068364,-183093,true,11188441549,22,10730426784,-458014765
1636068540,-183091,true,11190679349,22,10743310381,-447368968
1636068603,-183103,true,11177259259,22,10748683111,-428576148
1636068619,-183110,true,11169438306,22,10749757979,-419680327
1636068643,-183120,true,11158275008,22,10750832955,-407442053
1636068647,-183119,true,11159390836,22,10751908038,-407482798
1636068655,-183131,true,11146008267,22,10751908038,-394100229
1636068790,-183135,true,11141550978,22,10748683111,-392867867
1636068855,-183146,true,11129302622,22,10745459151,-383843471
1636069031,-183146,true,11129302622,22,10740088032,-389214590
1636069034,-183159,true,11114844652,22,10740088032,-374756620
1636069055,-183164,true,11109288896,22,10740088032,-369200864
1636069154,-183175,true,11097076007,22,10743310381,-353765626
1636069173,-183181,true,11090420091,22,10735793071,-354627020
1636069192,-183196,true,11073797762,22,10735793071,-338004691
1636069294,-183199,true,11070476287,22,10750832955,-319643332
1636069359,-183209,true,11059411897,22,10758360796,-301051101
1636069416,-183214,true,11053883850,22,10764817426,-289066424
1636069535,-183226,true,11040627807,22,10799318289,-241309518
1636069676,-183226,true,11040627807,22,10844768532,-195859275
1636070079,-183235,true,11030696209,22,10971293950,-59402259
1636070089,-183240,true,11025182515,22,10976780694,-48401821
1636070301,-183249,true,11015264810,22,11006456562,-8808248
1636070548,-183250,true,11014163394,22,10988861192,-25302202
1636070638,-183260,true,11003155286,22,10968003220,-35152066
1636070824,-183263,true,10999854999,22,10939524873,-60330126
1636071130,-183273,true,10988861192,22,10866478687,-122382505
1636071294,-183277,true,10984466746,22,10829597237,-154869509
1636071327,-183286,true,10974585667,22,10822019550,-152566117
1636071377,-183289,true,10971293950,22,10811203481,-160090469
1636071528,-183299,true,10960328688,22,10787446163,-172882525
1636071607,-183302,true,10957041246,22,10761588627,-195452619
1636071642,-183312,true,10946090229,22,10749757979,-196332250
1636071790,-183318,true,10939524873,22,10707917657,-231607216
1636071807,-183331,true,10925313441,22,10703635560,-221677881
1636071836,-183335,true,10920944408,22,10697215626,-223728782
1636071870,-183346,true,10908938573,22,10689730569,-219208004
1636071884,-183351,true,10903485740,22,10687592944,-215892796
1636071958,-183359,true,10894766876,22,10684387307,-210379569
1636071960,-183361,true,10892588249,22,10684387307,-208200942
1636072135,-183371,true,10881701649,22,10668373540,-213328109
1636072303,-183377,true,10875174913,22,10635354439,-239820474
1636072405,-183387,true,10864305717,22,10617290598,-247015119
1636072449,-183388,true,10863219395,22,10614106048,-249113347
1636072652,-183397,true,10853447384,22,10636417975,-217029409
1636072848,-183400,true,10850192001,22,10675843642,-174348359
1636072867,-183407,true,10842599904,22,10676911227,-165688677
1636072932,-183407,true,10842599904,22,10682250750,-160349154
1636072943,-183413,true,10836096620,22,10682250750,-153845870
1636072970,-183416,true,10832846441,22,10685455746,-147390695
1636073077,-183423,true,10825266481,22,10704705924,-120560557
1636073132,-183422,true,10826349008,22,10718630394,-107718614
1636073146,-183428,true,10819855471,22,10721846305,-98009166
1636073161,-183431,true,10816610164,22,10725063180,-91546984
1636073262,-183440,true,10806880080,22,10736866650,-70013430
1636073382,-183442,true,10804719028,22,10746533696,-58185332
1636073474,-183446,true,10800398221,22,10750832955,-49565266
1636073567,-183450,true,10796079141,22,10749757979,-46321162
1636073698,-183458,true,10787446163,22,10730426784,-57019379
1636073781,-183458,true,10787446163,22,10720774227,-66671936
1636073803,-183463,true,10782054058,22,10718630394,-63423664
1636073822,-183467,true,10777742314,22,10716486989,-61255325
1636073843,-183475,true,10769123999,22,10714344014,-54779985
1636073856,-183477,true,10766970498,22,10712201466,-54769032
1636073881,-183482,true,10761588627,22,10707917657,-53670970
1636073924,-183486,true,10757285067,22,10700425111,-56859956
1636073975,-183493,true,10749757979,22,10692937809,-56820170
1636074062,-183495,true,10747608350,22,10679046716,-68561634
1636074167,-183497,true,10745459151,22,10672641530,-72817621
1636074248,-183500,true,10742236157,22,10675843642,-66392515
1636074428,-183504,true,10737940337,22,10692937809,-45002528
1636074441,-183504,true,10737940337,22,10691868622,-46071715
1636074571,-183503,true,10739014131,22,10686524291,-52489840
1636074585,-183505,true,10736866650,22,10685455746,-51410904
1636074609,-183509,true,10732572977,22,10684387307,-48185670
1636074665,-183508,true,10733646234,22,10674776165,-58870069
1636074851,-183508,true,10733646234,22,10650253617,-83392617
1636074891,-183511,true,10730426784,22,10644930088,-85496696
1636074950,-183514,true,10727208300,22,10638545365,-88662935
1636075033,-183514,true,10727208300,22,10635354439,-91853861
1636075065,-183517,true,10723990781,22,10632164471,-91826310
1636075147,-183521,true,10719702257,22,10610922453,-108779804
1636075211,-183525,true,10715415448,22,10593959399,-121456049
1636075245,-183525,true,10715415448,22,10581254907,-134160541
1636075555,-183522,true,10718630394,22,10571736538,-146893856
1636075561,-183526,true,10714344014,22,10571736538,-142607476
1636075623,-183529,true,10711130353,22,10573850991,-137279362
1636075658,-183529,true,10711130353,22,10575965867,-135164486
1636075730,-183531,true,10708988448,22,10566452255,-142536193
1636075738,-183535,true,10704705924,22,10565395715,-139310209
1636075743,-183540,true,10699355176,22,10566452255,-132902921
1636075920,-183537,true,10702565304,22,10573850991,-128714313
1636076026,-183536,true,10703635560,22,10589722875,-113912685
1636076272,-183538,true,10701495154,22,10626849983,-74645171
1636076369,-183543,true,10696146011,22,10634291010,-61855001
1636076405,-183541,true,10698285347,22,10636417975,-61867372
1636076422,-183539,true,10700425111,22,10638545365,-61879746
1636076506,-183541,true,10698285347,22,10642801421,-55483926
1636076511,-183547,true,10691868622,22,10643865701,-48002921
1636076685,-183543,true,10696146011,22,10680114620,-16031391
1636076760,-183541,true,10698285347,22,10687592944,-10692403
1636076936,-183542,true,10697215626,22,10688661703,-8553923
1636076948,-183547,true,10691868622,22,10688661703,-3206919
1636076999,-183547,true,10691868622,22,10685455746,-6412876
1636077024,-183546,true,10692937809,22,10684387307,-8550502
1636077098,-183551,true,10687592944,22,10671574372,-16018572
1636077123,-183559,true,10679046716,22,10668373540,-10673176
1636077178,-183566,true,10671574372,22,10651318643,-20255729
1636077294,-183569,true,10668373540,22,10615167459,-53206081
1636077442,-183576,true,10660908665,22,10566452255,-94456410
1636077478,-183585,true,10651318643,22,10552725478,-98593165
1636077486,-183591,true,10644930088,22,10547450698,-97479390
1636077527,-183594,true,10641737247,22,10529536159,-112201088
1636077573,-183601,true,10634291010,22,10515857339,-118433671
1636077625,-183606,true,10628975459,22,10497996460,-130978999
1636077708,-183608,true,10626849983,22,10475974900,-150875083
1636077782,-183613,true,10621538152,22,10439374905,-182163247
1636077982,-183622,true,10611983545,22,10349985675,-261997870
1636078034,-183628,true,10605618583,22,10333439765,-272178818
1636078249,-183627,true,10606679145,22,10314857232,-291821913
1636078257,-183630,true,10603497777,22,10314857232,-288640545
1636078615,-183634,true,10599257438,22,10310732320,-288525118
1636078687,-183637,true,10596078297,22,10318983794,-277094503
1636078732,-183637,true,10596078297,22,10322079798,-273998499
1636078742,-183640,true,10592900109,22,10323112006,-269788103
1636078767,-183646,true,10586546593,22,10325176732,-261369861
1636078839,-183651,true,10581254907,22,10338607518,-242647389
1636078870,-183650,true,10582313033,22,10344812234,-237500799
1636078932,-183653,true,10579138974,22,10356197219,-222941755
1636078984,-183657,true,10574908376,22,10359304389,-215603987
1636079005,-183661,true,10570679470,22,10360340319,-210339151
1636079027,-183660,true,10571736538,22,10362412491,-209324047
1636079056,-183663,true,10568565651,22,10363448732,-205116919
1636079153,-183671,true,10560114602,22,10368631493,-191483109
1636079160,-183675,true,10555891612,22,10368631493,-187260119
1636079175,-183676,true,10554836128,22,10366558077,-188278051
1636079221,-183685,true,10545341524,22,10354126290,-191215234
1636079250,-183697,true,10532695335,22,10345846715,-186848620
1636079274,-183703,true,10526377930,22,10339641379,-186736551
1636079299,-183705,true,10524272970,22,10332406524,-191866446
1636079367,-183714,true,10514805858,22,10315888718,-198917140
1636079427,-183725,true,10503246509,22,10301457299,-201789210
1636079461,-183729,true,10499046260,22,10296308116,-202738144
1636079551,-183729,true,10499046260,22,10274709635,-224336625
1636079589,-183738,true,10489601841,22,10267520214,-222081627
1636079597,-183749,true,10478070199,22,10264440574,-213629625
1636079667,-183755,true,10471785557,22,10242908941,-228876616
1636079854,-183754,true,10472832736,22,10195902109,-276930627
1636079997,-183761,true,10465504684,22,10159264680,-306240004
1636080074,-183773,true,10452954238,22,10144037968,-308916270
1636080088,-183777,true,10448774101,22,10144037968,-304736133
1636080098,-183775,true,10450863961,22,10142009464,-308854497
1636080143,-183783,true,10442507030,22,10143023665,-299483365
1636080251,-183795,true,10429984163,22,10145052371,-284931792
1636080290,-183799,true,10425813212,22,10145052371,-280760841
1636080297,-183797,true,10427898479,22,10145052371,-282846108
1636080350,-183806,true,10418518062,22,10137953674,-280564388
1636080448,-183821,true,10402902780,22,10129846960,-273055820
1636080471,-183827,true,10396663222,22,10127821294,-268841928
1636080481,-183826,true,10397702888,22,10126808614,-270894274
1636080502,-183834,true,10389388468,22,10127821294,-261567174
1636080796,-183847,true,10375891713,22,10118710811,-257180902
1636080884,-183851,true,10371742393,22,10117699041,-254043352
1636080887,-183848,true,10374854227,22,10117699041,-257155186
1636080970,-183854,true,10368631493,22,10109608523,-259022970
1636081042,-183867,true,10355161703,22,10108597663,-246564040
1636081050,-183870,true,10352055775,22,10107586905,-244468870
1636081087,-183868,true,10354126290,22,10105565690,-248560600
1636081139,-183874,true,10347915988,22,10103544880,-244371108
1636081175,-183886,true,10335506556,22,10101524475,-233982081
1636081224,-183890,true,10331373387,22,10098494623,-232878764
1636081248,-183886,true,10335506556,22,10102534627,-232971929
1636081401,-183893,true,10328274595,22,10127821294,-200453301
1636081448,-183904,true,10316920306,22,10133899507,-183020799
1636081519,-183907,true,10313825849,22,10143023665,-170802184
1636081552,-183903,true,10317951998,22,10147081483,-170870515
1636081603,-183904,true,10316920306,22,10157233132,-159687174
1636081612,-183916,true,10304548046,22,10158248855,-146299191
1636081646,-183917,true,10303517694,22,10164345329,-139172365
1636081714,-183915,true,10305578500,22,10175531701,-130046799
1636081791,-183920,true,10300427257,22,10184693343,-115733914
1636081941,-183935,true,10284988969,22,10197941392,-87047577
1636082004,-183937,true,10282932280,22,10202021180,-80911100
1636082031,-183938,true,10281904090,22,10204061686,-77842404
1636082079,-183944,true,10275737106,22,10207123211,-68613895
1636082118,-183958,true,10261361857,22,10212227793,-49134064
1636082183,-183959,true,10260335824,22,10209164738,-51171086
1636082253,-183961,true,10258284065,22,10203041382,-55242683
1636082289,-183967,true,10252131248,22,10198961186,-53170062
1636082606,-183981,true,10237789023,22,10164345329,-73443694
1636082789,-183978,true,10240860667,22,10218356662,-22504005
1636082926,-183976,true,10242908941,22,10265467018,22558077
1636082974,-183981,true,10237789023,22,10281904090,44115067
1636083019,-183987,true,10231648499,22,10298367480,66718981
1636083078,-183984,true,10234718300,22,10320015692,85297392
1636083259,-183976,true,10242908941,22,10412269138,169360197
1636083298,-183978,true,10240860667,22,10432070264,191209597
1636083320,-183980,true,10238812802,22,10442507030,203694228
1636083503,-183976,true,10242908941,22,10525325397,282416456
1636083820,-183969,true,10250081129,22,10550615249,300534120
1636083843,-183969,true,10250081129,22,10552725478,302644349
1636083866,-183971,true,10248031420,22,10554836128,306804708
1636083883,-183968,true,10251106137,22,10554836128,303729991
1636083912,-183963,true,10256232715,22,10555891612,299658897
1636084048,-183964,true,10255207195,22,10544287095,289079900
1636084093,-183963,true,10256232715,22,10537962736,281730021
1636084163,-183959,true,10260335824,22,10528483310,268147486
1636084212,-183954,true,10265467018,22,10523220648,257753630
1636084248,-183955,true,10264440574,22,10521116319,256675745
1636084276,-183957,true,10262387994,22,10516908925,254520931
1636084323,-183955,true,10264440574,22,10506397798,241957224
1636084390,-183952,true,10267520214,22,10493798311,226278097
1636084430,-183954,true,10265467018,22,10486455590,220988572
1636084485,-183954,true,10265467018,22,10477022497,211555479
1636084495,-183953,true,10266493565,22,10474927407,208433842
1636084872,-183953,true,10266493565,22,10395623660,129130095
1636084889,-183955,true,10264440574,22,10400822511,136381937
1636085009,-183955,true,10264440574,22,10399782533,135341959
1636085306,-183952,true,10267520214,22,10432070264,164550050
1636085311,-183948,true,10271627838,22,10433113472,161485634
1636085319,-183949,true,10270600778,22,10434156783,163556005
1636085424,-183949,true,10270600778,22,10452954238,182353460
1636085651,-183942,true,10277792356,22,10530589112,252796756
1636085696,-183937,true,10282932280,22,10545341524,262409244
1636085763,-183935,true,10284988969,22,10568565651,283576682
1636085821,-183927,true,10293219841,22,10575965867,282746026
1636085837,-183920,true,10300427257,22,10578081166,277653909
1636085930,-183913,true,10307639719,22,10602437534,294797815
1636086038,-183911,true,10309701350,22,10624724932,315023582
1636086059,-183902,true,10318983794,22,10632164471,313180677
1636086082,-183896,true,10325176732,22,10635354439,310177707
1636086203,-183889,true,10332406524,22,10653449013,321042489
1636086221,-183888,true,10333439765,22,10656645367,323205602
1636086244,-183879,true,10342743582,22,10659842681,317099099
1636086259,-183870,true,10352055775,22,10663040953,310985178
1636086387,-183865,true,10357232838,22,10674776165,317543327
1636086722,-183864,true,10358268562,22,10690799542,332530980
1636086935,-183856,true,10366558077,22,10685455746,318897669
1636086958,-183848,true,10374854227,22,10681182632,306328405
1636087120,-183841,true,10382118804,22,10703635560,321516756
1636087216,-183838,true,10385233751,22,10714344014,329110263
1636087414,-183828,true,10395623660,22,10737940337,342316677
1636087518,-183819,true,10404983464,22,10749757979,344774515
1636087537,-183813,true,10411228015,22,10751908038,340680023
1636087577,-183809,true,10415393131,22,10761588627,346195496
1636087610,-183796,true,10428941269,22,10764817426,335876157
1636087701,-183787,true,10438331072,22,10775587089,337256017
1636087893,-183781,true,10444595636,22,10793920249,349324613
1636088098,-183778,true,10447729328,22,10793920249,346190921
1636088135,-183766,true,10460273501,22,10794999641,334726140
1636088171,-183758,true,10468644650,22,10789603761,320959111
1636088196,-183753,true,10473880019,22,10785288998,311408979
1636088249,-183751,true,10475974900,22,10784210577,308235677
1636088314,-183738,true,10489601841,22,10787446163,297844322
1636088477,-183727,true,10501146174,22,10792840965,291694791
1636088520,-183721,true,10507448437,22,10797158749,289710312
1636088653,-183718,true,10510600987,22,10807960768,297359781
1636088680,-183706,true,10523220648,22,10810122468,286901820
1636088709,-183693,true,10536909046,22,10811203481,274294435
1636088893,-183689,true,10541124441,22,10818773594,277649153
1636088927,-183690,true,10540070434,22,10819855471,279785037
1636089009,-183680,true,10550615249,22,10804719028,254103779
1636089425,-183671,true,10560114602,22,10754058527,193943925
1636089440,-183668,true,10563282953,22,10754058527,190775574
1636089461,-183670,true,10561170613,22,10750832955,189662342
1636089682,-183660,true,10571736538,22,10723990781,152254243
1636089809,-183651,true,10581254907,22,10711130353,129875446
1636089864,-183648,true,10584429601,22,10713272686,128843085
1636089888,-183649,true,10583371264,22,10716486989,133115725
1636089904,-183638,true,10595018795,22,10718630394,123611599
1636089938,-183628,true,10605618583,22,10719702257,114083674
1636090012,-183625,true,10608800587,22,10720774227,111973640
1636090074,-183625,true,10608800587,22,10722918489,114117902
1636090109,-183614,true,10620476104,22,10723990781,103514677
1636090166,-183604,true,10631101361,22,10725063180,93961819
1636090213,-183600,true,10635354439,22,10726135687,90781248
1636090294,-183600,true,10635354439,22,10730426784,95072345
1636090443,-183588,true,10648123886,22,10731499827,83375941
1636090491,-183582,true,10654514358,22,10732572977,78058619
1636090639,-183581,true,10655579809,22,10739014131,83434322
1636090662,-183581,true,10655579809,22,10740088032,84508223
1636090748,-183575,true,10661974756,22,10744384712,82409956
1636090872,-183570,true,10667306809,22,10749757979,82451170
1636090887,-183571,true,10666240185,22,10750832955,84592770
1636090979,-183573,true,10664107257,22,10752983229,88875972
1636091073,-183568,true,10669440377,22,10754058527,84618150
1636091163,-183563,true,10674776165,22,10755133933,80357768
1636091239,-183563,true,10674776165,22,10758360796,83584631
1636091300,-183564,true,10673708794,22,10758360796,84652002
1636091407,-183560,true,10677978918,22,10756209446,78230528
1636091532,-183554,true,10684387307,22,10751908038,67520731
1636091789,-183555,true,10683318975,22,10730426784,47107809
1636092046,-183557,true,10681182632,22,10675843642,-5338990
1636092087,-183553,true,10685455746,22,10666240185,-19215561
1636092294,-183549,true,10689730569,22,10621538152,-68192417
1636092332,-183552,true,10686524291,22,10614106048,-72418243
1636092465,-183554,true,10684387307,22,10588664008,-95723299
1636092531,-183549,true,10689730569,22,10579138974,-110591595
1636092536,-183544,true,10695076504,22,10578081166,-116995338
1636092769,-183546,true,10692937809,22,10542178554,-150759255
1636092953,-183548,true,10690799542,22,10528483310,-162316232
1636093274,-183542,true,10697215626,22,10544287095,-152928531
1636093687,-183536,true,10703635560,22,10574908376,-128727184
1636093724,-183536,true,10703635560,22,10573850991,-129784569
1636093796,-183539,true,10700425111,22,10569622508,-130802603
1636093948,-183536,true,10703635560,22,10548505443,-155130117
1636094126,-183536,true,10703635560,22,10517960615,-185674945
1636094349,-183540,true,10699355176,22,10483310282,-216044894
1636094451,-183542,true,10697215626,22,10467597890,-229617736
1636094568,-183539,true,10700425111,22,10449818979,-250606132
1636094598,-183543,true,10696146011,22,10446684660,-249461351
1636094726,-183547,true,10691868622,22,10448774101,-243094521
1636094736,-183549,true,10689730569,22,10448774101,-240956468
1636095103,-183549,true,10689730569,22,10439374905,-250355664
1636095324,-183552,true,10686524291,22,10433113472,-253410819
1636095328,-183557,true,10681182632,22,10433113472,-248069160
1636095358,-183561,true,10676911227,22,10434156783,-242754444
1636095450,-183562,true,10675843642,22,10422686094,-253157548
1636095880,-183568,true,10669440377,22,10381080696,-288359681
1636095958,-183572,true,10665173668,22,10374854227,-290319441
1636096122,-183576,true,10660908665,22,10354126290,-306782375
1636096410,-183576,true,10660908665,22,10342743582,-318165083
1636097138,-183581,true,10655579809,22,10370705323,-284874486
1636097222,-183586,true,10650253617,22,10386272275,-263981342
1636097444,-183588,true,10648123886,22,10420601869,-227522017
1636098073,-183584,true,10652383775,22,10580196888,-72186887
1636098129,-183586,true,10650253617,22,10587605248,-62648369
1636098180,-183591,true,10644930088,22,10593959399,-50970689
1636098221,-183593,true,10642801421,22,10598197619,-44603802
1636098277,-183592,true,10643865701,22,10602437534,-41428167
1636098304,-183594,true,10641737247,22,10604558127,-37179120
1636098659,-183600,true,10635354439,22,10592900109,-42454330
1636099342,-183603,true,10632164471,22,10564339281,-67825190
1636099760,-183603,true,10632164471,22,10553780750,-78383721
1636099884,-183605,true,10630038357,22,10546396058,-83642299
1636099896,-183611,true,10623662566,22,10547450698,-76211868
1636099933,-183614,true,10620476104,22,10544287095,-76189009
1636099951,-183614,true,10620476104,22,10545341524,-75134580
1636100011,-183613,true,10621538152,22,10549560293,-71977859
1636100067,-183617,true,10617290598,22,10554836128,-62454470
1636100130,-183617,true,10617290598,22,10567508900,-49781698
1636100175,-183617,true,10617290598,22,10573850991,-43439607
1636100250,-183616,true,10618352327,22,10597137905,-21214422
1636100290,-183620,true,10614106048,22,10609861467,-4244581
1636100321,-183618,true,10616228975,22,10622600305,6371330
1636100387,-183618,true,10616228975,22,10641737247,25508272
1636100810,-183618,true,10616228975,22,10768047195,151818220
1636101357,-183621,true,10613044744,22,10810122468,197077724
1636101801,-183619,true,10615167459,22,10823101752,207934293
1636102238,-183617,true,10617290598,22,10776664648,159374050
1636102459,-183615,true,10619414163,22,10784210577,164796414
1636102545,-183617,true,10617290598,22,10788524908,171234310
1636102776,-183613,true,10621538152,22,10840431709,218893557
1636102800,-183608,true,10626849983,22,10848022288,221172305
1636102863,-183604,true,10631101361,22,10883878098,252776737
1636103125,-183603,true,10632164471,22,10998755124,366590653
1636103501,-183597,true,10638545365,22,11095966411,457421046
1636103510,-183592,true,10643865701,22,11098185715,454320014
1636103591,-183588,true,10648123886,22,11109288896,461165010
1636103672,-183586,true,10650253617,22,11120403186,470149569
1636103711,-183580,true,10656645367,22,11123739640,467094273
1636103735,-183575,true,10661974756,22,11119291256,457316500
1636103928,-183571,true,10666240185,22,11115956136,449715951
1636103979,-183569,true,10668373540,22,11123739640,455366100
1636104048,-183561,true,10676911227,22,11146008267,469097040
1636104059,-183556,true,10682250750,22,11149352404,467101654
1636104168,-183545,true,10694007103,22,11187322817,493315714
1636104312,-183541,true,10698285347,22,11238900461,540615114
1636104577,-183534,true,10705776394,22,11322372617,616596223
1636104633,-183529,true,10711130353,22,11340502006,629371653
1636104802,-183518,true,10722918489,22,11397343660,674425171
1636104896,-183515,true,10726135687,22,11417876325,691740638
1636105135,-183506,true,10735793071,22,11424728764,688935693
1636105194,-183501,true,10741162041,22,11427013824,685851783
1636105295,-183488,true,10755133933,22,11451034565,695900632
1636105545,-183482,true,10761588627,22,11513034301,751445674
1636105595,-183471,true,10773432295,22,11534928764,761496469
1636105641,-183465,true,10779897971,22,11541851452,761953481
1636105762,-183454,true,10791761789,22,11545314354,753552565
1636105971,-183450,true,10796079141,22,11544159938,748080797
1636106083,-183438,true,10809041564,22,11544159938,735118374
1636106206,-183431,true,10816610164,22,11524552517,707942353
1636106210,-183418,true,10830680197,22,11523400177,692719980
1636106251,-183413,true,10836096620,22,11516488556,680391936
1636106358,-183400,true,10850192001,22,11500377558,650185557
1636106515,-183392,true,10858875193,22,11470516905,611641712
1636106849,-183379,true,10873000204,22,11495778557,622778353
1636106857,-183372,true,10880613588,22,11495778557,615164969
1636107045,-183359,true,10894766876,22,11487734730,592967854
1636107518,-183357,true,10896945938,22,11380261313,483315375
1636107767,-183347,true,10907847789,22,11324637204,416789415
1636107781,-183341,true,10914394134,22,11322372617,407978483
1636108222,-183329,true,10927498613,22,11305402637,377904024
1636108386,-183324,true,10932963455,22,11314450125,381486670
1636108850,-183313,true,10944995730,22,11262525768,317530038
1636108867,-183306,true,10952659525,22,11262525768,309866243
1636108931,-183296,true,10963617115,22,11252394561,288777446
1636109166,-183293,true,10966906529,22,11214203291,247296762
1636109299,-183282,true,10978976160,22,11190679349,211703189
1636109316,-183276,true,10985565193,22,11190679349,205114156
1636109497,-183265,true,10997655358,22,11182849006,185193648
1636109661,-183262,true,11000954985,22,11176141645,175186660
1636109970,-183251,true,11013062087,22,11163855262,150793175
1636110013,-183245,true,11019671577,22,11162738988,143067411
1636110122,-183235,true,11030696209,22,11158275008,127578799
1636110169,-183231,true,11035109149,22,11157159292,122050143
1636110213,-183218,true,11049463401,22,11157159292,107695891
1636110372,-183211,true,11057200347,22,11158275008,101074661
1636110376,-183200,true,11069369350,22,11158275008,88905658
1636110384,-183196,true,11073797762,22,11158275008,84477246
1636110652,-183183,true,11088202340,22,11167204753,79002413
1636110752,-183176,true,11095966411,22,11170555250,74588839
1636110762,-183166,true,11107067372,22,11171672305,64604933
1636110808,-183166,true,11107067372,22,11172789473,65722101
1636110989,-183158,true,11115956136,22,11181730833,65774697
1636111073,-183151,true,11123739640,22,11185085688,61346048
1636111141,-183142,true,11133755011,22,11186204196,52449185
1636111154,-183142,true,11133755011,22,11187322817,53567806
1636111191,-183134,true,11142665133,22,11182849006,40183873
1636111210,-183127,true,11150467339,22,11180612772,30145433
1636111369,-183117,true,11161622826,22,11182849006,21226180
1636111423,-183116,true,11162738988,22,11182849006,20110018
1636111562,-183107,true,11172789473,22,11183967291,11177818
1636111885,-183100,true,11180612772,22,11191798417,11185645
1636111910,-183089,true,11192917597,22,11192917597,0
1636112188,-183086,true,11196275808,22,11234406024,38130216
1636112276,-183078,true,11205235964,22,11256896194,51660230
1636112332,-183070,true,11214203291,22,11269284973,55081682
1636112390,-183061,true,11224300112,22,11282815555,58515443
1636112431,-183057,true,11228790506,22,11289586937,60796431
1636112564,-183052,true,11234406024,22,11311056469,76650445
1636112591,-183045,true,11242272468,22,11320108482,77836014
1636112648,-183038,true,11250144420,22,11334833456,84689036
1636112819,-183033,true,11255770617,22,11382537479,126766862
1636112920,-183026,true,11263652021,22,11399623242,135971221
1636113084,-183019,true,11271538943,22,11425871237,154332294
1636113200,-183012,true,11279431388,22,11429299341,149867953
1636113271,-183006,true,11286200739,22,11432728474,146527735
1636113277,-183000,true,11292974152,22,11432728474,139754322
1636113317,-182993,true,11300881606,22,11435015134,134133528
1636113401,-182987,true,11307663830,22,11439589826,131925996
1636113601,-182987,true,11307663830,22,11424728764,117064934
1636113838,-182985,true,11309925476,22,11399623242,89697766
1636113864,-182981,true,11314450125,22,11396204039,81753914
1636113894,-182978,true,11317844800,22,11396204039,78359239
1636113999,-182977,true,11318976584,22,11395064533,76087949
1636114103,-182972,true,11324637204,22,11391646697,67009493
1636114135,-182969,true,11328034935,22,11390507646,62472711
1636114254,-182966,true,11331433686,22,11389368709,57935023
1636114418,-182965,true,11332566829,22,11396204039,63637210
1636114449,-182961,true,11337100536,22,11398483394,61382858
1636114474,-182957,true,11341636056,22,11401903281,60267225
1636114621,-182956,true,11342770220,22,11419018113,76247893
1636114720,-182954,true,11345038887,22,11433871747,88832860
1636114975,-182957,true,11341636056,22,11454470219,112834163
1636115016,-182955,true,11343904497,22,11462490754,118586257
1636115046,-182952,true,11347308008,22,11465929845,118621837
1636115188,-182951,true,11348442739,22,11476253311,127810572
1636115207,-182953,true,11346173391,22,11477400936,131227545
1636115214,-182952,true,11347308008,22,11477400936,130092928
1636115235,-182951,true,11348442739,22,11479696531,131253792
1636115379,-182949,true,11350712541,22,11491181395,140468854
1636115468,-182953,true,11346173391,22,11494629094,148455703
1636115775,-182953,true,11346173391,22,11509581081,163407690
1636115870,-182955,true,11343904497,22,11515337022,171432525
1636115932,-182954,true,11345038887,22,11504978399,159939512
1636115994,-182956,true,11342770220,22,11501527596,158757376
1636116225,-182956,true,11342770220,22,11481992585,139222365
1636116292,-182956,true,11342770220,22,11485437527,142667307
1636116309,-182954,true,11345038887,22,11487734730,142695843
1636116398,-182956,true,11342770220,22,11479696531,136926311
1636116475,-182958,true,11340502006,22,11452179669,111677663
1636116571,-182962,true,11335966939,22,11420160015,84193076
1636116659,-182963,true,11334833456,22,11390507646,55674190
1636116782,-182968,true,11329167739,22,11350712541,21544802
1636117074,-182969,true,11328034935,22,11295232860,-32802075
1636117109,-182972,true,11324637204,22,11289586937,-35050267
1636117519,-182971,true,11325769668,22,11190679349,-135090319
1636117624,-182974,true,11322372617,22,11180612772,-141759845
1636117749,-182976,true,11320108482,22,11166088145,-154020337
1636117922,-182981,true,11314450125,22,11110399825,-204050300
1636117945,-182982,true,11313318793,22,11103735918,-209582875
1636118045,-182984,true,11311056469,22,11076012633,-235043836
1636118380,-182989,true,11305402637,22,11005356027,-300046610
1636118456,-182993,true,11300881606,22,10991059074,-309822532
1636118522,-182992,true,11302011694,22,10977878372,-324133322
1636119105,-182993,true,11300881606,22,10958136951,-342744655
1636119369,-182998,true,11295232860,22,10961424720,-333808140
1636119380,-183001,true,11291844968,22,10961424720,-330420248
1636119414,-183000,true,11292974152,22,10962520863,-330453289
1636119428,-183001,true,11291844968,22,10962520863,-329324105
1636119524,-183004,true,11288458092,22,10968003220,-320454872
1636119579,-183007,true,11285072231,22,10970196930,-314875301
1636119594,-183006,true,11286200739,22,10971293950,-314906789
1636119796,-183008,true,11283943837,22,10975683126,-308260711
1636119831,-183011,true,11280559331,22,10976780694,-303778637
1636119917,-183015,true,11276048235,22,10982270182,-293778053
1636119942,-183014,true,11277175840,22,10984466746,-292709094
1636119957,-183015,true,11276048235,22,10984466746,-291581489
1636120444,-183015,true,11276048235,22,11060517838,-215530397
1636120462,-183018,true,11272666097,22,11066049204,-206616893
1636120640,-183015,true,11276048235,22,11113733278,-162314957
1636120661,-183016,true,11274920743,22,11123739640,-151181103
1636120744,-183012,true,11279431388,22,11153812814,-125618574
1636120871,-183014,true,11277175840,22,11192917597,-84258243
1636121013,-183011,true,11280559331,22,11211960787,-68598544
1636121058,-183012,true,11279431388,22,11217567889,-61863499
1636121197,-183008,true,11283943837,22,11235529465,-48414372
1636121320,-183011,true,11280559331,22,11252394561,-28164770
1636121479,-183009,true,11282815555,22,11259147686,-23667869
1636121565,-183007,true,11285072231,22,11286200739,1128508
1636121695,-183003,true,11289586937,22,11288458092,-1128845
1636121812,-183005,true,11287329359,22,11295232860,7903501
1636121861,-183003,true,11289586937,22,11299751631,10164694
1636121926,-183004,true,11288458092,22,11313318793,24860701
1636121932,-183002,true,11290715896,22,11315581570,24865674
1636121978,-183002,true,11290715896,22,11332566829,41850933
1636122079,-183000,true,11292974152,22,11355253507,62279355
1636122213,-183001,true,11291844968,22,11381399339,89554371
1636122227,-182999,true,11294103450,22,11384814101,90710651
1636122244,-183001,true,11291844968,22,11387091177,95246209
1636122470,-183000,true,11292974152,22,11403043471,110069319
1636122605,-183002,true,11290715896,22,11421302031,130586135
1636122812,-183001,true,11291844968,22,11429299341,137454373
1636122880,-183002,true,11290715896,22,11420160015,129444119
1636122963,-183002,true,11290715896,22,11416734652,126018756
1636123011,-183003,true,11289586937,22,11425871237,136284300
1636123210,-183001,true,11291844968,22,11419018113,127173145
1636123311,-183002,true,11290715896,22,11415593093,124877197
1636123517,-183000,true,11292974152,22,11409887008,116912856
1636123583,-183002,true,11290715896,22,11411027997,120312101
1636123664,-182999,true,11294103450,22,11414451648,120348198
1636123775,-182999,true,11294103450,22,11437302251,143198801
1636123801,-182995,true,11298621769,22,11445310765,146688996
1636123823,-182996,true,11297492020,22,11454470219,156978199
1636123962,-182986,true,11308794597,22,11530315946,221521349
1636124033,-182979,true,11316713128,22,11574212302,257499174
1636124101,-182975,true,11321240493,22,11614790987,293550494
1636124143,-182975,true,11321240493,22,11643862836,322622343
1636124160,-182964,true,11333700086,22,11654346505,320646419
1636124207,-182958,true,11340502006,22,11689360289,348858283
1636124218,-182953,true,11346173391,22,11697545296,351371905
1636124235,-182952,true,11347308008,22,11713932508,366624500
1636124258,-182939,true,11362068363,22,11735035519,372967156
1636124408,-182930,true,11372298316,22,11869573607,497275291
1636124428,-182926,true,11376847918,22,11883824932,506977014
1636124444,-182925,true,11377985602,22,11895714106,517728504
1636124486,-182911,true,11393925140,22,11933839453,539914313
1636124554,-182900,true,11406464726,22,12008055378,601590652
1636124654,-182890,true,11417876325,22,12119033656,701157331
1636124697,-182888,true,11420160015,22,12165171283,745011268
1636124770,-182872,true,11438445982,22,12227369017,788923035
1636124789,-182859,true,11453324887,22,12242049932,788725045
1636124873,-182847,true,11467076438,22,12313256561,846180123
1636124970,-182841,true,11473958404,22,12412152726,938194322
1636125027,-182820,true,11498077828,22,12474365782,976287954
1636125130,-182809,true,11510732039,22,12539398170,1028666131
1636125232,-182798,true,11523400177,22,12585877554,1062477377
1636125285,-182794,true,11528010229,22,12613595577,1085585348
1636125323,-182773,true,11552243274,22,12636319358,1084076084
1636125395,-182756,true,11571897807,22,12683157996,1111260189
1636125397,-182743,true,11586950303,22,12684426312,1097476009
1636125493,-182732,true,11599702323,22,12739084042,1139381719
1636125506,-182711,true,11624086073,22,12744180440,1120094367
1636125548,-182690,true,11648521080,22,12764586429,1116065349
1636125572,-182674,true,11667172698,22,12781190351,1114017653
1636125609,-182662,true,11681181008,22,12799095653,1117914645
1636125667,0,false,0,0,12837548668,12837548668
1636125671,0,false,0,0,12840116306,12840116306
1636125679,0,false,0,0,12843968726,12843968726
1636125781,0,false,0,0,12878692562,12878692562
1636125811,-182556,true,11805653844,22,12885133196,1079479352
1636125839,-182531,true,11835203423,22,12895444911,1060241488
1636125914,-182516,true,11852968660,22,12892866209,1039897549
1636126020,-182510,true,11860082220,22,12895444911,1035362691
1636126034,-182485,true,11889768033,22,12896734456,1006966423
1636126067,-182462,true,11917144602,22,12904474431,987329829
1636126268,-182448,true,11933839453,22,12921260317,987420864
1636126575,-182442,true,11941001547,22,12795256692,854255145
1636126712,-182419,true,11968496082,22,12742906149,774410067
1636126810,-182395,true,11997253530,22,12735263081,738009551
1636126918,-182380,true,12015262013,22,12772247096,756985083
1636126926,-182371,true,12026080075,22,12774801673,748721598
1636126992,-182343,true,12059798598,22,12792698025,732899427
1636126997,-182318,true,12089984301,22,12793977295,703992994
1636127071,-182305,true,12105710715,22,12804216059,698505344
1636127142,-182297,true,12115398673,22,12814463018,699064345
1636127274,-182275,true,12142080556,22,12840116306,698035750
1636127326,-182251,true,12171255086,22,12851677034,680421948
1636127397,-182239,true,12185868628,22,12867107532,681238904
1636127414,-182232,true,12194401295,22,12870968050,676566755
1636127555,-182213,true,12217591522,22,12905764879,688173357
1636127568,-182190,true,12245722914,22,12910927959,665205045
1636127582,-182178,true,12260425867,22,12912219052,651793185
1636127642,-182170,true,12270237641,22,12922552443,652314802
1636127669,-182150,true,12294801444,22,12923844698,629043254
1636127771,-182129,true,12320646362,22,12900603863,579957501
1636127876,-182118,true,12334205852,22,12872255147,538049295
1636127894,-182114,true,12339140274,22,12867107532,527967258
1636127916,-182095,true,12362605753,22,12865820950,503215197
1636128002,-182074,true,12388593203,22,12861961975,473368772
1636128097,-182063,true,12402227471,22,12861961975,459734504
1636128194,-182058,true,12408429825,22,12846537649,438107824
1636128196,-182040,true,12430783994,22,12846537649,415753655
1636128257,-182024,true,12450688172,22,12822153618,371465446
1636128353,-182022,true,12453178434,22,12762033894,308855460
1636128602,-182020,true,12455669194,22,12643903045,188233851
1636128609,-182002,true,12478108466,22,12642638781,164530315
1636128685,-181985,true,12499338229,22,12621165627,121827398
1636128777,-181981,true,12504338715,22,12593430968,89092253
1636128867,-181977,true,12509341200,22,12575813381,66472181
1636129081,-181962,true,12528118353,22,12463144464,-64973889
1636129208,-181947,true,12546923690,22,12445709141,-101214549
1636129271,-181943,true,12551943213,22,12443220373,-108722840
1636129312,-181942,true,12553198407,22,12437000629,-116197778
1636129319,-181927,true,12572041391,22,12435757053,-136284338
1636129407,-181909,true,12594690311,22,12433270275,-161420036
1636129441,-181906,true,12598469096,22,12427055504,-171413592
1636129470,-181905,true,12599728943,22,12418360044,-181368899
1636129552,-181892,true,12616118422,22,12389832062,-226286360
1636129623,-181880,true,12631266094,22,12368788292,-262477802
1636129740,-181876,true,12636319358,22,12345311078,-291008280
1636129814,-181876,true,12636319358,22,12342842386,-293476972
1636129839,-181870,true,12643903045,22,12345311078,-298591967
1636129970,-181859,true,12657818295,22,12379924655,-277893640
1636130056,-181854,true,12664148470,22,12404708040,-259440430
1636130351,-181851,true,12667948094,22,12505589148,-162358946
1636130400,-181844,true,12676818319,22,12543160366,-133657953
1636130448,-181833,true,12690769793,22,12569527360,-121242433
1636130596,-181830,true,12694577405,22,12624952355,-69625050
1636130835,-181829,true,12695846863,22,12669214889,-26631974
1636130924,-181826,true,12699655998,22,12674283335,-25372663
1636130951,-181817,true,12711090261,22,12674283335,-36806926
1636131108,-181814,true,12714903969,22,12666681426,-48222543
1636131195,-181814,true,12714903969,22,12647696596,-67207373
1636131204,-181812,true,12717447077,22,12646431952,-71015125
1636131216,-181806,true,12725079454,22,12643903045,-81176409
1636131445,-181809,true,12721262693,22,12609812255,-111450438
1636131507,-181812,true,12717447077,22,12593430968,-124016109
1636131598,-181813,true,12716175460,22,12572041391,-144134069
1636131787,-181811,true,12718718822,22,12523108358,-195610464
1636131797,-181818,true,12709819279,22,12520604112,-189215167
1636131800,-181824,true,12702196056,22,12519352177,-182843879
1636131930,-181826,true,12699655998,22,12498088420,-201567578
1636132059,-181821,true,12706007096,22,12485597203,-220409893
1636132442,-181826,true,12699655998,22,12498088420,-201567578
1636132610,-181830,true,12694577405,22,12523108358,-171469047
1636132819,-181829,true,12695846863,22,12578328669,-117518194
1636133080,-181825,true,12700925963,22,12599728943,-101197020
1636133134,-181830,true,12694577405,22,12607290671,-87286734
1636133278,-181837,true,12685694754,22,12631266094,-54428660
1636133370,-181838,true,12684426312,22,12646431952,-37994360
1636133540,-181835,true,12688232020,22,12670481811,-17750209
1636133555,-181841,true,12680621745,22,12671748859,-8872886
1636133570,-181848,true,12671748859,22,12676818319,5069460
1636133661,-181852,true,12666681426,22,12683157996,16476570
1636133732,-181849,true,12670481811,22,12688232020,17750209
1636133785,-181856,true,12661616020,22,12693308074,31692054
1636133876,-181863,true,12652756433,22,12699655998,46899565
1636133940,-181865,true,12650226261,22,12704736622,54510361
1636134005,-181864,true,12651491284,22,12712361370,60870086
1636134094,-181870,true,12643903045,22,12689500843,45597798
1636134314,-181874,true,12638846748,22,12633792473,-5054275
1636134430,-181876,true,12636319358,22,12603509240,-32810118
1636134499,-181874,true,12638846748,22,12587136141,-51710607
1636134689,-181878,true,12633792473,22,12548178383,-85614090
1636135012,-181880,true,12631266094,22,12530624102,-100641992
1636135276,-181882,true,12628740219,22,12554453727,-74286492
1636135324,-181880,true,12631266094,22,12558220440,-73045654
1636135393,-181886,true,12623689986,22,12555709172,-67980814
1636135479,-181891,true,12617380034,22,12556964743,-60415291
1636136088,-181894,true,12613595577,22,12635055852,21460275
1636136215,-181894,true,12613595577,22,12648961365,35365788
1636136388,-181898,true,12608551400,22,12647696596,39145196
1636136404,-181902,true,12603509240,22,12647696596,44187356
1636136957,-181905,true,12599728943,22,12580844461,-18884482
1636137080,-181905,true,12599728943,22,12567013832,-32715111
1636137221,-181908,true,12595949780,22,12585877554,-10072226
1636137295,-181912,true,12590912660,22,12592171751,1259091
1636137326,-181914,true,12588394855,22,12595949780,7554925
1636137559,-181913,true,12589653694,22,12630003093,40349399
1636137737,-181916,true,12585877554,22,12656552640,70675086
1636138064,-181919,true,12582102545,22,12699655998,117553453
1636138291,-181921,true,12579586502,22,12719990694,140404192
1636138298,-181917,true,12584619092,22,12719990694,135371602
1636138389,-181919,true,12582102545,22,12727624597,145522052
1636138416,-181920,true,12580844461,22,12730170249,149325788
1636138579,-181921,true,12579586502,22,12745454858,165868356
1636138659,-181918,true,12583360756,22,12748004076,164643320
1636138669,-181922,true,12578328669,22,12748004076,169675407
1636138825,-181923,true,12577070962,22,12755654791,178583829
1636138905,-181924,true,12575813381,22,12760757819,184944438
1636139208,-181917,true,12584619092,22,12768416188,183797096
1636139291,-181914,true,12588394855,22,12769693029,181298174
1636139315,-181911,true,12592171751,22,12768416188,176244437
1636139410,-181912,true,12590912660,22,12769693029,178780369
1636139832,-181905,true,12599728943,22,12788860983,189132040
1636139962,-181903,true,12602249015,22,12792698025,190449010
1636140125,-181902,true,12603509240,22,12820871531,217362291
1636140215,-181898,true,12608551400,22,12852962202,244410802
1636140240,-181887,true,12622427743,22,12860675908,238248165
1636140363,-181881,true,12630003093,22,12898024129,268021036
1636140396,-181876,true,12636319358,22,12907055455,270736097
1636140510,-181871,true,12642638781,22,12949716958,307078177
1636140824,-181860,true,12656552640,22,13079857237,423304597
1636140888,-181853,true,12665414885,22,13109974024,444559139
1636140910,-181846,true,12674283335,22,13121777722,447494387
1636140967,-181838,true,12684426312,22,13150675964,466249652
1636141021,-181820,true,12707277697,22,13179637850,472360153
1636141130,-181811,true,12718718822,22,13236429467,517710645
1636141198,-181804,true,12727624597,22,13286821063,559196466
1636141270,-181794,true,12740357950,22,13349412968,609055018
1636141291,-181777,true,12762033894,22,13369451111,607417217
1636141378,-181769,true,12772247096,22,13416323825,644076729
1636141439,-181766,true,12776079153,22,13453940290,677861137
1636141524,-181759,true,12785025092,22,13502459331,717434239
1636141567,-181743,true,12805496481,22,13529489920,723993439
1636141617,-181736,true,12814463018,22,13549798367,735335349
1636141639,-181732,true,12819589572,22,13561998064,742408492
1636141682,-181724,true,12829848834,22,13586430422,756581588
1636141711,-181710,true,12847822302,22,13598663101,750840799
1636141731,-181701,true,12859389969,22,13609545840,750155871
1636141761,-181696,true,12865820950,22,13621799332,755978382
1636141763,-181688,true,12876117210,22,13623161512,747044302
1636141834,-181672,true,12896734456,22,13649068828,752334372
1636141903,-181661,true,12910927959,22,13675025412,764097453
1636141907,-181655,true,12918676453,22,13676392914,757716461
1636141994,-181645,true,12931600944,22,13705142078,773541134
1636142053,-181627,true,12954897622,22,13717481641,762584019
1636142217,-181614,true,12971749097,22,13711996019,740246922
1636142301,-181609,true,12978236269,22,13706512592,728276323
1636142532,-181603,true,12986025158,22,13685969262,699944104
1636142767,-181588,true,13005517837,22,13620437288,614919451
1636142838,-181580,true,13015925893,22,13585071914,569146021
1636142886,-181576,true,13021133045,22,13566067070,544934025
1636142913,-181573,true,13025039775,22,13555219099,530179324
1636142991,-181559,true,13043286688,22,13528137106,484850418
1636143023,-181550,true,13055030343,22,13518671197,463640854
1636143035,-181547,true,13058947244,22,13514616406,455669162
1636143056,-181544,true,13062865320,22,13510562832,447697512
1636143073,-181531,true,13079857237,22,13506510474,426653237
1636143153,-181520,true,13094252277,22,13501109220,406856943
1636143165,-181517,true,13098180945,22,13503809577,405628632
1636143171,-181513,true,13103421003,22,13506510474,403089471
1636143302,-181498,true,13123089899,22,13532195953,409106054
1636143559,-181483,true,13142788319,22,13632700586,489912267
1636143589,-181478,true,13149361028,22,13647704057,498343029
1636143685,-181473,true,13155937024,22,13701031357,545094333
1636143702,-181457,true,13177002317,22,13711996019,534993702
1636143759,-181439,true,13200741093,22,13743568326,542827233
1636143906,-181430,true,13212626513,22,13827656095,615029582
1636143954,-181423,true,13221878127,22,13853952301,632074174
1636143961,-181407,true,13243049006,22,13856723230,613674224
1636143999,-181388,true,13268233457,22,13873360446,605126989
1636144075,-181380,true,13278851760,22,13901133542,622281782
1636144106,-181374,true,13286821063,22,13906694830,619873767
1636144113,-181357,true,13309426738,22,13909476308,600049570
1636144215,-181337,true,13336070895,22,13952660426,616589531
1636144252,-181326,true,13350747910,22,13972206853,621458943
1636144254,-181321,true,13357424619,22,13973604073,616179454
1636144258,-181305,true,13378812535,22,13975001434,596188899
1636144297,-181280,true,13412299733,22,13993179840,580880107
1636144313,-181270,true,13425718070,22,14001577847,575859777
1636144366,-181263,true,13435118893,22,14026802121,591683228
1636144458,-181249,true,13453940290,22,14052071837,598131547
1636144505,-181228,true,13482221836,22,14052071837,569850001
1636144509,-181219,true,13494360690,22,14053477045,559116355
1636144514,-181216,true,13498409403,22,14053477045,555067642
1636144579,-181206,true,13511913888,22,14059099279,547185391
1636144643,-181183,true,13543025499,22,14067536847,524511348
1636144708,-181173,true,13556574621,22,14081610716,525036095
1636144743,-181169,true,13561998064,22,14095698665,533700601
1636144870,-181154,true,13582355308,22,14153606765,571251457
1636144903,-181129,true,13616351974,22,14169183519,552831545
1636144942,-181118,true,13631337453,22,14187614514,556277061
1636144970,-181114,true,13636790805,22,14201808515,565017710
1636144995,-181098,true,13658626043,22,14216016716,557390673
1636145052,-181072,true,13694182896,22,14241627308,547444412
1636145066,-181060,true,13710624957,22,14248749546,538124589
1636145205,-181056,true,13716110030,22,14278701861,562591831
1636145208,-181041,true,13736698603,22,14280129731,543431128
1636145399,-181018,true,13768327788,22,14323032297,554704509
1636145409,-181006,true,13784858871,22,14327329637,542470766
1636145451,-181005,true,13786237357,22,14343097582,556860225
1636145624,-180990,true,13806931195,22,14390505613,583574418
1636145643,-180967,true,13838722093,22,14389066707,550344614
1636145653,-180956,true,13853952301,22,14387627944,533675643
1636145669,-180955,true,13855337696,22,14387627944,532290248
1636145689,-180941,true,13874747782,22,14389066707,514318925
1636145724,-180922,true,13901133542,22,14386189325,485055783
1636145743,-180912,true,13915040933,22,14387627944,472587011
1636145762,-180911,true,13916432437,22,14389066707,472634270
1636145796,-180898,true,13934534658,22,14391944664,457410006
1636145877,-180878,true,13962430219,22,14397702305,435272086
1636145899,-180869,true,13975001434,22,14399142076,424140642
1636145927,-180868,true,13976398934,22,14404902596,428503662
1636145989,-180858,true,13990381624,22,14422197990,431816366
1636146013,-180838,true,14018388985,22,14429410531,411021546
1636146093,-180830,true,14029607622,22,14452514912,422907290
1636146105,-180833,true,14025399581,22,14455405559,430005978
1636146145,-180825,true,14036623829,22,14472761590,436137761
1636146161,-180808,true,14060505189,22,14479999418,419494229
1636146239,-180804,true,14066130234,22,14491587472,425457238
1636146261,-180805,true,14064723762,22,14495935383,431211621
1636146289,-180800,true,14071757530,22,14494485935,422728405
1636146319,-180784,true,14094289237,22,14493036631,398747394
1636146335,-180783,true,14095698665,22,14487240866,391542201
1636146350,-180788,true,14088652930,22,14482895562,394242632
1636146369,-180783,true,14095698665,22,14477103852,381405187
1636146416,-180771,true,14112622810,22,14462634708,350011898
1636146477,-180770,true,14114034072,22,14443846437,329812365
1636146637,-180771,true,14112622810,22,14409224499,296601689
1636146695,-180768,true,14116857020,22,14389066707,272209687
1636146726,-180756,true,14133806569,22,14376123019,242316450
1636146745,-180755,true,14135219950,22,14364627295,229407345
1636146785,-180760,true,14128154459,22,14345966344,217811885
1636146867,-180759,true,14129567275,22,14288699951,159132676
1636146897,-180747,true,14146532084,22,14267284038,120751954
1636146975,-180744,true,14150776468,22,14210331730,59555262
1636147099,-180748,true,14145117572,22,14111211689,-33905883
1636147236,-180747,true,14146532084,22,14046452414,-100079670
1636147338,-180733,true,14166350108,22,14021192803,-145157305
1636147446,-180731,true,14169183519,22,13988982725,-180200794
1636147517,-180733,true,14166350108,22,13965222844,-201127264
1636147578,-180733,true,14166350108,22,13940109308,-226240800
1636147588,-180720,true,14184777417,22,13937321704,-247455713
1636147645,-180718,true,14187614514,22,13928962237,-258652277
1636147670,-180721,true,14183359081,22,13923392045,-259967036
1636147694,-180721,true,14183359081,22,13916432437,-266926644
1636147761,-180712,true,14196129211,22,13895574479,-300554732
1636147800,-180712,true,14196129211,22,13881686544,-314442667
1636147806,-180716,true,14190452179,22,13880298514,-310153665
1636147860,-180718,true,14187614514,22,13863652977,-323961537
1636148082,-180707,true,14203228695,22,13895574479,-307654216
1636148164,-180706,true,14204649018,22,13910867255,-293781763
1636148257,-180710,true,14198968579,22,13928962237,-270006342
1636148360,-180713,true,14194709740,22,13948475465,-246234275
1636148385,-180703,true,14208910839,22,13954055692,-254855147
1636148448,-180703,true,14208910839,22,13969412830,-239498009
1636148623,-180707,true,14203228695,22,14018388985,-184839710
1636148676,-180708,true,14201808515,22,14042239320,-159569195
1636148714,-180698,true,14216016716,22,14061911239,-154105477
1636148773,-180697,true,14217438317,22,14097108235,-120330082
1636148844,-180696,true,14218860061,22,14119680533,-99179528
1636148855,-180697,true,14217438317,22,14125329252,-92109065
1636148910,-180689,true,14228816250,22,14139460940,-89355310
1636148937,-180692,true,14224548458,22,14146532084,-78016374
1636148966,-180693,true,14223126146,22,14153606765,-69519381
1636149042,-180694,true,14221703975,22,14172017498,-49686477
1636149070,-180691,true,14225970913,22,14180522834,-45448079
1636149111,-180692,true,14224548458,22,14190452179,-34096279
1636149218,-180695,true,14220281947,22,14214595256,-5686691
1636149267,-180693,true,14223126146,22,14225970913,2844767
1636149324,-180687,true,14231662155,22,14237355674,5693519
1636149332,-180688,true,14230239131,22,14235932081,5692950
1636149354,-180691,true,14225970913,22,14230239131,4268218
1636149365,-180689,true,14228816250,22,14228816250,0
1636149446,-180691,true,14225970913,22,14203228695,-22742218
1636149456,-180695,true,14220281947,22,14200388476,-19893471
1636149475,-180698,true,14216016716,22,14196129211,-19887505
1636149741,-180701,true,14211752763,22,14090061795,-121690968
1636149829,-180705,true,14206069483,22,14052071837,-153997646
1636149905,-180711,true,14197548824,22,14021192803,-176356021
1636149908,-180714,true,14193290411,22,14019790824,-173499587
1636149994,-180717,true,14189033275,22,13990381624,-198651651
1636150088,-180721,true,14183359081,22,13972206853,-211152228
1636150201,-180728,true,14173434699,22,13927569480,-245865219
1636150336,-180732,true,14167766743,22,13920607784,-247158959
1636150340,-180735,true,14163517263,22,13920607784,-242909479
1636150497,-180737,true,14160684984,22,13916432437,-244252547
1636150514,-180744,true,14150776468,22,13917824080,-232952388
1636150685,-180745,true,14149361532,22,13919215863,-230145669
1636150762,-180749,true,14143703202,22,13910867255,-232835947
1636150843,-180752,true,14139460940,22,13899743568,-239717372
1636151053,-180759,true,14129567275,22,13862266750,-267300525
1636151056,-180762,true,14125329252,22,13862266750,-263062502
1636151088,-180766,true,14119680533,22,13867812489,-251868044
1636151130,-180768,true,14116857020,22,13876135257,-240721763
1636151199,-180772,true,14111211689,22,13883074712,-228136977
1636151275,-180776,true,14105568615,22,13891406640,-214161975
1636151424,-180780,true,14099927798,22,13913649568,-186278230
1636151463,-180784,true,14094289237,22,13912258342,-182030895
1636151505,-180789,true,14087244206,22,13910867255,-176376951
1636151514,-180794,true,14080202696,22,13909476308,-170726388
1636151662,-180803,true,14067536847,22,13917824080,-149712767
1636151703,-180810,true,14057693509,22,13923392045,-134301464
1636151792,-180814,true,14052071837,22,13941503319,-110568518
1636151834,-180819,true,14045047909,22,13948475465,-96572444
1636151856,-180826,true,14035220307,22,13954055692,-81164615
1636152009,-180829,true,14031010583,22,14001577847,-29432736
1636152100,-180828,true,14032413684,22,14012783031,-19630653
1636152123,-180832,true,14026802121,22,14015585727,-11216394
1636152154,-180835,true,14022594922,22,14028204801,5609879
1636152348,-180834,true,14023997181,22,14099927798,75930617
1636152352,-180827,true,14033816925,22,14101337791,67520866
1636152371,-180827,true,14033816925,22,14111211689,77394764
1636152477,-180830,true,14029607622,22,14142288973,112681351
1636152558,-180830,true,14029607622,22,14164933614,135325992
1636152669,-180822,true,14040835237,22,14208910839,168075602
1636152693,-180824,true,14038027491,22,14217438317,179410826
1636152767,-180827,true,14033816925,22,14235932081,202115156
1636152791,-180825,true,14036623829,22,14238779410,202155581
1636152855,-180818,true,14046452414,22,14243051471,196599057
1636152862,-180820,true,14043643544,22,14243051471,199407927
1636152929,-180822,true,14040835237,22,14243051471,202216234
1636152983,-180821,true,14042239320,22,14247324813,205085493
1636153047,-180816,true,14049261845,22,14245900223,196638378
1636153114,-180815,true,14050666771,22,14231662155,180995384
1636153176,-180816,true,14049261845,22,14217438317,168176472
1636153197,-180813,true,14053477045,22,14214595256,161118211
1636153226,-180807,true,14061911239,22,14208910839,146999600
1636153240,-180806,true,14063317430,22,14206069483,142752053
1636153269,-180804,true,14066130234,22,14204649018,138518784
1636153658,-180800,true,14071757530,22,14221703975,149946445
1636153823,-180794,true,14080202696,22,14230239131,150036435
1636153825,-180793,true,14081610716,22,14230239131,148628415
1636153853,-180791,true,14084427179,22,14238779410,154352231
1636153944,-180784,true,14094289237,22,14270137638,175848401
1636154050,-180773,true,14109800709,22,14308717139,198916430
1636154075,-180771,true,14112622810,22,14318736247,206113437
1636154303,-180770,true,14114034072,22,14370374008,256339936
1636154305,-180768,true,14116857020,22,14371811045,254954025
1636154424,-180758,true,14130980232,22,14396262679,265282447
1636154537,-180757,true,14132393330,22,14420755914,288362584
1636154709,-180760,true,14128154459,22,14406343087,278188628
1636154938,-180760,true,14128154459,22,14335928184,207773725
1636154968,-180751,true,14140874886,22,14331628265,190753379
1636155048,-180754,true,14136633472,22,14304425383,167791911
1636155090,-180758,true,14130980232,22,14290128821,159148589
1636155332,-180760,true,14128154459,22,14198968579,70814120
1636155367,-180754,true,14136633472,22,14187614514,50981042
1636155590,-180760,true,14128154459,22,14140874886,12720427
1636155632,-180765,true,14121092501,22,14135219950,14127449
1636155654,-180768,true,14116857020,22,14133806569,16949549
1636155929,-180761,true,14126741785,22,14102747924,-23993861
1636156025,-180767,true,14118268706,22,14092879949,-25388757
1636156069,-180772,true,14111211689,22,14091470801,-19740888
1636156127,-180775,true,14106979172,22,14078794817,-28184355
1636156157,-180769,true,14115445476,22,14073164706,-42280770
1636156162,-180775,true,14106979172,22,14073164706,-33814466
1636156174,-180781,true,14098517946,22,14071757530,-26760416
1636156517,-180786,true,14091470801,22,13995978616,-95492185
1636156524,-180780,true,14099927798,22,13994579158,-105348640
1636156597,-180783,true,14095698665,22,13984786870,-110911795
1636156718,-180786,true,14091470801,22,13969412830,-122057971
1636156775,-180783,true,14095698665,22,13956846643,-138852022
1636156782,-180776,true,14105568615,22,13954055692,-151512923
1636156837,-180780,true,14099927798,22,13945686188,-154241610
1636156933,-180785,true,14092879949,22,13934534658,-158345291
1636156948,-180782,true,14097108235,22,13933141344,-163966891
1636157060,-180775,true,14106979172,22,13934534658,-172444514
1636157081,-180779,true,14101337791,22,13933141344,-168196447
1636157277,-180784,true,14094289237,22,13948475465,-145813772
1636157377,-180785,true,14092879949,22,13910867255,-182012694
1636157544,-180782,true,14097108235,22,13837338359,-259769876
1636157562,-180786,true,14091470801,22,13829038861,-262431940
1636157569,-180796,true,14077387078,22,13826273468,-251113610
1636157602,-180795,true,14078794817,22,13813836041,-264958776
1636157632,-180791,true,14084427179,22,13802789944,-281637235
1636157853,-180796,true,14077387078,22,13718853389,-358533689
1636157884,-180806,true,14063317430,22,13703771701,-359545729
1636157890,-180805,true,14064723762,22,13701031357,-363692405
1636157928,-180800,true,14071757530,22,13684600802,-387156728
1636158013,-180803,true,14067536847,22,13651798778,-415738069
1636158063,-180814,true,14052071837,22,13627248869,-424822968
1636158074,-180814,true,14052071837,22,13623161512,-428910325
1636158136,-180813,true,14053477045,22,13600022968,-453454077
1636158169,-180816,true,14049261845,22,13589147844,-460114001
1636158271,-180827,true,14033816925,22,13591865809,-441951116
1636158283,-180826,true,14035220307,22,13591865809,-443354498
1636158287,-180825,true,14036623829,22,13593224996,-443398833
1636158309,-180828,true,14032413684,22,13594584318,-437829366
1636158313,-180836,true,14021192803,22,13594584318,-426608485
1636158567,-180838,true,14018388985,22,13579639244,-438749741
1636158594,-180838,true,14018388985,22,13576923723,-441465262
1636158712,-180842,true,14012783031,22,13563354264,-449428767
1636158773,-180852,true,13998777952,22,13547088813,-451689139
1636158880,-180861,true,13986185349,22,13515967868,-470217481
1636159012,-180863,true,13983388531,22,13476830295,-506558236
1636159014,-180869,true,13975001434,22,13476830295,-498171139
1636159021,-180880,true,13959638152,22,13474135333,-485502819
1636159119,-180893,true,13941503319,22,13429746188,-511757131
1636159294,-180898,true,13934534658,22,13368114299,-566420359
1636159323,-180904,true,13926176863,22,13364104667,-562072196
1636159444,-180913,true,13913649568,22,13333404080,-580245488
1636159493,-180922,true,13901133542,22,13328072052,-573061490
1636159649,-180926,true,13895574479,22,13329404859,-566169620
1636159660,-180932,true,13887240051,22,13329404859,-557835192
1636159917,-180938,true,13878910623,22,13398894807,-480015816
1636160059,-180949,true,13863652977,22,13420349125,-443303852
1636160112,-180951,true,13860880662,22,13425718070,-435162592
1636160195,-180957,true,13852567044,22,13436462404,-416104640
1636160210,-180965,true,13841489976,22,13436462404,-405027572
1636160279,-180975,true,13827656095,22,13441837796,-385818299
1636160323,-180977,true,13824890979,22,13441837796,-383053183
1636160335,-180984,true,13815217425,22,13443181979,-372035446
1636160345,-180992,true,13804170223,22,13443181979,-360988244
1636160501,-181005,true,13786237357,22,13409617676,-376619681
1636160585,-181007,true,13783480523,22,13386841829,-396638694
1636160669,-181015,true,13772458699,22,13344074538,-428384161
1636160699,-181025,true,13758693812,22,13328072052,-430621760
1636160726,-181041,true,13736698603,22,13316082782,-420615821
1636160938,-181048,true,13727086759,22,13209984384,-517102375
1636160953,-181056,true,13716110030,22,13204701711,-511408319
1636160974,-181067,true,13701031357,22,13198101341,-502930016
1636161019,-181085,true,13676392914,22,13183592136,-492800778
1636161126,-181094,true,13664090313,22,13148046223,-516044090
1636161153,-181103,true,13651798778,22,13132278819,-519519959
1636161349,-181114,true,13636790805,22,13070704999,-566085806
1636161838,-181130,true,13614990475,22,13089015885,-525974590
1636161845,-181139,true,13602743108,22,13089015885,-513727223
1636161950,-181148,true,13590506758,22,13082473340,-508033418
1636162161,-181156,true,13579639244,22,13081165223,-498474021
1636162185,-181172,true,13557930278,22,13085089965,-472840313
1636162322,-181178,true,13549798367,22,13102110792,-447687575
1636162392,-181185,true,13540317301,22,13104731345,-435585956
1636162505,-181189,true,13534902527,22,13108663158,-426239369
1636162576,-181204,true,13514616406,22,13123089899,-391526507
1636162680,-181207,true,13510562832,22,13142788319,-367774513
1636162729,-181213,true,13502459331,22,13153306231,-349153100
1636162761,-181215,true,13499759244,22,13162516308,-337242936
1636162923,-181228,true,13482221836,22,13229813238,-252408598
1636162984,-181231,true,13478177978,22,13252321922,-225856056
1636163062,-181237,true,13470093901,22,13277524008,-192569893
1636163110,-181240,true,13466053681,22,13285492514,-180561167
1636163299,-181251,true,13451249905,22,13337404502,-113845403
1636163386,-181252,true,13449904915,22,13361432247,-88472668
1636163394,-181256,true,13444526298,22,13362768390,-81757908
1636163547,-181258,true,13441837796,22,13369451111,-72386685
1636163618,-181269,true,13427060642,22,13369451111,-57609531
1636163671,-181271,true,13424375632,22,13368114299,-56261333
1636163780,-181275,true,13419007224,22,13360096237,-58910987
1636163896,-181280,true,13412299733,22,13340072116,-72227617
1636163953,-181293,true,13394875943,22,13333404080,-61471863
1636163990,-181295,true,13392197369,22,13330737800,-61459569
1636164003,-181300,true,13385503279,22,13329404859,-56098420
1636164088,-181303,true,13381488431,22,13310757681,-70730750
1636164116,-181316,true,13364104667,22,13304104298,-60000369
1636164276,-181319,true,13360096237,22,13269560281,-90535956
1636164758,-181325,true,13352082984,22,13219234148,-132848836
1636164893,-181328,true,13348078161,22,13217912357,-130165804
1636165065,-181338,true,13334737421,22,13211305383,-123432038
1636165212,-181337,true,13336070895,22,13209984384,-126086511
1636165492,-181342,true,13329404859,22,13204701711,-124703148
1636165521,-181341,true,13330737800,22,13200741093,-129996707
1636165773,-181353,true,13314751307,22,13161200188,-153551119
1636165884,-181353,true,13314751307,22,13159884199,-154867108
1636165997,-181358,true,13308095928,22,13162516308,-145579620
1636166024,-181356,true,13310757681,22,13162516308,-148241373
1636166090,-181365,true,13298783986,22,13169098882,-129685104
1636166312,-181363,true,13301443876,22,13198101341,-103342535
1636166340,-181368,true,13294795149,22,13200741093,-94054056
1636166416,-181365,true,13298783986,22,13212626513,-86157473
1636166444,-181374,true,13286821063,22,13219234148,-67586915
1636166524,-181373,true,13288149745,22,13240400793,-47748952
1636166655,-181378,true,13281507663,22,13273541547,-7966116
1636166768,-181375,true,13285492514,22,13302774021,17281507
1636166850,-181383,true,13274868901,22,13325406837,50537936
1636166869,-181381,true,13277524008,22,13329404859,51880851
1636166984,-181386,true,13270887237,22,13333404080,62516843
1636167058,-181384,true,13273541547,22,13329404859,55863312
1636167303,-181391,true,13264253783,22,13332070873,67817090
1636167400,-181388,true,13268233457,22,13346743486,78510029
1636167403,-181392,true,13262927491,22,13348078161,85150670
1636167439,-181389,true,13266906767,22,13354753535,87846768
1636167459,-181389,true,13266906767,22,13361432247,94525480
1636167470,-181383,true,13274868901,22,13365441077,90572176
1636167639,-181384,true,13273541547,22,13406936154,133394607
1636167683,-181381,true,13277524008,22,13410958637,133434629
1636167877,-181379,true,13280179645,22,13453940290,173760645
1636167929,-181373,true,13288149745,22,13470093901,181944156
1636167971,-181374,true,13286821063,22,13482221836,195400773
1636168005,-181371,true,13290807508,22,13495710126,204902618
1636168098,-181368,true,13294795149,22,13534902527,240107378
1636168224,-181363,true,13301443876,22,13583713543,282269667
1636168388,-181364,true,13300113865,22,13623161512,323047647
1636168600,-181364,true,13300113865,22,13655894727,355780862
1636168836,-181361,true,13304104298,22,13690075463,385971165
1636168849,-181356,true,13310757681,22,13691444471,380686790
1636168871,-181357,true,13309426738,22,13692813615,383386877
1636169279,-181356,true,13310757681,22,13638154485,327396804
1636169409,-181355,true,13312088756,22,13606824339,294735583
1636169466,-181350,true,13318746132,22,13594584318,275838186
1636169563,-181350,true,13318746132,22,13583713543,264967411
1636169639,-181350,true,13318746132,22,13576923723,258177591
1636169655,-181345,true,13325406837,22,13571494311,246087474
1636169790,-181340,true,13332070873,22,13545734240,213663367
1636169878,-181339,true,13333404080,22,13548443522,215039442
1636169887,-181339,true,13333404080,22,13548443522,215039442
1636169904,-181333,true,13341406123,22,13548443522,207037399
1636170037,-181323,true,13354753535,22,13534902527,180148992
1636170225,-181321,true,13357424619,22,13545734240,188309621
1636170299,-181321,true,13357424619,22,13553863713,196439094
1636170334,-181314,true,13366777622,22,13556574621,189796999
1636170356,-181306,true,13377474787,22,13557930278,180455491
1636170466,-181303,true,13381488431,22,13559286071,177797640
1636170800,-181301,true,13384164862,22,13580997208,196832346
1636171174,-181296,true,13390858283,22,13609545840,218687557
1636171518,-181288,true,13401574720,22,13623161512,221586792
1636171618,-181285,true,13405595595,22,13625886280,220290685
1636172064,-181283,true,13408276848,22,13627248869,218972021
1636172302,-181276,true,13417665458,22,13621799332,204133874
1636172393,-181269,true,13427060642,22,13620437288,193376646
1636172421,-181267,true,13429746188,22,13614990475,185244287
1636172692,-181271,true,13424375632,22,13555219099,130843467
1636172798,-181267,true,13429746188,22,13532195953,102449765
1636172845,-181263,true,13435118893,22,13521375066,86256173
1636172877,-181262,true,13436462404,22,13515967868,79505464
1636173117,-181267,true,13429746188,22,13471440910,41694722
1636173196,-181264,true,13433775515,22,13459322673,25547158
1636173314,-181260,true,13439149831,22,13429746188,-9403643
1636173505,-181260,true,13439149831,22,13417665458,-21484373
1636173651,-181266,true,13431089163,22,13409617676,-21471487
1636173715,-181264,true,13433775515,22,13405595595,-28179920
1636173752,-181261,true,13437806051,22,13401574720,-36231331
1636173931,-181261,true,13437806051,22,13381488431,-56317620
1636173944,-181267,true,13429746188,22,13380150416,-49595772
1636174034,-181265,true,13432432272,22,13361432247,-71000025
1636174058,-181262,true,13436462404,22,13356089010,-80373394
1636174232,-181263,true,13435118893,22,13333404080,-101714813
1636174259,-181268,true,13428403348,22,13329404859,-98998489
1636174331,-181265,true,13432432272,22,13320078007,-112354265
1636174485,-181261,true,13437806051,22,13298783986,-139022065
1636174651,-181263,true,13435118893,22,13270887237,-164231656
1636174667,-181267,true,13429746188,22,13268233457,-161512731
1636174867,-181263,true,13435118893,22,13270887237,-164231656
1636174880,-181259,true,13440493746,22,13269560281,-170933465
1636174903,-181259,true,13440493746,22,13266906767,-173586979
1636174985,-181264,true,13433775515,22,13266906767,-166868748
1636175071,-181260,true,13439149831,22,13277524008,-161625823
1636175285,-181255,true,13445870750,22,13306765252,-139105498
1636175340,-181254,true,13447215337,22,13316082782,-131132555
1636175425,-181258,true,13441837796,22,13325406837,-116430959
1636175580,-181252,true,13449904915,22,13364104667,-85800248
1636175586,-181246,true,13457976876,22,13364104667,-93872209
1636175632,-181244,true,13460668606,22,13368114299,-92554307
1636175675,-181248,true,13455285684,22,13369451111,-85834573
1636175766,-181246,true,13457976876,22,13373462347,-84514529
1636176031,-181245,true,13459322673,22,13358760361,-100562312
1636176153,-181244,true,13460668606,22,13345408945,-115259661
1636176272,-181249,true,13453940290,22,13318746132,-135194158
1636176505,-181249,true,13453940290,22,13254972519,-198967771
1636176551,-181248,true,13455285684,22,13236429467,-218856217
1636176586,-181250,true,13452595030,22,13223200315,-229394715
1636176632,-181256,true,13444526298,22,13208663518,-235862780
1636177029,-181261,true,13437806051,22,13081165223,-356640828
1636177528,-181261,true,13437806051,22,12997717256,-440088795
1636177583,-181263,true,13435118893,22,12997717256,-437401637
1636177593,-181268,true,13428403348,22,12997717256,-430686092
1636177700,-181272,true,13423033329,22,12992519469,-430513860
1636177740,-181274,true,13420349125,22,12991220347,-429128778
1636178109,-181276,true,13417665458,22,12975641011,-442024447
1636178326,-181283,true,13408276848,22,12961376366,-446900482
1636178360,-181290,true,13398894807,22,12958784480,-440110327
1636178467,-181294,true,13393536589,22,12951011930,-442524659
1636178569,-181297,true,13389519331,22,12952307031,-437212300
1636178868,-181303,true,13381488431,22,12958784480,-422703951
1636179273,-181310,true,13372125135,22,12971749097,-400376038
1636179322,-181314,true,13366777622,22,12973046272,-393731350
1636179382,-181317,true,13362768390,22,12974343577,-388424813
1636179404,-181324,true,13353418193,22,12973046272,-380371921
1636179437,-181333,true,13341406123,22,12976938575,-364467548
1636179454,-181336,true,13337404502,22,12982130129,-355274373
1636179724,-181336,true,13337404502,22,13032856753,-304547749
1636179769,-181342,true,13329404859,22,13043286688,-286118171
1636179837,-181351,true,13317414391,22,13057641480,-259772911
1636179960,-181354,true,13313419965,22,13082473340,-230946625
1636180133,-181354,true,13313419965,22,13119153760,-194266205
1636180199,-181358,true,13308095928,22,13128339923,-179756005
1636180222,-181365,true,13298783986,22,13132278819,-166505167
1636180260,-181368,true,13294795149,22,13142788319,-152006830
1636180349,-181368,true,13294795149,22,13153306231,-141488918
1636180409,-181370,true,13292136589,22,13162516308,-129620281
1636180502,-181376,true,13284164097,22,13174367312,-109796785
1636180927,-181378,true,13281507663,22,13225845087,-55662576
1636181359,-181377,true,13282835814,22,13273541547,-9294267
1636181364,-181378,true,13281507663,22,13273541547,-7966116
1636181841,-181385,true,13272214325,22,13284164097,11949772
1636181866,-181386,true,13270887237,22,13284164097,13276860
1636182091,-181386,true,13270887237,22,13284164097,13276860
1636182295,-181388,true,13268233457,22,13282835814,14602357
1636182336,-181395,true,13258949408,22,13281507663,22558255
1636182530,-181397,true,13256298016,22,13270887237,14589221
1636182576,-181397,true,13256298016,22,13268233457,11935441
1636182735,-181400,true,13252321922,22,13260275303,7953381
1636182989,-181405,true,13245697748,22,13290807508,45109760
1636183028,-181407,true,13243049006,22,13294795149,51746143
1636183247,-181406,true,13244373311,22,13324074430,79701119
1636183568,-181408,true,13241724833,22,13378812535,137087702
1636183636,-181413,true,13235105957,22,13392197369,157091412
1636183798,-181414,true,13233782578,22,13398894807,165112229
1636183875,-181414,true,13233782578,22,13392197369,158414791
1636183934,-181413,true,13235105957,22,13386841829,151735872
1636184007,-181418,true,13228490389,22,13361432247,132941858
1636184066,-181422,true,13223200315,22,13341406123,118205808
1636184366,-181424,true,13220556072,22,13243049006,22492934
1636184843,-181425,true,13219234148,22,13092942982,-126291166
1636185007,-181430,true,13212626513,22,13095561702,-117064811
1636185192,-181434,true,13207342784,22,13104731345,-102611439
1636185216,-181435,true,13206022182,22,13106041819,-99980363
1636185232,-181434,true,13207342784,22,13106041819,-101300965
1636185272,-181438,true,13202061167,22,13107352423,-94708744
1636185295,-181442,true,13196781663,22,13107352423,-89429240
1636185335,-181443,true,13195462116,22,13108663158,-86798958
1636185348,-181441,true,13198101341,22,13111285022,-86816319
1636185355,-181444,true,13194142702,22,13112596150,-81546552
1636185454,-181447,true,13190185251,22,13123089899,-67095352
1636185566,-181446,true,13191504269,22,13134905406,-56598863
1636185802,-181444,true,13194142702,22,13155937024,-38205678
1636185934,-181449,true,13187547610,22,13132278819,-55268791
1636185937,-181452,true,13183592136,22,13132278819,-51313317
1636186230,-181453,true,13182273909,22,13074626602,-107647307
1636186385,-181454,true,13180955813,22,13032856753,-148099060
1636186511,-181460,true,13173050007,22,13001616962,-171433045
1636186555,-181463,true,13169098882,22,12989921355,-179177527
1636186598,-181466,true,13165148943,22,12979534093,-185614850
1636186725,-181468,true,13162516308,22,12935480812,-227035496
1636186749,-181474,true,13154621561,22,12934187394,-220434167
1636186969,-181479,true,13148046223,22,12927722240,-220323983
1636187027,-181482,true,13144102598,22,12925137083,-218965515
1636187186,-181481,true,13145417009,22,12945832820,-199584189
1636187327,-181488,true,13136218896,22,12965265168,-170953728
1636187590,-181490,true,13133592047,22,13018529209,-115062838
1636187848,-181493,true,13129652757,22,13057641480,-72011277
1636188326,-181494,true,13128339923,22,13055030343,-73309580
1636188719,-181500,true,13120465675,22,13044591017,-75874658
1636188964,-181500,true,13120465675,22,13040678422,-79787253
1636189144,-181502,true,13117841975,22,13039374485,-78467490
1636189153,-181502,true,13117841975,22,13038070678,-79771297
1636189239,-181507,true,13111285022,22,13032856753,-78428269
1636189369,-181504,true,13115218801,22,13045895476,-69323325
1636189637,-181504,true,13115218801,22,13068091250,-47127551
1636189647,-181504,true,13115218801,22,13069398059,-45820742
1636189934,-181503,true,13116530322,22,13087707114,-28823208
1636190030,-181500,true,13120465675,22,13106041819,-14423856
1636190508,-181498,true,13123089899,22,13171732834,48642935
1636190721,-181497,true,13124402208,22,13196781663,72379455
1636190729,-181496,true,13125714649,22,13196781663,71067014
1636190843,-181492,true,13130965722,22,13204701711,73735989
1636191205,-181491,true,13132278819,22,13182273909,49995090
1636191769,-181490,true,13133592047,22,13159884199,26292152
1636191866,-181488,true,13136218896,22,13157252617,21033721
1636192155,-181485,true,13140160156,22,13130965722,-9194434
1636192881,-181485,true,13140160156,22,13085089965,-55070191
1636192890,-181486,true,13138846271,22,13085089965,-53756306
1636193092,-181486,true,13138846271,22,13039374485,-99471786
1636193188,-181483,true,13142788319,22,13027644913,-115143406
1636193270,-181486,true,13138846271,22,13018529209,-120317062
1636193656,-181487,true,13137532518,22,12963968771,-173563747
1636193679,-181486,true,13138846271,22,12960080358,-178765913
1636193712,-181486,true,13138846271,22,12953602261,-185244010
1636193806,-181493,true,13129652757,22,12945832820,-183819937
1636193895,-181494,true,13128339923,22,12953602261,-174737662
1636194111,-181495,true,13127027220,22,12931600944,-195426276
1636194440,-181497,true,13124402208,22,12846537649,-277864559
1636194808,-181506,true,13112596150,22,12758206050,-354390100
1636194881,-181507,true,13111285022,22,12746729403,-364555619
1636194922,-181510,true,13107352423,22,12740357950,-366994473
1636195145,-181514,true,13102110792,22,12697116447,-404994345
1636195178,-181524,true,13089015885,22,12692038870,-396977015
1636195247,-181528,true,13083781587,22,12685694754,-398086833
1636195520,-181531,true,13079857237,22,12656552640,-423304597
1636195587,-181536,true,13073319270,22,12645167436,-428151834
1636195756,-181547,true,13058947244,22,12623689986,-435257258
1636196013,-181549,true,13056335846,22,12647696596,-408639250
1636196051,-181553,true,13051114617,22,12651491284,-399623333
1636196119,-181557,true,13045895476,22,12652756433,-393139043
1636196225,-181567,true,13032856753,22,12666681426,-366175327
1636196445,-181569,true,13030250573,22,12695846863,-334403710
1636196492,-181572,true,13026342279,22,12703466276,-322876003
1636196652,-181574,true,13023737401,22,12742906149,-280831252
1636197057,-181585,true,13009419882,22,12750553805,-258866077
1636197097,-181586,true,13008119070,22,12746729403,-261389667
1636197170,-181591,true,13001616962,22,12740357950,-261259012
1636197189,-181596,true,12995118103,22,12737810261,-257307842
1636197363,-181606,true,12982130129,22,12746729403,-235400726
1636197408,-181608,true,12979534093,22,12745454858,-234079235
1636197591,-181612,true,12974343577,22,12754379353,-219964224
1636197653,-181616,true,12969155136,22,12768416188,-200738948
1636197786,-181625,true,12957488731,22,12787582225,-169906506
1636197996,-181627,true,12954897622,22,12819589572,-135308050
1636198114,-181627,true,12954897622,22,12842684458,-112213164
1636198126,-181628,true,12953602261,22,12843968726,-109633535
1636198374,-181634,true,12945832820,22,12863248171,-82584649
1636198397,-181634,true,12945832820,22,12864534496,-81298324
1636198469,-181635,true,12944538366,22,12870968050,-73570316
1636198576,-181635,true,12944538366,22,12874829727,-69708639
1636198672,-181640,true,12938068038,22,12881268429,-56799609
1636198905,-181640,true,12938068038,22,12922552443,-15515595
1636198915,-181641,true,12936774360,22,12923844698,-12929662
1636199045,-181640,true,12938068038,22,12936774360,-1293678
1636199112,-181645,true,12931600944,22,12939361845,7760901
1636199248,-181647,true,12929015012,22,12951011930,21996918
1636199481,-181649,true,12926429597,22,12944538366,18108769
1636199711,-181650,true,12925137083,22,12926429597,1292514
1636199761,-181655,true,12918676453,22,12917384714,-1291739
1636199831,-181657,true,12916093105,22,12905764879,-10328226
1636199923,-181658,true,12914801625,22,12894155496,-20646129
1636199955,-181659,true,12913510274,22,12891577051,-21933223
1636200080,-181660,true,12912219052,22,12898024129,-14194923
1636200106,-181658,true,12914801625,22,12901893923,-12907702
1636200256,-181657,true,12916093105,22,12916093105,0
1636200649,-181658,true,12914801625,22,12951011930,36210305
1636200881,-181659,true,12913510274,22,12976938575,63428301
1636200907,-181655,true,12918676453,22,12983428342,64751889
1636201003,-181653,true,12921260317,22,12983428342,62168025
1636201015,-181655,true,12918676453,22,12983428342,64751889
1636201057,-181655,true,12918676453,22,12982130129,63453676
1636201237,-181655,true,12918676453,22,12980832046,62155593
1636201401,-181654,true,12919968320,22,12983428342,63460022
1636201469,-181658,true,12914801625,22,12982130129,67328504
1636201576,-181658,true,12914801625,22,12978236269,63434644
1636201578,-181658,true,12914801625,22,12978236269,63434644
1636201660,-181658,true,12914801625,22,12974343577,59541952
1636201717,-181662,true,12909636995,22,12971749097,62112102
1636201745,-181662,true,12909636995,22,12969155136,59518141
1636201875,-181663,true,12908346161,22,12953602261,45256100
1636201920,-181661,true,12910927959,22,12954897622,43969663
1636202315,-181665,true,12905764879,22,12962672504,56907625
1636202554,-181666,true,12904474431,22,12978236269,73761838
1636202851,-181666,true,12904474431,22,12997717256,93242825
1636202897,-181665,true,12905764879,22,12993818721,88053842
1636203103,-181670,true,12899313932,22,12978236269,78922337
1636203391,-181674,true,12894155496,22,12956193111,62037615
1636203507,-181674,true,12894155496,22,12958784480,64628984
1636204098,-181674,true,12894155496,22,12980832046,86676550
1636204396,-181678,true,12888999123,22,12962672504,73673381
1636204453,-181681,true,12885133196,22,12969155136,84021940
1636204530,-181680,true,12886421709,22,12992519469,106097760
1636206288,-181667,true,12903184113,22,13459322673,556138560
1636206336,-181668,true,12901893923,22,13457976876,556082953
1636206344,-181669,true,12900603863,22,13457976876,557373013
1636206389,-181667,true,12903184113,22,13456631212,553447099
1636206885,-181653,true,12921260317,22,13457976876,536716559
1636207284,-181654,true,12919968320,22,13447215337,527247017
1636207881,-181652,true,12922552443,22,13431089163,508536720
1636208118,-181650,true,12925137083,22,13427060642,501923559
1636208332,-181636,true,12943244041,22,13462014672,518770631
1636208454,-181636,true,12943244041,22,13509211911,565967870
1636208498,-181630,true,12951011930,22,13536256018,585244088
1636208603,-181623,true,12960080358,22,13600022968,639942610
1636209072,-181601,true,12988622493,22,13878910623,890288130
1636209988,-181597,true,12993818721,22,13970809772,976991051
1636210073,-181589,true,13004217415,22,13966619367,962401952
1636210395,-181583,true,13012021896,22,13884463020,872441124
1636210405,-181560,true,13041982490,22,13881686544,839704054
1636210668,-181558,true,13044591017,22,13841489976,796898959
1636211498,-181551,true,13053724971,22,13742194107,688469136
1636211701,-181544,true,13062865320,22,13724341753,661476433
1636211748,-181522,true,13091633819,22,13720225274,628591455
1636211841,-181521,true,13092942982,22,13710624957,617681975
1636211857,-181515,true,13100800712,22,13709254032,608453320
1636211963,-181510,true,13107352423,22,13696921870,589569447
1636212406,-181489,true,13134905406,22,13628611594,493706188
1636212414,-181488,true,13136218896,22,13627248869,491029973
1636212527,-181484,true,13141474172,22,13602743108,461268936
1636212595,-181481,true,13145417009,22,13589147844,443730835
1636212734,-181462,true,13170415792,22,13566067070,395651278
1636212800,-181463,true,13169098882,22,13556574621,387475739
1636212904,-181459,true,13174367312,22,13540317301,365949989
1636213025,-181455,true,13179637850,22,13528137106,348499256
1636213058,-181436,true,13204701711,22,13522727204,318025493
1636213144,-181437,true,13203381373,22,13509211911,305830538
1636213307,-181430,true,13212626513,22,13524079476,311452963
1636213600,-181425,true,13219234148,22,13572851461,353617313
1636213667,-181408,true,13241724833,22,13572851461,331126628
1636214132,-181413,true,13235105957,22,13498409403,263303446
1636214538,-181409,true,13240400793,22,13410958637,170557844
1636214598,-181406,true,13244373311,22,13398894807,154521496
1636214606,-181390,true,13265580209,22,13398894807,133314598
1636214649,-181394,true,13260275303,22,13393536589,133261286
1636215002,-181395,true,13258949408,22,13350747910,91798502
1636215058,-181392,true,13262927491,22,13344074538,81147047
1636215338,-181376,true,13284164097,22,13298783986,14619889
1636215530,-181380,true,13278851760,22,13285492514,6640754
1636215542,-181382,true,13276196388,22,13288149745,11953357
1636215568,-181380,true,13278851760,22,13293465802,14614042
1636215634,-181363,true,13301443876,22,13308095928,6652052
1636215669,-181363,true,13301443876,22,13316082782,14638906
1636215700,-181365,true,13298783986,22,13321410015,22626029
1636215814,-181364,true,13300113865,22,13336070895,35957030
1636215872,-181347,true,13322742156,22,13338738242,15996086
1636215929,-181347,true,13322742156,22,13348078161,25336005
1636215951,-181348,true,13321410015,22,13352082984,30672969
1636216028,-181346,true,13324074430,22,13365441077,41366647
1636216218,-181327,true,13349412968,22,13396215430,46802462
1636216448,-181326,true,13350747910,22,13429746188,78998278
1636216527,-181330,true,13345408945,22,13421691160,76282215
1636216703,-181329,true,13346743486,22,13420349125,73605639
1636216899,-181312,true,13369451111,22,13420349125,50898014
1636217030,-181312,true,13369451111,22,13413640963,44189852
1636217141,-181315,true,13365441077,22,13413640963,48199886
1636217278,-181314,true,13366777622,22,13406936154,40158532
1636217487,-181298,true,13388180513,22,13398894807,10714294
1636217558,-181298,true,13388180513,22,13396215430,8034917
1636217595,-181302,true,13382826580,22,13398894807,16068227
1636217986,-181298,true,13388180513,22,13435118893,46938380
1636218242,-181281,true,13410958637,22,13453940290,42981653
1636218346,-181281,true,13410958637,22,13462014672,51056035
1636218423,-181284,true,13406936154,22,13479525796,72589642
1636218437,-181280,true,13412299733,22,13482221836,69922103
1636218734,-181260,true,13439149831,22,13507861125,68711294
1636219019,-181259,true,13440493746,22,13530842869,90349123
1636219062,-181263,true,13435118893,22,13540317301,105198408
1636219082,-181258,true,13441837796,22,13544379802,102542006
1636219231,-181238,true,13468747026,22,13574208746,105461720
1636219255,-181236,true,13471440910,22,13576923723,105482813
1636219275,-181240,true,13466053681,22,13579639244,113585563
1636219472,-181237,true,13470093901,22,13586430422,116336521
1636219681,-181217,true,13497059697,22,13595943777,98884080
1636219709,-181215,true,13499759244,22,13597303371,97544127
1636219873,-181219,true,13494360690,22,13600022968,105662278
1636220188,-181219,true,13494360690,22,13497059697,2699007
1636220341,-181202,true,13517319465,22,13459322673,-57996792
1636220736,-181199,true,13521375066,22,13416323825,-105051241
1636220775,-181203,true,13515967868,22,13414982327,-100985541
1636221206,-181202,true,13517319465,22,13490313191,-27006274
1636221243,-181197,true,13524079476,22,13495710126,-28369350
1636221495,-181197,true,13524079476,22,13502459331,-21620145
1636221594,-181202,true,13517319465,22,13506510474,-10808991
1636221605,-181200,true,13520023064,22,13507861125,-12161939
1636221888,-181195,true,13526784427,22,13511913888,-14870539
1636221915,-181194,true,13528137106,22,13511913888,-16223218
1636221928,-181199,true,13521375066,22,13511913888,-9461178
1636221991,-181198,true,13522727204,22,13511913888,-10813316
1636222021,-181194,true,13528137106,22,13511913888,-16223218
1636222171,-181195,true,13526784427,22,13499759244,-27025183
1636222198,-181203,true,13515967868,22,13499759244,-16208624
1636222448,-181209,true,13507861125,22,13462014672,-45846453
1636222478,-181212,true,13503809577,22,13456631212,-47178365
1636222486,-181215,true,13499759244,22,13455285684,-44473560
1636222734,-181224,true,13487615533,22,13401574720,-86040813
1636222748,-181229,true,13480873748,22,13398894807,-81978941
1636222792,-181231,true,13478177978,22,13393536589,-84641389
1636222822,-181230,true,13479525796,22,13385503279,-94022517
1636222894,-181239,true,13467400286,22,13365441077,-101959209
1636223003,-181245,true,13459322673,22,13342740264,-116582409
1636223215,-181247,true,13456631212,22,13305434708,-151196504
1636223311,-181246,true,13457976876,22,13293465802,-164511074
1636223445,-181253,true,13448560059,22,13280179645,-168380414
1636223568,-181258,true,13441837796,22,13273541547,-168296249
1636223703,-181259,true,13440493746,22,13265580209,-174913537
1636223808,-181257,true,13443181979,22,13268233457,-174948522
1636223834,-181263,true,13435118893,22,13269560281,-165558612
1636224061,-181267,true,13429746188,22,13270887237,-158858951
1636224135,-181267,true,13429746188,22,13272214325,-157531863
1636224153,-181265,true,13432432272,22,13272214325,-160217947
1636224259,-181273,true,13421691160,22,13248347020,-173344140
1636224300,-181280,true,13412299733,22,13239076886,-173222847
1636224327,-181281,true,13410958637,22,13232459333,-178499304
1636224442,-181280,true,13412299733,22,13198101341,-214198392
1636224445,-181291,true,13397555052,22,13196781663,-200773389
1636224506,-181302,true,13382826580,22,13163832559,-218994021
1636224567,-181304,true,13380150416,22,13138846271,-241304145
1636224737,-181301,true,13384164862,22,13070704999,-313459863
1636225039,-181311,true,13370788056,22,12939361845,-431426211
1636225090,-181320,true,13358760361,22,12926429597,-432330764
1636225195,-181321,true,13357424619,22,12912219052,-445205567
1636225237,-181319,true,13360096237,22,12904474431,-455621806
1636225254,-181324,true,13353418193,22,12901893923,-451524270
1636225315,-181333,true,13341406123,22,12891577051,-449829072
1636225379,-181336,true,13337404502,22,12888999123,-448405379
1636225472,-181334,true,13340072116,22,12887710352,-452361764
1636225509,-181339,true,13333404080,22,12885133196,-448270884
1636225644,-181347,true,13322742156,22,12892866209,-429875947
1636225698,-181351,true,13317414391,22,12898024129,-419390262
1636225761,-181352,true,13316082782,22,12905764879,-410317903
1636225922,-181357,true,13309426738,22,12913510274,-395916464
1636225967,-181364,true,13300113865,22,12916093105,-384020760
1636226096,-181367,true,13296124629,22,12913510274,-382614355
1636226113,-181368,true,13294795149,22,12914801625,-379993524
1636226185,-181373,true,13288149745,22,12918676453,-369473292
1636226190,-181381,true,13277524008,22,12918676453,-358847555
1636226218,-181385,true,13272214325,22,12919968320,-352246005
1636226239,-181386,true,13270887237,22,12922552443,-348334794
1636226261,-181390,true,13265580209,22,12925137083,-340443126
1636226470,-181397,true,13256298016,22,12943244041,-313053975
1636226472,-181400,true,13252321922,22,12943244041,-309077881
1636226550,-181400,true,13252321922,22,12943244041,-309077881
1636226583,-181405,true,13245697748,22,12941949846,-303747902
1636226621,-181412,true,13236429467,22,12940655781,-295773686
1636226668,-181416,true,13231136219,22,12938068038,-293068181
1636226711,-181416,true,13231136219,22,12939361845,-291774374
1636226723,-181421,true,13224522635,22,12939361845,-285160790
1636226726,-181430,true,13212626513,22,12939361845,-273264668
1636226792,-181435,true,13206022182,22,12935480812,-270541370
1636226830,-181437,true,13203381373,22,12934187394,-269193979
1636227175,-181442,true,13196781663,22,12917384714,-279396949
1636227184,-181451,true,13184910496,22,12914801625,-270108871
1636227375,-181459,true,13174367312,22,12872255147,-302112165
1636227400,-181462,true,13170415792,22,12867107532,-303308260
1636227499,-181469,true,13161200188,22,12847822302,-313377886
1636227516,-181479,true,13148046223,22,12841400318,-306645905
1636227630,-181489,true,13134905406,22,12810619448,-324285958
1636227638,-181494,true,13128339923,22,12808057708,-320282215
1636227921,-181502,true,13117841975,22,12740357950,-377484025
1636228045,-181511,true,13106041819,22,12713632606,-392409213
1636228059,-181521,true,13092942982,22,12709819279,-383123703
1636228104,-181526,true,13086398474,22,12707277697,-379120777
1636228354,-181532,true,13078549383,22,12698386159,-380163224
1636228498,-181537,true,13072012069,22,12704736622,-367275447
1636228678,-181545,true,13061559164,22,12719990694,-341568470
1636228688,-181550,true,13055030343,22,12719990694,-335039649
1636228757,-181556,true,13047200066,22,12725079454,-322120612
1636228766,-181562,true,13039374485,22,12726351961,-313022524
1636228933,-181571,true,13027644913,22,12736536607,-291108306
1636229183,-181577,true,13019831061,22,12733989682,-285841379
1636229202,-181583,true,13012021896,22,12731443266,-280578630
1636229363,-181590,true,13002917123,22,12730170249,-272746874
1636229466,-181598,true,12992519469,22,12731443266,-261076203
1636229905,-181604,true,12984726685,22,12731443266,-253283419
1636229930,-181610,true,12976938575,22,12731443266,-245495309
1636229983,-181617,true,12967858351,22,12731443266,-236415085
1636229998,-181625,true,12957488731,22,12728897359,-228591372
1636230381,-181632,true,12948422116,22,12686963324,-261458792
1636230580,-181638,true,12940655781,22,12680621745,-260034036
1636230822,-181643,true,12934187394,22,12660349985,-273837409
1636231067,-181650,true,12925137083,22,12683157996,-241979087
1636231095,-181656,true,12917384714,22,12686963324,-230421390
1636231176,-181660,true,12912219052,22,12695846863,-216372189
1636231939,-181661,true,12910927959,22,12818307741,-92620218
1636232243,-181668,true,12901893923,22,12854247498,-47646425
1636232365,-181673,true,12895444911,22,12861961975,-33482936
1636232404,-181676,true,12891577051,22,12864534496,-27042555
1636232419,-181675,true,12892866209,22,12864534496,-28331713
1636232597,-181681,true,12885133196,22,12873542372,-11590824
1636232849,-181686,true,12878692562,22,12882556556,3863994
1636233064,-181689,true,12874829727,22,12876117210,1287483
1636233158,-181688,true,12876117210,22,12872255147,-3862063
1636233350,-181695,true,12867107532,22,12863248171,-3859361
1636233429,-181701,true,12859389969,22,12861961975,2572006
1636233466,-181704,true,12855532923,22,12861961975,6429052
1636233614,-181702,true,12858104158,22,12872255147,14150989
1636234000,-181707,true,12851677034,22,12898024129,46347095
1636234032,-181713,true,12843968726,22,12901893923,57925197
1636234033,-181714,true,12842684458,22,12901893923,59209465
1636234131,-181710,true,12847822302,22,12903184113,55361811
1636234175,-181714,true,12842684458,22,12905764879,63080421
1636234397,-181719,true,12836265042,22,12898024129,61759087
1636234630,-181721,true,12833698174,22,12870968050,37269876
1636234885,-181714,true,12842684458,22,12841400318,-1284140
1636234975,-181718,true,12837548668,22,12824718177,-12830491
1636235011,-181722,true,12832414932,22,12818307741,-14107191
1636235080,-181724,true,12829848834,22,12806777031,-23071803
1636235191,-181720,true,12834981543,22,12795256692,-39724851
1636235221,-181724,true,12829848834,22,12791418883,-38429951
1636235329,-181728,true,12824718177,22,12778634496,-46083681
1636235367,-181730,true,12822153618,22,12774801673,-47351945
1636235410,-181726,true,12827283249,22,12767139474,-60143775
1636235543,-181730,true,12822153618,22,12745454858,-76698760
1636235849,-181734,true,12817026039,22,12703466276,-113559763
1636235982,-181737,true,12813181700,22,12708548424,-104633276
1636236014,-181734,true,12817026039,22,12708548424,-108477615
1636236059,-181737,true,12813181700,22,12711090261,-102091439
1636236264,-181738,true,12811900510,22,12762033894,-49866616
1636236454,-181737,true,12813181700,22,12818307741,5126041
1636236467,-181734,true,12817026039,22,12822153618,5127579
1636236551,-181736,true,12814463018,22,12847822302,33359284
1636236608,-181736,true,12814463018,22,12869681082,55218064
1636236784,-181734,true,12817026039,22,12931600944,114574905
1636236857,-181731,true,12820871531,22,12952307031,131435500
1636237039,-181733,true,12818307741,22,12982130129,163822388
1636237348,-181734,true,12817026039,22,12973046272,156020233
1636237622,-181734,true,12817026039,22,12953602261,136576222
1636237755,-181731,true,12820871531,22,12945832820,124961289
1636237939,-181735,true,12815744464,22,12935480812,119736348
1636237966,-181736,true,12814463018,22,12935480812,121017794
1636238063,-181735,true,12815744464,22,12935480812,119736348
1636238433,-181733,true,12818307741,22,12917384714,99076973
1636238620,-181737,true,12813181700,22,12903184113,90002413
1636238689,-181737,true,12813181700,22,12896734456,83552756
1636238810,-181737,true,12813181700,22,12886421709,73240009
1636238865,-181735,true,12815744464,22,12882556556,66812092
1636238994,-181737,true,12813181700,22,12878692562,65510862
1636239048,-181737,true,12813181700,22,12877404821,64223121
1636239315,-181737,true,12813181700,22,12876117210,62935510
1636240029,-181735,true,12815744464,22,12879980431,64235967
1636240271,-181736,true,12814463018,22,12881268429,66805411
1636240488,-181736,true,12814463018,22,12879980431,65517413
1636240574,-181733,true,12818307741,22,12878692562,60384821
1636240747,-181731,true,12820871531,22,12876117210,55245679
1636240839,-181731,true,12820871531,22,12873542372,52670841
1636240894,-181731,true,12820871531,22,12870968050,50096519
1636240955,-181726,true,12827283249,22,12868394243,41110994
1636241052,-181725,true,12828565978,22,12864534496,35968518
1636241075,-181725,true,12828565978,22,12863248171,34682193
1636241256,-181725,true,12828565978,22,12854247498,25681520
1636241429,-181723,true,12831131819,22,12846537649,15405830
1636241538,-181721,true,12833698174,22,12841400318,7702144
1636241633,-181721,true,12833698174,22,12836265042,2566868
1636241649,-181721,true,12833698174,22,12837548668,3850494
1636241775,-181718,true,12837548668,22,12842684458,5135790
1636241891,-181717,true,12838832423,22,12847822302,8989879
1636242019,-181715,true,12841400318,22,12863248171,21847853
1636242260,-181714,true,12842684458,22,12908346161,65661703
1636242302,-181710,true,12847822302,22,12916093105,68270803
1636242389,-181708,true,12850391995,22,12929015012,78623017
1636242471,-181706,true,12852962202,22,12941949846,88987644
1636242587,-181704,true,12855532923,22,12969155136,113622213
1636242699,-181700,true,12860675908,22,12983428342,122752434
1636242707,-181698,true,12863248171,22,12983428342,120180171
1636242745,-181696,true,12865820950,22,12987323760,121502810
1636242794,-181692,true,12870968050,22,12989921355,118953305
1636242828,-181690,true,12873542372,22,12988622493,115080121
1636242853,-181688,true,12876117210,22,12989921355,113804145
1636242955,-181686,true,12878692562,22,12988622493,109929931
1636242959,-181684,true,12881268429,22,12988622493,107354064
1636242994,-181682,true,12883844812,22,12986025158,102180346
1636243023,-181683,true,12882556556,22,12982130129,99573573
1636243043,-181683,true,12882556556,22,12979534093,96977537
1636243416,-181681,true,12885133196,22,12948422116,63288920
1636243429,-181680,true,12886421709,22,12947127403,60705694
1636243484,-181682,true,12883844812,22,12936774360,52929548
1636243618,-181682,true,12883844812,22,12923844698,39999886
1636243707,-181680,true,12886421709,22,12918676453,32254744
1636243861,-181679,true,12887710352,22,12908346161,20635809
1636243864,-181681,true,12885133196,22,12908346161,23212965
1636244232,-181682,true,12883844812,22,12885133196,1288384
1636244306,-181680,true,12886421709,22,12879980431,-6441278
1636244431,-181679,true,12887710352,22,12865820950,-21889402
1636244996,-181684,true,12881268429,22,12758206050,-123062379
1636245234,-181688,true,12876117210,22,12719990694,-156126516
1636245368,-181687,true,12877404821,22,12709819279,-167585542
1636245974,-181687,true,12877404821,22,12704736622,-172668199
1636246158,-181692,true,12870968050,22,12690769793,-180198257
1636246461,-181696,true,12865820950,22,12669214889,-196606061
1636246627,-181693,true,12869681082,22,12659084077,-210597005
1636246742,-181693,true,12869681082,22,12659084077,-210597005
1636247043,-181697,true,12864534496,22,12694577405,-169957091
1636247149,-181699,true,12861961975,22,12711090261,-150871714
1636247164,-181695,true,12867107532,22,12713632606,-153474926
1636247215,-181694,true,12868394243,22,12718718822,-149675421
1636247300,-181696,true,12865820950,22,12726351961,-139468989
1636247417,-181699,true,12861961975,22,12737810261,-124151714
1636247498,-181694,true,12868394243,22,12751828860,-116565383
1636247501,-181693,true,12869681082,22,12751828860,-117852222
1636247561,-181694,true,12868394243,22,12760757819,-107636424
1636247677,-181695,true,12867107532,22,12773524320,-93583212
1636248333,-181690,true,12873542372,22,12814463018,-59079354
1636248451,-181689,true,12874829727,22,12814463018,-60366709
1636248489,-181690,true,12873542372,22,12814463018,-59079354
1636248522,-181691,true,12872255147,22,12817026039,-55229108
1636248598,-181689,true,12874829727,22,12829848834,-44980893
1636248632,-181689,true,12874829727,22,12834981543,-39848184
1636248847,-181690,true,12873542372,22,12868394243,-5148129
1636248870,-181691,true,12872255147,22,12870968050,-1287097
1636248917,-181690,true,12873542372,22,12874829727,1287355
1636249070,-181692,true,12870968050,22,12887710352,16742302
1636249313,-181694,true,12868394243,22,12910927959,42533716
1636249522,-181695,true,12867107532,22,12905764879,38657347
1636249632,-181693,true,12869681082,22,12896734456,27053374
1636249902,-181694,true,12868394243,22,12882556556,14162313
1636249972,-181696,true,12865820950,22,12881268429,15447479
1636250215,-181697,true,12864534496,22,12878692562,14158066
1636250250,-181695,true,12867107532,22,12878692562,11585030
1636250298,-181696,true,12865820950,22,12878692562,12871612
1636250322,-181697,true,12864534496,22,12878692562,14158066
1636250373,-181698,true,12863248171,22,12877404821,14156650
1636250719,-181696,true,12865820950,22,12873542372,7721422
1636250819,-181697,true,12864534496,22,12872255147,7720651
1636251002,-181697,true,12864534496,22,12869681082,5146586
1636251093,-181698,true,12863248171,22,12860675908,-2572263
1636251194,-181698,true,12863248171,22,12847822302,-15425869
1636251414,-181699,true,12861961975,22,12820871531,-41090444
1636251763,-181701,true,12859389969,22,12778634496,-80755473
1636251962,-181703,true,12856818476,22,12762033894,-94784582
1636252046,-181702,true,12858104158,22,12765862887,-92241271
1636252165,-181703,true,12856818476,22,12774801673,-82016803
1636252189,-181704,true,12855532923,22,12776079153,-79453770
1636252374,-181704,true,12855532923,22,12787582225,-67950698
1636252601,-181703,true,12856818476,22,12800375563,-56442913
1636252659,-181705,true,12854247498,22,12804216059,-50031439
1636253189,-181705,true,12854247498,22,12809338514,-44908984
1636253264,-181705,true,12854247498,22,12809338514,-44908984
1636253463,-181705,true,12854247498,22,12785025092,-69222406
1636253766,-181707,true,12851677034,22,12751828860,-99848174
1636253788,-181709,true,12849107085,22,12750553805,-98553280
1636253922,-181709,true,12849107085,22,12754379353,-94727732
1636253985,-181708,true,12850391995,22,12753104043,-97287952
1636254375,-181709,true,12849107085,22,12777356761,-71750324
1636254385,-181711,true,12846537649,22,12778634496,-67903153
1636254745,-181711,true,12846537649,22,12841400318,-5137331
1636254836,-181711,true,12846537649,22,12846537649,0
1636255047,-181711,true,12846537649,22,12863248171,16710522
1636255336,-181715,true,12841400318,22,12881268429,39868111
1636255424,-181715,true,12841400318,22,12874829727,33429409
1636255500,-181716,true,12840116306,22,12869681082,29564776
1636255758,-181717,true,12838832423,22,12852962202,14129779
1636255810,-181722,true,12832414932,22,12850391995,17977063
1636255829,-181722,true,12832414932,22,12847822302,15407370
1636255929,-181722,true,12832414932,22,12837548668,5133736
1636256013,-181722,true,12832414932,22,12828565978,-3848954
1636256180,-181727,true,12826000649,22,12808057708,-17942941
1636256452,-181729,true,12823435834,22,12770969999,-52465835
1636256490,-181729,true,12823435834,22,12765862887,-57572947
1636256694,-181730,true,12822153618,22,12740357950,-81795668
1636257451,-181736,true,12814463018,22,12703466276,-110996742
1636257480,-181737,true,12813181700,22,12703466276,-109715424
1636257728,-181737,true,12813181700,22,12692038870,-121142830
1636257748,-181738,true,12811900510,22,12690769793,-121130717
1636258434,-181745,true,12802935766,22,12667948094,-134987672
1636258607,-181745,true,12802935766,22,12667948094,-134987672
1636258788,-181746,true,12801655600,22,12666681426,-134974174
1636258794,-181746,true,12801655600,22,12666681426,-134974174
1636259006,-181753,true,12792698025,22,12659084077,-133613948
1636259375,-181753,true,12792698025,22,12669214889,-123483136
1636259416,-181753,true,12792698025,22,12667948094,-124749931
1636259501,-181753,true,12792698025,22,12674283335,-118414690
1636259661,-181756,true,12788860983,22,12681889807,-106971176
1636259983,-181754,true,12791418883,22,12700925963,-90492920
1636260093,-181753,true,12792698025,22,12704736622,-87961403
1636260244,-181752,true,12793977295,22,12709819279,-84158016
1636260297,-181755,true,12790139869,22,12712361370,-77778499
1636260335,-181752,true,12793977295,22,12713632606,-80344689
1636260395,-181751,true,12795256692,22,12713632606,-81624086
1636260416,-181750,true,12796536218,22,12713632606,-82903612
1636260522,-181755,true,12790139869,22,12709819279,-80320590
1636260554,-181754,true,12791418883,22,12708548424,-82870459
1636260625,-181755,true,12790139869,22,12702196056,-87943813
1636260769,-181755,true,12790139869,22,12689500843,-100639026
1636260960,-181760,true,12783746717,22,12669214889,-114531828
1636261509,-181758,true,12786303594,22,12604769591,-181534003
1636261619,-181760,true,12783746717,22,12600988916,-182757801
1636261973,-181760,true,12783746717,22,12599728943,-184017774
1636262223,-181766,true,12776079153,22,12600988916,-175090237
1636262357,-181765,true,12777356761,22,12613595577,-163761184
1636262414,-181767,true,12774801673,22,12617380034,-157421639
1636262603,-181766,true,12776079153,22,12636319358,-139759795
1636262703,-181771,true,12769693029,22,12645167436,-124525593
1636262962,-181771,true,12769693029,22,12642638781,-127054248
1636263194,-181775,true,12764586429,22,12636319358,-128267071
1636263412,-181776,true,12763310098,22,12636319358,-126990740
1636263517,-181782,true,12755654791,22,12635055852,-120598939
1636263676,-181781,true,12756930357,22,12654021709,-102908648
1636263924,-181783,true,12754379353,22,12697116447,-57262906
1636264192,-181783,true,12754379353,22,12735263081,-19116272
1636264340,-181787,true,12749278877,22,12746729403,-2549474
1636264372,-181786,true,12750553805,22,12749278877,-1274928
1636264433,-181788,true,12748004076,22,12753104043,5099967
1636264695,-181788,true,12748004076,22,12745454858,-2549218
1636264847,-181792,true,12742906149,22,12748004076,5097927
1636264953,-181791,true,12744180440,22,12744180440,0
1636265683,-181793,true,12741631986,22,12718718822,-22913164
1636265953,-181793,true,12741631986,22,12714903969,-26728017
1636265960,-181798,true,12735263081,22,12716175460,-19087621
1636266073,-181796,true,12737810261,22,12728897359,-8912902
1636266132,-181797,true,12736536607,22,12735263081,-1273526
1636266195,-181790,true,12745454858,22,12776079153,30624295
1636266596,-181798,true,12735263081,22,12811900510,76637429
1636266928,-181797,true,12736536607,22,12831131819,94595212
1636268560,-181801,true,12731443266,22,12699655998,-31787268
1636268903,-181793,true,12741631986,22,12678086001,-63545985
1636269351,-181801,true,12731443266,22,12648961365,-82481901
1636269471,-181800,true,12732716410,22,12642638781,-90077629
1636269528,-181805,true,12726351961,22,12637582990,-88768971
1636269560,-181798,true,12735263081,22,12636319358,-98943723
1636269654,-181808,true,12722534819,22,12631266094,-91268725
1636269865,-181809,true,12721262693,22,12618641772,-102620921
1636270018,-181813,true,12716175460,22,12609812255,-106363205
1636270096,-181806,true,12725079454,22,12604769591,-120309863
1636270433,-181816,true,12712361370,22,12580844461,-131516909
1636270639,-181817,true,12711090261,22,12575813381,-135276880
1636270688,-181821,true,12706007096,22,12572041391,-133965705
1636270808,-181813,true,12716175460,22,12574555925,-141619535
1636270988,-181821,true,12706007096,22,12577070962,-128936134
1636271172,-181822,true,12704736622,22,12583360756,-121375866
1636271200,-181826,true,12699655998,22,12584619092,-115036906
1636271248,-181821,true,12706007096,22,12584619092,-121388004
1636271376,-181829,true,12695846863,22,12583360756,-112486107
1636271556,-181832,true,12692038870,22,12583360756,-108678114
1636272148,-181837,true,12685694754,22,12559476262,-126218492
1636272186,-181833,true,12690769793,22,12558220440,-132549353
1636272565,-181841,true,12680621745,22,12546923690,-133698055
1636272761,-181844,true,12676818319,22,12540652110,-136166209
1636272881,-181849,true,12670481811,22,12534383665,-136098146
1636273089,-181843,true,12678086001,22,12551943213,-126142788
1636273999,-181849,true,12670481811,22,12627477472,-43004339
1636274081,-181851,true,12667948094,22,12617380034,-50568060
1636274209,-181856,true,12661616020,22,12594690311,-66925709
1636274317,-181850,true,12669214889,22,12575813381,-93401508
1636274332,-181860,true,12656552640,22,12570784313,-85768327
1636274415,-181862,true,12654021709,22,12553198407,-100823302
1636274500,-181867,true,12647696596,22,12534383665,-113312931
1636274506,-181861,true,12655287111,22,12533130352,-122156759
1636274691,-181871,true,12642638781,22,12483100458,-159538323
1636274773,-181873,true,12640110633,22,12460652209,-179458424
1636274850,-181879,true,12632529220,22,12437000629,-195528591
1636275021,-181872,true,12641374644,22,12410911635,-230463009
1636275335,-181881,true,12630003093,22,12393549383,-236453710
1636275468,-181883,true,12627477472,22,12398507547,-228969925
1636275616,-181888,true,12621165627,22,12402227471,-218938156
1636275665,-181882,true,12628740219,22,12402227471,-226512748
1636275692,-181889,true,12619903636,22,12402227471,-217676165
1636276011,-181892,true,12616118422,22,12417118332,-199000090
1636276193,-181896,true,12611073236,22,12435757053,-175316183
1636276217,-181890,true,12618641772,22,12437000629,-181641143
1636276611,-181898,true,12608551400,22,12461898275,-146653125
1636276636,-181900,true,12606030068,22,12461898275,-144131793
1636276870,-181905,true,12599728943,22,12466883782,-132845161
1636276956,-181899,true,12607290671,22,12465637218,-141653453
1636277579,-181908,true,12595949780,22,12441976175,-153973605
1636277690,-181910,true,12593430968,22,12443220373,-150210595
1636277713,-181915,true,12587136141,22,12443220373,-143915768
1636277759,-181909,true,12594690311,22,12443220373,-151469938
1636277788,-181916,true,12585877554,22,12443220373,-142657181
1636277980,-181919,true,12582102545,22,12441976175,-140126370
1636278926,-181923,true,12577070962,22,12441976175,-135094787
1636278973,-181916,true,12585877554,22,12441976175,-143901379
1636278996,-181923,true,12577070962,22,12441976175,-135094787
1636279020,-181925,true,12574555925,22,12441976175,-132579750
1636279227,-181929,true,12569527360,22,12440732102,-128795258
1636279320,-181922,true,12578328669,22,12440732102,-137596567
1636279429,-181929,true,12569527360,22,12440732102,-128795258
1636279479,-181932,true,12565757256,22,12439488153,-126269103
1636279643,-181936,true,12560732209,22,12437000629,-123731580
1636279667,-181930,true,12568270533,22,12435757053,-132513480
1636279797,-181938,true,12558220440,22,12439488153,-118732287
1636279877,-181939,true,12556964743,22,12440732102,-116232641
1636280244,-181942,true,12553198407,22,12450688172,-102510235
1636280277,-181936,true,12560732209,22,12451933241,-108798968
1636280326,-181943,true,12551943213,22,12458160453,-93782760
1636280438,-181945,true,12549433201,22,12479356277,-70076924
1636280540,-181947,true,12546923690,22,12499338229,-47585461
1636280584,-181942,true,12553198407,22,12508090391,-45108016
1636280975,-181949,true,12544414682,22,12565757256,21342574
1636281157,-181951,true,12541906175,22,12589653694,47747519
1636281197,-181953,true,12539398170,22,12593430968,54032798
1636281405,-181947,true,12546923690,22,12604769591,57845901
1636281476,-181953,true,12539398170,22,12608551400,69153230
1636281813,-181954,true,12538144356,22,12622427743,84283387
1636281889,-181956,true,12535637103,22,12624952355,89315252
1636281914,-181950,true,12543160366,22,12626214850,83054484
1636281950,-181957,true,12534383665,22,12628740219,94356554
1636281977,-181958,true,12533130352,22,12630003093,96872741
1636282576,-181961,true,12529371165,22,12624952355,95581190
1636282776,-181961,true,12529371165,22,12624952355,95581190
1636282852,-181965,true,12524360669,22,12624952355,100591686
1636282968,-181965,true,12524360669,22,12626214850,101854181
1636283204,-181965,true,12524360669,22,12633792473,109431804
1636283287,-181964,true,12525613105,22,12637582990,111969885
1636283308,-181966,true,12523108358,22,12640110633,117002275
1636283348,-181966,true,12523108358,22,12642638781,119530423
1636283361,-181963,true,12526865666,22,12645167436,118301770
1636283481,-181960,true,12530624102,22,12664148470,133524368
1636283710,-181961,true,12529371165,22,12699655998,170284833
1636283893,-181960,true,12530624102,22,12725079454,194455352
1636284036,-181957,true,12534383665,22,12741631986,207248321
1636284118,-181954,true,12538144356,22,12744180440,206036084
1636284169,-181955,true,12536890667,22,12745454858,208564191
1636284250,-181955,true,12536890667,22,12744180440,207289773
1636284367,-181953,true,12539398170,22,12733989682,194591512
1636284519,-181950,true,12543160366,22,12721262693,178102327
1636284935,-181951,true,12541906175,22,12684426312,142520137
1636285133,-181951,true,12541906175,22,12686963324,145057149
1636285348,-181949,true,12544414682,22,12686963324,142548642
1636285355,-181946,true,12548178383,22,12686963324,138784941
1636285474,-181947,true,12546923690,22,12692038870,145115180
1636285629,-181946,true,12548178383,22,12699655998,151477615
1636285779,-181943,true,12551943213,22,12717447077,165503864
1636285886,-181939,true,12556964743,22,12728897359,171932616
1636286142,-181939,true,12556964743,22,12754379353,197414610
1636286185,-181938,true,12558220440,22,12758206050,199985610
1636286240,-181934,true,12563244481,22,12760757819,197513338
1636286513,-181932,true,12565757256,22,12759481870,193724614
1636286609,-181935,true,12561988283,22,12750553805,188565522
1636286729,-181934,true,12563244481,22,12737810261,174565780
1636287191,-181930,true,12568270533,22,12711090261,142819728
1636287597,-181928,true,12570784313,22,12712361370,141577057
1636287614,-181927,true,12572041391,22,12713632606,141591215
1636287730,-181925,true,12574555925,22,12714903969,140348044
1636287829,-181920,true,12580844461,22,12716175460,135330999
1636287916,-181917,true,12584619092,22,12712361370,127742278
1636288293,-181916,true,12585877554,22,12693308074,107430520
1636288313,-181914,true,12588394855,22,12693308074,104913219
1636288973,-181910,true,12593430968,22,12635055852,41624884
1636289013,-181908,true,12595949780,22,12632529220,36579440
1636289038,-181908,true,12595949780,22,12631266094,35316314
1636289138,-181906,true,12598469096,22,12623689986,25220890
1636289168,-181903,true,12602249015,22,12622427743,20178728
1636289221,-181901,true,12604769591,22,12617380034,12610443
1636289676,-181901,true,12604769591,22,12603509240,-1260351
1636289685,-181900,true,12606030068,22,12603509240,-2520828
1636290152,-181898,true,12608551400,22,12594690311,-13861089
1636290538,-181895,true,12612334343,22,12618641772,6307429
1636290651,-181896,true,12611073236,22,12624952355,13879119
1636290862,-181895,true,12612334343,22,12636319358,23985015
1636290869,-181891,true,12617380034,22,12637582990,20202956
1636290890,-181888,true,12621165627,22,12638846748,17681121
1636291087,-181888,true,12621165627,22,12645167436,24001809
1636291113,-181888,true,12621165627,22,12645167436,24001809
1636291411,-181885,true,12624952355,22,12628740219,3787864
1636291683,-181883,true,12627477472,22,12607290671,-20186801
1636291750,-181884,true,12626214850,22,12598469096,-27745754
1636291892,-181883,true,12627477472,22,12579586502,-47890970
1636293799,-181881,true,12630003093,22,12530624102,-99378991
1636293931,-181880,true,12631266094,22,12524360669,-106905425
1636294039,-181881,true,12630003093,22,12520604112,-109398981
1636294051,-181880,true,12631266094,22,12519352177,-111913917
1636294139,-181880,true,12631266094,22,12510592134,-120673960
1636294665,-181879,true,12632529220,22,12469377283,-163151937
1636294666,-181880,true,12631266094,22,12469377283,-161888811
1636295194,-181879,true,12632529220,22,12458160453,-174368767
1636295331,-181879,true,12632529220,22,12456914761,-175614459
1636295479,-181878,true,12633792473,22,12456914761,-176877712
1636295508,-181879,true,12632529220,22,12456914761,-175614459
1636296556,-181879,true,12632529220,22,12446953712,-185575508
1636297090,-181879,true,12632529220,22,12444464695,-188064525
1636297300,-181878,true,12633792473,22,12444464695,-189327778
1636297629,-181880,true,12631266094,22,12444464695,-186801399
1636297764,-181881,true,12630003093,22,12443220373,-186782720
1636298109,-181884,true,12626214850,22,12440732102,-185482748
1636298174,-181884,true,12626214850,22,12440732102,-185482748
1636298251,-181886,true,12623689986,22,12445709141,-177980845
1636298407,-181886,true,12623689986,22,12455669194,-168020792
1636298700,-181888,true,12621165627,22,12473118470,-148047157
1636298705,-181888,true,12621165627,22,12474365782,-146799845
1636298706,-181890,true,12618641772,22,12474365782,-144275990
1636298771,-181890,true,12618641772,22,12484348768,-134293004
1636298878,-181890,true,12618641772,22,12500588163,-118053609
1636299124,-181890,true,12618641772,22,12534383665,-84258107
1636299260,-181892,true,12616118422,22,12544414682,-71703740
1636299383,-181892,true,12616118422,22,12553198407,-62920015
1636299506,-181892,true,12616118422,22,12560732209,-55386213
1636299806,-181892,true,12616118422,22,12573298595,-42819827
1636299976,-181894,true,12613595577,22,12574555925,-39039652
1636300051,-181894,true,12613595577,22,12574555925,-39039652
1636300188,-181894,true,12613595577,22,12577070962,-36524615
1636300363,-181894,true,12613595577,22,12580844461,-32751116
1636300492,-181897,true,12609812255,22,12579586502,-30225753
1636300495,-181897,true,12609812255,22,12579586502,-30225753
1636300681,-181898,true,12608551400,22,12574555925,-33995475
1636300726,-181901,true,12604769591,22,12572041391,-32728200
1636300984,-181904,true,12600988916,22,12561988283,-39000633
1636301045,-181905,true,12599728943,22,12559476262,-40252681
1636301226,-181907,true,12597209375,22,12545669124,-51540251
1636301279,-181909,true,12594690311,22,12541906175,-52784136
1636301412,-181913,true,12589653694,22,12523108358,-66545336
1636301452,-181913,true,12589653694,22,12516848682,-72805012
1636301793,-181915,true,12587136141,22,12473118470,-114017671
1636301860,-181918,true,12583360756,22,12464390779,-118969977
1636302116,-181922,true,12578328669,22,12438244329,-140084340
1636303292,-181922,true,12578328669,22,12428298210,-150030459
1636303570,-181925,true,12574555925,22,12427055504,-147500421
1636303606,-181927,true,12572041391,22,12427055504,-144985887
1636303680,-181932,true,12565757256,22,12425812923,-139944333
1636303986,-181933,true,12564500806,22,12420843840,-143656966
1636304094,-181937,true,12559476262,22,12422085924,-137390338
1636304312,-181939,true,12556964743,22,12423328133,-133636610
1636304381,-181945,true,12549433201,22,12423328133,-126105068
1636304383,-181946,true,12548178383,22,12423328133,-124850250
1636304584,-181948,true,12545669124,22,12435757053,-109912071
1636304726,-181950,true,12543160366,22,12443220373,-99939993
1636304896,-181954,true,12538144356,22,12450688172,-87456184
1636304933,-181954,true,12538144356,22,12451933241,-86211115
1636305179,-181957,true,12534383665,22,12469377283,-65006382
1636305443,-181958,true,12533130352,22,12479356277,-53774075
1636305547,-181962,true,12528118353,22,12481852273,-46266080
1636305551,-181962,true,12528118353,22,12481852273,-46266080
1636305712,-181965,true,12524360669,22,12485597203,-38763466
1636305719,-181966,true,12523108358,22,12486845763,-36262595
1636305780,-181969,true,12519352177,22,12486845763,-32506414
1636306064,-181970,true,12518100367,22,12470624221,-47476146
1636306137,-181973,true,12514345687,22,12459406269,-54939418
1636306400,-181975,true,12511843194,22,12420843840,-90999354
1636306506,-181978,true,12508090391,22,12413393941,-94696450
1636306702,-181979,true,12506839707,22,12400987372,-105852335
1636306768,-181981,true,12504338715,22,12397267820,-107070895
1636306773,-181982,true,12503088406,22,12397267820,-105820586
1636307441,-181985,true,12499338229,22,12382400764,-116937465
1636307785,-181987,true,12496838737,22,12373736549,-123102188
1636307929,-181989,true,12494339744,22,12373736549,-120603195
1636307991,-181990,true,12493090435,22,12373736549,-119353886
1636308173,-181995,true,12486845763,22,12366314905,-120530858
1636308442,-181997,true,12484348768,22,12353955389,-130393379
1636308514,-182000,true,12480604213,22,12350249943,-130354270
1636308943,-182002,true,12478108466,22,12330506330,-147602136
1636309352,-182006,true,12473118470,22,12329273403,-143845067
1636309438,-182009,true,12469377283,22,12329273403,-140103880
1636309486,-182011,true,12466883782,22,12330506330,-136377452
1636309525,-182012,true,12465637218,22,12329273403,-136363815
1636309630,-182015,true,12461898275,22,12331739380,-130158895
1636309650,-182017,true,12459406269,22,12332972554,-126433715
1636309657,-182018,true,12458160453,22,12332972554,-125187899
1636309690,-182018,true,12458160453,22,12332972554,-125187899
1636309709,-182022,true,12453178434,22,12332972554,-120205880
1636309847,-182024,true,12450688172,22,12331739380,-118948792
1636310081,-182024,true,12450688172,22,12326807918,-123880254
1636310085,-182024,true,12450688172,22,12326807918,-123880254
1636310292,-182027,true,12446953712,22,12320646362,-126307350
1636310598,-182030,true,12443220373,22,12309563323,-133657050
1636310704,-182029,true,12444464695,22,12307101779,-137362916
1636310969,-182029,true,12444464695,22,12304640728,-139823967
1636310983,-182033,true,12439488153,22,12304640728,-134847425
1636311094,-182035,true,12437000629,22,12310794279,-126206350
1636311112,-182034,true,12438244329,22,12312025359,-126218970
1636311188,-182033,true,12439488153,22,12316950907,-122537246
1636311476,-182037,true,12434513602,22,12314487887,-120025715
1636312045,-182040,true,12430783994,22,12300950074,-129833920
1636312570,-182039,true,12432027072,22,12294801444,-137225628
1636313078,-182038,true,12433270275,22,12292342852,-140927423
1636313118,-182043,true,12427055504,22,12292342852,-134712652
1636313722,-182047,true,12422085924,22,12257974149,-164111775
1636313767,-182048,true,12420843840,22,12255522922,-165320918
1636313854,-182047,true,12422085924,22,12251847001,-170238923
1636313990,-182052,true,12415876744,22,12246947487,-168929257
1636314697,-182054,true,12413393941,22,12313256561,-100137380
1636315003,-182057,true,12409670668,22,12329273403,-80397265
1636315115,-182056,true,12410911635,22,12329273403,-81638232
1636315164,-182061,true,12404708040,22,12328040598,-76667442
1636315170,-182063,true,12402227471,22,12328040598,-74186873
1636315278,-182065,true,12399747397,22,12332972554,-66774843
1636315365,-182064,true,12400987372,22,12335439272,-65548100
1636315399,-182069,true,12394788738,22,12337906483,-56882255
1636315453,-182070,true,12393549383,22,12342842386,-50706997
1636316044,-182072,true,12391071045,22,12396028217,4957172
1636316194,-182071,true,12392310152,22,12400987372,8677220
1636316216,-182075,true,12387354467,22,12400987372,13632905
1636316243,-182077,true,12384877368,22,12400987372,16110004
1636316267,-182079,true,12382400764,22,12402227471,19826707
1636316436,-182075,true,12387354467,22,12417118332,29763865
1636316500,-182078,true,12383639004,22,12423328133,39689129
1636316744,-182079,true,12382400764,22,12445709141,63308377
1636317137,-182080,true,12381162648,22,12483100458,101937810
1636317191,-182076,true,12386115856,22,12485597203,99481347
1636317220,-182078,true,12383639004,22,12485597203,101958199
1636317241,-182079,true,12382400764,22,12485597203,103196439
1636317250,-182079,true,12382400764,22,12485597203,103196439
1636317324,-182075,true,12387354467,22,12484348768,96994301
1636317440,-182077,true,12384877368,22,12483100458,98223090
1636317707,-182078,true,12383639004,22,12468130470,84491466
1636317723,-182078,true,12383639004,22,12466883782,83244778
1636318006,-182074,true,12388593203,22,12450688172,62094969
1636318149,-182077,true,12384877368,22,12443220373,58343005
1636318166,-182078,true,12383639004,22,12441976175,58337171
1636318484,-182078,true,12383639004,22,12430783994,47144990
1636318549,-182074,true,12388593203,22,12434513602,45920399
1636318596,-182076,true,12386115856,22,12434513602,48397746
1636318703,-182078,true,12383639004,22,12433270275,49631271
1636318837,-182078,true,12383639004,22,12433270275,49631271
1636318942,-182075,true,12387354467,22,12430783994,43429527
1636318957,-182078,true,12383639004,22,12428298210,44659206
1636319064,-182080,true,12381162648,22,12420843840,39681192
1636319294,-182082,true,12378686786,22,12404708040,26021254
1636319376,-182080,true,12381162648,22,12398507547,17344899
1636319608,-182083,true,12377449041,22,12376211420,-1237621
1636319824,-182085,true,12374973923,22,12360133602,-14840321
1636319847,-182086,true,12373736549,22,12360133602,-13602947
1636320025,-182085,true,12374973923,22,12346545609,-28428314
1636320125,-182087,true,12372499299,22,12349015042,-23484257
1636320152,-182089,true,12370025171,22,12349015042,-21010129
1636320168,-182090,true,12368788292,22,12349015042,-19773250
1636320335,-182086,true,12373736549,22,12351484968,-22251581
1636320366,-182088,true,12371262173,22,12352720117,-18542056
1636320505,-182090,true,12368788292,22,12353955389,-14832903
1636320747,-182091,true,12367551537,22,12342842386,-24709151
1636320810,-182089,true,12370025171,22,12346545609,-23479562
1636320928,-182090,true,12368788292,22,12351484968,-17303324
1636320993,-182091,true,12367551537,22,12347780264,-19771273
1636321062,-182093,true,12365078397,22,12344076671,-21001726
1636321534,-182091,true,12367551537,22,12308332490,-59219047
1636321614,-182092,true,12366314905,22,12305871192,-60443713
1636321881,-182093,true,12365078397,22,12293572087,-71506310
1636321906,-182095,true,12362605753,22,12292342852,-70262901
1636322012,-182093,true,12365078397,22,12289884752,-75193645
1636322108,-182094,true,12363842013,22,12287427144,-76414869
1636322588,-182095,true,12362605753,22,12278829385,-83776368
1636322819,-182097,true,12360133602,22,12275146472,-84987130
1636323184,-182095,true,12362605753,22,12276373987,-86231766
1636323314,-182096,true,12361369616,22,12276373987,-84995629
1636323395,-182098,true,12358897712,22,12275146472,-83751240
1636323580,-182099,true,12357661946,22,12277601624,-80060322
1636323621,-182098,true,12358897712,22,12267783962,-91113750
1636323655,-182100,true,12356426304,22,12264104362,-92321942
1636323806,-182101,true,12355190785,22,12260425867,-94764918
1636323955,-182103,true,12352720117,22,12251847001,-100873116
1636323963,-182101,true,12355190785,22,12251847001,-103343784
1636324080,-182102,true,12353955389,22,12254297492,-99657897
1636324398,-182102,true,12353955389,22,12261651909,-92303480
1636324406,-182103,true,12352720117,22,12261651909,-91068208
1636324590,-182102,true,12353955389,22,12276373987,-77581402
1636324762,-182102,true,12353955389,22,12282513402,-71441987
1636324845,-182103,true,12352720117,22,12287427144,-65292973
1636324898,-182105,true,12350249943,22,12287427144,-62822799
1636324999,-182105,true,12350249943,22,12282513402,-67736541
1636325078,-182105,true,12350249943,22,12278829385,-71420558
1636325139,-182105,true,12350249943,22,12276373987,-73875956
1636325248,-182106,true,12349015042,22,12271464665,-77550377
1636325485,-182106,true,12349015042,22,12262878075,-86136967
1636325669,-182105,true,12350249943,22,12278829385,-71420558
1636326172,-182103,true,12352720117,22,12326807918,-25912199
1636326179,-182104,true,12351484968,22,12326807918,-24677050
1636326279,-182102,true,12353955389,22,12336672816,-17282573
1636326690,-182101,true,12355190785,22,12346545609,-8645176
1636326726,-182102,true,12353955389,22,12346545609,-7409780
1636326764,-182103,true,12352720117,22,12346545609,-6174508
1636327307,-182102,true,12353955389,22,12339140274,-14815115
1636327368,-182101,true,12355190785,22,12337906483,-17284302
1636327498,-182102,true,12353955389,22,12335439272,-18516117
1636327527,-182103,true,12352720117,22,12334205852,-18514265
1636327684,-182103,true,12352720117,22,12324342926,-28377191
1636327874,-182103,true,12352720117,22,12315719336,-37000781
1636328139,-182105,true,12350249943,22,12298490253,-51759690
1636328277,-182108,true,12346545609,22,12289884752,-56660857
1636328592,-182108,true,12346545609,22,12280057268,-66488341
1636328615,-182108,true,12346545609,22,12278829385,-67716224
1636328628,-182110,true,12344076671,22,12277601624,-66475047
1636328638,-182112,true,12341608226,22,12276373987,-65234239
1636328706,-182116,true,12336672816,22,12271464665,-65208151
1636328735,-182117,true,12335439272,22,12269010740,-66428532
1636328788,-182118,true,12334205852,22,12271464665,-62741187
1636329256,-182119,true,12332972554,22,12291113741,-41858813
1636329322,-182123,true,12328040598,22,12293572087,-34468511
1636329699,-182123,true,12328040598,22,12324342926,-3697672
1636330388,-182125,true,12325575360,22,12304640728,-20934632
1636330657,-182125,true,12325575360,22,12291113741,-34461619
1636330790,-182129,true,12320646362,22,12277601624,-43044738
1636330898,-182131,true,12318182603,22,12259199947,-58982656
1636330945,-182134,true,12314487887,22,12239601889,-74885998
1636330949,-182137,true,12310794279,22,12238378052,-72416227
1636331115,-182147,true,12298490253,22,12159090522,-139399731
1636331128,-182152,true,12292342852,22,12148152810,-144190042
1636331205,-182157,true,12286198524,22,12097240106,-188958418
1636331231,-182160,true,12282513402,22,12081524696,-200988706
1636331362,-182173,true,12266557306,22,12009256184,-257301122
1636331395,-182177,true,12261651909,22,11994854439,-266797470
1636331434,-182180,true,12257974149,22,11976876543,-281097606
1636331485,-182183,true,12254297492,22,11954143218,-300154274
1636331520,-182194,true,12240825850,22,11935032837,-305793013
1636331542,-182198,true,12235930743,22,11925489106,-310441637
1636331599,-182203,true,12229814613,22,11894524654,-335289959
1636331620,-182207,true,12224923910,22,11880260497,-344663413
1636331676,-182219,true,12210263532,22,11845859368,-364404164
1636331777,-182226,true,12201719765,22,11777355661,-424364104
1636331793,-182233,true,12193181977,22,11765584781,-427597196
1636331836,-182237,true,12188305923,22,11745601276,-442704647
1636331973,-182250,true,12172472211,22,11692867447,-479604764
1636332187,-182255,true,12166387801,22,11659008943,-507378858
1636332234,-182261,true,12159090522,22,11654346505,-504744017
1636332441,-182264,true,12155443524,22,11619437601,-536005923
1636332504,-182277,true,12139652504,22,11617114062,-522538442
1636332537,-182281,true,12134797857,22,11618275773,-516522084
1636332966,-182286,true,12128732277,22,11685854182,-442878095
1636333019,-182288,true,12126306895,22,11689360289,-436946606
1636333304,-182303,true,12108131978,22,11656677491,-451454487
1636333384,-182307,true,12103289935,22,11646191725,-457098210
1636333508,-182315,true,12093611659,22,11629899279,-463712380
1636333559,-182317,true,12091193300,22,11624086073,-467107227
1636333753,-182331,true,12074278318,22,11593904212,-480374106
1636334024,-182335,true,12069449814,22,11569583774,-499866040
1636334056,-182342,true,12061004577,22,11568426932,-492577645
1636334087,-182345,true,12057387000,22,11567270205,-490116795
1636334102,-182358,true,12041723363,22,11567270205,-474453158
1636334143,-182363,true,12035704307,22,11566113593,-469590714
1636334196,-182370,true,12027282683,22,11564957097,-462325586
1636334284,-182374,true,12022472973,22,11555709294,-466763679
1636334353,-182389,true,12004453682,22,11539543428,-464910254
1636334375,-182395,true,11997253530,22,11534928764,-462324766
1636334446,-182405,true,11985262873,22,11507279510,-477983363
1636334492,-182412,true,11976876543,22,11490032392,-486844151
1636334519,-182427,true,11958925593,22,11483140784,-475784809
1636334661,-182431,true,11954143218,22,11449889576,-504253642
1636334720,-182441,true,11942195647,22,11432728474,-509467173
1636334864,-182445,true,11937419963,22,11411027997,-526391966
1636334874,-182460,true,11919528150,22,11408746133,-510782017
1636334940,-182465,true,11913570173,22,11396204039,-517366134
1636335030,-182474,true,11902853319,22,11381399339,-521453980
1636335088,-182480,true,11895714106,22,11370024197,-525689909
1636335137,-182496,true,11876697132,22,11362068363,-514628769
1636335180,-182500,true,11871947640,22,11357524672,-514422968
1636335198,-182510,true,11860082220,22,11352982797,-507099423
1636335350,-182516,true,11852968660,22,11355253507,-497715153
1636335364,-182532,true,11834020021,22,11356389033,-477630988
1636335401,-182537,true,11828104786,22,11357524672,-470580114
1636335438,-182546,true,11817464812,22,11357524672,-459940140
1636335502,-182552,true,11810376814,22,11356389033,-453987781
1636335510,-182568,true,11791496264,22,11357524672,-433971592
1636335554,-182572,true,11786780844,22,11360932270,-425848574
1636335639,-182582,true,11775000543,22,11368887309,-406113234
1636335684,-182587,true,11769114809,22,11368887309,-400227500
1636335773,-182602,true,11751475252,22,11376847918,-374627334
1636335838,-182606,true,11746775836,22,11383675733,-363100103
1636335876,-182615,true,11736209022,22,11384814101,-351394921
1636335921,-182620,true,11730342678,22,11387091177,-343251501
1636335950,-182636,true,11711590073,22,11389368709,-322221364
1636335975,-182639,true,11708077299,22,11393925140,-314152159
1636336356,-182646,true,11699884922,22,11478548676,-221336246
1636336392,-182651,true,11694036734,22,11486586071,-207450663
1636336463,-182666,true,11676509704,22,11492330513,-184179191
1636336548,-182670,true,11671840267,22,11491181395,-180658872
1636336701,-182677,true,11663673246,22,11498077828,-165595418
1636336768,-182682,true,11657843159,22,11500377558,-157465601
1636337524,-182696,true,11641534413,22,11503828016,-137706397
1636337798,-182700,true,11636878963,22,11494629094,-142249869
1636337920,-182707,true,11628736405,22,11490032392,-138704013
1636337988,-182711,true,11624086073,22,11488883503,-135202570
1636338035,-182725,true,11607824551,22,11488883503,-118941048
1636338137,-182728,true,11604342900,22,11487734730,-116608170
1636338313,-182737,true,11593904212,22,11475105800,-118798412
1636338362,-182743,true,11586950303,22,11471663957,-115286346
1636338421,-182758,true,11569583774,22,11465929845,-103653929
1636338475,-182762,true,11564957097,22,11462490754,-102466343
1636338839,-182769,true,11556864865,22,11472811123,-84053742
1636338979,-182774,true,11551088165,22,11492330513,-58757652
1636339064,-182787,true,11536082257,22,11496928135,-39154122
1636339191,-182790,true,11532622124,22,11507279510,-25342614
1636339241,-182794,true,11528010229,22,11510732039,-17278190
1636339301,-182798,true,11523400177,22,11514185604,-9214573
1636339326,-182805,true,11515337022,22,11516488556,1151534
1636339398,-182804,true,11516488556,22,11523400177,6911621
1636339788,-182805,true,11515337022,22,11530315946,14978924
1636340109,-182808,true,11511883112,22,11524552517,12669405
1636340145,-182814,true,11504978399,22,11525704972,20726573
1636340242,-182814,true,11504978399,22,11526857543,21879144
1636340287,-182816,true,11502677749,22,11529163030,26485281
1636340304,-182820,true,11498077828,22,11529163030,31085202
1636340308,-182827,true,11490032392,22,11529163030,39130638
1636340352,-182825,true,11492330513,22,11532622124,40291611
1636340374,-182825,true,11492330513,22,11534928764,42598251
1636340535,-182827,true,11490032392,22,11545314354,55281962
1636340658,-182831,true,11485437527,22,11551088165,65650638
1636341039,-182824,true,11493479746,22,11608985334,115505588
1636341124,-182822,true,11495778557,22,11624086073,128307516
1636341161,-182823,true,11494629094,22,11628736405,134107311
1636341924,-182827,true,11490032392,22,11641534413,151502021
1636342115,-182821,true,11496928135,22,11664839614,167911479
1636342174,-182819,true,11499227635,22,11673007451,173779816
1636342338,-182821,true,11496928135,22,11691698278,194770143
1636342438,-182823,true,11494629094,22,11703395238,208766144
1636342724,-182817,true,11501527596,22,11767938015,266410419
1636342965,-182815,true,11503828016,22,11798572930,294744914
1636343133,-182817,true,11501527596,22,11792675413,291147817
1636343177,-182817,true,11501527596,22,11791496264,289968668
1636343243,-182812,true,11507279510,22,11789138318,281858808
1636343272,-182810,true,11509581081,22,11787959522,278378441
1636343589,-182814,true,11504978399,22,11718618784,213640385
1636343605,-182814,true,11504978399,22,11713932508,208954109
1636344001,-182810,true,11509581081,22,11633388597,123807516
1636344043,-182808,true,11511883112,22,11627573648,115690536
1636344611,-182813,true,11506128897,22,11591585779,85456882
1636344712,-182813,true,11506128897,22,11588108998,81980101
1636344876,-182809,true,11510732039,22,11586950303,76218264
1636344915,-182806,true,11514185604,22,11586950303,72764699
1636344939,-182810,true,11509581081,22,11584633261,75052180
1636344973,-182808,true,11511883112,22,11589267809,77384697
1636345051,-182803,true,11517640205,22,11590426736,72786531
1636345090,-182797,true,11524552517,22,11590426736,65874219
1636345117,-182797,true,11524552517,22,11591585779,67033262
1636345234,-182795,true,11526857543,22,11590426736,63569193
1636345269,-182791,true,11531468977,22,11590426736,58957759
1636345356,-182786,true,11537235865,22,11591585779,54349914
1636345371,-182789,true,11533775387,22,11591585779,57810392
1636345375,-182787,true,11536082257,22,11591585779,55503522
1636345627,-182784,true,11539543428,22,11588108998,48565570
1636345763,-182780,true,11544159938,22,11584633261,40473323
1636345993,-182782,true,11541851452,22,11571897807,30046355
1636346010,-182780,true,11544159938,22,11570740733,26580795
1636346164,-182777,true,11547623532,22,11563800717,16177185
1636346335,-182772,true,11553398499,22,11553398499,0
1636346340,-182773,true,11552243274,22,11553398499,1155225
1636346381,-182771,true,11554553838,22,11551088165,-3465673
1636346402,-182768,true,11558020551,22,11549933172,-8087379
1636346443,-182764,true,11562644453,22,11547623532,-15020921
1636346461,-182766,true,11560332271,22,11546468885,-13863386
1636346480,-182763,true,11563800717,22,11546468885,-17331832
1636346675,-182763,true,11563800717,22,11528010229,-35790488
1636346698,-182760,true,11567270205,22,11525704972,-41565233
1636347315,-182764,true,11562644453,22,11454470219,-108174234
1636347526,-182763,true,11563800717,22,11446455296,-117345421
1636347680,-182764,true,11562644453,22,11447599942,-115044511
1636347777,-182761,true,11566113593,22,11449889576,-116224017
1636347815,-182765,true,11561488304,22,11452179669,-109308635
1636348310,-182762,true,11564957097,22,11479696531,-85260566
1636348894,-182762,true,11564957097,22,11483140784,-81816313
1636348981,-182762,true,11564957097,22,11481992585,-82964512
1636349071,-182766,true,11560332271,22,11479696531,-80635740
1636349166,-182764,true,11562644453,22,11471663957,-90980496
1636349198,-182765,true,11561488304,22,11468223146,-93265158
1636349241,-182765,true,11561488304,22,11463637003,-97851301
1636349276,-182770,true,11555709294,22,11460198600,-95510694
1636349299,-182768,true,11558020551,22,11457906904,-100113647
1636349426,-182769,true,11556864865,22,11446455296,-110409569
1636349709,-182769,true,11556864865,22,11415593093,-141271772
1636349808,-182774,true,11551088165,22,11400763205,-150324960
1636349908,-182772,true,11553398499,22,11396204039,-157194460
1636349988,-182772,true,11553398499,22,11393925140,-159473359
1636350182,-182771,true,11554553838,22,11405324194,-149229644
1636350249,-182775,true,11549933172,22,11408746133,-141187039
1636350438,-182772,true,11553398499,22,11421302031,-132096468
1636350880,-182772,true,11553398499,22,11451034565,-102363934
1636351149,-182772,true,11553398499,22,11446455296,-106943203
1636351340,-182778,true,11546468885,22,11440733785,-105735100
1636351528,-182776,true,11548778294,22,11431585315,-117192979
1636351604,-182776,true,11548778294,22,11429299341,-119478953
1636351683,-182777,true,11547623532,22,11428156526,-119467006
1636351709,-182781,true,11543005637,22,11428156526,-114849111
1636351756,-182778,true,11546468885,22,11428156526,-118312359
1636351977,-182776,true,11548778294,22,11447599942,-101178352
1636351982,-182778,true,11546468885,22,11448744702,-97724183
1636352132,-182781,true,11543005637,22,11475105800,-67899837
1636352235,-182778,true,11546468885,22,11487734730,-58734155
1636352267,-182775,true,11549933172,22,11491181395,-58751777
1636352462,-182777,true,11547623532,22,11513034301,-34589231
1636352572,-182782,true,11541851452,22,11516488556,-25362896
1636352667,-182779,true,11545314354,22,11513034301,-32280053
1636352782,-182780,true,11544159938,22,11498077828,-46082110
1636352785,-182784,true,11539543428,22,11496928135,-42615293
1636352825,-182789,true,11533775387,22,11488883503,-44891884
1636352899,-182788,true,11534928764,22,11470516905,-64411859
1636352954,-182792,true,11530315946,22,11456761228,-73554718
1636353016,-182796,true,11525704972,22,11435015134,-90689838
1636353106,-182803,true,11517640205,22,11408746133,-108894072
1636353266,-182803,true,11517640205,22,11368887309,-148752896
1636353768,-182807,true,11513034301,22,11291844968,-221189333
1636354220,-182811,true,11508430238,22,11291844968,-216585270
1636354346,-182818,true,11500377558,22,11291844968,-208532590
1636354761,-182821,true,11496928135,22,11289586937,-207341198
1636355491,-182826,true,11491181395,22,11280559331,-210622064
1636355546,-182832,true,11484289098,22,11273793363,-210495735
1636355705,-182840,true,11475105800,22,11247894728,-227211072
1636355931,-182843,true,11471663957,22,11222055589,-249608368
1636355985,-182850,true,11463637003,22,11217567889,-246069114
1636356413,-182853,true,11460198600,22,11181730833,-278467767
1636356589,-182858,true,11454470219,22,11197395436,-257074783
1636356750,-182860,true,11452179669,22,11218689645,-233490024
1636356877,-182865,true,11446455296,22,11245645487,-200809809
1636356892,-182866,true,11445310765,22,11247894728,-197416037
1636356972,-182868,true,11443022046,22,11265904864,-177117182
1636357095,-182867,true,11444166348,22,11299751631,-144414717
1636357112,-182871,true,11439589826,22,11304272210,-135317616
1636357235,-182872,true,11438445982,22,11338234246,-100211736
1636357810,-182873,true,11437302251,22,11435015134,-2287117
1636358073,-182874,true,11436158635,22,11433871747,-2286888
1636358305,-182878,true,11431585315,22,11430442271,-1143044
1636358482,-182879,true,11430442271,22,11429299341,-1142930
1636358626,-182881,true,11428156526,22,11427013824,-1142702
1636358637,-182880,true,11429299341,22,11427013824,-2285517
1636358837,-182884,true,11424728764,22,11438445982,13717218
1636358927,-182884,true,11424728764,22,11443022046,18293282
1636358989,-182885,true,11423586406,22,11445310765,21724359
1636359155,-182885,true,11423586406,22,11447599942,24013536
1636359219,-182888,true,11420160015,22,11456761228,36601213
1636359951,-182886,true,11422444161,22,11530315946,107871785
1636359993,-182887,true,11421302031,22,11534928764,113626733
1636360319,-182887,true,11421302031,22,11514185604,92883573
1636360567,-182890,true,11417876325,22,11481992585,64116260
1636360593,-182890,true,11417876325,22,11478548676,60672351
1636360710,-182891,true,11416734652,22,11460198600,43463948
1636360740,-182892,true,11415593093,22,11454470219,38877126
1636360872,-182895,true,11412169100,22,11433871747,21702647
1636360944,-182895,true,11412169100,22,11427013824,14844724
1636361034,-182895,true,11412169100,22,11425871237,13702137
1636361069,-182896,true,11411027997,22,11424728764,13700767
1636361111,-182898,true,11408746133,22,11423586406,14840273
1636361115,-182896,true,11411027997,22,11423586406,12558409
1636361169,-182895,true,11412169100,22,11422444161,10275061
1636361267,-182896,true,11411027997,22,11421302031,10274034
1636361630,-182898,true,11408746133,22,11428156526,19410393
1636362706,-182897,true,11409887008,22,11429299341,19412333
1636362737,-182897,true,11409887008,22,11430442271,20555263
1636362865,-182898,true,11408746133,22,11438445982,29699849
1636363211,-182900,true,11406464726,22,11455615666,49150940
1636363324,-182897,true,11409887008,22,11460198600,50311592
1636363420,-182897,true,11409887008,22,11464783367,54896359
1636363436,-182898,true,11408746133,22,11467076438,58330305
1636363439,-182898,true,11408746133,22,11467076438,58330305
1636363557,-182891,true,11416734652,22,11499227635,82492983
1636363608,-182885,true,11423586406,22,11523400177,99813771
1636363612,-182885,true,11423586406,22,11524552517,100966111
1636363643,-182885,true,11423586406,22,11536082257,112495851
1636363658,-182873,true,11437302251,22,11543005637,105703386
1636363670,-182865,true,11446455296,22,11549933172,103477876
1636363867,-182863,true,11448744702,22,11660174844,211430142
1636363909,-182861,true,11451034565,22,11689360289,238325724
1636363942,-182850,true,11463637003,22,11712761232,249124229
1636364019,-182842,true,11472811123,22,11765584781,292773658
1636364058,-182839,true,11476253311,22,11786780844,310527533
1636364256,-182838,true,11477400936,22,11912378935,434977999
1636364294,-182826,true,11491181395,22,11939807566,448626171
1636364716,-182814,true,11504978399,22,12150582562,645604163
1636364840,-182809,true,11510732039,22,12180995498,670263459
1636364895,-182806,true,11514185604,22,12191962781,677777177
1636364967,-182794,true,11528010229,22,12206601185,678590956
1636365150,-182783,true,11540697382,22,12237154336,696456954
1636365195,-182780,true,11544159938,22,12240825850,696665912
1636365225,-182779,true,11545314354,22,12238378052,693063698
1636365276,-182768,true,11558020551,22,12234707272,676686721
1636365405,-182759,true,11568426932,22,12216369885,647942953
1636365474,-182756,true,11571897807,22,12207821845,635924038
1636365495,-182756,true,11571897807,22,12205380647,633482840
1636365531,-182745,true,11584633261,22,12199279787,614646526
1636365655,-182734,true,11597382731,22,12184650163,587267432
1636365727,-182730,true,11602022380,22,12174906827,572884447
1636365743,-182730,true,11602022380,22,12172472211,570449831
1636365812,-182717,true,11617114062,22,12162738614,545624552
1636365907,-182704,true,11632225375,22,12167604439,535379064
1636365963,-182697,true,11640370376,22,12176124318,535753942
1636366076,-182693,true,11645027222,22,12202939937,557912715
1636366144,-182678,true,11662506996,22,12213926977,551419981
1636366565,-182664,true,11678845123,22,12303410387,624565264
1636366596,-182657,true,11687022767,22,12307101779,620079012
1636366721,-182653,true,11691698278,22,12323110615,631412337
1636367063,-182639,true,11708077299,22,12297260527,589183228
1636367206,-182626,true,11723306935,22,12286198524,562891589
1636367527,-182619,true,11731515712,22,12264104362,532588650
1636368513,-182617,true,11733862133,22,12177341931,443479798
1636368535,-182603,true,11750300222,22,12177341931,427041709
1636368649,-182590,true,11765584781,22,12177341931,411757150
1636368671,-182583,true,11773823161,22,12172472211,398649050
1636368729,-182580,true,11777355661,22,12160306431,382950770
1636369279,-182570,true,11789138318,22,12042927536,253789218
1636369385,-182559,true,11802112856,22,12021270846,219157990
1636369506,-182552,true,11810376814,22,12002053152,191676338
1636369649,-182551,true,11811557852,22,11999653101,188095249
1636369707,-182542,true,11822192507,22,12000853066,178660559
1636369792,-182533,true,11832836737,22,12000853066,168016329
1636369856,-182529,true,11837570582,22,12002053152,164482570
1636369911,-182528,true,11838754339,22,12006854693,168100354
1636369961,-182518,true,11850598422,22,12017665186,167066764
1636370077,-182507,true,11863640600,22,12035704307,172063707
1636370097,-182502,true,11869573607,22,12039315380,169741773
1636370106,-182501,true,11870760564,22,12040519311,169758747
1636370541,-182493,true,11880260497,22,12069449814,189189317
1636370735,-182481,true,11894524654,22,12104500264,209975610
1636370824,-182476,true,11900473105,22,12106921286,206448181
1636371524,-182476,true,11900473105,22,12096030503,195557398
1636371632,-182469,true,11908805936,22,12071863825,163057889
1636371652,-182458,true,11921912174,22,12069449814,147537640
1636371736,-182454,true,11926681655,22,12050155099,123473444
1636372153,-182459,true,11920720102,22,11962513629,41793527
1636372192,-182454,true,11926681655,22,11955338632,28656977
1636372432,-182444,true,11938613705,22,11905234009,-33379696
1636372559,-182439,true,11944584206,22,11894524654,-50059552
1636372608,-182443,true,11939807566,22,11894524654,-45282912
1636372782,-182437,true,11946973242,22,11894524654,-52448588
1636372929,-182426,true,11960121485,22,11893335320,-66786165
1636372939,-182421,true,11966102742,22,11893335320,-72767422
1636373053,-182423,true,11963709881,22,11911187816,-52522065
1636373100,-182415,true,11973284199,22,11917144602,-56139597
1636373335,-182402,true,11988858811,22,11952947923,-35910888
1636373613,-182397,true,11994854439,22,11994854439,0
1636373723,-182400,true,11991256703,22,12011658155,20401452
1636373929,-182393,true,11999653101,22,12027282683,27629582
1636374300,-182380,true,12015262013,22,12021270846,6008833
1636374417,-182374,true,12022472973,22,12018866952,-3606021
1636374507,-182377,true,12018866952,22,12017665186,-1201766
1636374595,-182370,true,12027282683,22,12016463539,-10819144
1636374665,-182358,true,12041723363,22,12015262013,-26461350
1636374771,-182352,true,12048950204,22,12014060607,-34889597
1636375470,-182356,true,12044131828,22,12003253357,-40878471
1636375603,-182349,true,12052565250,22,12011658155,-40907095
1636375725,-182337,true,12067036286,22,12017665186,-49371100
1636375883,-182331,true,12074278318,22,12023675220,-50603098
1636375891,-182333,true,12071863825,22,12024877588,-46986237
1636375925,-182332,true,12073071011,22,12024877588,-48193423
1636376189,-182323,true,12083941122,22,12053770507,-30170615
1636376881,-182317,true,12091193300,22,12100869641,9676341
1636376936,-182320,true,12087566667,22,12099659675,12093008
1636376961,-182322,true,12085149516,22,12100869641,15720125
1636377241,-182315,true,12093611659,22,12077900964,-15710695
1636377389,-182314,true,12094821020,22,12064623241,-30197779
1636377601,-182319,true,12088775424,22,12046540775,-42234649
1636378054,-182322,true,12085149516,22,12022472973,-62676543
1636378086,-182316,true,12092402419,22,12022472973,-69929446
1636378146,-182316,true,12092402419,22,12020068839,-72333580
1636378185,-182320,true,12087566667,22,12018866952,-68699715
1636378492,-182324,true,12082732849,22,12009256184,-73476665
1636378642,-182323,true,12083941122,22,12004453682,-79487440
1636379137,-182324,true,12082732849,22,11992455828,-90277021
1636379348,-182330,true,12075485746,22,11991256703,-84229043
1636379532,-182334,true,12070656759,22,11990057697,-80599062
1636379746,-182331,true,12074278318,22,11988858811,-85419507
1636379884,-182332,true,12073071011,22,11987660045,-85410966
1636379912,-182338,true,12065829703,22,11984064466,-81765237
1636379975,-182343,true,12059798598,22,11974481527,-85317071
1636380034,-182341,true,12062210678,22,11966102742,-96107936
1636380142,-182345,true,12057387000,22,11935032837,-122354163
1636380168,-182351,true,12050155099,22,11927874323,-122280776
1636380446,-182359,true,12040519311,22,11836386943,-204132368
1636380529,-182358,true,12041723363,22,11809195894,-232527469
1636380900,-182362,true,12036907878,22,11706906608,-330001270
1636381097,-182369,true,12028485412,22,11696375658,-332109754
1636381239,-182376,true,12020068839,22,11696375658,-323693181
1636381361,-182376,true,12020068839,22,11697545296,-322523543
1636381570,-182381,true,12014060607,22,11712761232,-301299375
1636381723,-182390,true,12003253357,22,11723306935,-279946422
1636381789,-182398,true,11993655074,22,11726824279,-266830795
1636382169,-182398,true,11993655074,22,11751475252,-242179822
1636382207,-182404,true,11986461399,22,11753825664,-232635735
1636382257,-182411,true,11978074231,22,11756176547,-221897684
1636382633,-182419,true,11968496082,22,11747950514,-220545568
1636382691,-182418,true,11969692932,22,11746775836,-222917096
1636383034,-182422,true,11964906251,22,11765584781,-199321470
1636383240,-182428,true,11957729820,22,11782067310,-175662510
1636383269,-182434,true,11950557692,22,11783245517,-167312175
1636384007,-182433,true,11951752748,22,11808015093,-143737655
1636384092,-182436,true,11948167939,22,11816283184,-131884755
1636384223,-182438,true,11945778664,22,11828104786,-117673878
1636384463,-182442,true,11941001547,22,11811557852,-129443695
1636384634,-182440,true,11943389867,22,11799752788,-143637079
1636384908,-182444,true,11938613705,22,11784423841,-154189864
1636384972,-182448,true,11933839453,22,11773823161,-160016292
1636385033,-182452,true,11929067110,22,11765584781,-163482329
1636385079,-182450,true,11931453043,22,11757352165,-174100878
1636385186,-182454,true,11926681655,22,11750300222,-176381433
1636385233,-182458,true,11921912174,22,11750300222,-171611952
1636385360,-182464,true,11914761530,22,11749125309,-165636221
1636385397,-182464,true,11914761530,22,11747950514,-166811016
1636385403,-182469,true,11908805936,22,11747950514,-160855422
1636385449,-182474,true,11902853319,22,11746775836,-156077483
1636385519,-182477,true,11899283177,22,11745601276,-153681901
1636385719,-182478,true,11898093368,22,11740904210,-157189158
1636385792,-182483,true,11892146105,22,11738556381,-153589724
1636385812,-182487,true,11887390436,22,11737382643,-150007793
1636386108,-182491,true,11882636668,22,11719790646,-162846022
1636386198,-182492,true,11881448523,22,11717447040,-164001483
1636386283,-182496,true,11876697132,22,11715103902,-161593230
1636386328,-182495,true,11877884802,22,11713932508,-163952294
1636386462,-182500,true,11871947640,22,11696375658,-175571982
1636387163,-182502,true,11869573607,22,11617114062,-252459545
1636387284,-182507,true,11863640600,22,11610146232,-253494368
1636387350,-182506,true,11864826964,22,11614790987,-250035977
1636387634,-182510,true,11860082220,22,11652015986,-208066234
1636387725,-182510,true,11860082220,22,11663673246,-196408974
1636387916,-182514,true,11855339373,22,11688191469,-167147904
1636388031,-182514,true,11855339373,22,11696375658,-158963715
1636388044,-182519,true,11849413481,22,11696375658,-153037823
1636388162,-182522,true,11845859368,22,11711590073,-134269295
1636388239,-182527,true,11839938214,22,11716275412,-123662802
1636388283,-182527,true,11839938214,22,11709248107,-130690107
1636388323,-182533,true,11832836737,22,11706906608,-125930129
1636388354,-182536,true,11829287596,22,11704565578,-124722018
1636388397,-182541,true,11823374726,22,11699884922,-123489804
1636388414,-182541,true,11823374726,22,11698715050,-124659676
1636388445,-182547,true,11816283184,22,11695206138,-121077046
1636388818,-182550,true,11812739008,22,11664839614,-147899394
1636388841,-182555,true,11806834410,22,11667172698,-139661712
1636388910,-182554,true,11808015093,22,11668339416,-139675677
1636389089,-182560,true,11800932763,22,11664839614,-136093149
1636389159,-182562,true,11798572930,22,11667172698,-131400232
1636389382,-182567,true,11792675413,22,11682349126,-110326287
1636389404,-182568,true,11791496264,22,11683517361,-107978903
1636389430,-182572,true,11786780844,22,11689360289,-97420555
1636389789,-182575,true,11783245517,22,11709248107,-73997410
1636389824,-182582,true,11775000543,22,11710419031,-64581512
1636389828,-182582,true,11775000543,22,11710419031,-64581512
1636389945,-182587,true,11769114809,22,11715103902,-54010907
1636390069,-182590,true,11765584781,22,11712761232,-52823549
1636390314,-182595,true,11759703753,22,11709248107,-50455646
1636390347,-182595,true,11759703753,22,11706906608,-52797145
1636390829,-182599,true,11755001047,22,11697545296,-57455751
1636390833,-182602,true,11751475252,22,11697545296,-53929956
1636391519,-182608,true,11744426834,22,11648521080,-95905754
1636392335,-182609,true,11743252508,22,11635715391,-107537117
1636392717,-182613,true,11738556381,22,11638042651,-100513730
1636392862,-182616,true,11735035519,22,11639206455,-95829064
1636393041,-182622,true,11727996961,22,11641534413,-86462548
1636393724,-182622,true,11727996961,22,11639206455,-88790506
1636393867,-182627,true,11722134721,22,11638042651,-84092070
1636393962,-182630,true,11718618784,22,11636878963,-81739821
1636394119,-182636,true,11711590073,22,11628736405,-82853668
1636394348,-182637,true,11710419031,22,11617114062,-93304969
1636394821,-182641,true,11705736035,22,11592744937,-112991098
1636395055,-182643,true,11703395238,22,11588108998,-115286240
1636395087,-182644,true,11702225016,22,11588108998,-114116018
1636395340,-182645,true,11701054910,22,11589267809,-111787101
1636395822,-182646,true,11699884922,22,11590426736,-109458186
1636396215,-182647,true,11698715050,22,11586950303,-111764747
1636396233,-182648,true,11697545296,22,11586950303,-110594993
1636396252,-182649,true,11696375658,22,11586950303,-109425355
1636396476,-182651,true,11694036734,22,11582316682,-111720052
1636396493,-182652,true,11692867447,22,11580000566,-112866881
1636396509,-182654,true,11690529225,22,11578842681,-111686544
1636396940,-182656,true,11688191469,22,11559176353,-129015116
1636397371,-182659,true,11684685713,22,11545314354,-139371359
1636397481,-182660,true,11683517361,22,11547623532,-135893829
1636397687,-182663,true,11680013007,22,11547623532,-132389475
1636397930,-182664,true,11678845123,22,11551088165,-127756958
1636397937,-182666,true,11676509704,22,11551088165,-125421539
1636398035,-182668,true,11674174752,22,11552243274,-121931478
1636398094,-182671,true,11670673200,22,11552243274,-118429926
1636398150,-182672,true,11669506249,22,11558020551,-111485698
1636398188,-182675,true,11666006098,22,11561488304,-104517794
1636398219,-182675,true,11666006098,22,11564957097,-101049001
1636398323,-182677,true,11663673246,22,11576527260,-87145986
1636398709,-182679,true,11661340862,22,11607824551,-53516311
1636399449,-182682,true,11657843159,22,11622923781,-34919378
1636399513,-182682,true,11657843159,22,11622923781,-34919378
1636399547,-182683,true,11656677491,22,11619437601,-37239890
1636399596,-182684,true,11655511940,22,11613629624,-41882316
1636399608,-182689,true,11649685932,22,11611307247,-38378685
1636399698,-182691,true,11647356344,22,11602022380,-45333964
1636399721,-182693,true,11645027222,22,11596223108,-48804114
1636399772,-182694,true,11643862836,22,11591585779,-52277057
1636399902,-182700,true,11636878963,22,11561488304,-75390659
1636400001,-182702,true,11634551936,22,11541851452,-92700484
1636400086,-182704,true,11632225375,22,11524552517,-107672858
1636400216,-182705,true,11631062268,22,11499227635,-131834633
1636400269,-182711,true,11624086073,22,11485437527,-138648546
1636400274,-182714,true,11620599544,22,11484289098,-136310446
1636400307,-182716,true,11618275773,22,11476253311,-142022462
1636400431,-182716,true,11618275773,22,11461344620,-156931153
1636400785,-182721,true,11612468378,22,11462490754,-149977624
1636401021,-182723,true,11610146232,22,11460198600,-149947632
1636401230,-182725,true,11607824551,22,11480844501,-126980050
1636401400,-182725,true,11607824551,22,11485437527,-122387024
1636401838,-182728,true,11604342900,22,11503828016,-100514884
1636401980,-182728,true,11604342900,22,11502677749,-101665151
1636402011,-182729,true,11603182582,22,11500377558,-102805024
1636402503,-182729,true,11603182582,22,11500377558,-102805024
1636402568,-182733,true,11598542469,22,11500377558,-98164911
1636402666,-182735,true,11596223108,22,11501527596,-94695512
1636402833,-182738,true,11592744937,22,11507279510,-85465427
1636402985,-182737,true,11593904212,22,11509581081,-84323131
1636403036,-182741,true,11589267809,22,11509581081,-79686728
1636403063,-182744,true,11585791724,22,11503828016,-81963708
1636403097,-182746,true,11583474913,22,11500377558,-83097355
1636403286,-182748,true,11581158566,22,11480844501,-100314065
1636403373,-182752,true,11576527260,22,11472811123,-103716137
1636403782,-182753,true,11575369723,22,11429299341,-146070382
1636404015,-182755,true,11573054996,22,11421302031,-151752965
1636404037,-182757,true,11570740733,22,11421302031,-149438702
1636404085,-182761,true,11566113593,22,11420160015,-145953578
1636404112,-182763,true,11563800717,22,11417876325,-145924392
1636404340,-182767,true,11559176353,22,11395064533,-164111820
1636404413,-182770,true,11555709294,22,11387091177,-168618117
1636404446,-182774,true,11551088165,22,11385952582,-165135583
1636404651,-182777,true,11547623532,22,11370024197,-177599335
1636404666,-182781,true,11543005637,22,11368887309,-174118328
1636404764,-182783,true,11540697382,22,11362068363,-178629019
1636405068,-182788,true,11534928764,22,11348442739,-186486025
1636405094,-182791,true,11531468977,22,11351847613,-179621364
1636405112,-182795,true,11526857543,22,11354118096,-172739447
1636405531,-182796,true,11525704972,22,11387091177,-138613795
1636405686,-182800,true,11521095843,22,11393925140,-127170703
1636405848,-182802,true,11518791969,22,11403043471,-115748498
1636405927,-182806,true,11514185604,22,11407605373,-106580231
1636406022,-182808,true,11511883112,22,11407605373,-104277739
1636406089,-182812,true,11507279510,22,11407605373,-99674137
1636406317,-182814,true,11504978399,22,11404183776,-100794623
1636406452,-182817,true,11501527596,22,11403043471,-98484125
1636406621,-182818,true,11500377558,22,11396204039,-104173519
1636406891,-182822,true,11495778557,22,11382537479,-113241078
1636406936,-182824,true,11493479746,22,11380261313,-113218433
1636406974,-182828,true,11488883503,22,11375710347,-113173156
1636407064,-182830,true,11486586071,22,11365477324,-121108747
1636407343,-182835,true,11480844501,22,11339368069,-141476432
1636407389,-182838,true,11477400936,22,11332566829,-144834107
1636407668,-182841,true,11473958404,22,11311056469,-162901935
1636407686,-182842,true,11472811123,22,11308794597,-164016526
1636407837,-182847,true,11467076438,22,11295232860,-171843578
1636408146,-182850,true,11463637003,22,11288458092,-175178911
1636408476,-182853,true,11460198600,22,11280559331,-179639269
1636408517,-182855,true,11457906904,22,11280559331,-177347573
1636408646,-182859,true,11453324887,22,11291844968,-161479919
1636408727,-182861,true,11451034565,22,11298621769,-152412796
1636408794,-182862,true,11449889576,22,11312187574,-137702002
1636408827,-182862,true,11449889576,22,11317844800,-132044776
1636409291,-182863,true,11448744702,22,11432728474,-16016228
1636409370,-182864,true,11447599942,22,11451034565,3434623
1636409472,-182865,true,11446455296,22,11463637003,17181707
1636409541,-182865,true,11446455296,22,11468223146,21767850
1636409675,-182867,true,11444166348,22,11473958404,29792056
1636409809,-182869,true,11441877858,22,11464783367,22905509
1636409839,-182869,true,11441877858,22,11461344620,19466762
1636409998,-182870,true,11440733785,22,11445310765,4576980
1636410070,-182873,true,11437302251,22,11437302251,0
1636410072,-182874,true,11436158635,22,11437302251,1143616
1636410296,-182874,true,11436158635,22,11431585315,-4573320
1636410323,-182875,true,11435015134,22,11433871747,-1143387
1636410491,-182876,true,11433871747,22,11457906904,24035157
1636410624,-182877,true,11432728474,22,11487734730,55006256
1636410724,-182876,true,11433871747,22,11517640205,83768458
1636410780,-182875,true,11435015134,22,11533775387,98760253
1636410804,-182874,true,11436158635,22,11541851452,105692817
1636410855,-182875,true,11435015134,22,11555709294,120694160
1636410946,-182874,true,11436158635,22,11581158566,144999931
1636410966,-182874,true,11436158635,22,11585791724,149633089
1636411012,-182871,true,11439589826,22,11596223108,156633282
1636411112,-182870,true,11440733785,22,11617114062,176380277
1636411181,-182868,true,11443022046,22,11631062268,188040222
1636411333,-182868,true,11443022046,22,11647356344,204334298
1636411454,-182864,true,11447599942,22,11648521080,200921138
1636411860,-182863,true,11448744702,22,11618275773,169531071
1636411990,-182862,true,11449889576,22,11608985334,159095758
1636412492,-182863,true,11448744702,22,11543005637,94260935
1636412762,-182860,true,11452179669,22,11516488556,64308887
1636412993,-182860,true,11452179669,22,11501527596,49347927
1636413235,-182859,true,11453324887,22,11496928135,43603248
1636413350,-182862,true,11449889576,22,11495778557,45888981
1636413373,-182860,true,11452179669,22,11494629094,42449425
1636413687,-182860,true,11452179669,22,11490032392,37852723
1636413875,-182859,true,11453324887,22,11486586071,33261184
1636414020,-182862,true,11449889576,22,11484289098,34399522
1636414149,-182860,true,11452179669,22,11483140784,30961115
1636414361,-182861,true,11451034565,22,11476253311,25218746
1636414974,-182861,true,11451034565,22,11455615666,4581101
1636415339,-182864,true,11447599942,22,11449889576,2289634
1636415608,-182862,true,11449889576,22,11449889576,0
1636416587,-182863,true,11448744702,22,11449889576,1144874
1636417085,-182862,true,11449889576,22,11492330513,42440937
1636417315,-182865,true,11446455296,22,11511883112,65427816
1636417377,-182863,true,11448744702,22,11516488556,67743854
1636417400,-182862,true,11449889576,22,11521095843,71206267
1636417414,-182860,true,11452179669,22,11523400177,71220508
1636417577,-182860,true,11452179669,22,11537235865,85056196
1636417990,-182855,true,11457906904,22,11593904212,135997308
1636418099,-182853,true,11460198600,22,11607824551,147625951
1636418439,-182852,true,11461344620,22,11636878963,175534343
1636418509,-182851,true,11462490754,22,11636878963,174388209
1636418600,-182846,true,11468223146,22,11643862836,175639690
1636418854,-182844,true,11470516905,22,11654346505,183829600
1636418874,-182839,true,11476253311,22,11654346505,178093194
1636418984,-182837,true,11478548676,22,11654346505,175797829
1636419073,-182833,true,11483140784,22,11656677491,173536707
1636419129,-182832,true,11484289098,22,11657843159,173554061
1636419452,-182827,true,11490032392,22,11664839614,174807222
1636419501,-182825,true,11492330513,22,11666006098,173675585
1636419536,-182820,true,11498077828,22,11668339416,170261588
1636419578,-182819,true,11499227635,22,11669506249,170278614
1636419625,-182811,true,11508430238,22,11677677355,169247117
1636419654,-182810,true,11509581081,22,11681181008,171599927
1636419659,-182805,true,11515337022,22,11682349126,167012104
1636419735,-182804,true,11516488556,22,11691698278,175209722
1636419751,-182795,true,11526857543,22,11697545296,170687753
1636419979,-182791,true,11531468977,22,11765584781,234115804
1636420524,-182781,true,11543005637,22,12024877588,481871951
1636420567,-182778,true,11546468885,22,12039315380,492846495
1636420689,-182769,true,11556864865,22,12073071011,516206146
1636420800,-182763,true,11563800717,22,12088775424,524974707
1636420891,-182754,true,11574212302,22,12103289935,529077633
1636420924,-182750,true,11578842681,22,12104500264,525657583
1636421410,-182743,true,11586950303,22,12045336242,458385939
1636422215,-182737,true,11593904212,22,12005654128,411749916
1636422223,-182726,true,11606663885,22,12005654128,398990243
1636423451,-182725,true,11607824551,22,11902853319,295028768
1636423698,-182718,true,11615952466,22,11902853319,286900853
1636423850,-182714,true,11620599544,22,11906424532,285824988
1636424397,-182702,true,11634551936,22,11923104366,288552430
1636424465,-182700,true,11636878963,22,11917144602,280265639
1636424476,-182693,true,11645027222,22,11915953006,270925784
1636425037,-182690,true,11648521080,22,11864826964,216305884
1636425055,-182680,true,11660174844,22,11863640600,203465756
1636425364,-182680,true,11660174844,22,11831653572,171478728
1636425481,-182675,true,11666006098,22,11825739519,159733421
1636425993,-182674,true,11667172698,22,11798572930,131400232
1636426157,-182668,true,11674174752,22,11795034066,120859314
1636426179,-182668,true,11674174752,22,11793854681,119679929
1636426365,-182663,true,11680013007,22,11786780844,106767837
1636426660,-182663,true,11680013007,22,11775000543,94987536
1636427089,-182656,true,11688191469,22,11757352165,69160696
1636427676,-182655,true,11689360289,22,11749125309,59765020
1636427875,-182651,true,11694036734,22,11747950514,53913780
1636427977,-182650,true,11695206138,22,11747950514,52744376
1636428133,-182642,true,11704565578,22,11749125309,44559731
1636428235,-182642,true,11704565578,22,11749125309,44559731
1636428335,-182638,true,11709248107,22,11749125309,39877202
1636428680,-182638,true,11709248107,22,11747950514,38702407
1636428905,-182633,true,11715103902,22,11745601276,30497374
1636429021,-182634,true,11713932508,22,11744426834,30494326
1636429173,-182633,true,11715103902,22,11743252508,28148606
1636429348,-182634,true,11713932508,22,11742078301,28145793
1636429409,-182630,true,11718618784,22,11743252508,24633724
1636429459,-182631,true,11717447040,22,11743252508,25805468
1636429788,-182630,true,11718618784,22,11740904210,22285426
1636429801,-182631,true,11717447040,22,11740904210,23457170
1636429969,-182627,true,11722134721,22,11739730237,17595516
1636430197,-182628,true,11720962625,22,11740904210,19941585
1636430313,-182627,true,11722134721,22,11738556381,16421660
1636430388,-182627,true,11722134721,22,11737382643,15247922
1636430546,-182623,true,11726824279,22,11737382643,10558364
1636430612,-182623,true,11726824279,22,11736209022,9384743
1636430840,-182622,true,11727996961,22,11731515712,3518751
1636430866,-182621,true,11729169761,22,11730342678,1172917
1636430894,-182616,true,11735035519,22,11729169761,-5865758
1636431268,-182615,true,11736209022,22,11717447040,-18761982
1636431573,-182614,true,11737382643,22,11715103902,-22278741
1636431608,-182612,true,11739730237,22,11715103902,-24626335
1636431655,-182607,true,11745601276,22,11720962625,-24638651
1636432566,-182603,true,11750300222,22,11817464812,67164590
1636432651,-182601,true,11752650399,22,11816283184,63632785
1636433502,-182599,true,11755001047,22,11825739519,70738472
1636433748,-182593,true,11762055811,22,11857710559,95654748
1636433769,-182589,true,11766761339,22,11860082220,93320881
1636433902,-182585,true,11771468750,22,11875509581,104040831
1636434347,-182580,true,11777355661,22,11925489106,148133445
1636434387,-182574,true,11784423841,22,11930260017,145836176
1636434634,-182570,true,11789138318,22,11927874323,138736005
1636434776,-182567,true,11792675413,22,11926681655,134006242
1636434983,-182563,true,11797393191,22,11921912174,124518983
1636435031,-182557,true,11804473397,22,11921912174,117438777
1636435108,-182555,true,11806834410,22,11919528150,112693740
1636435296,-182554,true,11808015093,22,11892146105,84131012
1636435604,-182553,true,11809195894,22,11843490551,34294657
1636435814,-182551,true,11811557852,22,11812739008,1181156
1636436332,-182549,true,11813920281,22,11783245517,-30674764
1636436444,-182548,true,11815101673,22,11783245517,-31856156
1636437193,-182547,true,11816283184,22,11811557852,-4725332
1636437382,-182544,true,11819828423,22,11818646558,-1181865
1636438118,-182543,true,11821010406,22,11813920281,-7090125
1636438283,-182543,true,11821010406,22,11811557852,-9452554
1636438321,-182542,true,11822192507,22,11811557852,-10634655
1636438759,-182539,true,11825739519,22,11810376814,-15362705
1636438854,-182537,true,11828104786,22,11810376814,-17727972
1636439015,-182537,true,11828104786,22,11816283184,-11821602
1636439030,-182536,true,11829287596,22,11817464812,-11822784
1636439172,-182532,true,11834020021,22,11822192507,-11827514
1636439390,-182530,true,11836386943,22,11828104786,-8282157
1636439402,-182533,true,11832836737,22,11829287596,-3549141
1636439689,-182534,true,11831653572,22,11828104786,-3548786
1636439908,-182531,true,11835203423,22,11824557064,-10646359
1636440040,-182530,true,11836386943,22,11818646558,-17740385
1636440106,-182534,true,11831653572,22,11817464812,-14188760
1636440271,-182537,true,11828104786,22,11811557852,-16546934
1636440325,-182540,true,11824557064,22,11809195894,-15361170
1636440849,-182541,true,11823374726,22,11779711250,-43663476
1636441058,-182545,true,11818646558,22,11793854681,-24791877
1636441953,-182548,true,11815101673,22,11863640600,48538927
1636442005,-182550,true,11812739008,22,11863640600,50901592
1636442091,-182550,true,11812739008,22,11864826964,52087956
1636442122,-182551,true,11811557852,22,11864826964,53269112
1636442194,-182553,true,11809195894,22,11866013447,56817553
1636442239,-182555,true,11806834410,22,11866013447,59179037
1636442534,-182553,true,11809195894,22,11870760564,61564670
1636442592,-182553,true,11809195894,22,11871947640,62751746
1636442779,-182554,true,11808015093,22,11877884802,69869709
1636443210,-182556,true,11805653844,22,11886201816,80547972
1636443282,-182554,true,11808015093,22,11883824932,75809839
1636444707,-182556,true,11805653844,22,11843490551,37836707
1636444814,-182555,true,11806834410,22,11843490551,36656141
1636444857,-182556,true,11805653844,22,11843490551,37836707
1636444889,-182553,true,11809195894,22,11843490551,34294657
1636446314,-182551,true,11811557852,22,11945778664,134220812
1636447361,-182551,true,11811557852,22,11869573607,58015755
1636447446,-182551,true,11811557852,22,11860082220,48524368
1636448147,-182550,true,11812739008,22,11785602284,-27136724
1636448315,-182550,true,11812739008,22,11773823161,-38915847
1636448597,-182550,true,11812739008,22,11776178043,-36560965
1636448780,-182551,true,11811557852,22,11776178043,-35379809
1636448963,-182549,true,11813920281,22,11776178043,-37742238
1636449269,-182549,true,11813920281,22,11775000543,-38919738
1636449423,-182550,true,11812739008,22,11773823161,-38915847
1636450167,-182550,true,11812739008,22,11765584781,-47154227
1636450252,-182548,true,11815101673,22,11770291720,-44809953
1636450540,-182548,true,11815101673,22,11778533397,-36568276
1636451019,-182548,true,11815101673,22,11787959522,-27142151
1636451254,-182549,true,11813920281,22,11776178043,-37742238
1636452047,-182548,true,11815101673,22,11740904210,-74197463
1636452159,-182548,true,11815101673,22,11739730237,-75371436
1636452420,-182548,true,11815101673,22,11738556381,-76545292
1636452728,-182549,true,11813920281,22,11733862133,-80058148
1636452780,-182548,true,11815101673,22,11733862133,-81239540
1636453058,-182548,true,11815101673,22,11730342678,-84758995
1636453296,-182549,true,11813920281,22,11726824279,-87096002
1636453524,-182549,true,11813920281,22,11726824279,-87096002
1636453632,-182549,true,11813920281,22,11725651714,-88268567
1636454465,-182549,true,11813920281,22,11704565578,-109354703
1636454626,-182550,true,11812739008,22,11702225016,-110513992
1636454750,-182551,true,11811557852,22,11701054910,-110502942
1636455511,-182552,true,11810376814,22,11563800717,-246576097
1636455596,-182555,true,11806834410,22,11549933172,-256901238
1636455604,-182556,true,11805653844,22,11548778294,-256875550
1636455759,-182557,true,11804473397,22,11549933172,-254540225
1636456069,-182558,true,11803293068,22,11562644453,-240648615
1636456290,-182560,true,11800932763,22,11571897807,-229034956
1636456398,-182562,true,11798572930,22,11575369723,-223203207
1636456642,-182563,true,11797393191,22,11574212302,-223180889
1636456699,-182566,true,11793854681,22,11573054996,-220799685
1636456970,-182570,true,11789138318,22,11563800717,-225337601
1636457292,-182572,true,11786780844,22,11553398499,-233382345
1636457324,-182574,true,11784423841,22,11553398499,-231025342
1636457450,-182578,true,11779711250,22,11549933172,-229778078
1636457529,-182582,true,11775000543,22,11554553838,-220446705
1636458048,-182585,true,11771468750,22,11591585779,-179882971
1636458143,-182587,true,11769114809,22,11597382731,-171732078
1636458414,-182590,true,11765584781,22,11618275773,-147309008
1636458626,-182594,true,11760879723,22,11619437601,-141442122
1636458641,-182597,true,11757352165,22,11618275773,-139076392
1636458832,-182598,true,11756176547,22,11614790987,-141385560
1636459483,-182602,true,11751475252,22,11591585779,-159889473
1636459867,-182604,true,11749125309,22,11586950303,-162175006
1636459932,-182605,true,11747950514,22,11586950303,-161000211
1636460097,-182607,true,11745601276,22,11584633261,-160968015
1636460506,-182611,true,11740904210,22,11570740733,-170163477
1636460683,-182613,true,11738556381,22,11563800717,-174755664
1636460742,-182615,true,11736209022,22,11562644453,-173564569
1636461118,-182615,true,11736209022,22,11590426736,-145782286
1636461320,-182618,true,11732688864,22,11607824551,-124864313
1636461418,-182620,true,11730342678,22,11608985334,-121357344
1636461740,-182622,true,11727996961,22,11607824551,-120172410
1636462158,-182624,true,11725651714,22,11577684913,-147966801
1636462166,-182628,true,11720962625,22,11577684913,-143277712
1636462423,-182630,true,11718618784,22,11583474913,-135143871
1636462594,-182631,true,11717447040,22,11586950303,-130496737
1636462751,-182633,true,11715103902,22,11590426736,-124677166
1636463205,-182637,true,11710419031,22,11596223108,-114195923
1636463444,-182639,true,11708077299,22,11593904212,-114173087
1636463466,-182640,true,11706906608,22,11593904212,-113002396
1636463567,-182642,true,11704565578,22,11593904212,-110661366
1636463602,-182645,true,11701054910,22,11593904212,-107150698
1636463678,-182647,true,11698715050,22,11595063602,-103651448
1636463824,-182649,true,11696375658,22,11597382731,-98992927
1636463845,-182650,true,11695206138,22,11597382731,-97823407
1636463923,-182652,true,11692867447,22,11597382731,-95484716
1636463934,-182655,true,11689360289,22,11597382731,-91977558
1636464068,-182658,true,11685854182,22,11597382731,-88471451
1636464466,-182659,true,11684685713,22,11593904212,-90781501
1636464522,-182663,true,11680013007,22,11592744937,-87268070
1636464552,-182666,true,11676509704,22,11592744937,-83764767
1636464794,-182669,true,11673007451,22,11586950303,-86057148
1636464949,-182670,true,11671840267,22,11584633261,-87207006
1636464974,-182674,true,11667172698,22,11584633261,-82539437
1636465081,-182677,true,11663673246,22,11583474913,-80198333
1636465124,-182681,true,11659008943,22,11583474913,-75534030
1636465460,-182680,true,11660174844,22,11608985334,-51189510
1636465556,-182684,true,11655511940,22,11615952466,-39559474
1636465601,-182685,true,11654346505,22,11619437601,-34908904
1636465657,-182688,true,11650850900,22,11627573648,-23277252
1636465809,-182686,true,11653181187,22,11649685932,-3495255
1636466827,-182689,true,11649685932,22,11709248107,59562175
1636466848,-182694,true,11643862836,22,11709248107,65385271
1636466864,-182696,true,11641534413,22,11708077299,66542886
1636467163,-182694,true,11643862836,22,11705736035,61873199
1636467388,-182697,true,11640370376,22,11683517361,43146985
1636467498,-182700,true,11636878963,22,11673007451,36128488
1636467589,-182700,true,11636878963,22,11663673246,26794283
1636467915,-182701,true,11635715391,22,11613629624,-22085767
1636468161,-182705,true,11631062268,22,11595063602,-35998666
1636468384,-182707,true,11628736405,22,11585791724,-42944681
1636468694,-182707,true,11628736405,22,11603182582,-25553823
1636468811,-182707,true,11628736405,22,11611307247,-17429158
1636468868,-182711,true,11624086073,22,11613629624,-10456449
1636468875,-182713,true,11621761604,22,11613629624,-8131980
1636469148,-182713,true,11621761604,22,11624086073,2324469
1636469788,-182713,true,11621761604,22,11631062268,9300664
1636470001,-182715,true,11619437601,22,11646191725,26754124
1636470393,-182718,true,11615952466,22,11635715391,19762925
1636470545,-182717,true,11617114062,22,11646191725,29077663
1636470577,-182716,true,11618275773,22,11645027222,26751449
1636470678,-182719,true,11614790987,22,11642698566,27907579
1636470850,-182721,true,11612468378,22,11626411006,13942628
1636471243,-182722,true,11611307247,22,11619437601,8130354
1636471535,-182722,true,11611307247,22,11592744937,-18562310
1636472054,-182725,true,11607824551,22,11582316682,-25507869
1636472057,-182726,true,11606663885,22,11582316682,-24347203
1636472205,-182727,true,11605503335,22,11580000566,-25502769
1636472236,-182726,true,11606663885,22,11580000566,-26663319
1636472277,-182727,true,11605503335,22,11580000566,-25502769
1636472423,-182727,true,11605503335,22,11577684913,-27818422
1636472686,-182727,true,11605503335,22,11568426932,-37076403
1636473319,-182726,true,11606663885,22,11556864865,-49799020
1636473710,-182728,true,11604342900,22,11549933172,-54409728
1636474416,-182728,true,11604342900,22,11541851452,-62491448
1636474549,-182728,true,11604342900,22,11543005637,-61337263
1636474918,-182727,true,11605503335,22,11540697382,-64805953
1636475134,-182729,true,11603182582,22,11532622124,-70560458
1636475489,-182729,true,11603182582,22,11526857543,-76325039
1636475635,-182729,true,11603182582,22,11524552517,-78630065
1636476023,-182728,true,11604342900,22,11547623532,-56719368
1636476449,-182729,true,11603182582,22,11571897807,-31284775
1636476584,-182729,true,11603182582,22,11576527260,-26655322
1636476750,-182730,true,11602022380,22,11566113593,-35908787
1636476967,-182729,true,11603182582,22,11552243274,-50939308
1636477646,-182733,true,11598542469,22,11516488556,-82053913
1636477826,-182733,true,11598542469,22,11516488556,-82053913
1636478025,-182735,true,11596223108,22,11516488556,-79734552
1636479042,-182734,true,11597382731,22,11501527596,-95855135
1636479145,-182736,true,11595063602,22,11498077828,-96985774
1636479176,-182736,true,11595063602,22,11498077828,-96985774
1636479382,-182738,true,11592744937,22,11493479746,-99265191
1636479503,-182738,true,11592744937,22,11490032392,-102712545
1636479741,-182740,true,11590426736,22,11481992585,-108434151
1636479840,-182740,true,11590426736,22,11478548676,-111878060
1636479852,-182742,true,11588108998,22,11478548676,-109560322
1636479893,-182742,true,11588108998,22,11476253311,-111855687
1636479928,-182746,true,11583474913,22,11475105800,-108369113
1636479964,-182746,true,11583474913,22,11475105800,-108369113
1636480476,-182747,true,11582316682,22,11479696531,-102620151
1636480913,-182747,true,11582316682,22,11483140784,-99175898
1636481048,-182749,true,11580000566,22,11483140784,-96859782
1636481173,-182750,true,11578842681,22,11480844501,-97998180
1636481214,-182751,true,11577684913,22,11479696531,-97988382
1636481250,-182751,true,11577684913,22,11479696531,-97988382
1636481630,-182755,true,11573054996,22,11471663957,-101391039
1636481794,-182755,true,11573054996,22,11468223146,-104831850
1636482319,-182756,true,11571897807,22,11454470219,-117427588
1636482499,-182757,true,11570740733,22,11448744702,-121996031
1636482644,-182760,true,11567270205,22,11444166348,-123103857
1636482731,-182761,true,11566113593,22,11443022046,-123091547
1636482826,-182763,true,11563800717,22,11441877858,-121922859
1636482853,-182764,true,11562644453,22,11441877858,-120766595
1636482898,-182767,true,11559176353,22,11441877858,-117298495
1636483658,-182767,true,11559176353,22,11439589826,-119586527
1636483730,-182769,true,11556864865,22,11439589826,-117275039
1636484284,-182770,true,11555709294,22,11437302251,-118407043
1636484618,-182773,true,11552243274,22,11435015134,-117228140
1636484707,-182773,true,11552243274,22,11433871747,-118371527
1636484808,-182775,true,11549933172,22,11433871747,-116061425
1636484925,-182775,true,11549933172,22,11438445982,-111487190
1636485275,-182779,true,11545314354,22,11421302031,-124012323
1636485541,-182780,true,11544159938,22,11407605373,-136554565
1636485615,-182782,true,11541851452,22,11405324194,-136527258
1636486407,-182784,true,11539543428,22,11401903281,-137640147
1636486959,-182789,true,11533775387,22,11398483394,-135291993
1636487085,-182790,true,11532622124,22,11396204039,-136418085
1636487364,-182792,true,11530315946,22,11409887008,-120428938
1636487618,-182795,true,11526857543,22,11424728764,-102128779
1636487690,-182799,true,11522247952,22,11428156526,-94091426
1636487755,-182800,true,11521095843,22,11436158635,-84937208
1636487785,-182802,true,11518791969,22,11439589826,-79202143
1636487958,-182804,true,11516488556,22,11457906904,-58581652
1636487990,-182806,true,11514185604,22,11463637003,-50548601
1636488013,-182806,true,11514185604,22,11467076438,-47109166
1636488198,-182806,true,11514185604,22,11504978399,-9207205
1636488721,-182803,true,11517640205,22,11603182582,85542377
1636488748,-182804,true,11516488556,22,11606663885,90175329
1636488811,-182804,true,11516488556,22,11619437601,102949045
1636489017,-182804,true,11516488556,22,11641534413,125045857
1636489094,-182801,true,11519943848,22,11641534413,121590565
1636489159,-182803,true,11517640205,22,11642698566,125058361
1636489289,-182804,true,11516488556,22,11643862836,127374280
1636489389,-182803,true,11517640205,22,11645027222,127387017
1636489491,-182800,true,11521095843,22,11646191725,125095882
1636489548,-182803,true,11517640205,22,11647356344,129716139
1636489687,-182804,true,11516488556,22,11646191725,129703169
1636489920,-182804,true,11516488556,22,11635715391,119226835
1636490251,-182801,true,11519943848,22,11621761604,101817756
1636490508,-182804,true,11516488556,22,11604342900,87854344
1636490679,-182805,true,11515337022,22,11596223108,80886086
1636490832,-182804,true,11516488556,22,11586950303,70461747
1636491178,-182801,true,11519943848,22,11608985334,89041486
1636491244,-182802,true,11518791969,22,11613629624,94837655
1636491511,-182803,true,11517640205,22,11629899279,112259074
1636491572,-182802,true,11518791969,22,11633388597,114596628
1636491612,-182799,true,11522247952,22,11635715391,113467439
1636492245,-182800,true,11521095843,22,11633388597,112292754
1636492395,-182801,true,11519943848,22,11633388597,113444749
1636492398,-182799,true,11522247952,22,11633388597,111140645
1636492455,-182796,true,11525704972,22,11632225375,106520403
1636492684,-182797,true,11524552517,22,11627573648,103021131
1636492699,-182798,true,11523400177,22,11626411006,103010829
1636493095,-182797,true,11524552517,22,11607824551,83272034
1636493213,-182794,true,11528010229,22,11600862294,72852065
1636493243,-182795,true,11526857543,22,11598542469,71684926
1636493295,-182795,true,11526857543,22,11600862294,74004751
1636494124,-182792,true,11530315946,22,11647356344,117040398
1636494338,-182790,true,11532622124,22,11619437601,86815477
1636494344,-182793,true,11529163030,22,11618275773,89112743
1636494979,-182795,true,11526857543,22,11529163030,2305487
1636495046,-182794,true,11528010229,22,11522247952,-5762277
1636495149,-182792,true,11530315946,22,11521095843,-9220103
1636495218,-182793,true,11529163030,22,11519943848,-9219182
1636495338,-182795,true,11526857543,22,11517640205,-9217338
1636495376,-182794,true,11528010229,22,11517640205,-10370024
1636495664,-182792,true,11530315946,22,11514185604,-16130342
1636495848,-182793,true,11529163030,22,11511883112,-17279918
1636495901,-182795,true,11526857543,22,11510732039,-16125504
1636495965,-182794,true,11528010229,22,11507279510,-20730719
1636496167,-182791,true,11531468977,22,11503828016,-27640961
1636496297,-182791,true,11531468977,22,11510732039,-20736938
1636496324,-182793,true,11529163030,22,11511883112,-17279918
1636496607,-182792,true,11530315946,22,11515337022,-14978924
1636496832,-182789,true,11533775387,22,11519943848,-13831539
1636496855,-182789,true,11533775387,22,11521095843,-12679544
1636497150,-182791,true,11531468977,22,11525704972,-5764005
1636497286,-182790,true,11532622124,22,11529163030,-3459094
1636497348,-182786,true,11537235865,22,11531468977,-5766888
1636497456,-182787,true,11536082257,22,11533775387,-2306870
1636497703,-182787,true,11536082257,22,11559176353,23094096
1636497867,-182786,true,11537235865,22,11573054996,35819131
1636498063,-182782,true,11541851452,22,11573054996,31203544
1636498150,-182783,true,11540697382,22,11568426932,27729550
1636498468,-182784,true,11539543428,22,11547623532,8080104
1636498600,-182783,true,11540697382,22,11534928764,-5768618
1636498801,-182780,true,11544159938,22,11517640205,-26519733
1636499112,-182780,true,11544159938,22,11514185604,-29974334
1636499150,-182781,true,11543005637,22,11514185604,-28820033
1636499680,-182781,true,11543005637,22,11503828016,-39177621
1636499764,-182777,true,11547623532,22,11503828016,-43795516
1636499951,-182777,true,11547623532,22,11513034301,-34589231
1636499984,-182778,true,11546468885,22,11515337022,-31131863
1636500402,-182776,true,11548778294,22,11534928764,-13849530
1636500605,-182773,true,11552243274,22,11548778294,-3464980
1636500659,-182773,true,11552243274,22,11551088165,-1155109
1636500786,-182774,true,11551088165,22,11552243274,1155109
1636500923,-182772,true,11553398499,22,11552243274,-1155225
1636500980,-182768,true,11558020551,22,11553398499,-4622052
1636501234,-182767,true,11559176353,22,11554553838,-4622515
1636501414,-182768,true,11558020551,22,11552243274,-5777277
1636501543,-182766,true,11560332271,22,11548778294,-11553977
1636501600,-182762,true,11564957097,22,11547623532,-17333565
1636501843,-182762,true,11564957097,22,11539543428,-25413669
1636501909,-182763,true,11563800717,22,11537235865,-26564852
1636501936,-182761,true,11566113593,22,11538389589,-27724004
1636501946,-182758,true,11569583774,22,11539543428,-30040346
1636502000,-182757,true,11570740733,22,11541851452,-28889281
1636502724,-182758,true,11569583774,22,11582316682,12732908
1636502877,-182756,true,11571897807,22,11585791724,13893917
1636503119,-182754,true,11574212302,22,11578842681,4630379
1636503182,-182754,true,11574212302,22,11576527260,2314958
1636503239,-182755,true,11573054996,22,11574212302,1157306
1636503470,-182756,true,11571897807,22,11564957097,-6940710
1636504139,-182757,true,11570740733,22,11548778294,-21962439
1636504437,-182757,true,11570740733,22,11528010229,-42730504
1636504455,-182759,true,11568426932,22,11526857543,-41569389
1636504526,-182761,true,11566113593,22,11519943848,-46169745
1636504929,-182764,true,11562644453,22,11485437527,-77206926
1636505333,-182765,true,11561488304,22,11467076438,-94411866
1636505525,-182767,true,11559176353,22,11462490754,-96685599
1636505720,-182768,true,11558020551,22,11459052694,-98967857
1636505854,-182771,true,11554553838,22,11461344620,-93209218
1636505932,-182772,true,11553398499,22,11462490754,-90907745
1636506180,-182773,true,11552243274,22,11468223146,-84020128
1636506232,-182774,true,11551088165,22,11469369968,-81718197
1636506399,-182777,true,11547623532,22,11463637003,-83986529
1636506511,-182778,true,11546468885,22,11462490754,-83978131
1636506683,-182779,true,11545314354,22,11461344620,-83969734
1636506691,-182779,true,11545314354,22,11461344620,-83969734
1636506954,-182783,true,11540697382,22,11456761228,-83936154
1636507062,-182784,true,11539543428,22,11453324887,-86218541
1636507183,-182786,true,11537235865,22,11452179669,-85056196
1636507318,-182787,true,11536082257,22,11457906904,-78175353
1636507584,-182790,true,11532622124,22,11457906904,-74715220
1636508647,-182791,true,11531468977,22,11455615666,-75853311
1636508674,-182793,true,11529163030,22,11453324887,-75838143
1636508965,-182794,true,11528010229,22,11459052694,-68957535
1636509468,-182797,true,11524552517,22,11469369968,-55182549
1636510212,-182797,true,11524552517,22,11472811123,-51741394
1636510402,-182799,true,11522247952,22,11469369968,-52877984
1636510613,-182799,true,11522247952,22,11456761228,-65486724
1636511006,-182802,true,11518791969,22,11456761228,-62030741
1636511342,-182802,true,11518791969,22,11460198600,-58593369
1636511703,-182804,true,11516488556,22,11464783367,-51705189
1636511959,-182806,true,11514185604,22,11459052694,-55132910
1636512011,-182809,true,11510732039,22,11457906904,-52825135
1636512342,-182807,true,11513034301,22,11495778557,-17255744
1636512492,-182806,true,11514185604,22,11513034301,-1151303
1636513013,-182804,true,11516488556,22,11563800717,47312161
1636513158,-182807,true,11513034301,22,11562644453,49610152
1636513219,-182806,true,11514185604,22,11561488304,47302700
1636513575,-182804,true,11516488556,22,11560332271,43843715
1636514102,-182803,true,11517640205,22,11548778294,31138089
1636514512,-182806,true,11514185604,22,11541851452,27665848
1636514599,-182805,true,11515337022,22,11525704972,10367950
1636515062,-182805,true,11515337022,22,11471663957,-43673065
1636515194,-182804,true,11516488556,22,11451034565,-65453991
1636515208,-182809,true,11510732039,22,11449889576,-60842463
1636515307,-182808,true,11511883112,22,11438445982,-73437130
1636515543,-182808,true,11511883112,22,11430442271,-81440841
1636515659,-182808,true,11511883112,22,11429299341,-82583771
1636515731,-182813,true,11506128897,22,11428156526,-77972371
1636516218,-182810,true,11509581081,22,11473958404,-35622677
1636516259,-182810,true,11509581081,22,11477400936,-32180145
1636516396,-182809,true,11510732039,22,11488883503,-21848536
1636516645,-182814,true,11504978399,22,11495778557,-9199842
1636516707,-182812,true,11507279510,22,11492330513,-14948997
1636516878,-182814,true,11504978399,22,11480844501,-24133898
1636516997,-182814,true,11504978399,22,11472811123,-32167276
1636517316,-182819,true,11499227635,22,11453324887,-45902748
1636518345,-182817,true,11501527596,22,11441877858,-59649738
1636518828,-182818,true,11500377558,22,11432728474,-67649084
1636518933,-182818,true,11500377558,22,11428156526,-72221032
1636519101,-182823,true,11494629094,22,11419018113,-75610981
1636519215,-182821,true,11496928135,22,11421302031,-75626104
1636519379,-182821,true,11496928135,22,11428156526,-68771609
1636519420,-182820,true,11498077828,22,11429299341,-68778487
1636519445,-182824,true,11493479746,22,11430442271,-63037475
1636519450,-182823,true,11494629094,22,11430442271,-64186823
1636519560,-182824,true,11493479746,22,11432728474,-60751272
1636519689,-182824,true,11493479746,22,11436158635,-57321111
1636519910,-182829,true,11487734730,22,11445310765,-42423965
1636520002,-182828,true,11488883503,22,11447599942,-41283561
1636520168,-182829,true,11487734730,22,11435015134,-52719596
1636520298,-182830,true,11486586071,22,11424728764,-61857307
1636520380,-182834,true,11481992585,22,11428156526,-53836059
1636520924,-182832,true,11484289098,22,11440733785,-43555313
1636521246,-182833,true,11483140784,22,11451034565,-32106219
1636521470,-182834,true,11481992585,22,11439589826,-42402759
1636522388,-182838,true,11477400936,22,11440733785,-36667151
1636522564,-182836,true,11479696531,22,11448744702,-30951829
1636522954,-182836,true,11479696531,22,11468223146,-11473385
1636523429,-182836,true,11479696531,22,11483140784,3444253
1636523585,-182840,true,11475105800,22,11483140784,8034984
1636523939,-182839,true,11476253311,22,11481992585,5739274
1636524104,-182840,true,11475105800,22,11483140784,8034984
1636524294,-182840,true,11475105800,22,11484289098,9183298
1636524474,-182844,true,11470516905,22,11484289098,13772193
1636524498,-182843,true,11471663957,22,11484289098,12625141
1636524787,-182844,true,11470516905,22,11484289098,13772193
1636524847,-182843,true,11471663957,22,11484289098,12625141
1636524871,-182847,true,11467076438,22,11484289098,17212660
1636524941,-182845,true,11469369968,22,11479696531,10326563
1636525498,-182845,true,11469369968,22,11501527596,32157628
1636525584,-182844,true,11470516905,22,11504978399,34461494
1636525909,-182845,true,11469369968,22,11518791969,49422001
1636525973,-182843,true,11471663957,22,11518791969,47128012
1636526028,-182842,true,11472811123,22,11518791969,45980846
1636526218,-182842,true,11472811123,22,11517640205,44829082
1636526455,-182843,true,11471663957,22,11510732039,39068082
1636526501,-182841,true,11473958404,22,11507279510,33321106
1636526571,-182842,true,11472811123,22,11502677749,29866626
1636526621,-182842,true,11472811123,22,11499227635,26416512
1636526735,-182844,true,11470516905,22,11490032392,19515487
1636527048,-182842,true,11472811123,22,11461344620,-11466503
1636527408,-182842,true,11472811123,22,11436158635,-36652488
1636527914,-182842,true,11472811123,22,11427013824,-45797299
1636527977,-182845,true,11469369968,22,11427013824,-42356144
1636528604,-182843,true,11471663957,22,11427013824,-44650133
1636528730,-182843,true,11471663957,22,11428156526,-43507431
1636528852,-182844,true,11470516905,22,11428156526,-42360379
1636528856,-182846,true,11468223146,22,11428156526,-40066620
1636528928,-182845,true,11469369968,22,11427013824,-42356144
1636528931,-182845,true,11469369968,22,11427013824,-42356144
1636529113,-182844,true,11470516905,22,11432728474,-37788431
1636529175,-182847,true,11467076438,22,11433871747,-33204691
1636529947,-182845,true,11469369968,22,11448744702,-20625266
1636530056,-182845,true,11469369968,22,11447599942,-21770026
1636530610,-182845,true,11469369968,22,11436158635,-33211333
1636530615,-182848,true,11465929845,22,11436158635,-29771210
1636530860,-182847,true,11467076438,22,11427013824,-40062614
1636530996,-182847,true,11467076438,22,11423586406,-43490032
1636531029,-182847,true,11467076438,22,11422444161,-44632277
1636531107,-182849,true,11464783367,22,11420160015,-44623352
1636531153,-182850,true,11463637003,22,11417876325,-45760678
1636531367,-182849,true,11464783367,22,11432728474,-32054893
1636531946,-182850,true,11463637003,22,11478548676,14911673
1636533008,-182853,true,11460198600,22,11469369968,9171368
1636533050,-182853,true,11460198600,22,11468223146,8024546
1636533453,-182853,true,11460198600,22,11467076438,6877838
1636534105,-182854,true,11459052694,22,11457906904,-1145790
1636534582,-182857,true,11455615666,22,11453324887,-2290779
1636534868,-182857,true,11455615666,22,11448744702,-6870964
1636535003,-182855,true,11457906904,22,11447599942,-10306962
1636535248,-182854,true,11459052694,22,11444166348,-14886346
1636535863,-182857,true,11455615666,22,11401903281,-53712385
1636536245,-182858,true,11454470219,22,11395064533,-59405686
1636537085,-182856,true,11456761228,22,11395064533,-61696695
1636537394,-182856,true,11456761228,22,11385952582,-70808646
1636537606,-182859,true,11453324887,22,11381399339,-71925548
1636537958,-182861,true,11451034565,22,11392785862,-58248703
1636538036,-182860,true,11452179669,22,11396204039,-55975630
1636538124,-182860,true,11452179669,22,11399623242,-52556427
1636538315,-182862,true,11449889576,22,11406464726,-43424850
1636538584,-182863,true,11448744702,22,11414451648,-34293054
1636538639,-182862,true,11449889576,22,11413310317,-36579259
1636538703,-182862,true,11449889576,22,11412169100,-37720476
1636538819,-182863,true,11448744702,22,11407605373,-41139329
1636538970,-182865,true,11446455296,22,11401903281,-44552015
1636539528,-182864,true,11447599942,22,11381399339,-66200603
1636539757,-182864,true,11447599942,22,11375710347,-71889595
1636540087,-182866,true,11445310765,22,11374572889,-70737876
1636540326,-182867,true,11444166348,22,11373435546,-70730802
1636540427,-182867,true,11444166348,22,11372298316,-71868032
1636540506,-182867,true,11444166348,22,11371161200,-73005148
1636540584,-182869,true,11441877858,22,11368887309,-72990549
1636541499,-182869,true,11441877858,22,11449889576,8011718
1636541528,-182867,true,11444166348,22,11448744702,4578354
1636541628,-182867,true,11444166348,22,11447599942,3433594
1636541735,-182869,true,11441877858,22,11444166348,2288490
1636541933,-182869,true,11441877858,22,11438445982,-3431876
1636542082,-182868,true,11443022046,22,11425871237,-17150809
1636542096,-182868,true,11443022046,22,11422444161,-20577885
1636542589,-182871,true,11439589826,22,11380261313,-59328513
1636543044,-182872,true,11438445982,22,11364340890,-74105092
1636543247,-182871,true,11439589826,22,11360932270,-78657556
1636543493,-182871,true,11439589826,22,11356389033,-83200793
1636543514,-182874,true,11436158635,22,11355253507,-80905128
1636543561,-182876,true,11433871747,22,11354118096,-79753651
1636543710,-182875,true,11435015134,22,11349577584,-85437550
1636543956,-182876,true,11433871747,22,11342770220,-91101527
1636544108,-182880,true,11429299341,22,11343904497,-85394844
1636544245,-182882,true,11427013824,22,11340502006,-86511818
1636544671,-182882,true,11427013824,22,11323504854,-103508970
1636545595,-182883,true,11425871237,22,11309925476,-115945761
1636545745,-182887,true,11421302031,22,11309925476,-111376555
1636545754,-182889,true,11419018113,22,11309925476,-109092637
1636546500,-182889,true,11419018113,22,11282815555,-136202558
1636546574,-182891,true,11416734652,22,11279431388,-137303264
1636546756,-182895,true,11412169100,22,11277175840,-134993260
1636546795,-182897,true,11409887008,22,11270411902,-139475106
1636546858,-182901,true,11405324194,22,11251269434,-154054760
1636546926,-182906,true,11399623242,22,11217567889,-182055353
1636547204,-182920,true,11383675733,22,11082659902,-301015831
1636547286,-182923,true,11380261313,22,11053883850,-326377463
1636547355,-182927,true,11375710347,22,11028490400,-347219947
1636547615,-182932,true,11370024197,22,10925313441,-444710756
1636547728,-182944,true,11356389033,22,10896945938,-459443095
1636547880,-182945,true,11355253507,22,10920944408,-434309099
1636548104,-182948,true,11351847613,22,10961424720,-390422893
1636548167,-182951,true,11348442739,22,10962520863,-385921876
1636548309,-182962,true,11335966939,22,10972391079,-363575860
1636548460,-182964,true,11333700086,22,10974585667,-359114419
1636548523,-182968,true,11329167739,22,10975683126,-353484613
1636548597,-182971,true,11325769668,22,10980074057,-345695611
1636548739,-182981,true,11314450125,22,10977878372,-336571753
1636549786,-182982,true,11313318793,22,10975683126,-337635667
1636549927,-182986,true,11308794597,22,10972391079,-336403518
1636549931,-182989,true,11305402637,22,10972391079,-333011558
1636549941,-183000,true,11292974152,22,10972391079,-320583073
1636550155,-183002,true,11290715896,22,10963617115,-327098781
1636550175,-183007,true,11285072231,22,10958136951,-326935280
1636550274,-183011,true,11280559331,22,10940618826,-339940505
1636550322,-183024,true,11265904864,22,10916577122,-349327742
1636550338,-183031,true,11258021884,22,10911120470,-346901414
1636550416,-183034,true,11254645153,22,10903485740,-351159413
1636550633,-183039,true,11249019518,22,10856703744,-392315774
1636550786,-183051,true,11235529465,22,10826349008,-409180457
1636550872,-183058,true,11227667739,22,10802558409,-425109330
1636550927,-183062,true,11223177795,22,10786367527,-436810268
1636551073,-183067,true,11217567889,22,10756209446,-461358443
1636551121,-183079,true,11204115553,22,10750832955,-453282598
1636551126,-183086,true,11196275808,22,10749757979,-446517829
1636551163,-183092,true,11189560393,22,10744384712,-445175681
1636551259,-183100,true,11180612772,22,10743310381,-437302391
1636551317,-183111,true,11168321474,22,10737940337,-430381137
1636551394,-183117,true,11161622826,22,10740088032,-421534794
1636551537,-183122,true,11156043688,22,10733646234,-422397454
1636551567,-183128,true,11149352404,22,10732572977,-416779427
1636551644,-183140,true,11135981874,22,10727208300,-408773574
1636552023,-183144,true,11131528594,22,10765893908,-365634686
1636552026,-183149,true,11125964499,22,10766970498,-358994001
1636552063,-183155,true,11119291256,22,10773432295,-345858961
1636552096,-183164,true,11109288896,22,10782054058,-327234838
1636552150,-183166,true,11107067372,22,10794999641,-312067731
1636552197,-183169,true,11103735918,22,10806880080,-296855838
1636552230,-183174,true,11098185715,22,10811203481,-286982234
1636552344,-183183,true,11088202340,22,10828514386,-259687954
1636552408,-183185,true,11085985032,22,10841515752,-244469280
1636552448,-183188,true,11082659902,22,10849107090,-233552812
1636552573,-183195,true,11074905142,22,10859961081,-214944061
1636552618,-183205,true,11063836326,22,10865392147,-198444179
1636552721,-183207,true,11061623890,22,10877350057,-184273833
1636552995,-183209,true,11059411897,22,10902395501,-157016396
1636553188,-183215,true,11052778572,22,10898035632,-154742940
1636553402,-183226,true,11040627807,22,10901305370,-139322437
1636553501,-183227,true,11039523855,22,10905666546,-133857309
1636553661,-183229,true,11037316281,22,10901305370,-136010911
1636553752,-183236,true,11029593249,22,10890410058,-139183191
1636553925,-183249,true,11015264810,22,10851277020,-163987790
1636553975,-183251,true,11013062087,22,10840431709,-172630378
1636554025,-183256,true,11007557208,22,10829597237,-177959971
1636554149,-183263,true,10999854999,22,10800398221,-199456778
1636554157,-183276,true,10985565193,22,10799318289,-186246904
1636554423,-183281,true,10980074057,22,10739014131,-241059926
1636554859,-183284,true,10976780694,22,10730426784,-246353910
1636555154,-183292,true,10968003220,22,10749757979,-218245241
1636555302,-183305,true,10953754791,22,10758360796,-195393995
1636555338,-183308,true,10950469322,22,10759436632,-191032690
1636555401,-183311,true,10947184838,22,10758360796,-188824042
1636555492,-183319,true,10938431030,22,10755133933,-183297097
1636555598,-183332,true,10924221019,22,10746533696,-177687323
1636555614,-183335,true,10920944408,22,10744384712,-176559696
1636555630,-183338,true,10917668779,22,10743310381,-174358398
1636555720,-183349,true,10905666546,22,10722918489,-182748057
1636555736,-183364,true,10889321126,22,10717558638,-171762488
1636555930,-183366,true,10887143588,22,10683318975,-203824613
1636556054,-183369,true,10883878098,22,10665173668,-218704430
1636556454,-183379,true,10873000204,22,10597137905,-275862299
1636556739,-183395,true,10855618182,22,10581254907,-274363275
1636556884,-183398,true,10852362148,22,10571736538,-280625610
1636556956,-183401,true,10849107090,22,10566452255,-282654835
1636557240,-183412,true,10837180230,22,10548505443,-288674787
1636557493,-183428,true,10819855471,22,10537962736,-281892735
1636557593,-183431,true,10816610164,22,10525325397,-291284767
1636557678,-183434,true,10813365829,22,10513754483,-299611346
1636557972,-183444,true,10802558409,22,10508499182,-294059227
1636558272,-183460,true,10785288998,22,10501146174,-284142824
1636558589,-183462,true,10783132263,22,10543232772,-239899491
1636558845,-183461,true,10784210577,22,10573850991,-210359586
1636559100,-183467,true,10777742314,22,10608800587,-168941727
1636559251,-183472,true,10772355060,22,10624724932,-147630128
1636559256,-183472,true,10772355060,22,10624724932,-147630128
1636559292,-183471,true,10773432295,22,10625787404,-147644891
1636559308,-183477,true,10766970498,22,10625787404,-141183094
1636559500,-183486,true,10757285067,22,10619414163,-137870904
1636559530,-183488,true,10755133933,22,10616228975,-138904958
1636559993,-183489,true,10754058527,22,10571736538,-182321989
1636560039,-183496,true,10746533696,22,10566452255,-180081441
1636560176,-183506,true,10735793071,22,10549560293,-186232778
1636560303,-183507,true,10734719599,22,10545341524,-189378075
1636560628,-183507,true,10734719599,22,10536909046,-197810553
1636560630,-183514,true,10727208300,22,10536909046,-190299254
1636561121,-183522,true,10718630394,22,10565395715,-153234679
1636561140,-183524,true,10716486989,22,10566452255,-150034734
1636562686,-183523,true,10717558638,22,10584429601,-133129037
1636563098,-183531,true,10708988448,22,10575965867,-133022581
1636563136,-183539,true,10700425111,22,10574908376,-125516735
1636563245,-183539,true,10700425111,22,10577023463,-123401648
1636563284,-183538,true,10701495154,22,10577023463,-124471691
1636563463,-183543,true,10696146011,22,10579138974,-117007037
1636563871,-183550,true,10688661703,22,10578081166,-110580537
1636564190,-183546,true,10692937809,22,10566452255,-126485554
1636564386,-183547,true,10691868622,22,10535855460,-156013162
1636564677,-183554,true,10684387307,22,10494847691,-189539616
1636564688,-183563,true,10674776165,22,10493798311,-180977854
1636565047,-183559,true,10679046716,22,10483310282,-195736434
1636565065,-183559,true,10679046716,22,10481213935,-197832781
1636565087,-183563,true,10674776165,22,10478070199,-196705966
1636565146,-183572,true,10665173668,22,10472832736,-192340932
1636565196,-183574,true,10663040953,22,10463411897,-199629056
1636565511,-183572,true,10665173668,22,10458181760,-206991908
1636565565,-183575,true,10661974756,22,10452954238,-209020518
1636565778,-183587,true,10649188698,22,10407064565,-242124133
1636565868,-183588,true,10648123886,22,10402902780,-245221106
1636565914,-183588,true,10648123886,22,10398742659,-249381227
1636566196,-183592,true,10643865701,22,10397702888,-246162813
1636566392,-183601,true,10634291010,22,10385233751,-249057259
1636566493,-183605,true,10630038357,22,10393544847,-236493510
1636566506,-183605,true,10630038357,22,10394584201,-235454156
1636566532,-183609,true,10625787404,22,10399782533,-226004871
1636566590,-183617,true,10617290598,22,10409146082,-208144516
1636566613,-183622,true,10611983545,22,10412269138,-199714407
1636566635,-183622,true,10611983545,22,10418518062,-193465483
1636566646,-183627,true,10606679145,22,10420601869,-186077276
1636566685,-183634,true,10599257438,22,10428941269,-170316169
1636567535,-183638,true,10595018795,22,10545341524,-49677271
1636567547,-183638,true,10595018795,22,10546396058,-48622737
1636567690,-183641,true,10591840925,22,10540070434,-51770491
1636567741,-183648,true,10584429601,22,10534801980,-49627621
1636567780,-183654,true,10578081166,22,10530589112,-47492054
1636567943,-183656,true,10575965867,22,10513754483,-62211384
1636568296,-183661,true,10570679470,22,10478070199,-92609271
1636568305,-183667,true,10564339281,22,10475974900,-88364381
1636568393,-183673,true,10558002896,22,10471785557,-86217339
1636568737,-183672,true,10559058696,22,10509550032,-49508664
1636568910,-183674,true,10556947201,22,10533748605,-23198596
1636569489,-183679,true,10551670311,22,10523220648,-28449663
1636569574,-183684,true,10546396058,22,10513754483,-32641575
1636569769,-183682,true,10548505443,22,10490650801,-57854642
1636569823,-183683,true,10547450698,22,10484358613,-63092085
1636569931,-183690,true,10540070434,22,10474927407,-65143027
1636569955,-183695,true,10534801980,22,10474927407,-59874573
1636570081,-183694,true,10535855460,22,10475974900,-59880560
1636570129,-183695,true,10534801980,22,10474927407,-59874573
1636570234,-183701,true,10528483310,22,10471785557,-56697753
1636570385,-183707,true,10522168431,22,10464458238,-57710193
1636570402,-183706,true,10523220648,22,10463411897,-59808751
1636570434,-183708,true,10521116319,22,10464458238,-56658081
1636570507,-183711,true,10517960615,22,10469691514,-48269101
1636570902,-183715,true,10513754483,22,10504296833,-9457650
1636570926,-183714,true,10514805858,22,10503246509,-11559349
1636570955,-183712,true,10516908925,22,10504296833,-12612092
1636571258,-183713,true,10515857339,22,10531642171,15784832
1636571421,-183717,true,10511652047,22,10537962736,26310689
1636571654,-183716,true,10512703212,22,10540070434,27367222
1636571696,-183714,true,10514805858,22,10540070434,25264576
1636571968,-183715,true,10513754483,22,10546396058,32641575
1636571984,-183718,true,10510600987,22,10545341524,34740537
1636572207,-183717,true,10511652047,22,10548505443,36853396
1636572237,-183713,true,10515857339,22,10554836128,38978789
1636572501,-183713,true,10515857339,22,10574908376,59051037
1636572553,-183715,true,10513754483,22,10578081166,64326683
1636572686,-183712,true,10516908925,22,10582313033,65404108
1636573038,-183710,true,10519012411,22,10590781847,71769436
1636573534,-183708,true,10521116319,22,10590781847,69665528
1636573614,-183712,true,10516908925,22,10592900109,75991184
1636573798,-183711,true,10517960615,22,10596078297,78117682
1636573811,-183709,true,10520064313,22,10595018795,74954482
1636573841,-183711,true,10517960615,22,10590781847,72821232
1636574871,-183723,true,10505347263,22,10341709411,-163637852
1636574880,-183723,true,10505347263,22,10341709411,-163637852
1636575003,-183721,true,10507448437,22,10367594733,-139853704
1636575171,-183719,true,10509550032,22,10384195332,-125354700
1636575351,-183728,true,10500096165,22,10406023963,-94072202
1636575379,-183727,true,10501146174,22,10408105271,-93040903
1636575572,-183725,true,10503246509,22,10446684660,-56561849
1636575576,-183722,true,10506397798,22,10447729328,-58668470
1636575622,-183729,true,10499046260,22,10460273501,-38772759
1636575662,-183727,true,10501146174,22,10472832736,-28313438
1636575703,-183722,true,10506397798,22,10483310282,-23087516
1636575732,-183721,true,10507448437,22,10489601841,-17846596
1636575875,-183728,true,10500096165,22,10511652047,11555882
1636575877,-183726,true,10502196289,22,10511652047,9455758
1636575890,-183721,true,10507448437,22,10512703212,5254775
1636575977,-183720,true,10508499182,22,10531642171,23142989
1636576033,-183725,true,10503246509,22,10545341524,42095015
1636576157,-183725,true,10503246509,22,10564339281,61092772
1636576195,-183721,true,10507448437,22,10568565651,61117214
1636576219,-183719,true,10509550032,22,10571736538,62186506
1636576313,-183724,true,10504296833,22,10589722875,85426042
1636576407,-183722,true,10506397798,22,10601377396,94979598
1636576475,-183716,true,10512703212,22,10608800587,96097375
1636576954,-183718,true,10510600987,22,10515857339,5256352
1636577041,-183724,true,10504296833,22,10501146174,-3150659
1636577160,-183723,true,10505347263,22,10494847691,-10499572
1636577427,-183718,true,10510600987,22,10479118006,-31482981
1636577580,-183718,true,10510600987,22,10492749036,-17851951
1636577594,-183717,true,10511652047,22,10492749036,-18903011
1636577722,-183718,true,10510600987,22,10495897176,-14703811
1636578035,-183715,true,10513754483,22,10492749036,-21005447
1636578065,-183714,true,10514805858,22,10487504236,-27301622
1636578122,-183715,true,10513754483,22,10484358613,-29395870
1636578258,-183714,true,10514805858,22,10487504236,-27301622
1636578306,-183708,true,10521116319,22,10494847691,-26268628
1636578556,-183706,true,10523220648,22,10531642171,8421523
1636578608,-183705,true,10524272970,22,10540070434,15797464
1636578624,-183703,true,10526377930,22,10542178554,15800624
1636578677,-183699,true,10530589112,22,10548505443,17916331
1636578972,-183701,true,10528483310,22,10583371264,54887954
1636579052,-183701,true,10528483310,22,10595018795,66535485
1636579392,-183701,true,10528483310,22,10560114602,31631292
1636579465,-183697,true,10532695335,22,10539016533,6321198
1636579727,-183705,true,10524272970,22,10466551235,-57721735
1636580213,-183708,true,10521116319,22,10331373387,-189742932
1636580465,-183711,true,10517960615,22,10296308116,-221652499
1636580486,-183707,true,10522168431,22,10296308116,-225860315
1636581069,-183715,true,10513754483,22,10307639719,-206114764
1636581318,-183715,true,10513754483,22,10352055775,-161698708
1636581354,-183716,true,10512703212,22,10358268562,-154434650
1636581479,-183711,true,10517960615,22,10370705323,-147255292
1636581640,-183714,true,10514805858,22,10408105271,-106700587
1636581831,-183713,true,10515857339,22,10451909047,-63948292
1636582025,-183718,true,10510600987,22,10478070199,-32530788
1636582248,-183713,true,10515857339,22,10513754483,-2102856
1636582284,-183714,true,10514805858,22,10520064313,5258455
1636582683,-183710,true,10519012411,22,10604558127,85545716
1636582753,-183711,true,10517960615,22,10615167459,97206844
1636582793,-183705,true,10524272970,22,10620476104,96203134
1636582820,-183705,true,10524272970,22,10623662566,99389596
1636583014,-183702,true,10527430567,22,10651318643,123888076
1636583105,-183704,true,10525325397,22,10653449013,128123616
1636583126,-183698,true,10531642171,22,10653449013,121806842
1636583189,-183698,true,10531642171,22,10657711032,126068861
1636583220,-183696,true,10533748605,22,10656645367,122896762
1636583317,-183696,true,10533748605,22,10651318643,117570038
1636583353,-183690,true,10540070434,22,10649188698,109118264
1636583523,-183691,true,10539016533,22,10641737247,102720714
1636583571,-183691,true,10539016533,22,10639609219,100592686
1636583598,-183691,true,10539016533,22,10639609219,100592686
1636583694,-183683,true,10547450698,22,10655579809,108129111
1636583744,-183684,true,10546396058,22,10658776803,112380745
1636583883,-183685,true,10545341524,22,10645994581,100653057
1636583943,-183686,true,10544287095,22,10649188698,104901603
1636584022,-183680,true,10550615249,22,10652383775,101768526
1636584191,-183681,true,10549560293,22,10649188698,99628405
1636584258,-183682,true,10548505443,22,10645994581,97489138
1636584270,-183683,true,10547450698,22,10645994581,98543883
1636584531,-183676,true,10554836128,22,10642801421,87965293
1636585326,-183678,true,10552725478,22,10651318643,98593165
1636585382,-183679,true,10551670311,22,10658776803,107106492
1636585464,-183680,true,10550615249,22,10679046716,128431467
1636586435,-183668,true,10563282953,22,10871913013,308630060
1636586461,-183666,true,10565395715,22,10870825930,305430215
1636587303,-183667,true,10564339281,22,10857789414,293450133
1636588280,-183668,true,10563282953,22,10877350057,314067104
1636589467,-183657,true,10574908376,22,10856703744,281795368
1636590211,-183654,true,10578081166,22,10840431709,262350543
1636590852,-183647,true,10585488044,22,10840431709,254943665
1636591660,-183647,true,10585488044,22,10826349008,240860964
1636591853,-183637,true,10596078297,22,10820937457,224859160
1636591924,-183635,true,10598197619,22,10819855471,221657852
1636592515,-183632,true,10601377396,22,10817691825,216314429
1636592807,-183632,true,10601377396,22,10816610164,215232768
1636592936,-183622,true,10611983545,22,10814447166,202463621
1636593142,-183621,true,10613044744,22,10810122468,197077724
1636593435,-183620,true,10614106048,22,10796079141,181973093
1636593619,-183621,true,10613044744,22,10790682721,177637977
1636593707,-183614,true,10620476104,22,10787446163,166970059
1636593806,-183612,true,10622600305,22,10784210577,161610272
1636593928,-183613,true,10621538152,22,10779897971,158359819
1636593935,-183614,true,10620476104,22,10778820089,158343985
1636593980,-183607,true,10627912668,22,10776664648,148751980
1636594399,-183607,true,10627912668,22,10760512576,132599908
1636595015,-183610,true,10624724932,22,10680114620,55389688
1636595166,-183611,true,10623662566,22,10663040953,39378387
1636595247,-183604,true,10631101361,22,10652383775,21282414
1636595588,-183606,true,10628975459,22,10586546593,-42428866
1636595886,-183612,true,10622600305,22,10560114602,-62485703
1636595945,-183614,true,10620476104,22,10554836128,-65639976
1636596411,-183607,true,10627912668,22,10556947201,-70965467
1636596507,-183604,true,10631101361,22,10563282953,-67818408
1636596534,-183609,true,10625787404,22,10561170613,-64616791
1636596630,-183610,true,10624724932,22,10552725478,-71999454
1636596744,-183604,true,10631101361,22,10559058696,-72042665
1636596876,-183601,true,10634291010,22,10569622508,-64668502
1636596984,-183606,true,10628975459,22,10575965867,-53009592
1636597074,-183606,true,10628975459,22,10581254907,-47720552
1636597202,-183598,true,10637481616,22,10587605248,-49876368
1636597528,-183594,true,10641737247,22,10613044744,-28692503
1636597622,-183599,true,10636417975,22,10608800587,-27617388
1636597713,-183601,true,10634291010,22,10602437534,-31853476
1636597801,-183596,true,10639609219,22,10596078297,-43530922
1636597817,-183596,true,10639609219,22,10595018795,-44590424
1636597907,-183600,true,10635354439,22,10599257438,-36097001
1636597958,-183601,true,10634291010,22,10606679145,-27611865
1636598191,-183592,true,10643865701,22,10640673180,-3192521
1636598548,-183589,true,10647059180,22,10692937809,45878629
1636598623,-183594,true,10641737247,22,10703635560,61898313
1636598739,-183593,true,10642801421,22,10718630394,75828973
1636598812,-183584,true,10652383775,22,10722918489,70534714
1636599321,-183578,true,10658776803,22,10702565304,43788501
1636599423,-183580,true,10656645367,22,10697215626,40570259
1636599683,-183576,true,10660908665,22,10692937809,32029144
1636599767,-183567,true,10670507321,22,10690799542,20292221
1636599900,-183561,true,10676911227,22,10702565304,25654077
1636600090,-183563,true,10674776165,22,10720774227,45998062
1636600204,-183558,true,10680114620,22,10743310381,63195761
1636600212,-183548,true,10690799542,22,10745459151,54659609
1636600364,-183544,true,10695076504,22,10776664648,81588144
1636600464,-183547,true,10691868622,22,10796079141,104210519
1636600586,-183542,true,10697215626,22,10820937457,123721831
1636600680,-183533,true,10706846972,22,10839347774,132500802
1636600812,-183530,true,10710059347,22,10851277020,141217673
1636600939,-183536,true,10703635560,22,10861047077,157411517
1636601119,-183533,true,10706846972,22,10858875193,152028221
1636601320,-183526,true,10714344014,22,10851277020,136933006
1636601474,-183523,true,10717558638,22,10845853009,128294371
1636601610,-183528,true,10712201466,22,10840431709,128230243
1636602001,-183525,true,10715415448,22,10836096620,120681172
1636602039,-183517,true,10723990781,22,10836096620,112105839
1636602354,-183515,true,10726135687,22,10836096620,109960933
1636602498,-183519,true,10721846305,22,10836096620,114250315
1636602617,-183515,true,10726135687,22,10851277020,125141333
1636602621,-183508,true,10733646234,22,10852362148,118715914
1636602982,-183501,true,10741162041,22,10931870268,190708227
1636602995,-183503,true,10739014131,22,10935150157,196136026
1636603568,-183499,true,10743310381,22,11032902458,289592077
1636603758,-183494,true,10748683111,22,11030696209,282013098
1636604067,-183487,true,10756209446,22,11043940327,287730881
1636604184,-183487,true,10756209446,22,11047253840,291044394
1636604431,-183483,true,10760512576,22,11056094737,295582161
1636604569,-183475,true,10769123999,22,11069369350,300245351
1636604650,-183468,true,10776664648,22,11078227946,301563298
1636604794,-183467,true,10777742314,22,11085985032,308242718
1636604991,-183462,true,10783132263,22,11098185715,315053452
1636605322,-183455,true,10790682721,22,11121515226,330832505
1636605485,-183449,true,10797158749,22,11115956136,318797387
1636605538,-183449,true,10797158749,22,11112622016,315463267
1636605769,-183444,true,10802558409,22,11101515504,298957095
1636605982,-183442,true,10804719028,22,11090420091,285701063
1636606059,-183440,true,10806880080,22,11085985032,279104952
1636606343,-183438,true,10809041564,22,11117067732,308026168
1636606442,-183433,true,10814447166,22,11131528594,317081428
1636606542,-183429,true,10818773594,22,11149352404,330578810
1636606706,-183425,true,10823101752,22,11175024142,351922390
1636606815,-183423,true,10825266481,22,11195156293,369889812
1636606887,-183417,true,10831763265,22,11208597871,376834606
1636607457,-183411,true,10838263948,22,11247894728,409630780
1636607582,-183407,true,10842599904,22,11264778386,422178482
1636607700,-183403,true,10846937594,22,11290715896,443778302
1636608088,-183394,true,10856703744,22,11393925140,537221396
1636608433,-183385,true,10866478687,22,11484289098,617810411
1636608498,-183379,true,10873000204,22,11494629094,621628890
1636608621,-183375,true,10877350057,22,11492330513,614980456
1636608792,-183366,true,10887143588,22,11477400936,590257348
1636608822,-183358,true,10895856352,22,11477400936,581544584
1636608836,-183353,true,10901305370,22,11475105800,573800430
1636609030,-183349,true,10905666546,22,11456761228,551094682
1636609075,-183340,true,10915485573,22,11449889576,534404003
1636609196,-183333,true,10923128706,22,11428156526,505027820
1636609466,-183327,true,10929684222,22,11389368709,459684487
1636609495,-183321,true,10936243672,22,11387091177,450847505
1636609564,-183313,true,10944995730,22,11381399339,436403609
1636609695,-183304,true,10954850167,22,11379123401,424273234
1636609983,-183297,true,10962520863,22,11348442739,385921876
1636610015,-183288,true,10972391079,22,11349577584,377186505
1636610064,-183280,true,10981172065,22,11345038887,363866822
1636610268,-183272,true,10989960078,22,11326902245,336942167
1636610347,-183267,true,10995456157,22,11316713128,321256971
1636610480,-183259,true,11004255601,22,11300881606,296626005
1636610638,-183250,true,11014163394,22,11278303557,264140163
1636610734,-183243,true,11021875621,22,11277175840,255300219
1636610806,-183239,true,11026285033,22,11269284973,242999940
1636611141,-183232,true,11034005748,22,11235529465,201523717
1636611367,-183225,true,11041731870,22,11232159480,190427610
1636611413,-183218,true,11049463401,22,11231036376,181572975
1636611547,-183214,true,11053883850,22,11226545085,172661235
1636611570,-183206,true,11062730053,22,11223177795,160447742
1636611607,-183199,true,11070476287,22,11218689645,148213358
1636611843,-183193,true,11077120234,22,11210839703,133719469
1636612261,-183187,true,11083768168,22,11198515175,114747007
1636612497,-183181,true,11090420091,22,11195156293,104736202
1636612505,-183176,true,11095966411,22,11195156293,99189882
1636613251,-183174,true,11098185715,22,11141550978,43365263
1636613347,-183170,true,11102625655,22,11134868387,32242732
1636613527,-183165,true,11108178078,22,11120403186,12225108
1636613679,-183159,true,11114844652,22,11128189803,13345151
1636614166,-183156,true,11118179438,22,11158275008,40095570
1636614737,-183150,true,11124852014,22,11187322817,62470803
1636615097,-183145,true,11130415553,22,11187322817,56907264
1636615178,-183138,true,11138209181,22,11187322817,49113636
1636615204,-183135,true,11141550978,22,11186204196,44653218
1636615522,-183130,true,11147122868,22,11186204196,39081328
1636615734,-183126,true,11151582386,22,11186204196,34621810
1636615745,-183122,true,11156043688,22,11185085688,29042000
1636616333,-183121,true,11157159292,22,11131528594,-25630698
1636617472,-183119,true,11159390836,22,11105956776,-53434060
1636617841,-183116,true,11162738988,22,11118179438,-44559550
1636617952,-183112,true,11167204753,22,11122627377,-44577376
1636618089,-183111,true,11168321474,22,11125964499,-42356975
1636618655,-183108,true,11171672305,22,11131528594,-40143711
1636619192,-183106,true,11173906752,22,11073797762,-100108990
1636619403,-183102,true,11178376985,22,11052778572,-125598413
1636619653,-183102,true,11178376985,22,11011960891,-166416094
1636619807,-183101,true,11179494822,22,10996555703,-182939119
1636620653,-183102,true,11178376985,22,10891499099,-286877886
1636621456,-183100,true,11180612772,22,10888232303,-292380469
1636621611,-183100,true,11180612772,22,10889321126,-291291646
1636621621,-183099,true,11181730833,22,10888232303,-293498530
1636622117,-183100,true,11180612772,22,10886054983,-294557789
1636622617,-183098,true,11182849006,22,10886054983,-296794023
1636622653,-183099,true,11181730833,22,10884966486,-296764347
1636622975,-183103,true,11177259259,22,10875174913,-302084346
1636623562,-183107,true,11172789473,22,10845853009,-326936464
1636623656,-183106,true,11173906752,22,10844768532,-329138220
1636624178,-183107,true,11172789473,22,10840431709,-332357764
1636624929,-183111,true,11168321474,22,10822019550,-346301924
1636624965,-183116,true,11162738988,22,10819855471,-342883517
1636625047,-183116,true,11162738988,22,10816610164,-346128824
1636625247,-183117,true,11161622826,22,10812284601,-349338225
1636625889,-183123,true,11154928195,22,10796079141,-358849054
1636625912,-183128,true,11149352404,22,10794999641,-354352763
1636625930,-183129,true,11148237580,22,10796079141,-352158439
1636626094,-183131,true,11146008267,22,10799318289,-346689978
1636626277,-183136,true,11140436935,22,10802558409,-337878526
1636626657,-183141,true,11134868387,22,10811203481,-323664906
1636627353,-183141,true,11134868387,22,10812284601,-322583786
1636627537,-183142,true,11133755011,22,10805799500,-327955511
1636627689,-183147,true,11128189803,22,10801478261,-326711542
1636627795,-183154,true,11120403186,22,10797158749,-323244437
1636627937,-183156,true,11118179438,22,10792840965,-325338473
1636629433,-183160,true,11113733278,22,10749757979,-363975299
1636629461,-183166,true,11107067372,22,10748683111,-358384261
1636631224,-183174,true,11098185715,22,10728281021,-369904694
1636632311,-183177,true,11094856925,22,10729353849,-365503076
1636632631,-183182,true,11089311160,22,10726135687,-363175473
1636633072,-183188,true,11082659902,22,10771277932,-311381970
1636633345,-183195,true,11074905142,22,10836096620,-238808522
1636633358,-183199,true,11070476287,22,10838263948,-232212339
1636633464,-183206,true,11062730053,22,10866478687,-196251366
1636633508,-183210,true,11058306067,22,10880613588,-177692479
1636633530,-183216,true,11051673405,22,10889321126,-162352279
1636633753,-183214,true,11053883850,22,10977878372,-76005478
1636633826,-183216,true,11051673405,22,11018569720,-33103685
1636633888,-183217,true,11050568348,22,11060517838,9949490
1636633942,-183221,true,11046149225,22,11101515504,55366279
1636633944,-183214,true,11053883850,22,11102625655,48741805
1636634013,-183212,true,11056094737,22,11154928195,98833458
1636634363,-183209,true,11059411897,22,11408746133,349334236
1636634526,-183212,true,11056094737,22,11493479746,437385009
1636634759,-183204,true,11064942709,22,11606663885,541721176
1636634874,-183201,true,11068262524,22,11627573648,559311124
1636635004,-183196,true,11073797762,22,11641534413,567736651
1636635063,-183199,true,11070476287,22,11640370376,569894089
1636635173,-183192,true,11078227946,22,11640370376,562142430
1636635220,-183188,true,11082659902,22,11641534413,558874511
1636635480,-183183,true,11088202340,22,11642698566,554496226
1636635574,-183186,true,11084876545,22,11633388597,548512052
1636635833,-183178,true,11093747550,22,11610146232,516398682
1636635965,-183174,true,11098185715,22,11603182582,504996867
1636636055,-183169,true,11103735918,22,11613629624,509893706
1636636107,-183169,true,11103735918,22,11625248482,521512564
1636636122,-183160,true,11113733278,22,11628736405,515003127
1636636130,-183153,true,11121515226,22,11629899279,508384053
1636636165,-183145,true,11130415553,22,11640370376,509954823
1636636327,-183142,true,11133755011,22,11697545296,563790285
1636636390,-183132,true,11144893778,22,11720962625,576068847
1636636479,-183123,true,11154928195,22,11764408340,609480145
1636636602,-183112,true,11167204753,22,11838754339,671549586
1636636662,-183108,true,11171672305,22,11875509581,703837276
1636636681,-183096,true,11185085688,22,11888579175,703493487
1636636690,-183085,true,11197395436,22,11894524654,697129218
1636636771,-183071,true,11213081983,22,11952947923,739865940
1636636919,-183065,true,11219811514,22,12051360114,831548600
1636636960,-183053,true,11233282696,22,12075485746,842203050
1636636977,-183043,true,11244521035,22,12082732849,838211814
1636637130,-183033,true,11255770617,22,12110553725,854783108
1636637219,-183031,true,11258021884,22,12110553725,852531841
1636637259,-183021,true,11269284973,22,12109342791,840057818
1636637421,-183012,true,11279431388,22,12092402419,812971031
1636637487,-183003,true,11289586937,22,12082732849,793145912
1636637753,-183000,true,11292974152,22,12022472973,729498821
1636637759,-182989,true,11305402637,22,12021270846,715868209
1636637825,-182979,true,11316713128,22,11988858811,672145683
1636638181,-182973,true,11323504854,22,11890957010,567452156
1636638377,-182973,true,11323504854,22,11852968660,529463806
1636638496,-182961,true,11337100536,22,11842306320,505205784
1636638620,-182951,true,11348442739,22,11835203423,486760684
1636638698,-182944,true,11356389033,22,11834020021,477630988
1636638731,-182939,true,11362068363,22,11845859368,483791005
1636639101,-182926,true,11376847918,22,11941001547,564153629
1636639199,-182913,true,11391646697,22,11970889901,579243204
1636639453,-182903,true,11403043471,22,12016463539,613420068
1636639524,-182895,true,11412169100,22,12033297528,621128428
1636639614,-182879,true,11430442271,22,12050155099,619712828
1636639842,-182868,true,11443022046,22,12033297528,590275482
1636639934,-182859,true,11453324887,22,12014060607,560735720
1636640035,-182854,true,11459052694,22,11990057697,531005003
1636640049,-182839,true,11476253311,22,11986461399,510208088
1636640187,-182830,true,11486586071,22,11951752748,465166677
1636640729,-182824,true,11493479746,22,11776178043,282698297
1636640897,-182818,true,11500377558,22,11756176547,255798989
1636640900,-182803,true,11517640205,22,11755001047,237360842
1636641141,-182795,true,11526857543,22,11729169761,202312218
1636641202,-182788,true,11534928764,22,11726824279,191895515
1636641272,-182782,true,11541851452,22,11729169761,187318309
1636641604,-182766,true,11560332271,22,11736209022,175876751
1636642354,-182760,true,11567270205,22,11655511940,88241735
1636642420,-182752,true,11576527260,22,11646191725,69664465
1636642829,-182747,true,11582316682,22,11636878963,54562281
1636643334,-182729,true,11603182582,22,11760879723,157697141
1636643472,-182721,true,11612468378,22,11793854681,181386303
1636643527,-182714,true,11620599544,22,11805653844,185054300
1636643660,-182705,true,11631062268,22,11836386943,205324675
1636643662,-182688,true,11650850900,22,11836386943,185536043
1636643811,-182681,true,11659008943,22,11829287596,170278653
1636644203,-182676,true,11664839614,22,11769114809,104275195
1636644239,-182668,true,11674174752,22,11764408340,90233588
1636644286,-182650,true,11695206138,22,11757352165,62146027
1636644458,-182642,true,11704565578,22,11742078301,37512723
1636644583,-182634,true,11713932508,22,11750300222,36367714
1636644770,-182625,true,11724479266,22,11763232016,38752750
1636644805,-182607,true,11745601276,22,11765584781,19983505
1636644820,-182598,true,11756176547,22,11766761339,10584792
1636644825,-182592,true,11763232016,22,11767938015,4705999
1636644866,-182584,true,11772645896,22,11771468750,-1177146
1636645069,-182566,true,11793854681,22,11799752788,5898107
1636645227,-182560,true,11800932763,22,11819828423,18895660
1636645268,-182556,true,11805653844,22,11823374726,17720882
1636645550,-182550,true,11812739008,22,11832836737,20097729
1636645633,-182536,true,11829287596,22,11843490551,14202955
1636645723,-182533,true,11832836737,22,11854153957,21317220
1636645799,-182532,true,11834020021,22,11858896330,24876309
1636646028,-182526,true,11841122208,22,11863640600,22518392
1636646079,-182518,true,11850598422,22,11862454355,11855933
1636646137,-182519,true,11849413481,22,11863640600,14227119
1636646299,-182522,true,11845859368,22,11849413481,3554113
1636646490,-182520,true,11848228658,22,11818646558,-29582100
1636646574,-182513,true,11856524907,22,11803293068,-53231839
1636647027,-182514,true,11855339373,22,11746775836,-108563537
1636647071,-182519,true,11849413481,22,11742078301,-107335180
1636647295,-182517,true,11851783482,22,11735035519,-116747963
1636647549,-182511,true,11858896330,22,11695206138,-163690192
1636647758,-182514,true,11855339373,22,11661340862,-193998511
1636647794,-182518,true,11850598422,22,11646191725,-204406697
1636647912,-182519,true,11849413481,22,11612468378,-236945103
1636648023,-182516,true,11852968660,22,11558020551,-294948109
1636648041,-182523,true,11844674900,22,11548778294,-295896606
1636648197,-182529,true,11837570582,22,11476253311,-361317271
1636648634,-182532,true,11834020021,22,11330300655,-503719366
1636648961,-182530,true,11836386943,22,11309925476,-526461467
1636649009,-182540,true,11824557064,22,11312187574,-512369490
1636649384,-182549,true,11813920281,22,11314450125,-499470156
1636649665,-182556,true,11805653844,22,11311056469,-494597375
1636649737,-182555,true,11806834410,22,11307663830,-499170580
1636649818,-182566,true,11793854681,22,11303141895,-490712786
1636649998,-182578,true,11779711250,22,11299751631,-479959619
1636650189,-182586,true,11770291720,22,11303141895,-467149825
1636650509,-182586,true,11770291720,22,11304272210,-466019510
1636650537,-182598,true,11756176547,22,11312187574,-443988973
1636650726,-182611,true,11740904210,22,11340502006,-400402204
1636650811,-182620,true,11730342678,22,11349577584,-380765094
1636651042,-182618,true,11732688864,22,11372298316,-360390548
1636651344,-182630,true,11718618784,22,11400763205,-317855579
1636651359,-182639,true,11708077299,22,11401903281,-306174018
1636651379,-182645,true,11701054910,22,11406464726,-294590184
1636651526,-182640,true,11706906608,22,11416734652,-290171956
1636652184,-182650,true,11695206138,22,11473958404,-221247734
1636652196,-182658,true,11685854182,22,11475105800,-210748382
1636652607,-182664,true,11678845123,22,11476253311,-202591812
1636652989,-182660,true,11683517361,22,11469369968,-214147393
1636653814,-182670,true,11671840267,22,11404183776,-267656491
1636654078,-182675,true,11666006098,22,11424728764,-241277334
1636654394,-182678,true,11662506996,22,11455615666,-206891330
1636654714,-182674,true,11667172698,22,11487734730,-179437968
1636655113,-182684,true,11655511940,22,11488883503,-166628437
1636655436,-182690,true,11648521080,22,11481992585,-166528495
1636656002,-182696,true,11641534413,22,11462490754,-179043659
1636656035,-182694,true,11643862836,22,11457906904,-185955932
1636656043,-182705,true,11631062268,22,11457906904,-173155364
1636656048,-182713,true,11621761604,22,11456761228,-165000376
1636656123,-182720,true,11613629624,22,11455615666,-158013958
1636656181,-182717,true,11617114062,22,11461344620,-155769442
1636656277,-182725,true,11607824551,22,11468223146,-139601405
1636656515,-182731,true,11600862294,22,11484289098,-116573196
1636656680,-182736,true,11595063602,22,11492330513,-102733089
1636656800,-182732,true,11599702323,22,11498077828,-101624495
1636656862,-182738,true,11592744937,22,11498077828,-94667109
1636656905,-182742,true,11588108998,22,11496928135,-91180863
1636656951,-182746,true,11583474913,22,11504978399,-78496514
1636657528,-182741,true,11589267809,22,11510732039,-78535770
1636658202,-182746,true,11583474913,22,11514185604,-69289309
1636658263,-182749,true,11580000566,22,11509581081,-70419485
1636658319,-182755,true,11573054996,22,11507279510,-65775486
1636658479,-182750,true,11578842681,22,11499227635,-79615046
1636658571,-182754,true,11574212302,22,11494629094,-79583208
1636658663,-182757,true,11570740733,22,11490032392,-80708341
1636659540,-182763,true,11563800717,22,11432728474,-131072243
1636659701,-182761,true,11566113593,22,11431585315,-134528278
1636659771,-182767,true,11559176353,22,11430442271,-128734082
1636659911,-182771,true,11554553838,22,11427013824,-127540014
1636660105,-182780,true,11544159938,22,11419018113,-125141825
1636660377,-182778,true,11546468885,22,11411027997,-135440888
1636660421,-182782,true,11541851452,22,11409887008,-131964444
1636660937,-182784,true,11539543428,22,11405324194,-134219234
1636661085,-182792,true,11530315946,22,11421302031,-109013915
1636661116,-182789,true,11533775387,22,11423586406,-110188981
1636661174,-182794,true,11528010229,22,11428156526,-99853703
1636661270,-182796,true,11525704972,22,11433871747,-91833225
1636661333,-182805,true,11515337022,22,11439589826,-75747196
1636661503,-182801,true,11519943848,22,11461344620,-58599228
1636661651,-182806,true,11514185604,22,11480844501,-33341103
1636661927,-182807,true,11513034301,22,11504978399,-8055902
1636662238,-182816,true,11502677749,22,11518791969,16114220
1636663002,-182814,true,11504978399,22,11515337022,10358623
1636663133,-182819,true,11499227635,22,11516488556,17260921
1636663211,-182819,true,11499227635,22,11518791969,19564334
1636663229,-182828,true,11488883503,22,11522247952,33364449
1636663521,-182824,true,11493479746,22,11552243274,58763528
1636663593,-182829,true,11487734730,22,11560332271,72597541
1636663656,-182829,true,11487734730,22,11564957097,77222367
1636663715,-182839,true,11476253311,22,11569583774,93330463
1636663720,-182835,true,11480844501,22,11571897807,91053306
1636664458,-182838,true,11477400936,22,11625248482,147847546
1636664558,-182837,true,11478548676,22,11639206455,160657779
1636664598,-182843,true,11471663957,22,11648521080,176857123
1636664692,-182839,true,11476253311,22,11654346505,178093194
1636664953,-182841,true,11473958404,22,11655511940,181553536
1636664970,-182840,true,11475105800,22,11655511940,180406140
1636665181,-182847,true,11467076438,22,11653181187,186104749
1636665341,-182841,true,11473958404,22,11650850900,176892496
1636665454,-182842,true,11472811123,22,11638042651,165231528
1636665482,-182840,true,11475105800,22,11632225375,157119575
1636665872,-182846,true,11468223146,22,11606663885,138440739
1636666210,-182837,true,11478548676,22,11597382731,118834055
1636666935,-182833,true,11483140784,22,11592744937,109604153
1636666978,-182830,true,11486586071,22,11592744937,106158866
1636667297,-182833,true,11483140784,22,11608985334,125844550
1636667364,-182825,true,11492330513,22,11611307247,118976734
1636667486,-182820,true,11498077828,22,11629899279,131821451
1636667523,-182816,true,11502677749,22,11633388597,130710848
1636667556,-182819,true,11499227635,22,11636878963,137651328
1636667659,-182809,true,11510732039,22,11647356344,136624305
1636667773,-182803,true,11517640205,22,11669506249,151866044
1636667810,-182799,true,11522247952,22,11675342170,153094218
1636668056,-182800,true,11521095843,22,11733862133,212766290
1636668243,-182788,true,11534928764,22,11797393191,262464427
1636668265,-182781,true,11543005637,22,11805653844,262648207
1636668298,-182778,true,11546468885,22,11813920281,267451396
1636668355,-182777,true,11547623532,22,11829287596,281664064
1636668369,-182767,true,11559176353,22,11831653572,272477219
1636668399,-182760,true,11567270205,22,11841122208,273852003
1636668623,-182756,true,11571897807,22,11908805936,336908129
1636668705,-182754,true,11574212302,22,11927874323,353662021
1636668869,-182745,true,11584633261,22,11951752748,367119487
1636669006,-182741,true,11589267809,22,11949362756,360094947
1636669113,-182739,true,11591585779,22,11936226340,344640561
1636669242,-182739,true,11591585779,22,11918336316,326750537
1636669333,-182732,true,11599702323,22,11892146105,292443782
1636669671,-182729,true,11603182582,22,11793854681,190672099
1636670050,-182728,true,11604342900,22,11727996961,123654061
1636670126,-182728,true,11604342900,22,11717447040,113104140
1636670165,-182721,true,11612468378,22,11715103902,102635524
1636670747,-182719,true,11614790987,22,11729169761,114378774
1636670968,-182718,true,11615952466,22,11730342678,114390212
1636670984,-182718,true,11615952466,22,11731515712,115563246
1636671015,-182711,true,11624086073,22,11731515712,107429639
1636671038,-182709,true,11626411006,22,11731515712,105104706
1636671192,-182707,true,11628736405,22,11732688864,103952459
1636671267,-182707,true,11628736405,22,11720962625,92226220
1636671910,-182705,true,11631062268,22,11654346505,23284237
1636672041,-182703,true,11633388597,22,11641534413,8145816
1636672262,-182702,true,11634551936,22,11662506996,27955060
1636672314,-182701,true,11635715391,22,11664839614,29124223
1636672351,-182697,true,11640370376,22,11667172698,26802322
1636672391,-182695,true,11642698566,22,11668339416,25640850
1636672411,-182695,true,11642698566,22,11668339416,25640850
1636672434,-182694,true,11643862836,22,11668339416,24476580
1636672571,-182689,true,11649685932,22,11689360289,39674357
1636672937,-182685,true,11654346505,22,11746775836,92429331
1636673102,-182684,true,11655511940,22,11753825664,98313724
1636673777,-182684,true,11655511940,22,11775000543,119488603
1636674188,-182678,true,11662506996,22,11782067310,119560314
1636674247,-182673,true,11668339416,22,11778533397,110193981
1636674362,-182672,true,11669506249,22,11784423841,114917592
1636674584,-182670,true,11671840267,22,11793854681,122014414
1636674882,-182664,true,11678845123,22,11803293068,124447945
1636674899,-182658,true,11685854182,22,11803293068,117438886
1636674995,-182657,true,11687022767,22,11806834410,119811643
1636675247,-182653,true,11691698278,22,11842306320,150608042
1636675274,-182645,true,11701054910,22,11845859368,144804458
1636675320,-182639,true,11708077299,22,11851783482,143706183
1636675421,-182636,true,11711590073,22,11876697132,165107059
1636675571,-182630,true,11718618784,22,11911187816,192569032
1636675656,-182622,true,11727996961,22,11931453043,203456082
1636675729,-182616,true,11735035519,22,11951752748,216717229
1636675770,-182615,true,11736209022,22,11958925593,222716571
1636676049,-182610,true,11742078301,22,11987660045,245581744
1636676221,-182604,true,11749125309,22,11986461399,237336090
1636676537,-182600,true,11753825664,22,11933839453,180013789
1636676827,-182600,true,11753825664,22,11892146105,138320441
1636677112,-182596,true,11758527900,22,11869573607,111045707
1636677234,-182590,true,11765584781,22,11868386768,102801987
1636677680,-182586,true,11770291720,22,11863640600,93348880
1636677760,-182587,true,11769114809,22,11863640600,94525791
1636678457,-182585,true,11771468750,22,11773823161,2354411
1636678703,-182581,true,11776178043,22,11769114809,-7063234
1636678957,-182580,true,11777355661,22,11772645896,-4709765
1636679170,-182581,true,11776178043,22,11772645896,-3532147
1636679201,-182578,true,11779711250,22,11772645896,-7065354
1636679308,-182575,true,11783245517,22,11773823161,-9422356
1636679543,-182574,true,11784423841,22,11771468750,-12955091
1636679546,-182575,true,11783245517,22,11771468750,-11776767
1636679556,-182573,true,11785602284,22,11770291720,-15310564
1636679869,-182572,true,11786780844,22,11746775836,-40005008
1636679894,-182574,true,11784423841,22,11738556381,-45867460
1636680033,-182575,true,11783245517,22,11713932508,-69313009
1636680128,-182572,true,11786780844,22,11706906608,-79874236
1636680247,-182572,true,11786780844,22,11683517361,-103263483
1636680648,-182574,true,11784423841,22,11613629624,-170794217
1636681066,-182576,true,11782067310,22,11589267809,-192799501
1636681394,-182574,true,11784423841,22,11553398499,-231025342
1636681851,-182575,true,11783245517,22,11504978399,-278267118
1636681923,-182577,true,11780889221,22,11496928135,-283961086
1636683058,-182580,true,11777355661,22,11500377558,-276978103
1636683195,-182578,true,11779711250,22,11499227635,-280483615
1636683203,-182579,true,11778533397,22,11499227635,-279305762
1636683233,-182583,true,11773823161,22,11499227635,-274595526
1636683571,-182586,true,11770291720,22,11499227635,-271064085
1636683903,-182586,true,11770291720,22,11490032392,-280259328
1636683967,-182587,true,11769114809,22,11487734730,-281380079
1636684062,-182592,true,11763232016,22,11484289098,-278942918
1636684344,-182597,true,11757352165,22,11461344620,-296007545
1636684374,-182599,true,11755001047,22,11459052694,-295948353
1636684508,-182604,true,11749125309,22,11448744702,-300380607
1636684597,-182610,true,11742078301,22,11444166348,-297911953
1636685402,-182615,true,11736209022,22,11420160015,-316049007
1636685584,-182620,true,11730342678,22,11420160015,-310182663
1636685597,-182625,true,11724479266,22,11421302031,-303177235
1636685663,-182631,true,11717447040,22,11417876325,-299570715
1636685818,-182637,true,11710419031,22,11408746133,-301672898
1636685858,-182643,true,11703395238,22,11409887008,-293508230
1636685982,-182647,true,11698715050,22,11411027997,-287687053
1636686268,-182652,true,11692867447,22,11411027997,-281839450
1636686273,-182656,true,11688191469,22,11409887008,-278304461
1636687342,-182664,true,11678845123,22,11304272210,-374572913
1636687348,-182666,true,11676509704,22,11303141895,-373367809
1636687766,-182670,true,11671840267,22,11269284973,-402555294
1636687775,-182674,true,11667172698,22,11269284973,-397887725
1636687813,-182683,true,11656677491,22,11263652021,-393025470
1636687970,-182686,true,11653181187,22,11245645487,-407535700
1636688058,-182691,true,11647356344,22,11235529465,-411826879
1636688097,-182695,true,11642698566,22,11231036376,-411662190
1636688108,-182705,true,11631062268,22,11229913385,-401148883
1636688391,-182707,true,11628736405,22,11206356488,-422379917
1636688451,-182712,true,11622923781,22,11205235964,-417687817
1636688696,-182717,true,11617114062,22,11195156293,-421957769
1636688739,-182724,true,11608985334,22,11195156293,-413829041
1636688829,-182726,true,11606663885,22,11191798417,-414865468
1636688908,-182731,true,11600862294,22,11188441549,-412420745
1636688989,-182736,true,11595063602,22,11186204196,-408859406
1636689043,-182744,true,11585791724,22,11185085688,-400706036
1636689177,-182747,true,11582316682,22,11182849006,-399467676
1636689685,-182752,true,11576527260,22,11175024142,-401503118
1636689915,-182755,true,11573054996,22,11180612772,-392442224
1636690170,-182763,true,11563800717,22,11181730833,-382069884
1636690303,-182768,true,11558020551,22,11198515175,-359505376
1636690381,-182774,true,11551088165,22,11207477124,-343611041
1636690477,-182777,true,11547623532,22,11217567889,-330055643
1636690531,-182783,true,11540697382,22,11223177795,-317519587
1636690584,-182788,true,11534928764,22,11227667739,-307261025
1636690642,-182794,true,11528010229,22,11233282696,-294727533
1636690921,-182797,true,11524552517,22,11255770617,-268781900
1636690938,-182804,true,11516488556,22,11256896194,-259592362
1636691203,-182809,true,11510732039,22,11264778386,-245953653
1636691645,-182816,true,11502677749,22,11260273601,-242404148
1636691873,-182819,true,11499227635,22,11254645153,-244582482
1636691882,-182828,true,11488883503,22,11253519801,-235363702
1636691945,-182834,true,11481992585,22,11251269434,-230723151
1636692750,-182839,true,11476253311,22,11314450125,-161803186
1636692960,-182844,true,11470516905,22,11325769668,-144747237
1636693747,-182854,true,11459052694,22,11331433686,-127619008
1636694221,-182861,true,11451034565,22,11333700086,-117334479
1636694417,-182867,true,11444166348,22,11331433686,-112732662
1636694543,-182871,true,11439589826,22,11330300655,-109289171
1636694551,-182880,true,11429299341,22,11330300655,-98998686
1636694682,-182886,true,11422444161,22,11331433686,-91010475
1636695170,-182889,true,11419018113,22,11335966939,-83051174
1636695304,-182893,true,11414451648,22,11335966939,-78484709
1636695414,-182901,true,11405324194,22,11335966939,-69357255
1636695421,-182907,true,11398483394,22,11335966939,-62516455
1636695505,-182911,true,11393925140,22,11334833456,-59091684
1636695627,-182914,true,11390507646,22,11332566829,-57940817
1636695652,-182920,true,11383675733,22,11329167739,-54507994
1636695749,-182927,true,11375710347,22,11315581570,-60128777
1636695804,-182931,true,11371161200,22,11306533177,-64628023
1636695969,-182936,true,11365477324,22,11281687387,-83789937
1636696817,-182943,true,11357524672,22,11201875066,-155649606
1636696949,-182949,true,11350712541,22,11202995253,-147717288
1636696994,-182953,true,11346173391,22,11201875066,-144298325
1636697280,-182959,true,11339368069,22,11196275808,-143092261
1636697792,-182967,true,11330300655,22,11179494822,-150805833
1636697887,-182971,true,11325769668,22,11186204196,-139565472
1636697994,-182973,true,11323504854,22,11197395436,-126109418
1636698234,-182977,true,11318976584,22,11219811514,-99165070
1636698266,-182983,true,11312187574,22,11223177795,-89009779
1636698533,-182985,true,11309925476,22,11247894728,-62030748
1636698591,-182987,true,11307663830,22,11253519801,-54144029
1636698912,-182991,true,11303141895,22,11254645153,-48496742
1636699222,-182994,true,11299751631,22,11281687387,-18064244
1636699503,-182995,true,11298621769,22,11307663830,9042061
1636699601,-182995,true,11298621769,22,11317844800,19223031
1636699997,-182998,true,11295232860,22,11316713128,21480268
1636700536,-183002,true,11290715896,22,11283943837,-6772059
1636700611,-183003,true,11289586937,22,11282815555,-6771382
1636700764,-183004,true,11288458092,22,11279431388,-9026704
1636701095,-183007,true,11285072231,22,11270411902,-14660329
1636701271,-183011,true,11280559331,22,11267031454,-13527877
1636702107,-183009,true,11282815555,22,11403043471,120227916
1636702184,-183009,true,11282815555,22,11411027997,128212442
1636702669,-183009,true,11282815555,22,11393925140,111109585
1636702965,-183013,true,11278303557,22,11357524672,79221115
1636703002,-183012,true,11279431388,22,11352982797,73551409
1636703783,-183013,true,11278303557,22,11304272210,25968653
1636703868,-183014,true,11277175840,22,11303141895,25966055
1636703934,-183018,true,11272666097,22,11302011694,29345597
1636704030,-183017,true,11273793363,22,11297492020,23698657
1636704219,-183019,true,11271538943,22,11288458092,16919149
1636704281,-183019,true,11271538943,22,11285072231,13533288
1636704453,-183023,true,11267031454,22,11276048235,9016781
1636704745,-183022,true,11268158157,22,11262525768,-5632389
1636705083,-183024,true,11265904864,22,11269284973,3380109
1636705241,-183025,true,11264778386,22,11274920743,10142357
1636705513,-183025,true,11264778386,22,11281687387,16909001
1636705547,-183024,true,11265904864,22,11280559331,14654467
1636705904,-183024,true,11265904864,22,11288458092,22553228
1636706110,-183025,true,11264778386,22,11287329359,22550973
1636706305,-183023,true,11267031454,22,11286200739,19169285
1636706426,-183021,true,11269284973,22,11287329359,18044386
1636706548,-183021,true,11269284973,22,11286200739,16915766
1636706797,-183022,true,11268158157,22,11279431388,11273231
1636706970,-183019,true,11271538943,22,11285072231,13533288
1636707199,-183017,true,11273793363,22,11296362383,22569020
1636707541,-183015,true,11276048235,22,11339368069,63319834
1636707649,-183015,true,11276048235,22,11348442739,72394504
1636707853,-183013,true,11278303557,22,11359796290,81492733
1636708403,-183010,true,11281687387,22,11343904497,62217110
1636708485,-183009,true,11282815555,22,11337100536,54284981
1636708918,-183009,true,11282815555,22,11314450125,31634570
1636709287,-183007,true,11285072231,22,11296362383,11290152
1636709877,-183007,true,11285072231,22,11225422542,-59649689
1636710108,-183006,true,11286200739,22,11207477124,-78723615
1636710233,-183007,true,11285072231,22,11201875066,-83197165
1636710351,-183006,true,11286200739,22,11205235964,-80964775
1636711609,-183006,true,11286200739,22,11214203291,-71997448
1636711698,-183006,true,11286200739,22,11211960787,-74239952
1636712072,-183008,true,11283943837,22,11236653018,-47290819
1636712165,-183008,true,11283943837,22,11242272468,-41671369
1636712986,-183006,true,11286200739,22,11286200739,0
1636713605,-183006,true,11286200739,22,11263652021,-22548718
1636714630,-183009,true,11282815555,22,11173906752,-108908803
1636714877,-183009,true,11282815555,22,11178376985,-104438570
1636714933,-183009,true,11282815555,22,11178376985,-104438570
1636715254,-183009,true,11282815555,22,11214203291,-68612264
1636715883,-183009,true,11282815555,22,11272666097,-10149458
1636715903,-183009,true,11282815555,22,11272666097,-10149458
1636716028,-183008,true,11283943837,22,11271538943,-12404894
1636716155,-183010,true,11281687387,22,11270411902,-11275485
1636716211,-183011,true,11280559331,22,11268158157,-12401174
1636716225,-183011,true,11280559331,22,11268158157,-12401174
1636716259,-183011,true,11280559331,22,11267031454,-13527877
1636716579,-183014,true,11277175840,22,11253519801,-23656039
1636716681,-183015,true,11276048235,22,11247894728,-28153507
1636716691,-183015,true,11276048235,22,11246770051,-29278184
1636716740,-183014,true,11277175840,22,11247894728,-29281112
1636716865,-183017,true,11273793363,22,11247894728,-25898635
1636717387,-183018,true,11272666097,22,11260273601,-12392496
1636717689,-183018,true,11272666097,22,11267031454,-5634643
1636718001,-183017,true,11273793363,22,11254645153,-19148210
1636718302,-183020,true,11270411902,22,11260273601,-10138301
1636718420,-183020,true,11270411902,22,11263652021,-6759881
1636718627,-183020,true,11270411902,22,11269284973,-1126929
1636718710,-183017,true,11273793363,22,11272666097,-1127266
1636718790,-183019,true,11271538943,22,11274920743,3381800
1636718874,-183018,true,11272666097,22,11280559331,7893234
1636718911,-183017,true,11273793363,22,11281687387,7894024
1636719046,-183014,true,11277175840,22,11282815555,5639715
1636719129,-183015,true,11276048235,22,11283943837,7895602
1636719571,-183012,true,11279431388,22,11326902245,47470857
1636720137,-183010,true,11281687387,22,11367750534,86063147
1636720160,-183007,true,11285072231,22,11367750534,82678303
1636720761,-183008,true,11283943837,22,11363204570,79260733
1636720774,-183006,true,11286200739,22,11363204570,77003831
1636720813,-183006,true,11286200739,22,11359796290,73595551
1636721011,-183003,true,11289586937,22,11363204570,73617633
1636721034,-183004,true,11288458092,22,11363204570,74746478
1636721132,-183001,true,11291844968,22,11364340890,72495922
1636721162,-183003,true,11289586937,22,11358660424,69073487
1636721431,-183004,true,11288458092,22,11328034935,39576843
1636721436,-183005,true,11287329359,22,11326902245,39572886
1636721496,-183004,true,11288458092,22,11322372617,33914525
1636721537,-183004,true,11288458092,22,11321240493,32782401
1636721673,-183002,true,11290715896,22,11317844800,27128904
1636722129,-183003,true,11289586937,22,11314450125,24863188
1636722279,-183001,true,11291844968,22,11322372617,30527649
1636722288,-183001,true,11291844968,22,11323504854,31659886
1636722293,-183003,true,11289586937,22,11323504854,33917917
1636722472,-183004,true,11288458092,22,11337100536,48642444
1636722780,-183002,true,11290715896,22,11347308008,56592112
1636723024,-183002,true,11290715896,22,11352982797,62266901
1636723108,-183003,true,11289586937,22,11359796290,70209353
1636723787,-183002,true,11290715896,22,11367750534,77034638
1636723940,-183000,true,11292974152,22,11371161200,78187048
1636724338,-183000,true,11292974152,22,11370024197,77050045
1636724591,-183000,true,11292974152,22,11359796290,66822138
1636724809,-182999,true,11294103450,22,11350712541,56609091
1636724967,-182996,true,11297492020,22,11339368069,41876049
1636725004,-182997,true,11296362383,22,11335966939,39604556
1636725019,-182998,true,11295232860,22,11333700086,38467226
1636725236,-182998,true,11295232860,22,11311056469,15823609
1636726047,-182996,true,11297492020,22,11296362383,-1129637
1636726343,-182996,true,11297492020,22,11295232860,-2259160
1636726428,-182997,true,11296362383,22,11292974152,-3388231
1636726715,-182998,true,11295232860,22,11294103450,-1129410
1636727161,-182995,true,11298621769,22,11292974152,-5647617
1636727182,-182996,true,11297492020,22,11292974152,-4517868
1636727238,-182997,true,11296362383,22,11288458092,-7904291
1636727289,-182998,true,11295232860,22,11288458092,-6774768
1636727313,-182997,true,11296362383,22,11286200739,-10161644
1636727376,-182997,true,11296362383,22,11289586937,-6775446
1636727570,-182998,true,11295232860,22,11281687387,-13545473
1636727807,-183000,true,11292974152,22,11283943837,-9030315
1636727831,-182999,true,11294103450,22,11282815555,-11287895
1636727846,-183000,true,11292974152,22,11282815555,-10158597
1636727882,-183001,true,11291844968,22,11283943837,-7901131
1636727894,-183001,true,11291844968,22,11285072231,-6772737
1636727920,-182998,true,11295232860,22,11289586937,-5645923
1636727932,-182997,true,11296362383,22,11290715896,-5646487
1636728000,-182992,true,11302011694,22,11306533177,4521483
1636728310,-182989,true,11305402637,22,11413310317,107907680
1636728314,-182984,true,11311056469,22,11414451648,103395179
1636728386,-182982,true,11313318793,22,11444166348,130847555
1636728414,-182976,true,11320108482,22,11457906904,137798422
1636728761,-182967,true,11330300655,22,11647356344,317055689
1636728932,-182963,true,11334833456,22,11706906608,372073152
1636728943,-182960,true,11338234246,22,11708077299,369843053
1636729021,-182957,true,11341636056,22,11712761232,371125176
1636729245,-182951,true,11348442739,22,11724479266,376036527
1636729444,-182947,true,11352982797,22,11699884922,346902125
1636729775,-182944,true,11356389033,22,11646191725,289802692
1636729837,-182940,true,11360932270,22,11635715391,274783121
1636730932,-182934,true,11367750534,22,11605503335,237752801
1636730996,-182933,true,11368887309,22,11604342900,235455591
1636731012,-182931,true,11371161200,22,11603182582,232021382
1636731199,-182927,true,11375710347,22,11590426736,214716389
1636731564,-182923,true,11380261313,22,11570740733,190479420
1636731675,-182921,true,11382537479,22,11564957097,182419618
1636731704,-182919,true,11384814101,22,11562644453,177830352
1636731708,-182915,true,11389368709,22,11562644453,173275744
1636731765,-182911,true,11393925140,22,11558020551,164095411
1636732423,-182910,true,11395064533,22,11525704972,130640439
1636733154,-182908,true,11397343660,22,11514185604,116841944
1636734248,-182904,true,11401903281,22,11515337022,113433741
1636734272,-182900,true,11406464726,22,11515337022,108872296
1636734526,-182900,true,11406464726,22,11509581081,103116355
1636735028,-182898,true,11408746133,22,11499227635,90481502
1636735243,-182894,true,11413310317,22,11501527596,88217279
1636735273,-182890,true,11417876325,22,11501527596,83651271
1636735464,-182891,true,11416734652,22,11502677749,85943097
1636735690,-182889,true,11419018113,22,11501527596,82509483
1636735695,-182886,true,11422444161,22,11500377558,77933397
1636735714,-182882,true,11427013824,22,11500377558,73363734
1636736110,-182883,true,11425871237,22,11477400936,51529699
1636736249,-182882,true,11427013824,22,11463637003,36623179
1636736493,-182880,true,11429299341,22,11441877858,12578517
1636736500,-182876,true,11433871747,22,11440733785,6862038
1636736818,-182880,true,11429299341,22,11421302031,-7997310
1636736993,-182880,true,11429299341,22,11412169100,-17130241
1636737015,-182878,true,11431585315,22,11411027997,-20557318
1636737592,-182874,true,11436158635,22,11407605373,-28553262
1636737937,-182879,true,11430442271,22,11404183776,-26258495
1636737952,-182878,true,11431585315,22,11404183776,-27401539
1636738857,-182876,true,11433871747,22,11406464726,-27407021
1636739460,-182873,true,11437302251,22,11398483394,-38818857
1636739678,-182877,true,11432728474,22,11405324194,-27404280
1636739718,-182876,true,11433871747,22,11406464726,-27407021
1636739728,-182871,true,11439589826,22,11406464726,-33125100
1636739833,-182868,true,11443022046,22,11401903281,-41118765
1636740034,-182873,true,11437302251,22,11391646697,-45655554
1636740646,-182873,true,11437302251,22,11345038887,-92263364
1636740899,-182870,true,11440733785,22,11345038887,-95694898
1636740976,-182867,true,11444166348,22,11342770220,-101396128
1636741233,-182873,true,11437302251,22,11330300655,-107001596
1636741795,-182875,true,11435015134,22,11283943837,-151071297
1636743093,-182873,true,11437302251,22,11263652021,-173650230
1636743124,-182870,true,11440733785,22,11269284973,-171448812
1636743421,-182876,true,11433871747,22,11306533177,-127338570
1636743531,-182877,true,11432728474,22,11313318793,-119409681
1636743573,-182873,true,11437302251,22,11315581570,-121720681
1636743675,-182871,true,11439589826,22,11321240493,-118349333
1636744293,-182881,true,11428156526,22,11251269434,-176887092
1636744330,-182883,true,11425871237,22,11245645487,-180225750
1636744334,-182878,true,11431585315,22,11244521035,-187064280
1636744511,-182876,true,11433871747,22,11222055589,-211816158
1636744523,-182887,true,11421302031,22,11219811514,-201490517
1636745078,-182886,true,11422444161,22,11233282696,-189161465
1636745107,-182881,true,11428156526,22,11234406024,-193750502
1636745132,-182878,true,11431585315,22,11234406024,-197179291
1636745246,-182888,true,11420160015,22,11237776683,-182383332
1636745518,-182889,true,11419018113,22,11241148353,-177869760
1636745738,-182884,true,11424728764,22,11236653018,-188075746
1636745974,-182881,true,11428156526,22,11233282696,-194873830
1636746185,-182891,true,11416734652,22,11220933496,-195801156
1636746191,-182892,true,11415593093,22,11220933496,-194659597
1636746263,-182887,true,11421302031,22,11217567889,-203734142
1636746466,-182884,true,11424728764,22,11208597871,-216130893
1636746525,-182893,true,11414451648,22,11206356488,-208095160
1636747146,-182895,true,11412169100,22,11192917597,-219251503
1636747295,-182890,true,11417876325,22,11192917597,-224958728
1636747329,-182888,true,11420160015,22,11191798417,-228361598
1636747445,-182898,true,11408746133,22,11188441549,-220304584
1636747933,-182900,true,11406464726,22,11166088145,-240376581
1636748494,-182897,true,11409887008,22,11127077096,-282809912
1636748613,-182895,true,11412169100,22,11120403186,-291765914
1636748665,-182907,true,11398483394,22,11118179438,-280303956
1636749522,-182911,true,11393925140,22,11114844652,-279080488
1636749827,-182911,true,11393925140,22,11119291256,-274633884
1636749866,-182913,true,11391646697,22,11120403186,-271243511
1636749876,-182925,true,11377985602,22,11120403186,-257582416
1636750060,-182929,true,11373435546,22,11119291256,-254144290
1636750291,-182931,true,11371161200,22,11115956136,-255205064
1636750479,-182939,true,11362068363,22,11112622016,-249446347
1636750567,-182951,true,11348442739,22,11109288896,-239153843
1636751240,-182956,true,11342770220,22,11095966411,-246803809
1636751896,-182958,true,11340502006,22,11080443702,-260058304
1636751902,-182963,true,11334833456,22,11079335769,-255497687
1636752172,-182973,true,11323504854,22,11100405463,-223099391
1636752296,-182977,true,11318976584,22,11111510865,-207465719
1636752678,-182977,true,11318976584,22,11144893778,-174082806
1636753021,-182981,true,11314450125,22,11154928195,-159521930
1636753357,-182991,true,11303141895,22,11150467339,-152674556
1636753453,-182995,true,11298621769,22,11150467339,-148154430
1636753555,-182995,true,11298621769,22,11147122868,-151498901
1636753579,-182998,true,11295232860,22,11146008267,-149224593
1636753682,-183008,true,11283943837,22,11140436935,-143506902
1636754357,-183013,true,11278303557,22,11115956136,-162347421
1636754408,-183013,true,11278303557,22,11109288896,-169014661
1636754522,-183015,true,11276048235,22,11109288896,-166759339
1636754745,-183025,true,11264778386,22,11098185715,-166592671
1636754991,-183030,true,11259147686,22,11092638286,-166509400
1636755411,-183028,true,11261399628,22,11141550978,-119848650
1636755581,-183030,true,11259147686,22,11167204753,-91942933
1636756055,-183038,true,11250144420,22,11191798417,-58346003
1636756303,-183043,true,11244521035,22,11167204753,-77316282
1636756463,-183042,true,11245645487,22,11152697544,-92947943
1636756509,-183044,true,11243396695,22,11149352404,-94044291
1636756939,-183054,true,11232159480,22,11121515226,-110644254
1636757168,-183059,true,11226545085,22,11120403186,-106141899
1636757477,-183056,true,11229913385,22,11130415553,-99497832
1636757583,-183058,true,11227667739,22,11133755011,-93912728
1636757854,-183066,true,11218689645,22,11151582386,-67107259
1636758270,-183070,true,11214203291,22,11167204753,-46998538
1636758363,-183067,true,11217567889,22,11169438306,-48129583
1636758576,-183068,true,11216446244,22,11192917597,-23528647
1636758685,-183075,true,11208597871,22,11202995253,-5602618
1636758882,-183077,true,11206356488,22,11219811514,13455026
1636758914,-183073,true,11210839703,22,11222055589,11215886
1636759017,-183075,true,11208597871,22,11229913385,21315514
1636759345,-183081,true,11201875066,22,11244521035,42645969
1636759354,-183084,true,11198515175,22,11244521035,46005860
1636759564,-183080,true,11202995253,22,11232159480,29164227
1636759708,-183082,true,11200754990,22,11222055589,21300599
1636759768,-183090,true,11191798417,22,11217567889,25769472
1636760160,-183093,true,11188441549,22,11188441549,0
1636760336,-183090,true,11191798417,22,11178376985,-13421432
1636760552,-183092,true,11189560393,22,11168321474,-21238919
1636760636,-183098,true,11182849006,22,11164971647,-17877359
1636760874,-183100,true,11180612772,22,11161622826,-18989946
1636760959,-183098,true,11182849006,22,11157159292,-25689714
1636761139,-183100,true,11180612772,22,11146008267,-34604505
1636761355,-183106,true,11173906752,22,11133755011,-40151741
1636762698,-183108,true,11171672305,22,11102625655,-69046650
1636762828,-183104,true,11176141645,22,11100405463,-75736182
1636762838,-183107,true,11172789473,22,11100405463,-72384010
1636763038,-183113,true,11166088145,22,11122627377,-43460768
1636763607,-183111,true,11168321474,22,11208597871,40276397
1636763657,-183110,true,11169438306,22,11210839703,41401397
1636763778,-183113,true,11166088145,22,11211960787,45872642
1636763796,-183115,true,11163855262,22,11208597871,44742609
1636763818,-183116,true,11162738988,22,11205235964,42496976
1636763930,-183114,true,11164971647,22,11202995253,38023606
1636764137,-183113,true,11166088145,22,11204115553,38027408
1636764422,-183114,true,11164971647,22,11206356488,41384841
1636764456,-183116,true,11162738988,22,11205235964,42496976
1636764547,-183114,true,11164971647,22,11208597871,43626224
1636764622,-183114,true,11164971647,22,11215324712,50353065
1636764730,-183115,true,11163855262,22,11227667739,63812477
1636765174,-183117,true,11161622826,22,11220933496,59310670
1636765407,-183114,true,11164971647,22,11216446244,51474597
1636765537,-183114,true,11164971647,22,11216446244,51474597
1636765772,-183115,true,11163855262,22,11213081983,49226721
1636766268,-183117,true,11161622826,22,11205235964,43613138
1636766540,-183114,true,11164971647,22,11201875066,36903419
1636766551,-183114,true,11164971647,22,11201875066,36903419
1636766637,-183115,true,11163855262,22,11197395436,33540174
1636766784,-183118,true,11160506775,22,11190679349,30172574
1636766876,-183115,true,11163855262,22,11196275808,32420546
1636767096,-183113,true,11166088145,22,11206356488,40268343
1636767157,-183113,true,11166088145,22,11208597871,42509726
1636767413,-183114,true,11164971647,22,11227667739,62696092
1636767509,-183110,true,11169438306,22,11236653018,67214712
1636767621,-183108,true,11171672305,22,11238900461,67228156
1636767807,-183109,true,11170555250,22,11229913385,59358135
1636767891,-183111,true,11168321474,22,11223177795,54856321
1636768354,-183108,true,11171672305,22,11158275008,-13397297
1636768553,-183107,true,11172789473,22,11147122868,-25666605
1636768875,-183108,true,11171672305,22,11141550978,-30121327
1636769478,-183110,true,11169438306,22,11144893778,-24544528
1636769516,-183107,true,11172789473,22,11143779400,-29010073
1636769545,-183106,true,11173906752,22,11142665133,-31241619
1636769582,-183107,true,11172789473,22,11140436935,-32352538
1636770355,-183111,true,11168321474,22,11083768168,-84553306
1636770673,-183107,true,11172789473,22,11080443702,-92345771
1636771222,-183105,true,11175024142,22,11104846291,-70177851
1636771323,-183107,true,11172789473,22,11107067372,-65722101
1636771343,-183111,true,11168321474,22,11108178078,-60143396
1636771503,-183109,true,11170555250,22,11109288896,-61266354
1636771627,-183108,true,11171672305,22,11104846291,-66826014
1636771679,-183110,true,11169438306,22,11099295533,-70142773
1636772265,-183114,true,11164971647,22,11071583335,-93388312
1636773096,-183112,true,11167204753,22,11070476287,-96728466
1636773251,-183111,true,11168321474,22,11070476287,-97845187
1636774636,-183112,true,11167204753,22,11093747550,-73457203
1636774695,-183115,true,11163855262,22,11092638286,-71216976
1636774804,-183113,true,11166088145,22,11087093631,-78994514
1636775035,-183112,true,11167204753,22,11073797762,-93406991
1636775450,-183115,true,11163855262,22,11048358566,-115496696
1636775554,-183117,true,11161622826,22,11042836043,-118786783
1636776149,-183117,true,11161622826,22,11031799278,-129823548
1636776429,-183117,true,11161622826,22,11029593249,-132029577
1636776460,-183121,true,11157159292,22,11029593249,-127566043
1636776657,-183123,true,11154928195,22,11030696209,-124231986
1636777041,-183123,true,11154928195,22,11029593249,-125334946
1636777166,-183121,true,11157159292,22,11046149225,-111010067
1636777184,-183123,true,11154928195,22,11049463401,-105464794
1636777204,-183125,true,11152697544,22,11051673405,-101024139
1636777332,-183121,true,11157159292,22,11072690493,-84468799
1636777595,-183119,true,11159390836,22,11115956136,-43434700
1636777836,-183122,true,11156043688,22,11157159292,1115604
1636777841,-183125,true,11152697544,22,11157159292,4461748
1636777921,-183121,true,11157159292,22,11159390836,2231544
1636777926,-183121,true,11157159292,22,11159390836,2231544
1636778353,-183129,true,11148237580,22,11105956776,-42280804
1636778395,-183133,true,11143779400,22,11099295533,-44483867
1636778406,-183130,true,11147122868,22,11097076007,-50046861
1636778475,-183130,true,11147122868,22,11085985032,-61137836
1636778591,-183137,true,11139323002,22,11064942709,-74380293
1636778796,-183141,true,11134868387,22,11038420013,-96448374
1636779131,-183138,true,11138209181,22,11028490400,-109718781
1636779158,-183137,true,11139323002,22,11028490400,-110832602
1636779213,-183144,true,11131528594,22,11026285033,-105243561
1636779250,-183148,true,11127077096,22,11025182515,-101894581
1636779587,-183145,true,11130415553,22,11018569720,-111845833
1636780331,-183144,true,11131528594,22,11010859805,-120668789
1636780713,-183151,true,11123739640,22,11002055080,-121684560
1636781140,-183154,true,11120403186,22,10988861192,-131541994
1636781407,-183151,true,11123739640,22,10986663749,-137075891
1636781433,-183150,true,11124852014,22,10986663749,-138188265
1636781724,-183157,true,11117067732,22,10986663749,-130403983
1636781784,-183159,true,11114844652,22,10986663749,-128180903
1636782016,-183156,true,11118179438,22,10987762415,-130417023
1636782156,-183155,true,11119291256,22,10977878372,-141412884
1636782293,-183163,true,11110399825,22,10968003220,-142396605
1636782514,-183170,true,11102625655,22,10951564369,-151061286
1636782527,-183168,true,11104846291,22,10952659525,-152186766
1636782607,-183166,true,11107067372,22,10960328688,-146738684
1636782624,-183173,true,11099295533,22,10962520863,-136774670
1636783577,-183172,true,11100405463,22,11064942709,-35462754
1636783682,-183171,true,11101515504,22,11062730053,-38785451
1636783702,-183172,true,11100405463,22,11062730053,-37675410
1636784168,-183180,true,11091529133,22,11020773544,-70755589
1636784170,-183182,true,11089311160,22,11019671577,-69639583
1636784362,-183181,true,11090420091,22,11020773544,-69646547
1636784604,-183180,true,11091529133,22,11020773544,-70755589
1636785080,-183188,true,11082659902,22,11040627807,-42032095
1636786022,-183189,true,11081551747,22,11016366337,-65185410
1636786531,-183189,true,11081551747,22,10994356721,-87195026
1636786542,-183189,true,11081551747,22,10994356721,-87195026
1636786930,-183196,true,11073797762,22,11021875621,-51922141
1636787359,-183196,true,11073797762,22,11069369350,-4428412
1636787536,-183194,true,11076012633,22,11077120234,1107601
1636787685,-183194,true,11076012633,22,11076012633,0
1636787962,-183202,true,11067155808,22,11047253840,-19901968
1636788028,-183202,true,11067155808,22,11039523855,-27631953
1636788217,-183201,true,11068262524,22,11040627807,-27634717
1636788361,-183201,true,11068262524,22,11040627807,-27634717
1636788400,-183208,true,11060517838,22,11041731870,-18785968
1636788412,-183210,true,11058306067,22,11041731870,-16574197
1636789154,-183208,true,11060517838,22,11079335769,18817931
1636789596,-183208,true,11060517838,22,11078227946,17710108
1636789914,-183214,true,11053883850,22,11080443702,26559852
1636790199,-183214,true,11053883850,22,11080443702,26559852
1636791285,-183211,true,11057200347,22,11077120234,19919887
1636791324,-183211,true,11057200347,22,11076012633,18812286
1636791803,-183216,true,11051673405,22,11087093631,35420226
1636791862,-183217,true,11050568348,22,11087093631,36525283
1636792021,-183213,true,11054989238,22,11085985032,30995794
1636792112,-183213,true,11054989238,22,11084876545,29887307
1636792401,-183221,true,11046149225,22,11057200347,11051122
1636792417,-183219,true,11048358566,22,11056094737,7736171
1636792509,-183215,true,11052778572,22,11054989238,2210666
1636792689,-183215,true,11052778572,22,11050568348,-2210224
1636792732,-183221,true,11046149225,22,11049463401,3314176
1636794448,-183220,true,11047253840,22,11061623890,14370050
1636794577,-183217,true,11050568348,22,11060517838,9949490
1636794748,-183216,true,11051673405,22,11058306067,6632662
1636795439,-183222,true,11045044721,22,11067155808,22111087
1636795930,-183221,true,11046149225,22,11069369350,23220125
1636796164,-183217,true,11050568348,22,11074905142,24336794
1636796331,-183216,true,11051673405,22,11077120234,25446829
1636796678,-183222,true,11045044721,22,11082659902,37615181
1636796887,-183221,true,11046149225,22,11082659902,36510677
1636797020,-183217,true,11050568348,22,11080443702,29875354
1636798654,-183217,true,11050568348,22,11067155808,16587460
1636798859,-183221,true,11046149225,22,11062730053,16580828
1636798887,-183220,true,11047253840,22,11062730053,15476213
1636798911,-183216,true,11051673405,22,11061623890,9950485
1636799068,-183216,true,11051673405,22,11060517838,8844433
1636799181,-183220,true,11047253840,22,11059411897,12158057
1636799353,-183217,true,11050568348,22,11081551747,30983399
1636799487,-183212,true,11056094737,22,11098185715,42090978
1636799986,-183213,true,11054989238,22,11123739640,68750402
1636800741,-183217,true,11050568348,22,11100405463,49837115
1636801050,-183215,true,11052778572,22,11100405463,47626891
1636801233,-183215,true,11052778572,22,11099295533,46516961
1636801243,-183216,true,11051673405,22,11098185715,46512310
1636801280,-183221,true,11046149225,22,11099295533,53146308
1636801344,-183218,true,11049463401,22,11098185715,48722314
1636801392,-183217,true,11050568348,22,11100405463,49837115
1636801424,-183217,true,11050568348,22,11102625655,52057307
1636801525,-183217,true,11050568348,22,11112622016,62053668
1636801636,-183212,true,11056094737,22,11132641747,76547010
1636802011,-183208,true,11060517838,22,11215324712,154806874
1636802416,-183208,true,11060517838,22,11274920743,214402905
1636802716,-183207,true,11061623890,22,11245645487,184021597
1636803046,-183203,true,11066049204,22,11214203291,148154087
1636803144,-183200,true,11069369350,22,11207477124,138107774
1636803324,-183201,true,11068262524,22,11194036889,125774365
1636803510,-183201,true,11068262524,22,11171672305,103409781
1636803634,-183198,true,11071583335,22,11158275008,86691673
1636803643,-183196,true,11073797762,22,11158275008,84477246
1636804052,-183194,true,11076012633,22,11175024142,99011509
1636804344,-183193,true,11077120234,22,11200754990,123634756
1636804451,-183189,true,11081551747,22,11213081983,131530236
1636804656,-183187,true,11083768168,22,11217567889,133799721
1636805129,-183186,true,11084876545,22,11196275808,111399263
1636805648,-183185,true,11085985032,22,11180612772,94627740
1636805935,-183181,true,11090420091,22,11175024142,84604051
1636805972,-183179,true,11092638286,22,11173906752,81268466
1636806198,-183178,true,11093747550,22,11152697544,58949994
1636806243,-183178,true,11093747550,22,11149352404,55604854
1636806353,-183174,true,11098185715,22,11144893778,46708063
1636806400,-183171,true,11101515504,22,11143779400,42263896
1636806435,-183171,true,11101515504,22,11141550978,40035474
1636806455,-183171,true,11101515504,22,11139323002,37807498
1636806875,-183172,true,11100405463,22,11118179438,17773975
1636806955,-183169,true,11103735918,22,11121515226,17779308
1636807055,-183168,true,11104846291,22,11125964499,21118208
1636807553,-183167,true,11105956776,22,11128189803,22233027
1636808371,-183168,true,11104846291,22,11074905142,-29941149
1636808484,-183165,true,11108178078,22,11064942709,-43235369
1636808746,-183165,true,11108178078,22,11077120234,-31057844
1636808915,-183166,true,11107067372,22,11083768168,-23299204
1636809026,-183165,true,11108178078,22,11087093631,-21084447
1636809050,-183162,true,11111510865,22,11087093631,-24417234
1636809215,-183162,true,11111510865,22,11090420091,-21090774
1636809326,-183163,true,11110399825,22,11091529133,-18870692
1636809516,-183162,true,11111510865,22,11104846291,-6664574
1636810016,-183160,true,11113733278,22,11128189803,14456525
1636810308,-183160,true,11113733278,22,11139323002,25589724
1636810535,-183159,true,11114844652,22,11133755011,18910359
1636811329,-183158,true,11115956136,22,11123739640,7783504
1636811340,-183156,true,11118179438,22,11123739640,5560202
1636811966,-183156,true,11118179438,22,11124852014,6672576
1636812629,-183157,true,11117067732,22,11119291256,2223524
1636812704,-183156,true,11118179438,22,11118179438,0
1636813206,-183154,true,11120403186,22,11104846291,-15556895
1636813236,-183154,true,11120403186,22,11107067372,-13335814
1636813246,-183156,true,11118179438,22,11107067372,-11112066
1636813295,-183155,true,11119291256,22,11107067372,-12223884
1636813704,-183152,true,11122627377,22,11111510865,-11116512
1636813988,-183153,true,11121515226,22,11108178078,-13337148
1636814062,-183155,true,11119291256,22,11105956776,-13334480
1636814072,-183155,true,11119291256,22,11105956776,-13334480
1636814137,-183153,true,11121515226,22,11101515504,-19999722
1636814241,-183152,true,11122627377,22,11107067372,-15560005
1636814385,-183151,true,11123739640,22,11112622016,-11117624
1636814697,-183150,true,11124852014,22,11123739640,-1112374
1636814722,-183148,true,11127077096,22,11120403186,-6673910
1636814798,-183148,true,11127077096,22,11120403186,-6673910
1636814813,-183149,true,11125964499,22,11120403186,-5561313
1636814878,-183150,true,11124852014,22,11119291256,-5560758
1636814889,-183148,true,11127077096,22,11119291256,-7785840
1636814931,-183149,true,11125964499,22,11114844652,-11119847
1636815114,-183149,true,11125964499,22,11109288896,-16675603
1636815677,-183151,true,11123739640,22,11038420013,-85319627
1636815744,-183149,true,11125964499,22,11034005748,-91958751
1636816380,-183151,true,11123739640,22,11002055080,-121684560
1636816680,-183152,true,11122627377,22,10997655358,-124972019
1636816884,-183155,true,11119291256,22,10999854999,-119436257
1636817074,-183152,true,11122627377,22,11002055080,-120572297
1636817296,-183154,true,11120403186,22,11005356027,-115047159
1636817408,-183154,true,11120403186,22,11005356027,-115047159
1636817644,-183157,true,11117067732,22,11006456562,-110611170
1636817783,-183154,true,11120403186,22,11022977809,-97425377
1636817882,-183154,true,11120403186,22,11037316281,-83086905
1636818172,-183153,true,11121515226,22,11078227946,-43287280
1636818618,-183156,true,11118179438,22,11130415553,12236115
1636818695,-183153,true,11121515226,22,11137095472,15580246
1636818752,-183154,true,11120403186,22,11134868387,14465201
1636818869,-183152,true,11122627377,22,11134868387,12241010
1636818930,-183155,true,11119291256,22,11133755011,14463755
1636819214,-183152,true,11122627377,22,11133755011,11127634
1636819267,-183152,true,11122627377,22,11132641747,10014370
1636819379,-183151,true,11123739640,22,11132641747,8902107
1636819383,-183154,true,11120403186,22,11132641747,12238561
1636819600,-183152,true,11122627377,22,11119291256,-3336121
1636819899,-183153,true,11121515226,22,11105956776,-15558450
1636820286,-183154,true,11120403186,22,11085985032,-34418154
1636820420,-183159,true,11114844652,22,11082659902,-32184750
1636820696,-183160,true,11113733278,22,11078227946,-35505332
1636820911,-183162,true,11111510865,22,11064942709,-46568156
1636821168,-183162,true,11111510865,22,11049463401,-62047464
1636821233,-183167,true,11105956776,22,11045044721,-60912055
1636821898,-183168,true,11104846291,22,11010859805,-93986486
1636821996,-183169,true,11103735918,22,11011960891,-91775027
1636822315,-183168,true,11104846291,22,11025182515,-79663776
1636822405,-183171,true,11101515504,22,11028490400,-73025104
1636822435,-183171,true,11101515504,22,11032902458,-68613046
1636822471,-183174,true,11098185715,22,11038420013,-59765702
1636822635,-183172,true,11100405463,22,11059411897,-40993566
1636823797,-183174,true,11098185715,22,11166088145,67902430
1636823816,-183174,true,11098185715,22,11164971647,66785932
1636824039,-183175,true,11097076007,22,11158275008,61199001
1636824255,-183174,true,11098185715,22,11135981874,37796159
1636824484,-183178,true,11093747550,22,11107067372,13319822
1636824613,-183178,true,11093747550,22,11087093631,-6653919
1636824858,-183180,true,11091529133,22,11052778572,-38750561
1636824874,-183178,true,11093747550,22,11050568348,-43179202
1636824896,-183182,true,11089311160,22,11047253840,-42057320
1636825116,-183182,true,11089311160,22,11030696209,-58614951
1636825313,-183185,true,11085985032,22,11022977809,-63007223
1636825336,-183183,true,11088202340,22,11021875621,-66326719
1636825557,-183186,true,11084876545,22,11017467973,-67408572
1636825865,-183186,true,11084876545,22,11016366337,-68510208
1636825956,-183189,true,11081551747,22,11015264810,-66286937
1636825997,-183188,true,11082659902,22,11015264810,-67395092
1636826268,-183190,true,11080443702,22,11011960891,-68482811
1636826284,-183190,true,11080443702,22,11011960891,-68482811
1636826376,-183192,true,11078227946,22,11015264810,-62963136
1636826456,-183190,true,11080443702,22,11019671577,-60772125
1636827121,-183191,true,11079335769,22,11052778572,-26557197
1636827381,-183192,true,11078227946,22,11051673405,-26554541
1636827667,-183195,true,11074905142,22,11022977809,-51927333
1636827690,-183192,true,11078227946,22,11019671577,-58556369
1636827703,-183196,true,11073797762,22,11019671577,-54126185
1636827834,-183198,true,11071583335,22,11011960891,-59622444
1636828220,-183199,true,11070476287,22,11013062087,-57414200
1636828404,-183196,true,11073797762,22,11015264810,-58532952
1636828417,-183200,true,11069369350,22,11016366337,-53003013
1636828631,-183202,true,11067155808,22,11022977809,-44177999
1636828770,-183204,true,11064942709,22,11018569720,-46372989
1636828847,-183202,true,11067155808,22,11013062087,-54093721
1636828926,-183205,true,11063836326,22,11004255601,-59580725
1636829810,-183208,true,11060517838,22,10944995730,-115522108
1636829865,-183210,true,11058306067,22,10950469322,-107836745
1636830081,-183208,true,11060517838,22,10959232764,-101285074
1636830117,-183211,true,11057200347,22,10961424720,-95775627
1636830252,-183214,true,11053883850,22,10964713477,-89170373
1636830291,-183216,true,11051673405,22,10965809948,-85863457
1636830622,-183214,true,11053883850,22,10964713477,-89170373
1636830837,-183216,true,11051673405,22,10993257396,-58416009
1636831198,-183216,true,11051673405,22,11042836043,-8837362
1636831425,-183218,true,11049463401,22,11081551747,32088346
1636831458,-183216,true,11051673405,22,11087093631,35420226
1636831893,-183219,true,11048358566,22,11054989238,6630672
1636832076,-183220,true,11047253840,22,11035109149,-12144691
1636832105,-183223,true,11043940327,22,11031799278,-12141049
1636832280,-183220,true,11047253840,22,11010859805,-36394035
1636832741,-183222,true,11045044721,22,10996555703,-48489018
1636832888,-183224,true,11042836043,22,10994356721,-48479322
1636833157,-183226,true,11040627807,22,10983368409,-57259398
1636833277,-183224,true,11042836043,22,10984466746,-58369297
1636833333,-183224,true,11042836043,22,10985565193,-57270850
1636833620,-183225,true,11041731870,22,10998755124,-42976746
1636833832,-183225,true,11041731870,22,11007557208,-34174662
1636833895,-183223,true,11043940327,22,11011960891,-31979436
1636834180,-183223,true,11043940327,22,11020773544,-23166783
1636834687,-183224,true,11042836043,22,11011960891,-30875152
1636834705,-183225,true,11041731870,22,11011960891,-29770979
1636834773,-183223,true,11043940327,22,11010859805,-33080522
1636834905,-183223,true,11043940327,22,11007557208,-36383119
1636834916,-183226,true,11040627807,22,11007557208,-33070599
1636834971,-183228,true,11038420013,22,11005356027,-33063986
1636835506,-183227,true,11039523855,22,10992158180,-47365675
1636835560,-183229,true,11037316281,22,10991059074,-46257207
1636835756,-183232,true,11034005748,22,10989960078,-44045670
1636835960,-183234,true,11031799278,22,10982270182,-49529096
1636835968,-183234,true,11031799278,22,10982270182,-49529096
1636836055,-183236,true,11029593249,22,10976780694,-52812555
1636836420,-183238,true,11027387662,22,10975683126,-51704536
1636836536,-183240,true,11025182515,22,10974585667,-50596848
1636836576,-183240,true,11025182515,22,10972391079,-52791436
1636836782,-183242,true,11022977809,22,10961424720,-61553089
1636837909,-183246,true,11018569720,22,10931870268,-86699452
1636837939,-183247,true,11017467973,22,10929684222,-87783751
1636838104,-183246,true,11018569720,22,10936243672,-82326048
1636838132,-183249,true,11015264810,22,10937337296,-77927514
1636838507,-183250,true,11014163394,22,10952659525,-61503869
1636838775,-183251,true,11013062087,22,10960328688,-52733399
1636838926,-183250,true,11014163394,22,10962520863,-51642531
1636839093,-183252,true,11011960891,22,10960328688,-51632203
1636839265,-183253,true,11010859805,22,10957041246,-53818559
1636839343,-183254,true,11009758830,22,10955945652,-53813178
1636839471,-183253,true,11010859805,22,10952659525,-58200280
1636839622,-183255,true,11008657964,22,10952659525,-55998439
1636839866,-183257,true,11006456562,22,10951564369,-54892193
1636840027,-183258,true,11005356027,22,10954850167,-50505860
1636840486,-183258,true,11005356027,22,10964713477,-40642550
1636840536,-183263,true,10999854999,22,10964713477,-35141522
1636840669,-183265,true,10997655358,22,10964713477,-32941881
1636841091,-183266,true,10996555703,22,10953754791,-42800912
1636841295,-183267,true,10995456157,22,10944995730,-50460427
1636841322,-183269,true,10993257396,22,10941712887,-51544509
1636841449,-183271,true,10991059074,22,10938431030,-52628044
1636841926,-183271,true,10991059074,22,10926405972,-64653102
1636842064,-183271,true,10991059074,22,10925313441,-65745633
1636842311,-183273,true,10988861192,22,10923128706,-65732486
1636842494,-183275,true,10986663749,22,10920944408,-65719341
1636842575,-183275,true,10986663749,22,10920944408,-65719341
1636842740,-183275,true,10986663749,22,10920944408,-65719341
1636843012,-183277,true,10984466746,22,10919852422,-64614324
1636843025,-183279,true,10982270182,22,10919852422,-62417760
1636843045,-183279,true,10982270182,22,10920944408,-61325774
1636843093,-183279,true,10982270182,22,10922036502,-60233680
1636843222,-183281,true,10980074057,22,10922036502,-58037555
1636843351,-183282,true,10978976160,22,10923128706,-55847454
1636843373,-183283,true,10977878372,22,10923128706,-54749666
1636843464,-183283,true,10977878372,22,10924221019,-53657353
1636843827,-183286,true,10974585667,22,10923128706,-51456961
1636843849,-183288,true,10972391079,22,10923128706,-49262373
1636843867,-183287,true,10973488318,22,10923128706,-50359612
1636843946,-183288,true,10972391079,22,10926405972,-45985107
1636844113,-183288,true,10972391079,22,10929684222,-42706857
1636844202,-183289,true,10971293950,22,10929684222,-41609728
1636844575,-183291,true,10969100020,22,10951564369,-17535651
1636844601,-183290,true,10970196930,22,10953754791,-16442139
1636844769,-183291,true,10969100020,22,10964713477,-4386543
1636845814,-183291,true,10969100020,22,10972391079,3291059
1636845856,-183292,true,10968003220,22,10971293950,3290730
1636846236,-183291,true,10969100020,22,10970196930,1096910
1636846318,-183292,true,10968003220,22,10969100020,1096800
1636846647,-183290,true,10970196930,22,10984466746,14269816
1636846954,-183290,true,10970196930,22,11003155286,32958356
1636847378,-183289,true,10971293950,22,11021875621,50581671
1636847513,-183289,true,10971293950,22,11021875621,50581671
1636847594,-183288,true,10972391079,22,11021875621,49484542
1636847648,-183288,true,10972391079,22,11019671577,47280498
1636847809,-183287,true,10973488318,22,11015264810,41776492
1636847829,-183289,true,10971293950,22,11015264810,43970860
1636847944,-183290,true,10970196930,22,11008657964,38461034
1636847989,-183290,true,10970196930,22,11007557208,37360278
1636848055,-183291,true,10969100020,22,11008657964,39557944
1636848096,-183291,true,10969100020,22,11007557208,38457188
1636848155,-183291,true,10969100020,22,11007557208,38457188
1636848268,-183290,true,10970196930,22,11009758830,39561900
1636848311,-183290,true,10970196930,22,11010859805,40662875
1636848703,-183290,true,10970196930,22,11020773544,50576614
1636848880,-183289,true,10971293950,22,11029593249,58299299
1636848942,-183288,true,10972391079,22,11027387662,54996583
1636849608,-183289,true,10971293950,22,10995456157,24162207
1636849889,-183289,true,10971293950,22,10985565193,14271243
1636849969,-183290,true,10970196930,22,10984466746,14269816
1636849988,-183290,true,10970196930,22,10985565193,15368263
1636850166,-183288,true,10972391079,22,11016366337,43975258
1636850171,-183287,true,10973488318,22,11017467973,43979655
1636850215,-183284,true,10976780694,22,11028490400,51709706
1636850303,-183283,true,10977878372,22,11050568348,72689976
1636850340,-183280,true,10981172065,22,11060517838,79345773
1636850386,-183278,true,10983368409,22,11071583335,88214926
1636850417,-183275,true,10986663749,22,11078227946,91564197
1636850437,-183274,true,10987762415,22,11083768168,96005753
1636850565,-183272,true,10989960078,22,11111510865,121550787
1636850938,-183270,true,10992158180,22,11188441549,196283369
1636851146,-183267,true,10995456157,22,11192917597,197461440
1636851300,-183265,true,10997655358,22,11204115553,206460195
1636851345,-183262,true,11000954985,22,11207477124,206522139
1636851424,-183258,true,11005356027,22,11222055589,216699562
1636851525,-183252,true,11011960891,22,11252394561,240433670
1636851731,-183247,true,11017467973,22,11313318793,295850820
1636851746,-183243,true,11021875621,22,11317844800,295969179
1636852175,-183238,true,11027387662,22,11444166348,416778686
1636852237,-183230,true,11036212660,22,11459052694,422840034
1636852329,-183225,true,11041731870,22,11472811123,431079253
1636852449,-183220,true,11047253840,22,11493479746,446225906
1636852773,-183212,true,11056094737,22,11543005637,486910900
1636853007,-183205,true,11063836326,22,11571897807,508061481
1636853226,-183198,true,11071583335,22,11622923781,551340446
1636853348,-183193,true,11077120234,22,11633388597,556268363
1636853407,-183184,true,11087093631,22,11645027222,557933591
1636853553,-183173,true,11099295533,22,11688191469,588895936
1636853630,-183164,true,11109288896,22,11717447040,608158144
1636853698,-183156,true,11118179438,22,11744426834,626247396
1636853848,-183145,true,11130415553,22,11798572930,668157377
1636853883,-183135,true,11141550978,22,11806834410,665283432
1636854064,-183127,true,11150467339,22,11836386943,685919604
1636854174,-183121,true,11157159292,22,11847043954,689884662
1636854279,-183112,true,11167204753,22,11855339373,688134620
1636854290,-183101,true,11179494822,22,11855339373,675844551
1636854379,-183094,true,11187322817,22,11848228658,660905841
1636854391,-183087,true,11195156293,22,11847043954,651887661
1636854905,-183080,true,11202995253,22,11752650399,549655146
1636854941,-183069,true,11215324712,22,11750300222,534975510
1636855343,-183062,true,11223177795,22,11731515712,508337917
1636855412,-183055,true,11231036376,22,11732688864,501652488
1636855508,-183048,true,11238900461,22,11724479266,485578805
1636855735,-183039,true,11249019518,22,11680013007,430993489
1636856074,-183035,true,11253519801,22,11612468378,358948577
1636856101,-183029,true,11260273601,22,11604342900,344069299
1636856148,-183023,true,11267031454,22,11591585779,324554325
1636856413,-183013,true,11278303557,22,11561488304,283184747
1636856592,-183007,true,11285072231,22,11584633261,299561030
1636856681,-183001,true,11291844968,22,11596223108,304378140
1636856754,-182994,true,11299751631,22,11611307247,311555616
1636856883,-182982,true,11313318793,22,11638042651,324723858
1636856971,-182975,true,11321240493,22,11660174844,338934351
1636857237,-182967,true,11330300655,22,11719790646,389489991
1636857290,-182960,true,11338234246,22,11729169761,390935515
1636857482,-182948,true,11351847613,22,11749125309,397277696
1636857647,-182941,true,11359796290,22,11762055811,402259521
1636858139,-182933,true,11368887309,22,11763232016,394344707
1636858457,-182927,true,11375710347,22,11763232016,387521669
1636858863,-182915,true,11389368709,22,11757352165,367983456
1636858889,-182909,true,11396204039,22,11757352165,361148126
1636858926,-182902,true,11404183776,22,11756176547,351992771
1636858981,-182896,true,11411027997,22,11756176547,345148550
1636859377,-182887,true,11421302031,22,11719790646,298488615
1636859635,-182881,true,11428156526,22,11696375658,268219132
1636859738,-182873,true,11437302251,22,11685854182,248551931
1636860156,-182868,true,11443022046,22,11656677491,213655445
1636860245,-182860,true,11452179669,22,11653181187,201001518
1636860292,-182855,true,11457906904,22,11650850900,192943996
1636860307,-182848,true,11465929845,22,11650850900,184921055
1636860486,-182844,true,11470516905,22,11642698566,172181661
1636860572,-182835,true,11480844501,22,11639206455,158361954
1636860605,-182830,true,11486586071,22,11638042651,151456580
1636860868,-182823,true,11494629094,22,11634551936,139922842
1636860978,-182818,true,11500377558,22,11634551936,134174378
1636861521,-182811,true,11508430238,22,11589267809,80837571
1636863151,-182807,true,11513034301,22,11563800717,50766416
1636863194,-182800,true,11521095843,22,11564957097,43861254
1636863897,-182795,true,11526857543,22,11589267809,62410266
1636863966,-182789,true,11533775387,22,11588108998,54333611
1636864472,-182785,true,11538389589,22,11564957097,26567508
1636864656,-182778,true,11546468885,22,11560332271,13863386
1636864718,-182774,true,11551088165,22,11559176353,8088188
1636864983,-182767,true,11559176353,22,11561488304,2311951
1636865323,-182762,true,11564957097,22,11575369723,10412626
1636865328,-182755,true,11573054996,22,11575369723,2314727
1636865502,-182750,true,11578842681,22,11592744937,13902256
1636865619,-182742,true,11588108998,22,11607824551,19715553
1636866017,-182734,true,11597382731,22,11662506996,65124265
1636866040,-182729,true,11603182582,22,11667172698,63990116
1636866072,-182726,true,11606663885,22,11666006098,59342213
1636866176,-182721,true,11612468378,22,11661340862,48872484
1636866641,-182719,true,11614790987,22,11599702323,-15088664
1636866784,-182716,true,11618275773,22,11582316682,-35959091
1636866992,-182712,true,11622923781,22,11545314354,-77609427
1636867097,-182708,true,11627573648,22,11541851452,-85722196
1636867118,-182706,true,11629899279,22,11540697382,-89201897
1636867165,-182704,true,11632225375,22,11531468977,-100756398
1636868648,-182705,true,11631062268,22,11363204570,-267857698
1636868693,-182701,true,11635715391,22,11362068363,-273647028
1636868745,-182700,true,11636878963,22,11362068363,-274810600
1636868888,-182697,true,11640370376,22,11362068363,-278302013
1636868979,-182700,true,11636878963,22,11362068363,-274810600
1636868980,-182700,true,11636878963,22,11362068363,-274810600
1636869225,-182701,true,11635715391,22,11372298316,-263417075
1636869810,-182699,true,11638042651,22,11396204039,-241838612
1636870060,-182703,true,11633388597,22,11398483394,-234905203
1636870080,-182703,true,11633388597,22,11396204039,-237184558
1636870152,-182705,true,11631062268,22,11390507646,-240554622
1636870192,-182705,true,11631062268,22,11384814101,-246248167
1636871113,-182715,true,11619437601,22,11289586937,-329850664
1636871152,-182715,true,11619437601,22,11289586937,-329850664
1636871170,-182718,true,11615952466,22,11290715896,-325236570
1636871330,-182718,true,11615952466,22,11294103450,-321849016
1636871603,-182729,true,11603182582,22,11300881606,-302300976
1636871840,-182732,true,11599702323,22,11308794597,-290907726
1636871920,-182738,true,11592744937,22,11311056469,-281688468
1636872324,-182740,true,11590426736,22,11321240493,-269186243
1636872375,-182752,true,11576527260,22,11321240493,-255286767
1636872431,-182755,true,11573054996,22,11323504854,-249550142
1636872681,-182759,true,11568426932,22,11331433686,-236993246
1636872759,-182760,true,11567270205,22,11333700086,-233570119
1636872974,-182770,true,11555709294,22,11325769668,-229939626
1636873025,-182774,true,11551088165,22,11324637204,-226450961
1636873154,-182778,true,11546468885,22,11317844800,-228624085
1636873457,-182780,true,11544159938,22,11298621769,-245538169
1636873459,-182788,true,11534928764,22,11298621769,-236306995
1636873460,-182792,true,11530315946,22,11298621769,-231694177
1636873487,-182796,true,11525704972,22,11297492020,-228212952
1636873909,-182797,true,11524552517,22,11292974152,-231578365
1636873946,-182805,true,11515337022,22,11292974152,-222362870
1636874046,-182807,true,11513034301,22,11294103450,-218930851
1636874151,-182807,true,11513034301,22,11295232860,-217801441
1636874625,-182807,true,11513034301,22,11294103450,-218930851
1636875104,-182815,true,11503828016,22,11286200739,-217627277
1636875277,-182818,true,11500377558,22,11285072231,-215305327
1636875868,-182819,true,11499227635,22,11289586937,-209640698
1636876130,-182821,true,11496928135,22,11291844968,-205083167
1636876175,-182829,true,11487734730,22,11298621769,-189112961
1636876468,-182832,true,11484289098,22,11338234246,-146054852
1636877212,-182833,true,11483140784,22,11413310317,-69830467
1636877462,-182834,true,11481992585,22,11411027997,-70964588
1636877744,-182843,true,11471663957,22,11409887008,-61776949
1636878092,-182847,true,11467076438,22,11396204039,-70872399
1636878200,-182848,true,11465929845,22,11391646697,-74283148
1636878541,-182849,true,11464783367,22,11374572889,-90210478
1636878600,-182858,true,11454470219,22,11371161200,-83309019
1636878724,-182862,true,11449889576,22,11365477324,-84412252
1636879273,-182860,true,11452179669,22,11446455296,-5724373
1636879379,-182861,true,11451034565,22,11459052694,8018129
1636879507,-182869,true,11441877858,22,11476253311,34375453
1636879530,-182870,true,11440733785,22,11479696531,38962746
1636879561,-182869,true,11441877858,22,11483140784,41262926
1636879706,-182869,true,11441877858,22,11484289098,42411240
1636879811,-182878,true,11431585315,22,11476253311,44667996
1636880226,-182879,true,11430442271,22,11444166348,13724077
1636880375,-182877,true,11432728474,22,11437302251,4573777
1636880589,-182878,true,11431585315,22,11431585315,0
1636880647,-182886,true,11422444161,22,11420160015,-2284146
1636881213,-182888,true,11420160015,22,11384814101,-35345914
1636881306,-182887,true,11421302031,22,11379123401,-42178630
1636881767,-182888,true,11420160015,22,11375710347,-44449668
1636881899,-182896,true,11411027997,22,11374572889,-36455108
1636883703,-182897,true,11409887008,22,11362068363,-47818645
1636883837,-182895,true,11412169100,22,11372298316,-39870784
1636883972,-182896,true,11411027997,22,11382537479,-28490518
1636884424,-182904,true,11401903281,22,11416734652,14831371
1636884436,-182903,true,11403043471,22,11417876325,14832854
1636884456,-182901,true,11405324194,22,11417876325,12552131
1636884766,-182902,true,11404183776,22,11419018113,14834337
1636884971,-182909,true,11396204039,22,11425871237,29667198
1636885198,-182908,true,11397343660,22,11432728474,35384814
1636885237,-182906,true,11399623242,22,11433871747,34248505
1636885833,-182906,true,11399623242,22,11462490754,62867512
1636886413,-182914,true,11390507646,22,11470516905,80009259
1636886488,-182914,true,11390507646,22,11476253311,85745665
1636886579,-182914,true,11390507646,22,11487734730,97227084
1636887116,-182913,true,11391646697,22,11553398499,161751802
1636887473,-182919,true,11384814101,22,11573054996,188240895
1636887895,-182917,true,11387091177,22,11575369723,188278546
1636887917,-182914,true,11390507646,22,11574212302,183704656
1636888544,-182912,true,11392785862,22,11563800717,171014855
1636889092,-182918,true,11385952582,22,11556864865,170912283
1636889195,-182917,true,11387091177,22,11556864865,169773688
1636889431,-182913,true,11391646697,22,11552243274,160596577
1636889522,-182910,true,11395064533,22,11551088165,156023632
1636889530,-182912,true,11392785862,22,11549933172,157147310
1636889834,-182912,true,11392785862,22,11509581081,116795219
1636890005,-182908,true,11397343660,22,11514185604,116841944
1636890424,-182905,true,11400763205,22,11498077828,97314623
1636891085,-182907,true,11398483394,22,11480844501,82361107
1636891725,-182906,true,11399623242,22,11476253311,76630069
1636893149,-182905,true,11400763205,22,11407605373,6842168
1636893577,-182903,true,11403043471,22,11414451648,11408177
1636893845,-182905,true,11400763205,22,11420160015,19396810
1636894321,-182906,true,11399623242,22,11425871237,26247995
1636894415,-182903,true,11403043471,22,11431585315,28541844
1636894504,-182900,true,11406464726,22,11436158635,29693909
1636894589,-182899,true,11407605373,22,11440733785,33128412
1636894614,-182898,true,11408746133,22,11443022046,34275913
1636894696,-182896,true,11411027997,22,11447599942,36571945
1636894965,-182893,true,11414451648,22,11462490754,48039106
1636895005,-182893,true,11414451648,22,11464783367,50331719
1636895265,-182892,true,11415593093,22,11475105800,59512707
1636895534,-182890,true,11417876325,22,11473958404,56082079
1636895664,-182887,true,11421302031,22,11473958404,52656373
1636895793,-182887,true,11421302031,22,11464783367,43481336
1636895965,-182887,true,11421302031,22,11452179669,30877638
1636896090,-182886,true,11422444161,22,11443022046,20577885
1636896596,-182884,true,11424728764,22,11419018113,-5710651
1636896669,-182883,true,11425871237,22,11421302031,-4569206
1636896911,-182883,true,11425871237,22,11425871237,0
1636897708,-182881,true,11428156526,22,11423586406,-4570120
1636897846,-182878,true,11431585315,22,11422444161,-9141154
1636897902,-182878,true,11431585315,22,11424728764,-6856551
1636898206,-182877,true,11432728474,22,11436158635,3430161
1636898385,-182874,true,11436158635,22,11443022046,6863411
1636898515,-182872,true,11438445982,22,11446455296,8009314
1636898602,-182872,true,11438445982,22,11447599942,9153960
1636898887,-182871,true,11439589826,22,11447599942,8010116
1636899376,-182869,true,11441877858,22,11435015134,-6862724
1636899505,-182866,true,11445310765,22,11432728474,-12582291
1636899607,-182866,true,11445310765,22,11433871747,-11439018
1636899714,-182865,true,11446455296,22,11433871747,-12583549
1636899716,-182863,true,11448744702,22,11433871747,-14872955
1636899836,-182860,true,11452179669,22,11433871747,-18307922
1636900115,-182860,true,11452179669,22,11431585315,-20594354
1636900336,-182861,true,11451034565,22,11430442271,-20592294
1636900474,-182861,true,11451034565,22,11427013824,-24020741
1636900525,-182860,true,11452179669,22,11431585315,-20594354
1636900663,-182859,true,11453324887,22,11440733785,-12591102
1636900747,-182859,true,11453324887,22,11447599942,-5724945
1636900795,-182857,true,11455615666,22,11451034565,-4581101
1636901023,-182855,true,11457906904,22,11461344620,3437716
1636901194,-182855,true,11457906904,22,11467076438,9169534
1636901234,-182855,true,11457906904,22,11465929845,8022941
1636901915,-182857,true,11455615666,22,11414451648,-41164018
1636901955,-182858,true,11454470219,22,11412169100,-42301119
1636902115,-182858,true,11454470219,22,11400763205,-53707014
1636902647,-182859,true,11453324887,22,11367750534,-85574353
1636902921,-182861,true,11451034565,22,11367750534,-83284031
1636902931,-182861,true,11451034565,22,11367750534,-83284031
1636903175,-182861,true,11451034565,22,11373435546,-77599019
1636903217,-182861,true,11451034565,22,11375710347,-75324218
1636903435,-182864,true,11447599942,22,11382537479,-65062463
1636903595,-182862,true,11449889576,22,11411027997,-38861579
1636903617,-182860,true,11452179669,22,11414451648,-37728021
1636903735,-182858,true,11454470219,22,11430442271,-24027948
1636903811,-182858,true,11454470219,22,11439589826,-14880393
1636903987,-182856,true,11456761228,22,11464783367,8022139
1636904534,-182855,true,11457906904,22,11490032392,32125488
1636904792,-182854,true,11459052694,22,11459052694,0
1636904892,-182854,true,11459052694,22,11445310765,-13741929
1636905267,-182853,true,11460198600,22,11446455296,-13743304
1636905399,-182853,true,11460198600,22,11439589826,-20608774
1636905500,-182853,true,11460198600,22,11447599942,-12598658
1636905523,-182853,true,11460198600,22,11449889576,-10309024
1636905636,-182850,true,11463637003,22,11461344620,-2292383
1636905790,-182850,true,11463637003,22,11475105800,11468797
1636906071,-182850,true,11463637003,22,11492330513,28693510
1636906122,-182850,true,11463637003,22,11495778557,32141554
1636906371,-182848,true,11465929845,22,11514185604,48255759
1636906470,-182848,true,11465929845,22,11517640205,51710360
1636906495,-182848,true,11465929845,22,11518791969,52862124
1636906543,-182848,true,11465929845,22,11522247952,56318107
1636906689,-182848,true,11465929845,22,11530315946,64386101
1636906798,-182850,true,11463637003,22,11522247952,58610949
1636906953,-182851,true,11462490754,22,11509581081,47090327
1636907015,-182851,true,11462490754,22,11511883112,49392358
1636907267,-182850,true,11463637003,22,11521095843,57458840
1636907474,-182853,true,11460198600,22,11495778557,35579957
1636907762,-182855,true,11457906904,22,11468223146,10316242
1636908023,-182854,true,11459052694,22,11457906904,-1145790
1636908192,-182854,true,11459052694,22,11448744702,-10307992
1636908535,-182856,true,11456761228,22,11478548676,21787448
1636908941,-182854,true,11459052694,22,11506128897,47076203
1636909028,-182854,true,11459052694,22,11509581081,50528387
1636909076,-182854,true,11459052694,22,11501527596,42474902
1636909259,-182854,true,11459052694,22,11525704972,66652278
1636909355,-182852,true,11461344620,22,11538389589,77044969
1636909739,-182848,true,11465929845,22,11574212302,108282457
1636909833,-182848,true,11465929845,22,11582316682,116386837
1636909876,-182847,true,11467076438,22,11584633261,117556823
1636909936,-182844,true,11470516905,22,11589267809,118750904
1636910174,-182843,true,11471663957,22,11581158566,109494609
1636910220,-182843,true,11471663957,22,11577684913,106020956
1636910254,-182844,true,11470516905,22,11575369723,104852818
1636910299,-182842,true,11472811123,22,11571897807,99086684
1636910641,-182838,true,11477400936,22,11586950303,109549367
1636911304,-182838,true,11477400936,22,11618275773,140874837
1636911316,-182838,true,11477400936,22,11617114062,139713126
1636911465,-182836,true,11479696531,22,11608985334,129288803
1636911586,-182833,true,11483140784,22,11605503335,122362551
1636911651,-182833,true,11483140784,22,11604342900,121202116
1636911674,-182833,true,11483140784,22,11603182582,120041798
1636912148,-182831,true,11485437527,22,11596223108,110785581
1636912401,-182826,true,11491181395,22,11593904212,102722817
1636912808,-182827,true,11490032392,22,11571897807,81865415
1636913004,-182827,true,11490032392,22,11569583774,79551382
1636913100,-182825,true,11492330513,22,11562644453,70313940
1636913462,-182822,true,11495778557,22,11533775387,37996830
1636913630,-182823,true,11494629094,22,11517640205,23011111
1636913687,-182824,true,11493479746,22,11513034301,19554555
1636913715,-182823,true,11494629094,22,11514185604,19556510
1636914057,-182818,true,11500377558,22,11534928764,34551206
1636914211,-182818,true,11500377558,22,11538389589,38012031
1636914221,-182819,true,11499227635,22,11538389589,39161954
1636914358,-182818,true,11500377558,22,11543005637,42628079
1636914494,-182814,true,11504978399,22,11556864865,51886466
1636914794,-182814,true,11504978399,22,11549933172,44954773
1636914931,-182815,true,11503828016,22,11540697382,36869366
1636914955,-182813,true,11506128897,22,11539543428,33414531
1636915016,-182809,true,11510732039,22,11544159938,33427899
1636915158,-182809,true,11510732039,22,11553398499,42666460
1636915177,-182809,true,11510732039,22,11554553838,43821799
1636915235,-182807,true,11513034301,22,11556864865,43830564
1636915275,-182803,true,11517640205,22,11558020551,40380346
1636915455,-182806,true,11514185604,22,11539543428,25357824
1636915710,-182808,true,11511883112,22,11514185604,2302492
1636915712,-182808,true,11511883112,22,11514185604,2302492
1636915748,-182805,true,11515337022,22,11510732039,-4604983
1636915936,-182807,true,11513034301,22,11487734730,-25299571
1636916192,-182808,true,11511883112,22,11460198600,-51684512
1636916221,-182808,true,11511883112,22,11460198600,-51684512
1636916303,-182804,true,11516488556,22,11460198600,-56289956
1636916346,-182806,true,11514185604,22,11456761228,-57424376
1636916735,-182804,true,11516488556,22,11487734730,-28753826
1636916818,-182802,true,11518791969,22,11494629094,-24162875
1636916936,-182798,true,11523400177,22,11501527596,-21872581
1636917080,-182799,true,11522247952,22,11507279510,-14968442
1636917349,-182798,true,11523400177,22,11514185604,-9214573
1636917612,-182798,true,11523400177,22,11504978399,-18421778
1636917689,-182793,true,11529163030,22,11502677749,-26485281
1636917752,-182796,true,11525704972,22,11500377558,-25327414
1636917771,-182796,true,11525704972,22,11500377558,-25327414
1636917811,-182797,true,11524552517,22,11499227635,-25324882
1636917851,-182794,true,11528010229,22,11500377558,-27632671
1636918014,-182796,true,11525704972,22,11503828016,-21876956
1636918404,-182795,true,11526857543,22,11515337022,-11520521
1636918748,-182794,true,11528010229,22,11531468977,3458748
1636918814,-182791,true,11531468977,22,11523400177,-8068800
1636918916,-182794,true,11528010229,22,11509581081,-18429148
1636918996,-182793,true,11529163030,22,11498077828,-31085202
1636919028,-182796,true,11525704972,22,11498077828,-27627144
1636919072,-182793,true,11529163030,22,11496928135,-32234895
1636919186,-182794,true,11528010229,22,11494629094,-33381135
1636919500,-182792,true,11530315946,22,11484289098,-46026848
1636919577,-182796,true,11525704972,22,11480844501,-44860471
1636919739,-182793,true,11529163030,22,11491181395,-37981635
1636919763,-182794,true,11528010229,22,11493479746,-34530483
1636920010,-182793,true,11529163030,22,11509581081,-19581949
1636920074,-182797,true,11524552517,22,11503828016,-20724501
1636920487,-182796,true,11525704972,22,11463637003,-62067969
1636921218,-182798,true,11523400177,22,11413310317,-110089860
1636921295,-182797,true,11524552517,22,11412169100,-112383417
1636921412,-182800,true,11521095843,22,11412169100,-108926743
1636922122,-182799,true,11522247952,22,11414451648,-107796304
1636922352,-182802,true,11518791969,22,11412169100,-106622869
1636922451,-182800,true,11521095843,22,11403043471,-118052372
1636922673,-182802,true,11518791969,22,11415593093,-103198876
1636922816,-182801,true,11519943848,22,11422444161,-97499687
1636923067,-182802,true,11518791969,22,11433871747,-84920222
1636923188,-182801,true,11519943848,22,11437302251,-82641597
1636923379,-182805,true,11515337022,22,11440733785,-74603237
1636923529,-182804,true,11516488556,22,11427013824,-89474732
1636923547,-182806,true,11514185604,22,11424728764,-89456840
1636924156,-182806,true,11514185604,22,11398483394,-115702210
1636924244,-182811,true,11508430238,22,11396204039,-112226199
1636924318,-182812,true,11507279510,22,11391646697,-115632813
1636924453,-182815,true,11503828016,22,11396204039,-107623977
1636924591,-182815,true,11503828016,22,11395064533,-108763483
1636924702,-182820,true,11498077828,22,11392785862,-105291966
1636925040,-182819,true,11499227635,22,11381399339,-117828296
1636925353,-182821,true,11496928135,22,11374572889,-122355246
1636925397,-182822,true,11495778557,22,11372298316,-123480241
1636925415,-182826,true,11491181395,22,11371161200,-120020195
1636925855,-182826,true,11491181395,22,11421302031,-69879364
1636926051,-182827,true,11490032392,22,11445310765,-44721627
1636926455,-182827,true,11490032392,22,11475105800,-14926592
1636926478,-182832,true,11484289098,22,11473958404,-10330694
1636926499,-182831,true,11485437527,22,11473958404,-11479123
1636926682,-182833,true,11483140784,22,11463637003,-19503781
1636926894,-182834,true,11481992585,22,11452179669,-29812916
1636927005,-182838,true,11477400936,22,11445310765,-32090171
1636927016,-182838,true,11477400936,22,11445310765,-32090171
1636927113,-182839,true,11476253311,22,11439589826,-36663485
1636927269,-182840,true,11475105800,22,11430442271,-44663529
1636927303,-182844,true,11470516905,22,11428156526,-42360379
1636927306,-182843,true,11471663957,22,11428156526,-43507431
1636927766,-182841,true,11473958404,22,11439589826,-34368578
1636928086,-182841,true,11473958404,22,11461344620,-12613784
1636928212,-182845,true,11469369968,22,11469369968,0
1636928301,-182846,true,11468223146,22,11468223146,0
1636928459,-182845,true,11469369968,22,11464783367,-4586601
1636928629,-182846,true,11468223146,22,11460198600,-8024546
1636928929,-182850,true,11463637003,22,11444166348,-19470655
1636928955,-182850,true,11463637003,22,11441877858,-21759145
1636929044,-182850,true,11463637003,22,11433871747,-29765256
1636929170,-182851,true,11462490754,22,11423586406,-38904348
1636929376,-182855,true,11457906904,22,11427013824,-30893080
1636929897,-182855,true,11457906904,22,11433871747,-24035157
1636929942,-182855,true,11457906904,22,11435015134,-22891770
1636930026,-182857,true,11455615666,22,11433871747,-21743919
1636930435,-182862,true,11449889576,22,11406464726,-43424850
1636930662,-182862,true,11449889576,22,11393925140,-55964436
1636931538,-182860,true,11452179669,22,11389368709,-62810960
1636931543,-182860,true,11452179669,22,11389368709,-62810960
1636931779,-182865,true,11446455296,22,11389368709,-57086587
1636931870,-182865,true,11446455296,22,11389368709,-57086587
1636931938,-182861,true,11451034565,22,11404183776,-46850789
1636932113,-182860,true,11452179669,22,11435015134,-17164535
1636932176,-182862,true,11449889576,22,11446455296,-3434280
1636932183,-182861,true,11451034565,22,11447599942,-3434623
1636932482,-182858,true,11454470219,22,11500377558,45907339
1636932700,-182859,true,11453324887,22,11537235865,83910978
1636932733,-182861,true,11451034565,22,11541851452,90816887
1636932973,-182861,true,11451034565,22,11526857543,75822978
1636933042,-182858,true,11454470219,22,11519943848,65473629
1636933377,-182860,true,11452179669,22,11488883503,36703834
1636933521,-182863,true,11448744702,22,11472811123,24066421
1636933658,-182863,true,11448744702,22,11457906904,9162202
1636933796,-182860,true,11452179669,22,11448744702,-3434967
1636933827,-182863,true,11448744702,22,11447599942,-1144760
1636933899,-182865,true,11446455296,22,11444166348,-2288948
1636934265,-182866,true,11445310765,22,11427013824,-18296941
1636934435,-182864,true,11447599942,22,11423586406,-24013536
1636934548,-182867,true,11444166348,22,11419018113,-25148235
1636934899,-182870,true,11440733785,22,11420160015,-20573770
1636934932,-182870,true,11440733785,22,11425871237,-14862548
1636935245,-182867,true,11444166348,22,11446455296,2288948
1636935278,-182868,true,11443022046,22,11448744702,5722656
1636935404,-182868,true,11443022046,22,11447599942,4577896
1636935459,-182869,true,11441877858,22,11447599942,5722084
1636935780,-182870,true,11440733785,22,11433871747,-6862038
1636936130,-182873,true,11437302251,22,11395064533,-42237718
1636936161,-182873,true,11437302251,22,11391646697,-45655554
1636936360,-182874,true,11436158635,22,11389368709,-46789926
1636936919,-182875,true,11435015134,22,11381399339,-53615795
1636936971,-182878,true,11431585315,22,11380261313,-51324002
1636937635,-182878,true,11431585315,22,11368887309,-62698006
1636937862,-182877,true,11432728474,22,11365477324,-67251150
1636937927,-182878,true,11431585315,22,11365477324,-66107991
1636937978,-182880,true,11429299341,22,11364340890,-64958451
1636938665,-182881,true,11428156526,22,11331433686,-96722840
1636938933,-182881,true,11428156526,22,11322372617,-105783909
1636940281,-182882,true,11427013824,22,11280559331,-146454493
1636940720,-182884,true,11424728764,22,11278303557,-146425207
1636941301,-182886,true,11422444161,22,11276048235,-146395926
1636941485,-182887,true,11421302031,22,11276048235,-145253796
1636941888,-182889,true,11419018113,22,11242272468,-176745645
1636942464,-182893,true,11414451648,22,11205235964,-209215684
1636942773,-182894,true,11413310317,22,11226545085,-186765232
1636942914,-182894,true,11413310317,22,11235529465,-177780852
1636942941,-182896,true,11411027997,22,11236653018,-174374979
1636944480,-182901,true,11405324194,22,11199635027,-205689167
1636944535,-182902,true,11404183776,22,11199635027,-204548749
1636944560,-182902,true,11404183776,22,11198515175,-205668601
1636945845,-182906,true,11399623242,22,11117067732,-282555510
1636946537,-182911,true,11393925140,22,11118179438,-275745702
1636946588,-182913,true,11391646697,22,11121515226,-270131471
1636946622,-182913,true,11391646697,22,11129302622,-262344075
1636946960,-182913,true,11391646697,22,11200754990,-190891707
1636946977,-182914,true,11390507646,22,11204115553,-186392093
1636947260,-182915,true,11389368709,22,11264778386,-124590323
1636947292,-182918,true,11385952582,22,11271538943,-114413639
1636947489,-182920,true,11383675733,22,11297492020,-86183713
1636947540,-182922,true,11381399339,22,11294103450,-87295889
1636948272,-182924,true,11379123401,22,11252394561,-126728840
1636948413,-182926,true,11376847918,22,11251269434,-125578484
1636948654,-182929,true,11373435546,22,11249019518,-124416028
1636948799,-182929,true,11373435546,22,11246770051,-126665495
1636948903,-182932,true,11370024197,22,11243396695,-126627502
1636949079,-182935,true,11366613872,22,11224300112,-142313760
1636950124,-182939,true,11362068363,22,11160506775,-201561588
1636950290,-182939,true,11362068363,22,11161622826,-200445537
1636950802,-182942,true,11358660424,22,11169438306,-189222118
1636951308,-182945,true,11355253507,22,11161622826,-193630681
1636951318,-182950,true,11349577584,22,11161622826,-187954758
1636951488,-182952,true,11347308008,22,11158275008,-189033000
1636951582,-182955,true,11343904497,22,11156043688,-187860809
1636951677,-182958,true,11340502006,22,11153812814,-186689192
1636951798,-182963,true,11334833456,22,11153812814,-181020642
1636951960,-182963,true,11334833456,22,11156043688,-178789768
1636952035,-182966,true,11331433686,22,11156043688,-175389998
1636952197,-182969,true,11328034935,22,11156043688,-171991247
1636952345,-182974,true,11322372617,22,11157159292,-165213325
1636952798,-182974,true,11322372617,22,11154928195,-167444422
1636952920,-182977,true,11318976584,22,11154928195,-164048389
1636952980,-182980,true,11315581570,22,11152697544,-162884026
1636953934,-182986,true,11308794597,22,11095966411,-212828186
1636954037,-182987,true,11307663830,22,11103735918,-203927912
1636954323,-182989,true,11305402637,22,11118179438,-187223199
1636954383,-182991,true,11303141895,22,11124852014,-178289881
1636954401,-182996,true,11297492020,22,11125964499,-171527521
1636954554,-182996,true,11297492020,22,11141550978,-155941042
1636954616,-182997,true,11296362383,22,11148237580,-148124803
1636954746,-182999,true,11294103450,22,11161622826,-132480624
1636954948,-183005,true,11287329359,22,11172789473,-114539886
1636955273,-183005,true,11287329359,22,11223177795,-64151564
1636955500,-183008,true,11283943837,22,11250144420,-33799417
1636955530,-183011,true,11280559331,22,11251269434,-29289897
1636955688,-183016,true,11274920743,22,11258021884,-16898859
1636955737,-183017,true,11273793363,22,11259147686,-14645677
1636955785,-183020,true,11270411902,22,11261399628,-9012274
1636955992,-183023,true,11267031454,22,11251269434,-15762020
1636956233,-183028,true,11261399628,22,11229913385,-31486243
1636956413,-183027,true,11262525768,22,11214203291,-48322477
1636957265,-183031,true,11258021884,22,11194036889,-63984995
1636957812,-183034,true,11254645153,22,11188441549,-66203604
1636957842,-183038,true,11250144420,22,11187322817,-62821603
1636957867,-183037,true,11251269434,22,11187322817,-63946617
1636957947,-183041,true,11246770051,22,11183967291,-62802760
1636958277,-183043,true,11244521035,22,11191798417,-52722618
1636958432,-183047,true,11240024351,22,11197395436,-42628915
1636958536,-183045,true,11242272468,22,11197395436,-44877032
1636958687,-183050,true,11236653018,22,11196275808,-40377210
1636958699,-183052,true,11234406024,22,11196275808,-38130216
1636958906,-183058,true,11227667739,22,11188441549,-39226190
1636958964,-183058,true,11227667739,22,11183967291,-43700448
1636958979,-183063,true,11222055589,22,11182849006,-39206583
1636959019,-183064,true,11220933496,22,11179494822,-41438674
1636959048,-183068,true,11216446244,22,11177259259,-39186985
1636959064,-183068,true,11216446244,22,11176141645,-40304599
1636959131,-183073,true,11210839703,22,11169438306,-41401397
1636959165,-183075,true,11208597871,22,11167204753,-41393118
1636959777,-183079,true,11204115553,22,11130415553,-73700000
1636960150,-183078,true,11205235964,22,11122627377,-82608587
1636960166,-183083,true,11199635027,22,11122627377,-77007650
1636960353,-183085,true,11197395436,22,11119291256,-78104180
1636961086,-183089,true,11192917597,22,11111510865,-81406732
1636961222,-183088,true,11194036889,22,11117067732,-76969157
1636961307,-183092,true,11189560393,22,11121515226,-68045167
1636962242,-183093,true,11188441549,22,11147122868,-41318681
1636962776,-183094,true,11187322817,22,11190679349,3356532
1636963049,-183093,true,11188441549,22,11214203291,25761742
1636963058,-183096,true,11185085688,22,11214203291,29117603
1636963173,-183095,true,11186204196,22,11220933496,34729300
1636964648,-183096,true,11185085688,22,11218689645,33603957
1636965171,-183093,true,11188441549,22,11268158157,79716608
1636965306,-183095,true,11186204196,22,11281687387,95483191
1636965567,-183094,true,11187322817,22,11300881606,113558789
1636966055,-183094,true,11187322817,22,11254645153,67322336
1636966386,-183092,true,11189560393,22,11207477124,17916731
1636966510,-183094,true,11187322817,22,11200754990,13432173
1636966786,-183094,true,11187322817,22,11196275808,8952991
1636966830,-183093,true,11188441549,22,11195156293,6714744
1636966889,-183088,true,11194036889,22,11194036889,0
1636967033,-183091,true,11190679349,22,11196275808,5596459
1636967112,-183090,true,11191798417,22,11200754990,8956573
1636967366,-183093,true,11188441549,22,11194036889,5595340
1636967976,-183094,true,11187322817,22,11153812814,-33510003
1636968091,-183097,true,11183967291,22,11147122868,-36844423
1636968139,-183097,true,11183967291,22,11146008267,-37959024
1636968582,-183099,true,11181730833,22,11134868387,-46862446
1636968691,-183100,true,11180612772,22,11133755011,-46857761
1636968706,-183102,true,11178376985,22,11133755011,-44621974
1636968928,-183102,true,11178376985,22,11132641747,-45735238
1636969112,-183104,true,11176141645,22,11133755011,-42386634
1636969125,-183104,true,11176141645,22,11133755011,-42386634
1636970080,-183107,true,11172789473,22,11130415553,-42373920
1636970338,-183105,true,11175024142,22,11137095472,-37928670
1636971065,-183105,true,11175024142,22,11142665133,-32359009
1636971254,-183106,true,11173906752,22,11139323002,-34583750
1636971549,-183108,true,11171672305,22,11137095472,-34576833
1636971768,-183106,true,11173906752,22,11131528594,-42378158
1636971973,-183106,true,11173906752,22,11129302622,-44604130
1636972389,-183107,true,11172789473,22,11128189803,-44599670
1636973445,-183109,true,11170555250,22,11124852014,-45703236
1636973870,-183107,true,11172789473,22,11125964499,-46824974
1636974737,-183107,true,11172789473,22,11127077096,-45712377
1636975484,-183108,true,11171672305,22,11125964499,-45707806
1636975960,-183110,true,11169438306,22,11109288896,-60149410
1636976372,-183108,true,11171672305,22,11127077096,-44595209
1636976524,-183109,true,11170555250,22,11138209181,-32346069
1636976905,-183109,true,11170555250,22,11162738988,-7816262
1636976943,-183110,true,11169438306,22,11161622826,-7815480
1636977086,-183108,true,11171672305,22,11158275008,-13397297
1636977718,-183108,true,11171672305,22,11141550978,-30121327
1636977757,-183108,true,11171672305,22,11140436935,-31235370
1636978003,-183109,true,11170555250,22,11135981874,-34573376
1636978265,-183107,true,11172789473,22,11133755011,-39034462
1636978545,-183108,true,11171672305,22,11132641747,-39030558
1636978589,-183109,true,11170555250,22,11134868387,-35686863
1636978651,-183110,true,11169438306,22,11144893778,-24544528
1636978672,-183108,true,11171672305,22,11148237580,-23434725
1636978865,-183103,true,11177259259,22,11198515175,21255916
1636978933,-183104,true,11176141645,22,11215324712,39183067
1636978972,-183106,true,11173906752,22,11225422542,51515790
1636979010,-183104,true,11176141645,22,11235529465,59387820
1636979142,-183099,true,11181730833,22,11272666097,90935264
1636979332,-183099,true,11181730833,22,11328034935,146304102
1636979561,-183100,true,11180612772,22,11376847918,196235146
1636979966,-183097,true,11183967291,22,11389368709,205401418
1636980136,-183092,true,11189560393,22,11390507646,200947253
1636980156,-183092,true,11189560393,22,11391646697,202086304
1636980219,-183092,true,11189560393,22,11391646697,202086304
1636980381,-183089,true,11192917597,22,11391646697,198729100
1636980656,-183084,true,11198515175,22,11385952582,187437407
1636980755,-183084,true,11198515175,22,11381399339,182884164
1636980805,-183084,true,11198515175,22,11379123401,180608226
1636980895,-183082,true,11200754990,22,11375710347,174955357
1636980971,-183078,true,11205235964,22,11373435546,168199582
1636981259,-183078,true,11205235964,22,11372298316,167062352
1636981306,-183077,true,11206356488,22,11375710347,169353859
1636981338,-183074,true,11209718731,22,11376847918,167129187
1636981721,-183070,true,11214203291,22,11360932270,146728979
1636983842,-183072,true,11211960787,22,11276048235,64087448
1636985439,-183071,true,11213081983,22,11289586937,76504954
1636985855,-183069,true,11215324712,22,11287329359,72004647
1636986090,-183065,true,11219811514,22,11285072231,65260717
1636986129,-183066,true,11218689645,22,11285072231,66382586
1636986556,-183065,true,11219811514,22,11289586937,69775423
1636986902,-183062,true,11223177795,22,11292974152,69796357
1636986980,-183058,true,11227667739,22,11294103450,66435711
1636987722,-183059,true,11226545085,22,11287329359,60784274
1636988028,-183058,true,11227667739,22,11290715896,63048157
1636988120,-183055,true,11231036376,22,11291844968,60808592
1636988229,-183051,true,11235529465,22,11290715896,55186431
1636988354,-183052,true,11234406024,22,11304272210,69866186
1636988528,-183049,true,11237776683,22,11321240493,83463810
1636988572,-183046,true,11241148353,22,11332566829,91418476
1636989686,-183039,true,11249019518,22,11465929845,216910327
1636989890,-183040,true,11247894728,22,11467076438,219181710
1636990082,-183038,true,11250144420,22,11468223146,218078726
1636990680,-183036,true,11252394561,22,11478548676,226154115
1636990771,-183029,true,11260273601,22,11478548676,218275075
1636991296,-183030,true,11259147686,22,11496928135,237780449
1636991391,-183028,true,11261399628,22,11498077828,236678200
1636991429,-183026,true,11263652021,22,11498077828,234425807
1636991580,-183019,true,11271538943,22,11514185604,242646661
1636991621,-183018,true,11272666097,22,11517640205,244974108
1636991883,-183014,true,11277175840,22,11538389589,261213749
1636992376,-183010,true,11281687387,22,11597382731,315695344
1636992610,-183003,true,11289586937,22,11610146232,320559295
1636992622,-183002,true,11290715896,22,11612468378,321752482
1636992715,-182997,true,11296362383,22,11624086073,327723690
1636992803,-182993,true,11300881606,22,11631062268,330180662
1636992874,-182983,true,11312187574,22,11639206455,327018881
1636992951,-182982,true,11313318793,22,11638042651,324723858
1636992960,-182976,true,11320108482,22,11641534413,321425931
1636992977,-182971,true,11325769668,22,11643862836,318093168
1636993782,-182964,true,11333700086,22,11621761604,288061518
1636994041,-182961,true,11337100536,22,11660174844,323074308
1636994100,-182955,true,11343904497,22,11675342170,331437673
1636994274,-182949,true,11350712541,22,11722134721,371422180
1636994435,-182936,true,11365477324,22,11764408340,398931016
1636994686,-182933,true,11368887309,22,11824557064,455669755
1636994714,-182927,true,11375710347,22,11825739519,450029172
1636994800,-182921,true,11382537479,22,11842306320,459768841
1636995141,-182905,true,11400763205,22,11927874323,527111118
1636995185,-182899,true,11407605373,22,11933839453,526234080
1636995227,-182892,true,11415593093,22,11944584206,528991113
1636995404,-182885,true,11423586406,22,11981668013,558081607
1636995481,-182869,true,11441877858,22,11998453256,556575398
1636995497,-182863,true,11448744702,22,12003253357,554508655
1636995593,-182856,true,11456761228,22,12030891229,574130001
1636995595,-182848,true,11465929845,22,12032094318,566164473
1636995661,-182832,true,11484289098,22,12042927536,558638438
1636996137,-182827,true,11490032392,22,12030891229,540858837
1636996323,-182821,true,11496928135,22,12029688260,532760125
1636996370,-182813,true,11506128897,22,12022472973,516344076
1636996382,-182797,true,11524552517,22,12020068839,495516322
1636996579,-182795,true,11526857543,22,11980469966,453612423
1636997771,-182792,true,11530315946,22,11900473105,370157159
1636997895,-182784,true,11539543428,22,11914761530,375218102
1636998289,-182766,true,11560332271,22,11961317497,400985226
1636998406,-182764,true,11562644453,22,11974481527,411837074
1636998892,-182757,true,11570740733,22,12006854693,436113960
1636998899,-182749,true,11580000566,22,12006854693,426854127
1636999004,-182732,true,11599702323,22,12005654128,405951805
1636999145,-182730,true,11602022380,22,12005654128,403631748
1636999239,-182723,true,11610146232,22,12011658155,401511923
1636999329,-182716,true,11618275773,22,12016463539,398187766
1636999357,-182704,true,11632225375,22,12017665186,385439811
1636999422,-182702,true,11634551936,22,12018866952,384315016
1636999452,-182697,true,11640370376,22,12020068839,379698463
1636999552,-182691,true,11647356344,22,12011658155,364301811
1636999591,-182681,true,11659008943,22,12005654128,346645185
1636999672,-182681,true,11659008943,22,11994854439,335845496
1636999773,-182676,true,11664839614,22,11981668013,316828399
1637000307,-182670,true,11671840267,22,11951752748,279912481
1637000404,-182659,true,11684685713,22,11951752748,267067035
1637000640,-182659,true,11684685713,22,11969692932,285007219
1637001636,-182654,true,11690529225,22,11966102742,275573517
1637001817,-182647,true,11698715050,22,11964906251,266191201
1637001907,-182636,true,11711590073,22,11963709881,252119808
1637002125,-182636,true,11711590073,22,11957729820,246139747
1637002196,-182631,true,11717447040,22,11956534166,239087126
1637002318,-182625,true,11724479266,22,11939807566,215328300
1637002450,-182615,true,11736209022,22,11924296676,188087654
1637004423,-182619,true,11731515712,22,11791496264,59980552
1637004968,-182615,true,11736209022,22,11785602284,49393262
1637005596,-182609,true,11743252508,22,11839938214,96685706
1637005599,-182598,true,11756176547,22,11839938214,83761667
1637005723,-182599,true,11755001047,22,11835203423,80202376
1637005779,-182594,true,11760879723,22,11831653572,70773849
1637006068,-182589,true,11766761339,22,11830470525,63709186
1637006140,-182578,true,11779711250,22,11821010406,41299156
1637006248,-182577,true,11780889221,22,11825739519,44850298
1637006428,-182572,true,11786780844,22,11829287596,42506752
1637006806,-182567,true,11792675413,22,11855339373,62663960
1637007667,-182555,true,11806834410,22,11855339373,48504963
1637007990,-182555,true,11806834410,22,11848228658,41394248
1637008198,-182549,true,11813920281,22,11866013447,52093166
1637008392,-182544,true,11819828423,22,11885013314,65184891
1637008490,-182532,true,11834020021,22,11893335320,59315299
1637008643,-182531,true,11835203423,22,11904043604,68840181
1637008926,-182527,true,11839938214,22,11921912174,81973960
1637009364,-182523,true,11844674900,22,11892146105,47471205
1637009559,-182514,true,11855339373,22,11883824932,28485559
1637009579,-182514,true,11855339373,22,11882636668,27297295
1637009615,-182511,true,11858896330,22,11880260497,21364167
1637009815,-182508,true,11862454355,22,11869573607,7119252
1637009910,-182500,true,11871947640,22,11868386768,-3560872
1637010481,-182499,true,11873134835,22,11895714106,22579271
1637010794,-182495,true,11877884802,22,11914761530,36876728
1637011098,-182492,true,11881448523,22,11913570173,32121650
1637011303,-182484,true,11890957010,22,11911187816,20230806
1637011422,-182484,true,11890957010,22,11907615175,16658165
1637011425,-182482,true,11893335320,22,11906424532,13089212
1637011546,-182481,true,11894524654,22,11899283177,4758523
1637011826,-182475,true,11901663153,22,11867200048,-34463105
1637011958,-182476,true,11900473105,22,11852968660,-47504445
1637012244,-182474,true,11902853319,22,11821010406,-81842913
1637012320,-182475,true,11901663153,22,11815101673,-86561480
1637012598,-182471,true,11906424532,22,11805653844,-100770688
1637012612,-182471,true,11906424532,22,11805653844,-100770688
1637012672,-182469,true,11908805936,22,11805653844,-103152092
1637012740,-182470,true,11907615175,22,11806834410,-100780765
1637012775,-182463,true,11915953006,22,11806834410,-109118596
1637012986,-182464,true,11914761530,22,11821010406,-93751124
1637012991,-182462,true,11917144602,22,11821010406,-96134196
1637013054,-182463,true,11915953006,22,11824557064,-91395942
1637013076,-182461,true,11918336316,22,11825739519,-92596797
1637013208,-182461,true,11918336316,22,11845859368,-72476948
1637013763,-182459,true,11920720102,22,11919528150,-1191952
1637013988,-182460,true,11919528150,22,11933839453,14311303
1637014102,-182462,true,11917144602,22,11932646188,15501586
1637014265,-182464,true,11914761530,22,11936226340,21464810
1637014549,-182463,true,11915953006,22,11914761530,-1191476
1637014676,-182466,true,11912378935,22,11905234009,-7144926
1637014779,-182467,true,11911187816,22,11899283177,-11904639
1637014836,-182471,true,11906424532,22,11894524654,-11899878
1637015316,-182471,true,11906424532,22,11843490551,-62933981
1637015656,-182474,true,11902853319,22,11848228658,-54624661
1637015791,-182476,true,11900473105,22,11852968660,-47504445
1637015984,-182477,true,11899283177,22,11868386768,-30896409
1637016065,-182476,true,11900473105,22,11873134835,-27338270
1637016078,-182479,true,11896903677,22,11875509581,-21394096
1637016134,-182481,true,11894524654,22,11877884802,-16639852
1637016213,-182480,true,11895714106,22,11877884802,-17829304
1637016869,-182480,true,11895714106,22,11822192507,-73521599
1637018885,-182485,true,11889768033,22,11710419031,-179349002
1637019065,-182488,true,11886201816,22,11708077299,-178124517
1637019417,-182488,true,11886201816,22,11749125309,-137076507
1637019497,-182490,true,11883824932,22,11757352165,-126472767
1637019570,-182494,true,11879072590,22,11756176547,-122896043
1637020045,-182498,true,11874322149,22,11739730237,-134591912
1637020149,-182500,true,11871947640,22,11725651714,-146295926
1637021315,-182504,true,11867200048,22,11643862836,-223337212
1637021585,-182508,true,11862454355,22,11642698566,-219755789
1637021650,-182513,true,11856524907,22,11634551936,-221972971
1637021813,-182516,true,11852968660,22,11617114062,-235854598
1637022106,-182522,true,11845859368,22,11586950303,-258909065
1637022327,-182526,true,11841122208,22,11562644453,-278477755
1637022363,-182529,true,11837570582,22,11560332271,-277238311
1637023093,-182529,true,11837570582,22,11573054996,-264515586
1637023519,-182534,true,11831653572,22,11618275773,-213377799
1637023524,-182539,true,11825739519,22,11618275773,-207463746
1637024089,-182541,true,11823374726,22,11704565578,-118809148
1637024719,-182539,true,11825739519,22,11725651714,-100087805
1637025064,-182543,true,11821010406,22,11722134721,-98875685
1637025073,-182548,true,11815101673,22,11722134721,-92966952
1637025617,-182552,true,11810376814,22,11652015986,-158360828
1637025676,-182551,true,11811557852,22,11645027222,-166530630
1637026366,-182556,true,11805653844,22,11631062268,-174591576
1637026373,-182559,true,11802112856,22,11632225375,-169887481
1637026986,-182560,true,11800932763,22,11701054910,-99877853
1637027166,-182556,true,11805653844,22,11718618784,-87035060
1637028133,-182559,true,11802112856,22,11710419031,-91693825
1637028211,-182563,true,11797393191,22,11709248107,-88145084
1637028221,-182564,true,11796213570,22,11709248107,-86965463
1637028932,-182560,true,11800932763,22,11698715050,-102217713
1637029122,-182564,true,11796213570,22,11696375658,-99837912
1637029203,-182567,true,11792675413,22,11696375658,-96299755
1637029405,-182568,true,11791496264,22,11692867447,-98628817
1637029567,-182566,true,11793854681,22,11687022767,-106831914
1637029708,-182571,true,11787959522,22,11682349126,-105610396
1637030364,-182574,true,11784423841,22,11666006098,-118417743
1637031176,-182576,true,11782067310,22,11659008943,-123058367
1637031333,-182573,true,11785602284,22,11657843159,-127759125
1637031815,-182579,true,11778533397,22,11633388597,-145144800
1637032405,-182583,true,11773823161,22,11614790987,-159032174
1637032622,-182586,true,11770291720,22,11615952466,-154339254
1637032727,-182585,true,11771468750,22,11625248482,-146220268
1637033008,-182590,true,11765584781,22,11642698566,-122886215
1637033209,-182592,true,11763232016,22,11654346505,-108885511
1637033469,-182595,true,11759703753,22,11669506249,-90197504
1637033689,-182593,true,11762055811,22,11669506249,-92549562
1637033863,-182598,true,11756176547,22,11666006098,-90170449
1637033889,-182600,true,11753825664,22,11664839614,-88986050
1637034230,-182606,true,11746775836,22,11577684913,-169090923
1637034437,-182609,true,11743252508,22,11528010229,-215242279
1637034543,-182615,true,11736209022,22,11503828016,-232381006
1637034673,-182618,true,11732688864,22,11476253311,-256435553
1637034749,-182624,true,11725651714,22,11460198600,-265453114
1637034793,-182626,true,11723306935,22,11452179669,-271127266
1637034904,-182632,true,11716275412,22,11454470219,-261805193
1637034909,-182635,true,11712761232,22,11454470219,-258291013
1637035277,-182639,true,11708077299,22,11461344620,-246732679
1637035306,-182640,true,11706906608,22,11460198600,-246708008
1637035533,-182646,true,11699884922,22,11472811123,-227073799
1637035665,-182647,true,11698715050,22,11479696531,-219018519
1637035836,-182650,true,11695206138,22,11491181395,-204024743
1637035881,-182651,true,11694036734,22,11493479746,-200556988
1637036412,-182656,true,11688191469,22,11539543428,-148648041
1637036455,-182657,true,11687022767,22,11541851452,-145171315
1637036979,-182660,true,11683517361,22,11552243274,-131274087
1637037380,-182663,true,11680013007,22,11546468885,-133544122
1637037701,-182668,true,11674174752,22,11541851452,-132323300
1637038008,-182670,true,11671840267,22,11538389589,-133450678
1637038169,-182673,true,11668339416,22,11537235865,-131103551
1637038235,-182677,true,11663673246,22,11547623532,-116049714
1637038260,-182682,true,11657843159,22,11551088165,-106754994
1637038305,-182683,true,11656677491,22,11555709294,-100968197
1637038423,-182684,true,11655511940,22,11569583774,-85928166
1637038436,-182688,true,11650850900,22,11570740733,-80110167
1637039192,-182693,true,11645027222,22,11631062268,-13964954
1637039487,-182693,true,11645027222,22,11627573648,-17453574
1637039763,-182694,true,11643862836,22,11624086073,-19776763
1637039832,-182698,true,11639206455,22,11624086073,-15120382
1637040616,-182701,true,11635715391,22,11619437601,-16277790
1637040688,-182702,true,11634551936,22,11617114062,-17437874
1637040834,-182703,true,11633388597,22,11613629624,-19758973
1637041122,-182707,true,11628736405,22,11605503335,-23233070
1637041432,-182713,true,11621761604,22,11597382731,-24378873
1637041668,-182714,true,11620599544,22,11596223108,-24376436
1637041929,-182714,true,11620599544,22,11600862294,-19737250
1637042269,-182717,true,11617114062,22,11605503335,-11610727
1637042297,-182721,true,11612468378,22,11605503335,-6965043
1637042449,-182719,true,11614790987,22,11610146232,-4644755
1637043459,-182719,true,11614790987,22,11622923781,8132794
1637043932,-182722,true,11611307247,22,11619437601,8130354
1637044041,-182725,true,11607824551,22,11619437601,11613050
1637044094,-182724,true,11608985334,22,11619437601,10452267
1637044950,-182722,true,11611307247,22,11704565578,93258331
1637045979,-182722,true,11611307247,22,11706906608,95599361
1637046621,-182723,true,11610146232,22,11703395238,93249006
1637046757,-182722,true,11611307247,22,11722134721,110827474
1637047118,-182718,true,11615952466,22,11769114809,153162343
1637047170,-182717,true,11617114062,22,11775000543,157886481
1637047367,-182714,true,11620599544,22,11797393191,176793647
1637047846,-182712,true,11622923781,22,11806834410,183910629
1637047859,-182708,true,11627573648,22,11806834410,179260762
1637048073,-182709,true,11626411006,22,11780889221,154478215
1637048126,-182707,true,11628736405,22,11775000543,146264138
1637048146,-182708,true,11627573648,22,11772645896,145072248
1637048717,-182706,true,11629899279,22,11708077299,78178020
1637048964,-182709,true,11626411006,22,11695206138,68795132
1637049095,-182708,true,11627573648,22,11690529225,62955577
1637049159,-182709,true,11626411006,22,11697545296,71134290
1637049265,-182705,true,11631062268,22,11708077299,77015031
1637049447,-182702,true,11634551936,22,11760879723,126327787
1637049454,-182699,true,11638042651,22,11763232016,125189365
1637050537,-182697,true,11640370376,22,11957729820,317359444
1637050866,-182694,true,11643862836,22,11954143218,310280382
1637051017,-182692,true,11646191725,22,11951752748,305561023
1637051031,-182689,true,11649685932,22,11951752748,302066816
1637051553,-182688,true,11650850900,22,11937419963,286569063
1637051846,-182686,true,11653181187,22,11929067110,275885923
1637053168,-182686,true,11653181187,22,11822192507,169011320
1637053349,-182683,true,11656677491,22,11826922093,170244602
1637053762,-182682,true,11657843159,22,11851783482,193940323
1637053894,-182680,true,11660174844,22,11861268228,201093384
1637054164,-182679,true,11661340862,22,11877884802,216543940
1637054316,-182675,true,11666006098,22,11887390436,221384338
1637054346,-182674,true,11667172698,22,11888579175,221406477
1637054468,-182672,true,11669506249,22,11882636668,213130419
1637054638,-182671,true,11670673200,22,11874322149,203648949
1637054924,-182668,true,11674174752,22,11856524907,182350155
1637054966,-182666,true,11676509704,22,11854153957,177644253
1637054999,-182664,true,11678845123,22,11849413481,170568358
1637055102,-182663,true,11680013007,22,11835203423,155190416
1637055811,-182663,true,11680013007,22,11767938015,87925008
1637055815,-182662,true,11681181008,22,11767938015,86757007
1637056189,-182660,true,11683517361,22,11773823161,90305800
1637056306,-182659,true,11684685713,22,11777355661,92669948
1637056486,-182658,true,11685854182,22,11780889221,95035039
1637057130,-182659,true,11684685713,22,11722134721,37449008
1637057211,-182654,true,11690529225,22,11706906608,16377383
1637057326,-182652,true,11692867447,22,11676509704,-16357743
1637057418,-182651,true,11694036734,22,11632225375,-61811359
1637057587,-182661,true,11682349126,22,11548778294,-133570832
1637057592,-182658,true,11685854182,22,11546468885,-139385297
1637057868,-182664,true,11678845123,22,11347308008,-331537115
1637057955,-182664,true,11678845123,22,11295232860,-383612263
1637058251,-182673,true,11668339416,22,11191798417,-476540999
1637058599,-182668,true,11674174752,22,11211960787,-462213965
1637058723,-182672,true,11669506249,22,11250144420,-419361829
1637058818,-182672,true,11669506249,22,11271538943,-397967306
1637059286,-182679,true,11661340862,22,11333700086,-327640776
1637059731,-182674,true,11667172698,22,11372298316,-294874382
1637059734,-182678,true,11662506996,22,11372298316,-290208680
1637059759,-182679,true,11661340862,22,11372298316,-289042546
1637059784,-182686,true,11653181187,22,11372298316,-280882871
1637059808,-182682,true,11657843159,22,11371161200,-286681959
1637060509,-182685,true,11654346505,22,11372298316,-282048189
1637060703,-182684,true,11655511940,22,11413310317,-242201623
1637060724,-182691,true,11647356344,22,11416734652,-230621692
1637061031,-182685,true,11654346505,22,11472811123,-181535382
1637062067,-182685,true,11654346505,22,11533775387,-120571118
1637062131,-182685,true,11654346505,22,11543005637,-111340868
1637062366,-182693,true,11645027222,22,11573054996,-71972226
1637062739,-182688,true,11650850900,22,11621761604,-29089296
1637062893,-182685,true,11654346505,22,11643862836,-10483669
1637062973,-182684,true,11655511940,22,11654346505,-1165435
1637064745,-182696,true,11641534413,22,11509581081,-131953332
1637064927,-182692,true,11646191725,22,11523400177,-122791548
1637064976,-182689,true,11649685932,22,11529163030,-120522902
1637065231,-182688,true,11650850900,22,11539543428,-111307472
1637065364,-182698,true,11639206455,22,11546468885,-92737570
1637065409,-182694,true,11643862836,22,11545314354,-98548482
1637065601,-182692,true,11646191725,22,11540697382,-105494343
1637065951,-182692,true,11646191725,22,11510732039,-135459686
1637066825,-182703,true,11633388597,22,11456761228,-176627369
1637066932,-182700,true,11636878963,22,11456761228,-180117735
1637067422,-182698,true,11639206455,22,11459052694,-180153761
1637067500,-182697,true,11640370376,22,11460198600,-180171776
1637068157,-182710,true,11625248482,22,11416734652,-208513830
1637068244,-182707,true,11628736405,22,11414451648,-214284757
1637068501,-182706,true,11629899279,22,11414451648,-215447631
1637068901,-182705,true,11631062268,22,11430442271,-200619997
1637069021,-182717,true,11617114062,22,11445310765,-171803297
1637069401,-182714,true,11620599544,22,11514185604,-106413940
1637069654,-182713,true,11621761604,22,11547623532,-74138072
1637069809,-182711,true,11624086073,22,11566113593,-57972480
1637069839,-182722,true,11611307247,22,11568426932,-42880315
1637069859,-182721,true,11612468378,22,11569583774,-42884604
1637069892,-182720,true,11613629624,22,11571897807,-41731817
1637070015,-182721,true,11612468378,22,11570740733,-41727645
1637070319,-182732,true,11599702323,22,11558020551,-41681772
1637070436,-182730,true,11602022380,22,11558020551,-44001829
1637070666,-182729,true,11603182582,22,11561488304,-41694278
1637070863,-182729,true,11603182582,22,11562644453,-40538129
1637071330,-182738,true,11592744937,22,11551088165,-41656772
1637071337,-182736,true,11595063602,22,11551088165,-43975437
1637071509,-182735,true,11596223108,22,11543005637,-53217471
1637071553,-182735,true,11596223108,22,11540697382,-55525726
1637071564,-182745,true,11584633261,22,11539543428,-45089833
1637071932,-182738,true,11592744937,22,11614790987,22046050
1637072236,-182739,true,11591585779,22,11681181008,89595229
1637072563,-182741,true,11589267809,22,11732688864,143421055
1637072855,-182753,true,11575369723,22,11724479266,149109543
1637072921,-182747,true,11582316682,22,11720962625,138645943
1637073015,-182748,true,11581158566,22,11716275412,135116846
1637073150,-182751,true,11577684913,22,11706906608,129221695
1637073520,-182764,true,11562644453,22,11676509704,113865251
1637073538,-182758,true,11569583774,22,11673007451,103423677
1637073661,-182757,true,11570740733,22,11653181187,82440454
1637073782,-182760,true,11567270205,22,11634551936,67281731
1637073800,-182775,true,11549933172,22,11633388597,83455425
1637073899,-182767,true,11559176353,22,11632225375,73049022
1637074199,-182766,true,11560332271,22,11632225375,71893104
1637074216,-182769,true,11556864865,22,11632225375,75360510
1637074333,-182784,true,11539543428,22,11633388597,93845169
1637074642,-182776,true,11548778294,22,11657843159,109064865
1637074704,-182774,true,11551088165,22,11662506996,111418831
1637074789,-182775,true,11549933172,22,11661340862,111407690
1637075070,-182790,true,11532622124,22,11655511940,122889816
1637075357,-182783,true,11540697382,22,11646191725,105494343
1637075428,-182781,true,11543005637,22,11643862836,100857199
1637075485,-182781,true,11543005637,22,11641534413,98528776
1637075629,-182796,true,11525704972,22,11634551936,108846964
1637075776,-182789,true,11533775387,22,11628736405,94961018
1637075818,-182787,true,11536082257,22,11626411006,90328749
1637075902,-182787,true,11536082257,22,11622923781,86841524
1637076215,-182801,true,11519943848,22,11610146232,90202384
1637076356,-182793,true,11529163030,22,11607824551,78661521
1637076781,-182790,true,11532622124,22,11608985334,76363210
1637076806,-182788,true,11534928764,22,11608985334,74056570
1637076957,-182793,true,11529163030,22,11611307247,82144217
1637077412,-182783,true,11540697382,22,11608985334,68287952
1637077570,-182772,true,11553398499,22,11606663885,53265386
1637078200,-182770,true,11555709294,22,11603182582,47473288
1637078505,-182775,true,11549933172,22,11602022380,52089208
1637078660,-182767,true,11559176353,22,11602022380,42846027
1637078701,-182759,true,11568426932,22,11602022380,33595448
1637078891,-182757,true,11570740733,22,11600862294,30121561
1637078895,-182764,true,11562644453,22,11600862294,38217841
1637078909,-182758,true,11569583774,22,11602022380,32438606
1637079100,-182749,true,11580000566,22,11603182582,23182016
1637079159,-182747,true,11582316682,22,11604342900,22026218
1637079367,-182757,true,11570740733,22,11573054996,2314263
1637079411,-182751,true,11577684913,22,11567270205,-10414708
1637079471,-182744,true,11585791724,22,11558020551,-27771173
1637079547,-182744,true,11585791724,22,11556864865,-28926859
1637079831,-182749,true,11580000566,22,11583474913,3474347
1637080251,-182743,true,11586950303,22,11624086073,37135770
1637080304,-182740,true,11590426736,22,11633388597,42961861
1637080689,-182740,true,11590426736,22,11638042651,47615915
1637080915,-182746,true,11583474913,22,11625248482,41773569
1637080994,-182742,true,11588108998,22,11620599544,32490546
1637081010,-182742,true,11588108998,22,11620599544,32490546
1637081096,-182742,true,11588108998,22,11615952466,27843468
1637081313,-182745,true,11584633261,22,11603182582,18549321
1637081332,-182740,true,11590426736,22,11600862294,10435558
1637081596,-182740,true,11590426736,22,11578842681,-11584055
1637081632,-182740,true,11590426736,22,11577684913,-12741823
1637081949,-182745,true,11584633261,22,11567270205,-17363056
1637082804,-182739,true,11591585779,22,11561488304,-30097475
1637083067,-182738,true,11592744937,22,11562644453,-30100484
1637083102,-182738,true,11592744937,22,11562644453,-30100484
1637083168,-182741,true,11589267809,22,11561488304,-27779505
1637083574,-182736,true,11595063602,22,11560332271,-34731331
1637083893,-182735,true,11596223108,22,11556864865,-39358243
1637083917,-182734,true,11597382731,22,11558020551,-39362180
1637084198,-182736,true,11595063602,22,11561488304,-33575298
1637084223,-182731,true,11600862294,22,11561488304,-39373990
1637084657,-182727,true,11605503335,22,11602022380,-3480955
1637085297,-182727,true,11605503335,22,11607824551,2321216
1637085365,-182730,true,11602022380,22,11604342900,2320520
1637085761,-182726,true,11606663885,22,11588108998,-18554887
1637085830,-182724,true,11608985334,22,11586950303,-22035031
1637085969,-182726,true,11606663885,22,11584633261,-22030624
1637086144,-182730,true,11602022380,22,11580000566,-22021814
1637086227,-182725,true,11607824551,22,11578842681,-28981870
1637086526,-182724,true,11608985334,22,11573054996,-35930338
1637086715,-182726,true,11606663885,22,11568426932,-38236953
1637086978,-182730,true,11602022380,22,11558020551,-44001829
1637087107,-182726,true,11606663885,22,11552243274,-54420611
1637087151,-182725,true,11607824551,22,11549933172,-57891379
1637087403,-182727,true,11605503335,22,11545314354,-60188981
1637087493,-182730,true,11602022380,22,11543005637,-59016743
1637087890,-182726,true,11606663885,22,11544159938,-62503947
1637087949,-182724,true,11608985334,22,11545314354,-63670980
1637087978,-182727,true,11605503335,22,11545314354,-60188981
1637087990,-182729,true,11603182582,22,11544159938,-59022644
1637088246,-182733,true,11598542469,22,11516488556,-82053913
1637088984,-182735,true,11596223108,22,11447599942,-148623166
1637089841,-182738,true,11592744937,22,11448744702,-144000235
1637090132,-182740,true,11590426736,22,11440733785,-149692951
1637090239,-182744,true,11585791724,22,11437302251,-148489473
1637090277,-182745,true,11584633261,22,11437302251,-147331010
1637090431,-182748,true,11581158566,22,11436158635,-144999931
1637090665,-182749,true,11580000566,22,11437302251,-142698315
1637090859,-182752,true,11576527260,22,11441877858,-134649402
1637090987,-182753,true,11575369723,22,11445310765,-130058958
1637091219,-182754,true,11574212302,22,11452179669,-122032633
1637091234,-182754,true,11574212302,22,11452179669,-122032633
1637091492,-182757,true,11570740733,22,11467076438,-103664295
1637092015,-182758,true,11569583774,22,11507279510,-62304264
1637092117,-182760,true,11567270205,22,11515337022,-51933183
1637092474,-182759,true,11568426932,22,11523400177,-45026755
1637092526,-182763,true,11563800717,22,11523400177,-40400540
1637092583,-182763,true,11563800717,22,11526857543,-36943174
1637092747,-182766,true,11560332271,22,11521095843,-39236428
1637093276,-182766,true,11560332271,22,11495778557,-64553714
1637093292,-182769,true,11556864865,22,11495778557,-61086308
1637093466,-182770,true,11555709294,22,11481992585,-73716709
1637093471,-182772,true,11553398499,22,11481992585,-71405914
1637093726,-182772,true,11553398499,22,11471663957,-81734542
1637093840,-182775,true,11549933172,22,11463637003,-86296169
1637093928,-182777,true,11547623532,22,11459052694,-88570838
1637093992,-182779,true,11545314354,22,11454470219,-90844135
1637094308,-182779,true,11545314354,22,11435015134,-110299220
1637094498,-182782,true,11541851452,22,11425871237,-115980215
1637094550,-182784,true,11539543428,22,11422444161,-117099267
1637094562,-182786,true,11537235865,22,11421302031,-115933834
1637094576,-182787,true,11536082257,22,11422444161,-113638096
1637094701,-182787,true,11536082257,22,11436158635,-99923622
1637094801,-182788,true,11534928764,22,11444166348,-90762416
1637094963,-182790,true,11532622124,22,11459052694,-73569430
1637095412,-182791,true,11531468977,22,11508430238,-23038739
1637095462,-182791,true,11531468977,22,11514185604,-17283373
1637095524,-182791,true,11531468977,22,11513034301,-18434676
1637095590,-182793,true,11529163030,22,11511883112,-17279918
1637095689,-182794,true,11528010229,22,11510732039,-17278190
1637095809,-182794,true,11528010229,22,11510732039,-17278190
1637095844,-182795,true,11526857543,22,11510732039,-16125504
1637095972,-182798,true,11523400177,22,11508430238,-14969939
1637096516,-182796,true,11525704972,22,11504978399,-20726573
1637096581,-182796,true,11525704972,22,11503828016,-21876956
1637096590,-182795,true,11526857543,22,11503828016,-23029527
1637096696,-182797,true,11524552517,22,11500377558,-24174959
1637096799,-182802,true,11518791969,22,11496928135,-21863834
1637097005,-182802,true,11518791969,22,11492330513,-26461456
1637097369,-182802,true,11518791969,22,11472811123,-45980846
1637097432,-182804,true,11516488556,22,11470516905,-45971651
1637097693,-182808,true,11511883112,22,11465929845,-45953267
1637097828,-182808,true,11511883112,22,11462490754,-49392358
1637098614,-182808,true,11511883112,22,11463637003,-48246109
1637098658,-182809,true,11510732039,22,11463637003,-47095036
1637098695,-182813,true,11506128897,22,11463637003,-42491894
1637098710,-182813,true,11506128897,22,11467076438,-39052459
1637098783,-182810,true,11509581081,22,11476253311,-33327770
1637098861,-182810,true,11509581081,22,11486586071,-22995010
1637098862,-182812,true,11507279510,22,11486586071,-20693439
1637098917,-182813,true,11506128897,22,11490032392,-16096505
1637098952,-182810,true,11509581081,22,11491181395,-18399686
1637099127,-182812,true,11507279510,22,11501527596,-5751914
1637099773,-182813,true,11506128897,22,11540697382,34568485
1637100021,-182813,true,11506128897,22,11548778294,42649397
1637101154,-182811,true,11508430238,22,11536082257,27652019
1637101187,-182812,true,11507279510,22,11536082257,28802747
1637101423,-182814,true,11504978399,22,11534928764,29950365
1637101512,-182815,true,11503828016,22,11534928764,31100748
1637101609,-182814,true,11504978399,22,11534928764,29950365
1637101899,-182815,true,11503828016,22,11536082257,32254241
1637102394,-182818,true,11500377558,22,11488883503,-11494055
1637102470,-182819,true,11499227635,22,11481992585,-17235050
1637102591,-182818,true,11500377558,22,11469369968,-31007590
1637102809,-182820,true,11498077828,22,11451034565,-47043263
1637104150,-182823,true,11494629094,22,11460198600,-34430494
1637104235,-182824,true,11493479746,22,11459052694,-34427052
1637104377,-182823,true,11494629094,22,11457906904,-36722190
1637104568,-182824,true,11493479746,22,11467076438,-26403308
1637104815,-182826,true,11491181395,22,11477400936,-13780459
1637105039,-182827,true,11490032392,22,11471663957,-18368435
1637105206,-182826,true,11491181395,22,11468223146,-22958249
1637105339,-182827,true,11490032392,22,11463637003,-26395389
1637105652,-182830,true,11486586071,22,11440733785,-45852286
1637105826,-182831,true,11485437527,22,11448744702,-36692825
1637105861,-182829,true,11487734730,22,11451034565,-36700165
1637105894,-182831,true,11485437527,22,11453324887,-32112640
1637105902,-182832,true,11484289098,22,11453324887,-30964211
1637107225,-182832,true,11484289098,22,11429299341,-54989757
1637107317,-182830,true,11486586071,22,11427013824,-59572247
1637107585,-182832,true,11484289098,22,11419018113,-65270985
1637107883,-182833,true,11483140784,22,11409887008,-73253776
1637107904,-182834,true,11481992585,22,11411027997,-70964588
1637108130,-182831,true,11485437527,22,11429299341,-56138186
1637108236,-182831,true,11485437527,22,11440733785,-44703742
1637108355,-182831,true,11485437527,22,11447599942,-37837585
1637108412,-182832,true,11484289098,22,11449889576,-34399522
1637108466,-182830,true,11486586071,22,11453324887,-33261184
1637108607,-182831,true,11485437527,22,11459052694,-26384833
1637108664,-182831,true,11485437527,22,11461344620,-24092907
1637108800,-182834,true,11481992585,22,11462490754,-19501831
1637109046,-182833,true,11483140784,22,11437302251,-45838533
1637109096,-182835,true,11480844501,22,11433871747,-46972754
1637109665,-182835,true,11480844501,22,11440733785,-40110716
1637109756,-182837,true,11478548676,22,11445310765,-33237911
1637109766,-182836,true,11479696531,22,11445310765,-34385766
1637110101,-182838,true,11477400936,22,11448744702,-28656234
1637110108,-182837,true,11478548676,22,11449889576,-28659100
1637110200,-182838,true,11477400936,22,11457906904,-19494032
1637110216,-182837,true,11478548676,22,11459052694,-19495982
1637110808,-182836,true,11479696531,22,11502677749,22981218
1637110973,-182834,true,11481992585,22,11516488556,34495971
1637111300,-182836,true,11479696531,22,11524552517,44855986
1637111337,-182833,true,11483140784,22,11525704972,42564188
1637111683,-182832,true,11484289098,22,11530315946,46026848
1637111777,-182830,true,11486586071,22,11530315946,43729875
1637112071,-182832,true,11484289098,22,11524552517,40263419
1637112132,-182829,true,11487734730,22,11523400177,35665447
1637112426,-182826,true,11491181395,22,11560332271,69150876
1637112615,-182823,true,11494629094,22,11586950303,92321209
1637112763,-182826,true,11491181395,22,11611307247,120125852
1637113066,-182824,true,11493479746,22,11655511940,162032194
1637113154,-182821,true,11496928135,22,11656677491,159749356
1637113427,-182817,true,11501527596,22,11659008943,157481347
1637113509,-182820,true,11498077828,22,11659008943,160931115
1637113628,-182818,true,11500377558,22,11656677491,156299933
1637113648,-182815,true,11503828016,22,11655511940,151683924
1637114353,-182815,true,11503828016,22,11569583774,65755758
1637114554,-182817,true,11501527596,22,11575369723,73842127
1637115100,-182815,true,11503828016,22,11613629624,109801608
1637115657,-182812,true,11507279510,22,11598542469,91262959
1637116039,-182811,true,11508430238,22,11591585779,83155541
1637116146,-182813,true,11506128897,22,11590426736,84297839
1637116196,-182811,true,11508430238,22,11589267809,80837571
1637116212,-182808,true,11511883112,22,11589267809,77384697
1637116341,-182806,true,11514185604,22,11596223108,82037504
1637116558,-182807,true,11513034301,22,11605503335,92469034
1637116669,-182805,true,11515337022,22,11610146232,94809210
1637116750,-182802,true,11518791969,22,11612468378,93676409
1637116857,-182800,true,11521095843,22,11615952466,94856623
1637117041,-182801,true,11519943848,22,11622923781,102979933
1637117175,-182799,true,11522247952,22,11624086073,101838121
1637117258,-182796,true,11525704972,22,11622923781,97218809
1637117541,-182794,true,11528010229,22,11614790987,86780758
1637117806,-182795,true,11526857543,22,11610146232,83288689
1637117928,-182796,true,11525704972,22,11606663885,80958913
1637117978,-182794,true,11528010229,22,11606663885,78653656
1637118017,-182793,true,11529163030,22,11605503335,76340305
1637118503,-182794,true,11528010229,22,11593904212,65893983
1637118765,-182794,true,11528010229,22,11583474913,55464684
1637118931,-182792,true,11530315946,22,11577684913,47368967
1637119341,-182793,true,11529163030,22,11524552517,-4610513
1637119603,-182796,true,11525704972,22,11477400936,-48304036
1637119647,-182797,true,11524552517,22,11471663957,-52888560
1637119830,-182796,true,11525704972,22,11441877858,-83827114
1637120295,-182797,true,11524552517,22,11425871237,-98681280
1637120495,-182800,true,11521095843,22,11430442271,-90653572
1637120512,-182801,true,11519943848,22,11430442271,-89501577
1637120890,-182800,true,11521095843,22,11430442271,-90653572
1637122305,-182800,true,11521095843,22,11415593093,-105502750
1637122481,-182803,true,11517640205,22,11415593093,-102047112
1637122684,-182804,true,11516488556,22,11419018113,-97470443
1637122726,-182801,true,11519943848,22,11420160015,-99783833
1637122936,-182801,true,11519943848,22,11428156526,-91787322
1637122995,-182804,true,11516488556,22,11430442271,-86046285
1637123318,-182804,true,11516488556,22,11443022046,-73466510
1637123464,-182802,true,11518791969,22,11445310765,-73481204
1637124253,-182802,true,11518791969,22,11455615666,-63176303
1637124356,-182804,true,11516488556,22,11457906904,-58581652
1637124394,-182804,true,11516488556,22,11460198600,-56289956
1637124538,-182801,true,11519943848,22,11461344620,-58599228
1637124967,-182801,true,11519943848,22,11464783367,-55160481
1637125127,-182804,true,11516488556,22,11464783367,-51705189
1637125273,-182804,true,11516488556,22,11461344620,-55143936
1637125633,-182802,true,11518791969,22,11448744702,-70047267
1637126201,-182804,true,11516488556,22,11428156526,-88332030
1637126322,-182804,true,11516488556,22,11427013824,-89474732
1637126345,-182804,true,11516488556,22,11427013824,-89474732
1637126644,-182802,true,11518791969,22,11424728764,-94063205
1637126699,-182804,true,11516488556,22,11423586406,-92902150
1637126763,-182803,true,11517640205,22,11423586406,-94053799
1637127016,-182805,true,11515337022,22,11417876325,-97460697
1637127167,-182804,true,11516488556,22,11413310317,-103178239
1637127281,-182807,true,11513034301,22,11409887008,-103147293
1637127316,-182806,true,11514185604,22,11408746133,-105439471
1637127421,-182808,true,11511883112,22,11406464726,-105418386
1637127440,-182806,true,11514185604,22,11405324194,-108861410
1637127461,-182809,true,11510732039,22,11405324194,-105407845
1637127522,-182807,true,11513034301,22,11406464726,-106569575
1637127611,-182807,true,11513034301,22,11409887008,-103147293
1637128384,-182805,true,11515337022,22,11448744702,-66592320
1637129168,-182808,true,11511883112,22,11464783367,-47099745
1637129740,-182807,true,11513034301,22,11449889576,-63144725
1637130982,-182807,true,11513034301,22,11463637003,-49397298
1637131350,-182805,true,11515337022,22,11431585315,-83751707
1637131644,-182808,true,11511883112,22,11405324194,-106558918
1637131891,-182808,true,11511883112,22,11382537479,-129345633
1637132143,-182811,true,11508430238,22,11359796290,-148633948
1637132342,-182811,true,11508430238,22,11358660424,-149769814
1637132759,-182815,true,11503828016,22,11351847613,-151980403
1637132800,-182815,true,11503828016,22,11351847613,-151980403
1637133594,-182817,true,11501527596,22,11351847613,-149679983
1637133635,-182818,true,11500377558,22,11350712541,-149665017
1637134018,-182823,true,11494629094,22,11318976584,-175652510
1637134147,-182822,true,11495778557,22,11326902245,-168876312
1637134225,-182825,true,11492330513,22,11329167739,-163162774
1637134504,-182827,true,11490032392,22,11337100536,-152931856
1637134755,-182831,true,11485437527,22,11360932270,-124505257
1637134928,-182833,true,11483140784,22,11376847918,-106292866
1637135306,-182837,true,11478548676,22,11357524672,-121024004
1637135410,-182839,true,11476253311,22,11352982797,-123270514
1637135693,-182844,true,11470516905,22,11342770220,-127746685
1637136026,-182844,true,11470516905,22,11382537479,-87979426
1637136069,-182847,true,11467076438,22,11388229886,-78846552
1637136084,-182849,true,11464783367,22,11389368709,-75414658
1637136563,-182849,true,11464783367,22,11433871747,-30911620
1637137119,-182851,true,11462490754,22,11417876325,-44614429
1637137635,-182854,true,11459052694,22,11413310317,-45742377
1637139119,-182856,true,11456761228,22,11391646697,-65114531
1637139133,-182857,true,11455615666,22,11390507646,-65108020
1637139164,-182859,true,11453324887,22,11392785862,-60539025
1637139793,-182861,true,11451034565,22,11441877858,-9156707
1637140228,-182861,true,11451034565,22,11460198600,9164035
1637140330,-182863,true,11448744702,22,11459052694,10307992
1637140599,-182865,true,11446455296,22,11448744702,2289406
1637141552,-182869,true,11441877858,22,11438445982,-3431876
1637142092,-182868,true,11443022046,22,11468223146,25201100
1637142509,-182869,true,11441877858,22,11488883503,47005645
1637142554,-182872,true,11438445982,22,11488883503,50437521
1637142796,-182874,true,11436158635,22,11488883503,52724868
1637143063,-182873,true,11437302251,22,11491181395,53879144
1637143795,-182873,true,11437302251,22,11532622124,95319873
1637143830,-182875,true,11435015134,22,11537235865,102220731
1637143843,-182876,true,11433871747,22,11540697382,106825635
1637143912,-182875,true,11435015134,22,11559176353,124161219
1637144165,-182868,true,11443022046,22,11619437601,176415555
1637144322,-182868,true,11443022046,22,11663673246,220651200
1637144756,-182868,true,11443022046,22,11804473397,361451351
1637144918,-182866,true,11445310765,22,11823374726,378063961
1637145072,-182857,true,11455615666,22,11839938214,384322548
1637145614,-182856,true,11456761228,22,11803293068,346531840
1637146289,-182856,true,11456761228,22,11758527900,301766672
1637146414,-182853,true,11460198600,22,11753825664,293627064
1637146488,-182844,true,11470516905,22,11744426834,273909929
1637146788,-182844,true,11470516905,22,11717447040,246930135
1637146989,-182846,true,11468223146,22,11701054910,232831764
1637147332,-182843,true,11471663957,22,11682349126,210685169
1637147443,-182833,true,11483140784,22,11690529225,207388441
1637147823,-182833,true,11483140784,22,11713932508,230791724
1637148340,-182832,true,11484289098,22,11790317232,306028134
1637148537,-182828,true,11488883503,22,11813920281,325036778
1637148561,-182819,true,11499227635,22,11816283184,317055549
1637148817,-182818,true,11500377558,22,11818646558,318269000
1637148898,-182819,true,11499227635,22,11809195894,309968259
1637149367,-182816,true,11502677749,22,11766761339,264083590
1637149432,-182807,true,11513034301,22,11762055811,249021510
1637149827,-182806,true,11514185604,22,11759703753,245518149
1637150012,-182807,true,11513034301,22,11760879723,247845422
1637150342,-182804,true,11516488556,22,11763232016,246743460
1637150655,-182795,true,11526857543,22,11762055811,235198268
1637150704,-182795,true,11526857543,22,11762055811,235198268
1637150802,-182795,true,11526857543,22,11752650399,225792856
1637150953,-182794,true,11528010229,22,11738556381,210546152
1637151532,-182784,true,11539543428,22,11709248107,169704679
1637151599,-182784,true,11539543428,22,11705736035,166192607
1637151624,-182784,true,11539543428,22,11706906608,167363180
1637151659,-182782,true,11541851452,22,11709248107,167396655
1637152363,-182773,true,11552243274,22,11715103902,162860628
1637152412,-182772,true,11553398499,22,11715103902,161705403
1637152594,-182773,true,11552243274,22,11710419031,158175757
1637152797,-182770,true,11555709294,22,11702225016,146515722
1637152868,-182762,true,11564957097,22,11699884922,134927825
1637152872,-182761,true,11566113593,22,11699884922,133771329
1637152906,-182762,true,11564957097,22,11697545296,132588199
1637152961,-182759,true,11568426932,22,11695206138,126779206
1637153467,-182750,true,11578842681,22,11684685713,105843032
1637153677,-182750,true,11578842681,22,11692867447,114024766
1637153795,-182752,true,11576527260,22,11695206138,118678878
1637154294,-182750,true,11578842681,22,11697545296,118702615
1637154331,-182741,true,11589267809,22,11697545296,108277487
1637154378,-182741,true,11589267809,22,11697545296,108277487
1637154784,-182743,true,11586950303,22,11688191469,101241166
1637154792,-182741,true,11589267809,22,11687022767,97754958
1637155041,-182731,true,11600862294,22,11685854182,84991888
1637155116,-182731,true,11600862294,22,11684685713,83823419
1637155131,-182730,true,11602022380,22,11687022767,85000387
1637155203,-182727,true,11605503335,22,11695206138,89702803
1637155236,-182716,true,11618275773,22,11698715050,80439277
1637155518,-182712,true,11622923781,22,11742078301,119154520
1637155718,-182712,true,11622923781,22,11771468750,148544969
1637155734,-182709,true,11626411006,22,11773823161,147412155
1637155814,-182697,true,11640370376,22,11782067310,141696934
1637156061,-182695,true,11642698566,22,11800932763,158234197
1637156106,-182694,true,11643862836,22,11799752788,155889952
1637156302,-182692,true,11646191725,22,11787959522,141767797
1637156824,-182682,true,11657843159,22,11759703753,101860594
1637156873,-182679,true,11661340862,22,11758527900,97187038
1637157075,-182678,true,11662506996,22,11752650399,90143403
1637157093,-182676,true,11664839614,22,11752650399,87810785
1637157207,-182666,true,11676509704,22,11751475252,74965548
1637157529,-182665,true,11677677355,22,11749125309,71447954
1637157546,-182665,true,11677677355,22,11747950514,70273159
1637157800,-182663,true,11680013007,22,11731515712,51502705
1637158108,-182655,true,11689360289,22,11711590073,22229784
1637158688,-182654,true,11690529225,22,11687022767,-3506458
1637159002,-182654,true,11690529225,22,11684685713,-5843512
1637159111,-182652,true,11692867447,22,11684685713,-8181734
1637159135,-182644,true,11702225016,22,11684685713,-17539303
1637159234,-182643,true,11703395238,22,11683517361,-19877877
1637159335,-182644,true,11702225016,22,11681181008,-21044008
1637159401,-182644,true,11702225016,22,11681181008,-21044008
1637159414,-182635,true,11712761232,22,11680013007,-32748225
1637159553,-182635,true,11712761232,22,11671840267,-40920965
1637159698,-182636,true,11711590073,22,11662506996,-49083077
1637160078,-182637,true,11710419031,22,11636878963,-73540068
1637160179,-182629,true,11719790646,22,11631062268,-88728378
1637160309,-182629,true,11719790646,22,11624086073,-95704573
1637161039,-182631,true,11717447040,22,11625248482,-92198558
1637161258,-182632,true,11716275412,22,11624086073,-92189339
1637161347,-182625,true,11724479266,22,11624086073,-100393193
1637161437,-182625,true,11724479266,22,11625248482,-99230784
1637161513,-182627,true,11722134721,22,11622923781,-99210940
1637161520,-182629,true,11719790646,22,11622923781,-96866865
1637161859,-182629,true,11719790646,22,11614790987,-104999659
1637162030,-182631,true,11717447040,22,11608985334,-108461706
1637163240,-182637,true,11710419031,22,11543005637,-167413394
1637163277,-182639,true,11708077299,22,11541851452,-166225847
1637163292,-182641,true,11705736035,22,11541851452,-163884583
1637163657,-182642,true,11704565578,22,11529163030,-175402548
1637163744,-182648,true,11697545296,22,11519943848,-177601448
1637163766,-182650,true,11695206138,22,11518791969,-176414169
1637163794,-182651,true,11694036734,22,11517640205,-176396529
1637163856,-182651,true,11694036734,22,11516488556,-177548178
1637164446,-182654,true,11690529225,22,11513034301,-177494924
1637164490,-182656,true,11688191469,22,11514185604,-174005865
1637164940,-182657,true,11687022767,22,11521095843,-165926924
1637165133,-182659,true,11684685713,22,11518791969,-165893744
1637165285,-182664,true,11678845123,22,11517640205,-161204918
1637166539,-182666,true,11676509704,22,11544159938,-132349766
1637166652,-182668,true,11674174752,22,11543005637,-131169115
1637167098,-182670,true,11671840267,22,11540697382,-131142885
1637167428,-182674,true,11667172698,22,11532622124,-134550574
1637167869,-182677,true,11663673246,22,11452179669,-211493577
1637168013,-182679,true,11661340862,22,11436158635,-225182227
1637168055,-182682,true,11657843159,22,11431585315,-226257844
1637168212,-182688,true,11650850900,22,11417876325,-232974575
1637169369,-182690,true,11648521080,22,11435015134,-213505946
1637170283,-182692,true,11646191725,22,11427013824,-219177901
1637170672,-182695,true,11642698566,22,11429299341,-213399225
1637170932,-182700,true,11636878963,22,11431585315,-205293648
1637170989,-182702,true,11634551936,22,11437302251,-197249685
1637170991,-182702,true,11634551936,22,11437302251,-197249685
1637171638,-182704,true,11632225375,22,11490032392,-142192983
1637172318,-182708,true,11627573648,22,11502677749,-124895899
1637172461,-182710,true,11625248482,22,11501527596,-123720886
1637172597,-182711,true,11624086073,22,11498077828,-126008245
1637172629,-182712,true,11622923781,22,11496928135,-125995646
1637172824,-182718,true,11615952466,22,11485437527,-130514939
1637173127,-182720,true,11613629624,22,11467076438,-146553186
1637173194,-182720,true,11613629624,22,11463637003,-149992621
1637173219,-182722,true,11611307247,22,11462490754,-148816493
1637173344,-182726,true,11606663885,22,11456761228,-149902657
1637173810,-182728,true,11604342900,22,11463637003,-140705897
1637173835,-182729,true,11603182582,22,11464783367,-138399215
1637173964,-182730,true,11602022380,22,11465929845,-136092535
1637174093,-182735,true,11596223108,22,11465929845,-130293263
1637175810,-182739,true,11591585779,22,11416734652,-174851127
1637176219,-182740,true,11590426736,22,11389368709,-201058027
1637176432,-182742,true,11588108998,22,11375710347,-212398651
1637177308,-182747,true,11582316682,22,11358660424,-223656258
1637177751,-182752,true,11576527260,22,11356389033,-220138227
1637177892,-182753,true,11575369723,22,11355253507,-220116216
1637178032,-182755,true,11573054996,22,11349577584,-223477412
1637178168,-182761,true,11566113593,22,11342770220,-223343373
1637178341,-182767,true,11559176353,22,11335966939,-223209414
1637178403,-182770,true,11555709294,22,11332566829,-223142465
1637178584,-182774,true,11551088165,22,11335966939,-215121226
1637178846,-182781,true,11543005637,22,11300881606,-242124031
1637178911,-182788,true,11534928764,22,11295232860,-239695904
1637179154,-182792,true,11530315946,22,11271538943,-258777003
1637179273,-182796,true,11525704972,22,11260273601,-265431371
1637179551,-182803,true,11517640205,22,11233282696,-284357509
1637179799,-182809,true,11510732039,22,11236653018,-274079021
1637180386,-182812,true,11507279510,22,11241148353,-266131157
1637180462,-182816,true,11502677749,22,11242272468,-260405281
1637181030,-182823,true,11494629094,22,11238900461,-255728633
1637181872,-182829,true,11487734730,22,11216446244,-271288486
1637182001,-182833,true,11483140784,22,11215324712,-267816072
1637182218,-182837,true,11478548676,22,11215324712,-263223964
1637182432,-182844,true,11470516905,22,11233282696,-237234209
1637182549,-182847,true,11467076438,22,11259147686,-207928752
1637182715,-182849,true,11464783367,22,11295232860,-169550507
1637182798,-182850,true,11463637003,22,11313318793,-150318210
1637183428,-182855,true,11457906904,22,11405324194,-52582710
1637183917,-182859,true,11453324887,22,11397343660,-55981227
1637183970,-182860,true,11452179669,22,11397343660,-54836009
1637184117,-182861,true,11451034565,22,11388229886,-62804679
1637184171,-182866,true,11445310765,22,11382537479,-62773286
1637184390,-182872,true,11438445982,22,11364340890,-74105092
1637185045,-182874,true,11436158635,22,11302011694,-134146941
1637185232,-182875,true,11435015134,22,11289586937,-145428197
1637185350,-182880,true,11429299341,22,11285072231,-144227110
1637185934,-182885,true,11423586406,22,11277175840,-146410566
1637186044,-182888,true,11420160015,22,11278303557,-141856458
1637186072,-182889,true,11419018113,22,11279431388,-139586725
1637186090,-182894,true,11413310317,22,11279431388,-133878929
1637186382,-182899,true,11407605373,22,11283943837,-123661536
1637186647,-182901,true,11405324194,22,11287329359,-117994835
1637186827,-182902,true,11404183776,22,11294103450,-110080326
1637187011,-182907,true,11398483394,22,11296362383,-102121011
1637187111,-182912,true,11392785862,22,11282815555,-109970307
1637187336,-182915,true,11389368709,22,11265904864,-123463845
1637188884,-182917,true,11387091177,22,11218689645,-168401532
1637189281,-182920,true,11383675733,22,11217567889,-166107844
1637189298,-182926,true,11376847918,22,11217567889,-159280029
1637189758,-182928,true,11374572889,22,11252394561,-122178328
1637189885,-182928,true,11374572889,22,11264778386,-109794503
1637190128,-182929,true,11373435546,22,11288458092,-84977454
1637190658,-182934,true,11367750534,22,11297492020,-70258514
1637190805,-182936,true,11365477324,22,11289586937,-75890387
1637191159,-182937,true,11364340890,22,11255770617,-108570273
1637191194,-182939,true,11362068363,22,11252394561,-109673802
1637191286,-182946,true,11354118096,22,11244521035,-109597061
1637191464,-182949,true,11350712541,22,11228790506,-121922035
1637191741,-182949,true,11350712541,22,11211960787,-138751754
1637191850,-182951,true,11348442739,22,11207477124,-140965615
1637192440,-182959,true,11339368069,22,11213081983,-126286086
1637193196,-182962,true,11335966939,22,11219811514,-116155425
1637193622,-182962,true,11335966939,22,11220933496,-115033443
1637193882,-182964,true,11333700086,22,11222055589,-111644497
1637193966,-182969,true,11328034935,22,11222055589,-105979346
1637194023,-182971,true,11325769668,22,11225422542,-100347126
1637194598,-182969,true,11328034935,22,11259147686,-68887249
1637195153,-182970,true,11326902245,22,11265904864,-60997381
1637195371,-182976,true,11320108482,22,11260273601,-59834881
1637195492,-182978,true,11317844800,22,11255770617,-62074183
1637195566,-182976,true,11320108482,22,11254645153,-65463329
1637195630,-182977,true,11318976584,22,11253519801,-65456783
1637195763,-182983,true,11312187574,22,11252394561,-59793013
1637196077,-182986,true,11308794597,22,11243396695,-65397902
1637196079,-182986,true,11308794597,22,11243396695,-65397902
1637196258,-182988,true,11306533177,22,11237776683,-68756494
1637197875,-182995,true,11298621769,22,11220933496,-77688273
1637197964,-182997,true,11296362383,22,11219811514,-76550869
1637198468,-182997,true,11296362383,22,11209718731,-86643652
1637198526,-182998,true,11295232860,22,11208597871,-86634989
1637198705,-183005,true,11287329359,22,11205235964,-82093395
1637198881,-183007,true,11285072231,22,11210839703,-74232528
1637198962,-183006,true,11286200739,22,11214203291,-71997448
1637199070,-183007,true,11285072231,22,11219811514,-65260717
1637199393,-183014,true,11277175840,22,11233282696,-43893144
1637199414,-183016,true,11274920743,22,11234406024,-40514719
1637199458,-183015,true,11276048235,22,11235529465,-40518770
1637199826,-183016,true,11274920743,22,11237776683,-37144060
1637200469,-183021,true,11269284973,22,11228790506,-40494467
1637200493,-183023,true,11267031454,22,11228790506,-38240948
1637200597,-183022,true,11268158157,22,11225422542,-42735615
1637200638,-183023,true,11267031454,22,11223177795,-43853659
1637200668,-183028,true,11261399628,22,11223177795,-38221833
1637200808,-183029,true,11260273601,22,11222055589,-38218012
1637201313,-183027,true,11262525768,22,11232159480,-30366288
1637201519,-183027,true,11262525768,22,11237776683,-24749085
1637201617,-183031,true,11258021884,22,11241148353,-16873531
1637201725,-183032,true,11256896194,22,11242272468,-14623726
1637201770,-183031,true,11258021884,22,11241148353,-16873531
1637202095,-183029,true,11260273601,22,11236653018,-23620583
1637202142,-183033,true,11255770617,22,11236653018,-19117599
1637202256,-183033,true,11255770617,22,11236653018,-19117599
1637202571,-183031,true,11258021884,22,11236653018,-21368866
1637202879,-183029,true,11260273601,22,11245645487,-14628114
1637203180,-183033,true,11255770617,22,11251269434,-4501183
1637203219,-183033,true,11255770617,22,11251269434,-4501183
1637203286,-183030,true,11259147686,22,11252394561,-6753125
1637203314,-183029,true,11260273601,22,11252394561,-7879040
1637203355,-183032,true,11256896194,22,11252394561,-4501633
1637203489,-183032,true,11256896194,22,11252394561,-4501633
1637203697,-183030,true,11259147686,22,11245645487,-13502199
1637203815,-183028,true,11261399628,22,11241148353,-20251275
1637204278,-183034,true,11254645153,22,11229913385,-24731768
1637204365,-183036,true,11252394561,22,11229913385,-22481176
1637204631,-183035,true,11253519801,22,11227667739,-25852062
1637204763,-183035,true,11253519801,22,11226545085,-26974716
1637205123,-183041,true,11246770051,22,11220933496,-25836555
1637205157,-183043,true,11244521035,22,11219811514,-24709521
1637205201,-183042,true,11245645487,22,11218689645,-26955842
1637205475,-183042,true,11245645487,22,11214203291,-31442196
1637206350,-183047,true,11240024351,22,11192917597,-47106754
1637206531,-183047,true,11240024351,22,11195156293,-44868058
1637206629,-183046,true,11241148353,22,11196275808,-44872545
1637206635,-183046,true,11241148353,22,11196275808,-44872545
1637206762,-183049,true,11237776683,22,11205235964,-32540719
1637207181,-183049,true,11237776683,22,11232159480,-5617203
1637207305,-183047,true,11240024351,22,11240024351,0
1637207745,-183047,true,11240024351,22,11244521035,4496684
1637208475,-183051,true,11235529465,22,11225422542,-10106923
1637208490,-183051,true,11235529465,22,11224300112,-11229353
1637209889,-183051,true,11235529465,22,11210839703,-24689762
1637210466,-183051,true,11235529465,22,11206356488,-29172977
1637211050,-183054,true,11232159480,22,11205235964,-26923516
1637212170,-183053,true,11233282696,22,11199635027,-33647669
1637212939,-183052,true,11234406024,22,11198515175,-35890849
1637213537,-183052,true,11234406024,22,11167204753,-67201271
1637214104,-183055,true,11231036376,22,11180612772,-50423604
1637214144,-183055,true,11231036376,22,11182849006,-48187370
1637214309,-183055,true,11231036376,22,11190679349,-40357027
1637214414,-183056,true,11229913385,22,11195156293,-34757092
1637214509,-183060,true,11225422542,22,11194036889,-31385653
1637214953,-183058,true,11227667739,22,11208597871,-19069868
1637215303,-183057,true,11228790506,22,11222055589,-6734917
1637216935,-183057,true,11228790506,22,11220933496,-7857010
1637216983,-183060,true,11225422542,22,11220933496,-4489046
1637217198,-183058,true,11227667739,22,11207477124,-20190615
1637217406,-183057,true,11228790506,22,11195156293,-33634213
1637217484,-183059,true,11226545085,22,11189560393,-36984692
1637217655,-183062,true,11223177795,22,11176141645,-47036150
1637217718,-183061,true,11224300112,22,11171672305,-52627807
1637217798,-183059,true,11226545085,22,11168321474,-58223611
1637217948,-183061,true,11224300112,22,11164971647,-59328465
1637218107,-183064,true,11220933496,22,11166088145,-54845351
1637218419,-183063,true,11222055589,22,11172789473,-49266116
1637218885,-183062,true,11223177795,22,11182849006,-40328789
1637218928,-183065,true,11219811514,22,11182849006,-36962508
1637219028,-183067,true,11217567889,22,11183967291,-33600598
1637219395,-183066,true,11218689645,22,11181730833,-36958812
1637219458,-183066,true,11218689645,22,11178376985,-40312660
1637220020,-183067,true,11217567889,22,11181730833,-35837056
1637220797,-183069,true,11215324712,22,11189560393,-25764319
1637221525,-183068,true,11216446244,22,11204115553,-12330691
1637221824,-183067,true,11217567889,22,11206356488,-11211401
1637222102,-183069,true,11215324712,22,11186204196,-29120516
1637222216,-183071,true,11213081983,22,11175024142,-38057841
1637222518,-183071,true,11213081983,22,11143779400,-69302583
1637222857,-183071,true,11213081983,22,11138209181,-74872802
1637222921,-183072,true,11211960787,22,11139323002,-72637785
1637222966,-183073,true,11210839703,22,11140436935,-70402768
1637223229,-183073,true,11210839703,22,11150467339,-60372364
1637223327,-183073,true,11210839703,22,11154928195,-55911508
1637223734,-183075,true,11208597871,22,11153812814,-54785057
1637223808,-183077,true,11206356488,22,11151582386,-54774102
1637223876,-183077,true,11206356488,22,11149352404,-57004084
1637223964,-183077,true,11206356488,22,11146008267,-60348221
1637224431,-183080,true,11202995253,22,11130415553,-72579700
1637224493,-183081,true,11201875066,22,11128189803,-73685263
1637224599,-183081,true,11201875066,22,11123739640,-78135426
1637224656,-183082,true,11200754990,22,11119291256,-81463734
1637224931,-183085,true,11197395436,22,11103735918,-93659518
1637224973,-183086,true,11196275808,22,11099295533,-96980275
1637225003,-183087,true,11195156293,22,11095966411,-99189882
1637225441,-183090,true,11191798417,22,11043940327,-147858090
1637225465,-183094,true,11187322817,22,11040627807,-146695010
1637225877,-183096,true,11185085688,22,11008657964,-176427724
1637226054,-183097,true,11183967291,22,11006456562,-177510729
1637226073,-183100,true,11180612772,22,11006456562,-174156210
1637226186,-183104,true,11176141645,22,11009758830,-166382815
1637226330,-183105,true,11175024142,22,11010859805,-164164337
1637226494,-183105,true,11175024142,22,11013062087,-161962055
1637226549,-183109,true,11170555250,22,11009758830,-160796420
1637226647,-183113,true,11166088145,22,11011960891,-154127254
1637226775,-183115,true,11163855262,22,11014163394,-149691868
1637226924,-183115,true,11163855262,22,11017467973,-146387289
1637227593,-183119,true,11159390836,22,11008657964,-150732872
1637227744,-183124,true,11153812814,22,10993257396,-160555418
1637228198,-183126,true,11151582386,22,10952659525,-198922861
1637228542,-183126,true,11151582386,22,10934056751,-217525635
1637228708,-183131,true,11146008267,22,10937337296,-208670971
1637228728,-183136,true,11140436935,22,10937337296,-203099639
1637228964,-183137,true,11139323002,22,10954850167,-184472835
1637229030,-183137,true,11139323002,22,10959232764,-180090238
1637229138,-183140,true,11135981874,22,10972391079,-163590795
1637229250,-183144,true,11131528594,22,10991059074,-140469520
1637229283,-183144,true,11131528594,22,10995456157,-136072437
1637229632,-183143,true,11132641747,22,11039523855,-93117892
1637229825,-183146,true,11129302622,22,11050568348,-78734274
1637230167,-183151,true,11123739640,22,11050568348,-73171292
1637230194,-183150,true,11124852014,22,11050568348,-74283666
1637230229,-183149,true,11125964499,22,11048358566,-77605933
1637230257,-183153,true,11121515226,22,11047253840,-74261386
1637231435,-183156,true,11118179438,22,11062730053,-55449385
1637231643,-183156,true,11118179438,22,11062730053,-55449385
1637232245,-183157,true,11117067732,22,11031799278,-85268454
1637232262,-183161,true,11112622016,22,11030696209,-81925807
1637232275,-183165,true,11108178078,22,11029593249,-78584829
1637232320,-183165,true,11108178078,22,11026285033,-81893045
1637232626,-183167,true,11105956776,22,11005356027,-100600749
1637232684,-183170,true,11102625655,22,11003155286,-99470369
1637232777,-183174,true,11098185715,22,11000954985,-97230730
1637232804,-183174,true,11098185715,22,10999854999,-98330716
1637233203,-183174,true,11098185715,22,11019671577,-78514138
1637233263,-183177,true,11094856925,22,11025182515,-69674410
1637233505,-183180,true,11091529133,22,11041731870,-49797263
1637234122,-183180,true,11091529133,22,11052778572,-38750561
1637234342,-183180,true,11091529133,22,11048358566,-43170567
1637234378,-183182,true,11089311160,22,11048358566,-40952594
1637234613,-183186,true,11084876545,22,11046149225,-38727320
1637234671,-183186,true,11084876545,22,11045044721,-39831824
1637234732,-183187,true,11083768168,22,11042836043,-40932125
1637234757,-183189,true,11081551747,22,11042836043,-38715704
1637234969,-183194,true,11076012633,22,11034005748,-42006885
1637235002,-183194,true,11076012633,22,11032902458,-43110175
1637235076,-183195,true,11074905142,22,11025182515,-49722627
1637235625,-183199,true,11070476287,22,10974585667,-95890620
1637235766,-183203,true,11066049204,22,10965809948,-100239256
1637235946,-183203,true,11066049204,22,10954850167,-111199037
1637235971,-183204,true,11064942709,22,10954850167,-110092542
1637236138,-183208,true,11060517838,22,10949374385,-111143453
1637236352,-183212,true,11056094737,22,10940618826,-115475911
1637236775,-183213,true,11054989238,22,10920944408,-134044830
1637236976,-183214,true,11053883850,22,10915485573,-138398277
1637237073,-183219,true,11048358566,22,10919852422,-128506144
1637237228,-183223,true,11043940327,22,10926405972,-117534355
1637237277,-183223,true,11043940327,22,10928591363,-115348964
1637237796,-183224,true,11042836043,22,10952659525,-90176518
1637238090,-183228,true,11038420013,22,10957041246,-81378767
1637238115,-183232,true,11034005748,22,10957041246,-76964502
1637238369,-183232,true,11034005748,22,10957041246,-76964502
1637238613,-183233,true,11032902458,22,10957041246,-75861212
1637238713,-183238,true,11027387662,22,10955945652,-71442010
1637238754,-183242,true,11022977809,22,10955945652,-67032157
1637238768,-183242,true,11022977809,22,10954850167,-68127642
1637238888,-183241,true,11024080107,22,10959232764,-64847343
1637238959,-183244,true,11020773544,22,10961424720,-59348824
1637239628,-183250,true,11014163394,22,10935150157,-79013237
1637239647,-183251,true,11013062087,22,10935150157,-77911930
1637239762,-183250,true,11014163394,22,10935150157,-79013237
1637239805,-183253,true,11010859805,22,10934056751,-76803054
1637239892,-183258,true,11005356027,22,10929684222,-75671805
1637239909,-183259,true,11004255601,22,10928591363,-75664238
1637240295,-183260,true,11003155286,22,10915485573,-87669713
1637240444,-183264,true,10998755124,22,10911120470,-87634654
1637240659,-183268,true,10994356721,22,10887143588,-107213133
1637240970,-183269,true,10993257396,22,10868652091,-124605305
1637241056,-183271,true,10991059074,22,10866478687,-124580387
1637241160,-183275,true,10986663749,22,10863219395,-123444354
1637241170,-183278,true,10983368409,22,10863219395,-120149014
1637241293,-183278,true,10983368409,22,10859961081,-123407328
1637241698,-183279,true,10982270182,22,10867565334,-114704848
1637241811,-183282,true,10978976160,22,10866478687,-112497473
1637241881,-183284,true,10976780694,22,10865392147,-111388547
1637241980,-183284,true,10976780694,22,10863219395,-113561299
1637242228,-183290,true,10970196930,22,10804719028,-165477902
1637242405,-183294,true,10965809948,22,10761588627,-204221321
1637242479,-183298,true,10961424720,22,10742236157,-219188563
1637242552,-183299,true,10960328688,22,10727208300,-233120388
1637242575,-183305,true,10953754791,22,10720774227,-232980564
1637242674,-183308,true,10950469322,22,10703635560,-246833762
1637242681,-183311,true,10947184838,22,10702565304,-244619534
1637243072,-183311,true,10947184838,22,10701495154,-245689684
1637243234,-183316,true,10941712887,22,10718630394,-223082493
1637243271,-183319,true,10938431030,22,10718630394,-219800636
1637243273,-183322,true,10935150157,22,10718630394,-216519763
1637243501,-183319,true,10938431030,22,10761588627,-176842403
1637243742,-183323,true,10934056751,22,10775587089,-158469662
1637243802,-183325,true,10931870268,22,10776664648,-155205620
1637243947,-183328,true,10928591363,22,10778820089,-149771274
1637244132,-183327,true,10929684222,22,10780975960,-148708262
1637244436,-183332,true,10924221019,22,10769123999,-155097020
1637245013,-183335,true,10920944408,22,10754058527,-166885881
1637245059,-183339,true,10916577122,22,10752983229,-163593893
1637245129,-183339,true,10916577122,22,10751908038,-164669084
1637245184,-183345,true,10910029467,22,10749757979,-160271488
1637245988,-183349,true,10905666546,22,10743310381,-162356165
1637246055,-183352,true,10902395501,22,10741162041,-161233460
1637246246,-183352,true,10902395501,22,10735793071,-166602430
1637246310,-183358,true,10895856352,22,10731499827,-164356525
1637246352,-183362,true,10891499099,22,10732572977,-158926122
1637246611,-183366,true,10887143588,22,10733646234,-153497354
1637247071,-183366,true,10887143588,22,10739014131,-148129457
1637247176,-183371,true,10881701649,22,10742236157,-139465492
1637247326,-183375,true,10877350057,22,10743310381,-134039676
1637247328,-183378,true,10874087504,22,10743310381,-130777123
1637247926,-183379,true,10873000204,22,10702565304,-170434900
1637248066,-183383,true,10868652091,22,10694007103,-174644988
1637248332,-183388,true,10863219395,22,10683318975,-179900420
1637248357,-183391,true,10859961081,22,10684387307,-175573774
1637248529,-183392,true,10858875193,22,10673708794,-185166399
1637248560,-183399,true,10851277020,22,10672641530,-178635490
1637248997,-183406,true,10843684164,22,10634291010,-209393154
1637249027,-183409,true,10840431709,22,10631101361,-209330348
1637249065,-183411,true,10838263948,22,10621538152,-216725796
1637249140,-183419,true,10829597237,22,10599257438,-230339799
1637249179,-183431,true,10816610164,22,10589722875,-226887289
1637249333,-183436,true,10811203481,22,10542178554,-269024927
1637249366,-183438,true,10809041564,22,10533748605,-275292959
1637249553,-183445,true,10801478261,22,10503246509,-298231752
1637249594,-183456,true,10789603761,22,10496946766,-292656995
1637249606,-183460,true,10785288998,22,10494847691,-290441307
1637249736,-183461,true,10784210577,22,10484358613,-299851964
1637249853,-183464,true,10780975960,22,10484358613,-296617347
1637250132,-183472,true,10772355060,22,10528483310,-243871750
1637250192,-183475,true,10769123999,22,10543232772,-225891227
1637250244,-183476,true,10768047195,22,10547450698,-220596497
1637250330,-183480,true,10763741052,22,10553780750,-209960302
1637250368,-183490,true,10752983229,22,10555891612,-197091617
1637250482,-183492,true,10750832955,22,10569622508,-181210447
1637250639,-183491,true,10751908038,22,10580196888,-171711150
1637250916,-183495,true,10747608350,22,10560114602,-187493748
1637251198,-183505,true,10736866650,22,10548505443,-188361207
1637251483,-183509,true,10732572977,22,10532695335,-199877642
1637251493,-183508,true,10733646234,22,10532695335,-200950899
1637251553,-183513,true,10728281021,22,10529536159,-198744862
1637251671,-183524,true,10716486989,22,10525325397,-191161592
1637251728,-183527,true,10713272686,22,10523220648,-190052038
1637251812,-183527,true,10713272686,22,10520064313,-193208373
1637251828,-183532,true,10707917657,22,10520064313,-187853344
1637251886,-183542,true,10697215626,22,10523220648,-173994978
1637252027,-183542,true,10697215626,22,10544287095,-152928531
1637252541,-183539,true,10700425111,22,10628975459,-71449652
1637252586,-183545,true,10694007103,22,10635354439,-58652664
1637252692,-183556,true,10682250750,22,10644930088,-37320662
1637252810,-183555,true,10683318975,22,10647059180,-36259795
1637252867,-183554,true,10684387307,22,10641737247,-42650060
1637252889,-183560,true,10677978918,22,10639609219,-38369699
1637252966,-183571,true,10666240185,22,10624724932,-41515253
1637252989,-183572,true,10665173668,22,10620476104,-44697564
1637253009,-183573,true,10664107257,22,10616228975,-47878282
1637253026,-183577,true,10659842681,22,10614106048,-45736633
1637253414,-183583,true,10653449013,22,10601377396,-52071617
1637253626,-183583,true,10653449013,22,10607739813,-45709200
1637254020,-183583,true,10653449013,22,10636417975,-17031038
1637254049,-183587,true,10649188698,22,10635354439,-13834259
1637254110,-183592,true,10643865701,22,10631101361,-12764340
1637254220,-183593,true,10642801421,22,10621538152,-21263269
1637254298,-183595,true,10640673180,22,10615167459,-25505721
1637254306,-183599,true,10636417975,22,10614106048,-22311927
1637254307,-183605,true,10630038357,22,10614106048,-15932309
1637254346,-183607,true,10627912668,22,10608800587,-19112081
1637254509,-183608,true,10626849983,22,10596078297,-30771686
1637254513,-183608,true,10626849983,22,10596078297,-30771686
1637254674,-183611,true,10623662566,22,10585488044,-38174522
1637254866,-183612,true,10622600305,22,10572793712,-49806593
1637254984,-183613,true,10621538152,22,10558002896,-63535256
1637255071,-183613,true,10621538152,22,10545341524,-76196628
1637255299,-183619,true,10615167459,22,10517960615,-97206844
1637255449,-183622,true,10611983545,22,10491699867,-120283678
1637255530,-183626,true,10607739813,22,10469691514,-138048299
1637255604,-183628,true,10605618583,22,10449818979,-155799604
1637255784,-183636,true,10597137905,22,10394584201,-202553704
1637255810,-183641,true,10591840925,22,10388349633,-203491292
1637255857,-183647,true,10585488044,22,10377966995,-207521049
1637255898,-183649,true,10583371264,22,10368631493,-214739771
1637256151,-183656,true,10575965867,22,10344812234,-231153633
1637256274,-183659,true,10572793712,22,10351020673,-221773039
1637256367,-183663,true,10568565651,22,10360340319,-208225332
1637256635,-183664,true,10567508900,22,10402902780,-164606120
1637256642,-183669,true,10562226731,22,10402902780,-159323951
1637256710,-183671,true,10560114602,22,10414351696,-145762906
1637256764,-183676,true,10554836128,22,10426855794,-127980334
1637256938,-183673,true,10558002896,22,10475974900,-82027996
1637256994,-183677,true,10553780750,22,10489601841,-64178909
1637257170,-183678,true,10552725478,22,10517960615,-34764863
1637257304,-183681,true,10549560293,22,10547450698,-2109595
1637257355,-183678,true,10552725478,22,10556947201,4221723
1637258027,-183682,true,10548505443,22,10610922453,62417010
1637258097,-183684,true,10546396058,22,10607739813,61343755
1637258268,-183687,true,10543232772,22,10593959399,50726627
1637258299,-183684,true,10546396058,22,10592900109,46504051
1637258583,-183689,true,10541124441,22,10585488044,44363603
1637258598,-183691,true,10539016533,22,10585488044,46471511
1637258642,-183693,true,10536909046,22,10582313033,45403987
1637258715,-183690,true,10540070434,22,10575965867,35895433
1637258765,-183695,true,10534801980,22,10571736538,36934558
1637258888,-183696,true,10533748605,22,10570679470,36930865
1637258894,-183698,true,10531642171,22,10569622508,37980337
1637259095,-183694,true,10535855460,22,10567508900,31653440
1637259190,-183697,true,10532695335,22,10564339281,31643946
1637259320,-183699,true,10530589112,22,10559058696,28469584
1637259323,-183699,true,10530589112,22,10559058696,28469584
1637259396,-183695,true,10534801980,22,10558002896,23200916
1637259426,-183693,true,10536909046,22,10560114602,23205556
1637259509,-183686,true,10544287095,22,10586546593,42259498
1637259856,-183685,true,10545341524,22,10664107257,118765733
1637260008,-183680,true,10550615249,22,10706846972,156231723
1637260026,-183678,true,10552725478,22,10712201466,159475988
1637260440,-183671,true,10560114602,22,10813365829,253251227
1637260486,-183670,true,10561170613,22,10817691825,256521212
1637261061,-183668,true,10563282953,22,10809041564,245758611
1637261145,-183669,true,10562226731,22,10802558409,240331678
1637261274,-183663,true,10568565651,22,10793920249,225354598
1637261438,-183662,true,10569622508,22,10772355060,202732552
1637261563,-183661,true,10570679470,22,10761588627,190909157
1637261708,-183659,true,10572793712,22,10764817426,192023714
1637261813,-183653,true,10579138974,22,10766970498,187831524
1637262044,-183654,true,10578081166,22,10756209446,178128280
1637262072,-183653,true,10579138974,22,10752983229,173844255
1637262191,-183650,true,10582313033,22,10749757979,167444946
1637262385,-183645,true,10587605248,22,10757285067,169679819
1637262522,-183645,true,10587605248,22,10756209446,168604198
1637262582,-183643,true,10589722875,22,10755133933,165411058
1637262772,-183640,true,10592900109,22,10756209446,163309337
1637263141,-183633,true,10600317364,22,10776664648,176347284
1637263157,-183633,true,10600317364,22,10775587089,175269725
1637263308,-183631,true,10602437534,22,10789603761,187166227
1637263480,-183628,true,10605618583,22,10801478261,195859678
1637263509,-183624,true,10609861467,22,10802558409,192696942
1637263522,-183626,true,10607739813,22,10803638664,195898851
1637263603,-183623,true,10610922453,22,10811203481,200281028
1637263659,-183619,true,10615167459,22,10816610164,201442705
1637263700,-183614,true,10620476104,22,10822019550,201543446
1637264173,-183613,true,10621538152,22,10889321126,267782974
1637264209,-183609,true,10625787404,22,10892588249,266800845
1637264336,-183604,true,10631101361,22,10907847789,276746428
1637264414,-183597,true,10638545365,22,10917668779,279123414
1637264940,-183596,true,10639609219,22,10904576089,264966870
1637265573,-183592,true,10643865701,22,10891499099,247633398
1637265618,-183592,true,10643865701,22,10891499099,247633398
1637266649,-183587,true,10649188698,22,10818773594,169584896
1637267204,-183587,true,10649188698,22,10814447166,165258468
1637268431,-183586,true,10650253617,22,10714344014,64090397
1637268560,-183586,true,10650253617,22,10713272686,63019069
1637268675,-183582,true,10654514358,22,10712201466,57687108
1637270202,-183580,true,10656645367,22,10760512576,103867209
1637270302,-183578,true,10658776803,22,10759436632,100659829
1637270327,-183578,true,10658776803,22,10758360796,99583993
1637270464,-183573,true,10664107257,22,10748683111,84575854
1637270598,-183573,true,10664107257,22,10739014131,74906874
1637270701,-183572,true,10665173668,22,10729353849,64180181
1637270937,-183573,true,10664107257,22,10710059347,45952090
1637271756,-183569,true,10668373540,22,10658776803,-9596737
1637272095,-183569,true,10668373540,22,10654514358,-13859182
1637272228,-183567,true,10670507321,22,10656645367,-13861954
1637272993,-183566,true,10671574372,22,10667306809,-4267563
1637273156,-183561,true,10676911227,22,10633227687,-43683540
1637273604,-183561,true,10676911227,22,10539016533,-137894694
1637273905,-183560,true,10677978918,22,10499046260,-178932658
1637274254,-183558,true,10680114620,22,10523220648,-156893972
1637274461,-183552,true,10686524291,22,10536909046,-149615245
1637274472,-183551,true,10687592944,22,10536909046,-150683898
1637274749,-183549,true,10689730569,22,10530589112,-159141457
1637275102,-183550,true,10688661703,22,10519012411,-169649292
1637275159,-183546,true,10692937809,22,10513754483,-179183326
1637275350,-183547,true,10691868622,22,10495897176,-195971446
1637275362,-183547,true,10691868622,22,10494847691,-197020931
1637275436,-183551,true,10687592944,22,10489601841,-197991103
1637275905,-183543,true,10696146011,22,10509550032,-186595979
1637276151,-183543,true,10696146011,22,10525325397,-170820614
1637276215,-183547,true,10691868622,22,10530589112,-161279510
1637276412,-183552,true,10686524291,22,10529536159,-156988132
1637276836,-183547,true,10691868622,22,10491699867,-200168755
1637276852,-183549,true,10689730569,22,10490650801,-199079768
1637277012,-183552,true,10686524291,22,10487504236,-199020055
1637277090,-183557,true,10681182632,22,10486455590,-194727042
1637277167,-183551,true,10687592944,22,10488552986,-199039958
1637277461,-183552,true,10686524291,22,10506397798,-180126493
1637277484,-183555,true,10683318975,22,10507448437,-175870538
1637277991,-183559,true,10679046716,22,10537962736,-141083980
1637278011,-183553,true,10685455746,22,10536909046,-148546700
1637278127,-183553,true,10685455746,22,10543232772,-142222974
1637278164,-183556,true,10682250750,22,10544287095,-137963655
1637278292,-183558,true,10680114620,22,10548505443,-131609177
1637278362,-183552,true,10686524291,22,10550615249,-135909042
1637278632,-183553,true,10685455746,22,10552725478,-132730268
1637278746,-183557,true,10681182632,22,10545341524,-135841108
1637278979,-183560,true,10677978918,22,10530589112,-147389806
1637279014,-183554,true,10684387307,22,10526377930,-158009377
1637279144,-183555,true,10683318975,22,10525325397,-157993578
1637279422,-183559,true,10679046716,22,10500096165,-178950551
1637279956,-183561,true,10676911227,22,10516908925,-160002302
1637279967,-183562,true,10675843642,22,10516908925,-158934717
1637280122,-183565,true,10672641530,22,10529536159,-143105371
1637280488,-183569,true,10668373540,22,10560114602,-108258938
1637280774,-183570,true,10667306809,22,10573850991,-93455818
1637280967,-183572,true,10665173668,22,10566452255,-98721413
1637281266,-183577,true,10659842681,22,10545341524,-114501157
1637281455,-183581,true,10655579809,22,10532695335,-122884474
1637281511,-183583,true,10653449013,22,10529536159,-123912854
1637281786,-183584,true,10652383775,22,10510600987,-141782788
1637281846,-183588,true,10648123886,22,10509550032,-138573854
1637282065,-183591,true,10644930088,22,10506397798,-138532290
1637282123,-183594,true,10641737247,22,10505347263,-136389984
1637282179,-183595,true,10640673180,22,10504296833,-136376347
1637282255,-183599,true,10636417975,22,10503246509,-133171466
1637282289,-183602,true,10633227687,22,10505347263,-127880424
1637282548,-183603,true,10632164471,22,10519012411,-113152060
1637282577,-183603,true,10632164471,22,10521116319,-111048152
1637282648,-183608,true,10626849983,22,10525325397,-101524586
1637282724,-183611,true,10623662566,22,10529536159,-94126407
1637282752,-183612,true,10622600305,22,10531642171,-90958134
1637283101,-183613,true,10621538152,22,10552725478,-68812674
1637283259,-183618,true,10616228975,22,10553780750,-62448225
1637283358,-183621,true,10613044744,22,10554836128,-58208616
1637283405,-183623,true,10610922453,22,10554836128,-56086325
1637283423,-183624,true,10609861467,22,10556947201,-52914266
1637283444,-183628,true,10605618583,22,10558002896,-47615687
1637283543,-183629,true,10604558127,22,10572793712,-31764415
1637283647,-183630,true,10603497777,22,10588664008,-14833769
1637283675,-183633,true,10600317364,22,10591840925,-8476439
1637283790,-183637,true,10596078297,22,10614106048,18027751
1637283913,-183637,true,10596078297,22,10644930088,48851791
1637284459,-183636,true,10597137905,22,10791761789,194623884
1637284748,-183638,true,10595018795,22,10816610164,221591369
1637284785,-183641,true,10591840925,22,10816610164,224769239
1637284957,-183641,true,10591840925,22,10806880080,215039155
1637285109,-183640,true,10592900109,22,10797158749,204258640
1637285227,-183641,true,10591840925,22,10789603761,197762836
1637285576,-183644,true,10588664008,22,10768047195,179383187
1637285603,-183641,true,10591840925,22,10763741052,171900127
1637285686,-183641,true,10591840925,22,10754058527,162217602
1637286107,-183642,true,10590781847,22,10717558638,126776791
1637286167,-183646,true,10586546593,22,10713272686,126726093
1637286236,-183644,true,10588664008,22,10708988448,120324440
1637286421,-183644,true,10588664008,22,10696146011,107482003
1637286824,-183646,true,10586546593,22,10668373540,81826947
1637288053,-183649,true,10583371264,22,10637481616,54110352
1637288252,-183647,true,10585488044,22,10611983545,26495501
1637288794,-183647,true,10585488044,22,10543232772,-42255272
1637289044,-183650,true,10582313033,22,10527430567,-54882466
1637289348,-183654,true,10578081166,22,10530589112,-47492054
1637289607,-183652,true,10580196888,22,10533748605,-46448283
1637290071,-183653,true,10579138974,22,10529536159,-49602815
1637290533,-183655,true,10577023463,22,10524272970,-52750493
1637290700,-183657,true,10574908376,22,10523220648,-51687728
1637291028,-183654,true,10578081166,22,10520064313,-58016853
1637291185,-183653,true,10579138974,22,10519012411,-60126563
1637291215,-183655,true,10577023463,22,10516908925,-60114538
1637291310,-183659,true,10572793712,22,10512703212,-60090500
1637291338,-183656,true,10575965867,22,10510600987,-65364880
1637291468,-183653,true,10579138974,22,10511652047,-67486927
1637291833,-183654,true,10578081166,22,10513754483,-64326683
1637291931,-183657,true,10574908376,22,10514805858,-60102518
1637292538,-183654,true,10578081166,22,10519012411,-59068755
1637292978,-183650,true,10582313033,22,10544287095,-38025938
1637293030,-183653,true,10579138974,22,10549560293,-29578681
1637293527,-183656,true,10575965867,22,10592900109,16934242
1637293556,-183652,true,10580196888,22,10590781847,10584959
1637293652,-183647,true,10585488044,22,10585488044,0
1637293905,-183650,true,10582313033,22,10572793712,-9519321
1637294157,-183654,true,10578081166,22,10551670311,-26410855
1637294272,-183650,true,10582313033,22,10541124441,-41188592
1637294318,-183645,true,10587605248,22,10536909046,-50696202
1637294346,-183649,true,10583371264,22,10534801980,-48569284
1637294360,-183654,true,10578081166,22,10532695335,-45385831
1637294764,-183650,true,10582313033,22,10524272970,-58040063
1637294947,-183645,true,10587605248,22,10536909046,-50696202
1637294986,-183649,true,10583371264,22,10539016533,-44354731
1637295282,-183654,true,10578081166,22,10560114602,-17966564
1637295357,-183649,true,10583371264,22,10564339281,-19031983
1637295368,-183644,true,10588664008,22,10565395715,-23268293
1637295526,-183648,true,10584429601,22,10584429601,0
1637295573,-183651,true,10581254907,22,10589722875,8467968
1637295653,-183646,true,10586546593,22,10592900109,6353516
1637295660,-183640,true,10592900109,22,10593959399,1059290
1637295809,-183644,true,10588664008,22,10597137905,8473897
1637296102,-183647,true,10585488044,22,10609861467,24373423
1637296134,-183641,true,10591840925,22,10609861467,18020542
1637296180,-183636,true,10597137905,22,10611983545,14845640
1637296341,-183639,true,10593959399,22,10617290598,23331199
1637296440,-183642,true,10590781847,22,10617290598,26508751
1637296515,-183637,true,10596078297,22,10619414163,23335866
1637296940,-183634,true,10599257438,22,10617290598,18033160
1637297066,-183638,true,10595018795,22,10616228975,21210180
1637297093,-183640,true,10592900109,22,10616228975,23328866
1637297503,-183633,true,10600317364,22,10633227687,32910323
1637297549,-183629,true,10604558127,22,10636417975,31859848
1637298120,-183631,true,10602437534,22,10658776803,56339269
1637298181,-183633,true,10600317364,22,10657711032,57393668
1637298212,-183627,true,10606679145,22,10657711032,51031887
1637298652,-183622,true,10611983545,22,10653449013,41465468
1637298684,-183625,true,10608800587,22,10652383775,43583188
1637298761,-183627,true,10606679145,22,10645994581,39315436
1637298988,-183622,true,10611983545,22,10624724932,12741387
1637299306,-183622,true,10611983545,22,10574908376,-37075169
1637299421,-183625,true,10608800587,22,10556947201,-51853386
1637299574,-183628,true,10605618583,22,10533748605,-71869978
1637299594,-183624,true,10609861467,22,10531642171,-78219296
1637299678,-183624,true,10609861467,22,10525325397,-84536070
1637299790,-183627,true,10606679145,22,10517960615,-88718530
1637300292,-183630,true,10603497777,22,10512703212,-90794565
1637300644,-183625,true,10608800587,22,10520064313,-88736274
1637301166,-183626,true,10607739813,22,10509550032,-98189781
1637301273,-183629,true,10604558127,22,10511652047,-92906080
1637301278,-183633,true,10600317364,22,10511652047,-88665317
1637301391,-183631,true,10602437534,22,10520064313,-82373221
1637301551,-183630,true,10603497777,22,10531642171,-71855606
1637301586,-183633,true,10600317364,22,10535855460,-64461904
1637301731,-183637,true,10596078297,22,10552725478,-43352819
1637302994,-183637,true,10596078297,22,10574908376,-21169921
1637303036,-183639,true,10593959399,22,10574908376,-19051023
1637303304,-183643,true,10589722875,22,10566452255,-23270620
1637303391,-183648,true,10584429601,22,10563282953,-21146648
1637303642,-183649,true,10583371264,22,10554836128,-28535136
1637303748,-183650,true,10582313033,22,10550615249,-31697784
1637304361,-183651,true,10581254907,22,10590781847,9526940
1637304470,-183655,true,10577023463,22,10598197619,21174156
1637305295,-183655,true,10577023463,22,10613044744,36021281
1637305848,-183655,true,10577023463,22,10615167459,38143996
1637305874,-183655,true,10577023463,22,10616228975,39205512
1637306048,-183658,true,10573850991,22,10623662566,49811575
1637306278,-183658,true,10573850991,22,10630038357,56187366
1637306400,-183657,true,10574908376,22,10633227687,58319311
1637306494,-183656,true,10575965867,22,10630038357,54072490
1637306710,-183659,true,10572793712,22,10623662566,50868854
1637307432,-183659,true,10572793712,22,10588664008,15870296
1637308458,-183658,true,10573850991,22,10590781847,16930856
1637310082,-183656,true,10575965867,22,10586546593,10580726
1637310349,-183657,true,10574908376,22,10581254907,6346531
1637310503,-183657,true,10574908376,22,10595018795,20110419
1637310851,-183655,true,10577023463,22,10624724932,47701469
1637311183,-183652,true,10580196888,22,10630038357,49841469
1637311213,-183652,true,10580196888,22,10633227687,53030799
1637311443,-183652,true,10580196888,22,10631101361,50904473
1637311480,-183651,true,10581254907,22,10632164471,50909564
1637311654,-183646,true,10586546593,22,10633227687,46681094
1637311741,-183645,true,10587605248,22,10638545365,50940117
1637312595,-183643,true,10589722875,22,10714344014,124621139
1637312707,-183642,true,10590781847,22,10716486989,125705142
1637313142,-183637,true,10596078297,22,10720774227,124695930
1637314452,-183637,true,10596078297,22,10715415448,119337151
1637314596,-183635,true,10598197619,22,10708988448,110790829
1637314609,-183634,true,10599257438,22,10707917657,108660219
1637315185,-183631,true,10602437534,22,10679046716,76609182
1637315351,-183632,true,10601377396,22,10673708794,72331398
1637315474,-183631,true,10602437534,22,10677978918,75541384
1637315844,-183630,true,10603497777,22,10673708794,70211017
1637316313,-183627,true,10606679145,22,10661974756,55295611
1637316604,-183627,true,10606679145,22,10654514358,47835213
1637316628,-183625,true,10608800587,22,10654514358,45713771
1637317223,-183626,true,10607739813,22,10617290598,9550785
1637317397,-183623,true,10610922453,22,10607739813,-3182640
1637317942,-183623,true,10610922453,22,10607739813,-3182640
1637317955,-183622,true,10611983545,22,10607739813,-4243732
1637318385,-183623,true,10610922453,22,10604558127,-6364326
1637319296,-183620,true,10614106048,22,10597137905,-16968143
1637320011,-183621,true,10613044744,22,10632164471,19119727
1637320071,-183621,true,10613044744,22,10635354439,22309695
1637320243,-183622,true,10611983545,22,10640673180,28689635
1637320806,-183619,true,10615167459,22,10636417975,21250516
1637320883,-183620,true,10614106048,22,10635354439,21248391
1637321136,-183620,true,10614106048,22,10631101361,16995313
1637321182,-183621,true,10613044744,22,10630038357,16993613
1637321478,-183617,true,10617290598,22,10630038357,12747759
1637321633,-183619,true,10615167459,22,10630038357,14870898
1637321683,-183619,true,10615167459,22,10627912668,12745209
1637321757,-183620,true,10614106048,22,10628975459,14869411
1637321948,-183617,true,10617290598,22,10626849983,9559385
1637322092,-183619,true,10615167459,22,10624724932,9557473
1637322158,-183619,true,10615167459,22,10625787404,10619945
1637322828,-183619,true,10615167459,22,10640673180,25505721
1637323218,-183616,true,10618352327,22,10647059180,28706853
1637323770,-183618,true,10616228975,22,10639609219,23380244
1637324495,-183619,true,10615167459,22,10628975459,13808000
1637324543,-183620,true,10614106048,22,10627912668,13806620
1637325225,-183617,true,10617290598,22,10622600305,5309707
1637325545,-183619,true,10615167459,22,10649188698,34021239
1637325676,-183619,true,10615167459,22,10659842681,44675222
1637325766,-183620,true,10614106048,22,10674776165,60670117
1637325891,-183614,true,10620476104,22,10705776394,85300290
1637325910,-183613,true,10621538152,22,10711130353,89592201
1637325959,-183610,true,10624724932,22,10728281021,103556089
1637326014,-183605,true,10630038357,22,10751908038,121869681
1637326056,-183595,true,10640673180,22,10771277932,130604752
1637326068,-183593,true,10642801421,22,10777742314,134940893
1637326462,-183581,true,10655579809,22,11024080107,368500298
1637326847,-183574,true,10663040953,22,11219811514,556770561
1637326878,-183564,true,10673708794,22,11231036376,557327582
1637326970,-183562,true,10675843642,22,11264778386,588934744
1637327003,-183549,true,10689730569,22,11271538943,581808374
1637327391,-183537,true,10702565304,22,11340502006,637936702
1637327725,-183528,true,10712201466,22,11380261313,668059847
1637327741,-183525,true,10715415448,22,11382537479,667122031
1637327744,-183513,true,10728281021,22,11382537479,654256458
1637327837,-183506,true,10735793071,22,11372298316,636505245
1637328073,-183500,true,10742236157,22,11335966939,593730782
1637328164,-183498,true,10744384712,22,11321240493,576855781
1637328650,-183484,true,10759436632,22,11264778386,505341754
1637328654,-183478,true,10765893908,22,11264778386,498884478
1637329120,-183471,true,10773432295,22,11271538943,498106648
1637329192,-183468,true,10776664648,22,11271538943,494874295
1637329414,-183455,true,10790682721,22,11261399628,470716907
1637329570,-183449,true,10797158749,22,11242272468,445113719
1637329638,-183445,true,10801478261,22,11235529465,434051204
1637329685,-183443,true,10803638664,22,11231036376,427397712
1637331143,-183434,true,10813365829,22,11093747550,280381721
1637331749,-183428,true,10819855471,22,11124852014,304996543
1637331811,-183424,true,10824184063,22,11128189803,304005740
1637332060,-183422,true,10826349008,22,11185085688,358736680
1637332096,-183411,true,10838263948,22,11190679349,352415401
1637332924,-183401,true,10849107090,22,11296362383,447255293
1637333129,-183397,true,10853447384,22,11288458092,435010708
1637333310,-183394,true,10856703744,22,11281687387,424983643
1637333324,-183382,true,10869738956,22,11281687387,411948431
1637333430,-183373,true,10879525635,22,11280559331,401033696
1637333509,-183368,true,10884966486,22,11279431388,394464902
1637333563,-183364,true,10889321126,22,11283943837,394622711
1637333668,-183351,true,10903485740,22,11292974152,389488412
1637333800,-183341,true,10914394134,22,11311056469,396662335
1637333822,-183336,true,10919852422,22,11315581570,395729148
1637334073,-183331,true,10925313441,22,11380261313,454947872
1637334169,-183315,true,10942807059,22,11421302031,478494972
1637334328,-183302,true,10957041246,22,11485437527,528396281
1637334361,-183298,true,10961424720,22,11500377558,538952838
1637334401,-183290,true,10970196930,22,11518791969,548595039
1637334626,-183275,true,10986663749,22,11612468378,625804629
1637334692,-183259,true,11004255601,22,11647356344,643100743
1637334738,-183255,true,11008657964,22,11671840267,663182303
1637334758,-183245,true,11019671577,22,11687022767,667351190
1637334818,-183223,true,11043940327,22,11729169761,685229434
1637334935,-183202,true,11067155808,22,11818646558,751490750
1637334953,-183196,true,11073797762,22,11834020021,760222259
1637335126,-183184,true,11087093631,22,11952947923,865854292
1637335162,-183161,true,11112622016,22,11973284199,860662183
1637335210,-183141,true,11134868387,22,11997253530,862385143
1637335232,-183135,true,11141550978,22,12008055378,866504400
1637335261,-183127,true,11150467339,22,12017665186,867197847
1637335317,-183106,true,11173906752,22,12036907878,863001126
1637335452,-183087,true,11195156293,22,12063416899,868260606
1637335531,-183080,true,11202995253,22,12085149516,882154263
1637335612,-183071,true,11213081983,22,12099659675,886577692
1637335630,-183050,true,11236653018,22,12102079728,865426710
1637335729,-183029,true,11260273601,22,12099659675,839386074
1637335812,-183020,true,11270411902,22,12092402419,821990517
1637335838,-183011,true,11280559331,22,12092402419,811843088
1637335918,-182988,true,11306533177,22,12094821020,788287843
1637335974,-182965,true,11332566829,22,12093611659,761044830
1637335991,-182956,true,11342770220,22,12091193300,748423080
1637336004,-182947,true,11352982797,22,12089984301,737001504
1637336070,-182925,true,11377985602,22,12092402419,714416817
1637336091,-182903,true,11403043471,22,12094821020,691777549
1637336314,-182895,true,11412169100,22,12131158145,718989045
1637336427,-182886,true,11422444161,22,12156659069,734214908
1637336457,-182865,true,11446455296,22,12157874735,711419439
1637336478,-182843,true,11471663957,22,12156659069,684995112
1637336514,-182835,true,11480844501,22,12154228102,673383601
1637336766,-182829,true,11487734730,22,12119033656,631298926
1637337063,-182807,true,11513034301,22,12081524696,568490395
1637337170,-182786,true,11537235865,22,12075485746,538249881
1637337254,-182779,true,11545314354,22,12069449814,524135460
1637337362,-182771,true,11554553838,22,12059798598,505244760
1637337404,-182749,true,11580000566,22,12063416899,483416333
1637337553,-182728,true,11604342900,22,12076693294,472350394
1637337572,-182720,true,11613629624,22,12079108754,465479130
1637337663,-182712,true,11622923781,22,12099659675,476735894
1637337726,-182689,true,11649685932,22,12110553725,460867793
1637337888,-182666,true,11676509704,22,12127519525,451009821
1637337953,-182663,true,11680013007,22,12123881997,443868990
1637338164,-182659,true,11684685713,22,12110553725,425868012
1637338185,-182640,true,11706906608,22,12109342791,402436183
1637338580,-182622,true,11727996961,22,12065829703,337832742
1637338733,-182622,true,11727996961,22,12024877588,296880627
1637338923,-182620,true,11730342678,22,11998453256,268110578
1637339060,-182610,true,11742078301,22,11973284199,231205898
1637339094,-182595,true,11759703753,22,11967299352,207595599
1637339201,-182597,true,11757352165,22,11944584206,187232041
1637339239,-182597,true,11757352165,22,11932646188,175294023
1637339263,-182589,true,11766761339,22,11925489106,158727767
1637339317,-182579,true,11778533397,22,11908805936,130272539
1637339435,-182582,true,11775000543,22,11873134835,98134292
1637339503,-182583,true,11773823161,22,11852968660,79145499
1637339647,-182574,true,11784423841,22,11821010406,36586565
1637339809,-182562,true,11798572930,22,11792675413,-5897517
1637340364,-182562,true,11798572930,22,11775000543,-23572387
1637340388,-182562,true,11798572930,22,11776178043,-22394887
1637340630,-182554,true,11808015093,22,11785602284,-22412809
1637340661,-182542,true,11822192507,22,11786780844,-35411663
1637340708,-182542,true,11822192507,22,11786780844,-35411663
1637340864,-182541,true,11823374726,22,11793854681,-29520045
1637340971,-182532,true,11834020021,22,11797393191,-36626830
1637341076,-182519,true,11849413481,22,11802112856,-47300625
1637341171,-182517,true,11851783482,22,11811557852,-40225630
1637341415,-182515,true,11854153957,22,11834020021,-20133936
1637341519,-182502,true,11869573607,22,11841122208,-28451399
1637341633,-182491,true,11882636668,22,11829287596,-53349072
1637341835,-182490,true,11883824932,22,11810376814,-73448118
1637342121,-182491,true,11882636668,22,11773823161,-108813507
1637342388,-182481,true,11894524654,22,11733862133,-160662521
1637342417,-182473,true,11904043604,22,11726824279,-177219325
1637342421,-182472,true,11905234009,22,11725651714,-179582295
1637342622,-182475,true,11901663153,22,11706906608,-194756545
1637342737,-182467,true,11911187816,22,11696375658,-214812158
1637343126,-182460,true,11919528150,22,11619437601,-300090549
1637343255,-182460,true,11919528150,22,11598542469,-320985681
1637343300,-182464,true,11914761530,22,11589267809,-325493721
1637343444,-182458,true,11921912174,22,11570740733,-351171441
1637343663,-182453,true,11927874323,22,11558020551,-369853772
1637343708,-182454,true,11926681655,22,11560332271,-366349384
1637344041,-182461,true,11918336316,22,11538389589,-379946727
1637344464,-182457,true,11923104366,22,11507279510,-415824856
1637344594,-182456,true,11924296676,22,11492330513,-431966163
1637344730,-182457,true,11923104366,22,11488883503,-434220863
1637345054,-182468,true,11909996817,22,11471663957,-438332860
1637345210,-182467,true,11911187816,22,11464783367,-446404449
1637345253,-182468,true,11909996817,22,11462490754,-447506063
1637345270,-182471,true,11906424532,22,11462490754,-443933778
1637345571,-182483,true,11892146105,22,11454470219,-437675886
1637346089,-182488,true,11886201816,22,11471663957,-414537859
1637346405,-182493,true,11880260497,22,11480844501,-399415996
1637346569,-182498,true,11874322149,22,11480844501,-393477648
1637346968,-182511,true,11858896330,22,11478548676,-380347654
1637347065,-182516,true,11852968660,22,11477400936,-375567724
1637347739,-182522,true,11845859368,22,11447599942,-398259426
1637347848,-182526,true,11841122208,22,11441877858,-399244350
1637348183,-182536,true,11829287596,22,11431585315,-397702281
1637348257,-182540,true,11824557064,22,11429299341,-395257723
1637348553,-182543,true,11821010406,22,11421302031,-399708375
1637348705,-182548,true,11815101673,22,11428156526,-386945147
1637349022,-182557,true,11804473397,22,11445310765,-359162632
1637349157,-182561,true,11799752788,22,11453324887,-346427901
1637349248,-182567,true,11792675413,22,11460198600,-332476813
1637349310,-182572,true,11786780844,22,11464783367,-321997477
1637349477,-182582,true,11775000543,22,11475105800,-299894743
1637349672,-182588,true,11767938015,22,11476253311,-291684704
1637349892,-182595,true,11759703753,22,11472811123,-286892630
1637350012,-182601,true,11752650399,22,11468223146,-284427253
1637350090,-182612,true,11739730237,22,11464783367,-274946870
1637350441,-182617,true,11733862133,22,11445310765,-288551368
1637350475,-182624,true,11725651714,22,11443022046,-282629668
1637350548,-182629,true,11719790646,22,11437302251,-282488395
1637350869,-182640,true,11706906608,22,11423586406,-283320202
1637351063,-182645,true,11701054910,22,11420160015,-280894895
1637351333,-182652,true,11692867447,22,11414451648,-278415799
1637351592,-182657,true,11687022767,22,11413310317,-273712450
1637351765,-182664,true,11678845123,22,11412169100,-266676023
1637351773,-182670,true,11671840267,22,11412169100,-259671167
1637351994,-182677,true,11663673246,22,11411027997,-252645249
1637352509,-182682,true,11657843159,22,11409887008,-247956151
1637353403,-182692,true,11646191725,22,11339368069,-306823656
1637353479,-182697,true,11640370376,22,11337100536,-303269840
1637353502,-182705,true,11631062268,22,11337100536,-293961732
1637353807,-182711,true,11624086073,22,11331433686,-292652387
1637353974,-182723,true,11610146232,22,11339368069,-270778163
1637354010,-182729,true,11603182582,22,11340502006,-262680576
1637354234,-182737,true,11593904212,22,11350712541,-243191671
1637354276,-182742,true,11588108998,22,11356389033,-231719965
1637354732,-182749,true,11580000566,22,11422444161,-157556405
1637354830,-182754,true,11574212302,22,11429299341,-144912961
1637354888,-182760,true,11567270205,22,11431585315,-135684890
1637354936,-182764,true,11562644453,22,11432728474,-129915979
1637355443,-182771,true,11554553838,22,11419018113,-135535725
1637355537,-182776,true,11548778294,22,11413310317,-135467977
1637356084,-182780,true,11544159938,22,11406464726,-137695212
1637356579,-182783,true,11540697382,22,11411027997,-129669385
1637356958,-182788,true,11534928764,22,11411027997,-123900767
1637357133,-182793,true,11529163030,22,11380261313,-148901717
1637358020,-182798,true,11523400177,22,11260273601,-263126576
1637358069,-182801,true,11519943848,22,11261399628,-258544220
1637358346,-182807,true,11513034301,22,11287329359,-225704942
1637358554,-182811,true,11508430238,22,11306533177,-201897061
1637358651,-182815,true,11503828016,22,11314450125,-189377891
1637358736,-182818,true,11500377558,22,11318976584,-181400974
1637358967,-182825,true,11492330513,22,11334833456,-157497057
1637359296,-182829,true,11487734730,22,11323504854,-164229876
1637359747,-182834,true,11481992585,22,11306533177,-175459408
1637360376,-182837,true,11478548676,22,11295232860,-183315816
1637360552,-182845,true,11469369968,22,11294103450,-175266518
1637360580,-182850,true,11463637003,22,11292974152,-170662851
1637360588,-182855,true,11457906904,22,11292974152,-164932752
1637360834,-182859,true,11453324887,22,11288458092,-164866795
1637361108,-182867,true,11444166348,22,11283943837,-160222511
1637362179,-182872,true,11438445982,22,11285072231,-153373751
1637362236,-182876,true,11433871747,22,11283943837,-149927910
1637362611,-182879,true,11430442271,22,11281687387,-148754884
1637362918,-182885,true,11423586406,22,11279431388,-144155018
1637362975,-182890,true,11417876325,22,11279431388,-138444937
1637363086,-182894,true,11413310317,22,11276048235,-137262082
1637363426,-182897,true,11409887008,22,11270411902,-139475106
1637363479,-182902,true,11404183776,22,11269284973,-134898803
1637363799,-182903,true,11403043471,22,11305402637,-97640834
1637364252,-182904,true,11401903281,22,11362068363,-39834918
1637364479,-182906,true,11399623242,22,11375710347,-23912895
1637364606,-182910,true,11395064533,22,11373435546,-21628987
1637364797,-182911,true,11393925140,22,11366613872,-27311268
1637364832,-182912,true,11392785862,22,11365477324,-27308538
1637364860,-182914,true,11390507646,22,11364340890,-26166756
1637365006,-182917,true,11387091177,22,11358660424,-28430753
1637365105,-182918,true,11385952582,22,11352982797,-32969785
1637365398,-182919,true,11384814101,22,11342770220,-42043881
1637365612,-182920,true,11383675733,22,11341636056,-42039677
1637365867,-182923,true,11380261313,22,11343904497,-36356816
1637366538,-182922,true,11381399339,22,11368887309,-12512030
1637367278,-182922,true,11381399339,22,11373435546,-7963793
1637367331,-182923,true,11380261313,22,11372298316,-7962997
1637367467,-182926,true,11376847918,22,11376847918,0
1637367532,-182925,true,11377985602,22,11383675733,5690131
1637367738,-182924,true,11379123401,22,11403043471,23920070
1637367981,-182924,true,11379123401,22,11422444161,43320760
1637368339,-182927,true,11375710347,22,11445310765,69600418
1637368569,-182927,true,11375710347,22,11441877858,66167511
1637368813,-182925,true,11377985602,22,11438445982,60460380
1637368881,-182925,true,11377985602,22,11437302251,59316649
1637368942,-182927,true,11375710347,22,11437302251,61591904
1637369143,-182926,true,11376847918,22,11437302251,60454333
1637369224,-182924,true,11379123401,22,11438445982,59322581
1637369234,-182924,true,11379123401,22,11439589826,60466425
1637370095,-182927,true,11375710347,22,11433871747,58161400
1637370122,-182927,true,11375710347,22,11433871747,58161400
1637370389,-182925,true,11377985602,22,11451034565,73048963
1637370631,-182925,true,11377985602,22,11467076438,89090836
1637371065,-182927,true,11375710347,22,11491181395,115471048
1637371127,-182927,true,11375710347,22,11491181395,115471048
1637371249,-182924,true,11379123401,22,11488883503,109760102
1637371385,-182924,true,11379123401,22,11486586071,107462670
1637371789,-182927,true,11375710347,22,11457906904,82196557
1637372154,-182927,true,11375710347,22,11427013824,51303477
1637372195,-182924,true,11379123401,22,11422444161,43320760
1637372342,-182925,true,11377985602,22,11407605373,29619771
1637372398,-182928,true,11374572889,22,11403043471,28470582
1637372459,-182929,true,11373435546,22,11397343660,23908114
1637372497,-182927,true,11375710347,22,11395064533,19354186
1637372512,-182928,true,11374572889,22,11392785862,18212973
1637373314,-182932,true,11370024197,22,11331433686,-38590511
1637373447,-182932,true,11370024197,22,11328034935,-41989262
1637373696,-182930,true,11372298316,22,11328034935,-44263381
1637374097,-182932,true,11370024197,22,11296362383,-73661814
1637374348,-182935,true,11366613872,22,11274920743,-91693129
1637374604,-182937,true,11364340890,22,11242272468,-122068422
1637374679,-182935,true,11366613872,22,11238900461,-127713411
1637374796,-182936,true,11365477324,22,11233282696,-132194628
1637374824,-182940,true,11360932270,22,11232159480,-128772790
1637374922,-182942,true,11358660424,22,11228790506,-129869918
1637374945,-182940,true,11360932270,22,11227667739,-133264531
1637375165,-182944,true,11356389033,22,11208597871,-147791162
1637375325,-182950,true,11349577584,22,11199635027,-149942557
1637375561,-182952,true,11347308008,22,11191798417,-155509591
1637375618,-182951,true,11348442739,22,11194036889,-154405850
1637375796,-182953,true,11346173391,22,11197395436,-148777955
1637375886,-182958,true,11340502006,22,11200754990,-139747016
1637375922,-182959,true,11339368069,22,11202995253,-136372816
1637376389,-182958,true,11340502006,22,11227667739,-112834267
1637376765,-182961,true,11337100536,22,11222055589,-115044947
1637376819,-182965,true,11332566829,22,11220933496,-111633333
1637377246,-182966,true,11331433686,22,11219811514,-111622172
1637377482,-182962,true,11335966939,22,11226545085,-109421854
1637377983,-182963,true,11334833456,22,11240024351,-94809105
1637378309,-182968,true,11329167739,22,11224300112,-104867627
1637379099,-182969,true,11328034935,22,11194036889,-133998046
1637379886,-182967,true,11330300655,22,11194036889,-136263766
1637380453,-182969,true,11328034935,22,11192917597,-135117338
1637380515,-182973,true,11323504854,22,11192917597,-130587257
1637380632,-182974,true,11322372617,22,11194036889,-128335728
1637381415,-182972,true,11324637204,22,11181730833,-142906371
1637381483,-182974,true,11322372617,22,11180612772,-141759845
1637381529,-182978,true,11317844800,22,11181730833,-136113967
1637381757,-182977,true,11318976584,22,11207477124,-111499460
1637382722,-182973,true,11323504854,22,11280559331,-42945523
1637382764,-182974,true,11322372617,22,11279431388,-42941229
1637382941,-182978,true,11317844800,22,11280559331,-37285469
1637382957,-182978,true,11317844800,22,11280559331,-37285469
1637382998,-182973,true,11323504854,22,11280559331,-42945523
1637383342,-182974,true,11322372617,22,11281687387,-40685230
1637383454,-182978,true,11317844800,22,11279431388,-38413412
1637383466,-182978,true,11317844800,22,11279431388,-38413412
1637383765,-182974,true,11322372617,22,11265904864,-56467753
1637383838,-182975,true,11321240493,22,11261399628,-59840865
1637383887,-182979,true,11316713128,22,11259147686,-57565442
1637383950,-182980,true,11315581570,22,11255770617,-59810953
1637384506,-182978,true,11317844800,22,11226545085,-91299715
1637384637,-182981,true,11314450125,22,11223177795,-91272330
1637384799,-182985,true,11309925476,22,11219811514,-90113962
1637384942,-182986,true,11308794597,22,11217567889,-91226708
1637384999,-182984,true,11311056469,22,11214203291,-96853178
1637385256,-182988,true,11306533177,22,11202995253,-103537924
1637385736,-182990,true,11304272210,22,11211960787,-92311423
1637386032,-182991,true,11303141895,22,11226545085,-76596810
1637386169,-182989,true,11305402637,22,11234406024,-70996613
1637386203,-182992,true,11302011694,22,11234406024,-67605670
1637386326,-182995,true,11298621769,22,11235529465,-63092304
1637386344,-182996,true,11297492020,22,11235529465,-61962555
1637386567,-182995,true,11298621769,22,11223177795,-75443974
1637386632,-182998,true,11295232860,22,11223177795,-72055065
1637386794,-183001,true,11291844968,22,11224300112,-67544856
1637386958,-183002,true,11290715896,22,11234406024,-56309872
1637387224,-183002,true,11290715896,22,11249019518,-41696378
1637387445,-183005,true,11287329359,22,11269284973,-18044386
1637387490,-183008,true,11283943837,22,11273793363,-10150474
1637387635,-183008,true,11283943837,22,11287329359,3385522
1637388182,-183007,true,11285072231,22,11303141895,18069664
1637388484,-183009,true,11282815555,22,11330300655,47485100
1637388527,-183012,true,11279431388,22,11332566829,53135441
1637388614,-183012,true,11279431388,22,11338234246,58802858
1637388671,-183010,true,11281687387,22,11346173391,64486004
1637388682,-183011,true,11280559331,22,11348442739,67883408
1637388788,-183013,true,11278303557,22,11366613872,88310315
1637389302,-183010,true,11281687387,22,11460198600,178511213
1637389546,-183008,true,11283943837,22,11480844501,196900664
1637390041,-183011,true,11280559331,22,11432728474,152169143
1637390325,-183014,true,11277175840,22,11405324194,128148354
1637390953,-183014,true,11277175840,22,11388229886,111054046
1637391227,-183012,true,11279431388,22,11401903281,122471893
1637391335,-183014,true,11277175840,22,11415593093,138417253
1637391576,-183015,true,11276048235,22,11441877858,165829623
1637391734,-183012,true,11279431388,22,11457906904,178475516
1637392401,-183010,true,11281687387,22,11475105800,193418413
1637392466,-183012,true,11279431388,22,11475105800,195674412
1637392581,-183012,true,11279431388,22,11475105800,195674412
1637392726,-183008,true,11283943837,22,11473958404,190014567
1637393220,-183004,true,11288458092,22,11504978399,216520307
1637394320,-183006,true,11286200739,22,11486586071,200385332
1637394625,-183006,true,11286200739,22,11485437527,199236788
1637394661,-183001,true,11291844968,22,11481992585,190147617
1637395381,-182999,true,11294103450,22,11421302031,127198581
1637395434,-183001,true,11291844968,22,11417876325,126031357
1637395567,-183000,true,11292974152,22,11411027997,118053845
1637396277,-182995,true,11298621769,22,11416734652,118112883
1637396555,-182992,true,11302011694,22,11416734652,114722958
1637396796,-182993,true,11300881606,22,11433871747,132990141
1637397019,-182991,true,11303141895,22,11447599942,144458047
1637397305,-182986,true,11308794597,22,11448744702,139950105
1637397611,-182983,true,11312187574,22,11438445982,126258408
1637398002,-182985,true,11309925476,22,11395064533,85139057
1637398167,-182984,true,11311056469,22,11370024197,58967728
1637398204,-182979,true,11316713128,22,11367750534,51037406
1637398266,-182976,true,11320108482,22,11363204570,43096088
1637398293,-182980,true,11315581570,22,11359796290,44214720
1637398306,-182978,true,11317844800,22,11358660424,40815624
1637398352,-182975,true,11321240493,22,11355253507,34013014
1637398436,-182972,true,11324637204,22,11347308008,22670804
1637398582,-182975,true,11321240493,22,11339368069,18127576
1637401034,-182974,true,11322372617,22,11322372617,0
1637401629,-182970,true,11326902245,22,11320108482,-6793763
1637402088,-182968,true,11329167739,22,11318976584,-10191155
1637402597,-182972,true,11324637204,22,11321240493,-3396711
1637402792,-182971,true,11325769668,22,11308794597,-16975071
1637403118,-182967,true,11330300655,22,11287329359,-42971296
1637403492,-182964,true,11333700086,22,11285072231,-48627855
1637403531,-182968,true,11329167739,22,11287329359,-41838380
1637404230,-182965,true,11332566829,22,11358660424,26093595
1637404276,-182961,true,11337100536,22,11360932270,23831734
1637404749,-182957,true,11341636056,22,11371161200,29525144
1637404973,-182961,true,11337100536,22,11373435546,36335010
1637405045,-182957,true,11341636056,22,11373435546,31799490
1637406042,-182954,true,11345038887,22,11342770220,-2268667
1637406299,-182954,true,11345038887,22,11338234246,-6804641
1637406831,-182958,true,11340502006,22,11328034935,-12467071
1637406836,-182955,true,11343904497,22,11328034935,-15869562
1637406901,-182953,true,11346173391,22,11321240493,-24932898
1637406951,-182953,true,11346173391,22,11315581570,-30591821
1637407119,-182958,true,11340502006,22,11308794597,-31707409
1637407237,-182955,true,11343904497,22,11304272210,-39632287
1637407554,-182952,true,11347308008,22,11291844968,-55463040
1637407743,-182951,true,11348442739,22,11285072231,-63370508
1637407750,-182957,true,11341636056,22,11285072231,-56563825
1637408078,-182953,true,11346173391,22,11289586937,-56586454
1637408159,-182950,true,11349577584,22,11289586937,-59990647
1637408540,-182949,true,11350712541,22,11291844968,-58867573
1637408597,-182954,true,11345038887,22,11292974152,-52064735
1637408619,-182950,true,11349577584,22,11292974152,-56603432
1637409157,-182947,true,11352982797,22,11292974152,-60008645
1637409424,-182946,true,11354118096,22,11282815555,-71302541
1637410340,-182951,true,11348442739,22,11258021884,-90420855
1637410705,-182947,true,11352982797,22,11286200739,-66782058
1637410991,-182945,true,11355253507,22,11306533177,-48720330
1637411082,-182943,true,11357524672,22,11313318793,-44205879
1637411195,-182947,true,11352982797,22,11321240493,-31742304
1637411476,-182944,true,11356389033,22,11321240493,-35148540
1637411835,-182942,true,11358660424,22,11317844800,-40815624
1637412034,-182939,true,11362068363,22,11316713128,-45355235
1637412384,-182943,true,11357524672,22,11315581570,-41943102
1637413373,-182940,true,11360932270,22,11315581570,-45350700
1637414093,-182938,true,11363204570,22,11311056469,-52148101
1637414471,-182937,true,11364340890,22,11308794597,-55546293
1637414668,-182942,true,11358660424,22,11308794597,-49865827
1637415120,-182939,true,11362068363,22,11300881606,-61186757
1637415503,-182938,true,11363204570,22,11285072231,-78132339
1637416050,-182938,true,11363204570,22,11276048235,-87156335
1637416584,-182943,true,11357524672,22,11278303557,-79221115
1637417990,-182941,true,11359796290,22,11277175840,-82620450
1637418188,-182941,true,11359796290,22,11276048235,-83748055
1637418251,-182942,true,11358660424,22,11271538943,-87121481
1637418350,-182949,true,11350712541,22,11233282696,-117429845
1637418523,-182954,true,11345038887,22,11176141645,-168897242
1637418602,-182960,true,11338234246,22,11149352404,-188881842
1637418620,-182963,true,11334833456,22,11142665133,-192168323
1637418816,-182972,true,11324637204,22,11032902458,-291734746
1637418858,-182979,true,11316713128,22,11013062087,-303651041
1637418962,-182984,true,11311056469,22,10969100020,-341956449
1637419338,-182985,true,11309925476,22,10880613588,-429311888
1637419636,-182993,true,11300881606,22,10873000204,-427881402
1637419661,-183001,true,11291844968,22,10875174913,-416670055
1637420092,-183008,true,11283943837,22,10873000204,-410943633
1637420624,-183010,true,11281687387,22,10861047077,-420640310
1637420637,-183018,true,11272666097,22,10859961081,-412705016
1637420782,-183026,true,11263652021,22,10851277020,-412375001
1637420787,-183033,true,11255770617,22,10851277020,-404493597
1637420819,-183039,true,11249019518,22,10845853009,-403166509
1637420909,-183047,true,11240024351,22,10836096620,-403927731
1637421150,-183053,true,11233282696,22,10833929726,-399352970
1637421245,-183061,true,11224300112,22,10833929726,-390370386
1637421353,-183065,true,11219811514,22,10832846441,-386965073
1637421630,-183071,true,11213081983,22,10837180230,-375901753
1637421735,-183076,true,11207477124,22,10845853009,-361624115
1637422209,-183082,true,11200754990,22,10886054983,-314700007
1637422397,-183086,true,11196275808,22,10899125436,-297150372
1637422420,-183092,true,11189560393,22,10900215349,-289345044
1637422899,-183098,true,11182849006,22,10910029467,-272819539
1637422943,-183104,true,11176141645,22,10906757113,-269384532
1637422974,-183108,true,11171672305,22,10902395501,-269276804
1637423836,-183114,true,11164971647,22,10867565334,-297406313
1637423981,-183118,true,11160506775,22,10878437792,-282068983
1637423999,-183124,true,11153812814,22,10878437792,-275375022
1637424160,-183127,true,11150467339,22,10886054983,-264412356
1637424731,-183130,true,11147122868,22,10914394134,-232728734
1637425045,-183136,true,11140436935,22,10913302804,-227134131
1637425262,-183142,true,11133755011,22,10912211582,-221543429
1637425783,-183145,true,11130415553,22,10906757113,-223658440
1637425880,-183148,true,11127077096,22,10905666546,-221410550
1637425891,-183153,true,11121515226,22,10905666546,-215848680
1637425974,-183159,true,11114844652,22,10905666546,-209178106
1637426741,-183160,true,11113733278,22,10941712887,-172020391
1637427291,-183163,true,11110399825,22,10946090229,-164309596
1637427941,-183168,true,11104846291,22,10944995730,-159850561
1637428070,-183173,true,11099295533,22,10949374385,-149921148
1637428296,-183174,true,11098185715,22,10959232764,-138952951
1637428762,-183176,true,11095966411,22,10981172065,-114794346
1637429100,-183182,true,11089311160,22,10984466746,-104844414
1637429610,-183188,true,11082659902,22,10984466746,-98193156
1637430174,-183190,true,11080443702,22,10978976160,-101467542
1637430204,-183192,true,11078227946,22,10975683126,-102544820
1637430449,-183199,true,11070476287,22,10949374385,-121101902
1637430507,-183205,true,11063836326,22,10949374385,-114461941
1637430678,-183207,true,11061623890,22,10950469322,-111154568
1637430783,-183208,true,11060517838,22,10950469322,-110048516
1637430816,-183214,true,11053883850,22,10950469322,-103414528
1637431103,-183219,true,11048358566,22,10952659525,-95699041
1637431239,-183221,true,11046149225,22,10964713477,-81435748
1637431344,-183221,true,11046149225,22,10973488318,-72660907
1637431398,-183226,true,11040627807,22,10972391079,-68236728
1637431433,-183232,true,11034005748,22,10970196930,-63808818
1637431534,-183235,true,11030696209,22,10962520863,-68175346
1637432109,-183236,true,11029593249,22,10916577122,-113016127
1637432344,-183242,true,11022977809,22,10902395501,-120582308
1637432745,-183249,true,11015264810,22,10870825930,-144438880
1637433261,-183252,true,11011960891,22,10865392147,-146568744
1637433537,-183253,true,11010859805,22,10881701649,-129158156
1637433538,-183260,true,11003155286,22,10881701649,-121453637
1637433596,-183265,true,10997655358,22,10884966486,-112688872
1637433632,-183268,true,10994356721,22,10887143588,-107213133
1637433703,-183269,true,10993257396,22,10886054983,-107202413
1637433771,-183276,true,10985565193,22,10887143588,-98421605
1637433804,-183282,true,10978976160,22,10887143588,-91832572
1637433834,-183284,true,10976780694,22,10890410058,-86370636
1637434322,-183286,true,10974585667,22,10914394134,-60191533
1637434399,-183292,true,10968003220,22,10917668779,-50334441
1637434435,-183297,true,10962520863,22,10919852422,-42668441
1637434733,-183300,true,10959232764,22,10932963455,-26269309
1637434772,-183301,true,10958136951,22,10932963455,-25173496
1637434842,-183307,true,10951564369,22,10931870268,-19694101
1637434968,-183313,true,10944995730,22,10930777190,-14218540
1637435172,-183316,true,10941712887,22,10919852422,-21860465
1637435248,-183318,true,10939524873,22,10913302804,-26222069
1637435435,-183325,true,10931870268,22,10896945938,-34924330
1637435519,-183331,true,10925313441,22,10888232303,-37081138
1637435696,-183334,true,10922036502,22,10869738956,-52297546
1637436620,-183337,true,10918760546,22,10829597237,-89163309
1637436960,-183343,true,10912211582,22,10827431643,-84779939
1637436988,-183349,true,10905666546,22,10827431643,-78234903
1637437332,-183353,true,10901305370,22,10823101752,-78203618
1637437376,-183355,true,10899125436,22,10822019550,-77105886
1637437572,-183356,true,10898035632,22,10814447166,-83588466
1637437623,-183357,true,10896945938,22,10812284601,-84661337
1637437779,-183360,true,10893677508,22,10806880080,-86797428
1637437856,-183359,true,10894766876,22,10803638664,-91128212
1637437951,-183358,true,10895856352,22,10792840965,-103015387
1637438217,-183360,true,10893677508,22,10764817426,-128860082
1637438230,-183365,true,10888232303,22,10762664786,-125567517
1637438406,-183364,true,10889321126,22,10764817426,-124503700
1637440740,-183365,true,10888232303,22,10729353849,-158878454
1637440910,-183366,true,10887143588,22,10729353849,-157789739
1637441043,-183371,true,10881701649,22,10725063180,-156638469
1637441441,-183370,true,10882789819,22,10713272686,-169517133
1637441585,-183371,true,10881701649,22,10706846972,-174854677
1637441607,-183373,true,10879525635,22,10705776394,-173749241
1637441672,-183375,true,10877350057,22,10703635560,-173714497
1637442186,-183374,true,10878437792,22,10697215626,-181222166
1637442400,-183376,true,10876262430,22,10700425111,-175837319
1637442443,-183378,true,10874087504,22,10701495154,-172592350
1637442735,-183381,true,10870825930,22,10680114620,-190711310
1637442867,-183381,true,10870825930,22,10680114620,-190711310
1637443026,-183384,true,10867565334,22,10679046716,-188518618
1637443106,-183387,true,10864305717,22,10679046716,-185259001
1637443336,-183390,true,10861047077,22,10677978918,-183068159
1637443724,-183390,true,10861047077,22,10701495154,-159551923
1637443992,-183393,true,10857789414,22,10703635560,-154153854
1637444001,-183396,true,10854532729,22,10702565304,-151967425
1637444163,-183398,true,10852362148,22,10698285347,-154076801
1637444180,-183398,true,10852362148,22,10698285347,-154076801
1637444291,-183401,true,10849107090,22,10694007103,-155099987
1637444513,-183404,true,10845853009,22,10686524291,-159328718
1637445551,-183408,true,10841515752,22,10641737247,-199778505
1637445793,-183409,true,10840431709,22,10641737247,-198694462
1637445884,-183412,true,10837180230,22,10641737247,-195442983
1637445972,-183415,true,10833929726,22,10640673180,-193256546
1637446575,-183419,true,10829597237,22,10634291010,-195306227
1637446965,-183421,true,10827431643,22,10636417975,-191013668
1637447416,-183423,true,10825266481,22,10639609219,-185657262
1637447587,-183427,true,10820937457,22,10636417975,-184519482
1637448641,-183431,true,10816610164,22,10682250750,-134359414
1637448765,-183432,true,10815528611,22,10681182632,-134345979
1637448891,-183435,true,10812284601,22,10680114620,-132169981
1637448911,-183438,true,10809041564,22,10680114620,-128926944
1637448941,-183443,true,10803638664,22,10679046716,-124591948
1637449136,-183445,true,10801478261,22,10676911227,-124567034
1637449204,-183448,true,10798238465,22,10674776165,-123462300
1637449453,-183452,true,10793920249,22,10664107257,-129812992
1637449972,-183457,true,10788524908,22,10648123886,-140401022
1637450024,-183459,true,10786367527,22,10647059180,-139308347
1637450346,-183461,true,10784210577,22,10645994581,-138215996
1637450463,-183465,true,10779897971,22,10645994581,-133903390
1637450599,-183469,true,10775587089,22,10645994581,-129592508
1637450615,-183471,true,10773432295,22,10645994581,-127437714
1637450755,-183475,true,10769123999,22,10653449013,-115674986
1637450882,-183476,true,10768047195,22,10668373540,-99673655
1637450978,-183479,true,10764817426,22,10679046716,-85770710
1637451063,-183481,true,10762664786,22,10688661703,-74003083
1637451537,-183484,true,10759436632,22,10740088032,-19348600
1637451644,-183485,true,10758360796,22,10745459151,-12901645
1637451652,-183487,true,10756209446,22,10745459151,-10750295
1637451757,-183488,true,10755133933,22,10743310381,-11823552
1637452022,-183489,true,10754058527,22,10764817426,10758899
1637452256,-183489,true,10754058527,22,10784210577,30152050
1637452262,-183491,true,10751908038,22,10784210577,32302539
1637452328,-183491,true,10751908038,22,10789603761,37695723
1637452455,-183491,true,10751908038,22,10799318289,47410251
1637452752,-183493,true,10749757979,22,10809041564,59283585
1637452944,-183494,true,10748683111,22,10803638664,54955553
1637452985,-183494,true,10748683111,22,10802558409,53875298
1637453057,-183495,true,10747608350,22,10800398221,52789871
1637453102,-183496,true,10746533696,22,10799318289,52784593
1637453137,-183499,true,10743310381,22,10798238465,54928084
1637453372,-183500,true,10742236157,22,10792840965,50604808
1637453415,-183501,true,10741162041,22,10792840965,51678924
1637453944,-183502,true,10740088032,22,10789603761,49515729
1637454013,-183505,true,10736866650,22,10784210577,47343927
1637454478,-183507,true,10734719599,22,10752983229,18263630
1637454799,-183509,true,10732572977,22,10730426784,-2146193
1637454819,-183511,true,10730426784,22,10728281021,-2145763
1637454907,-183513,true,10728281021,22,10720774227,-7506794
1637455596,-183516,true,10725063180,22,10666240185,-58822995
1637456572,-183518,true,10722918489,22,10655579809,-67338680
1637456893,-183520,true,10720774227,22,10652383775,-68390452
1637456912,-183521,true,10719702257,22,10651318643,-68383614
1637457479,-183524,true,10716486989,22,10644930088,-71556901
1637457520,-183526,true,10714344014,22,10644930088,-69413926
1637457676,-183528,true,10712201466,22,10644930088,-67271378
1637457919,-183529,true,10711130353,22,10643865701,-67264652
1637457953,-183532,true,10707917657,22,10643865701,-64051956
1637458325,-183533,true,10706846972,22,10642801421,-64045551
1637458400,-183535,true,10704705924,22,10641737247,-62968677
1637458501,-183535,true,10704705924,22,10641737247,-62968677
1637458666,-183538,true,10701495154,22,10639609219,-61885935
1637459201,-183539,true,10700425111,22,10637481616,-62943495
1637459296,-183539,true,10700425111,22,10637481616,-62943495
1637459809,-183539,true,10700425111,22,10637481616,-62943495
1637459832,-183543,true,10696146011,22,10637481616,-58664395
1637460340,-183543,true,10696146011,22,10636417975,-59728036
1637460584,-183544,true,10695076504,22,10634291010,-60785494
1637460600,-183543,true,10696146011,22,10634291010,-61855001
1637461344,-183546,true,10692937809,22,10669440377,-23497432
1637461619,-183545,true,10694007103,22,10673708794,-20298309
1637462578,-183545,true,10694007103,22,10656645367,-37361736
1637462846,-183545,true,10694007103,22,10644930088,-49077015
1637464123,-183548,true,10690799542,22,10621538152,-69261390
1637465422,-183548,true,10690799542,22,10610922453,-79877089
1637465530,-183549,true,10689730569,22,10610922453,-78808116
1637465789,-183548,true,10690799542,22,10610922453,-79877089
1637465954,-183551,true,10687592944,22,10610922453,-76670491
1637466152,-183550,true,10688661703,22,10608800587,-79861116
1637466201,-183551,true,10687592944,22,10604558127,-83034817
1637466843,-183554,true,10684387307,22,10541124441,-143262866
1637468025,-183558,true,10680114620,22,10524272970,-155841650
1637468128,-183558,true,10680114620,22,10523220648,-156893972
1637468462,-183559,true,10679046716,22,10522168431,-156878285
1637468505,-183562,true,10675843642,22,10522168431,-153675211
1637468791,-183566,true,10671574372,22,10517960615,-153613757
1637468805,-183565,true,10672641530,22,10517960615,-154680915
1637469119,-183566,true,10671574372,22,10514805858,-156768514
1637469293,-183567,true,10670507321,22,10521116319,-149391002
1637469506,-183571,true,10666240185,22,10528483310,-137756875
1637469529,-183570,true,10667306809,22,10529536159,-137770650
1637469871,-183570,true,10667306809,22,10551670311,-115636498
1637469933,-183570,true,10667306809,22,10554836128,-112470681
1637470534,-183573,true,10664107257,22,10568565651,-95541606
1637470541,-183573,true,10664107257,22,10568565651,-95541606
1637470613,-183572,true,10665173668,22,10570679470,-94494198
1637470756,-183574,true,10663040953,22,10574908376,-88132577
1637471419,-183575,true,10661974756,22,10618352327,-43622429
1637471494,-183575,true,10661974756,22,10622600305,-39374451
1637471915,-183575,true,10661974756,22,10624724932,-37249824
1637473035,-183576,true,10660908665,22,10614106048,-46802617
1637473055,-183578,true,10658776803,22,10613044744,-45732059
1637473507,-183577,true,10659842681,22,10613044744,-46797937
1637474268,-183577,true,10659842681,22,10613044744,-46797937
1637474591,-183578,true,10658776803,22,10611983545,-46793258
1637475026,-183579,true,10657711032,22,10610922453,-46788579
1637475078,-183579,true,10657711032,22,10609861467,-47849565
1637475143,-183578,true,10658776803,22,10609861467,-48915336
1637476015,-183580,true,10656645367,22,10602437534,-54207833
1637476941,-183581,true,10655579809,22,10601377396,-54202413
1637477009,-183581,true,10655579809,22,10602437534,-53142275
1637477086,-183582,true,10654514358,22,10603497777,-51016581
1637477194,-183585,true,10651318643,22,10604558127,-46760516
1637477224,-183586,true,10650253617,22,10605618583,-44635034
1637477275,-183587,true,10649188698,22,10606679145,-42509553
1637477464,-183588,true,10648123886,22,10609861467,-38262419
1637477510,-183591,true,10644930088,22,10608800587,-36129501
1637477542,-183592,true,10643865701,22,10607739813,-36125888
1637477805,-183595,true,10640673180,22,10602437534,-38235646
1637477835,-183597,true,10638545365,22,10601377396,-37167969
1637478095,-183600,true,10635354439,22,10591840925,-43513514
1637478637,-183602,true,10633227687,22,10580196888,-53030799
1637479076,-183605,true,10630038357,22,10571736538,-58301819
1637479148,-183607,true,10627912668,22,10570679470,-57233198
1637479722,-183610,true,10624724932,22,10577023463,-47701469
1637479938,-183611,true,10623662566,22,10578081166,-45581400
1637480485,-183614,true,10620476104,22,10578081166,-42394938
1637480727,-183616,true,10618352327,22,10580196888,-38155439
1637481180,-183619,true,10615167459,22,10580196888,-34970571
1637481228,-183620,true,10614106048,22,10580196888,-33909160
1637481834,-183623,true,10610922453,22,10578081166,-32841287
1637481906,-183625,true,10608800587,22,10578081166,-30719421
1637482298,-183627,true,10606679145,22,10585488044,-21191101
1637482533,-183628,true,10605618583,22,10587605248,-18013335
1637482735,-183630,true,10603497777,22,10590781847,-12715930
1637483525,-183631,true,10602437534,22,10588664008,-13773526
1637483630,-183633,true,10600317364,22,10588664008,-11653356
1637484570,-183632,true,10601377396,22,10590781847,-10595549
1637484574,-183633,true,10600317364,22,10589722875,-10594489
1637485062,-183634,true,10599257438,22,10582313033,-16944405
1637485077,-183636,true,10597137905,22,10582313033,-14824872
1637485417,-183635,true,10598197619,22,10574908376,-23289243
1637485504,-183636,true,10597137905,22,10572793712,-24344193
1637485650,-183637,true,10596078297,22,10571736538,-24341759
1637485777,-183639,true,10593959399,22,10569622508,-24336891
1637486107,-183638,true,10595018795,22,10564339281,-30679514
1637486471,-183640,true,10592900109,22,10559058696,-33841413
1637486813,-183640,true,10592900109,22,10558002896,-34897213
1637487051,-183643,true,10589722875,22,10560114602,-29608273
1637487488,-183642,true,10590781847,22,10563282953,-27498894
1637488219,-183643,true,10589722875,22,10560114602,-29608273
1637488939,-183644,true,10588664008,22,10564339281,-24324727
1637488974,-183646,true,10586546593,22,10564339281,-22207312
1637490114,-183645,true,10587605248,22,10562226731,-25378517
1637490129,-183646,true,10586546593,22,10560114602,-26431991
1637490328,-183647,true,10585488044,22,10553780750,-31707294
1637490539,-183649,true,10583371264,22,10546396058,-36975206
1637490868,-183650,true,10582313033,22,10535855460,-46457573
1637491341,-183652,true,10580196888,22,10532695335,-47501553
1637492302,-183654,true,10578081166,22,10483310282,-94770884
1637492477,-183656,true,10575965867,22,10490650801,-85315066
1637492487,-183656,true,10575965867,22,10490650801,-85315066
1637492635,-183658,true,10573850991,22,10495897176,-77953815
1637492656,-183658,true,10573850991,22,10496946766,-76904225
1637493197,-183658,true,10573850991,22,10549560293,-24290698
1637493523,-183659,true,10572793712,22,10558002896,-14790816
1637493693,-183660,true,10571736538,22,10555891612,-15844926
1637494001,-183660,true,10571736538,22,10546396058,-25340480
1637494484,-183658,true,10573850991,22,10548505443,-25345548
1637494868,-183658,true,10573850991,22,10551670311,-22180680
1637495548,-183659,true,10572793712,22,10547450698,-25343014
1637495804,-183659,true,10572793712,22,10546396058,-26397654
1637495920,-183657,true,10574908376,22,10546396058,-28512318
1637496229,-183657,true,10574908376,22,10545341524,-29566852
1637496350,-183657,true,10574908376,22,10547450698,-27457678
1637496747,-183657,true,10574908376,22,10553780750,-21127626
1637496762,-183656,true,10575965867,22,10553780750,-22185117
1637497067,-183656,true,10575965867,22,10555891612,-20074255
1637497094,-183656,true,10575965867,22,10556947201,-19018666
1637498152,-183654,true,10578081166,22,10644930088,66848922
1637498171,-183653,true,10579138974,22,10644930088,65791114
1637498234,-183652,true,10580196888,22,10644930088,64733200
1637499002,-183653,true,10579138974,22,10665173668,86034694
1637499014,-183650,true,10582313033,22,10665173668,82860635
1637499342,-183650,true,10582313033,22,10648123886,65810853
1637500729,-183652,true,10580196888,22,10613044744,32847856
1637500815,-183653,true,10579138974,22,10609861467,30722493
1637500979,-183651,true,10581254907,22,10605618583,24363676
1637501078,-183650,true,10582313033,22,10604558127,22245094
1637501131,-183653,true,10579138974,22,10603497777,24358803
1637501268,-183654,true,10578081166,22,10602437534,24356368
1637501366,-183651,true,10581254907,22,10602437534,21182627
1637501664,-183651,true,10581254907,22,10603497777,22242870
1637501803,-183653,true,10579138974,22,10605618583,26479609
1637502618,-183655,true,10577023463,22,10554836128,-22187335
1637502849,-183653,true,10579138974,22,10549560293,-29578681
1637502874,-183653,true,10579138974,22,10550615249,-28523725
1637503047,-183655,true,10577023463,22,10548505443,-28518020
1637503152,-183658,true,10573850991,22,10546396058,-27454933
1637503198,-183656,true,10575965867,22,10545341524,-30624343
1637503667,-183656,true,10575965867,22,10535855460,-40110407
1637504252,-183659,true,10572793712,22,10531642171,-41151541
1637504486,-183662,true,10569622508,22,10532695335,-36927173
1637504497,-183659,true,10572793712,22,10532695335,-40098377
1637505241,-183660,true,10571736538,22,10495897176,-75839362
1637505442,-183664,true,10567508900,22,10488552986,-78955914
1637505774,-183666,true,10565395715,22,10490650801,-74744914
1637505901,-183663,true,10568565651,22,10490650801,-77914850
1637505979,-183664,true,10567508900,22,10491699867,-75809033
1637506089,-183667,true,10564339281,22,10493798311,-70540970
1637506113,-183669,true,10562226731,22,10493798311,-68428420
1637506742,-183667,true,10564339281,22,10492749036,-71590245
1637506751,-183667,true,10564339281,22,10492749036,-71590245
1637506961,-183671,true,10560114602,22,10491699867,-68414735
1637507314,-183673,true,10558002896,22,10485407049,-72595847
1637507674,-183671,true,10560114602,22,10475974900,-84139702
1637507807,-183672,true,10559058696,22,10471785557,-87273139
1637507830,-183676,true,10554836128,22,10471785557,-83050571
1637507940,-183678,true,10552725478,22,10469691514,-83033964
1637508088,-183676,true,10554836128,22,10468644650,-86191478
1637508233,-183677,true,10553780750,22,10466551235,-87229515
1637508272,-183681,true,10549560293,22,10465504684,-84055609
1637508281,-183684,true,10546396058,22,10465504684,-80891374
1637508452,-183682,true,10548505443,22,10463411897,-85093546
1637508556,-183683,true,10547450698,22,10459227579,-88223119
1637508757,-183687,true,10543232772,22,10455044933,-88187839
1637508906,-183690,true,10540070434,22,10458181760,-81888674
1637509375,-183688,true,10542178554,22,10447729328,-94449226
1637509483,-183689,true,10541124441,22,10447729328,-93395113
1637509553,-183692,true,10537962736,22,10448774101,-89188635
1637509808,-183695,true,10534801980,22,10442507030,-92294950
1637510428,-183693,true,10536909046,22,10434156783,-102752263
1637511137,-183695,true,10534801980,22,10424770735,-110031245
1637511246,-183698,true,10531642171,22,10422686094,-108956077
1637511468,-183701,true,10528483310,22,10418518062,-109965248
1637511509,-183700,true,10529536159,22,10417476314,-112059845
1637511897,-183702,true,10527430567,22,10408105271,-119325296
1637511971,-183705,true,10524272970,22,10407064565,-117208405
1637512015,-183708,true,10521116319,22,10404983464,-116132855
1637512099,-183707,true,10522168431,22,10402902780,-119265651
1637512141,-183709,true,10520064313,22,10402902780,-117161533
1637512618,-183712,true,10516908925,22,10395623660,-121285265
1637512681,-183715,true,10513754483,22,10397702888,-116051595
1637512949,-183713,true,10515857339,22,10409146082,-106711257
1637513070,-183715,true,10513754483,22,10415393131,-98361352
1637513071,-183716,true,10512703212,22,10415393131,-97310081
1637513220,-183719,true,10509550032,22,10421643930,-87906102
1637513266,-183716,true,10512703212,22,10423728363,-88974849
1637513406,-183718,true,10510600987,22,10426855794,-83745193
1637513863,-183721,true,10507448437,22,10400822511,-106625926
1637513923,-183724,true,10504296833,22,10397702888,-106593945
1637513936,-183722,true,10506397798,22,10396663222,-109734576
1637514401,-183727,true,10501146174,22,10366558077,-134588097
1637514796,-183729,true,10499046260,22,10359304389,-139741871
1637514929,-183732,true,10495897176,22,10360340319,-135556857
1637515046,-183731,true,10496946766,22,10362412491,-134534275
1637515125,-183735,true,10492749036,22,10362412491,-130336545
1637515206,-183738,true,10489601841,22,10360340319,-129261522
1637515701,-183741,true,10486455590,22,10352055775,-134399815
1637515838,-183739,true,10488552986,22,10346881300,-141671686
1637516028,-183744,true,10483310282,22,10341709411,-141600871
1637516074,-183746,true,10481213935,22,10341709411,-139504524
1637516112,-183750,true,10477022497,22,10345846715,-131175782
1637516404,-183746,true,10481213935,22,10372779567,-108434368
1637516413,-183750,true,10477022497,22,10373816845,-103205652
1637516435,-183752,true,10474927407,22,10371742393,-103185014
1637516543,-183757,true,10469691514,22,10368631493,-101060021
1637516562,-183760,true,10466551235,22,10367594733,-98956502
1637516592,-183763,true,10463411897,22,10366558077,-96853820
1637516986,-183767,true,10459227579,22,10352055775,-107171804
1637517227,-183772,true,10453999533,22,10316920306,-137079227
1637517398,-183776,true,10449818979,22,10303517694,-146301285
1637517483,-183778,true,10447729328,22,10300427257,-147302071
1637518135,-183782,true,10443551281,22,10289103582,-154447699
1637518273,-183786,true,10439374905,22,10302487445,-136887460
1637518369,-183789,true,10436243719,22,10312794570,-123449149
1637518569,-183791,true,10434156783,22,10331373387,-102783396
1637518619,-183791,true,10434156783,22,10336540107,-97616676
1637518630,-183795,true,10429984163,22,10337573761,-92410402
1637518649,-183799,true,10425813212,22,10338607518,-87205694
1637519143,-183803,true,10421643930,22,10351020673,-70623257
1637519784,-183803,true,10421643930,22,10318983794,-102660136
1637520124,-183806,true,10418518062,22,10312794570,-105723492
1637520184,-183810,true,10414351696,22,10312794570,-101557126
1637520969,-183813,true,10411228015,22,10313825849,-97402166
1637521110,-183814,true,10410186997,22,10313825849,-96361148
1637521370,-183816,true,10408105271,22,10312794570,-95310701
1637521557,-183819,true,10404983464,22,10310732320,-94251144
1637521809,-183823,true,10400822511,22,10303517694,-97304817
1637521879,-183824,true,10399782533,22,10300427257,-99355276
1637522217,-183826,true,10397702888,22,10312794570,-84908318
1637522235,-183829,true,10394584201,22,10313825849,-80758352
1637522399,-183831,true,10392505596,22,10318983794,-73521802
1637522493,-183831,true,10392505596,22,10322079798,-70425798
1637522546,-183833,true,10390427407,22,10320015692,-70411715
1637524094,-183839,true,10384195332,22,10254181777,-130013555
1637524969,-183842,true,10381080696,22,10247006720,-134073976
1637525118,-183841,true,10382118804,22,10245982121,-136136683
1637525233,-183844,true,10379004791,22,10242908941,-136095850
1637525521,-183850,true,10372779567,22,10235741772,-137037795
1637525771,-183853,true,10369668356,22,10226534209,-143134147
1637525825,-183853,true,10369668356,22,10224489209,-145179147
1637525873,-183856,true,10366558077,22,10217334929,-149223148
1637526003,-183864,true,10358268562,22,10186730384,-171538178
1637526278,-183870,true,10352055775,22,10145052371,-207003404
1637526327,-183871,true,10351020673,22,10137953674,-213066999
1637526346,-183873,true,10348950780,22,10136939980,-212010800
1637526716,-183881,true,10340675343,22,10070259797,-270415546
1637527398,-183888,true,10333439765,22,10066232700,-267207065
1637527432,-183888,true,10333439765,22,10067239323,-266200442
1637527680,-183891,true,10330340353,22,10083358993,-246981360
1637527869,-183898,true,10323112006,22,10091428504,-231683502
1637527988,-183903,true,10317951998,22,10097484875,-220467123
1637528151,-183903,true,10317951998,22,10104555235,-213396763
1637528640,-183906,true,10314857232,22,10109608523,-205248709
1637528690,-183913,true,10307639719,22,10112641709,-194998010
1637528816,-183917,true,10303517694,22,10117699041,-185818653
1637529443,-183915,true,10305578500,22,10195902109,-109676391
1637529536,-183916,true,10304548046,22,10213249016,-91299030
1637529604,-183922,true,10298367480,22,10222444618,-75922862
1637529636,-183926,true,10294249163,22,10227556863,-66692300
1637530001,-183923,true,10297337746,22,10249056223,-48281523
1637530561,-183924,true,10296308116,22,10233694931,-62613185
1637530956,-183930,true,10290132492,22,10214270341,-75862151
1637531176,-183934,true,10286017468,22,10212227793,-73789675
1637531604,-183931,true,10289103582,22,10207123211,-81980371
1637532018,-183933,true,10287046070,22,10204061686,-82984384
1637532280,-183939,true,10280876002,22,10203041382,-77834620
1637532293,-183943,true,10276764679,22,10203041382,-73723297
1637533099,-183938,true,10281904090,22,10253156461,-28747629
1637533730,-183939,true,10280876002,22,10257258339,-23617663
1637533877,-183946,true,10273682266,22,10255207195,-18475071
1637534028,-183950,true,10269573821,22,10252131248,-17442573
1637534129,-183946,true,10273682266,22,10251106137,-22576129
1637534223,-183948,true,10271627838,22,10249056223,-22571615
1637534580,-183955,true,10264440574,22,10237789023,-26651551
1637534633,-183958,true,10261361857,22,10235741772,-25620085
1637534867,-183954,true,10265467018,22,10229602476,-35864542
1637535177,-183955,true,10264440574,22,10220400436,-44040138
1637535505,-183961,true,10258284065,22,10233694931,-24589134
1637535854,-183964,true,10255207195,22,10251106137,-4101058
1637536033,-183959,true,10260335824,22,10258284065,-2051759
1637536139,-183959,true,10260335824,22,10263414232,3078408
1637536463,-183965,true,10254181777,22,10270600778,16419001
1637537275,-183967,true,10252131248,22,10282932280,30801032
1637538050,-183962,true,10257258339,22,10280876002,23617663
1637538157,-183962,true,10257258339,22,10279848017,22589678
1637538582,-183968,true,10251106137,22,10274709635,23603498
1637538977,-183970,true,10249056223,22,10263414232,14358009
1637539247,-183966,true,10253156461,22,10255207195,2050734
1637539332,-183966,true,10253156461,22,10253156461,0
1637539347,-183974,true,10244957626,22,10254181777,9224151
1637539588,-183977,true,10241884753,22,10269573821,27689068
1637539937,-183972,true,10247006720,22,10280876002,33869282
1637540187,-183971,true,10248031420,22,10292190622,44159202
1637540353,-183975,true,10243933232,22,10288074774,44141542
1637540393,-183978,true,10240860667,22,10282932280,42071613
1637540498,-183973,true,10245982121,22,10280876002,34893881
1637540712,-183972,true,10247006720,22,10282932280,35925560
1637540844,-183976,true,10242908941,22,10284988969,42080028
1637541492,-183978,true,10240860667,22,10290132492,49271825
1637541952,-183972,true,10247006720,22,10328274595,81267875
1637542277,-183970,true,10249056223,22,10356197219,107140996
1637542491,-183975,true,10243933232,22,10365521525,121588293
1637542624,-183977,true,10241884753,22,10363448732,121563979
1637542992,-183973,true,10245982121,22,10358268562,112286441
1637543117,-183971,true,10248031420,22,10356197219,108165799
1637544023,-183976,true,10242908941,22,10326209250,83300309
1637544144,-183977,true,10241884753,22,10325176732,83291979
1637544468,-183973,true,10245982121,22,10317951998,71969877
1637544965,-183971,true,10248031420,22,10307639719,59608299
1637545040,-183977,true,10241884753,22,10306609058,64724305
1637545504,-183977,true,10241884753,22,10305578500,63693747
1637545537,-183973,true,10245982121,22,10304548046,58565925
1637545841,-183972,true,10247006720,22,10303517694,56510974
1637545958,-183977,true,10241884753,22,10301457299,59572546
1637546372,-183978,true,10240860667,22,10292190622,51329955
1637546563,-183973,true,10245982121,22,10287046070,41063949
1637547099,-183973,true,10245982121,22,10274709635,28727514
1637547394,-183979,true,10239836683,22,10270600778,30764095
1637547485,-183980,true,10238812802,22,10269573821,30761019
1637547657,-183977,true,10241884753,22,10266493565,24608812
1637547804,-183976,true,10242908941,22,10265467018,22558077
1637547886,-183979,true,10239836683,22,10263414232,23577549
1637548004,-183980,true,10238812802,22,10259309893,20497091
1637548045,-183977,true,10241884753,22,10258284065,16399312
1637548251,-183976,true,10242908941,22,10257258339,14349398
1637548307,-183979,true,10239836683,22,10257258339,17421656
1637548425,-183979,true,10239836683,22,10257258339,17421656
1637548513,-183975,true,10243933232,22,10256232715,12299483
1637548674,-183972,true,10247006720,22,10268546966,21540246
1637548815,-183972,true,10247006720,22,10279848017,32841297
1637548991,-183969,true,10250081129,22,10295278588,45197459
1637549019,-183964,true,10255207195,22,10295278588,40071393
1637549136,-183961,true,10258284065,22,10306609058,48324993
1637549253,-183961,true,10258284065,22,10315888718,57604653
1637549476,-183957,true,10262387994,22,10328274595,65886601
1637549764,-183952,true,10267520214,22,10328274595,60754381
1637549772,-183950,true,10269573821,22,10328274595,58700774
1637549833,-183950,true,10269573821,22,10327241871,57668050
1637549840,-183947,true,10272655001,22,10327241871,54586870
1637550004,-183940,true,10279848017,22,10341709411,61861394
1637550382,-183937,true,10282932280,22,10371742393,88810113
1637550628,-183937,true,10282932280,22,10391466450,108534170
1637550650,-183935,true,10284988969,22,10392505596,107516627
1637550700,-183930,true,10290132492,22,10396663222,106530730
1637550771,-183930,true,10290132492,22,10398742659,108610167
1637550828,-183930,true,10290132492,22,10396663222,106530730
1637550906,-183929,true,10291161506,22,10392505596,101344090
1637550969,-183926,true,10294249163,22,10389388468,95139305
1637551202,-183924,true,10296308116,22,10383157016,86848900
1637551285,-183924,true,10296308116,22,10381080696,84772580
1637551488,-183922,true,10298367480,22,10376929302,78561822
1637551709,-183918,true,10302487445,22,10375891713,73404268
1637551749,-183916,true,10304548046,22,10375891713,71343667
1637551883,-183916,true,10304548046,22,10388349633,83801587
1637552697,-183912,true,10308670483,22,10440418842,131748359
1637553076,-183909,true,10311763393,22,10426855794,115092401
1637553286,-183908,true,10312794570,22,10418518062,105723492
1637553350,-183908,true,10312794570,22,10416434670,103640100
1637553726,-183906,true,10314857232,22,10403943070,89085838
1637553759,-183903,true,10317951998,22,10402902780,84950782
1637554171,-183901,true,10320015692,22,10395623660,75607968
1637554460,-183900,true,10321047694,22,10414351696,93304002
1637554470,-183897,true,10324144318,22,10415393131,91248813
1637554850,-183893,true,10328274595,22,10470738483,142463888
1637555223,-183889,true,10332406524,22,10513754483,181347959
1637555435,-183888,true,10333439765,22,10523220648,189780883
1637555524,-183885,true,10336540107,22,10522168431,185628324
1637555634,-183881,true,10340675343,22,10516908925,176233582
1637555939,-183879,true,10342743582,22,10501146174,158402592
1637555995,-183878,true,10343777856,22,10497996460,154218604
1637556009,-183876,true,10345846715,22,10497996460,152149745
1637556246,-183873,true,10348950780,22,10483310282,134359502
1637556340,-183871,true,10351020673,22,10475974900,124954227
1637556798,-183871,true,10351020673,22,10446684660,95663987
1637558484,-183870,true,10352055775,22,10400822511,48766736
1637558606,-183866,true,10356197219,22,10399782533,43585314
1637559311,-183864,true,10358268562,22,10395623660,37355098
1637559354,-183865,true,10357232838,22,10395623660,38390822
1637559528,-183865,true,10357232838,22,10395623660,38390822
1637559687,-183861,true,10361376353,22,10398742659,37366306
1637560062,-183859,true,10363448732,22,10404983464,41534732
1637560087,-183860,true,10362412491,22,10403943070,41530579
1637560179,-183859,true,10363448732,22,10401862593,38413861
1637560313,-183856,true,10366558077,22,10398742659,32184582
1637560647,-183855,true,10367594733,22,10384195332,16600599
1637560787,-183856,true,10366558077,22,10376929302,10371225
1637560879,-183856,true,10366558077,22,10371742393,5184316
1637561009,-183854,true,10368631493,22,10365521525,-3109968
1637561094,-183854,true,10368631493,22,10363448732,-5182761
1637561576,-183856,true,10366558077,22,10344812234,-21745843
1637561872,-183856,true,10366558077,22,10363448732,-3109345
1637561906,-183854,true,10368631493,22,10365521525,-3109968
1637562246,-183853,true,10369668356,22,10391466450,21798094
1637562279,-183853,true,10369668356,22,10394584201,24915845
1637562740,-183853,true,10369668356,22,10406023963,36355607
1637562826,-183850,true,10372779567,22,10408105271,35325704
1637563030,-183849,true,10373816845,22,10412269138,38452293
1637563090,-183848,true,10374854227,22,10413310365,38456138
1637563235,-183848,true,10374854227,22,10408105271,33251044
1637563410,-183845,true,10377966995,22,10414351696,36384701
1637563449,-183844,true,10379004791,22,10418518062,39513271
1637563803,-183841,true,10382118804,22,10451909047,69790243
1637564072,-183840,true,10383157016,22,10475974900,92817884
1637564573,-183835,true,10388349633,22,10532695335,144345702
1637564580,-183833,true,10390427407,22,10532695335,142267928
1637564739,-183829,true,10394584201,22,10543232772,148648571
1637565051,-183828,true,10395623660,22,10540070434,144446774
1637565208,-183824,true,10399782533,22,10532695335,132912802
1637565327,-183822,true,10401862593,22,10526377930,124515337
1637565398,-183818,true,10406023963,22,10531642171,125618208
1637565727,-183811,true,10413310365,22,10607739813,194429448
1637565973,-183804,true,10420601869,22,10674776165,254174296
1637566057,-183801,true,10423728363,22,10698285347,274556984
1637566095,-183796,true,10428941269,22,10708988448,280047179
1637566145,-183790,true,10435200199,22,10722918489,287718290
1637566646,-183784,true,10441462884,22,10733646234,292183350
1637566828,-183782,true,10443551281,22,10727208300,283657019
1637566884,-183778,true,10447729328,22,10726135687,278406359
1637567101,-183772,true,10453999533,22,10716486989,262487456
1637567164,-183767,true,10459227579,22,10716486989,257259410
1637567721,-183765,true,10461319529,22,10712201466,250881937
1637568239,-183762,true,10464458238,22,10683318975,218860737
1637568943,-183757,true,10469691514,22,10663040953,193349439
1637569027,-183752,true,10474927407,22,10661974756,187047349
1637569150,-183751,true,10475974900,22,10659842681,183867781
1637569191,-183748,true,10479118006,22,10658776803,179658797
1637569420,-183743,true,10484358613,22,10653449013,169090400
1637569583,-183741,true,10486455590,22,10648123886,161668296
1637569998,-183739,true,10488552986,22,10660908665,172355679
1637570143,-183737,true,10490650801,22,10666240185,175589384
1637570288,-183732,true,10495897176,22,10671574372,175677196
1637570399,-183729,true,10499046260,22,10675843642,176797382
1637571247,-183727,true,10501146174,22,10668373540,167227366
1637572333,-183724,true,10504296833,22,10666240185,161943352
1637572457,-183719,true,10509550032,22,10665173668,155623636
1637572520,-183716,true,10512703212,22,10663040953,150337741
1637572599,-183715,true,10513754483,22,10659842681,146088198
1637572670,-183712,true,10516908925,22,10657711032,140802107
1637572797,-183708,true,10521116319,22,10651318643,130202324
1637572835,-183705,true,10524272970,22,10649188698,124915728
1637572960,-183704,true,10525325397,22,10642801421,117476024
1637573661,-183703,true,10526377930,22,10622600305,96222375
1637573717,-183699,true,10530589112,22,10625787404,95198292
1637573831,-183696,true,10533748605,22,10634291010,100542405
1637573875,-183695,true,10534801980,22,10636417975,101615995
1637574003,-183692,true,10537962736,22,10643865701,105902965
1637575161,-183687,true,10543232772,22,10691868622,148635850
1637575776,-183684,true,10546396058,22,10686524291,140128233
1637575831,-183683,true,10547450698,22,10685455746,138005048
1637575983,-183680,true,10550615249,22,10684387307,133772058
1637576766,-183675,true,10555891612,22,10700425111,144533499
1637579074,-183673,true,10558002896,22,10701495154,143492258
1637579108,-183674,true,10556947201,22,10701495154,144547953
1637579628,-183672,true,10559058696,22,10703635560,144576864
1637580104,-183668,true,10563282953,22,10674776165,111493212
1637580402,-183667,true,10564339281,22,10656645367,92306086
1637580419,-183667,true,10564339281,22,10655579809,91240528
1637581199,-183666,true,10565395715,22,10610922453,45526738
1637581419,-183662,true,10569622508,22,10607739813,38117305
1637582902,-183661,true,10570679470,22,10599257438,28577968
1637582965,-183661,true,10570679470,22,10598197619,27518149
1637583311,-183659,true,10572793712,22,10597137905,24344193
1637584328,-183654,true,10578081166,22,10597137905,19056739
1637585327,-183653,true,10579138974,22,10583371264,4232290
1637585727,-183653,true,10579138974,22,10583371264,4232290
1637585804,-183651,true,10581254907,22,10582313033,1058126
1637585837,-183646,true,10586546593,22,10582313033,-4233560
1637586355,-183645,true,10587605248,22,10580196888,-7408360
1637586916,-183645,true,10587605248,22,10577023463,-10581785
1637587007,-183643,true,10589722875,22,10577023463,-12699412
1637587218,-183639,true,10593959399,22,10572793712,-21165687
1637587507,-183638,true,10595018795,22,10568565651,-26453144
1637587916,-183637,true,10596078297,22,10554836128,-41242169
1637587942,-183635,true,10598197619,22,10553780750,-44416869
1637588260,-183631,true,10602437534,22,10544287095,-58150439
1637588440,-183630,true,10603497777,22,10529536159,-73961618
1637588452,-183630,true,10603497777,22,10529536159,-73961618
1637588690,-183628,true,10605618583,22,10514805858,-90812725
1637589078,-183625,true,10608800587,22,10487504236,-121296351
1637589256,-183625,true,10608800587,22,10480165918,-128634669
1637589278,-183626,true,10607739813,22,10479118006,-128621807
1637589562,-183626,true,10607739813,22,10460273501,-147466312
1637589617,-183624,true,10609861467,22,10456090438,-153771029
1637589754,-183624,true,10609861467,22,10456090438,-153771029
1637589756,-183625,true,10608800587,22,10456090438,-152710149
1637589793,-183624,true,10609861467,22,10457136047,-152725420
1637590366,-183616,true,10618352327,22,10562226731,-56125596
1637590550,-183615,true,10619414163,22,10606679145,-12735018
1637590585,-183616,true,10618352327,22,10617290598,-1061729
1637591293,-183615,true,10619414163,22,10691868622,72454459
1637591424,-183607,true,10627912668,22,10699355176,71442508
1637592899,-183608,true,10626849983,22,10699355176,72505193
1637593212,-183608,true,10626849983,22,10697215626,70365643
1637593321,-183608,true,10626849983,22,10696146011,69296028
1637593589,-183601,true,10634291010,22,10674776165,40485155
1637593775,-183602,true,10633227687,22,10657711032,24483345
1637594424,-183603,true,10632164471,22,10623662566,-8501905
1637594661,-183604,true,10631101361,22,10624724932,-6376429
1637594963,-183603,true,10632164471,22,10600317364,-31847107
1637595755,-183607,true,10627912668,22,10551670311,-76242357
1637596101,-183611,true,10623662566,22,10548505443,-75157123
1637596401,-183613,true,10621538152,22,10544287095,-77251057
1637597405,-183612,true,10622600305,22,10533748605,-88851700
1637597770,-183615,true,10619414163,22,10532695335,-86718828
1637597841,-183619,true,10615167459,22,10532695335,-82472124
1637598214,-183621,true,10613044744,22,10528483310,-84561434
1637598557,-183620,true,10614106048,22,10524272970,-89833078
1637598576,-183623,true,10610922453,22,10524272970,-86649483
1637598890,-183627,true,10606679145,22,10523220648,-83458497
1637598960,-183628,true,10605618583,22,10524272970,-81345613
1637599404,-183626,true,10607739813,22,10527430567,-80309246
1637599475,-183630,true,10603497777,22,10528483310,-75014467
1637599600,-183633,true,10600317364,22,10531642171,-68675193
1637599887,-183633,true,10600317364,22,10540070434,-60246930
1637599956,-183631,true,10602437534,22,10539016533,-63421001
1637600464,-183635,true,10598197619,22,10526377930,-71819689
1637600813,-183639,true,10593959399,22,10510600987,-83358412
1637600837,-183640,true,10592900109,22,10510600987,-82299122
1637601206,-183637,true,10596078297,22,10513754483,-82323814
1637601943,-183642,true,10590781847,22,10514805858,-75975989
1637601967,-183645,true,10587605248,22,10514805858,-72799390
1637602052,-183646,true,10586546593,22,10514805858,-71740735
1637602100,-183644,true,10588664008,22,10513754483,-74909525
1637602126,-183648,true,10584429601,22,10513754483,-70675118
1637602188,-183653,true,10579138974,22,10507448437,-71690537
1637602238,-183654,true,10578081166,22,10501146174,-76934992
1637602317,-183652,true,10580196888,22,10495897176,-84299712
1637602352,-183657,true,10574908376,22,10493798311,-81110065
1637603476,-183660,true,10571736538,22,10452954238,-118782300
1637603564,-183662,true,10569622508,22,10452954238,-116668270
1637603572,-183660,true,10571736538,22,10452954238,-118782300
1637603801,-183664,true,10567508900,22,10465504684,-102004216
1637603873,-183667,true,10564339281,22,10467597890,-96741391
1637603895,-183670,true,10561170613,22,10468644650,-92525963
1637604151,-183669,true,10562226731,22,10471785557,-90441174
1637604266,-183673,true,10558002896,22,10473880019,-84122877
1637605342,-183679,true,10551670311,22,10387310902,-164359409
1637605593,-183682,true,10548505443,22,10386272275,-162233168
1637605930,-183682,true,10548505443,22,10379004791,-169500652
1637606069,-183687,true,10543232772,22,10385233751,-157999021
1637606303,-183692,true,10537962736,22,10392505596,-145457140
1637606494,-183695,true,10534801980,22,10398742659,-136059321
1637606535,-183694,true,10535855460,22,10399782533,-136072927
1637606542,-183698,true,10531642171,22,10399782533,-131859638
1637606728,-183703,true,10526377930,22,10416434670,-109943260
1637606803,-183703,true,10526377930,22,10424770735,-101607195
1637606904,-183701,true,10528483310,22,10431027162,-97456148
1637606989,-183705,true,10524272970,22,10432070264,-92202706
1637607114,-183709,true,10520064313,22,10436243719,-83820594
1637607117,-183709,true,10520064313,22,10436243719,-83820594
1637607158,-183708,true,10521116319,22,10435200199,-85916120
1637607227,-183712,true,10516908925,22,10434156783,-82752142
1637608055,-183715,true,10513754483,22,10445640096,-68114387
1637608097,-183716,true,10512703212,22,10447729328,-64973884
1637608126,-183714,true,10514805858,22,10448774101,-66031757
1637608129,-183718,true,10510600987,22,10449818979,-60782008
1637608478,-183721,true,10507448437,22,10446684660,-60763777
1637608614,-183721,true,10507448437,22,10445640096,-61808341
1637608746,-183720,true,10508499182,22,10442507030,-65992152
1637609335,-183722,true,10506397798,22,10467597890,-38799908
1637609411,-183725,true,10503246509,22,10479118006,-24128503
1637609868,-183724,true,10504296833,22,10521116319,16819486
1637610015,-183721,true,10507448437,22,10529536159,22087722
1637610151,-183722,true,10506397798,22,10536909046,30511248
1637610427,-183724,true,10504296833,22,10536909046,32612213
1637610789,-183722,true,10506397798,22,10534801980,28404182
1637611004,-183720,true,10508499182,22,10512703212,4204030
1637611360,-183720,true,10508499182,22,10505347263,-3151919
1637611579,-183722,true,10506397798,22,10517960615,11562817
1637611731,-183720,true,10508499182,22,10529536159,21036977
1637612329,-183714,true,10514805858,22,10583371264,68565406
1637612538,-183714,true,10514805858,22,10583371264,68565406
1637613246,-183716,true,10512703212,22,10595018795,82315583
1637613404,-183714,true,10514805858,22,10595018795,80212937
1637613560,-183714,true,10514805858,22,10590781847,75975989
1637613615,-183716,true,10512703212,22,10589722875,77019663
1637613843,-183718,true,10510600987,22,10583371264,72770277
1637613879,-183718,true,10510600987,22,10582313033,71712046
1637613893,-183719,true,10509550032,22,10581254907,71704875
1637613927,-183721,true,10507448437,22,10580196888,72748451
1637614047,-183723,true,10505347263,22,10575965867,70618604
1637614186,-183724,true,10504296833,22,10570679470,66382637
1637614201,-183725,true,10503246509,22,10570679470,67432961
1637614361,-183725,true,10503246509,22,10567508900,64262391
1637614557,-183726,true,10502196289,22,10564339281,62142992
1637615025,-183727,true,10501146174,22,10546396058,45249884
1637615531,-183728,true,10500096165,22,10528483310,28387145
1637615687,-183727,true,10501146174,22,10526377930,25231756
1637615856,-183728,true,10500096165,22,10523220648,23124483
1637615914,-183728,true,10500096165,22,10523220648,23124483
1637615956,-183728,true,10500096165,22,10522168431,22072266
1637615989,-183728,true,10500096165,22,10521116319,21020154
1637616087,-183729,true,10499046260,22,10519012411,19966151
1637616405,-183730,true,10497996460,22,10511652047,13655587
1637618390,-183725,true,10503246509,22,10624724932,121478423
1637618481,-183725,true,10503246509,22,10623662566,120416057
1637618949,-183725,true,10503246509,22,10628975459,125728950
1637619502,-183725,true,10503246509,22,10631101361,127854852
1637619591,-183721,true,10507448437,22,10628975459,121527022
1637620195,-183720,true,10508499182,22,10619414163,110914981
1637620569,-183721,true,10507448437,22,10611983545,104535108
1637620635,-183722,true,10506397798,22,10610922453,104524655
1637621236,-183718,true,10510600987,22,10603497777,92896790
1637621943,-183718,true,10510600987,22,10546396058,35795071
1637622049,-183720,true,10508499182,22,10539016533,30517351
1637622161,-183720,true,10508499182,22,10534801980,26302798
1637622506,-183717,true,10511652047,22,10541124441,29472394
1637623259,-183717,true,10511652047,22,10534801980,23149933
1637623757,-183719,true,10509550032,22,10529536159,19986127
1637624450,-183719,true,10509550032,22,10523220648,13670616
1637624933,-183717,true,10511652047,22,10511652047,0
1637625084,-183717,true,10511652047,22,10508499182,-3152865
1637625309,-183718,true,10510600987,22,10502196289,-8404698
1637625633,-183717,true,10511652047,22,10495897176,-15754871
1637625789,-183714,true,10514805858,22,10493798311,-21007547
1637626370,-183715,true,10513754483,22,10471785557,-41968926
1637626797,-183717,true,10511652047,22,10459227579,-52424468
1637627922,-183717,true,10511652047,22,10443551281,-68100766
1637628080,-183714,true,10514805858,22,10442507030,-72298828
1637628123,-183716,true,10512703212,22,10443551281,-69151931
1637629378,-183719,true,10509550032,22,10445640096,-63909936
1637629454,-183719,true,10509550032,22,10445640096,-63909936
1637629660,-183716,true,10512703212,22,10445640096,-67063116
1637630112,-183717,true,10511652047,22,10445640096,-66011951
1637630483,-183717,true,10511652047,22,10444595636,-67056411
1637630500,-183718,true,10510600987,22,10444595636,-66005351
1637630834,-183714,true,10514805858,22,10434156783,-80649075
1637630904,-183715,true,10513754483,22,10434156783,-79597700
1637631005,-183715,true,10513754483,22,10436243719,-77510764
1637631129,-183716,true,10512703212,22,10438331072,-74372140
1637631798,-183712,true,10516908925,22,10457136047,-59772878
1637631840,-183713,true,10515857339,22,10457136047,-58721292
1637634180,-183715,true,10513754483,22,10435200199,-78554284
1637634626,-183716,true,10512703212,22,10434156783,-78546429
1637634707,-183713,true,10515857339,22,10432070264,-83787075
1637635028,-183714,true,10514805858,22,10431027162,-83778696
1637635242,-183715,true,10513754483,22,10460273501,-53480982
1637635578,-183714,true,10514805858,22,10505347263,-9458595
1637635782,-183710,true,10519012411,22,10531642171,12629760
1637635886,-183708,true,10521116319,22,10544287095,23170776
1637637960,-183711,true,10517960615,22,10526377930,8417315
1637638032,-183710,true,10519012411,22,10534801980,15789569
1637638679,-183705,true,10524272970,22,10607739813,83466843
1637638709,-183704,true,10525325397,22,10610922453,85597056
1637638852,-183703,true,10526377930,22,10615167459,88789529
1637638931,-183703,true,10526377930,22,10607739813,81361883
1637639511,-183700,true,10529536159,22,10551670311,22134152
1637639571,-183700,true,10529536159,22,10545341524,15805365
1637639678,-183701,true,10528483310,22,10541124441,12641131
1637639732,-183702,true,10527430567,22,10540070434,12639867
1637639849,-183699,true,10530589112,22,10540070434,9481322
1637639902,-183700,true,10529536159,22,10540070434,10534275
1637640329,-183701,true,10528483310,22,10531642171,3158861
1637640428,-183702,true,10527430567,22,10531642171,4211604
1637641130,-183699,true,10530589112,22,10535855460,5266348
1637641174,-183700,true,10529536159,22,10533748605,4212446
1637641183,-183700,true,10529536159,22,10533748605,4212446
1637641325,-183701,true,10528483310,22,10532695335,4212025
1637641373,-183701,true,10528483310,22,10531642171,3158861
1637641681,-183703,true,10526377930,22,10516908925,-9469005
1637642292,-183704,true,10525325397,22,10491699867,-33625530
1637642406,-183706,true,10523220648,22,10491699867,-31520781
1637642752,-183705,true,10524272970,22,10492749036,-31523934
1637643152,-183707,true,10522168431,22,10490650801,-31517630
1637643217,-183708,true,10521116319,22,10489601841,-31514478
1637643391,-183709,true,10520064313,22,10497996460,-22067853
1637643441,-183708,true,10521116319,22,10501146174,-19970145
1637643652,-183709,true,10520064313,22,10514805858,-5258455
1637643804,-183709,true,10520064313,22,10524272970,4208657
1637643898,-183709,true,10520064313,22,10530589112,10524799
1637643993,-183709,true,10520064313,22,10535855460,15791147
1637644252,-183710,true,10519012411,22,10545341524,26329113
1637644564,-183710,true,10519012411,22,10537962736,18950325
1637645008,-183710,true,10519012411,22,10527430567,8418156
1637645743,-183709,true,10520064313,22,10520064313,0
1637645778,-183710,true,10519012411,22,10517960615,-1051796
1637646194,-183711,true,10517960615,22,10500096165,-17864450
1637646216,-183711,true,10517960615,22,10500096165,-17864450
1637646338,-183711,true,10517960615,22,10493798311,-24162304
1637647021,-183712,true,10516908925,22,10474927407,-41981518
1637647061,-183712,true,10516908925,22,10473880019,-43028906
1637647205,-183712,true,10516908925,22,10471785557,-45123368
1637647274,-183717,true,10511652047,22,10466551235,-45100812
1637647542,-183718,true,10510600987,22,10465504684,-45096303
1637648730,-183718,true,10510600987,22,10489601841,-20999146
1637649158,-183718,true,10510600987,22,10486455590,-24145397
1637649288,-183723,true,10505347263,22,10486455590,-18891673
1637649302,-183724,true,10504296833,22,10486455590,-17841243
1637649926,-183724,true,10504296833,22,10485407049,-18889784
1637650191,-183724,true,10504296833,22,10481213935,-23082898
1637650460,-183728,true,10500096165,22,10477022497,-23073668
1637650668,-183728,true,10500096165,22,10473880019,-26216146
1637650792,-183728,true,10500096165,22,10472832736,-27263429
1637650989,-183728,true,10500096165,22,10470738483,-29357682
1637651106,-183731,true,10496946766,22,10470738483,-26208283
1637651530,-183731,true,10496946766,22,10469691514,-27255252
1637651554,-183731,true,10496946766,22,10469691514,-27255252
1637651628,-183731,true,10496946766,22,10468644650,-28302116
1637651769,-183734,true,10493798311,22,10468644650,-25153661
1637651878,-183733,true,10494847691,22,10467597890,-27249801
1637652291,-183733,true,10494847691,22,10460273501,-34574190
1637652358,-183732,true,10495897176,22,10458181760,-37715416
1637652453,-183736,true,10491699867,22,10456090438,-35609429
1637652794,-183735,true,10492749036,22,10450863961,-41885075
1637652972,-183734,true,10493798311,22,10450863961,-42934350
1637653243,-183733,true,10494847691,22,10449818979,-45028712
1637653386,-183735,true,10492749036,22,10450863961,-41885075
1637653933,-183735,true,10492749036,22,10447729328,-45019708
1637654071,-183734,true,10493798311,22,10447729328,-46068983
1637654127,-183732,true,10495897176,22,10446684660,-49212516
1637654692,-183735,true,10492749036,22,10446684660,-46064376
1637654955,-183734,true,10493798311,22,10447729328,-46068983
1637655129,-183734,true,10493798311,22,10448774101,-45024210
1637655661,-183732,true,10495897176,22,10447729328,-48167848
1637655684,-183735,true,10492749036,22,10446684660,-46064376
1637655928,-183735,true,10492749036,22,10415393131,-77355905
1637656664,-183736,true,10491699867,22,10334473109,-157226758
1637657205,-183737,true,10490650801,22,10330340353,-160310448
1637657921,-183741,true,10486455590,22,10328274595,-158180995
1637658064,-183741,true,10486455590,22,10328274595,-158180995
1637658477,-183741,true,10486455590,22,10327241871,-159213719
1637658555,-183742,true,10485407049,22,10332406524,-153000525
1637658703,-183744,true,10483310282,22,10343777856,-139532426
1637659449,-183745,true,10482262056,22,10328274595,-153987461
1637660026,-183747,true,10480165918,22,10314857232,-165308686
1637661141,-183750,true,10477022497,22,10305578500,-171443997
1637661201,-183753,true,10473880019,22,10304548046,-169331973
1637661216,-183756,true,10470738483,22,10304548046,-166190437
1637662479,-183757,true,10469691514,22,10300427257,-169264257
1637662942,-183760,true,10466551235,22,10303517694,-163033541
1637663039,-183764,true,10462365661,22,10301457299,-160908362
1637663050,-183767,true,10459227579,22,10300427257,-158800322
1637665014,-183772,true,10453999533,22,10259309893,-194689640
1637666714,-183775,true,10450863961,22,10260335824,-190528137
1637667066,-183777,true,10448774101,22,10251106137,-197667964
1637668960,-183780,true,10445640096,22,10225511658,-220128438
1637669078,-183785,true,10440418842,22,10224489209,-215929633
1637669197,-183789,true,10436243719,22,10222444618,-213799101
1637669207,-183791,true,10434156783,22,10222444618,-211712165
1637669261,-183794,true,10431027162,22,10222444618,-208582544
1637669387,-183799,true,10425813212,22,10218356662,-207456550
1637669824,-183803,true,10421643930,22,10206102601,-215541329
1637669856,-183805,true,10419559913,22,10205082092,-214477821
1637670150,-183808,true,10416434670,22,10201001080,-215433590
1637670333,-183814,true,10410186997,22,10199981082,-210205915
1637670540,-183818,true,10406023963,22,10199981082,-206042881
1637670592,-183819,true,10404983464,22,10198961186,-206022278
1637671442,-183822,true,10401862593,22,10192843950,-209018643
1637671492,-183827,true,10396663222,22,10191824768,-204838454
1637671705,-183831,true,10392505596,22,10201001080,-191504516
1637672128,-183831,true,10392505596,22,10237789023,-154716573
1637673634,-183832,true,10391466450,22,10258284065,-133182385
1637673913,-183837,true,10386272275,22,10253156461,-133115814
1637673977,-183841,true,10382118804,22,10251106137,-131012667
1637674313,-183842,true,10381080696,22,10241884753,-139195943
1637674965,-183846,true,10376929302,22,10230625436,-146303866
1637675241,-183851,true,10371742393,22,10220400436,-151341957
1637675249,-183855,true,10367594733,22,10220400436,-147194297
1637675262,-183857,true,10365521525,22,10219378498,-146143027
1637675840,-183861,true,10361376353,22,10185711813,-175664540
1637675882,-183867,true,10355161703,22,10184693343,-170468360
1637676563,-183870,true,10352055775,22,10188767832,-163287943
1637676803,-183872,true,10349985675,22,10190805687,-159179988
1637677050,-183876,true,10345846715,22,10177566909,-168279806
1637677652,-183882,true,10339641379,22,10151140925,-188500454
1637678142,-183886,true,10335506556,22,10156217510,-179289046
1637678251,-183886,true,10335506556,22,10156217510,-179289046
1637678354,-183890,true,10331373387,22,10154186572,-177186815
1637679133,-183897,true,10324144318,22,10116687372,-207456946
1637679789,-183904,true,10316920306,22,10010022144,-306898162
1637679825,-183904,true,10316920306,22,10004018232,-312902074
1637680107,-183909,true,10311763393,22,9972058135,-339705258
1637680251,-183920,true,10300427257,22,9972058135,-328369122
1637680739,-183927,true,10293219841,22,9954125471,-339094370
1637680921,-183928,true,10292190622,22,9945171236,-347019386
1637681006,-183934,true,10286017468,22,9930265407,-355752061
1637681249,-183946,true,10273682266,22,9898540930,-375141336
1637681373,-183955,true,10264440574,22,9883704990,-380735584
1637681769,-183956,true,10263414232,22,9866917804,-396496428
1637682041,-183961,true,10258284065,22,9878764620,-379519445
1637682715,-183972,true,10247006720,22,9889636696,-357370024
1637682815,-183981,true,10237789023,22,9888647831,-349141192
1637682828,-183982,true,10236765346,22,9888647831,-348117515
1637682995,-183987,true,10231648499,22,9889636696,-342011803
1637683893,-183999,true,10219378498,22,9860999725,-358378773
1637684100,-184008,true,10210185654,22,9858042017,-352143637
1637684200,-184009,true,10209164738,22,9857056311,-352108427
1637684502,-184014,true,10204061686,22,9855085195,-348976491
1637684588,-184026,true,10191824768,22,9856070704,-335754064
1637684996,-184035,true,10182656710,22,9860013723,-322642987
1637685076,-184035,true,10182656710,22,9860013723,-322642987
1637685229,-184041,true,10176549254,22,9858042017,-318507237
1637685382,-184052,true,10165361763,22,9856070704,-309291059
1637685433,-184062,true,10155201990,22,9855085195,-300116795
1637685440,-184063,true,10154186572,22,9853114474,-301072098
1637685934,-184070,true,10147081483,22,9803974311,-343107172
1637685953,-184083,true,10133899507,22,9795155145,-338744362
1637685982,-184093,true,10123771178,22,9790259036,-333512142
1637686220,-184094,true,10122758903,22,9758981841,-363777062
1637686718,-184103,true,10113652973,22,9727804568,-385848405
1637687611,-184115,true,10101524475,22,9726831885,-374692590
1637687756,-184126,true,10090419462,22,9713224528,-377194934
1637687828,-184127,true,10089410521,22,9707398633,-382011888
1637687851,-184135,true,10081342623,22,9705457444,-375885179
1637688170,-184148,true,10068246047,22,9679289360,-388956687
1637688335,-184157,true,10059189155,22,9664782035,-394407120
1637688491,-184158,true,10058183337,22,9651261482,-406921855
1637688653,-184166,true,10050140410,22,9649331520,-400808890
1637688757,-184179,true,10037084368,22,9646437299,-390647069
1637689046,-184189,true,10027052802,22,9636796165,-390256637
1637689144,-184191,true,10025047692,22,9631979212,-393068480
1637689342,-184199,true,10017031262,22,9624277095,-392754167
1637689541,-184212,true,10004018232,22,9615619575,-388398657
1637689766,-184221,true,9995019116,22,9609852222,-385166894
1637690743,-184224,true,9992021210,22,9580109293,-411911917
1637690841,-184232,true,9984031189,22,9581067304,-402963885
1637690924,-184245,true,9971061029,22,9582983613,-388077416
1637690947,-184254,true,9962091559,22,9582983613,-379107946
1637691034,-184256,true,9960099440,22,9584900306,-375199134
1637691124,-184264,true,9952134945,22,9586817381,-365317564
1637691248,-184276,true,9940200142,22,9588734841,-351465301
1637691628,-184284,true,9932251559,22,9592570910,-339680649
1637691708,-184286,true,9930265407,22,9592570910,-337694497
1637691755,-184294,true,9922324768,22,9591611749,-330713019
1637692010,-184306,true,9910425714,22,9587776063,-322649651
1637692363,-184314,true,9902500940,22,9586817381,-315683559
1637692572,-184316,true,9900520737,22,9586817381,-313703356
1637692774,-184323,true,9893593144,22,9586817381,-306775763
1637692942,-184334,true,9882716718,22,9585858796,-296857922
1637692985,-184342,true,9874814102,22,9583941911,-290872191
1637693013,-184344,true,9872839435,22,9582025410,-290814025
1637693040,-184352,true,9864944716,22,9581067304,-283877412
1637693190,-184364,true,9853114474,22,9575320675,-277793799
1637693231,-184372,true,9845235528,22,9572448653,-272786875
1637693384,-184375,true,9842282548,22,9560013176,-282269372
1637693472,-184382,true,9835395705,22,9557145746,-278249959
1637693531,-184394,true,9823600899,22,9558101460,-265499439
1637693639,-184402,true,9815745553,22,9561925275,-253820278
1637693750,-184404,true,9813782699,22,9559057271,-254725428
1637693913,-184413,true,9804954709,22,9560013176,-244941533
1637694342,-184426,true,9792217186,22,9572448653,-219768533
1637694518,-184434,true,9784386936,22,9565750618,-218636318
1637694926,-184436,true,9782430352,22,9562881467,-219548885
1637695131,-184444,true,9774607928,22,9563837755,-210770173
1637695283,-184455,true,9763862308,22,9578193558,-185668750
1637695336,-184463,true,9756054732,22,9582025410,-174029322
1637695536,-184463,true,9756054732,22,9597368155,-158686577
1637695615,-184469,true,9750203147,22,9603128016,-147075131
1637695651,-184480,true,9739484356,22,9606009242,-133475114
1637695771,-184488,true,9731696274,22,9615619575,-116076699
1637695785,-184489,true,9730723201,22,9616581137,-114142064
1637696123,-184498,true,9721969928,22,9583941911,-138028017
1637696278,-184509,true,9711282175,22,9573405898,-137876277
1637696825,-184516,true,9704486995,22,9561925275,-142561720
1637696890,-184516,true,9704486995,22,9567663864,-136823131
1637696931,-184525,true,9695757322,22,9571491504,-124265818
1637697083,-184535,true,9686066896,22,9581067304,-104999592
1637697201,-184538,true,9683161657,22,9579151378,-104010279
1637697603,-184539,true,9682193437,22,9567663864,-114529573
1637697622,-184546,true,9675418612,22,9566707194,-108711418
1637697697,-184554,true,9667681759,22,9565750618,-101931141
1637697831,-184557,true,9664782035,22,9561925275,-102856760
1637697869,-184557,true,9664782035,22,9560013176,-104768859
1637697888,-184564,true,9658019393,22,9560013176,-98006217
1637697999,-184569,true,9653191831,22,9560969178,-92222653
1637698120,-184570,true,9652226609,22,9565750618,-86475991
1637698381,-184570,true,9652226609,22,9576278207,-75948402
1637698629,-184576,true,9646437299,22,9601207678,-45229621
1637699120,-184581,true,9641615527,22,9634869095,-6746432
1637699248,-184582,true,9640651462,22,9642579689,1928227
1637699386,-184581,true,9641615527,22,9643543947,1928420
1637699719,-184588,true,9634869095,22,9640651462,5782367
1637699832,-184593,true,9630053105,22,9629090196,-962909
1637699925,-184594,true,9629090196,22,9619466400,-9623796
1637700144,-184594,true,9629090196,22,9595448969,-33641227
1637700291,-184602,true,9621390389,22,9578193558,-43196831
1637701073,-184607,true,9616581137,22,9541867303,-74713834
1637701543,-184609,true,9614658109,22,9540913211,-73744898
1637702054,-184609,true,9614658109,22,9539005315,-75652794
1637702095,-184617,true,9606969843,22,9539005315,-67964528
1637702139,-184622,true,9602167799,22,9538051510,-64116289
1637702183,-184623,true,9601207678,22,9538051510,-63156168
1637702300,-184624,true,9600247653,22,9536144186,-64103467
1637702361,-184630,true,9594489520,22,9535190666,-59298854
1637702433,-184634,true,9590652684,22,9534237243,-56415441
1637702746,-184634,true,9590652684,22,9526613284,-64039400
1637702834,-184635,true,9589693714,22,9524708247,-64985467
1637702882,-184639,true,9585858796,22,9522803591,-63055205
1637702922,-184643,true,9582025410,22,9521851406,-60174004
1637703016,-184644,true,9581067304,22,9518995422,-62071882
1637703028,-184645,true,9580109293,22,9518995422,-61113871
1637703213,-184648,true,9577235835,22,9518995422,-58240413
1637703349,-184649,true,9576278207,22,9519947321,-56330886
1637703473,-184650,true,9575320675,22,9520899316,-54421359
1637703579,-184650,true,9575320675,22,9520899316,-54421359
1637703629,-184654,true,9571491504,22,9520899316,-50592188
1637704082,-184655,true,9570534450,22,9520899316,-49635134
1637704108,-184656,true,9569577493,22,9518043618,-51533875
1637704939,-184656,true,9569577493,22,9491431700,-78145793
1637705002,-184660,true,9565750618,22,9496178365,-69572253
1637705056,-184661,true,9564794139,22,9499977406,-64816733
1637705057,-184661,true,9564794139,22,9500927404,-63866735
1637705179,-184658,true,9567663864,22,9509481660,-58182204
1637705342,-184661,true,9564794139,22,9521851406,-42942733
1637705513,-184661,true,9564794139,22,9543775772,-21018367
1637705520,-184661,true,9564794139,22,9542821489,-21972650
1637705767,-184659,true,9566707194,22,9562881467,-3825727
1637705910,-184662,true,9563837755,22,9567663864,3826109
1637706366,-184663,true,9562881467,22,9558101460,-4780007
1637706719,-184663,true,9562881467,22,9553323843,-9557624
1637707004,-184661,true,9564794139,22,9553323843,-11470296
1637707239,-184664,true,9561925275,22,9551413465,-10511810
1637707287,-184665,true,9560969178,22,9550458419,-10510759
1637707294,-184665,true,9560969178,22,9550458419,-10510759
1637707328,-184663,true,9562881467,22,9549503469,-13377998
1637707339,-184666,true,9560013176,22,9550458419,-9554757
1637707367,-184665,true,9560969178,22,9553323843,-7645335
1637707546,-184663,true,9562881467,22,9567663864,4782397
1637707991,-184661,true,9564794139,22,9601207678,36413539
1637708230,-184663,true,9562881467,22,9619466400,56584933
1637708802,-184662,true,9563837755,22,9610813207,46975452
1637708825,-184660,true,9565750618,22,9609852222,44101604
1637708926,-184657,true,9568620631,22,9608891333,40270702
1637709594,-184660,true,9565750618,22,9589693714,23943096
1637709957,-184660,true,9565750618,22,9583941911,18191293
1637710576,-184659,true,9566707194,22,9562881467,-3825727
1637710771,-184658,true,9567663864,22,9556190127,-11473737
1637711138,-184662,true,9563837755,22,9549503469,-14334286
1637711312,-184661,true,9564794139,22,9547593855,-17200284
1637711523,-184660,true,9565750618,22,9541867303,-23883315
1637711690,-184659,true,9566707194,22,9537097800,-29609394
1637711862,-184663,true,9562881467,22,9532330681,-30550786
1637711932,-184663,true,9562881467,22,9537097800,-25783667
1637712004,-184662,true,9563837755,22,9540913211,-22924544
1637712461,-184661,true,9564794139,22,9569577493,4783354
1637712548,-184665,true,9560969178,22,9582983613,22014435
1637712735,-184664,true,9561925275,22,9611774289,49849014
1637712865,-184662,true,9563837755,22,9631979212,68141457
1637712974,-184658,true,9567663864,22,9649331520,81667656
1637713221,-184657,true,9568620631,22,9688973006,120352375
1637713808,-184655,true,9570534450,22,9732669443,162134993
1637713892,-184654,true,9571491504,22,9732669443,161177939
1637714023,-184650,true,9575320675,22,9731696274,156375599
1637714130,-184650,true,9575320675,22,9729750226,154429551
1637714510,-184650,true,9575320675,22,9703516644,128195969
1637714747,-184649,true,9576278207,22,9688004206,111725999
1637714781,-184644,true,9581067304,22,9682193437,101126133
1637715380,-184646,true,9579151378,22,9642579689,63428311
1637715937,-184646,true,9579151378,22,9608891333,29739955
1637716066,-184645,true,9580109293,22,9616581137,36471844
1637716602,-184640,true,9584900306,22,9665748513,80848207
1637716710,-184642,true,9582983613,22,9674451167,91467554
1637716795,-184641,true,9583941911,22,9676386154,92444243
1637716910,-184642,true,9582983613,22,9670582354,87598741
1637717140,-184639,true,9585858796,22,9646437299,60578503
1637717384,-184642,true,9582983613,22,9615619575,32635962
1637717429,-184643,true,9582025410,22,9610813207,28787797
1637717551,-184643,true,9582025410,22,9606969843,24944433
1637717833,-184640,true,9584900306,22,9619466400,34566094
1637718047,-184642,true,9582983613,22,9624277095,41293482
1637718437,-184643,true,9582025410,22,9629090196,47064786
1637718684,-184642,true,9582983613,22,9613696740,30713127
1637719285,-184639,true,9585858796,22,9616581137,30722341
1637719746,-184639,true,9585858796,22,9621390389,35531593
1637719862,-184639,true,9585858796,22,9621390389,35531593
1637720180,-184639,true,9585858796,22,9620428347,34569551
1637720427,-184636,true,9588734841,22,9595448969,6714128
1637720453,-184637,true,9587776063,22,9588734841,958778
1637720701,-184639,true,9585858796,22,9546639191,-39219605
1637720796,-184641,true,9583941911,22,9528518702,-55423209
1637721045,-184639,true,9585858796,22,9482893681,-102965115
1637721095,-184640,true,9584900306,22,9474363343,-110536963
1637721480,-184643,true,9582025410,22,9446928860,-135096550
1637721779,-184645,true,9580109293,22,9439374716,-140734577
1637721932,-184643,true,9582025410,22,9435599910,-146425500
1637722005,-184644,true,9581067304,22,9434656445,-146410859
1637722019,-184647,true,9578193558,22,9433713073,-144480485
1637722126,-184648,true,9577235835,22,9437487125,-139748710
1637722385,-184646,true,9579151378,22,9445984261,-133167117
1637722441,-184647,true,9578193558,22,9446928860,-131264698
1637722728,-184650,true,9575320675,22,9456380041,-118940634
1637722926,-184651,true,9574363238,22,9463947793,-110415445
1637722954,-184649,true,9576278207,22,9461109177,-115169030
1637722968,-184650,true,9575320675,22,9463001493,-112319182
1637723080,-184652,true,9573405898,22,9471521602,-101884296
1637723094,-184652,true,9573405898,22,9472468754,-100937144
1637723262,-184648,true,9577235835,22,9480997387,-96238448
1637723336,-184649,true,9576278207,22,9484790355,-91487852
1637723672,-184651,true,9574363238,22,9503777967,-70585271
1637723912,-184651,true,9574363238,22,9513286023,-61077215
1637723952,-184651,true,9574363238,22,9507580049,-66783189
1637723966,-184652,true,9573405898,22,9504728345,-68677553
1637724001,-184656,true,9569577493,22,9496178365,-73399128
1637724050,-184661,true,9564794139,22,9489533698,-75260441
1637724227,-184657,true,9568620631,22,9482893681,-85726950
1637724370,-184658,true,9567663864,22,9471521602,-96142262
1637724789,-184662,true,9563837755,22,9432769796,-131067959
1637724799,-184666,true,9560013176,22,9429940531,-130072645
1637724821,-184663,true,9562881467,22,9430883525,-131997942
1637724830,-184664,true,9561925275,22,9431826614,-130098661
1637724877,-184665,true,9560969178,22,9439374716,-121594462
1637725046,-184668,true,9558101460,22,9456380041,-101721419
1637725325,-184665,true,9560969178,22,9476258310,-84710868
1637725486,-184666,true,9560013176,22,9489533698,-70479478
1637725558,-184668,true,9558101460,22,9496178365,-61923095
1637725604,-184673,true,9553323843,22,9499027504,-54296339
1637725866,-184671,true,9555234603,22,9500927404,-54307199
1637726048,-184672,true,9554279176,22,9495228842,-59050334
1637726111,-184674,true,9552368606,22,9493330081,-59038525
1637726188,-184679,true,9547593855,22,9491431700,-56162155
1637726671,-184676,true,9550458419,22,9488584840,-61873579
1637726876,-184678,true,9548548614,22,9489533698,-59014916
1637726897,-184679,true,9547593855,22,9489533698,-58060157
1637726930,-184683,true,9543775772,22,9487636076,-56139696
1637727049,-184682,true,9544730149,22,9479101472,-65628677
1637727051,-184683,true,9543775772,22,9479101472,-64674300
1637727071,-184684,true,9542821489,22,9479101472,-63720017
1637727361,-184688,true,9539005315,22,9467733940,-71271375
1637727824,-184686,true,9540913211,22,9438430873,-102482338
1637728185,-184688,true,9539005315,22,9431826614,-107178701
1637728210,-184689,true,9538051510,22,9432769796,-105281714
1637728386,-184693,true,9534237243,22,9445984261,-88252982
1637728468,-184692,true,9535190666,22,9452598434,-82592232
1637729084,-184693,true,9534237243,22,9504728345,-29508898
1637729206,-184694,true,9533283914,22,9505678818,-27605096
1637729513,-184699,true,9528518702,22,9505678818,-22839884
1637729628,-184700,true,9527565945,22,9505678818,-21887127
1637729879,-184702,true,9525660718,22,9505678818,-19981900
1637729905,-184705,true,9522803591,22,9505678818,-17124773
1637730264,-184710,true,9518043618,22,9501877497,-16166121
1637730667,-184712,true,9516140294,22,9496178365,-19961929
1637730694,-184713,true,9515188775,22,9499027504,-16161271
1637730773,-184714,true,9514237352,22,9503777967,-10459385
1637730795,-184718,true,9510432608,22,9501877497,-8555111
1637730950,-184719,true,9509481660,22,9502827685,-6653975
1637730989,-184720,true,9508530807,22,9503777967,-4752840
1637731062,-184720,true,9508530807,22,9505678818,-2851989
1637731095,-184724,true,9504728345,22,9506629386,1901041
1637731110,-184725,true,9503777967,22,9506629386,2851419
1637731274,-184727,true,9501877497,22,9503777967,1900470
1637731307,-184729,true,9499977406,22,9502827685,2850279
1637731696,-184733,true,9496178365,22,9480997387,-15180978
1637731727,-184732,true,9497127983,22,9480049382,-17078601
1637731949,-184734,true,9495228842,22,9464894188,-30334654
1637732096,-184736,true,9493330081,22,9457325679,-36004402
1637732179,-184740,true,9489533698,22,9455434497,-34099201
1637732265,-184740,true,9489533698,22,9454489049,-35044649
1637732347,-184743,true,9486687408,22,9453543694,-33143714
1637732359,-184744,true,9485738834,22,9454489049,-31249785
1637732453,-184747,true,9482893681,22,9459217239,-23676442
1637732541,-184747,true,9482893681,22,9458271411,-24622270
1637732571,-184749,true,9480997387,22,9458271411,-22725976
1637732716,-184751,true,9479101472,22,9456380041,-22721431
1637732876,-184756,true,9474363343,22,9455434497,-18928846
1637733955,-184755,true,9475310779,22,9424284547,-51026232
1637733999,-184757,true,9473416001,22,9414865443,-58550558
1637734012,-184757,true,9473416001,22,9409218501,-64197500
1637734139,-184761,true,9469627582,22,9353870317,-115757265
1637734237,-184774,true,9457325679,22,9313737029,-143588650
1637734272,-184777,true,9454489049,22,9301637643,-152851406
1637734413,-184774,true,9457325679,22,9265433709,-191891970
1637734550,-184775,true,9456380041,22,9231216656,-225163385
1637734554,-184786,true,9445984261,22,9230293627,-215690634
1637734924,-184788,true,9444095348,22,9154003048,-290092300
1637735359,-184786,true,9445984261,22,9184259641,-261724620
1637735712,-184788,true,9444095348,22,9176915539,-267179809
1637735738,-184800,true,9432769796,22,9175997939,-256771857
1637735770,-184803,true,9429940531,22,9174163015,-255777516
1637735792,-184801,true,9431826614,22,9170494267,-261332347
1637735965,-184802,true,9430883525,22,9173245690,-257637835
1637736087,-184813,true,9420515775,22,9174163015,-246352760
1637736101,-184816,true,9417690186,22,9174163015,-243527171
1637736153,-184815,true,9418631955,22,9179668889,-238963066
1637736255,-184816,true,9417690186,22,9187933896,-229756290
1637736375,-184826,true,9408277673,22,9199885379,-208392294
1637736392,-184829,true,9405455754,22,9201725448,-203730306
1637736465,-184827,true,9407336939,22,9209089406,-198247533
1637736741,-184828,true,9406396300,22,9245997685,-160398615
1637736924,-184837,true,9397934774,22,9263580901,-134353873
1637736947,-184840,true,9395115958,22,9264507259,-130608699
1637737016,-184837,true,9397934774,22,9265433709,-132501065
1637737101,-184834,true,9400754437,22,9260802382,-139952055
1637737527,-184848,true,9387603246,22,9236756771,-150846475
1637737607,-184851,true,9384787528,22,9231216656,-153570872
1637737954,-184847,true,9388542006,22,9217380902,-171161104
1637738050,-184845,true,9390419809,22,9219224471,-171195338
1637738058,-184858,true,9378220804,22,9219224471,-158996333
1637738259,-184861,true,9375407900,22,9210931316,-164476584
1637738272,-184861,true,9375407900,22,9210010315,-165397585
1637738306,-184861,true,9375407900,22,9208168589,-167239311
1637738469,-184875,true,9362292168,22,9198965483,-163326685
1637738597,-184878,true,9359484042,22,9192528782,-166955260
1637738741,-184878,true,9359484042,22,9183341307,-176142735
1637738867,-184878,true,9359484042,22,9175080431,-184403611
1637738913,-184891,true,9347325226,22,9170494267,-176830959
1637739121,-184894,true,9344521589,22,9161328814,-183192775
1637739280,-184894,true,9344521589,22,9160412773,-184108816
1637739383,-184894,true,9344521589,22,9158580965,-185940624
1637739513,-184907,true,9332382210,22,9159496823,-172885387
1637739544,-184910,true,9329583055,22,9159496823,-170086232
1637739679,-184911,true,9328650190,22,9155833940,-172816250
1637739794,-184910,true,9329583055,22,9152172522,-177410533
1637739825,-184923,true,9317463083,22,9151257396,-166205687
1637739938,-184925,true,9315599870,22,9147597808,-168002062
1637740004,-184926,true,9314668403,22,9144854078,-169814325
1637740053,-184926,true,9314668403,22,9143025381,-171643022
1637740283,-184938,true,9303498063,22,9135714251,-167783812
1637740309,-184940,true,9301637643,22,9133887382,-167750261
1637740530,-184941,true,9300707572,22,9130234741,-170472831
1637740747,-184942,true,9299777594,22,9129321808,-170455786
1637740774,-184955,true,9287696342,22,9129321808,-158374534
1637741263,-184957,true,9285839081,22,9157665198,-128173883
1637741761,-184957,true,9285839081,22,9179668889,-106170192
1637742028,-184958,true,9284910590,22,9177833230,-107077360
1637742031,-184970,true,9273775936,22,9177833230,-95942706
1637742088,-184973,true,9270994360,22,9175080431,-95913929
1637742225,-184974,true,9270067353,22,9165910395,-104156958
1637742355,-184976,true,9268213618,22,9155833940,-112379678
1637742481,-184989,true,9256173370,22,9144854078,-111319292
1637742565,-184992,true,9253397073,22,9139369085,-114027988
1637742722,-184993,true,9252471826,22,9128408968,-124062858
1637743107,-184996,true,9249696639,22,9105617586,-144079053
1637743134,-185009,true,9237680447,22,9104707115,-132973332
1637743209,-185012,true,9234909697,22,9103796735,-131112962
1637743290,-185013,true,9233986298,22,9108349544,-125636754
1637743633,-185014,true,9233062992,22,9123846132,-109216860
1637743689,-185028,true,9220146393,22,9126583560,-93562833
1637743758,-185029,true,9219224471,22,9129321808,-89902663
1637744202,-185029,true,9219224471,22,9143025381,-76199090
1637744624,-185030,true,9218302640,22,9132060879,-86241761
1637744702,-185044,true,9205406691,22,9132060879,-73345812
1637744901,-185044,true,9205406691,22,9142111170,-63295521
1637744949,-185044,true,9205406691,22,9144854078,-60552613
1637745047,-185044,true,9205406691,22,9149427419,-55979272
1637745097,-185057,true,9193448035,22,9151257396,-42190639
1637745579,-185058,true,9192528782,22,9168660443,-23868339
1637745776,-185058,true,9192528782,22,9170494267,-22034515
1637745796,-185059,true,9191609621,22,9170494267,-21115354
1637746150,-185072,true,9179668889,22,9173245690,-6423199
1637746232,-185073,true,9178751014,22,9169577309,-9173705
1637746254,-185073,true,9178751014,22,9168660443,-10090571
1637746269,-185072,true,9179668889,22,9167743668,-11925221
1637746279,-185087,true,9165910395,22,9165910395,0
1637746360,-185091,true,9162244947,22,9155833940,-6411007
1637746494,-185091,true,9162244947,22,9136627823,-25617124
1637746627,-185088,true,9164993895,22,9122021636,-42972259
1637746695,-185088,true,9164993895,22,9114727302,-50266593
1637746969,-185090,true,9163161171,22,9091060974,-72100197
1637747490,-185091,true,9162244947,22,9102886447,-59358500
1637747522,-185091,true,9162244947,22,9103796735,-58448212
1637747642,-185093,true,9160412773,22,9095607414,-64805359
1637747689,-185095,true,9158580965,22,9087425458,-71155507
1637747845,-185101,true,9153087739,22,9064736402,-88351337
1637747880,-185099,true,9154918448,22,9066549440,-88369008
1637748238,-185100,true,9154003048,22,9047530614,-106472434
1637748248,-185102,true,9152172522,22,9046625951,-105546571
1637748436,-185106,true,9148512568,22,9025843660,-122668908
1637749016,-185106,true,9148512568,22,9022234225,-126278343
1637749506,-185108,true,9146683140,22,9007810913,-138872227
1637749542,-185110,true,9144854078,22,9006910222,-137943856
1637749561,-185116,true,9139369085,22,9006009621,-133359464
1637749698,-185118,true,9137541485,22,8998808054,-138733431
1637750036,-185118,true,9137541485,22,9029454539,-108086946
1637750300,-185120,true,9135714251,22,9052960490,-82753761
1637750332,-185125,true,9131147764,22,9058393624,-72754140
1637750466,-185127,true,9129321808,22,9070176604,-59145204
1637750844,-185128,true,9128408968,22,9076527633,-51881335
1637750867,-185130,true,9126583560,22,9073805219,-52778341
1637750917,-185136,true,9121109525,22,9070176604,-50932921
1637751172,-185137,true,9120197506,22,9052055284,-68142222
1637751187,-185138,true,9119285577,22,9051150169,-68135408
1637751215,-185140,true,9117461994,22,9046625951,-70836043
1637751500,-185146,true,9111993431,22,9021332091,-90661340
1637751544,-185148,true,9110171305,22,9018626233,-91545072
1637751575,-185150,true,9108349544,22,9015921186,-92428358
1637751693,-185150,true,9108349544,22,9013216951,-95132593
1637751700,-185155,true,9103796735,22,9013216951,-90579784
1637751701,-185156,true,9102886447,22,9013216951,-89669496
1637751774,-185154,true,9104707115,22,9024038762,-80668353
1637751824,-185151,true,9107438800,22,9029454539,-77984261
1637751962,-185156,true,9102886447,22,9044816898,-58069549
1637752310,-185158,true,9101066143,22,9084699776,-16366367
1637752707,-185157,true,9101976249,22,9101976249,0
1637753164,-185154,true,9104707115,22,9100156127,-4550988
1637753185,-185159,true,9100156127,22,9101066143,910016
1637753380,-185160,true,9099246202,22,9121109525,21863323
1637753560,-185158,true,9101066143,22,9138455240,37389097
1637754036,-185151,true,9107438800,22,9212773594,105334794
1637754124,-185156,true,9102886447,22,9221990515,119104068
1637754276,-185156,true,9102886447,22,9230293627,127407180
1637754318,-185152,true,9106528148,22,9232139778,125611630
1637754376,-185146,true,9111993431,22,9237680447,125687016
1637754565,-185149,true,9109260379,22,9253397073,144136694
1637754690,-185148,true,9110171305,22,9257098987,146927682
1637754712,-185145,true,9112904630,22,9259876394,146971764
1637754774,-185138,true,9119285577,22,9263580901,144295324
1637754886,-185141,true,9116550339,22,9270067353,153517014
1637755058,-185140,true,9117461994,22,9278413752,160951758
1637755064,-185137,true,9120197506,22,9278413752,158216246
1637755109,-185131,true,9125670992,22,9283053886,157382894
1637755540,-185134,true,9122933839,22,9313737029,190803190
1637755658,-185132,true,9124758517,22,9323054959,198296442
1637755741,-185129,true,9127496218,22,9324919663,197423445
1637756015,-185123,true,9132974085,22,9330516014,197541929
1637756411,-185127,true,9129321808,22,9300707572,171385764
1637756772,-185124,true,9132060879,22,9274703314,142642435
1637757053,-185121,true,9134800771,22,9267286889,132486118
1637757177,-185116,true,9139369085,22,9269140439,129771354
1637757210,-185119,true,9136627823,22,9270067353,133439530
1637757274,-185116,true,9139369085,22,9270994360,131625275
1637757322,-185112,true,9143025381,22,9270994360,127968979
1637757665,-185107,true,9147597808,22,9271921459,124323651
1637757846,-185111,true,9143939684,22,9261728462,117788778
1637758096,-185111,true,9143939684,22,9249696639,105756955
1637758960,-185108,true,9146683140,22,9210931316,64248176
1637759220,-185104,true,9150342362,22,9212773594,62431232
1637759775,-185108,true,9146683140,22,9200805368,54122228
1637759946,-185107,true,9147597808,22,9205406691,57808883
1637760191,-185104,true,9150342362,22,9211852409,61510047
1637760241,-185100,true,9154003048,22,9219224471,65221423
1637760509,-185102,true,9152172522,22,9260802382,108629860
1637760616,-185101,true,9153087739,22,9276558347,123470608
1637760663,-185097,true,9156749524,22,9283982192,127232668
1637760715,-185092,true,9161328814,22,9289553974,128225160
1637760732,-185094,true,9159496823,22,9291411978,131915155
1637760856,-185094,true,9159496823,22,9300707572,141210749
1637761247,-185090,true,9163161171,22,9312805749,149644578
1637761377,-185086,true,9166826986,22,9303498063,136671077
1637761873,-185090,true,9163161171,22,9243224441,80063270
1637761942,-185090,true,9163161171,22,9235833188,72672017
1637762000,-185085,true,9167743668,22,9229370690,61627022
1637762063,-185079,true,9173245690,22,9222912714,49667024
1637762102,-185082,true,9170494267,22,9218302640,47808373
1637762128,-185082,true,9170494267,22,9215537703,45043436
1637762306,-185081,true,9171411316,22,9188852689,17441373
1637762433,-185076,true,9175997939,22,9176915539,917600
1637762615,-185079,true,9173245690,22,9172328457,-917233
1637762642,-185080,true,9172328457,22,9170494267,-1834190
1637762731,-185077,true,9175080431,22,9173245690,-1834741
1637762838,-185070,true,9181504914,22,9178751014,-2753900
1637762961,-185068,true,9183341307,22,9178751014,-4590293
1637762977,-185069,true,9182423065,22,9178751014,-3672051
1637763008,-185068,true,9183341307,22,9177833230,-5508077
1637763040,-185062,true,9188852689,22,9178751014,-10101675
1637763090,-185061,true,9189771575,22,9181504914,-8266661
1637763117,-185062,true,9188852689,22,9182423065,-6429624
1637763308,-185061,true,9189771575,22,9185178067,-4593508
1637763370,-185056,true,9194367380,22,9182423065,-11944315
1637763728,-185056,true,9194367380,22,9145768563,-48598817
1637763899,-185055,true,9195286816,22,9128408968,-66877848
1637764392,-185058,true,9192528782,22,9105617586,-86911196
1637764592,-185054,true,9196206345,22,9098336369,-97869976
1637764627,-185054,true,9196206345,22,9095607414,-100598931
1637765027,-185056,true,9194367380,22,9062923727,-131443653
1637765049,-185059,true,9191609621,22,9059299464,-132310157
1637765057,-185056,true,9194367380,22,9059299464,-135067916
1637765079,-185056,true,9194367380,22,9054771172,-139596208
1637765195,-185060,true,9190690552,22,9038488058,-152202494
1637765371,-185062,true,9188852689,22,9009612565,-179240124
1637765493,-185059,true,9191609621,22,8989814193,-201795428
1637765642,-185059,true,9191609621,22,8979033425,-212576196
1637765692,-185062,true,9188852689,22,8974545255,-214307434
1637765743,-185064,true,9187015195,22,8969162412,-217852783
1637765816,-185061,true,9189771575,22,8963782798,-225988777
1637765876,-185063,true,9187933896,22,8956614997,-231318899
1637765996,-185066,true,9185178067,22,8956614997,-228563070
1637766079,-185071,true,9180586856,22,8957510659,-223076197
1637766099,-185070,true,9181504914,22,8957510659,-223994255
1637766214,-185070,true,9181504914,22,8961094201,-220410713
1637766283,-185073,true,9178751014,22,8961094201,-217656813
1637766474,-185077,true,9175080431,22,8967368849,-207711582
1637766757,-185076,true,9175997939,22,8981727405,-194270534
1637766901,-185076,true,9175997939,22,8987117789,-188880150
1637766923,-185080,true,9172328457,22,8985320635,-187007822
1637767216,-185086,true,9166826986,22,8966472201,-200354785
1637767282,-185090,true,9163161171,22,8965575644,-197585527
1637767342,-185091,true,9162244947,22,8964679176,-197565771
1637767417,-185094,true,9159496823,22,8963782798,-195714025
1637767594,-185100,true,9154003048,22,8960198181,-193804867
1637767706,-185103,true,9151257396,22,8955719425,-195537971
1637767730,-185105,true,9149427419,22,8955719425,-193707994
1637767820,-185109,true,9145768563,22,8957510659,-188257904
1637767998,-185114,true,9141197050,22,8974545255,-166651795
1637768127,-185118,true,9137541485,22,8984422192,-153119293
1637768185,-185120,true,9135714251,22,8986219167,-149495084
1637768231,-185124,true,9132060879,22,8983523840,-148537039
1637768468,-185131,true,9125670992,22,8969162412,-156508580
1637768923,-185134,true,9122933839,22,8971853430,-151080409
1637768936,-185137,true,9120197506,22,8971853430,-148344076
1637769358,-185142,true,9115638775,22,8988915302,-126723473
1637769492,-185148,true,9110171305,22,8988016500,-122154805
1637769494,-185151,true,9107438800,22,8988016500,-119422300
1637769579,-185152,true,9106528148,22,8998808054,-107720094
1637770043,-185153,true,9105617586,22,9043008206,-62609380
1637770272,-185159,true,9100156127,22,9055676650,-44479477
1637770328,-185161,true,9098336369,22,9057487875,-40848494
1637770434,-185163,true,9096516974,22,9058393624,-38123350
1637770949,-185168,true,9091970080,22,8982625577,-109344503
1637771068,-185175,true,9085608246,22,8969162412,-116445834
1637771342,-185178,true,9082883108,22,8935145968,-147737140
1637771442,-185179,true,9081974911,22,8920861879,-161113032
1637771472,-185185,true,9076527633,22,8917294426,-159233207
1637772085,-185193,true,9069269677,22,8853323676,-215946001
1637772132,-185197,true,9065642876,22,8842706590,-222936286
1637772228,-185199,true,9063830019,22,8824157317,-239672702
1637772319,-185205,true,9058393624,22,8812693938,-245699686
1637772456,-185218,true,9046625951,22,8793328290,-253297661
1637772489,-185222,true,9043008206,22,8789811838,-253196368
1637772527,-185228,true,9037584299,22,8780148843,-257435456
1637772565,-185235,true,9031260520,22,8774882597,-256377923
1637772658,-185249,true,9018626233,22,8762606971,-256019262
1637772710,-185254,true,9014118272,22,8753849181,-260269091
1637772715,-185258,true,9010513526,22,8752973884,-257539642
1637772983,-185267,true,9002408117,22,8704096658,-298311459
1637773018,-185280,true,8990713175,22,8705837564,-284875611
1637773046,-185285,true,8986219167,22,8703226335,-282992832
1637773151,-185286,true,8985320635,22,8709320421,-276000214
1637773186,-185291,true,8980829322,22,8711062373,-269766949
1637773217,-185303,true,8970059328,22,8713675953,-256383375
1637773246,-185306,true,8967368849,22,8713675953,-253692896
1637773354,-185309,true,8964679176,22,8716290317,-248388859
1637773389,-185315,true,8959302250,22,8714547320,-244754930
1637773498,-185326,true,8949452929,22,8716290317,-233162612
1637773532,-185328,true,8947663306,22,8715418775,-232244531
1637773614,-185329,true,8946768630,22,8729373908,-217394722
1637773635,-185334,true,8942296587,22,8733739468,-208557119
1637773722,-185344,true,8933359207,22,8744225722,-189133485
1637773741,-185348,true,8929786756,22,8746849252,-182937504
1637773773,-185351,true,8927108356,22,8750348517,-176759839
1637773839,-185357,true,8921753965,22,8756475598,-165278367
1637773861,-185366,true,8913728400,22,8760854712,-152873688
1637773925,-185369,true,8911054816,22,8760854712,-150200104
1637774082,-185373,true,8907491285,22,8754724566,-152766719
1637774139,-185380,true,8901258534,22,8748598709,-152659825
1637774182,-185389,true,8893251406,22,8744225722,-149025684
1637774364,-185393,true,8889694994,22,8727628296,-162066698
1637774397,-185398,true,8885251480,22,8724138117,-161113363
1637774483,-185405,true,8879034291,22,8704967067,-174067224
1637774503,-185414,true,8871047154,22,8699745915,-171301239
1637774639,-185419,true,8866612961,22,8670218480,-196394481
1637774649,-185423,true,8863067202,22,8668484696,-194582506
1637774685,-185429,true,8857751223,22,8662419184,-195332039
1637774722,-185436,true,8851553276,22,8656357915,-195195361
1637774734,-185440,true,8848013540,22,8653761527,-194252013
1637774754,-185445,true,8843590860,22,8648571087,-195019773
1637774773,-185448,true,8840938314,22,8644248098,-196690216
1637774815,-185456,true,8833868745,22,8636472163,-197396582
1637774839,-185461,true,8829453135,22,8631292093,-198161042
1637774880,-185466,true,8825039732,22,8622665546,-202374186
1637774971,-185469,true,8822392750,22,8603717480,-218675270
1637775233,-185477,true,8815338011,22,8572801325,-242536686
1637775345,-185482,true,8810931664,22,8563376900,-247554764
1637775556,-185486,true,8807408172,22,8564233237,-243174935
1637775638,-185490,true,8803886089,22,8556529280,-247356809
1637775669,-185498,true,8796846149,22,8554818231,-242027918
1637776142,-185500,true,8795087043,22,8620941272,-174145771
1637776190,-185503,true,8792449045,22,8627840439,-164608606
1637776255,-185506,true,8789811838,22,8636472163,-153339675
1637776272,-185514,true,8782783151,22,8642519508,-140263643
1637776286,-185514,true,8782783151,22,8644248098,-138535053
1637776575,-185518,true,8779270916,22,8682364679,-96906237
1637776613,-185520,true,8777515325,22,8684101239,-93414086
1637776817,-185527,true,8771373522,22,8691050952,-80322570
1637776930,-185527,true,8771373522,22,8692789249,-78584273
1637776997,-185530,true,8768742636,22,8696266886,-72475750
1637777249,-185530,true,8768742636,22,8731992983,-36749653
1637777443,-185537,true,8762606971,22,8756475598,-6131373
1637777524,-185536,true,8763483231,22,8762606971,-876260
1637777812,-185539,true,8760854712,22,8785418250,24563538
1637777857,-185541,true,8759102804,22,8789811838,30709034
1637778386,-185548,true,8752973884,22,8774005197,21031313
1637778412,-185548,true,8752973884,22,8774882597,21908713
1637778655,-185551,true,8750348517,22,8775760086,25411569
1637778848,-185552,true,8749473569,22,8754724566,5250997
1637778867,-185559,true,8743351387,22,8752973884,9622497
1637779304,-185561,true,8741602979,22,8715418775,-26184204
1637779485,-185564,true,8738981022,22,8714547320,-24433702
1637779502,-185565,true,8738107212,22,8714547320,-23559892
1637779611,-185573,true,8731119871,22,8721521399,-9598472
1637779671,-185572,true,8731992983,22,8727628296,-4364687
1637779741,-185577,true,8727628296,22,8727628296,0
1637779951,-185584,true,8721521399,22,8715418775,-6102624
1637780063,-185593,true,8713675953,22,8710191354,-3484599
1637780434,-185592,true,8714547320,22,8678024799,-36522521
1637780479,-185596,true,8711062373,22,8681496529,-29565844
1637780597,-185599,true,8708449577,22,8683232915,-25216662
1637780707,-185605,true,8703226335,22,8698876027,-4350308
1637780836,-185601,true,8706708148,22,8717161946,10453798
1637780885,-185605,true,8703226335,22,8715418775,12192440
1637781106,-185607,true,8701485951,22,8730246846,28760895
1637781192,-185612,true,8697136513,22,8735486304,38349791
1637781220,-185607,true,8701485951,22,8737233488,35747537
1637781400,-185610,true,8698876027,22,8735486304,36610277
1637781568,-185611,true,8698006226,22,8733739468,35733242
1637781844,-185611,true,8698006226,22,8741602979,43596753
1637781879,-185606,true,8702356099,22,8742477139,40121040
1637782094,-185607,true,8701485951,22,8752098674,50612723
1637782210,-185607,true,8701485951,22,8757351246,55865295
1637782642,-185608,true,8700615889,22,8756475598,55859709
1637782980,-185603,true,8704967067,22,8752973884,48006817
1637782992,-185605,true,8703226335,22,8754724566,51498231
1637783152,-185603,true,8704967067,22,8773127884,68160817
1637783248,-185603,true,8704967067,22,8783661430,78694363
1637783293,-185594,true,8712804672,22,8788932944,76128272
1637783796,-185596,true,8711062373,22,8877258751,166196378
1637783820,-185596,true,8711062373,22,8881698268,170635895
1637783837,-185595,true,8711933479,22,8885251480,173318001
1637784042,-185586,true,8719777356,22,8907491285,187713929
1637784160,-185587,true,8718905466,22,8908382034,189476568
1637784283,-185589,true,8717161946,22,8895919648,178757702
1637784553,-185588,true,8718033662,22,8862180984,144147322
1637784607,-185581,true,8724138117,22,8853323676,129185559
1637784694,-185584,true,8721521399,22,8848013540,126492141
1637784821,-185586,true,8719777356,22,8834752131,114974775
1637785079,-185587,true,8718905466,22,8824157317,105251851
1637785274,-185580,true,8725010531,22,8830336080,105325549
1637785385,-185582,true,8723265790,22,8838286562,115020772
1637785488,-185582,true,8723265790,22,8846244203,122978413
1637785519,-185583,true,8722393551,22,8848898341,126504790
1637785811,-185576,true,8728501058,22,8848898341,120397283
1637785893,-185576,true,8728501058,22,8848013540,119512482
1637786029,-185576,true,8728501058,22,8847128827,118627769
1637786118,-185576,true,8728501058,22,8848013540,119512482
1637786562,-185562,true,8740728906,22,8922646140,181917234
1637786794,-185560,true,8742477139,22,8962886509,220409370
1637786802,-185557,true,8745100145,22,8964679176,219579031
1637786816,-185556,true,8745974655,22,8967368849,221394194
1637786881,-185541,true,8759102804,22,8978135612,219032808
1637787058,-185540,true,8759978714,22,8997908263,237929549
1637787214,-185539,true,8760854712,22,8992511407,231656695
1637787732,-185537,true,8762606971,22,8977237888,214630917
1637787787,-185523,true,8774882597,22,8977237888,202355291
1637787967,-185521,true,8776637662,22,8979931329,203293667
1637788261,-185516,true,8781026858,22,9035777053,254750195
1637788285,-185511,true,8785418250,22,9041199875,255781625
1637788292,-185495,true,8799485467,22,9043008206,243522739
1637788574,-185489,true,8804766478,22,9115638775,310872297
1637788659,-185482,true,8810931664,22,9137541485,326609821
1637788732,-185477,true,8815338011,22,9155833940,340495929
1637788820,-185460,true,8830336080,22,9182423065,352086985
1637788844,-185454,true,8835635607,22,9191609621,355974014
1637788899,-185446,true,8842706590,22,9206327231,363620641
1637788916,-185440,true,8848013540,22,9209089406,361075866
1637788963,-185425,true,8861294855,22,9219224471,357929616
1637788972,-185419,true,8866612961,22,9221068408,354455447
1637789050,-185412,true,8872821453,22,9238604215,365782762
1637789158,-185407,true,8877258751,22,9255247845,377989094
1637789197,-185395,true,8887917322,22,9256173370,368256048
1637789314,-185390,true,8892362170,22,9260802382,368440212
1637789746,-185387,true,8895030145,22,9238604215,343574070
1637789966,-185382,true,8899478550,22,9198965483,299486933
1637789995,-185370,true,8910163800,22,9195286816,285123016
1637790027,-185366,true,8913728400,22,9191609621,277881221
1637790312,-185366,true,8913728400,22,9164993895,251265495
1637790440,-185364,true,8915511235,22,9159496823,243985588
1637790788,-185353,true,8925323202,22,9141197050,215873848
1637790936,-185349,true,8928893867,22,9130234741,201340874
1637791043,-185348,true,8929786756,22,9125670992,195884236
1637791090,-185346,true,8931572803,22,9123846132,192273329
1637791307,-185337,true,8939614434,22,9103796735,164182301
1637791703,-185334,true,8942296587,22,9070176604,127880017
1637791936,-185333,true,8943190817,22,9052055284,108864467
1637792005,-185330,true,8945874042,22,9048435367,102561325
1637792112,-185320,true,8954823943,22,9045721379,90897436
1637792727,-185319,true,8955719425,22,9001507967,45788542
1637792741,-185319,true,8955719425,22,9000607906,44888481
1637792794,-185317,true,8957510659,22,8997908263,40397604
1637792855,-185309,true,8964679176,22,8993410659,28731483
1637793258,-185307,true,8966472201,22,8979931329,13459128
1637793392,-185305,true,8968265585,22,8979931329,11665744
1637793503,-185301,true,8971853430,22,8977237888,5384458
1637793562,-185293,true,8979033425,22,8976340254,-2693171
1637793661,-185292,true,8979931329,22,8974545255,-5386074
1637793667,-185291,true,8980829322,22,8974545255,-6284067
1637793696,-185289,true,8982625577,22,8970059328,-12566249
1637795173,-185286,true,8985320635,22,8930679735,-54640900
1637796246,-185284,true,8987117789,22,8892362170,-94755619
1637796488,-185282,true,8988915302,22,8888806114,-100109188
1637797187,-185280,true,8990713175,22,8858636998,-132076177
1637797274,-185277,true,8993410659,22,8848013540,-145397119
1637797513,-185277,true,8993410659,22,8846244203,-147166456
1637797564,-185276,true,8994310000,22,8845359667,-148950333
1637797632,-185276,true,8994310000,22,8844475219,-149834781
1637797839,-185272,true,8997908263,22,8843590860,-154317403
1637797852,-185273,true,8997008562,22,8843590860,-153417702
1637798003,-185272,true,8997908263,22,8841822407,-156085856
1637798182,-185271,true,8998808054,22,8846244203,-152563851
1637798295,-185268,true,9001507967,22,8843590860,-157917107
1637798487,-185268,true,9001507967,22,8840054308,-161453659
1637798521,-185268,true,9001507967,22,8842706590,-158801377
1637798555,-185268,true,9001507967,22,8849783231,-151724736
1637798728,-185265,true,9004208689,22,8871934259,-132274430
1637798824,-185266,true,9003308358,22,8871934259,-131374099
1637798871,-185267,true,9002408117,22,8875483565,-126924552
1637798927,-185268,true,9001507967,22,8877258751,-124249216
1637799438,-185268,true,9001507967,22,8887028619,-114479348
1637799741,-185269,true,9000607906,22,8865726389,-134881517
1637799819,-185268,true,9001507967,22,8863067202,-138440765
1637799899,-185267,true,9002408117,22,8862180984,-140227133
1637799924,-185265,true,9004208689,22,8862180984,-142027705
1637800044,-185266,true,9003308358,22,8858636998,-144671360
1637800133,-185265,true,9004208689,22,8863953509,-140255180
1637800199,-185264,true,9005109110,22,8873708735,-131400375
1637800223,-185262,true,9006910222,22,8878146476,-128763746
1637800283,-185258,true,9010513526,22,8898588691,-111924835
1637800537,-185251,true,9016822778,22,8982625577,-34197201
1637800575,-185249,true,9018626233,22,8990713175,-27913058
1637800652,-185248,true,9019528096,22,9006910222,-12617874
1637800974,-185246,true,9021332091,22,9076527633,55195542
1637801097,-185240,true,9026746244,22,9099246202,72499958
1637801153,-185237,true,9029454539,22,9101976249,72521710
1637801289,-185240,true,9026746244,22,9101066143,74319899
1637801390,-185235,true,9031260520,22,9109260379,77999859
1637801670,-185231,true,9034873566,22,9134800771,99927205
1637801739,-185229,true,9036680631,22,9146683140,110002509
1637801839,-185229,true,9036680631,22,9178751014,142070383
1637801859,-185224,true,9041199875,22,9186096585,144896710
1637801915,-185213,true,9051150169,22,9207247864,156097695
1637801972,-185207,true,9056582217,22,9233986298,177404081
1637802184,-185201,true,9062017525,22,9334248780,272231255
1637802207,-185195,true,9067456095,22,9346390587,278934492
1637802227,-185185,true,9076527633,22,9358548187,282020554
1637802341,-185180,true,9081066804,22,9424284547,343217743
1637802459,-185175,true,9085608246,22,9475310779,389702533
1637802500,-185174,true,9086516807,22,9492380843,405864036
1637802528,-185167,true,9092879277,22,9502827685,409948408
1637802749,-185165,true,9094697944,22,9561925275,467227331
1637803008,-185162,true,9097426626,22,9533283914,435857288
1637803163,-185164,true,9095607414,22,9483841970,388234556
1637803560,-185159,true,9100156127,22,9406396300,306240173
1637803869,-185160,true,9099246202,22,9380096542,280850340
1637803877,-185160,true,9099246202,22,9379158626,279912424
1637803959,-185161,true,9098336369,22,9378220804,279884435
1637804240,-185159,true,9100156127,22,9350129704,249973577
1637804636,-185160,true,9099246202,22,9334248780,235002578
1637804768,-185159,true,9100156127,22,9324919663,224763536
1637804789,-185159,true,9100156127,22,9323987264,223831137
1637804822,-185153,true,9105617586,22,9321190627,215573041
1637804977,-185154,true,9104707115,22,9322122746,217415631
1637805002,-185152,true,9106528148,22,9323054959,216526811
1637805262,-185153,true,9105617586,22,9319326669,213709083
1637805455,-185146,true,9111993431,22,9311874561,199881130
1637805726,-185146,true,9111993431,22,9306289392,194295961
1637806043,-185145,true,9112904630,22,9275630784,162726154
1637806206,-185146,true,9111993431,22,9260802382,148808951
1637806232,-185139,true,9118373740,22,9258024697,139650957
1637806589,-185141,true,9116550339,22,9224757388,108207049
1637806603,-185138,true,9119285577,22,9223835005,104549428
1637806845,-185138,true,9119285577,22,9220146393,100860816
1637806891,-185131,true,9125670992,22,9221990515,96319523
1637807348,-185131,true,9125670992,22,9245073178,119402186
1637807474,-185128,true,9128408968,22,9249696639,121287671
1637807555,-185125,true,9131147764,22,9262654635,131506871
1637807607,-185116,true,9139369085,22,9274703314,135334229
1637807724,-185113,true,9142111170,22,9299777594,157666424
1637807784,-185107,true,9147597808,22,9316531430,168933622
1637808275,-185101,true,9153087739,22,9440318654,287230915
1637808334,-185092,true,9161328814,22,9455434497,294105683
1637808436,-185087,true,9165910395,22,9479101472,313191077
1637808501,-185081,true,9171411316,22,9492380843,320969527
1637808733,-185069,true,9182423065,22,9559057271,376634206
1637808797,-185059,true,9191609621,22,9570534450,378924829
1637808837,-185052,true,9198045678,22,9577235835,379190157
1637808895,-185044,true,9205406691,22,9587776063,382369372
1637808981,-185033,true,9215537703,22,9603128016,387590313
1637809004,-185022,true,9225679864,22,9607930540,382250676
1637809053,-185015,true,9232139778,22,9617542795,385403017
1637809081,-185004,true,9242300211,22,9626202047,383901836
1637809101,-184991,true,9254322413,22,9631016111,376693698
1637809199,-184980,true,9264507259,22,9656088078,391580819
1637809429,-184971,true,9272848651,22,9699636207,426787556
1637809633,-184960,true,9283053886,22,9717110401,434056515
1637809687,-184946,true,9296058613,22,9732669443,436610830
1637809702,-184934,true,9307220021,22,9737536751,430316730
1637809830,-184923,true,9317463083,22,9758981841,441518758
1637809832,-184911,true,9328650190,22,9758981841,430331651
1637809979,-184896,true,9342652965,22,9801033707,458380742
1637809997,-184883,true,9354805704,22,9805935204,451129500
1637810035,-184871,true,9366037647,22,9815745553,449707906
1637810050,-184861,true,9375407900,22,9819672440,444264540
1637810413,-184848,true,9387603246,22,9887659065,500055819
1637810435,-184836,true,9398874568,22,9891614722,492740154
1637810443,-184823,true,9411100439,22,9892603883,481503444
1637810478,-184811,true,9422399973,22,9894582503,472182530
1637810490,-184799,true,9433713073,22,9895571961,461858888
1637810526,-184788,true,9444095348,22,9896561519,452466171
1637810545,-184776,true,9455434497,22,9895571961,440137464
1637810588,-184764,true,9466787262,22,9889636696,422849434
1637810653,-184753,true,9477205936,22,9883704990,406499054
1637810705,-184744,true,9485738834,22,9880740471,395001637
1637810825,-184733,true,9496178365,22,9865931211,369752846
1637810839,-184723,true,9505678818,22,9861985825,356307007
1637810939,-184717,true,9511383651,22,9836379245,324995594
1637811019,-184715,true,9513286023,22,9818690571,305404548
1637811050,-184705,true,9522803591,22,9811820236,289016645
1637811101,-184694,true,9533283914,22,9805935204,272651290
1637811238,-184686,true,9540913211,22,9781452207,240538996
1637811337,-184681,true,9545684622,22,9762886019,217201397
1637811448,-184672,true,9554279176,22,9753128501,198849325
1637811481,-184662,true,9563837755,22,9751178168,187340413
1637811530,-184658,true,9567663864,22,9750203147,182539283
1637811769,-184653,true,9572448653,22,9750203147,177754494
1637811910,-184644,true,9581067304,22,9758981841,177914537
1637812105,-184635,true,9589693714,22,9762886019,173192305
1637812150,-184631,true,9593530167,22,9765815178,172285011
1637812266,-184632,true,9592570910,22,9759957739,167386829
1637812311,-184628,true,9596408514,22,9757030337,160621823
1637812468,-184626,true,9598327892,22,9758006040,159678148
1637812657,-184622,true,9602167799,22,9757030337,154862538
1637812689,-184625,true,9599287725,22,9757030337,157742612
1637812791,-184623,true,9601207678,22,9755079224,153871546
1637812808,-184621,true,9603128016,22,9755079224,151951208
1637812875,-184616,true,9607930540,22,9755079224,147148684
1637812929,-184617,true,9606969843,22,9756054732,149084889
1637813149,-184608,true,9615619575,22,9779496210,163876635
1637813222,-184604,true,9619466400,22,9789280108,169813708
1637813261,-184597,true,9626202047,22,9793196407,166994360
1637813378,-184597,true,9626202047,22,9802994012,176791965
1637813697,-184587,true,9635832582,22,9830479483,194646901
1637813781,-184582,true,9640651462,22,9835395705,194744243
1637813932,-184576,true,9646437299,22,9836379245,189941946
1637814192,-184574,true,9648366683,22,9832445677,184078994
1637814280,-184564,true,9658019393,22,9824583259,166563866
1637814404,-184560,true,9661883180,22,9810839152,148955972
1637814440,-184553,true,9668648527,22,9804954709,136306182
1637815112,-184556,true,9665748513,22,9702546389,36797876
1637816102,-184547,true,9674451167,22,9630053105,-44398062
1637816140,-184544,true,9677353793,22,9627164667,-50189126
1637816985,-184538,true,9683161657,22,9577235835,-105925822
1637817102,-184542,true,9679289360,22,9566707194,-112582166
1637817123,-184535,true,9686066896,22,9565750618,-120316278
1637817397,-184530,true,9690910898,22,9546639191,-144271707
1637817475,-184526,true,9694787844,22,9541867303,-152920541
1637817889,-184529,true,9691879989,22,9513286023,-178593966
1637817989,-184521,true,9699636207,22,9504728345,-194907862
1637818129,-184517,true,9703516644,22,9496178365,-207338279
1637818529,-184514,true,9706427990,22,9463947793,-242480197
1637818601,-184519,true,9701576231,22,9458271411,-243304820
1637818645,-184511,true,9709340209,22,9453543694,-255796515
1637818928,-184508,true,9712253303,22,9440318654,-271934649
1637819012,-184506,true,9714195851,22,9437487125,-276708726
1637819251,-184513,true,9707398633,22,9411100439,-296298194
1637819526,-184510,true,9710311143,22,9380096542,-330214601
1637819573,-184511,true,9709340209,22,9375407900,-333932309
1637819628,-184513,true,9707398633,22,9365101137,-342297496
1637819833,-184521,true,9699636207,22,9337983040,-361653167
1637820633,-184518,true,9702546389,22,9349194784,-353351605
1637821059,-184519,true,9701576231,22,9351999823,-349576408
1637821258,-184526,true,9694787844,22,9357612426,-337175418
1637821876,-184534,true,9687035502,22,9384787528,-302247974
1637821959,-184532,true,9688973006,22,9380096542,-308876464
1637822182,-184534,true,9687035502,22,9357612426,-329423076
1637822371,-184541,true,9680257289,22,9337049335,-343207954
1637822414,-184551,true,9670582354,22,9332382210,-338200144
1637823071,-184550,true,9671549412,22,9291411978,-380137434
1637823282,-184553,true,9668648527,22,9292341119,-376307408
1637824229,-184560,true,9661883180,22,9301637643,-360245537
1637824265,-184571,true,9651261482,22,9300707572,-350553910
1637824441,-184571,true,9651261482,22,9295129100,-356132382
1637824923,-184575,true,9647401943,22,9280269527,-367132416
1637825020,-184583,true,9639687493,22,9275630784,-364056709
1637825092,-184595,true,9628127384,22,9275630784,-352496600
1637825575,-184596,true,9627164667,22,9281197554,-345967113
1637825587,-184601,true,9622352529,22,9281197554,-341154975
1637826217,-184611,true,9612735466,22,9281197554,-331537912
1637826706,-184624,true,9600247653,22,9272848651,-327399002
1637827130,-184628,true,9596408514,22,9268213618,-328194896
1637827611,-184633,true,9591611749,22,9268213618,-323398131
1637827836,-184642,true,9582983613,22,9267286889,-315696724
1637828030,-184655,true,9570534450,22,9269140439,-301394011
1637828221,-184658,true,9567663864,22,9271921459,-295742405
1637828262,-184663,true,9562881467,22,9270067353,-292814114
1637828402,-184672,true,9554279176,22,9262654635,-291624541
1637828757,-184685,true,9541867303,22,9220146393,-321720910
1637828763,-184689,true,9538051510,22,9219224471,-318827039
1637828831,-184694,true,9533283914,22,9210010315,-323273599
1637829302,-184702,true,9525660718,22,9156749524,-368911194
1637829726,-184714,true,9514237352,22,9159496823,-354740529
1637829753,-184719,true,9509481660,22,9158580965,-350900695
1637831043,-184725,true,9503777967,22,9103796735,-399981232
1637831346,-184732,true,9497127983,22,9103796735,-393331248
1637831397,-184745,true,9484790355,22,9103796735,-380993620
1637831488,-184749,true,9480997387,22,9100156127,-380841260
1637831773,-184757,true,9473416001,22,9079250863,-394165138
1637832559,-184767,true,9463947793,22,9030357484,-433590309
1637832751,-184781,true,9450708198,22,9015921186,-434787012
1637832885,-184784,true,9447873553,22,9014118272,-433755281
1637833189,-184792,true,9440318654,22,9011414578,-428904076
1637833228,-184803,true,9429940531,22,9007810913,-422129618
1637833775,-184816,true,9417690186,22,9031260520,-386429666
1637833950,-184819,true,9414865443,22,9056582217,-358283226
1637834186,-184826,true,9408277673,22,9076527633,-331750040
1637834361,-184837,true,9397934774,22,9083791397,-314143377
1637834416,-184848,true,9387603246,22,9086516807,-301086439
1637835341,-184849,true,9386664580,22,9144854078,-241810502
1637835572,-184855,true,9381034552,22,9137541485,-243493067
1637835598,-184866,true,9370721602,22,9136627823,-234093779
1637836122,-184878,true,9359484042,22,9111082322,-248401720
1637836413,-184881,true,9356676758,22,9079250863,-277425895
1637836499,-184889,true,9349194784,22,9071083622,-278111162
1637836832,-184900,true,9338916838,22,9046625951,-292290887
1637837115,-184913,true,9326784740,22,9033066862,-293717878
1637837619,-184920,true,9320258602,22,9011414578,-308844024
1637837678,-184928,true,9312805749,22,9009612565,-303193184
1637838094,-184940,true,9301637643,22,8997008562,-304629081
1637838830,-184954,true,9288625111,22,8999707935,-288917176
1637839131,-184961,true,9282125674,22,8988016500,-294109174
1637839434,-184969,true,9274703314,22,8976340254,-298363060
1637839727,-184982,true,9262654635,22,8964679176,-297975459
1637839852,-184995,true,9250621609,22,8981727405,-268894204
1637839884,-185001,true,9245073178,22,8981727405,-263345773
1637840302,-185008,true,9238604215,22,8984422192,-254182023
1637840401,-185020,true,9227525092,22,8983523840,-244001252
1637840498,-185031,true,9217380902,22,8982625577,-234755325
1637840548,-185035,true,9213694872,22,8981727405,-231967467
1637841322,-185042,true,9207247864,22,8951242909,-256004955
1637841929,-185053,true,9197125966,22,8951242909,-245883057
1637842023,-185063,true,9187933896,22,8951242909,-236690987
1637842379,-185065,true,9186096585,22,8956614997,-229481588
1637842548,-185072,true,9179668889,22,8959302250,-220366639
1637842822,-185080,true,9172328457,22,8959302250,-213026207
1637842866,-185090,true,9163161171,22,8959302250,-203858921
1637842946,-185093,true,9160412773,22,8954823943,-205588830
1637843239,-185100,true,9154003048,22,8936933086,-217069962
1637843692,-185108,true,9146683140,22,8913728400,-232954740
1637844280,-185119,true,9136627823,22,8848013540,-288614283
1637844355,-185121,true,9134800771,22,8840054308,-294746463
1637844561,-185129,true,9127496218,22,8818864675,-308631543
1637844595,-185139,true,9118373740,22,8817101167,-301272573
1637844701,-185146,true,9111993431,22,8832102236,-279891195
1637844758,-185146,true,9111993431,22,8842706590,-269286841
1637844803,-185149,true,9109260379,22,8851553276,-257707103
1637844979,-185157,true,9101976249,22,8879922195,-222054054
1637845057,-185162,true,9097426626,22,8902148660,-195277966
1637845092,-185163,true,9096516974,22,8914619773,-181897201
1637845269,-185162,true,9097426626,22,8988016500,-109410126
1637845559,-185168,true,9091970080,22,9076527633,-15442447
1637845638,-185173,true,9087425458,22,9094697944,7272486
1637845914,-185174,true,9086516807,22,9134800771,48283964
1637845945,-185174,true,9086516807,22,9135714251,49197444
1637846234,-185179,true,9081974911,22,9117461994,35487083
1637846502,-185183,true,9078343029,22,9092879277,14536248
1637846675,-185185,true,9076527633,22,9078343029,1815396
1637847363,-185186,true,9075620071,22,9015019684,-60600387
1637847614,-185193,true,9069269677,22,9007810913,-61458764
1637847761,-185197,true,9065642876,22,9008711694,-56931182
1637847837,-185199,true,9063830019,22,9009612565,-54217454
1637847924,-185200,true,9062923727,22,9008711694,-54212033
1637847969,-185206,true,9057487875,22,9007810913,-49676962
1637848558,-185211,true,9052960490,22,8999707935,-53252555
1637848695,-185213,true,9051150169,22,8999707935,-51442234
1637848772,-185214,true,9050245145,22,9000607906,-49637239
1637848829,-185220,true,9044816898,22,9001507967,-43308931
1637848862,-185224,true,9041199875,22,9001507967,-39691908
1637848927,-185227,true,9038488058,22,9001507967,-36980091
1637849298,-185228,true,9037584299,22,8997008562,-40575737
1637849370,-185234,true,9032163646,22,8996108952,-36054694
1637849463,-185238,true,9028551684,22,8995209431,-33342253
1637849662,-185241,true,9025843660,22,8992511407,-33332253
1637849949,-185242,true,9024941166,22,8993410659,-31530507
1637850121,-185247,true,9020430048,22,8996108952,-24321096
1637850183,-185248,true,9019528096,22,8997008562,-22519534
1637850720,-185250,true,9017724461,22,9001507967,-16216494
1637850799,-185251,true,9016822778,22,9001507967,-15314811
1637850889,-185255,true,9013216951,22,9001507967,-11708984
1637850948,-185256,true,9012315719,22,9001507967,-10807752
1637851012,-185258,true,9010513526,22,9001507967,-9005559
1637851078,-185257,true,9011414578,22,9000607906,-10806672
1637851246,-185260,true,9008711694,22,9003308358,-5403336
1637851561,-185261,true,9007810913,22,9002408117,-5402796
1637851771,-185262,true,9006910222,22,9014118272,7208050
1637851978,-185259,true,9009612565,22,9035777053,26164488
1637852040,-185260,true,9008711694,22,9040295846,31584152
1637852152,-185258,true,9010513526,22,9061111414,50597888
1637852236,-185257,true,9011414578,22,9075620071,64205493
1637852374,-185253,true,9015019684,22,9096516974,81497290
1637852384,-185252,true,9015921186,22,9098336369,82415183
1637852405,-185252,true,9015921186,22,9101976249,86055063
1637852436,-185252,true,9015921186,22,9107438800,91517614
1637852463,-185248,true,9019528096,22,9112904630,93376534
1637852603,-185249,true,9018626233,22,9123846132,105219899
1637853370,-185256,true,9012315719,22,9022234225,9918506
1637853455,-185257,true,9011414578,22,9020430048,9015470
1637853467,-185253,true,9015019684,22,9020430048,5410364
1637853551,-185255,true,9013216951,22,9016822778,3605827
1637853694,-185260,true,9008711694,22,9016822778,8111084
1637853945,-185259,true,9009612565,22,9035777053,26164488
1637854151,-185254,true,9014118272,22,9051150169,37031897
1637854162,-185255,true,9013216951,22,9052960490,39743539
1637854785,-185261,true,9007810913,22,9009612565,1801652
1637855365,-185260,true,9008711694,22,8981727405,-26984289
1637855378,-185255,true,9013216951,22,8982625577,-30591374
1637855798,-185255,true,9013216951,22,9022234225,9017274
1637856017,-185259,true,9009612565,22,9043008206,33395641
1637856172,-185256,true,9012315719,22,9055676650,43360931
1637856220,-185251,true,9016822778,22,9059299464,42476686
1637856280,-185251,true,9016822778,22,9067456095,50633317
1637856332,-185254,true,9014118272,22,9073805219,59686947
1637856386,-185248,true,9019528096,22,9081974911,62446815
1637856778,-185240,true,9026746244,22,9159496823,132750579
1637856854,-185238,true,9028551684,22,9187015195,158463511
1637857025,-185236,true,9030357484,22,9271921459,241563975
1637857078,-185229,true,9036680631,22,9305358856,268678225
1637857163,-185211,true,9052960490,22,9356676758,303716268
1637857240,-185208,true,9055676650,22,9391358851,335682201
1637857290,-185204,true,9059299464,22,9411100439,351800975
1637857309,-185198,true,9064736402,22,9418631955,353895553
1637857349,-185181,true,9080158788,22,9435599910,355441122
1637857385,-185175,true,9085608246,22,9452598434,366990188
1637857591,-185170,true,9090151959,22,9552368606,462216647
1637857622,-185162,true,9097426626,22,9566707194,469280568
1637857671,-185143,true,9114727302,22,9595448969,480721667
1637857680,-185137,true,9120197506,22,9599287725,479090219
1637857764,-185130,true,9126583560,22,9622352529,495768969
1637857796,-185124,true,9132060879,22,9621390389,489329510
1637857819,-185107,true,9147597808,22,9620428347,472830539
1637857877,-185100,true,9154003048,22,9621390389,467387341
1637858138,-185099,true,9154918448,22,9585858796,430940348
1637858345,-185092,true,9161328814,22,9575320675,413991861
1637858378,-185079,true,9173245690,22,9571491504,398245814
1637858408,-185072,true,9179668889,22,9569577493,389908604
1637858757,-185069,true,9182423065,22,9559057271,376634206
1637858766,-185063,true,9187933896,22,9558101460,370167564
1637858858,-185054,true,9196206345,22,9565750618,369544273
1637858947,-185051,true,9198965483,22,9573405898,374440415
1637858970,-185050,true,9199885379,22,9576278207,376392828
1637859026,-185044,true,9205406691,22,9578193558,372786867
1637859064,-185034,true,9214616241,22,9576278207,361661966
1637859322,-185032,true,9216459256,22,9552368606,335909350
1637859455,-185030,true,9218302640,22,9537097800,318795160
1637859666,-185022,true,9225679864,22,9518995422,293315558
1637859804,-185010,true,9236756771,22,9532330681,295573910
1637859805,-185006,true,9240452028,22,9532330681,291878653
1637859986,-185001,true,9245073178,22,9560013176,314939998
1637860082,-184990,true,9255247845,22,9581067304,325819459
1637860101,-184977,true,9267286889,22,9585858796,318571907
1637860221,-184972,true,9271921459,22,9620428347,348506888
1637860227,-184965,true,9278413752,22,9623314764,344901012
1637860363,-184950,true,9292341119,22,9684129973,391788854
1637860417,-184935,true,9306289392,22,9716138787,409849395
1637860458,-184925,true,9315599870,22,9743380734,427780864
1637860465,-184918,true,9322122746,22,9747278671,425155925
1637860509,-184899,true,9339850730,22,9774607928,434757198
1637860515,-184882,true,9355741184,22,9777540604,421799420
1637860518,-184873,true,9364164720,22,9779496210,415331490
1637860535,-184868,true,9368847739,22,9787322545,418474806
1637860555,-184852,true,9383849143,22,9797114273,413265130
1637860620,-184837,true,9397934774,22,9819672440,421737666
1637860698,-184826,true,9408277673,22,9856070704,447793031
1637860721,-184820,true,9413924051,22,9868891286,454967235
1637860735,-184802,true,9430883525,22,9877776842,446893317
1637860786,-184781,true,9450708198,22,9917365094,466656896
1637860843,-184765,true,9465840677,22,9960099440,494258763
1637860882,-184756,true,9474363343,22,9995019116,520655773
1637860902,-184737,true,9492380843,22,10013025451,520644608
1637860954,-184714,true,9514237352,22,10055166485,540929133
1637861011,-184696,true,9531377544,22,10104555235,573177691
1637861056,-184685,true,9541867303,22,10146066877,604199574
1637861184,-184667,true,9559057271,22,10239836683,680779412
1637861258,-184645,true,9580109293,22,10292190622,712081329
1637861364,-184627,true,9597368155,22,10343777856,746409701
1637861383,-184619,true,9605048737,22,10353090981,748042244
1637861420,-184603,true,9620428347,22,10369668356,749240009
1637861456,-184584,true,9638723621,22,10384195332,745471711
1637861458,-184569,true,9653191831,22,10384195332,731003501
1637861487,-184565,true,9657053687,22,10391466450,734412763
1637861562,-184554,true,9667681759,22,10402902780,735221021
1637861757,-184537,true,9684129973,22,10387310902,703180929
1637861850,-184519,true,9701576231,22,10365521525,663945294
1637861923,-184509,true,9711282175,22,10345846715,634564540
1637861935,-184498,true,9721969928,22,10341709411,619739483
1637861947,-184478,true,9741432350,22,10336540107,595107757
1637861983,-184461,true,9758006040,22,10322079798,564073758
1637862010,-184454,true,9764838694,22,10313825849,548987155
1637862044,-184443,true,9775585389,22,10304548046,528962657
1637862085,-184425,true,9793196407,22,10289103582,495907175
1637862141,-184408,true,9809858167,22,10263414232,453556065
1637862182,-184400,true,9817708800,22,10245982121,428273321
1637862535,-184395,true,9822618637,22,10102534627,279915990
1637862738,-184377,true,9840314387,22,10038088077,197773690
1637862848,-184363,true,9854099785,22,9999017723,144917938
1637862897,-184356,true,9860999725,22,9986028095,125028370
1637863108,-184354,true,9862972023,22,9928279652,65307629
1637863161,-184337,true,9879752496,22,9923317001,43564505
1637863177,-184323,true,9893593144,22,9922324768,28731624
1637863197,-184318,true,9898540930,22,9920340601,21799671
1637863200,-184319,true,9897551175,22,9920340601,22789426
1637863202,-184307,true,9909434771,22,9919348666,9913895
1637863359,-184299,true,9917365094,22,9886670398,-30694696
1637863400,-184297,true,9919348666,22,9877776842,-41571824
1637863468,-184300,true,9916373456,22,9865931211,-50442245
1637863506,-184297,true,9919348666,22,9853114474,-66234192
1637863619,-184292,true,9924309332,22,9817708800,-106600532
1637863690,-184293,true,9923317001,22,9796134660,-127182341
1637863801,-184298,true,9918356830,22,9752153285,-166203545
1637863827,-184295,true,9921332635,22,9740458305,-180874330
1637863853,-184294,true,9922324768,22,9729750226,-192574542
1637863910,-184297,true,9919348666,22,9714195851,-205152815
1637864001,-184298,true,9918356830,22,9705457444,-212899386
1637864043,-184293,true,9923317001,22,9702546389,-220770612
1637864140,-184290,true,9926294293,22,9699636207,-226658086
1637864172,-184292,true,9924309332,22,9700606171,-223703161
1637864312,-184290,true,9926294293,22,9712253303,-214040990
1637864541,-184282,true,9934238109,22,9749228224,-185009885
1637864542,-184278,true,9938212400,22,9749228224,-188984176
1637864624,-184275,true,9941194162,22,9771676132,-169518030
1637864732,-184275,true,9941194162,22,9809858167,-131335995
1637865000,-184267,true,9949149901,22,9835395705,-113754196
1637865024,-184263,true,9953130158,22,9836379245,-116750913
1637865025,-184264,true,9952134945,22,9837362883,-114772062
1637865051,-184264,true,9952134945,22,9838346619,-113788326
1637865274,-184256,true,9960099440,22,9841298418,-118801022
1637865403,-184251,true,9965080486,22,9843266776,-121813710
1637865553,-184249,true,9967073602,22,9846220052,-120853550
1637865764,-184249,true,9967073602,22,9861985825,-105087777
1637865793,-184239,true,9977045162,22,9865931211,-111113951
1637865810,-184232,true,9984031189,22,9868891286,-115139903
1637866120,-184229,true,9987026698,22,9916373456,-70653242
1637866127,-184227,true,9989024203,22,9917365094,-71659109
1637866312,-184219,true,9997018220,22,9935231533,-61786687
1637866391,-184214,true,10002017729,22,9939206221,-62811508
1637866422,-184213,true,10003017930,22,9940200142,-62817788
1637866624,-184216,true,10000017625,22,9934238109,-65779516
1637866645,-184209,true,10007019738,22,9932251559,-74768179
1637866884,-184206,true,10010022144,22,9899530784,-110491360
1637866948,-184208,true,10008020440,22,9885681830,-122338610
1637867173,-184218,true,9998017921,22,9839330454,-158687467
1637867215,-184213,true,10003017930,22,9831462530,-171555400
1637867289,-184216,true,10000017625,22,9819672440,-180345185
1637867550,-184218,true,9998017921,22,9790259036,-207758885
1637867575,-184231,true,9985029592,22,9788301278,-196728314
1637867636,-184227,true,9989024203,22,9782430352,-206593851
1637867744,-184229,true,9987026698,22,9772653300,-214373398
1637867910,-184230,true,9986028095,22,9777540604,-208487491
1637868049,-184238,true,9978042866,22,9801033707,-177009159
1637868147,-184232,true,9984031189,22,9816727128,-167304061
1637868168,-184235,true,9981036578,22,9818690571,-162346007
1637868410,-184237,true,9979040670,22,9824583259,-154457411
1637868446,-184247,true,9969067116,22,9825565717,-143501399
1637868461,-184248,true,9968070309,22,9825565717,-142504592
1637868474,-184258,true,9958107719,22,9824583259,-133524460
1637868745,-184268,true,9948155086,22,9789280108,-158874978
1637869046,-184282,true,9934238109,22,9690910898,-243327211
1637869291,-184285,true,9931258433,22,9634869095,-296389338
1637869471,-184297,true,9919348666,22,9602167799,-317180867
1637869620,-184310,true,9906462535,22,9581067304,-325395231
1637869687,-184324,true,9892603883,22,9579151378,-313452505
1637869937,-184327,true,9889636696,22,9595448969,-294187727
1637870078,-184339,true,9877776842,22,9597368155,-280408687
1637870090,-184350,true,9866917804,22,9597368155,-269549649
1637870112,-184364,true,9853114474,22,9597368155,-255746319
1637870936,-184366,true,9851144147,22,9608891333,-242252814
1637870941,-184375,true,9842282548,22,9608891333,-233391215
1637870946,-184382,true,9835395705,22,9608891333,-226504372
1637871098,-184391,true,9826548274,22,9574363238,-252185036
1637871310,-184401,true,9816727128,22,9526613284,-290113844
1637871583,-184411,true,9806915798,22,9462055288,-344860510
1637871630,-184419,true,9799073794,22,9452598434,-346475360
1637871664,-184430,true,9788301278,22,9445039757,-343261521
1637871831,-184440,true,9778518358,22,9421457827,-357060531
1637872003,-184447,true,9771676132,22,9429940531,-341735601
1637872542,-184453,true,9765815178,22,9467733940,-298081238
1637873076,-184464,true,9755079224,22,9464894188,-290185036
1637873372,-184473,true,9746304041,22,9464894188,-281409853
1637873706,-184480,true,9739484356,22,9466787262,-272697094
1637874609,-184484,true,9735589536,22,9531377544,-204211992
1637874684,-184487,true,9732669443,22,9530424501,-202244942
1637875152,-184495,true,9724886810,22,9491431700,-233455110
1637875185,-184501,true,9719053920,22,9488584840,-230469080
1637875306,-184507,true,9713224528,22,9465840677,-247383851
1637875513,-184510,true,9710311143,22,9428997632,-281313511
1637875645,-184520,true,9700606171,22,9410159423,-290446748
1637875711,-184526,true,9694787844,22,9404515303,-290272541
1637875751,-184531,true,9689941904,22,9400754437,-289187467
1637875754,-184533,true,9688004206,22,9400754437,-287249769
1637875785,-184543,true,9678321528,22,9397934774,-280386754
1637875792,-184544,true,9677353793,22,9396995075,-280358718
1637875816,-184549,true,9672516567,22,9395115958,-277400609
1637875888,-184551,true,9670582354,22,9389480861,-281101493
1637875902,-184560,true,9661883180,22,9387603246,-274279934
1637875990,-184560,true,9661883180,22,9380096542,-281786638
1637876185,-184566,true,9656088078,22,9358548187,-297539891
1637876332,-184566,true,9656088078,22,9349194784,-306893294
1637877060,-184575,true,9647401943,22,9319326669,-328075274
1637877193,-184573,true,9649331520,22,9319326669,-330004851
1637877351,-184578,true,9644508301,22,9315599870,-328908431
1637877835,-184583,true,9639687493,22,9326784740,-312902753
1637877897,-184594,true,9629090196,22,9327717419,-301372777
1637877901,-184594,true,9629090196,22,9327717419,-301372777
1637878038,-184600,true,9623314764,22,9328650190,-294664574
1637878250,-184606,true,9617542795,22,9334248780,-283294015
1637878495,-184617,true,9606969843,22,9330516014,-276453829
1637878944,-184617,true,9606969843,22,9325852155,-281117688
1637879226,-184625,true,9599287725,22,9325852155,-273435570
1637879447,-184630,true,9594489520,22,9335182205,-259307315
1637879584,-184641,true,9583941911,22,9339850730,-244091181
1637879597,-184641,true,9583941911,22,9339850730,-244091181
1637879921,-184647,true,9578193558,22,9355741184,-222452374
1637879951,-184652,true,9573405898,22,9357612426,-215793472
1637880132,-184663,true,9562881467,22,9366974251,-195907216
1637880618,-184660,true,9565750618,22,9450708198,-115042420
1637880851,-184664,true,9561925275,22,9488584840,-73340435
1637881011,-184670,true,9556190127,22,9514237352,-41952775
1637881029,-184681,true,9545684622,22,9517091908,-28592714
1637881146,-184678,true,9548548614,22,9518043618,-30504996
1637881222,-184685,true,9541867303,22,9513286023,-28581280
1637881458,-184693,true,9534237243,22,9497127983,-37109260
1637881480,-184703,true,9524708247,22,9497127983,-27580264
1637881871,-184700,true,9527565945,22,9495228842,-32337103
1637881922,-184705,true,9522803591,22,9494279414,-28524177
1637882843,-184712,true,9516140294,22,9497127983,-19012311
1637882884,-184722,true,9506629386,22,9496178365,-10451021
1637882933,-184717,true,9511383651,22,9496178365,-15205286
1637883005,-184722,true,9506629386,22,9496178365,-10451021
1637883220,-184727,true,9501877497,22,9494279414,-7598083
1637883258,-184736,true,9493330081,22,9492380843,-949238
1637883424,-184731,true,9498077696,22,9481945487,-16132209
1637883588,-184737,true,9492380843,22,9471521602,-20859241
1637884038,-184744,true,9485738834,22,9423342213,-62396621
1637884229,-184754,true,9476258310,22,9406396300,-69862010
1637884641,-184749,true,9480997387,22,9384787528,-96209859
1637884647,-184756,true,9474363343,22,9382910852,-91452491
1637884750,-184765,true,9465840677,22,9375407900,-90432777
1637884810,-184776,true,9455434497,22,9375407900,-80026597
1637884985,-184773,true,9458271411,22,9372595840,-85675571
1637885179,-184779,true,9452598434,22,9370721602,-81876832
1637885260,-184787,true,9445039757,22,9366037647,-79002110
1637885422,-184797,true,9435599910,22,9358548187,-77051723
1637886100,-184796,true,9436543470,22,9300707572,-135835898
1637886694,-184798,true,9434656445,22,9278413752,-156242693
1637887608,-184807,true,9426169498,22,9154003048,-272166450
1637889401,-184818,true,9415806930,22,9154003048,-261803882
1637889616,-184817,true,9416748511,22,9173245690,-243502821
1637889745,-184818,true,9415806930,22,9185178067,-230628863
1637889906,-184826,true,9408277673,22,9199885379,-208392294
1637889927,-184835,true,9399814455,22,9201725448,-198089007
1637890529,-184835,true,9399814455,22,9233062992,-166751463
1637891448,-184837,true,9397934774,22,9227525092,-170409682
1637891848,-184846,true,9389480861,22,9227525092,-161955769
1637891892,-184854,true,9381972655,22,9227525092,-154447563
1637891949,-184853,true,9382910852,22,9225679864,-157230988
1637892332,-184856,true,9380096542,22,9214616241,-165480301
1637892404,-184865,true,9371658675,22,9194367380,-177291295
1637892553,-184867,true,9369784624,22,9164993895,-204790729
1637892962,-184869,true,9367910948,22,9075620071,-292290877
1637893085,-184875,true,9362292168,22,9059299464,-302992704
1637893192,-184883,true,9354805704,22,9043912506,-310893198
1637893349,-184886,true,9351999823,22,9036680631,-315319192
1637893613,-184888,true,9350129704,22,9052055284,-298074420
1637893912,-184894,true,9344521589,22,9067456095,-277065494
1637894437,-184901,true,9337983040,22,9109260379,-228722661
1637895293,-184903,true,9336115723,22,9131147764,-204967959
1637895408,-184905,true,9334248780,22,9124758517,-209490263
1637896078,-184912,true,9327717419,22,9133887382,-193830037
1637896379,-184919,true,9321190627,22,9154918448,-166272179
1637896438,-184920,true,9320258602,22,9158580965,-161677637
1637896752,-184923,true,9317463083,22,9136627823,-180835260
1637897243,-184928,true,9312805749,22,9091970080,-220835669
1637897374,-184936,true,9305358856,22,9076527633,-228831223
1637897533,-184935,true,9306289392,22,9079250863,-227038529
1637897584,-184937,true,9304428413,22,9080158788,-224269625
1637897693,-184943,true,9298847709,22,9076527633,-222320076
1637897936,-184951,true,9291411978,22,9069269677,-222142301
1637897953,-184950,true,9292341119,22,9071083622,-221257497
1637898538,-184949,true,9293270353,22,9137541485,-155728868
1637898622,-184955,true,9287696342,22,9149427419,-138268923
1637899253,-184961,true,9282125674,22,9175997939,-106127735
1637899409,-184960,true,9283053886,22,9175080431,-107973455
1637899619,-184959,true,9283982192,22,9175080431,-108901761
1637899639,-184963,true,9280269527,22,9174163015,-106106512
1637900419,-184969,true,9274703314,22,9156749524,-117953790
1637900821,-184968,true,9275630784,22,9153087739,-122543045
1637900828,-184967,true,9276558347,22,9153087739,-123470608
1637900982,-184970,true,9273775936,22,9165910395,-107865541
1637901027,-184976,true,9268213618,22,9169577309,-98636309
1637901067,-184972,true,9271921459,22,9176915539,-95005920
1637901205,-184971,true,9272848651,22,9196206345,-76642306
1637901232,-184973,true,9270994360,22,9199885379,-71108981
1637901246,-184978,true,9266360253,22,9202645621,-63714632
1637901301,-184974,true,9270067353,22,9212773594,-57293759
1637901470,-184972,true,9271921459,22,9241376073,-30545386
1637901599,-184974,true,9270067353,22,9264507259,-5560094
1637901993,-184979,true,9265433709,22,9301637643,36203934
1637902339,-184974,true,9270067353,22,9336115723,66048370
1637902842,-184971,true,9272848651,22,9382910852,110062201
1637902908,-184974,true,9270067353,22,9387603246,117535893
1637903336,-184978,true,9266360253,22,9387603246,121242993
1637903717,-184973,true,9270994360,22,9389480861,118486501
1637903839,-184974,true,9270067353,22,9383849143,113781790
1637904110,-184979,true,9265433709,22,9370721602,105287893
1637904312,-184984,true,9260802382,22,9361356033,100553651
1637904546,-184981,true,9263580901,22,9350129704,86548803
1637904839,-184982,true,9262654635,22,9346390587,83735952
1637904983,-184987,true,9258024697,22,9354805704,96781007
1637905062,-184990,true,9255247845,22,9359484042,104236197
1637905232,-184986,true,9258950499,22,9367910948,108960449
1637905425,-184987,true,9258024697,22,9378220804,120196107
1637906004,-184993,true,9252471826,22,9366037647,113565821
1637906023,-184996,true,9249696639,22,9364164720,114468081
1637906138,-184993,true,9252471826,22,9358548187,106076361
1637906636,-184994,true,9251546671,22,9349194784,97648113
1637906649,-185000,true,9245997685,22,9351064717,105067032
1637907058,-185001,true,9245073178,22,9393237216,148164038
1637907452,-184997,true,9248771762,22,9432769796,183998034
1637907481,-184995,true,9250621609,22,9433713073,183091464
1637907686,-185001,true,9245073178,22,9428054826,182981648
1637908523,-185002,true,9244148763,22,9395115958,150967195
1637908972,-184998,true,9247846977,22,9395115958,147268981
1637909160,-184995,true,9250621609,22,9386664580,136042971
1637909406,-185001,true,9245073178,22,9373533100,128459922
1637909733,-185002,true,9244148763,22,9357612426,113463663
1637909927,-184999,true,9246922285,22,9349194784,102272499
1637909971,-184996,true,9249696639,22,9349194784,99498145
1637910368,-185002,true,9244148763,22,9341718793,97570030
1637910475,-185003,true,9243224441,22,9339850730,96626289
1637910700,-185000,true,9245997685,22,9335182205,89184520
1637911018,-184995,true,9250621609,22,9332382210,81760601
1637911508,-185000,true,9245997685,22,9330516014,84518329
1637911770,-184999,true,9246922285,22,9319326669,72404384
1637912187,-184994,true,9251546671,22,9301637643,50090972
1637912578,-184989,true,9256173370,22,9297917917,41744547
1637912585,-184994,true,9251546671,22,9296058613,44511942
1637912608,-184993,true,9252471826,22,9293270353,40798527
1637912717,-184992,true,9253397073,22,9281197554,27800481
1637912724,-184991,true,9254322413,22,9279341593,25019180
1637912785,-184998,true,9247846977,22,9264507259,16660282
1637912952,-184998,true,9247846977,22,9233986298,-13860679
1637913000,-184999,true,9246922285,22,9221068408,-25853877
1637913311,-184997,true,9248771762,22,9165910395,-82861367
1637913543,-185002,true,9244148763,22,9132974085,-111174678
1637913615,-184999,true,9246922285,22,9132060879,-114861406
1637914488,-184997,true,9248771762,22,9207247864,-41523898
1637914624,-184991,true,9254322413,22,9207247864,-47074549
1637914790,-184994,true,9251546671,22,9193448035,-58098636
1637914839,-184992,true,9253397073,22,9183341307,-70055766
1637914874,-184992,true,9253397073,22,9175997939,-77399134
1637914913,-184991,true,9254322413,22,9159496823,-94825590
1637914975,-184998,true,9247846977,22,9145768563,-102078414
1637915031,-185000,true,9245997685,22,9123846132,-122151553
1637915073,-185002,true,9244148763,22,9108349544,-135799219
1637915383,-185005,true,9241376073,22,8977237888,-264138185
1637915390,-185013,true,9233986298,22,8974545255,-259441043
1637915418,-185015,true,9232139778,22,8965575644,-266564134
1637915477,-185017,true,9230293627,22,8950347874,-279945753
1637915694,-185012,true,9234909697,22,8917294426,-317615271
1637916073,-185019,true,9228447845,22,8953928550,-274519295
1637916345,-185018,true,9229370690,22,9033970169,-195400521
1637916745,-185017,true,9230293627,22,9114727302,-115566325
1637916766,-185011,true,9235833188,22,9118373740,-117459448
1637917082,-185015,true,9232139778,22,9166826986,-65312792
1637917152,-185013,true,9233986298,22,9165910395,-68075903
1637917812,-185008,true,9238604215,22,9259876394,21272179
1637917817,-185005,true,9241376073,22,9259876394,18500321
1637918958,-185007,true,9239528075,22,9323054959,83526884
1637919729,-185006,true,9240452028,22,9315599870,75147842
1637919956,-185001,true,9245073178,22,9341718793,96645615
1637919973,-184998,true,9247846977,22,9344521589,96674612
1637920022,-184998,true,9247846977,22,9362292168,114445191
1637920137,-184989,true,9256173370,22,9402634682,146461312
1637920183,-184978,true,9266360253,22,9418631955,152271702
1637920444,-184976,true,9268213618,22,9490482652,222269034
1637920809,-184980,true,9264507259,22,9532330681,267823422
1637921100,-184973,true,9270994360,22,9501877497,230883137
1637921358,-184966,true,9277486003,22,9483841970,206355967
1637921393,-184965,true,9278413752,22,9484790355,206376603
1637921686,-184971,true,9272848651,22,9471521602,198672951
1637921932,-184965,true,9278413752,22,9454489049,176075297
1637922871,-184959,true,9283982192,22,9410159423,126177231
1637923920,-184960,true,9283053886,22,9412041549,128987663
1637924097,-184966,true,9277486003,22,9408277673,130791670
1637924191,-184960,true,9283053886,22,9406396300,123342414
1637924916,-184955,true,9287696342,22,9415806930,128110588
1637924972,-184957,true,9285839081,22,9417690186,131851105
1637925349,-184963,true,9280269527,22,9405455754,125186227
1637925457,-184959,true,9283982192,22,9398874568,114892376
1637925464,-184956,true,9286767665,22,9397934774,111167109
1637925667,-184958,true,9284910590,22,9388542006,103631416
1637926070,-184963,true,9280269527,22,9381972655,101703128
1637926499,-184958,true,9284910590,22,9387603246,102692656
1637926660,-184954,true,9288625111,22,9387603246,98978135
1637926890,-184956,true,9286767665,22,9389480861,102713196
1637927042,-184961,true,9282125674,22,9389480861,107355187
1637927435,-184956,true,9286767665,22,9394176540,107408875
1637927528,-184953,true,9289553974,22,9396055469,106501495
1637927598,-184955,true,9287696342,22,9396055469,108359127
1637927642,-184960,true,9283053886,22,9396055469,113001583
1637927726,-184955,true,9287696342,22,9396055469,108359127
1637927794,-184951,true,9291411978,22,9396055469,104643491
1637928010,-184956,true,9286767665,22,9366037647,79269982
1637928218,-184962,true,9281197554,22,9346390587,65193033
1637928680,-184959,true,9283982192,22,9302567806,18585614
1637929201,-184955,true,9287696342,22,9336115723,48419381
1637929833,-184960,true,9283053886,22,9423342213,140288327
1637931108,-184963,true,9280269527,22,9437487125,157217598
1637931644,-184958,true,9284910590,22,9436543470,151632880
1637931995,-184953,true,9289553974,22,9456380041,166826067
1637932247,-184957,true,9285839081,22,9470574544,184735463
1637932773,-184959,true,9283982192,22,9485738834,201756642
1637933095,-184952,true,9290482929,22,9479101472,188618543
1637933180,-184946,true,9296058613,22,9477205936,181147323
1637933823,-184951,true,9291411978,22,9461109177,169697199
1637934086,-184953,true,9289553974,22,9445984261,156430287
1637934584,-184948,true,9294199680,22,9426169498,131969818
1637934702,-184941,true,9300707572,22,9427112115,126404543
1637935398,-184946,true,9296058613,22,9462055288,165996675
1637935542,-184947,true,9295129100,22,9466787262,171658162
1637935663,-184941,true,9300707572,22,9466787262,166079690
1637935905,-184934,true,9307220021,22,9470574544,163354523
1637936299,-184939,true,9302567806,22,9447873553,145305747
1637936632,-184941,true,9300707572,22,9419573818,118866246
1637936823,-184934,true,9307220021,22,9404515303,97295282
1637937176,-184927,true,9313737029,22,9396995075,83258046
1637937330,-184927,true,9313737029,22,9423342213,109605184
1637937373,-184928,true,9312805749,22,9411100439,98294690
1637937536,-184920,true,9320258602,22,9425226975,104968373
1637937601,-184912,true,9327717419,22,9405455754,77738335
1637938120,-184913,true,9326784740,22,9429940531,103155791
1637938126,-184913,true,9326784740,22,9428997632,102212892
1637938975,-184906,true,9333315448,22,9447873553,114558105
1637938982,-184899,true,9339850730,22,9447873553,108022823
1637939177,-184901,true,9337983040,22,9443151033,105167993
1637939335,-184902,true,9337049335,22,9419573818,82524483
1637939459,-184897,true,9341718793,22,9400754437,59035644
1637939565,-184888,true,9350129704,22,9383849143,33719439
1637939719,-184888,true,9350129704,22,9361356033,11226329
1637940355,-184886,true,9351999823,22,9304428413,-47571410
1637940371,-184879,true,9358548187,22,9304428413,-54119774
1637940390,-184869,true,9367910948,22,9300707572,-67203376
1637940455,-184866,true,9370721602,22,9302567806,-68153796
1637940531,-184863,true,9373533100,22,9301637643,-71895457
1637940572,-184855,true,9381034552,22,9303498063,-77536489
1637940782,-184845,true,9390419809,22,9312805749,-77614060
1637941828,-184849,true,9386664580,22,9343587230,-43077350
1637942105,-184845,true,9390419809,22,9342652965,-47766844
1637942206,-184840,true,9395115958,22,9342652965,-52462993
1637942255,-184832,true,9402634682,22,9342652965,-59981717
1637942322,-184837,true,9397934774,22,9341718793,-56215981
1637942409,-184836,true,9398874568,22,9349194784,-49679784
1637942500,-184830,true,9404515303,22,9352935023,-51580280
1637943208,-184825,true,9409218501,22,9381034552,-28183949
1637943392,-184831,true,9403574945,22,9371658675,-31916270
1637943804,-184833,true,9401694512,22,9351999823,-49694689
1637944326,-184828,true,9406396300,22,9329583055,-76813245
1637944338,-184825,true,9409218501,22,9328650190,-80568311
1637944506,-184831,true,9403574945,22,9323054959,-80519986
1637944567,-184835,true,9399814455,22,9323987264,-75827191
1637944674,-184837,true,9397934774,22,9324919663,-73015111
1637945038,-184839,true,9396055469,22,9332382210,-63673259
1637945115,-184843,true,9392297987,22,9333315448,-58982539
1637945240,-184843,true,9392297987,22,9338916838,-53381149
1637946289,-184845,true,9390419809,22,9358548187,-31871622
1637946809,-184845,true,9390419809,22,9384787528,-5632281
1637947251,-184848,true,9387603246,22,9407336939,19733693
1637947562,-184848,true,9387603246,22,9405455754,17852508
1637947919,-184847,true,9388542006,22,9400754437,12212431
1637948359,-184846,true,9389480861,22,9394176540,4695679
1637948947,-184849,true,9386664580,22,9389480861,2816281
1637949008,-184849,true,9386664580,22,9387603246,938666
1637949263,-184848,true,9387603246,22,9375407900,-12195346
1637949325,-184848,true,9387603246,22,9372595840,-15007406
1637949481,-184852,true,9383849143,22,9366037647,-17811496
1637949595,-184851,true,9384787528,22,9365101137,-19686391
1637949712,-184850,true,9385726007,22,9363228397,-22497610
1637949828,-184849,true,9386664580,22,9361356033,-25308547
1637950158,-184853,true,9382910852,22,9351064717,-31846135
1637950645,-184852,true,9383849143,22,9371658675,-12190468
1637950797,-184851,true,9384787528,22,9380096542,-4690986
1637950909,-184849,true,9386664580,22,9388542006,1877426
1637951366,-184853,true,9382910852,22,9403574945,20664093
1637951431,-184851,true,9384787528,22,9401694512,16906984
1637951535,-184851,true,9384787528,22,9397934774,13147246
1637951855,-184849,true,9386664580,22,9388542006,1877426
1637952142,-184854,true,9381972655,22,9377283076,-4689579
1637952180,-184852,true,9383849143,22,9375407900,-8441243
1637952238,-184852,true,9383849143,22,9374470453,-9378690
1637952307,-184850,true,9385726007,22,9373533100,-12192907
1637952537,-184849,true,9386664580,22,9396055469,9390889
1637952956,-184846,true,9389480861,22,9438430873,48950012
1637953783,-184844,true,9391358851,22,9461109177,69750326
1637954106,-184844,true,9391358851,22,9458271411,66912560
1637954959,-184845,true,9390419809,22,9454489049,64069240
1637955195,-184844,true,9391358851,22,9453543694,62184843
1637955590,-184843,true,9392297987,22,9450708198,58410211
1637955945,-184843,true,9392297987,22,9447873553,55575566
1637957098,-184845,true,9390419809,22,9444095348,53675539
1637957407,-184845,true,9390419809,22,9443151033,52731224
1637957502,-184845,true,9390419809,22,9443151033,52731224
1637957700,-184845,true,9390419809,22,9441262686,50842877
1637957815,-184847,true,9388542006,22,9439374716,50832710
1637958054,-184846,true,9389480861,22,9436543470,47062609
1637958072,-184845,true,9390419809,22,9436543470,46123661
1637958189,-184846,true,9389480861,22,9434656445,45175584
1637958333,-184847,true,9388542006,22,9433713073,45171067
1637958650,-184847,true,9388542006,22,9433713073,45171067
1637958684,-184847,true,9388542006,22,9436543470,48001464
1637958735,-184846,true,9389480861,22,9447873553,58392692
1637958919,-184842,true,9393237216,22,9508530807,115293591
1637959234,-184830,true,9404515303,22,9653191831,248676528
1637959617,-184829,true,9405455754,22,9802994012,397538258
1637959880,-184828,true,9406396300,22,9802994012,396597712
1637960123,-184824,true,9410159423,22,9779496210,369336787
1637960136,-184813,true,9420515775,22,9778518358,358002583
1637960229,-184813,true,9420515775,22,9776562948,356047173
1637960285,-184811,true,9422399973,22,9775585389,353185416
1637960409,-184807,true,9426169498,22,9773630565,347461067
1637960546,-184798,true,9434656445,22,9756054732,321398287
1637960799,-184801,true,9431826614,22,9720025825,288199211
1637960898,-184800,true,9432769796,22,9708369372,275599576
1637960900,-184797,true,9435599910,22,9708369372,272769462
1637961388,-184788,true,9444095348,22,9634869095,190773747
1637962137,-184786,true,9445984261,22,9679289360,233305099
1637962250,-184785,true,9446928860,22,9687035502,240106642
1637962435,-184780,true,9451653269,22,9682193437,230540168
1637962669,-184770,true,9461109177,22,9671549412,210440235
1637962699,-184769,true,9462055288,22,9673483819,211428531
1637962830,-184766,true,9464894188,22,9694787844,229893656
1637962864,-184760,true,9470574544,22,9698666341,228091797
1637963161,-184746,true,9483841970,22,9734616075,250774105
1637963185,-184745,true,9484790355,22,9738510505,253720150
1637963534,-184743,true,9486687408,22,9800053702,313366294
1637963785,-184739,true,9490482652,22,9772653300,282170648
1637963797,-184726,true,9502827685,22,9771676132,268848447
1637963898,-184726,true,9502827685,22,9759957739,257130054
1637964427,-184727,true,9501877497,22,9695757322,193879825
1637964528,-184722,true,9506629386,22,9694787844,188158458
1637964694,-184710,true,9518043618,22,9694787844,176744226
1637964785,-184710,true,9518043618,22,9698666341,180622723
1637964803,-184711,true,9517091908,22,9699636207,182544299
1637964854,-184706,true,9521851406,22,9701576231,179724825
1637964973,-184692,true,9535190666,22,9709340209,174149543
1637965223,-184692,true,9535190666,22,9722942125,187751459
1637965231,-184691,true,9536144186,22,9722942125,186797939
1637965873,-184686,true,9540913211,22,9752153285,211240074
1637966045,-184672,true,9554279176,22,9753128501,198849325
1637966324,-184671,true,9555234603,22,9753128501,197893898
1637966353,-184671,true,9555234603,22,9752153285,196918682
1637967030,-184669,true,9557145746,22,9688004206,130858460
1637967324,-184655,true,9570534450,22,9667681759,97147309
1637967365,-184656,true,9569577493,22,9661883180,92305687
1637967527,-184658,true,9567663864,22,9649331520,81667656
1637967630,-184657,true,9568620631,22,9636796165,68175534
1637967882,-184646,true,9579151378,22,9607930540,28779162
1637968004,-184648,true,9577235835,22,9594489520,17253685
1637968077,-184650,true,9575320675,22,9582983613,7662938
1637968087,-184649,true,9576278207,22,9581067304,4789097
1637968125,-184639,true,9585858796,22,9575320675,-10538121
1637968580,-184641,true,9583941911,22,9539959215,-43982696
1637968755,-184643,true,9582025410,22,9532330681,-49694729
1637969030,-184641,true,9583941911,22,9525660718,-58281193
1637969657,-184631,true,9593530167,22,9525660718,-67869449
1637970417,-184634,true,9590652684,22,9510432608,-80220076
1637970566,-184636,true,9588734841,22,9507580049,-81154792
1637970627,-184633,true,9591611749,22,9506629386,-84982363
1637970704,-184624,true,9600247653,22,9506629386,-93618267
1637970839,-184628,true,9596408514,22,9504728345,-91680169
1637970859,-184630,true,9594489520,22,9504728345,-89761175
1637971460,-184628,true,9596408514,22,9503777967,-92630547
1637971824,-184619,true,9605048737,22,9506629386,-98419351
1637972000,-184623,true,9601207678,22,9506629386,-94578292
1637972097,-184624,true,9600247653,22,9507580049,-92667604
1637972228,-184621,true,9603128016,22,9516140294,-86987722
1637972587,-184611,true,9612735466,22,9539005315,-73730151
1637972748,-184614,true,9609852222,22,9547593855,-62258367
1637972827,-184615,true,9608891333,22,9550458419,-58432914
1637973451,-184615,true,9608891333,22,9540913211,-67978122
1637973602,-184606,true,9617542795,22,9543775772,-73767023
1637973783,-184610,true,9613696740,22,9550458419,-63238321
1637974234,-184611,true,9612735466,22,9569577493,-43157973
1637974646,-184610,true,9613696740,22,9574363238,-39333502
1637974682,-184601,true,9622352529,22,9574363238,-47989291
1637974704,-184604,true,9619466400,22,9574363238,-45103162
1637974949,-184604,true,9619466400,22,9579151378,-40315022
1637974967,-184603,true,9620428347,22,9580109293,-40319054
1637975021,-184594,true,9629090196,22,9581067304,-48022892
1637975392,-184597,true,9626202047,22,9590652684,-35549363
1637975559,-184598,true,9625239523,22,9586817381,-38422142
1637975605,-184596,true,9627164667,22,9584900306,-42264361
1637975667,-184587,true,9635832582,22,9582025410,-53807172
1637975980,-184591,true,9631979212,22,9563837755,-68141457
1637976186,-184592,true,9631016111,22,9549503469,-81512642
1637977803,-184592,true,9631016111,22,9508530807,-122485304
1637977961,-184583,true,9639687493,22,9507580049,-132107444
1637978226,-184588,true,9634869095,22,9505678818,-129190277
1637979128,-184590,true,9632942410,22,9499977406,-132965004
1637979440,-184594,true,9629090196,22,9512334790,-116755406
1637979494,-184595,true,9628127384,22,9515188775,-112938609
1637979844,-184601,true,9622352529,22,9537097800,-85254729
1637980012,-184602,true,9621390389,22,9546639191,-74751198
1637980158,-184606,true,9617542795,22,9543775772,-73767023
1637980438,-184607,true,9616581137,22,9535190666,-81390471
1637980553,-184612,true,9611774289,22,9529471554,-82302735
1637980852,-184614,true,9609852222,22,9517091908,-92760314
1637980895,-184619,true,9605048737,22,9515188775,-89859962
1637981061,-184618,true,9606009242,22,9514237352,-91771890
1637981162,-184620,true,9604088328,22,9514237352,-89850976
1637981246,-184622,true,9602167799,22,9514237352,-87930447
1637981294,-184625,true,9599287725,22,9514237352,-85050373
1637981397,-184624,true,9600247653,22,9514237352,-86010301
1637981877,-184628,true,9596408514,22,9514237352,-82171162
1637982635,-184628,true,9596408514,22,9528518702,-67889812
1637982791,-184632,true,9592570910,22,9530424501,-62146409
1637982820,-184631,true,9593530167,22,9532330681,-61199486
1637982875,-184634,true,9590652684,22,9530424501,-60228183
1637982950,-184637,true,9587776063,22,9527565945,-60210118
1637983140,-184642,true,9582983613,22,9518995422,-63988191
1637983428,-184645,true,9580109293,22,9506629386,-73479907
1637984503,-184649,true,9576278207,22,9484790355,-91487852
1637984760,-184652,true,9573405898,22,9482893681,-90512217
1637984769,-184656,true,9569577493,22,9482893681,-86683812
1637984893,-184658,true,9567663864,22,9491431700,-76232164
1637985133,-184659,true,9566707194,22,9516140294,-50566900
1637985215,-184658,true,9567663864,22,9523755872,-43907992
1637985217,-184662,true,9563837755,22,9524708247,-39129508
1637985230,-184664,true,9561925275,22,9526613284,-35311991
1637985356,-184662,true,9563837755,22,9557145746,-6692009
1637985639,-184656,true,9569577493,22,9649331520,79754027
1637986075,-184664,true,9561925275,22,9678321528,116396253
1637986129,-184666,true,9560013176,22,9680257289,120244113
1637986389,-184665,true,9560969178,22,9648366683,87397505
1637986564,-184662,true,9563837755,22,9623314764,59477009
1637987203,-184671,true,9555234603,22,9585858796,30624193
1637987299,-184674,true,9552368606,22,9579151378,26782772
1637987550,-184674,true,9552368606,22,9569577493,17208887
1637988369,-184670,true,9556190127,22,9569577493,13387366
1637989123,-184676,true,9550458419,22,9620428347,69969928
1637990286,-184678,true,9548548614,22,9634869095,86320481
1637990743,-184676,true,9550458419,22,9635832582,85374163
1637990789,-184671,true,9555234603,22,9635832582,80597979
1637991157,-184675,true,9551413465,22,9635832582,84419117
1637991701,-184675,true,9551413465,22,9633905704,82492239
1637991843,-184673,true,9553323843,22,9632942410,79618567
1637991912,-184668,true,9558101460,22,9631979212,73877752
1637992077,-184672,true,9554279176,22,9629090196,74811020
1637994856,-184673,true,9553323843,22,9571491504,18167661
1637994862,-184671,true,9555234603,22,9571491504,16256901
1637994932,-184665,true,9560969178,22,9566707194,5738016
1637995828,-184670,true,9556190127,22,9523755872,-32434255
1637996243,-184674,true,9552368606,22,9502827685,-49540921
1637996638,-184672,true,9554279176,22,9478153656,-76125520
1637997751,-184667,true,9559057271,22,9476258310,-82798961
1637998173,-184672,true,9554279176,22,9475310779,-78968397
1637998488,-184675,true,9551413465,22,9473416001,-77997464
1637998508,-184673,true,9553323843,22,9469627582,-83696261
1637998555,-184668,true,9558101460,22,9465840677,-92260783
1637998611,-184675,true,9551413465,22,9461109177,-90304288
1637999055,-184681,true,9545684622,22,9423342213,-122342409
1637999717,-184678,true,9548548614,22,9396055469,-152493145
1638000727,-184673,true,9553323843,22,9432769796,-120554047
1638001210,-184680,true,9546639191,22,9432769796,-113869395
1638001433,-184687,true,9539959215,22,9436543470,-103415745
1638001746,-184684,true,9542821489,22,9443151033,-99670456
1638001855,-184679,true,9547593855,22,9445039757,-102554098
1638001886,-184685,true,9541867303,22,9445039757,-96827546
1638002219,-184691,true,9536144186,22,9448818340,-87325846
1638002231,-184689,true,9538051510,22,9448818340,-89233170
1638002439,-184684,true,9542821489,22,9448818340,-94003149
1638002983,-184691,true,9536144186,22,9445984261,-90159925
1638003791,-184697,true,9530424501,22,9445039757,-85384744
1638004163,-184695,true,9532330681,22,9444095348,-88235333
1638004253,-184690,true,9537097800,22,9446928860,-90168940
1638005511,-184697,true,9530424501,22,9480997387,-49427114
1638005639,-184703,true,9524708247,22,9469627582,-55080665
1638005678,-184701,true,9526613284,22,9466787262,-59826022
1638006225,-184696,true,9531377544,22,9428054826,-103322718
1638006402,-184704,true,9523755872,22,9424284547,-99471325
1638006683,-184710,true,9518043618,22,9438430873,-79612745
1638007041,-184706,true,9521851406,22,9454489049,-67362357
1638007228,-184700,true,9527565945,22,9457325679,-70240266
1638007894,-184707,true,9520899316,22,9449763222,-71136094
1638008073,-184713,true,9515188775,22,9448818340,-66370435
1638008163,-184709,true,9518995422,22,9448818340,-70177082
1638008191,-184703,true,9524708247,22,9448818340,-75889907
1638008820,-184710,true,9518043618,22,9448818340,-69225278
1638009157,-184716,true,9512334790,22,9447873553,-64461237
1638009505,-184712,true,9516140294,22,9446928860,-69211434
1638009728,-184708,true,9519947321,22,9447873553,-72073768
1638009836,-184715,true,9513286023,22,9447873553,-65412470
1638009844,-184720,true,9508530807,22,9447873553,-60657254
1638009879,-184716,true,9512334790,22,9445984261,-66350529
1638010172,-184712,true,9516140294,22,9438430873,-77709421
1638010202,-184719,true,9509481660,22,9437487125,-71994535
1638010601,-184725,true,9503777967,22,9422399973,-81377994
1638011050,-184719,true,9509481660,22,9454489049,-54992611
1638011509,-184714,true,9514237352,22,9491431700,-22805652
1638012845,-184721,true,9507580049,22,9478153656,-29426393
1638012942,-184726,true,9502827685,22,9477205936,-25621749
1638013455,-184721,true,9507580049,22,9476258310,-31321739
1638014067,-184716,true,9512334790,22,9476258310,-36076480
1638014174,-184724,true,9504728345,22,9475310779,-29417566
1638014509,-184729,true,9499977406,22,9473416001,-26561405
1638015602,-184724,true,9504728345,22,9460163160,-44565185
1638016079,-184719,true,9509481660,22,9459217239,-50264421
1638016373,-184726,true,9502827685,22,9458271411,-44556274
1638017112,-184730,true,9499027504,22,9460163160,-38864344
1638017198,-184725,true,9503777967,22,9460163160,-43614807
1638017367,-184721,true,9507580049,22,9460163160,-47416889
1638017430,-184727,true,9501877497,22,9459217239,-42660258
1638017585,-184732,true,9497127983,22,9458271411,-38856572
1638017920,-184728,true,9500927404,22,9472468754,-28458650
1638018174,-184724,true,9504728345,22,9483841970,-20886375
1638018539,-184730,true,9499027504,22,9495228842,-3798662
1638018962,-184736,true,9493330081,22,9486687408,-6642673
1638019080,-184735,true,9494279414,22,9483841970,-10437444
1638019191,-184737,true,9492380843,22,9483841970,-8538873
1638019311,-184740,true,9489533698,22,9492380843,2847145
1638019450,-184744,true,9485738834,22,9501877497,16138663
1638019736,-184741,true,9488584840,22,9523755872,35171032
1638020045,-184740,true,9489533698,22,9545684622,56150924
1638020184,-184742,true,9487636076,22,9547593855,59957779
1638020487,-184746,true,9483841970,22,9545684622,61842652
1638021149,-184743,true,9486687408,22,9539005315,52317907
1638021171,-184742,true,9487636076,22,9539005315,51369239
1638021425,-184744,true,9485738834,22,9537097800,51358966
1638021649,-184749,true,9480997387,22,9536144186,55146799
1638021816,-184747,true,9482893681,22,9530424501,47530820
1638021839,-184747,true,9482893681,22,9529471554,46577873
1638021966,-184750,true,9480049382,22,9523755872,43706490
1638022332,-184756,true,9474363343,22,9504728345,30365002
1638022505,-184754,true,9476258310,22,9494279414,18021104
1638023034,-184753,true,9477205936,22,9511383651,34177715
1638023507,-184756,true,9474363343,22,9522803591,48440248
1638024167,-184759,true,9471521602,22,9513286023,41764421
1638024523,-184757,true,9473416001,22,9511383651,37967650
1638025145,-184756,true,9474363343,22,9509481660,35118317
1638025362,-184758,true,9472468754,22,9509481660,37012906
1638025720,-184759,true,9471521602,22,9507580049,36058447
1638026052,-184757,true,9473416001,22,9495228842,21812841
1638026141,-184756,true,9474363343,22,9492380843,18017500
1638026303,-184757,true,9473416001,22,9485738834,12322833
1638026885,-184759,true,9471521602,22,9474363343,2841741
1638026933,-184757,true,9473416001,22,9474363343,947342
1638027030,-184755,true,9475310779,22,9474363343,-947436
1638027067,-184756,true,9474363343,22,9475310779,947436
1638027139,-184755,true,9475310779,22,9476258310,947531
1638027170,-184753,true,9477205936,22,9476258310,-947626
1638028179,-184753,true,9477205936,22,9462055288,-15150648
1638028404,-184754,true,9476258310,22,9460163160,-16095150
1638029074,-184753,true,9477205936,22,9455434497,-21771439
1638029211,-184752,true,9478153656,22,9456380041,-21773615
1638029249,-184752,true,9478153656,22,9460163160,-17990496
1638029422,-184752,true,9478153656,22,9498077696,19924040
1638029466,-184747,true,9482893681,22,9514237352,31343671
1638029617,-184739,true,9490482652,22,9570534450,80051798
1638029761,-184738,true,9491431700,22,9622352529,130920829
1638029948,-184734,true,9495228842,22,9717110401,221881559
1638030017,-184728,true,9500927404,22,9750203147,249275743
1638030169,-184719,true,9509481660,22,9815745553,306263893
1638030455,-184716,true,9512334790,22,9875801583,363466793
1638030564,-184713,true,9515188775,22,9883704990,368516215
1638030766,-184709,true,9518995422,22,9870865163,351869741
1638030965,-184703,true,9524708247,22,9833428921,308720674
1638031422,-184702,true,9525660718,22,9751178168,225517450
1638031612,-184698,true,9529471554,22,9734616075,205144521
1638031823,-184695,true,9532330681,22,9729750226,197419545
1638032620,-184689,true,9538051510,22,9723914419,185862909
1638032631,-184689,true,9538051510,22,9723914419,185862909
1638032691,-184686,true,9540913211,22,9721969928,181056717
1638032841,-184683,true,9543775772,22,9718082112,174306340
1638033084,-184678,true,9548548614,22,9707398633,158850019
1638033404,-184678,true,9548548614,22,9692849177,144300563
1638033431,-184674,true,9552368606,22,9691879989,139511383
1638033463,-184671,true,9555234603,22,9689941904,134707301
1638033571,-184666,true,9560013176,22,9692849177,132836001
1638033939,-184666,true,9560013176,22,9688973006,128959830
1638033973,-184663,true,9562881467,22,9688004206,125122739
1638034075,-184660,true,9565750618,22,9687035502,121284884
1638034249,-184655,true,9570534450,22,9684129973,113595523
1638034428,-184655,true,9570534450,22,9677353793,106819343
1638034632,-184651,true,9574363238,22,9671549412,97186174
1638034743,-184648,true,9577235835,22,9676386154,99150319
1638034770,-184644,true,9581067304,22,9679289360,98222056
1638034877,-184643,true,9582025410,22,9693818462,111793052
1638034930,-184636,true,9588734841,22,9708369372,119634531
1638035074,-184630,true,9594489520,22,9743380734,148891214
1638035117,-184626,true,9598327892,22,9750203147,151875255
1638035162,-184625,true,9599287725,22,9751178168,151890443
1638035788,-184622,true,9602167799,22,9771676132,169508333
1638037167,-184616,true,9607930540,22,9775585389,167654849
1638038033,-184612,true,9611774289,22,9770699062,158924773
1638038426,-184611,true,9612735466,22,9765815178,153079712
1638038478,-184608,true,9615619575,22,9763862308,148242733
1638038561,-184602,true,9621390389,22,9758981841,137591452
1638038999,-184599,true,9624277095,22,9732669443,108392348
1638039067,-184599,true,9624277095,22,9728777349,104500254
1638039533,-184596,true,9627164667,22,9711282175,84117508
1638040229,-184590,true,9632942410,22,9711282175,78339765
1638040256,-184588,true,9634869095,22,9711282175,76413080
1638040660,-184588,true,9634869095,22,9728777349,93908254
1638040701,-184585,true,9637759845,22,9726831885,89072040
1638041696,-184581,true,9641615527,22,9664782035,23166508
1638042168,-184580,true,9642579689,22,9607930540,-34649149
1638043246,-184582,true,9640651462,22,9560013176,-80638286
1638043403,-184580,true,9642579689,22,9562881467,-79698222
1638043943,-184578,true,9644508301,22,9588734841,-55773460
1638044056,-184578,true,9644508301,22,9594489520,-50018781
1638045097,-184580,true,9642579689,22,9584900306,-57679383
1638046735,-184578,true,9644508301,22,9585858796,-58649505
1638046888,-184576,true,9646437299,22,9584900306,-61536993
1638047486,-184576,true,9646437299,22,9604088328,-42348971
1638047624,-184578,true,9644508301,22,9608891333,-35616968
1638048613,-184574,true,9648366683,22,9607930540,-40436143
1638049638,-184573,true,9649331520,22,9593530167,-55801353
1638050023,-184572,true,9650296453,22,9590652684,-59643769
1638050060,-184574,true,9648366683,22,9589693714,-58672969
1638050381,-184571,true,9651261482,22,9585858796,-65402686
1638050614,-184570,true,9652226609,22,9556190127,-96036482
1638050795,-184570,true,9652226609,22,9534237243,-117989366
1638050865,-184574,true,9648366683,22,9525660718,-122705965
1638051071,-184572,true,9650296453,22,9500927404,-149369049
1638052037,-184573,true,9649331520,22,9443151033,-206180487
1638052133,-184574,true,9648366683,22,9445984261,-202382422
1638052643,-184576,true,9646437299,22,9469627582,-176809717
1638052940,-184575,true,9647401943,22,9483841970,-163559973
1638052995,-184574,true,9648366683,22,9483841970,-164524713
1638053083,-184574,true,9648366683,22,9482893681,-165473002
1638053388,-184577,true,9645472752,22,9478153656,-167319096
1638053547,-184576,true,9646437299,22,9475310779,-171126520
1638053573,-184574,true,9648366683,22,9474363343,-174003340
1638053654,-184575,true,9647401943,22,9472468754,-174933189
1638053747,-184577,true,9645472752,22,9473416001,-172056751
1638054096,-184575,true,9647401943,22,9478153656,-169248287
1638054246,-184574,true,9648366683,22,9480997387,-167369296
1638054646,-184574,true,9648366683,22,9489533698,-158832985
1638055558,-184576,true,9646437299,22,9488584840,-157852459
1638056112,-184575,true,9647401943,22,9452598434,-194803509
1638056179,-184574,true,9648366683,22,9450708198,-197658485
1638056321,-184574,true,9648366683,22,9447873553,-200493130
1638057176,-184576,true,9646437299,22,9469627582,-176809717
1638057752,-184575,true,9647401943,22,9496178365,-151223578
1638057811,-184579,true,9643543947,22,9499027504,-144516443
1638058141,-184584,true,9638723621,22,9510432608,-128291013
1638058672,-184587,true,9635832582,22,9508530807,-127301775
1638059218,-184590,true,9632942410,22,9507580049,-125362361
1638059953,-184594,true,9629090196,22,9501877497,-127212699
1638060088,-184602,true,9621390389,22,9500927404,-120462985
1638060138,-184606,true,9617542795,22,9499977406,-117565389
1638060332,-184609,true,9614658109,22,9501877497,-112780612
1638060442,-184611,true,9612735466,22,9501877497,-110857969
1638060610,-184617,true,9606969843,22,9500927404,-106042439
1638061349,-184618,true,9606009242,22,9496178365,-109830877
1638061577,-184620,true,9604088328,22,9491431700,-112656628
1638061786,-184623,true,9601207678,22,9487636076,-113571602
1638061917,-184628,true,9596408514,22,9483841970,-112566544
1638062114,-184630,true,9594489520,22,9480049382,-114440138
1638062203,-184632,true,9592570910,22,9477205936,-115364974
1638062890,-184634,true,9590652684,22,9471521602,-119131082
1638062925,-184638,true,9586817381,22,9470574544,-116242837
1638063122,-184640,true,9584900306,22,9468680714,-116219592
1638063159,-184642,true,9582983613,22,9468680714,-114302899
1638063195,-184645,true,9580109293,22,9467733940,-112375353
1638063250,-184650,true,9575320675,22,9466787262,-108533413
1638064415,-184655,true,9570534450,22,9374470453,-196063997
1638064477,-184657,true,9568620631,22,9370721602,-197899029
1638064610,-184660,true,9565750618,22,9355741184,-210009434
1638064705,-184665,true,9560969178,22,9343587230,-217381948
1638064735,-184674,true,9552368606,22,9340784715,-211583891
1638064959,-184677,true,9549503469,22,9313737029,-235766440
1638065164,-184680,true,9546639191,22,9289553974,-257085217
1638065772,-184685,true,9541867303,22,9263580901,-278286402
1638065995,-184695,true,9532330681,22,9270994360,-261336321
1638066667,-184701,true,9526613284,22,9296988219,-229625065
1638066745,-184707,true,9520899316,22,9296988219,-223911097
1638067050,-184712,true,9516140294,22,9296058613,-220081681
1638067461,-184723,true,9505678818,22,9263580901,-242097917
1638068483,-184726,true,9502827685,22,9228447845,-274379840
1638068513,-184732,true,9497127983,22,9230293627,-266834356
1638068546,-184737,true,9492380843,22,9233062992,-259317851
1638069155,-184747,true,9482893681,22,9279341593,-203552088
1638069191,-184749,true,9480997387,22,9282125674,-198871713
1638069758,-184756,true,9474363343,22,9264507259,-209856084
1638070032,-184760,true,9470574544,22,9248771762,-221802782
1638070147,-184769,true,9462055288,22,9245073178,-216982110
1638070234,-184771,true,9460163160,22,9245997685,-214165475
1638070366,-184778,true,9453543694,22,9245997685,-207546009
1638070686,-184782,true,9449763222,22,9245997685,-203765537
1638070720,-184792,true,9440318654,22,9245997685,-194320969
1638070841,-184794,true,9438430873,22,9249696639,-188734234
1638071330,-184799,true,9433713073,22,9259876394,-173836679
1638071533,-184801,true,9431826614,22,9262654635,-169171979
1638071703,-184808,true,9425226975,22,9273775936,-151451039
1638072076,-184809,true,9424284547,22,9278413752,-145870795
1638072105,-184812,true,9421457827,22,9279341593,-142116234
1638072361,-184814,true,9419573818,22,9291411978,-128161840
1638072483,-184822,true,9412041549,22,9294199680,-117841869
1638072694,-184823,true,9411100439,22,9290482929,-120617510
1638073498,-184826,true,9408277673,22,9292341119,-115936554
1638074178,-184829,true,9405455754,22,9286767665,-118688089
1638074209,-184837,true,9397934774,22,9285839081,-112095693
1638074261,-184839,true,9396055469,22,9283982192,-112073277
1638075075,-184843,true,9392297987,22,9251546671,-140751316
1638075624,-184846,true,9389480861,22,9250621609,-138859252
1638075825,-184854,true,9381972655,22,9249696639,-132276016
1638075872,-184855,true,9381034552,22,9257098987,-123935565
1638076067,-184856,true,9380096542,22,9281197554,-98898988
1638076280,-184855,true,9381034552,22,9308150743,-72883809
1638076362,-184861,true,9375407900,22,9317463083,-57944817
1638076444,-184860,true,9376345441,22,9325852155,-50493286
1638076616,-184861,true,9375407900,22,9342652965,-32754935
1638077718,-184861,true,9375407900,22,9337049335,-38358565
1638079250,-184867,true,9369784624,22,9336115723,-33668901
1638079340,-184866,true,9370721602,22,9336115723,-34605879
1638079689,-184868,true,9368847739,22,9337049335,-31798404
1638079808,-184868,true,9368847739,22,9337049335,-31798404
1638080926,-184874,true,9363228397,22,9331449065,-31779332
1638081727,-184873,true,9364164720,22,9331449065,-32715655
1638082120,-184875,true,9362292168,22,9335182205,-27109963
1638082429,-184874,true,9363228397,22,9335182205,-28046192
1638082442,-184881,true,9356676758,22,9335182205,-21494553
1638082766,-184880,true,9357612426,22,9344521589,-13090837
1638083113,-184881,true,9356676758,22,9357612426,935668
1638083205,-184880,true,9357612426,22,9361356033,3743607
1638083574,-184887,true,9351064717,22,9369784624,18719907
1638083635,-184885,true,9352935023,22,9369784624,16849601
1638083653,-184886,true,9351999823,22,9368847739,16847916
1638084279,-184884,true,9353870317,22,9395115958,41245641
1638084607,-184889,true,9349194784,22,9407336939,58142155
1638086301,-184889,true,9349194784,22,9396055469,46860685
1638086350,-184890,true,9348259958,22,9395115958,46856000
1638086830,-184888,true,9350129704,22,9392297987,42168283
1638087693,-184895,true,9343587230,22,9383849143,40261913
1638087711,-184895,true,9343587230,22,9382910852,39323622
1638087998,-184896,true,9342652965,22,9381034552,38381587
1638088043,-184894,true,9344521589,22,9381034552,36512963
1638088245,-184901,true,9337983040,22,9378220804,40237764
1638088303,-184901,true,9337983040,22,9377283076,39300036
1638088425,-184903,true,9336115723,22,9376345441,40229718
1638088617,-184900,true,9338916838,22,9378220804,39303966
1638088850,-184907,true,9332382210,22,9381972655,49590445
1638089028,-184906,true,9333315448,22,9384787528,51472080
1638089802,-184908,true,9331449065,22,9353870317,22421252
1638089941,-184906,true,9333315448,22,9347325226,14009778
1638090100,-184913,true,9326784740,22,9346390587,19605847
1638090777,-184912,true,9327717419,22,9336115723,8398304
1638091216,-184915,true,9324919663,22,9330516014,5596351
1638092012,-184912,true,9327717419,22,9353870317,26152898
1638092099,-184919,true,9321190627,22,9356676758,35486131
1638092125,-184918,true,9322122746,22,9357612426,35489680
1638093013,-184920,true,9320258602,22,9376345441,56086839
1638093932,-184917,true,9323054959,22,9373533100,50478141
1638094496,-184919,true,9321190627,22,9372595840,51405213
1638094738,-184919,true,9321190627,22,9366974251,45783624
1638095243,-184920,true,9320258602,22,9357612426,37353824
1638095930,-184917,true,9323054959,22,9353870317,30815358
1638096376,-184915,true,9324919663,22,9353870317,28950654
1638098863,-184915,true,9324919663,22,9338916838,13997175
1638099046,-184916,true,9323987264,22,9351999823,28012559
1638101260,-184912,true,9327717419,22,9355741184,28023765
1638101263,-184912,true,9327717419,22,9354805704,27088285
1638101579,-184911,true,9328650190,22,9342652965,14002775
1638101743,-184913,true,9326784740,22,9336115723,9330983
1638102020,-184911,true,9328650190,22,9324919663,-3730527
1638102205,-184910,true,9329583055,22,9318394829,-11188226
1638102494,-184907,true,9332382210,22,9317463083,-14919127
1638102777,-184909,true,9330516014,22,9315599870,-14916144
1638104957,-184908,true,9331449065,22,9285839081,-45609984
1638104972,-184908,true,9331449065,22,9285839081,-45609984
1638105003,-184908,true,9331449065,22,9285839081,-45609984
1638106601,-184908,true,9331449065,22,9287696342,-43752723
1638106653,-184907,true,9332382210,22,9286767665,-45614545
1638106970,-184906,true,9333315448,22,9284910590,-48404858
1638106995,-184906,true,9333315448,22,9283982192,-49333256
1638107205,-184907,true,9332382210,22,9281197554,-51184656
1638107504,-184906,true,9333315448,22,9265433709,-67881739
1638109164,-184906,true,9333315448,22,9242300211,-91015237
1638110554,-184907,true,9332382210,22,9224757388,-107624822
1638110927,-184908,true,9331449065,22,9224757388,-106691677
1638112008,-184908,true,9331449065,22,9238604215,-92844850
1638112202,-184908,true,9331449065,22,9237680447,-93768618
1638112256,-184908,true,9331449065,22,9239528075,-91920990
1638112738,-184910,true,9329583055,22,9258024697,-71558358
1638113021,-184909,true,9330516014,22,9274703314,-55812700
1638113538,-184908,true,9331449065,22,9285839081,-45609984
1638113770,-184909,true,9330516014,22,9297917917,-32598097
1638114021,-184909,true,9330516014,22,9309081558,-21434456
1638114172,-184908,true,9331449065,22,9315599870,-15849195
1638114306,-184906,true,9333315448,22,9330516014,-2799434
1638115236,-184905,true,9334248780,22,9383849143,49600363
1638117071,-184904,true,9335182205,22,9378220804,43038599
1638117246,-184902,true,9337049335,22,9379158626,42109291
1638117914,-184900,true,9338916838,22,9349194784,10277946
1638118046,-184900,true,9338916838,22,9331449065,-7467773
1638118357,-184902,true,9337049335,22,9303498063,-33551272
1638118539,-184903,true,9336115723,22,9288625111,-47490612
1638118879,-184905,true,9334248780,22,9257098987,-77149793
1638119154,-184905,true,9334248780,22,9233986298,-100262482
1638119905,-184907,true,9332382210,22,9233062992,-99319218
1638119939,-184908,true,9331449065,22,9234909697,-96539368
1638121841,-184910,true,9329583055,22,9245997685,-83585370
1638121855,-184910,true,9329583055,22,9247846977,-81736078
1638121985,-184912,true,9327717419,22,9258024697,-69692722
1638122008,-184912,true,9327717419,22,9261728462,-65988957
1638122337,-184911,true,9328650190,22,9286767665,-41882525
1638122583,-184911,true,9328650190,22,9305358856,-23291334
1638122610,-184912,true,9327717419,22,9307220021,-20497398
1638122725,-184914,true,9325852155,22,9309081558,-16770597
1638122776,-184913,true,9326784740,22,9305358856,-21425884
1638122931,-184915,true,9324919663,22,9293270353,-31649310
1638123500,-184917,true,9323054959,22,9254322413,-68732546
1638123564,-184919,true,9321190627,22,9253397073,-67793554
1638123637,-184918,true,9322122746,22,9253397073,-68725673
1638124130,-184921,true,9319326669,22,9251546671,-67779998
1638124191,-184923,true,9317463083,22,9251546671,-65916412
1638124240,-184926,true,9314668403,22,9251546671,-63121732
1638125232,-184927,true,9313737029,22,9209089406,-104647623
1638125286,-184930,true,9310943467,22,9205406691,-105536776
1638125376,-184932,true,9309081558,22,9203565886,-105515672
1638125524,-184935,true,9306289392,22,9199885379,-106404013
1638125600,-184937,true,9304428413,22,9199885379,-104543034
1638125690,-184939,true,9302567806,22,9198965483,-103602323
1638126058,-184942,true,9299777594,22,9192528782,-107248812
1638126100,-184945,true,9296988219,22,9191609621,-105378598
1638126401,-184946,true,9296058613,22,9191609621,-104448992
1638127640,-184949,true,9293270353,22,9178751014,-114519339
1638127652,-184951,true,9291411978,22,9177833230,-113578748
1638128006,-184954,true,9288625111,22,9176915539,-111709572
1638128781,-184956,true,9286767665,22,9174163015,-112604650
1638131165,-184959,true,9283982192,22,9171411316,-112570876
1638132565,-184961,true,9282125674,22,9164993895,-117131779
1638134444,-184964,true,9279341593,22,9171411316,-107930277
1638134973,-184965,true,9278413752,22,9168660443,-109753309
1638135008,-184968,true,9275630784,22,9175080431,-100550353
1638135066,-184969,true,9274703314,22,9185178067,-89525247
1638135739,-184969,true,9274703314,22,9256173370,-18529944
1638135987,-184970,true,9273775936,22,9252471826,-21304110
1638136368,-184972,true,9271921459,22,9233986298,-37935161
1638136723,-184976,true,9268213618,22,9188852689,-79360929
1638138449,-184980,true,9264507259,22,9142111170,-122396089
1638138878,-184980,true,9264507259,22,9140283022,-124224237
1638141126,-184984,true,9260802382,22,9124758517,-136043865
1638141984,-184987,true,9258024697,22,9122021636,-136003061
1638142079,-184991,true,9254322413,22,9120197506,-134124907
1638142142,-184992,true,9253397073,22,9122933839,-130463234
1638142183,-184995,true,9250621609,22,9124758517,-125863092
1638142274,-184998,true,9247846977,22,9127496218,-120350759
1638142476,-185001,true,9245073178,22,9135714251,-109358927
1638142512,-185001,true,9245073178,22,9136627823,-108445355
1638142960,-185005,true,9241376073,22,9153087739,-88288334
1638143025,-185007,true,9239528075,22,9157665198,-81862877
1638143696,-185009,true,9237680447,22,9160412773,-77267674
1638143766,-185009,true,9237680447,22,9161328814,-76351633
1638143780,-185013,true,9233986298,22,9161328814,-72657484
1638143990,-185014,true,9233062992,22,9166826986,-66236006
1638144206,-185014,true,9233062992,22,9175080431,-57982561
1638144395,-185014,true,9233062992,22,9180586856,-52476136
1638144692,-185017,true,9230293627,22,9190690552,-39603075
1638144761,-185019,true,9228447845,22,9190690552,-37757293
1638144768,-185019,true,9228447845,22,9190690552,-37757293
1638145365,-185021,true,9226602432,22,9140283022,-86319410
1638145630,-185025,true,9222912714,22,9122021636,-100891078
1638145841,-185027,true,9221068408,22,9122933839,-98134569
1638146096,-185026,true,9221990515,22,9128408968,-93581547
1638146154,-185027,true,9221068408,22,9130234741,-90833667
1638146284,-185030,true,9218302640,22,9138455240,-79847400
1638146645,-185030,true,9218302640,22,9156749524,-61553116
1638146689,-185029,true,9219224471,22,9159496823,-59727648
1638146705,-185029,true,9219224471,22,9161328814,-57895657
1638147048,-185032,true,9216459256,22,9191609621,-24849635
1638147473,-185032,true,9216459256,22,9206327231,-10132025
1638147487,-185032,true,9216459256,22,9207247864,-9211392
1638147616,-185033,true,9215537703,22,9212773594,-2764109
1638147845,-185036,true,9212773594,22,9204486242,-8287352
1638147950,-185038,true,9210931316,22,9194367380,-16563936
1638148006,-185038,true,9210931316,22,9189771575,-21159741
1638148018,-185042,true,9207247864,22,9187933896,-19313968
1638148187,-185048,true,9201725448,22,9172328457,-29396991
1638148194,-185051,true,9198965483,22,9171411316,-27554167
1638148427,-185051,true,9198965483,22,9149427419,-49538064
1638149064,-185052,true,9198045678,22,9154003048,-44042630
1638149781,-185058,true,9192528782,22,9167743668,-24785114
1638149964,-185058,true,9192528782,22,9167743668,-24785114
1638150073,-185058,true,9192528782,22,9166826986,-25701796
1638150270,-185057,true,9193448035,22,9167743668,-25704367
1638150696,-185062,true,9188852689,22,9162244947,-26607742
1638150851,-185062,true,9188852689,22,9156749524,-32103165
1638150890,-185061,true,9189771575,22,9155833940,-33937635
1638151261,-185061,true,9189771575,22,9146683140,-43088435
1638151373,-185067,true,9184259641,22,9146683140,-37576501
1638151394,-185068,true,9183341307,22,9145768563,-37572744
1638151767,-185067,true,9184259641,22,9129321808,-54937833
1638151959,-185072,true,9179668889,22,9111993431,-67675458
1638152248,-185079,true,9173245690,22,9082883108,-90362582
1638152737,-185080,true,9172328457,22,9048435367,-123893090
1638154229,-185080,true,9172328457,22,9043008206,-129320251
1638154294,-185084,true,9168660443,22,9042103995,-126556448
1638154499,-185090,true,9163161171,22,9042103995,-121057176
1638154605,-185091,true,9162244947,22,9038488058,-123756889
1638154838,-185092,true,9161328814,22,9029454539,-131874275
1638154915,-185096,true,9157665198,22,9025843660,-131821538
1638155023,-185102,true,9152172522,22,9021332091,-130840431
1638155058,-185103,true,9151257396,22,9019528096,-131729300
1638155623,-185104,true,9150342362,22,9004208689,-146133673
1638155880,-185107,true,9147597808,22,9004208689,-143389119
1638155885,-185112,true,9143025381,22,9003308358,-139717023
1638155994,-185113,true,9142111170,22,9003308358,-138802812
1638156467,-185114,true,9141197050,22,8997008562,-144188488
1638156845,-185117,true,9138455240,22,8995209431,-143245809
1638157317,-185122,true,9133887382,22,9015921186,-117966196
1638157332,-185122,true,9133887382,22,9015019684,-118867698
1638157566,-185123,true,9132974085,22,9016822778,-116151307
1638157585,-185125,true,9131147764,22,9017724461,-113423303
1638158085,-185131,true,9125670992,22,9006910222,-118760770
1638158240,-185131,true,9125670992,22,8999707935,-125963057
1638158721,-185132,true,9124758517,22,9013216951,-111541566
1638159363,-185133,true,9123846132,22,9037584299,-86261833
1638159556,-185138,true,9119285577,22,9039391906,-79893671
1638159858,-185138,true,9119285577,22,9035777053,-83508524
1638160012,-185138,true,9119285577,22,9033066862,-86218715
1638160047,-185139,true,9118373740,22,9035777053,-82596687
1638160144,-185144,true,9113815920,22,9041199875,-72616045
1638160354,-185143,true,9114727302,22,9052960490,-61766812
1638161080,-185145,true,9112904630,22,9091060974,-21843656
1638161173,-185148,true,9110171305,22,9090151959,-20019346
1638161446,-185152,true,9106528148,22,9087425458,-19102690
1638161771,-185150,true,9108349544,22,9086516807,-21832737
1638162318,-185150,true,9108349544,22,9069269677,-39079867
1638162725,-185153,true,9105617586,22,9024038762,-81578824
1638163590,-185157,true,9101976249,22,9024941166,-77035083
1638163959,-185155,true,9103796735,22,9024941166,-78855569
1638164031,-185155,true,9103796735,22,9024941166,-78855569
1638164258,-185158,true,9101066143,22,9024941166,-76124977
1638164277,-185162,true,9097426626,22,9024941166,-72485460
1638164313,-185161,true,9098336369,22,9024038762,-74297607
1638164903,-185162,true,9097426626,22,9022234225,-75192401
1638165365,-185165,true,9094697944,22,9016822778,-77875166
1638165981,-185169,true,9091060974,22,9011414578,-79646396
1638166004,-185168,true,9091970080,22,9011414578,-80555502
1638166045,-185169,true,9091060974,22,9011414578,-79646396
1638166114,-185172,true,9088334201,22,9011414578,-76919623
1638166728,-185176,true,9084699776,22,9009612565,-75087211
1638167672,-185176,true,9084699776,22,9013216951,-71482825
1638167782,-185178,true,9082883108,22,9010513526,-72369582
1638167795,-185181,true,9080158788,22,9010513526,-69645262
1638168008,-185185,true,9076527633,22,9006910222,-69617411
1638168094,-185185,true,9076527633,22,9005109110,-71418523
1638168242,-185187,true,9074712599,22,9009612565,-65100034
1638169471,-185187,true,9074712599,22,9034873566,-39839033
1638169848,-185190,true,9071990730,22,9034873566,-37117164
1638172688,-185190,true,9071990730,22,9035777053,-36213677
1638175490,-185191,true,9071083622,22,9036680631,-34402991
1638175939,-185192,true,9070176604,22,9036680631,-33495973
1638176829,-185195,true,9067456095,22,9033970169,-33485926
1638176885,-185196,true,9066549440,22,9033066862,-33482578
1638177046,-185198,true,9064736402,22,9032163646,-32572756
1638177222,-185199,true,9063830019,22,9034873566,-28956453
1638177638,-185200,true,9062923727,22,9097426626,34502899
1638178310,-185200,true,9062923727,22,9167743668,104819941
1638179399,-185203,true,9060205393,22,9059299464,-905929
1638179466,-185204,true,9059299464,22,9061111414,1811950
1638179626,-185205,true,9058393624,22,9065642876,7249252
1638180712,-185205,true,9058393624,22,9082883108,24489484
1638181460,-185208,true,9055676650,22,9080158788,24482138
1638182809,-185208,true,9055676650,22,9081066804,25390154
1638182815,-185207,true,9056582217,22,9080158788,23576571
1638183781,-185207,true,9056582217,22,9078343029,21760812
1638186141,-185212,true,9052055284,22,9027648919,-24406365
1638186685,-185213,true,9051150169,22,9030357484,-20792685
1638188312,-185213,true,9051150169,22,9030357484,-20792685
1638188461,-185214,true,9050245145,22,9029454539,-20790606
1638188774,-185218,true,9046625951,22,9033970169,-12655782
1638188892,-185220,true,9044816898,22,9034873566,-9943332
1638189099,-185220,true,9044816898,22,9035777053,-9039845
1638190104,-185220,true,9044816898,22,9035777053,-9039845
1638190207,-185224,true,9041199875,22,9033970169,-7229706
1638190309,-185226,true,9039391906,22,9030357484,-9034422
1638192547,-185227,true,9038488058,22,8971853430,-66634628
1638192800,-185228,true,9037584299,22,8991612246,-45972053
1638193489,-185231,true,9034873566,22,9084699776,49826210
1638193507,-185231,true,9034873566,22,9084699776,49826210
1638193593,-185227,true,9038488058,22,9085608246,47120188
1638193812,-185227,true,9038488058,22,9079250863,40762805
1638193886,-185231,true,9034873566,22,9074712599,39839033
1638194750,-185231,true,9034873566,22,9045721379,10847813
1638195622,-185227,true,9038488058,22,9047530614,9042556
1638196399,-185227,true,9038488058,22,9042103995,3615937
1638196730,-185230,true,9035777053,22,9041199875,5422822
1638197146,-185229,true,9036680631,22,9041199875,4519244
1638197742,-185225,true,9040295846,22,9040295846,0
1638198295,-185226,true,9039391906,22,9037584299,-1807607
1638198364,-185228,true,9037584299,22,9037584299,0
1638201539,-185228,true,9037584299,22,9037584299,0
1638201753,-185224,true,9041199875,22,9035777053,-5422822
1638202099,-185224,true,9041199875,22,9026746244,-14453631
1638202147,-185226,true,9039391906,22,9024941166,-14450740
1638202287,-185227,true,9038488058,22,9021332091,-17155967
1638202602,-185223,true,9042103995,22,9012315719,-29788276
1638202906,-185224,true,9041199875,22,9004208689,-36991186
1638203561,-185227,true,9038488058,22,8988915302,-49572756
1638203684,-185228,true,9037584299,22,8989814193,-47770106
1638203722,-185224,true,9041199875,22,8993410659,-47789216
1638203802,-185224,true,9041199875,22,9000607906,-40591969
1638203993,-185224,true,9041199875,22,9028551684,-12648191
1638204203,-185225,true,9040295846,22,9046625951,6330105
1638204893,-185222,true,9043008206,22,9062017525,19009319
1638204940,-185222,true,9043008206,22,9062017525,19009319
1638205311,-185221,true,9043912506,22,9091060974,47148468
1638205415,-185222,true,9043008206,22,9105617586,62609380
1638205465,-185216,true,9048435367,22,9115638775,67203408
1638205672,-185217,true,9047530614,22,9154918448,107387834
1638205736,-185215,true,9049340211,22,9167743668,118403457
1638205755,-185215,true,9049340211,22,9171411316,122071105
1638205876,-185209,true,9054771172,22,9193448035,138676863
1638205892,-185209,true,9054771172,22,9197125966,142354794
1638205913,-185205,true,9058393624,22,9200805368,142411744
1638205947,-185203,true,9060205393,22,9210010315,149804922
1638206062,-185191,true,9071083622,22,9247846977,176763355
1638206233,-185190,true,9071990730,22,9299777594,227786864
1638206270,-185186,true,9075620071,22,9307220021,231599950
1638206305,-185184,true,9077435285,22,9312805749,235370464
1638206312,-185173,true,9087425458,22,9313737029,226311571
1638206339,-185175,true,9085608246,22,9316531430,230923184
1638206425,-185171,true,9089243034,22,9323987264,234744230
1638206444,-185169,true,9091060974,22,9325852155,234791181
1638206564,-185157,true,9101976249,22,9342652965,240676716
1638206661,-185159,true,9100156127,22,9348259958,248103831
1638206812,-185156,true,9102886447,22,9353870317,250983870
1638207031,-185155,true,9103796735,22,9310943467,207146732
1638207093,-185144,true,9113815920,22,9298847709,185031789
1638207107,-185147,true,9111082322,22,9298847709,187765387
1638207177,-185143,true,9114727302,22,9296058613,181331311
1638207537,-185139,true,9118373740,22,9310012466,191638726
1638207575,-185127,true,9129321808,22,9312805749,183483941
1638207652,-185128,true,9128408968,22,9323054959,194645991
1638207668,-185126,true,9130234741,22,9323987264,193752523
1638207838,-185122,true,9133887382,22,9338916838,205029456
1638207976,-185111,true,9143939684,22,9352935023,208995339
1638207991,-185114,true,9141197050,22,9353870317,212673267
1638208229,-185111,true,9143939684,22,9348259958,204320274
1638208268,-185108,true,9146683140,22,9346390587,199707447
1638208287,-185096,true,9157665198,22,9347325226,189660028
1638208338,-185099,true,9154918448,22,9347325226,192406778
1638208392,-185096,true,9157665198,22,9343587230,185922032
1638208422,-185093,true,9160412773,22,9343587230,183174457
1638208591,-185085,true,9167743668,22,9332382210,164638542
1638208856,-185089,true,9164077488,22,9328650190,164572702
1638209160,-185085,true,9167743668,22,9324919663,157175995
1638209246,-185082,true,9170494267,22,9321190627,150696360
1638209457,-185076,true,9175997939,22,9296058613,120060674
1638209518,-185079,true,9173245690,22,9290482929,117237239
1638209556,-185077,true,9175080431,22,9286767665,111687234
1638209702,-185075,true,9176915539,22,9277486003,100570464
1638209928,-185067,true,9184259641,22,9260802382,76542741
1638210435,-185071,true,9180586856,22,9254322413,73735557
1638210726,-185067,true,9184259641,22,9253397073,69137432
1638210961,-185063,true,9187933896,22,9270067353,82133457
1638211084,-185055,true,9195286816,22,9278413752,83126936
1638211211,-185057,true,9193448035,22,9286767665,93319630
1638211535,-185053,true,9197125966,22,9309081558,111955592
1638212020,-185049,true,9200805368,22,9320258602,119453234
1638212040,-185041,true,9208168589,22,9323054959,114886370
1638212416,-185041,true,9208168589,22,9390419809,182251220
1638212468,-185035,true,9213694872,22,9401694512,187999640
1638212479,-185027,true,9221068408,22,9403574945,182506537
1638212566,-185016,true,9231216656,22,9432769796,201553140
1638212639,-185009,true,9237680447,22,9469627582,231947135
1638212671,-185002,true,9244148763,22,9483841970,239693207
1638212710,-184992,true,9253397073,22,9505678818,252281745
1638212734,-184982,true,9262654635,22,9518043618,255388983
1638212791,-184972,true,9271921459,22,9556190127,284268668
1638212814,-184962,true,9281197554,22,9571491504,290293950
1638212834,-184951,true,9291411978,22,9582983613,291571635
1638212895,-184940,true,9301637643,22,9626202047,324564404
1638212903,-184929,true,9311874561,22,9631016111,319141550
1638212977,-184922,true,9318394829,22,9661883180,343488351
1638213068,-184913,true,9326784740,22,9692849177,366064437
1638213100,-184903,true,9336115723,22,9704486995,368371272
1638213230,-184891,true,9347325226,22,9766791760,419466534
1638213442,-184882,true,9355741184,22,9858042017,502300833
1638213535,-184871,true,9366037647,22,9877776842,511739195
1638213627,-184860,true,9376345441,22,9900520737,524175296
1638213644,-184847,true,9388542006,22,9906462535,517920529
1638213668,-184835,true,9399814455,22,9910425714,510611259
1638213899,-184825,true,9409218501,22,9928279652,519061151
1638213963,-184814,true,9419573818,22,9940200142,520626324
1638214045,-184801,true,9431826614,22,9950144816,518318202
1638214144,-184789,true,9443151033,22,9956116396,512965363
1638214179,-184779,true,9452598434,22,9958107719,505509285
1638214245,-184769,true,9462055288,22,9952134945,490079657
1638214305,-184759,true,9471521602,22,9942188281,470666679
1638214502,-184754,true,9476258310,22,9902500940,426242630
1638214536,-184745,true,9484790355,22,9891614722,406824367
1638214582,-184735,true,9494279414,22,9877776842,383497428
1638214676,-184724,true,9504728345,22,9860999725,356271380
1638214891,-184720,true,9508530807,22,9823600899,315070092
1638214895,-184712,true,9516140294,22,9823600899,307460605
1638215108,-184701,true,9526613284,22,9823600899,296987615
1638215119,-184691,true,9536144186,22,9824583259,288439073
1638215120,-184686,true,9540913211,22,9824583259,283670048
1638215127,-184678,true,9548548614,22,9824583259,276034645
1638215409,-184670,true,9556190127,22,9860013723,303823596
1638215443,-184661,true,9564794139,22,9863958321,299164182
1638215514,-184656,true,9569577493,22,9873826719,304249226
1638215619,-184649,true,9576278207,22,9887659065,311380858
1638215803,-184648,true,9577235835,22,9897551175,320315340
1638215903,-184639,true,9585858796,22,9886670398,300811602
1638216410,-184636,true,9588734841,22,9841298418,252563577
1638216418,-184629,true,9595448969,22,9840314387,244865418
1638216681,-184628,true,9596408514,22,9808877279,212468765
1638216940,-184617,true,9606969843,22,9792217186,185247343
1638217034,-184614,true,9609852222,22,9787322545,177470323
1638217279,-184609,true,9614658109,22,9748253399,133595290
1638217291,-184609,true,9614658109,22,9746304041,131645932
1638217358,-184599,true,9624277095,22,9740458305,116181210
1638217589,-184598,true,9625239523,22,9697696571,72457048
1638218011,-184595,true,9628127384,22,9582983613,-45143771
1638218464,-184596,true,9627164667,22,9517091908,-110072759
1638218773,-184586,true,9636796165,22,9515188775,-121607390
1638218815,-184586,true,9636796165,22,9515188775,-121607390
1638219309,-184587,true,9635832582,22,9518995422,-116837160
1638219429,-184588,true,9634869095,22,9519947321,-114921774
1638220001,-184579,true,9643543947,22,9514237352,-129306595
1638220064,-184579,true,9643543947,22,9514237352,-129306595
1638220228,-184580,true,9642579689,22,9513286023,-129293666
1638220319,-184580,true,9642579689,22,9517091908,-125487781
1638221026,-184568,true,9654157150,22,9565750618,-88406532
1638221186,-184568,true,9654157150,22,9573405898,-80751252
1638221210,-184568,true,9654157150,22,9573405898,-80751252
1638221266,-184568,true,9654157150,22,9576278207,-77878943
1638221385,-184555,true,9666715088,22,9588734841,-77980247
1638221490,-184553,true,9668648527,22,9599287725,-69360802
1638221518,-184553,true,9668648527,22,9604088328,-64560199
1638221697,-184552,true,9669615392,22,9625239523,-44375869
1638221788,-184538,true,9683161657,22,9635832582,-47329075
1638222451,-184539,true,9682193437,22,9613696740,-68496697
1638222484,-184539,true,9682193437,22,9609852222,-72341215
1638222619,-184537,true,9684129973,22,9600247653,-83882320
1638222697,-184523,true,9697696571,22,9589693714,-108002857
1638222986,-184523,true,9697696571,22,9576278207,-121418364
1638224016,-184522,true,9698666341,22,9587776063,-110890278
1638224083,-184521,true,9699636207,22,9587776063,-111860144
1638224147,-184507,true,9713224528,22,9588734841,-124489687
1638224191,-184507,true,9713224528,22,9596408514,-116816014
1638224261,-184504,true,9716138787,22,9604088328,-112050459
1638224393,-184502,true,9718082112,22,9617542795,-100539317
1638224431,-184488,true,9731696274,22,9621390389,-110305885
1638224482,-184489,true,9730723201,22,9629090196,-101633005
1638224570,-184486,true,9733642710,22,9635832582,-97810128
1638224944,-184486,true,9733642710,22,9665748513,-67894197
1638225023,-184474,true,9745329508,22,9670582354,-74747154
1638225089,-184476,true,9743380734,22,9668648527,-74732207
1638225241,-184478,true,9741432350,22,9664782035,-76650315
1638225263,-184478,true,9741432350,22,9665748513,-75683837
1638225312,-184472,true,9747278671,22,9670582354,-76696317
1638225336,-184476,true,9743380734,22,9672516567,-70864167
1638225484,-184473,true,9746304041,22,9704486995,-41817046
1638225632,-184475,true,9744355072,22,9739484356,-4870716
1638225878,-184471,true,9748253399,22,9800053702,51800303
1638226089,-184477,true,9742406494,22,9840314387,97907893
1638226110,-184475,true,9744355072,22,9843266776,98911704
1638226377,-184480,true,9739484356,22,9835395705,95911349
1638226389,-184477,true,9742406494,22,9834412264,92005770
1638226578,-184481,true,9738510505,22,9819672440,81161935
1638226615,-184476,true,9743380734,22,9819672440,76291706
1638226966,-184477,true,9742406494,22,9835395705,92989211
1638227035,-184476,true,9743380734,22,9837362883,93982149
1638227045,-184481,true,9738510505,22,9837362883,98852378
1638227157,-184478,true,9741432350,22,9844251103,102818753
1638227506,-184482,true,9737536751,22,9855085195,117548444
1638227520,-184482,true,9737536751,22,9854099785,116563034
1638227899,-184488,true,9731696274,22,9830479483,98783209
1638228362,-184485,true,9734616075,22,9832445677,97829602
1638228452,-184488,true,9731696274,22,9835395705,103699431
1638228549,-184487,true,9732669443,22,9838346619,105677176
1638228694,-184493,true,9726831885,22,9842282548,115450663
1638228782,-184490,true,9729750226,22,9843266776,113516550
1638228864,-184491,true,9728777349,22,9845235528,116458179
1638228909,-184489,true,9730723201,22,9843266776,112543575
1638228964,-184492,true,9727804568,22,9844251103,116446535
1638229160,-184488,true,9731696274,22,9845235528,113539254
1638229233,-184488,true,9731696274,22,9854099785,122403511
1638229346,-184484,true,9735589536,22,9870865163,135275627
1638229466,-184486,true,9733642710,22,9885681830,152039120
1638229499,-184479,true,9740458305,22,9892603883,152145578
1638229550,-184481,true,9738510505,22,9902500940,163990435
1638229748,-184477,true,9742406494,22,9942188281,199781787
1638229928,-184482,true,9737536751,22,9975050052,237513301
1638230117,-184475,true,9744355072,22,10009021242,264666170
1638230139,-184475,true,9744355072,22,10014026753,269671681
1638230216,-184470,true,9749228224,22,10025047692,275819468
1638230251,-184474,true,9745329508,22,10030061219,284731711
1638230268,-184465,true,9754103814,22,10034073845,279970031
1638230323,-184461,true,9758006040,22,10053155753,295149713
1638230343,-184454,true,9764838694,22,10061201093,296362399
1638230373,-184455,true,9763862308,22,10070259797,306397489
1638230434,-184445,true,9773630565,22,10084367328,310736763
1638230466,-184440,true,9778518358,22,10093446890,314928532
1638230482,-184433,true,9785365375,22,10098494623,313129248
1638230519,-184432,true,9786343911,22,10107586905,321242994
1638230962,-184425,true,9793196407,22,10177566909,384370502
1638230988,-184421,true,9797114273,22,10178584665,381470392
1638231353,-184414,true,9803974311,22,10111630546,307656235
1638231442,-184412,true,9805935204,22,10091428504,285493300
1638231603,-184404,true,9813782699,22,10059189155,245406456
1638231804,-184399,true,9818690571,22,10019034768,200344197
1638232252,-184395,true,9822618637,22,9949149901,126531264
1638232822,-184393,true,9824583259,22,9911416757,86833498
1638233111,-184386,true,9831462530,22,9886670398,55207868
1638233174,-184382,true,9835395705,22,9878764620,43368915
1638233216,-184378,true,9839330454,22,9874814102,35483648
1638233810,-184377,true,9840314387,22,9849174213,8859826
1638234147,-184369,true,9848189394,22,9869878175,21688781
1638234554,-184365,true,9852129261,22,9881728546,29599285
1638234569,-184363,true,9854099785,22,9881728546,27628761
1638234702,-184362,true,9855085195,22,9886670398,31585203
1638235233,-184354,true,9862972023,22,9886670398,23698375
1638235409,-184350,true,9866917804,22,9900520737,33602933
1638235527,-184349,true,9867904496,22,9903491190,35586694
1638236044,-184351,true,9865931211,22,9898540930,32609719
1638236720,-184344,true,9872839435,22,9867904496,-4934939
1638236731,-184341,true,9875801583,22,9867904496,-7897087
1638236797,-184340,true,9876789163,22,9866917804,-9871359
1638237114,-184339,true,9877776842,22,9864944716,-12832126
1638237791,-184333,true,9883704990,22,9857056311,-26648679
1638238084,-184329,true,9887659065,22,9858042017,-29617048
1638238434,-184328,true,9888647831,22,9860013723,-28634108
1638239231,-184325,true,9891614722,22,9869878175,-21736547
1638239428,-184319,true,9897551175,22,9870865163,-26686012
1638239466,-184315,true,9901510789,22,9870865163,-30645626
1638240197,-184313,true,9903491190,22,9931258433,27767243
1638240826,-184308,true,9908443926,22,10001017627,92573701
1638240941,-184304,true,9912407898,22,10010022144,97614246
1638241019,-184300,true,9916373456,22,10022040779,105667323
1638241108,-184297,true,9919348666,22,10041099804,121751138
1638241132,-184290,true,9926294293,22,10044112435,117818142
1638241242,-184282,true,9934238109,22,10067239323,133001214
1638241444,-184275,true,9941194162,22,10120734654,179540492
1638241485,-184270,true,9946165753,22,10131873031,185707278
1638241495,-184263,true,9953130158,22,10135926388,182796230
1638241564,-184254,true,9962091559,22,10155201990,193110431
1638241679,-184245,true,9971061029,22,10201001080,229940051
1638241871,-184239,true,9977045162,22,10276764679,299719517
1638241974,-184231,true,9985029592,22,10320015692,334986100
1638242023,-184227,true,9989024203,22,10342743582,353719379
1638242134,-184217,true,9999017723,22,10388349633,389331910
1638242206,-184209,true,10007019738,22,10410186997,403167259
1638242241,-184201,true,10015028156,22,10420601869,405573713
1638242453,-184198,true,10018032965,22,10464458238,446425273
1638242504,-184188,true,10028055507,22,10467597890,439542383
1638242606,-184180,true,10036080760,22,10473880019,437799259
1638242652,-184171,true,10045116847,22,10477022497,431905650
1638242663,-184169,true,10047125970,22,10479118006,431992036
1638242734,-184160,true,10056172002,22,10495897176,439725174
1638242745,-184149,true,10067239323,22,10499046260,431806937
1638243014,-184135,true,10081342623,22,10560114602,478771979
1638243061,-184132,true,10084367328,22,10570679470,486312142
1638243095,-184119,true,10097484875,22,10582313033,484828158
1638243103,-184109,true,10107586905,22,10584429601,476842696
1638243206,-184092,true,10124783556,22,10624724932,499941376
1638243294,-184087,true,10129846960,22,10666240185,536393225
1638243369,-184073,true,10144037968,22,10711130353,567092385
1638243417,-184062,true,10155201990,22,10742236157,587034167
1638243462,-184042,true,10175531701,22,10775587089,600055388
1638243484,-184036,true,10181638546,22,10793920249,612281703
1638243492,-184019,true,10198961186,22,10801478261,602517075
1638243528,-184006,true,10212227793,22,10828514386,616286593
1638243536,-183985,true,10233694931,22,10833929726,600234795
1638243554,-183976,true,10242908941,22,10853447384,610538443
1638243596,-183964,true,10255207195,22,10874087504,618880309
1638243618,-183953,true,10266493565,22,10884966486,618472921
1638243649,-183933,true,10287046070,22,10901305370,614259300
1638243708,-183930,true,10290132492,22,10918760546,628628054
1638243749,-183919,true,10301457299,22,10932963455,631506156
1638243844,-183908,true,10312794570,22,10970196930,657402360
1638243925,-183888,true,10333439765,22,11000954985,667515220
1638243964,-183885,true,10336540107,22,11010859805,674319698
1638244001,-183874,true,10347915988,22,11018569720,670653732
1638244008,-183864,true,10358268562,22,11019671577,661403015
1638244038,-183849,true,10373816845,22,11020773544,646956699
1638244056,-183850,true,10372779567,22,11022977809,650198242
1638244081,-183843,true,10380042692,22,11025182515,645139823
1638244102,-183836,true,10387310902,22,11026285033,638974131
1638244105,-183822,true,10401862593,22,11026285033,624422440
1638244146,-183824,true,10399782533,22,11026285033,626502500
1638244167,-183816,true,10408105271,22,11026285033,618179762
1638244193,-183809,true,10415393131,22,11027387662,611994531
1638244203,-183794,true,10431027162,22,11028490400,597463238
1638244242,-183789,true,10436243719,22,11030696209,594452490
1638244294,-183778,true,10447729328,22,11038420013,590690685
1638244352,-183766,true,10460273501,22,11043940327,583666826
1638244362,-183750,true,10477022497,22,11043940327,566917830
1638244400,-183742,true,10485407049,22,11040627807,555220758
1638244411,-183730,true,10497996460,22,11040627807,542631347
1638244502,-183717,true,10511652047,22,11035109149,523457102
1638244525,-183700,true,10529536159,22,11035109149,505572990
1638244634,-183690,true,10540070434,22,11042836043,502765609
1638245026,-183680,true,10550615249,22,11046149225,495533976
1638245098,-183666,true,10565395715,22,11053883850,488488135
1638245130,-183649,true,10583371264,22,11047253840,463882576
1638245183,-183641,true,10591840925,22,11031799278,439958353
1638245213,-183634,true,10599257438,22,11021875621,422618183
1638245237,-183623,true,10610922453,22,11015264810,404342357
1638245334,-183608,true,10626849983,22,10980074057,353224074
1638245426,-183601,true,10634291010,22,10950469322,316178312
1638245479,-183595,true,10640673180,22,10931870268,291197088
1638245677,-183584,true,10652383775,22,10879525635,227141860
1638245748,-183568,true,10669440377,22,10863219395,193779018
1638246036,-183559,true,10679046716,22,10826349008,147302292
1638246122,-183552,true,10686524291,22,10832846441,146322150
1638246301,-183539,true,10700425111,22,10862133182,161708071
1638246517,-183522,true,10718630394,22,10898035632,179405238
1638246529,-183512,true,10729353849,22,10900215349,170861500
1638246626,-183504,true,10737940337,22,10922036502,184096165
1638246640,-183491,true,10751908038,22,10926405972,174497934
1638246682,-183471,true,10773432295,22,10939524873,166092578
1638246782,-183459,true,10786367527,22,10972391079,186023552
1638246830,-183448,true,10798238465,22,10992158180,193919715
1638246863,-183435,true,10812284601,22,11006456562,194171961
1638246883,-183417,true,10831763265,22,11015264810,183501545
1638246900,-183403,true,10846937594,22,11024080107,177142513
1638246942,-183393,true,10857789414,22,11041731870,183942456
1638247019,-183382,true,10869738956,22,11071583335,201844379
1638247045,-183365,true,10888232303,22,11085985032,197752729
1638247310,-183350,true,10904576089,22,11245645487,341069398
1638247367,-183342,true,10913302804,22,11277175840,363873036
1638247400,-183330,true,10926405972,22,11302011694,375605722
1638247454,-183313,true,10944995730,22,11334833456,389837726
1638247490,-183298,true,10961424720,22,11354118096,392693376
1638247521,-183292,true,10968003220,22,11372298316,404295096
1638248013,-183285,true,10975683126,22,11464783367,489100241
1638248056,-183270,true,10992158180,22,11459052694,466894514
1638248105,-183257,true,11006456562,22,11453324887,446868325
1638248135,-183252,true,11011960891,22,11446455296,434494405
1638248140,-183251,true,11013062087,22,11446455296,433393209
1638248217,-183237,true,11028490400,22,11432728474,404238074
1638248223,-183223,true,11043940327,22,11431585315,387644988
1638248229,-183217,true,11050568348,22,11430442271,379873923
1638248517,-183214,true,11053883850,22,11384814101,330930251
1638248615,-183200,true,11069369350,22,11379123401,309754051
1638248724,-183185,true,11085985032,22,11364340890,278355858
1638248732,-183182,true,11089311160,22,11362068363,272757203
1638248785,-183182,true,11089311160,22,11349577584,260266424
1638248831,-183176,true,11095966411,22,11340502006,244535595
1638248939,-183163,true,11110399825,22,11320108482,209708657
1638248964,-183161,true,11112622016,22,11315581570,202959554
1638248982,-183161,true,11112622016,22,11312187574,199565558
1638249068,-183161,true,11112622016,22,11285072231,172450215
1638249081,-183153,true,11121515226,22,11281687387,160172161
1638249097,-183153,true,11121515226,22,11277175840,155660614
1638249279,-183155,true,11119291256,22,11223177795,103886539
1638249313,-183157,true,11117067732,22,11213081983,96014251
1638249358,-183151,true,11123739640,22,11202995253,79255613
1638249484,-183152,true,11122627377,22,11182849006,60221629
1638249538,-183153,true,11121515226,22,11175024142,53508916
1638249601,-183155,true,11119291256,22,11168321474,49030218
1638249807,-183152,true,11122627377,22,11148237580,25610203
1638249823,-183149,true,11125964499,22,11147122868,21158369
1638249832,-183150,true,11124852014,22,11146008267,21156253
1638249987,-183152,true,11122627377,22,11158275008,35647631
1638250015,-183146,true,11129302622,22,11163855262,34552640
1638250029,-183143,true,11132641747,22,11164971647,32329900
1638250084,-183145,true,11130415553,22,11172789473,42373920
1638250348,-183145,true,11130415553,22,11209718731,79303178
1638250548,-183138,true,11138209181,22,11219811514,81602333
1638250598,-183136,true,11140436935,22,11224300112,83863177
1638250623,-183136,true,11140436935,22,11227667739,87230804
1638250702,-183132,true,11144893778,22,11240024351,95130573
1638250821,-183122,true,11156043688,22,11265904864,109861176
1638251088,-183116,true,11162738988,22,11318976584,156237596
1638251157,-183116,true,11162738988,22,11330300655,167561667
1638251164,-183113,true,11166088145,22,11331433686,165345541
1638251287,-183103,true,11177259259,22,11339368069,162108810
1638251308,-183097,true,11183967291,22,11340502006,156534715
1638251366,-183098,true,11182849006,22,11346173391,163324385
1638251405,-183096,true,11185085688,22,11349577584,164491896
1638251424,-183088,true,11194036889,22,11349577584,155540695
1638251505,-183089,true,11192917597,22,11343904497,150986900
1638251564,-183093,true,11188441549,22,11339368069,150926520
1638251649,-183092,true,11189560393,22,11324637204,135076811
1638251693,-183086,true,11196275808,22,11314450125,118174317
1638251735,-183087,true,11195156293,22,11297492020,102335727
1638251855,-183093,true,11188441549,22,11244521035,56079486
1638251900,-183093,true,11188441549,22,11228790506,40348957
1638252065,-183087,true,11195156293,22,11172789473,-22366820
1638252182,-183087,true,11195156293,22,11132641747,-62514546
1638252229,-183093,true,11188441549,22,11112622016,-75819533
1638252422,-183094,true,11187322817,22,11046149225,-141173592
1638252710,-183088,true,11194036889,22,10992158180,-201878709
1638252840,-183086,true,11196275808,22,10975683126,-220592682
1638252941,-183089,true,11192917597,22,10959232764,-233684833
1638253010,-183089,true,11192917597,22,10950469322,-242448275
1638253029,-183083,true,11199635027,22,10948279557,-251355470
1638253092,-183081,true,11201875066,22,10934056751,-267818315
1638253102,-183086,true,11196275808,22,10932963455,-263312353
1638253523,-183089,true,11192917597,22,10852362148,-340555449
1638253610,-183085,true,11197395436,22,10831763265,-365632171
1638253822,-183085,true,11197395436,22,10790682721,-406712715
1638253876,-183091,true,11190679349,22,10784210577,-406468772
1638253928,-183095,true,11186204196,22,10776664648,-409539548
1638254079,-183091,true,11190679349,22,10783132263,-407547086
1638254244,-183090,true,11191798417,22,10793920249,-397878168
1638254371,-183095,true,11186204196,22,10817691825,-368512371
1638254403,-183103,true,11177259259,22,10820937457,-356321802
1638254724,-183102,true,11178376985,22,10831763265,-346613720
1638254816,-183104,true,11176141645,22,10840431709,-335709936
1638254854,-183111,true,11168321474,22,10843684164,-324637310
1638254920,-183119,true,11159390836,22,10849107090,-310283746
1638254937,-183117,true,11161622826,22,10850192001,-311430825
1638255342,-183120,true,11158275008,22,10852362148,-305912860
1638255458,-183128,true,11149352404,22,10863219395,-286133009
1638255499,-183136,true,11140436935,22,10867565334,-272871601
1638255544,-183140,true,11135981874,22,10875174913,-260806961
1638255754,-183141,true,11134868387,22,10898035632,-236832755
1638255788,-183150,true,11124852014,22,10896945938,-227906076
1638255803,-183159,true,11114844652,22,10898035632,-216809020
1638255859,-183163,true,11110399825,22,10894766876,-215632949
1638255943,-183168,true,11104846291,22,10892588249,-212258042
1638255950,-183174,true,11098185715,22,10892588249,-205597466
1638256087,-183182,true,11089311160,22,10893677508,-195633652
1638256227,-183186,true,11084876545,22,10896945938,-187930607
1638256262,-183191,true,11079335769,22,10891499099,-187836670
1638256402,-183196,true,11073797762,22,10875174913,-198622849
1638256702,-183204,true,11064942709,22,10817691825,-247250884
1638257065,-183208,true,11060517838,22,10771277932,-289239906
1638257518,-183213,true,11054989238,22,10764817426,-290171812
1638257695,-183219,true,11048358566,22,10758360796,-289997770
1638258023,-183228,true,11038420013,22,10771277932,-267142081
1638258108,-183232,true,11034005748,22,10773432295,-260573453
1638258200,-183237,true,11028490400,22,10776664648,-251825752
1638258689,-183241,true,11024080107,22,10794999641,-229080466
1638259068,-183247,true,11017467973,22,10839347774,-178120199
1638259275,-183249,true,11015264810,22,10844768532,-170496278
1638259855,-183254,true,11009758830,22,10819855471,-189903359
1638259911,-183258,true,11005356027,22,10811203481,-194152546
1638259945,-183262,true,11000954985,22,10805799500,-195155485
1638260128,-183262,true,11000954985,22,10793920249,-207034736
1638260139,-183267,true,10995456157,22,10792840965,-202615192
1638260170,-183270,true,10992158180,22,10793920249,-198237931
1638260361,-183273,true,10988861192,22,10801478261,-187382931
1638260385,-183271,true,10991059074,22,10804719028,-186340046
1638260442,-183278,true,10983368409,22,10810122468,-173245941
1638261045,-183280,true,10981172065,22,10931870268,-49301797
1638261184,-183282,true,10978976160,22,10971293950,-7682210
1638261465,-183279,true,10982270182,22,11027387662,45117480
1638261634,-183284,true,10976780694,22,11050568348,73787654
1638261836,-183284,true,10976780694,22,11078227946,101447252
1638261936,-183285,true,10975683126,22,11091529133,115846007
1638262329,-183283,true,10977878372,22,11089311160,111432788
1638262407,-183288,true,10972391079,22,11088202340,115811261
1638262522,-183289,true,10971293950,22,11078227946,106933996
1638262766,-183293,true,10966906529,22,11056094737,89188208
1638262905,-183292,true,10968003220,22,11046149225,78146005
1638263158,-183299,true,10960328688,22,11011960891,51632203
1638263411,-183300,true,10959232764,22,10984466746,25233982
1638263424,-183305,true,10953754791,22,10984466746,30711955
1638263575,-183307,true,10951564369,22,10977878372,26314003
1638263628,-183314,true,10943901339,22,10987762415,43861076
1638263689,-183313,true,10944995730,22,10993257396,48261666
1638263779,-183316,true,10941712887,22,11025182515,83469628
1638263802,-183313,true,10944995730,22,11029593249,84597519
1638263806,-183319,true,10938431030,22,11031799278,93368248
1638264067,-183317,true,10940618826,22,11100405463,159786637
1638264338,-183321,true,10936243672,22,11176141645,239897973
1638264496,-183318,true,10939524873,22,11214203291,274678418
1638264820,-183322,true,10935150157,22,11182849006,247698849
1638265315,-183322,true,10935150157,22,11087093631,151943474
1638265455,-183326,true,10930777190,22,11063836326,133059136
1638265557,-183323,true,10934056751,22,11051673405,117616654
1638265577,-183328,true,10928591363,22,11049463401,120872038
1638265957,-183324,true,10932963455,22,11028490400,95526945
1638266090,-183327,true,10929684222,22,11026285033,96600811
1638266266,-183324,true,10932963455,22,11021875621,88912166
1638266473,-183329,true,10927498613,22,11015264810,87766197
1638266574,-183326,true,10930777190,22,11013062087,82284897
1638266648,-183327,true,10929684222,22,11009758830,80074608
1638266685,-183323,true,10934056751,22,11011960891,77904140
1638266749,-183326,true,10930777190,22,11014163394,83386204
1638266994,-183322,true,10935150157,22,11025182515,90032358
1638267094,-183322,true,10935150157,22,11031799278,96649121
1638267100,-183317,true,10940618826,22,11031799278,91180452
1638267198,-183319,true,10938431030,22,11038420013,99988983
1638267239,-183313,true,10944995730,22,11041731870,96736140
1638267294,-183310,true,10948279557,22,11050568348,102288791
1638267306,-183304,true,10954850167,22,11051673405,96823238
1638267611,-183304,true,10954850167,22,11088202340,133352173
1638267868,-183299,true,10960328688,22,11103735918,143407230
1638267913,-183295,true,10964713477,22,11105956776,141243299
1638267955,-183291,true,10969100020,22,11105956776,136856756
1638267988,-183293,true,10966906529,22,11105956776,139050247
1638268300,-183290,true,10970196930,22,11098185715,127988785
1638268642,-183283,true,10977878372,22,11150467339,172588967
1638268755,-183277,true,10984466746,22,11163855262,179388516
1638268762,-183279,true,10982270182,22,11166088145,183817963
1638268921,-183272,true,10989960078,22,11205235964,215275886
1638268936,-183264,true,10998755124,22,11210839703,212084579
1638269103,-183260,true,11003155286,22,11259147686,255992400
1638269163,-183261,true,11002055080,22,11276048235,273993155
1638269213,-183253,true,11010859805,22,11282815555,271955750
1638269243,-183246,true,11018569720,22,11287329359,268759639
1638269702,-183238,true,11027387662,22,11384814101,357426439
1638269841,-183240,true,11025182515,22,11416734652,391552137
1638270009,-183231,true,11035109149,22,11457906904,422797755
1638270028,-183224,true,11042836043,22,11462490754,419654711
1638270080,-183213,true,11054989238,22,11469369968,414380730
1638270160,-183214,true,11053883850,22,11475105800,421221950
1638270180,-183208,true,11060517838,22,11475105800,414587962
1638270208,-183202,true,11067155808,22,11472811123,405655315
1638270293,-183194,true,11076012633,22,11456761228,380748595
1638270506,-183196,true,11073797762,22,11420160015,346362253
1638270527,-183189,true,11081551747,22,11417876325,336324578
1638270554,-183181,true,11090420091,22,11416734652,326314561
1638270695,-183171,true,11101515504,22,11387091177,285575673
1638270702,-183173,true,11099295533,22,11385952582,286657049
1638270755,-183166,true,11107067372,22,11371161200,264093828
1638271015,-183159,true,11114844652,22,11305402637,190557985
1638271162,-183150,true,11124852014,22,11303141895,178289881
1638271240,-183151,true,11123739640,22,11308794597,185054957
1638271246,-183145,true,11130415553,22,11309925476,179509923
1638271275,-183138,true,11138209181,22,11317844800,179635619
1638271371,-183126,true,11151582386,22,11333700086,182117700
1638271465,-183125,true,11152697544,22,11349577584,196880040
1638271533,-183118,true,11160506775,22,11364340890,203834115
1638271656,-183109,true,11170555250,22,11405324194,234768944
1638271730,-183093,true,11188441549,22,11446455296,258013747
1638271767,-183089,true,11192917597,22,11465929845,273012248
1638271788,-183082,true,11200754990,22,11476253311,275498321
1638271889,-183070,true,11214203291,22,11526857543,312654252
1638271986,-183056,true,11229913385,22,11584633261,354719876
1638272204,-183052,true,11234406024,22,11683517361,449111337
1638272248,-183047,true,11240024351,22,11701054910,461030559
1638272261,-183037,true,11251269434,22,11705736035,454466601
1638272296,-183025,true,11264778386,22,11716275412,451497026
1638272496,-183027,true,11262525768,22,11730342678,467816910
1638272562,-183026,true,11263652021,22,11729169761,465517740
1638272686,-183017,true,11273793363,22,11708077299,434283936
1638272701,-183004,true,11288458092,22,11706906608,418448516
1638272857,-183006,true,11286200739,22,11677677355,391476616
1638272982,-183004,true,11288458092,22,11652015986,363557894
1638273023,-182994,true,11299751631,22,11643862836,344111205
1638273201,-182980,true,11315581570,22,11618275773,302694203
1638273366,-182979,true,11316713128,22,11633388597,316675469
1638273381,-182977,true,11318976584,22,11634551936,315575352
1638273430,-182966,true,11331433686,22,11645027222,313593536
1638273447,-182950,true,11349577584,22,11648521080,298943496
1638273539,-182948,true,11351847613,22,11667172698,315325085
1638273616,-182947,true,11352982797,22,11681181008,328198211
1638273745,-182941,true,11359796290,22,11688191469,328395179
1638273972,-182931,true,11371161200,22,11701054910,329893710
1638274112,-182931,true,11371161200,22,11685854182,314692982
1638274138,-182932,true,11370024197,22,11678845123,308820926
1638274156,-182925,true,11377985602,22,11675342170,297356568
1638274178,-182918,true,11385952582,22,11668339416,282386834
1638274309,-182922,true,11381399339,22,11622923781,241524442
1638274361,-182920,true,11383675733,22,11600862294,217186561
1638274418,-182912,true,11392785862,22,11576527260,183741398
1638274484,-182905,true,11400763205,22,11543005637,142242432
1638274522,-182908,true,11397343660,22,11524552517,127208857
1638274562,-182907,true,11398483394,22,11509581081,111097687
1638274710,-182902,true,11404183776,22,11431585315,27401539
1638274796,-182896,true,11411027997,22,11393925140,-17102857
1638274842,-182899,true,11407605373,22,11373435546,-34169827
1638274904,-182896,true,11411027997,22,11358660424,-52367573
1638274922,-182889,true,11419018113,22,11355253507,-63764606
1638274963,-182882,true,11427013824,22,11346173391,-80840433
1638275087,-182885,true,11423586406,22,11330300655,-93285751
1638275103,-182884,true,11424728764,22,11329167739,-95561025
1638275133,-182878,true,11431585315,22,11323504854,-108080461
1638275171,-182871,true,11439589826,22,11317844800,-121745026
1638275267,-182878,true,11431585315,22,11296362383,-135222932
1638275300,-182878,true,11431585315,22,11288458092,-143127223
1638275313,-182873,true,11437302251,22,11285072231,-152230020
1638275455,-182865,true,11446455296,22,11277175840,-169279456
1638275544,-182872,true,11438445982,22,11283943837,-154502145
1638275643,-182871,true,11439589826,22,11289586937,-150002889
1638275658,-182867,true,11444166348,22,11289586937,-154579411
1638275689,-182858,true,11454470219,22,11291844968,-162625251
1638275720,-182864,true,11447599942,22,11294103450,-153496492
1638275763,-182861,true,11451034565,22,11295232860,-155801705
1638275844,-182859,true,11453324887,22,11291844968,-161479919
1638275996,-182850,true,11463637003,22,11300881606,-162755397
1638276055,-182855,true,11457906904,22,11312187574,-145719330
1638276313,-182855,true,11457906904,22,11365477324,-92429580
1638276441,-182855,true,11457906904,22,11364340890,-93566014
1638276503,-182848,true,11465929845,22,11363204570,-102725275
1638276761,-182855,true,11457906904,22,11362068363,-95838541
1638276775,-182856,true,11456761228,22,11360932270,-95828958
1638276822,-182855,true,11457906904,22,11356389033,-101517871
1638276910,-182852,true,11461344620,22,11348442739,-112901881
1638276964,-182859,true,11453324887,22,11343904497,-109420390
1638276999,-182861,true,11451034565,22,11341636056,-109398509
1638277166,-182859,true,11453324887,22,11340502006,-112822881
1638277254,-182856,true,11456761228,22,11348442739,-108318489
1638277280,-182863,true,11448744702,22,11350712541,-98032161
1638277677,-182867,true,11444166348,22,11300881606,-143284742
1638277821,-182866,true,11445310765,22,11276048235,-169262530
1638277920,-182863,true,11448744702,22,11254645153,-194099549
1638278166,-182867,true,11444166348,22,11188441549,-255724799
1638278288,-182872,true,11438445982,22,11185085688,-253360294
1638278422,-182872,true,11438445982,22,11176141645,-262304337
1638278815,-182869,true,11441877858,22,11159390836,-282487022
1638279155,-182875,true,11435015134,22,11141550978,-293464156
1638279200,-182879,true,11430442271,22,11140436935,-290005336
1638279278,-182878,true,11431585315,22,11141550978,-290034337
1638279509,-182875,true,11435015134,22,11143779400,-291235734
1638279609,-182881,true,11428156526,22,11146008267,-282148259
1638279625,-182885,true,11423586406,22,11146008267,-277578139
1638279760,-182886,true,11422444161,22,11147122868,-275321293
1638279913,-182886,true,11422444161,22,11149352404,-273091757
1638279936,-182894,true,11413310317,22,11150467339,-262842978
1638280037,-182897,true,11409887008,22,11164971647,-244915361
1638280415,-182898,true,11408746133,22,11215324712,-193421421
1638280425,-182899,true,11407605373,22,11217567889,-190037484
1638280581,-182908,true,11397343660,22,11250144420,-147199240
1638280867,-182912,true,11392785862,22,11302011694,-90774168
1638280888,-182914,true,11390507646,22,11303141895,-87365751
1638281042,-182916,true,11388229886,22,11314450125,-73779761
1638281093,-182926,true,11376847918,22,11313318793,-63529125
1638281120,-182931,true,11371161200,22,11314450125,-56711075
1638281162,-182934,true,11367750534,22,11314450125,-53300409
1638281379,-182939,true,11362068363,22,11292974152,-69094211
1638281400,-182943,true,11357524672,22,11289586937,-67937735
1638281444,-182948,true,11351847613,22,11282815555,-69032058
1638281651,-182950,true,11349577584,22,11254645153,-94932431
1638281704,-182954,true,11345038887,22,11247894728,-97144159
1638281922,-182960,true,11338234246,22,11217567889,-120666357
1638282258,-182964,true,11333700086,22,11205235964,-128464122
1638282372,-182967,true,11330300655,22,11205235964,-125064691
1638282714,-182971,true,11325769668,22,11204115553,-121654115
1638282854,-182977,true,11318976584,22,11205235964,-113740620
1638282905,-182982,true,11313318793,22,11200754990,-112563803
1638283004,-182986,true,11308794597,22,11192917597,-115877000
1638283219,-182992,true,11302011694,22,11190679349,-111332345
1638283247,-183001,true,11291844968,22,11190679349,-101165619
1638283415,-183006,true,11286200739,22,11189560393,-96640346
1638283606,-183008,true,11283943837,22,11175024142,-108919695
1638283636,-183014,true,11277175840,22,11172789473,-104386367
1638283746,-183022,true,11268158157,22,11153812814,-114345343
1638283934,-183028,true,11261399628,22,11135981874,-125417754
1638284146,-183031,true,11258021884,22,11102625655,-155396229
1638284216,-183032,true,11256896194,22,11091529133,-165367061
1638284364,-183037,true,11251269434,22,11061623890,-189645544
1638284502,-183043,true,11244521035,22,11040627807,-203893228
1638284516,-183047,true,11240024351,22,11037316281,-202708070
1638284639,-183049,true,11237776683,22,11024080107,-213696576
1638284691,-183054,true,11232159480,22,11010859805,-221299675
1638284719,-183062,true,11223177795,22,10999854999,-223322796
1638285043,-183064,true,11220933496,22,10907847789,-313085707
1638285219,-183069,true,11215324712,22,10839347774,-375976938
1638285292,-183075,true,11208597871,22,10802558409,-406039462
1638285422,-183085,true,11197395436,22,10736866650,-460528786
1638285579,-183095,true,11186204196,22,10669440377,-516763819
1638285648,-183103,true,11177259259,22,10650253617,-527005642
1638285845,-183110,true,11169438306,22,10591840925,-577597381
1638285876,-183120,true,11158275008,22,10582313033,-575961975
1638285917,-183129,true,11148237580,22,10567508900,-580728680
1638285922,-183136,true,11140436935,22,10565395715,-575041220
1638285959,-183142,true,11133755011,22,10551670311,-582084700
1638286229,-183150,true,11124852014,22,10515857339,-608994675
1638286251,-183159,true,11114844652,22,10514805858,-600038794
1638286281,-183168,true,11104846291,22,10509550032,-595296259
1638286361,-183176,true,11095966411,22,10493798311,-602168100
1638286742,-183188,true,11082659902,22,10431027162,-651632740
1638286745,-183197,true,11072690493,22,10429984163,-642706330
1638286839,-183206,true,11062730053,22,10423728363,-639001690
1638287051,-183213,true,11054989238,22,10410186997,-644802241
1638287188,-183226,true,11040627807,22,10406023963,-634603844
1638287241,-183235,true,11030696209,22,10412269138,-618427071
1638287280,-183245,true,11019671577,22,10417476314,-602195263
1638287920,-183251,true,11013062087,22,10482262056,-530800031
1638287985,-183264,true,10998755124,22,10485407049,-513348075
1638288089,-183271,true,10991059074,22,10504296833,-486762241
1638288217,-183280,true,10981172065,22,10519012411,-462159654
1638288235,-183283,true,10977878372,22,10521116319,-456762053
1638288271,-183293,true,10966906529,22,10524272970,-442633559
1638288684,-183299,true,10960328688,22,10615167459,-345161229
1638288692,-183307,true,10951564369,22,10618352327,-333212042
1638288770,-183310,true,10948279557,22,10624724932,-323554625
1638288849,-183322,true,10935150157,22,10620476104,-314674053
1638289296,-183337,true,10918760546,22,10528483310,-390277236
1638289364,-183347,true,10907847789,22,10506397798,-401449991
1638289378,-183351,true,10903485740,22,10501146174,-402339566
1638289552,-183359,true,10894766876,22,10434156783,-460610093
1638289598,-183374,true,10878437792,22,10418518062,-459919730
1638289664,-183382,true,10869738956,22,10402902780,-466836176
1638289709,-183387,true,10864305717,22,10397702888,-466602829
1638289824,-183394,true,10856703744,22,10389388468,-467315276
1638289871,-183408,true,10841515752,22,10385233751,-456282001
1638289906,-183416,true,10832846441,22,10385233751,-447612690
1638289972,-183419,true,10829597237,22,10384195332,-445401905
1638290197,-183424,true,10824184063,22,10383157016,-441027047
1638290461,-183438,true,10809041564,22,10401862593,-407178971
1638290705,-183446,true,10800398221,22,10416434670,-383963551
1638290737,-183450,true,10796079141,22,10418518062,-377561079
1638291266,-183456,true,10789603761,22,10401862593,-387741168
1638291326,-183470,true,10774509638,22,10404983464,-369526174
1638291415,-183478,true,10765893908,22,10401862593,-364031315
1638291431,-183482,true,10761588627,22,10398742659,-362845968
1638291448,-183489,true,10754058527,22,10396663222,-357395305
1638291480,-183509,true,10732572977,22,10388349633,-344223344
1638291547,-183521,true,10719702257,22,10375891713,-343810544
1638291849,-183528,true,10712201466,22,10304548046,-407653420
1638291909,-183536,true,10703635560,22,10291161506,-412474054
1638292070,-183557,true,10681182632,22,10254181777,-427000855
1638292133,-183570,true,10667306809,22,10239836683,-427470126
1638292447,-183577,true,10659842681,22,10168411677,-491431004
1638292504,-183585,true,10651318643,22,10164345329,-486973314
1638292589,-183606,true,10628975459,22,10161296635,-467678824
1638292632,-183616,true,10618352327,22,10160280607,-458071720
1638293030,-183621,true,10613044744,22,10173496900,-439547844
1638293055,-183628,true,10605618583,22,10175531701,-430086882
1638293269,-183648,true,10584429601,22,10194882621,-389546980
1638293363,-183658,true,10573850991,22,10203041382,-370809609
1638293450,-183662,true,10569622508,22,10215291768,-354330740
1638293595,-183669,true,10562226731,22,10228579618,-333647113
1638293705,-183689,true,10541124441,22,10233694931,-307429510
1638293862,-183698,true,10531642171,22,10240860667,-290781504
1638293870,-183702,true,10527430567,22,10241884753,-285545814
1638294002,-183709,true,10520064313,22,10244957626,-275106687
1638294414,-183729,true,10499046260,22,10250081129,-248965131
1638294908,-183737,true,10490650801,22,10278820135,-211830666
1638295185,-183740,true,10487504236,22,10297337746,-190166490
1638295966,-183748,true,10479118006,22,10266493565,-212624441
1638296031,-183767,true,10459227579,22,10263414232,-195813347
1638296060,-183775,true,10450863961,22,10259309893,-191554068
1638296157,-183777,true,10448774101,22,10268546966,-180227135
1638296177,-183782,true,10443551281,22,10270600778,-172950503
1638296265,-183798,true,10426855794,22,10276764679,-150091115
1638296392,-183804,true,10420601869,22,10297337746,-123264123
1638296405,-183805,true,10419559913,22,10300427257,-119132656
1638296556,-183808,true,10416434670,22,10327241871,-89192799
1638296936,-183822,true,10401862593,22,10413310365,11447772
1638296999,-183827,true,10396663222,22,10425813212,29149990
1638297054,-183827,true,10396663222,22,10431027162,34363940
1638297083,-183827,true,10396663222,22,10432070264,35407042
1638297299,-183841,true,10382118804,22,10426855794,44736990
1638297530,-183843,true,10380042692,22,10407064565,27021873
1638297813,-183843,true,10380042692,22,10374854227,-5188465
1638297896,-183842,true,10381080696,22,10366558077,-14522619
1638297920,-183851,true,10371742393,22,10364485077,-7257316
1638298255,-183851,true,10371742393,22,10359304389,-12438004
1638298341,-183851,true,10371742393,22,10357232838,-14509555
1638298464,-183850,true,10372779567,22,10349985675,-22793892
1638298936,-183859,true,10363448732,22,10321047694,-42401038
1638298985,-183860,true,10362412491,22,10317951998,-44460493
1638299175,-183859,true,10363448732,22,10269573821,-93874911
1638299196,-183860,true,10362412491,22,10265467018,-96945473
1638299570,-183875,true,10346881300,22,10190805687,-156075613
1638300115,-183876,true,10345846715,22,10131873031,-213973684
1638300488,-183874,true,10347915988,22,10130859945,-217056043
1638300618,-183872,true,10349985675,22,10128834077,-221151598
1638300719,-183886,true,10335506556,22,10126808614,-208697942
1638300792,-183888,true,10333439765,22,10125796034,-207643731
1638300841,-183887,true,10334473109,22,10123771178,-210701931
1638301876,-183886,true,10335506556,22,10108597663,-226908893
1638302809,-183902,true,10318983794,22,10037084368,-281899426
1638302890,-183904,true,10316920306,22,10042103914,-274816392
1638302912,-183905,true,10315888718,22,10044112435,-271776283
1638302963,-183906,true,10314857232,22,10047125970,-267731262
1638302987,-183920,true,10300427257,22,10049135496,-251291761
1638303210,-183923,true,10297337746,22,10061201093,-236136653
1638303263,-183925,true,10295278588,22,10072273950,-223004638
1638303452,-183926,true,10294249163,22,10095465681,-198783482
1638304245,-183939,true,10280876002,22,10262387994,-18488008
1638304919,-183939,true,10280876002,22,10370705323,89829321
1638304926,-183941,true,10278820135,22,10371742393,92922258
1638305210,-183939,true,10280876002,22,10426855794,145979792
1638305342,-183940,true,10279848017,22,10436243719,156395702
1638305666,-183938,true,10281904090,22,10459227579,177323489
1638305695,-183939,true,10280876002,22,10461319529,180443527
1638305847,-183936,true,10283960573,22,10469691514,185730941
1638305872,-183936,true,10283960573,22,10468644650,184684077
1638305922,-183933,true,10287046070,22,10466551235,179505165
1638305952,-183934,true,10286017468,22,10465504684,179487216
1638306077,-183933,true,10287046070,22,10457136047,170089977
1638306157,-183933,true,10287046070,22,10451909047,164862977
1638306505,-183933,true,10287046070,22,10407064565,120018495
1638306601,-183935,true,10284988969,22,10394584201,109595232
1638306790,-183935,true,10284988969,22,10371742393,86753424
1638306985,-183936,true,10283960573,22,10357232838,73272265
1638307017,-183936,true,10283960573,22,10355161703,71201130
1638308042,-183938,true,10281904090,22,10359304389,77400299
1638308208,-183938,true,10281904090,22,10339641379,57737289
1638308478,-183939,true,10280876002,22,10308670483,27794481
1638308841,-183939,true,10280876002,22,10273682266,-7193736
1638309606,-183943,true,10276764679,22,10295278588,18513909
1638309677,-183943,true,10276764679,22,10298367480,21602801
1638309990,-183940,true,10279848017,22,10296308116,16460099
1638310008,-183937,true,10282932280,22,10297337746,14405466
1638310022,-183938,true,10281904090,22,10298367480,16463390
1638310109,-183938,true,10281904090,22,10304548046,22643956
1638310220,-183933,true,10287046070,22,10310732320,23686250
1638310307,-183929,true,10291161506,22,10315888718,24727212
1638310652,-183929,true,10291161506,22,10342743582,51582076
1638310707,-183928,true,10292190622,22,10347915988,55725366
1638310735,-183923,true,10297337746,22,10349985675,52647929
1638310761,-183919,true,10301457299,22,10351020673,49563374
1638311331,-183920,true,10300427257,22,10402902780,102475523
1638311387,-183919,true,10301457299,22,10406023963,104566664
1638312195,-183914,true,10306609058,22,10416434670,109825612
1638312242,-183910,true,10310732320,22,10416434670,105702350
1638312264,-183911,true,10309701350,22,10416434670,106733320
1638312467,-183911,true,10309701350,22,10419559913,109858563
1638312632,-183906,true,10314857232,22,10421643930,106786698
1638312876,-183902,true,10318983794,22,10443551281,124567487
1638313190,-183902,true,10318983794,22,10467597890,148614096
1638313219,-183901,true,10320015692,22,10469691514,149675822
1638313239,-183896,true,10325176732,22,10470738483,145561751
1638313250,-183892,true,10329307422,22,10471785557,142478135
1638313791,-183897,true,10324144318,22,10426855794,102711476
1638313957,-183896,true,10325176732,22,10407064565,81887833
1638314590,-183893,true,10328274595,22,10334473109,6198514
1638314752,-183889,true,10332406524,22,10321047694,-11358830
1638315024,-183895,true,10326209250,22,10304548046,-21661204
1638315858,-183895,true,10326209250,22,10348950780,22741530
1638315931,-183892,true,10329307422,22,10353090981,23783559
1638316173,-183890,true,10331373387,22,10353090981,21717594
1638316186,-183896,true,10325176732,22,10351020673,25843941
1638317363,-183902,true,10318983794,22,10211206673,-107777121
1638318177,-183903,true,10317951998,22,10145052371,-172899627
1638318593,-183903,true,10317951998,22,10105565690,-212386308
1638318619,-183909,true,10311763393,22,10103544880,-208218513
1638318935,-183917,true,10303517694,22,10094456235,-209061459
1638319041,-183916,true,10304548046,22,10090419462,-214128584
1638319588,-183913,true,10307639719,22,10150125912,-157513807
1638319624,-183918,true,10302487445,22,10158248855,-144238590
1638319669,-183925,true,10295278588,22,10165361763,-129916825
1638319887,-183923,true,10297337746,22,10209164738,-88173008
1638320282,-183916,true,10304548046,22,10259309893,-45238153
1638320492,-183921,true,10299397317,22,10284988969,-14408348
1638320894,-183928,true,10292190622,22,10252131248,-40059374
1638321183,-183926,true,10294249163,22,10225511658,-68737505
1638321620,-183919,true,10301457299,22,10261361857,-40095442
1638321671,-183922,true,10298367480,22,10266493565,-31873915
1638321693,-183927,true,10293219841,22,10269573821,-23646020
1638321718,-183918,true,10302487445,22,10272655001,-29832444
1638321786,-183911,true,10309701350,22,10279848017,-29853333
1638322229,-183914,true,10306609058,22,10310732320,4123262
1638322377,-183920,true,10300427257,22,10306609058,6181801
1638322660,-183911,true,10309701350,22,10300427257,-9274093
1638322919,-183903,true,10317951998,22,10299397317,-18554681
1638322950,-183906,true,10314857232,22,10298367480,-16489752
1638323016,-183912,true,10308670483,22,10292190622,-16479861
1638323079,-183902,true,10318983794,22,10286017468,-32966326
1638323199,-183896,true,10325176732,22,10274709635,-50467097
1638323372,-183900,true,10321047694,22,10258284065,-62763629
1638323872,-183906,true,10314857232,22,10181638546,-133218686
1638324267,-183899,true,10322079798,22,10156217510,-165862288
1638324356,-183892,true,10329307422,22,10162312765,-166994657
1638324365,-183897,true,10324144318,22,10162312765,-161831553
1638324836,-183903,true,10317951998,22,10189786708,-128165290
1638325090,-183899,true,10322079798,22,10199981082,-122098716
1638325478,-183898,true,10323112006,22,10192843950,-130268056
1638325902,-183903,true,10317951998,22,10174514249,-143437749
1638325983,-183911,true,10309701350,22,10167394937,-142306413
1638326167,-183911,true,10309701350,22,10152156039,-157545311
1638326907,-183913,true,10307639719,22,10105565690,-202074029
1638327001,-183919,true,10301457299,22,10088401681,-213055618
1638327105,-183928,true,10292190622,22,10076303464,-215887158
1638327793,-183930,true,10290132492,22,9996018618,-294113874
1638328064,-183934,true,10286017468,22,9999017723,-286999745
1638328299,-183940,true,10279848017,22,10000017625,-279830392
1638329697,-183949,true,10270600778,22,9935231533,-335369245
1638330705,-183953,true,10266493565,22,9863958321,-402535244
1638331736,-183955,true,10264440574,22,9847204674,-417235900
1638332072,-183962,true,10257258339,22,9796134660,-461123679
1638332725,-183973,true,10245982121,22,9714195851,-531786270
1638332794,-183979,true,10239836683,22,9705457444,-534379239
1638332816,-183985,true,10233694931,22,9703516644,-530178287
1638332823,-183992,true,10226534209,22,9701576231,-524957978
1638333037,-184009,true,10209164738,22,9665748513,-543416225
1638333406,-184013,true,10205082092,22,9617542795,-587539297
1638333442,-184018,true,10199981082,22,9613696740,-586284342
1638334316,-184023,true,10194882621,22,9619466400,-575416221
1638334438,-184039,true,10178584665,22,9627164667,-551419998
1638334497,-184043,true,10174514249,22,9631016111,-543498138
1638334723,-184048,true,10169428518,22,9639687493,-529741025
1638334921,-184052,true,10165361763,22,9648366683,-516995080
1638334976,-184068,true,10149111001,22,9655122566,-493988435
1638335716,-184072,true,10145052371,22,9722942125,-422110246
1638336054,-184077,true,10139981367,22,9729750226,-410231141
1638336093,-184080,true,10136939980,22,9732669443,-404270537
1638336650,-184097,true,10119722682,22,9730723201,-388999481
1638336699,-184101,true,10115675805,22,9730723201,-384952604
1638337715,-184110,true,10106576247,22,9602167799,-504408448
1638338175,-184116,true,10100514423,22,9597368155,-503146268
1638338266,-184134,true,10082350757,22,9597368155,-484982602
1638338391,-184139,true,10077311094,22,9575320675,-501990419
1638338839,-184150,true,10066232700,22,9515188775,-551043925
1638339005,-184158,true,10058183337,22,9493330081,-564853256
1638339152,-184177,true,10039091885,22,9486687408,-552404477
1638339201,-184182,true,10034073845,22,9490482652,-543591193
1638339324,-184193,true,10023042983,22,9502827685,-520215298
1638340506,-184199,true,10017031262,22,9560969178,-456062084
1638340724,-184218,true,9998017921,22,9590652684,-407365237
1638341259,-184222,true,9994019714,22,9657053687,-336966027
1638341278,-184233,true,9983032885,22,9658985195,-324047690
1638342248,-184232,true,9984031189,22,9669615392,-314415797
1638342390,-184251,true,9965080486,22,9646437299,-318643187
1638342451,-184254,true,9962091559,22,9636796165,-325295394
1638343589,-184266,true,9950144816,22,9581067304,-369077512
1638343945,-184266,true,9950144816,22,9580109293,-370035523
1638344218,-184285,true,9931258433,22,9579151378,-352107055
1638344346,-184288,true,9928279652,22,9578193558,-350086094
1638345182,-184300,true,9916373456,22,9625239523,-291133933
1638345552,-184300,true,9916373456,22,9606969843,-309403613
1638345800,-184314,true,9902500940,22,9614658109,-287842831
1638346012,-184315,true,9901510789,22,9608891333,-292619456
1638346027,-184325,true,9891614722,22,9607930540,-283684182
1638346360,-184325,true,9891614722,22,9611774289,-279840433
1638346417,-184337,true,9879752496,22,9613696740,-266055756
1638346484,-184338,true,9878764620,22,9613696740,-265067880
1638346652,-184350,true,9866917804,22,9613696740,-253221064
1638346990,-184350,true,9866917804,22,9610813207,-256104597
1638348156,-184364,true,9853114474,22,9598327892,-254786582
1638348978,-184367,true,9850159131,22,9549503469,-300655662
1638349603,-184382,true,9835395705,22,9543775772,-291619933
1638350155,-184383,true,9834412264,22,9542821489,-291590775
1638350305,-184397,true,9820654408,22,9540913211,-279741197
1638350661,-184399,true,9818690571,22,9529471554,-289219017
1638350994,-184416,true,9802013810,22,9515188775,-286825035
1638351381,-184416,true,9802013810,22,9529471554,-272542256
1638351390,-184431,true,9787322545,22,9529471554,-257850991
1638352466,-184433,true,9785365375,22,9628127384,-157237991
1638352583,-184448,true,9770699062,22,9627164667,-143534395
1638352775,-184448,true,9770699062,22,9610813207,-159885855
1638353203,-184463,true,9756054732,22,9572448653,-183606079
1638353354,-184467,true,9752153285,22,9559057271,-193096014
1638353562,-184482,true,9737536751,22,9547593855,-189942896
1638354024,-184482,true,9737536751,22,9548548614,-188988137
1638354707,-184498,true,9721969928,22,9518995422,-202974506
1638355038,-184501,true,9719053920,22,9518995422,-200058498
1638355156,-184514,true,9706427990,22,9533283914,-173144076
1638355189,-184514,true,9706427990,22,9539959215,-166468775
1638355523,-184526,true,9694787844,22,9571491504,-123296340
1638355960,-184527,true,9693818462,22,9599287725,-94530737
1638356248,-184540,true,9681225315,22,9591611749,-89613566
1638356400,-184540,true,9681225315,22,9591611749,-89613566
1638356699,-184553,true,9668648527,22,9594489520,-74159007
1638357862,-184555,true,9666715088,22,9598327892,-68387196
1638357979,-184568,true,9654157150,22,9605048737,-49108413
1638358078,-184567,true,9655122566,22,9610813207,-44309359
1638358104,-184579,true,9643543947,22,9611774289,-31769658
1638358491,-184577,true,9645472752,22,9653191831,7719079
1638359054,-184588,true,9634869095,22,9687035502,52166407
1638359516,-184585,true,9637759845,22,9680257289,42497444
1638359554,-184598,true,9625239523,22,9680257289,55017766
1638360537,-184592,true,9631016111,22,9760933735,129917624
1638360907,-184600,true,9623314764,22,9758981841,135667077
1638362210,-184598,true,9625239523,22,9695757322,70517799
1638362267,-184608,true,9615619575,22,9695757322,80137747
1638362420,-184602,true,9621390389,22,9695757322,74366933
1638362496,-184609,true,9614658109,22,9702546389,87888280
1638362592,-184604,true,9619466400,22,9717110401,97644001
1638363193,-184607,true,9616581137,22,9836379245,219798108
1638363258,-184598,true,9625239523,22,9849174213,223934690
1638363349,-184601,true,9622352529,22,9863958321,241605792
1638363415,-184596,true,9627164667,22,9868891286,241726619
1638363976,-184590,true,9632942410,22,9932251559,299309149
1638364009,-184581,true,9641615527,22,9933244784,291629257
1638364612,-184585,true,9637759845,22,9919348666,281588821
1638364870,-184581,true,9641615527,22,9882716718,241101191
1638365182,-184578,true,9644508301,22,9862972023,218463722
1638365961,-184571,true,9651261482,22,9796134660,144873178
1638366503,-184577,true,9645472752,22,9800053702,154580950
1638366601,-184575,true,9647401943,22,9802994012,155592069
1638367642,-184572,true,9650296453,22,9806915798,156619345
1638367976,-184567,true,9655122566,22,9805935204,150812638
1638368140,-184573,true,9649331520,22,9805935204,156603684
1638368222,-184571,true,9651261482,22,9805935204,154673722
1638368484,-184570,true,9652226609,22,9786343911,134117302
1638368730,-184566,true,9656088078,22,9752153285,96065207
1638369012,-184571,true,9651261482,22,9703516644,52255162
1638369054,-184569,true,9653191831,22,9696726898,43535067
1638369189,-184567,true,9655122566,22,9680257289,25134723
1638369741,-184563,true,9658985195,22,9659951093,965898
1638370085,-184563,true,9658985195,22,9685098386,26113191
1638370134,-184559,true,9662849368,22,9691879989,29030621
1638370322,-184556,true,9665748513,22,9716138787,50390274
1638370337,-184551,true,9670582354,22,9718082112,47499758
1638370360,-184551,true,9670582354,22,9720997828,50415474
1638370504,-184549,true,9672516567,22,9737536751,65020184
1638370562,-184547,true,9674451167,22,9744355072,69903905
1638370642,-184543,true,9678321528,22,9753128501,74806973
1638370747,-184545,true,9676386154,22,9746304041,69917887
1638371086,-184547,true,9674451167,22,9737536751,63085584
1638371237,-184545,true,9676386154,22,9725859299,49473145
1638371568,-184541,true,9680257289,22,9699636207,19378918
1638372236,-184540,true,9681225315,22,9726831885,45606570
1638372455,-184539,true,9682193437,22,9756054732,73861295
1638372486,-184537,true,9684129973,22,9761909828,77779855
1638372538,-184532,true,9688973006,22,9776562948,87589942
1638372578,-184528,true,9692849177,22,9787322545,94473368
1638372794,-184522,true,9698666341,22,9842282548,143616207
1638373019,-184522,true,9698666341,22,9884693361,186027020
1638373207,-184517,true,9703516644,22,9918356830,214840186
1638373439,-184513,true,9707398633,22,9932251559,224852926
1638374182,-184508,true,9712253303,22,9931258433,219005130
1638374567,-184506,true,9714195851,22,9937218678,223022827
1638375944,-184501,true,9719053920,22,9942188281,223134361
1638376292,-184498,true,9721969928,22,9953130158,231160230
1638376615,-184493,true,9726831885,22,9961095450,234263565
1638377126,-184490,true,9729750226,22,9929272480,199522254
1638377260,-184485,true,9734616075,22,9918356830,183740755
1638377603,-184482,true,9737536751,22,9897551175,160014424
1638379085,-184477,true,9742406494,22,9895571961,153165467
1638379163,-184474,true,9745329508,22,9894582503,149252995
1638379965,-184468,true,9751178168,22,9868891286,117713118
1638380592,-184465,true,9754103814,22,9860013723,105909909
1638383077,-184463,true,9756054732,22,9806915798,50861066
1638383158,-184460,true,9758981841,22,9805935204,46953363
1638383340,-184458,true,9760933735,22,9804954709,44020974
1638384037,-184456,true,9762886019,22,9767768439,4882420
1638385026,-184456,true,9762886019,22,9764838694,1952675
1638386298,-184452,true,9766791760,22,9765815178,-976582
1638386383,-184448,true,9770699062,22,9765815178,-4883884
1638386514,-184446,true,9772653300,22,9766791760,-5861540
1638386625,-184446,true,9772653300,22,9767768439,-4884861
1638386664,-184441,true,9777540604,22,9767768439,-9772165
1638387161,-184436,true,9782430352,22,9771676132,-10754220
1638387738,-184435,true,9783408595,22,9770699062,-12709533
1638387836,-184434,true,9784386936,22,9769722090,-14664846
1638387944,-184432,true,9786343911,22,9769722090,-16621821
1638388139,-184429,true,9789280108,22,9768745216,-20534892
1638389085,-184427,true,9791238062,22,9767768439,-23469623
1638389118,-184426,true,9792217186,22,9766791760,-25425426
1638389564,-184424,true,9794175727,22,9761909828,-32265899
1638390292,-184421,true,9797114273,22,9755079224,-42035049
1638390828,-184420,true,9798093985,22,9755079224,-43014761
1638390879,-184419,true,9799073794,22,9751178168,-47895626
1638391297,-184417,true,9801033707,22,9749228224,-51805483
1638391569,-184417,true,9801033707,22,9747278671,-53755036
1638391786,-184417,true,9801033707,22,9747278671,-53755036
1638391858,-184416,true,9802013810,22,9747278671,-54735139
1638392079,-184414,true,9803974311,22,9745329508,-58644803
1638392181,-184417,true,9801033707,22,9740458305,-60575402
1638393316,-184418,true,9800053702,22,9706427990,-93625712
1638393392,-184417,true,9801033707,22,9706427990,-94605717
1638393520,-184415,true,9802994012,22,9709340209,-93653803
1638393683,-184417,true,9801033707,22,9702546389,-98487318
1638393768,-184418,true,9800053702,22,9697696571,-102357131
1638394246,-184420,true,9798093985,22,9675418612,-122675373
1638396139,-184423,true,9795155145,22,9667681759,-127473386
1638396157,-184426,true,9792217186,22,9666715088,-125502098
1638396442,-184428,true,9790259036,22,9666715088,-123543948
1638396869,-184430,true,9788301278,22,9664782035,-123519243
1638397448,-184436,true,9782430352,22,9654157150,-128273202
1638398227,-184439,true,9779496210,22,9649331520,-130164690
1638398467,-184441,true,9777540604,22,9649331520,-128209084
1638398501,-184442,true,9776562948,22,9647401943,-129161005
1638399066,-184447,true,9771676132,22,9614658109,-157018023
1638399067,-184450,true,9768745216,22,9614658109,-154087107
1638399578,-184451,true,9767768439,22,9600247653,-167520786
1638399983,-184452,true,9766791760,22,9593530167,-173261593
1638400104,-184457,true,9761909828,22,9587776063,-174133765
1638400191,-184460,true,9758981841,22,9583941911,-175039930
1638400475,-184461,true,9758006040,22,9588734841,-169271199
1638400565,-184462,true,9757030337,22,9592570910,-164459427
1638401468,-184465,true,9754103814,22,9614658109,-139445705
1638401713,-184466,true,9753128501,22,9612735466,-140393035
1638402032,-184465,true,9754103814,22,9610813207,-143290607
1638402451,-184466,true,9753128501,22,9605048737,-148079764
1638402487,-184468,true,9751178168,22,9604088328,-147089840
1638402570,-184469,true,9750203147,22,9602167799,-148035348
1638402872,-184470,true,9749228224,22,9579151378,-170076846
1638403841,-184471,true,9748253399,22,9584900306,-163353093
1638403953,-184474,true,9745329508,22,9574363238,-170966270
1638404073,-184478,true,9741432350,22,9562881467,-178550883
1638404359,-184481,true,9738510505,22,9527565945,-210944560
1638404956,-184486,true,9733642710,22,9456380041,-277262669
1638405072,-184489,true,9730723201,22,9446928860,-283794341
1638405159,-184493,true,9726831885,22,9440318654,-286513231
1638405386,-184496,true,9723914419,22,9413924051,-309990368
1638405641,-184502,true,9718082112,22,9392297987,-325784125
1638405905,-184506,true,9714195851,22,9371658675,-342537176
1638405978,-184509,true,9711282175,22,9368847739,-342434436
1638406152,-184513,true,9707398633,22,9363228397,-344170236
1638407943,-184521,true,9699636207,22,9320258602,-379377605
1638409229,-184526,true,9694787844,22,9321190627,-373597217
1638409854,-184530,true,9690910898,22,9364164720,-326746178
1638410063,-184538,true,9683161657,22,9378220804,-304940853
1638410930,-184551,true,9670582354,22,9321190627,-349391727
1638411013,-184554,true,9667681759,22,9320258602,-347423157
1638411512,-184558,true,9663815653,22,9318394829,-345420824
1638411775,-184567,true,9655122566,22,9321190627,-333931939
1638411835,-184580,true,9642579689,22,9321190627,-321389062
1638412142,-184583,true,9639687493,22,9317463083,-322224410
1638412447,-184588,true,9634869095,22,9315599870,-319269225
1638412504,-184597,true,9626202047,22,9312805749,-313396298
1638412824,-184610,true,9613696740,22,9296988219,-316708521
1638412910,-184613,true,9610813207,22,9294199680,-316613527
1638412942,-184619,true,9605048737,22,9290482929,-314565808
1638413220,-184627,true,9597368155,22,9275630784,-321737371
1638413249,-184641,true,9583941911,22,9272848651,-311093260
1638413344,-184644,true,9581067304,22,9269140439,-311926865
1638413578,-184648,true,9577235835,22,9269140439,-308095396
1638414036,-184656,true,9569577493,22,9272848651,-296728842
1638414348,-184667,true,9559057271,22,9273775936,-285281335
1638414502,-184670,true,9556190127,22,9271921459,-284268668
1638414556,-184675,true,9551413465,22,9265433709,-285979756
1638414819,-184682,true,9544730149,22,9250621609,-294108540
1638415266,-184693,true,9534237243,22,9215537703,-318699540
1638416157,-184696,true,9531377544,22,9246922285,-284455259
1638416866,-184699,true,9528518702,22,9289553974,-238964728
1638417680,-184706,true,9521851406,22,9301637643,-220213763
1638417738,-184716,true,9512334790,22,9301637643,-210697147
1638417999,-184718,true,9510432608,22,9306289392,-204143216
1638418856,-184721,true,9507580049,22,9314668403,-192911646
1638418913,-184728,true,9500927404,22,9313737029,-187190375
1638418959,-184738,true,9491431700,22,9312805749,-178625951
1638419808,-184738,true,9491431700,22,9368847739,-122583961
1638419891,-184740,true,9489533698,22,9376345441,-113188257
1638419905,-184746,true,9483841970,22,9374470453,-109371517
1638420111,-184757,true,9473416001,22,9375407900,-98008101
1638420555,-184757,true,9473416001,22,9376345441,-97070560
1638421652,-184758,true,9472468754,22,9376345441,-96123313
1638421809,-184764,true,9466787262,22,9375407900,-91379362
1638422012,-184775,true,9456380041,22,9374470453,-81909588
1638422063,-184775,true,9456380041,22,9373533100,-82846941
1638422838,-184777,true,9454489049,22,9342652965,-111836084
1638422880,-184783,true,9448818340,22,9344521589,-104296751
1638423165,-184793,true,9439374716,22,9364164720,-75209996
1638423178,-184793,true,9439374716,22,9365101137,-74273579
1638423577,-184793,true,9439374716,22,9396055469,-43319247
1638423888,-184798,true,9434656445,22,9407336939,-27319506
1638424124,-184807,true,9426169498,22,9427112115,942617
1638424224,-184806,true,9427112115,22,9435599910,8487795
1638424452,-184805,true,9428054826,22,9454489049,26434223
1638424771,-184808,true,9425226975,22,9480049382,54822407
1638424951,-184816,true,9417690186,22,9479101472,61411286
1638424998,-184815,true,9418631955,22,9479101472,60469517
1638425027,-184814,true,9419573818,22,9476258310,56684492
1638425068,-184817,true,9416748511,22,9476258310,59509799
1638425125,-184826,true,9408277673,22,9475310779,67033106
1638425391,-184824,true,9410159423,22,9474363343,64203920
1638425471,-184822,true,9412041549,22,9474363343,62321794
1638425641,-184825,true,9409218501,22,9476258310,67039809
1638425817,-184834,true,9400754437,22,9465840677,65086240
1638425879,-184833,true,9401694512,22,9457325679,55631167
1638426357,-184831,true,9403574945,22,9427112115,23537170
1638426843,-184834,true,9400754437,22,9413924051,13169614
1638426999,-184843,true,9392297987,22,9412982753,20684766
1638427050,-184841,true,9394176540,22,9412982753,18806213
1638427769,-184840,true,9395115958,22,9410159423,15043465
1638430144,-184843,true,9392297987,22,9402634682,10336695
1638430788,-184852,true,9383849143,22,9398874568,15025425
1638430802,-184851,true,9384787528,22,9398874568,14087040
1638431237,-184850,true,9385726007,22,9385726007,0
1638431253,-184854,true,9381972655,22,9384787528,2814873
1638431691,-184864,true,9372595840,22,9372595840,0
1638431846,-184862,true,9374470453,22,9379158626,4688173
1638431927,-184860,true,9376345441,22,9382910852,6565411
1638432574,-184862,true,9374470453,22,9406396300,31925847
1638432769,-184872,true,9365101137,22,9397934774,32833637
1638432861,-184870,true,9366974251,22,9393237216,26262965
1638433648,-184869,true,9367910948,22,9373533100,5622152
1638434678,-184871,true,9366037647,22,9374470453,8432806
1638434725,-184877,true,9360419991,22,9377283076,16863085
1638435331,-184874,true,9363228397,22,9416748511,53520114
1638435777,-184871,true,9366037647,22,9434656445,68618798
1638435903,-184870,true,9366974251,22,9435599910,68625659
1638436203,-184874,true,9363228397,22,9418631955,55403558
1638436263,-184871,true,9366037647,22,9416748511,50710864
1638436606,-184869,true,9367910948,22,9404515303,36604355
1638437179,-184868,true,9368847739,22,9414865443,46017704
1638437351,-184870,true,9366974251,22,9417690186,50715935
1638439440,-184868,true,9368847739,22,9365101137,-3746602
1638439891,-184867,true,9369784624,22,9366974251,-2810373
1638440260,-184867,true,9369784624,22,9362292168,-7492456
1638440354,-184869,true,9367910948,22,9365101137,-2809811
1638440665,-184867,true,9369784624,22,9376345441,6560817
1638440694,-184864,true,9372595840,22,9377283076,4687236
1638440826,-184863,true,9373533100,22,9381972655,8439555
1638441848,-184866,true,9370721602,22,9381034552,10312950
1638442521,-184864,true,9372595840,22,9380096542,7500702
1638442638,-184861,true,9375407900,22,9379158626,3750726
1638442666,-184859,true,9377283076,22,9379158626,1875550
1638442684,-184862,true,9374470453,22,9379158626,4688173
1638442997,-184860,true,9376345441,22,9374470453,-1874988
1638444139,-184857,true,9379158626,22,9366974251,-12184375
1638444240,-184855,true,9381034552,22,9366974251,-14060301
1638445168,-184856,true,9380096542,22,9368847739,-11248803
1638445247,-184855,true,9381034552,22,9368847739,-12186813
1638445979,-184852,true,9383849143,22,9369784624,-14064519
1638446240,-184850,true,9385726007,22,9365101137,-20624870
1638447102,-184852,true,9383849143,22,9355741184,-28107959
1638447194,-184851,true,9384787528,22,9355741184,-29046344
1638447417,-184847,true,9388542006,22,9356676758,-31865248
1638447773,-184845,true,9390419809,22,9358548187,-31871622
1638447907,-184845,true,9390419809,22,9358548187,-31871622
1638447947,-184844,true,9391358851,22,9357612426,-33746425
1638448236,-184842,true,9393237216,22,9355741184,-37496032
1638449404,-184841,true,9394176540,22,9341718793,-52457747
1638449927,-184842,true,9393237216,22,9341718793,-51518423
1638450807,-184842,true,9393237216,22,9330516014,-62721202
1638451820,-184840,true,9395115958,22,9379158626,-15957332
1638453547,-184839,true,9396055469,22,9375407900,-20647569
1638454258,-184840,true,9395115958,22,9375407900,-19708058
1638454972,-184841,true,9394176540,22,9380096542,-14079998
1638455237,-184840,true,9395115958,22,9380096542,-15019416
1638455268,-184838,true,9396995075,22,9376345441,-20649634
1638455326,-184839,true,9396055469,22,9378220804,-17834665
1638455777,-184840,true,9395115958,22,9389480861,-5635097
1638456405,-184839,true,9396055469,22,9401694512,5639043
1638456448,-184837,true,9397934774,22,9403574945,5640171
1638456599,-184838,true,9396995075,22,9406396300,9401225
1638456600,-184838,true,9396995075,22,9406396300,9401225
1638456932,-184835,true,9399814455,22,9412982753,13168298
1638457179,-184834,true,9400754437,22,9413924051,13169614
1638457618,-184835,true,9399814455,22,9412982753,13168298
1638457752,-184836,true,9398874568,22,9410159423,11284855
1638457872,-184835,true,9399814455,22,9407336939,7522484
1638459252,-184835,true,9399814455,22,9362292168,-37522287
1638459330,-184838,true,9396995075,22,9361356033,-35639042
1638459381,-184839,true,9396055469,22,9360419991,-35635478
1638459679,-184840,true,9395115958,22,9356676758,-38439200
1638459761,-184842,true,9393237216,22,9354805704,-38431512
1638459835,-184845,true,9390419809,22,9349194784,-41225025
1638459925,-184846,true,9389480861,22,9349194784,-40286077
1638460160,-184846,true,9389480861,22,9346390587,-43090274
1638460350,-184848,true,9387603246,22,9343587230,-44016016
1638460373,-184850,true,9385726007,22,9344521589,-41204418
1638460810,-184851,true,9384787528,22,9368847739,-15939789
1638461204,-184851,true,9384787528,22,9383849143,-938385
1638462409,-184852,true,9383849143,22,9382910852,-938291
1638462696,-184854,true,9381972655,22,9381972655,0
1638462703,-184854,true,9381972655,22,9381972655,0
1638463283,-184853,true,9382910852,22,9381972655,-938197
1638463606,-184853,true,9382910852,22,9395115958,12205106
1638463853,-184855,true,9381034552,22,9404515303,23480751
1638463946,-184855,true,9381034552,22,9407336939,26302387
1638464056,-184853,true,9382910852,22,9410159423,27248571
1638464244,-184853,true,9382910852,22,9412041549,29130697
1638464432,-184855,true,9381034552,22,9400754437,19719885
1638464580,-184855,true,9381034552,22,9392297987,11263435
1638465247,-184854,true,9381972655,22,9366974251,-14998404
1638465394,-184854,true,9381972655,22,9368847739,-13124916
1638465945,-184855,true,9381034552,22,9373533100,-7501452
1638466134,-184855,true,9381034552,22,9404515303,23480751
1638466330,-184852,true,9383849143,22,9434656445,50807302
1638467221,-184851,true,9384787528,22,9499027504,114239976
1638467420,-184851,true,9384787528,22,9497127983,112340455
1638468112,-184849,true,9386664580,22,9522803591,136139011
1638468383,-184847,true,9388542006,22,9512334790,123792784
1638469052,-184845,true,9390419809,22,9465840677,75420868
1638469712,-184845,true,9390419809,22,9470574544,80154735
1638469845,-184845,true,9390419809,22,9472468754,82048945
1638470630,-184843,true,9392297987,22,9477205936,84907949
1638470846,-184843,true,9392297987,22,9476258310,83960323
1638470909,-184843,true,9392297987,22,9477205936,84907949
1638470973,-184843,true,9392297987,22,9474363343,82065356
1638471027,-184840,true,9395115958,22,9472468754,77352796
1638471804,-184842,true,9393237216,22,9434656445,41419229
1638471890,-184842,true,9393237216,22,9432769796,39532580
1638472182,-184840,true,9395115958,22,9429940531,34824573
1638472357,-184838,true,9396995075,22,9425226975,28231900
1638472608,-184839,true,9396055469,22,9415806930,19751461
1638472706,-184840,true,9395115958,22,9408277673,13161715
1638473545,-184840,true,9395115958,22,9378220804,-16895154
1638473995,-184838,true,9396995075,22,9379158626,-17836449
1638475189,-184841,true,9394176540,22,9341718793,-52457747
1638475419,-184841,true,9394176540,22,9340784715,-53391825
1638476185,-184842,true,9393237216,22,9333315448,-59921768
1638476342,-184840,true,9395115958,22,9342652965,-52462993
1638476505,-184843,true,9392297987,22,9343587230,-48710757
1638477074,-184843,true,9392297987,22,9341718793,-50579194
1638479487,-184843,true,9392297987,22,9330516014,-61781973
1638479714,-184842,true,9393237216,22,9329583055,-63654161
1638479752,-184845,true,9390419809,22,9328650190,-61769619
1638479921,-184845,true,9390419809,22,9326784740,-63635069
1638480476,-184846,true,9389480861,22,9321190627,-68290234
1638480955,-184844,true,9391358851,22,9314668403,-76690448
1638481396,-184847,true,9388542006,22,9311874561,-76667445
1638482152,-184847,true,9388542006,22,9310012466,-78529540
1638482176,-184848,true,9387603246,22,9309081558,-78521688
1638482347,-184846,true,9389480861,22,9306289392,-83191469
1638483087,-184850,true,9385726007,22,9300707572,-85018435
1638483135,-184850,true,9385726007,22,9296988219,-88737788
1638483477,-184851,true,9384787528,22,9288625111,-96162417
1638483502,-184850,true,9385726007,22,9289553974,-96172033
1638484417,-184851,true,9384787528,22,9332382210,-52405318
1638484704,-184851,true,9384787528,22,9331449065,-53338463
1638484819,-184852,true,9383849143,22,9321190627,-62658516
1638484843,-184851,true,9384787528,22,9319326669,-65460859
1638484889,-184854,true,9381972655,22,9318394829,-63577826
1638484935,-184856,true,9380096542,22,9317463083,-62633459
1638485015,-184856,true,9380096542,22,9315599870,-64496672
1638485080,-184854,true,9381972655,22,9313737029,-68235626
1638485129,-184858,true,9378220804,22,9310943467,-67277337
1638485205,-184859,true,9377283076,22,9310012466,-67270610
1638485435,-184857,true,9379158626,22,9328650190,-50508436
1638485580,-184855,true,9381034552,22,9339850730,-41183822
1638485713,-184858,true,9378220804,22,9359484042,-18736762
1638486094,-184859,true,9377283076,22,9397934774,20651698
1638486255,-184857,true,9379158626,22,9400754437,21595811
1638486510,-184856,true,9380096542,22,9402634682,22538140
1638486585,-184859,true,9377283076,22,9403574945,26291869
1638486757,-184860,true,9376345441,22,9406396300,30050859
1638487212,-184857,true,9379158626,22,9410159423,31000797
1638487269,-184856,true,9380096542,22,9410159423,30062881
1638487326,-184857,true,9379158626,22,9409218501,30059875
1638487429,-184858,true,9378220804,22,9402634682,24413878
1638487482,-184857,true,9379158626,22,9399814455,20655829
1638489724,-184856,true,9380096542,22,9351064717,-29031825
1638490701,-184857,true,9379158626,22,9345456041,-33702585
1638491386,-184858,true,9378220804,22,9341718793,-36502011
1638491422,-184857,true,9379158626,22,9340784715,-38373911
1638491468,-184856,true,9380096542,22,9337983040,-42113502
1638491604,-184858,true,9378220804,22,9332382210,-45838594
1638491751,-184860,true,9376345441,22,9325852155,-50493286
1638491863,-184860,true,9376345441,22,9314668403,-61677038
1638493529,-184862,true,9374470453,22,9261728462,-112741991
1638493742,-184863,true,9373533100,22,9273775936,-99757164
1638494223,-184865,true,9371658675,22,9302567806,-69090869
1638494307,-184865,true,9371658675,22,9313737029,-57921646
1638494745,-184863,true,9373533100,22,9356676758,-16856342
1638494997,-184865,true,9371658675,22,9376345441,4686766
1638495044,-184866,true,9370721602,22,9379158626,8437024
1638495217,-184866,true,9370721602,22,9384787528,14065926
1638497227,-184865,true,9371658675,22,9371658675,0
1638497299,-184867,true,9369784624,22,9370721602,936978
1638497524,-184867,true,9369784624,22,9368847739,-936885
1638498345,-184867,true,9369784624,22,9363228397,-6556227
1638498482,-184866,true,9370721602,22,9359484042,-11237560
1638498629,-184867,true,9369784624,22,9355741184,-14043440
1638499020,-184868,true,9368847739,22,9351064717,-17783022
1638499359,-184869,true,9367910948,22,9343587230,-24323718
1638499458,-184870,true,9366974251,22,9342652965,-24321286
1638499497,-184873,true,9364164720,22,9342652965,-21511755
1638499589,-184876,true,9361356033,22,9342652965,-18703068
1638499812,-184878,true,9359484042,22,9328650190,-30833852
1638499936,-184880,true,9357612426,22,9320258602,-37353824
1638500042,-184882,true,9355741184,22,9314668403,-41072781
1638500057,-184885,true,9352935023,22,9313737029,-39197994
1638500913,-184890,true,9348259958,22,9230293627,-117966331
1638500935,-184891,true,9347325226,22,9227525092,-119800134
1638501108,-184895,true,9343587230,22,9217380902,-126206328
1638501567,-184898,true,9340784715,22,9195286816,-145497899
1638502237,-184906,true,9333315448,22,9130234741,-203080707
1638503224,-184908,true,9331449065,22,9111993431,-219455634
1638503484,-184910,true,9329583055,22,9111993431,-217589624
1638507850,-184914,true,9325852155,22,9114727302,-211124853
1638507972,-184921,true,9319326669,22,9113815920,-205510749
1638508039,-184923,true,9317463083,22,9113815920,-203647163
1638508048,-184925,true,9315599870,22,9111993431,-203606439
1638508584,-184930,true,9310943467,22,9090151959,-220791508
1638508893,-184937,true,9304428413,22,9067456095,-236972318
1638509218,-184939,true,9302567806,22,9055676650,-246891156
1638509790,-184940,true,9301637643,22,9044816898,-256820745
1638510179,-184945,true,9296988219,22,9035777053,-261211166
1638510553,-184952,true,9290482929,22,9024941166,-265541763
1638510894,-184954,true,9288625111,22,9020430048,-268195063
1638511481,-184956,true,9286767665,22,9021332091,-265435574
1638511606,-184961,true,9282125674,22,9022234225,-259891449
1638512133,-184968,true,9275630784,22,9019528096,-256102688
1638512908,-184970,true,9273775936,22,9018626233,-255149703
1638512983,-184971,true,9272848651,22,9020430048,-252418603
1638513305,-184976,true,9268213618,22,9024038762,-244174856
1638513685,-184982,true,9262654635,22,9030357484,-232297151
1638514322,-184984,true,9260802382,22,9032163646,-228638736
1638514994,-184985,true,9259876394,22,9037584299,-222292095
1638516001,-184989,true,9256173370,22,9087425458,-168747912
1638516080,-184995,true,9250621609,22,9086516807,-164104802
1638516096,-184996,true,9249696639,22,9086516807,-163179832
1638516234,-184996,true,9249696639,22,9082883108,-166813531
1638516430,-185000,true,9245997685,22,9080158788,-165838897
1638516561,-185005,true,9241376073,22,9084699776,-156676297
1638516666,-185006,true,9240452028,22,9088334201,-152117827
1638516769,-185007,true,9239528075,22,9086516807,-153011268
1638517477,-185012,true,9234909697,22,9085608246,-149301451
1638517728,-185017,true,9230293627,22,9083791397,-146502230
1638517740,-185017,true,9230293627,22,9084699776,-145593851
1638518556,-185017,true,9230293627,22,9122933839,-107359788
1638518644,-185019,true,9228447845,22,9125670992,-102776853
1638522048,-185027,true,9221068408,22,9104707115,-116361293
1638522261,-185027,true,9221068408,22,9095607414,-125460994
1638522627,-185027,true,9221068408,22,9079250863,-141817545
1638523520,-185030,true,9218302640,22,9082883108,-135419532
1638523705,-185041,true,9208168589,22,9080158788,-128009801
1638523754,-185042,true,9207247864,22,9078343029,-128904835
1638523827,-185042,true,9207247864,22,9081066804,-126181060
1638524073,-185045,true,9204486242,22,9091970080,-112516162
1638524161,-185055,true,9195286816,22,9094697944,-100588872
1638524177,-185056,true,9194367380,22,9095607414,-98759966
1638524435,-185057,true,9193448035,22,9096516974,-96931061
1638524806,-185060,true,9190690552,22,9110171305,-80519247
1638524930,-185070,true,9181504914,22,9110171305,-71333609
1638525572,-185071,true,9180586856,22,9104707115,-75879741
1638525578,-185072,true,9179668889,22,9103796735,-75872154
1638526234,-185075,true,9176915539,22,9080158788,-96756751
1638527070,-185084,true,9168660443,22,9058393624,-110266819
1638527188,-185086,true,9166826986,22,9056582217,-110244769
1638527253,-185086,true,9166826986,22,9055676650,-111150336
1638527314,-185089,true,9164077488,22,9054771172,-109306316
1638527592,-185099,true,9154918448,22,9051150169,-103768279
1638527604,-185100,true,9154003048,22,9051150169,-102852879
1638527823,-185100,true,9154003048,22,9043912506,-110090542
1638527847,-185103,true,9151257396,22,9043912506,-107344890
1638528600,-185112,true,9143025381,22,9035777053,-107248328
1638529198,-185112,true,9143025381,22,9035777053,-107248328
1638529833,-185112,true,9143025381,22,9036680631,-106344750
1638530795,-185114,true,9141197050,22,9043008206,-98188844
1638531062,-185124,true,9132060879,22,9042103995,-89956884
1638531741,-185126,true,9130234741,22,9096516974,-33717767
1638531820,-185126,true,9130234741,22,9108349544,-21885197
1638531888,-185128,true,9128408968,22,9125670992,-2737976
1638532116,-185135,true,9122021636,22,9170494267,48472631
1638532192,-185131,true,9125670992,22,9194367380,68696388
1638532533,-185127,true,9129321808,22,9313737029,184415221
1638532567,-185128,true,9128408968,22,9325852155,197443187
1638532623,-185132,true,9124758517,22,9344521589,219763072
1638532911,-185125,true,9131147764,22,9443151033,312003269
1638533360,-185116,true,9139369085,22,9561925275,422556190
1638533399,-185117,true,9138455240,22,9570534450,432079210
1638533618,-185120,true,9135714251,22,9606969843,471255592
1638533683,-185112,true,9143025381,22,9609852222,466826841
1638534038,-185105,true,9149427419,22,9582983613,433556194
1638534703,-185108,true,9146683140,22,9481945487,335262347
1638535071,-185112,true,9143025381,22,9466787262,323761881
1638535131,-185103,true,9151257396,22,9464894188,313636792
1638535356,-185098,true,9155833940,22,9455434497,299600557
1638535545,-185101,true,9153087739,22,9447873553,294785814
1638535642,-185102,true,9152172522,22,9448818340,296645818
1638535691,-185093,true,9160412773,22,9451653269,291240496
1638535749,-185085,true,9167743668,22,9460163160,292419492
1638536094,-185083,true,9169577309,22,9519947321,350370012
1638536484,-185080,true,9172328457,22,9597368155,425039698
1638536779,-185070,true,9181504914,22,9598327892,416822978
1638536880,-185063,true,9187933896,22,9587776063,399842167
1638537018,-185060,true,9190690552,22,9589693714,399003162
1638537031,-185057,true,9193448035,22,9589693714,396245679
1638537072,-185047,true,9202645621,22,9589693714,387048093
1638537261,-185039,true,9210010315,22,9585858796,375848481
1638537427,-185035,true,9213694872,22,9582025410,368330538
1638537866,-185033,true,9215537703,22,9578193558,362655855
1638538134,-185023,true,9224757388,22,9564794139,340036751
1638539935,-185014,true,9233062992,22,9561925275,328862283
1638540042,-185010,true,9236756771,22,9560969178,324212407
1638540193,-185007,true,9239528075,22,9560969178,321441103
1638540918,-184997,true,9248771762,22,9537097800,288326038
1638541286,-184989,true,9256173370,22,9532330681,276157311
1638541402,-184985,true,9259876394,22,9526613284,266736890
1638541440,-184982,true,9262654635,22,9518995422,256340787
1638542073,-184977,true,9267286889,22,9394176540,126889651
1638542091,-184971,true,9272848651,22,9388542006,115693355
1638542135,-184969,true,9274703314,22,9378220804,103517490
1638542375,-184967,true,9276558347,22,9341718793,65160446
1638543275,-184961,true,9282125674,22,9373533100,91407426
1638543286,-184955,true,9287696342,22,9371658675,83962333
1638543450,-184954,true,9288625111,22,9360419991,71794880
1638543901,-184952,true,9290482929,22,9330516014,40033085
1638544078,-184949,true,9293270353,22,9318394829,25124476
1638544587,-184944,true,9297917917,22,9312805749,14887832
1638545035,-184941,true,9300707572,22,9347325226,46617654
1638545121,-184939,true,9302567806,22,9353870317,51302511
1638546125,-184935,true,9306289392,22,9378220804,71931412
1638546283,-184930,true,9310943467,22,9377283076,66339609
1638546728,-184927,true,9313737029,22,9374470453,60733424
1638546805,-184925,true,9315599870,22,9373533100,57933230
1638546981,-184921,true,9319326669,22,9370721602,51394933
1638547054,-184917,true,9323054959,22,9369784624,46729665
1638547167,-184915,true,9324919663,22,9366037647,41117984
1638547199,-184913,true,9326784740,22,9365101137,38316397
1638547878,-184910,true,9329583055,22,9342652965,13069910
1638548150,-184906,true,9333315448,22,9316531430,-16784018
1638548300,-184904,true,9335182205,22,9297917917,-37264288
1638548917,-184902,true,9337049335,22,9270067353,-66981982
1638549153,-184900,true,9338916838,22,9276558347,-62358491
1638549187,-184896,true,9342652965,22,9278413752,-64239213
1638549568,-184895,true,9343587230,22,9293270353,-50316877
1638549637,-184893,true,9345456041,22,9296058613,-49397428
1638549867,-184890,true,9348259958,22,9315599870,-32660088
1638549899,-184885,true,9352935023,22,9319326669,-33608354
1638550121,-184883,true,9354805704,22,9338916838,-15888866
1638550239,-184881,true,9356676758,22,9337049335,-19627423
1638550372,-184877,true,9360419991,22,9351999823,-8420168
1638550535,-184872,true,9365101137,22,9362292168,-2808969
1638550924,-184870,true,9366974251,22,9358548187,-8426064
1638551598,-184867,true,9369784624,22,9349194784,-20589840
1638551648,-184863,true,9373533100,22,9350129704,-23403396
1638551800,-184858,true,9378220804,22,9353870317,-24350487
1638551948,-184855,true,9381034552,22,9355741184,-25293368
1638552147,-184851,true,9384787528,22,9358548187,-26239341
1638552952,-184845,true,9390419809,22,9410159423,19739614
1638553320,-184840,true,9395115958,22,9415806930,20690972
1638554153,-184835,true,9399814455,22,9474363343,74548888
1638554356,-184831,true,9403574945,22,9472468754,68893809
1638554712,-184825,true,9409218501,22,9458271411,49052910
1638554992,-184819,true,9414865443,22,9446928860,32063417
1638555090,-184815,true,9418631955,22,9444095348,25463393
1638555165,-184811,true,9422399973,22,9452598434,30198461
1638555552,-184803,true,9429940531,22,9496178365,66237834
1638555738,-184797,true,9435599910,22,9514237352,78637442
1638556299,-184795,true,9437487125,22,9530424501,92937376
1638556700,-184793,true,9439374716,22,9521851406,82476690
1638556894,-184791,true,9441262686,22,9519947321,78684635
1638557786,-184790,true,9442206812,22,9488584840,46378028
1638557941,-184788,true,9444095348,22,9487636076,43540728
1638558490,-184789,true,9443151033,22,9531377544,88226511
1638558504,-184789,true,9443151033,22,9532330681,89179648
1638558724,-184791,true,9441262686,22,9543775772,102513086
1638558941,-184790,true,9442206812,22,9545684622,103477810
1638559219,-184792,true,9440318654,22,9536144186,95825532
1638561519,-184794,true,9438430873,22,9524708247,86277374
1638561722,-184794,true,9438430873,22,9508530807,70099934
1638561898,-184790,true,9442206812,22,9508530807,66323995
1638562048,-184790,true,9442206812,22,9519947321,77740509
1638562466,-184790,true,9442206812,22,9555234603,113027791
1638562841,-184788,true,9444095348,22,9591611749,147516401
1638563010,-184783,true,9448818340,22,9589693714,140875374
1638563687,-184783,true,9448818340,22,9582025410,133207070
1638563726,-184784,true,9447873553,22,9580109293,132235740
1638563729,-184783,true,9448818340,22,9579151378,130333038
1638563849,-184783,true,9448818340,22,9578193558,129375218
1638563868,-184786,true,9445984261,22,9575320675,129336414
1638564079,-184787,true,9445039757,22,9558101460,113061703
1638564439,-184786,true,9445984261,22,9536144186,90159925
1638564442,-184786,true,9445984261,22,9536144186,90159925
1638564874,-184788,true,9444095348,22,9524708247,80612899
1638564892,-184790,true,9442206812,22,9524708247,82501435
1638564972,-184790,true,9442206812,22,9532330681,90123869
1638565048,-184788,true,9444095348,22,9546639191,102543843
1638565207,-184785,true,9446928860,22,9568620631,121691771
1638568170,-184787,true,9445039757,22,9644508301,199468544
1638568659,-184786,true,9445984261,22,9643543947,197559686
1638568759,-184784,true,9447873553,22,9643543947,195670394
1638569306,-184781,true,9450708198,22,9641615527,190907329
1638570058,-184784,true,9447873553,22,9568620631,120747078
1638570329,-184783,true,9448818340,22,9556190127,107371787
1638572417,-184782,true,9449763222,22,9560013176,110249954
1638573032,-184780,true,9451653269,22,9557145746,105492477
1638573946,-184778,true,9453543694,22,9554279176,100735482
1638574063,-184774,true,9457325679,22,9553323843,95998164
1638574414,-184773,true,9458271411,22,9551413465,93142054
1638574960,-184770,true,9461109177,22,9538051510,76942333
1638575487,-184769,true,9462055288,22,9532330681,70275393
1638575525,-184766,true,9464894188,22,9532330681,67436493
1638575693,-184764,true,9466787262,22,9530424501,63637239
1638575701,-184761,true,9469627582,22,9528518702,58891120
1638575796,-184759,true,9471521602,22,9529471554,57949952
1638575813,-184756,true,9474363343,22,9529471554,55108211
1638576034,-184756,true,9474363343,22,9518995422,44632079
1638576858,-184751,true,9479101472,22,9575320675,96219203
1638577809,-184750,true,9480049382,22,9521851406,41802024
1638577882,-184748,true,9481945487,22,9520899316,38953829
1638577925,-184748,true,9481945487,22,9518995422,37049935
1638578335,-184744,true,9485738834,22,9495228842,9490008
1638579262,-184745,true,9484790355,22,9470574544,-14215811
1638579423,-184743,true,9486687408,22,9460163160,-26524248
1638579858,-184743,true,9486687408,22,9435599910,-51087498
1638579983,-184740,true,9489533698,22,9428054826,-61478872
1638580031,-184742,true,9487636076,22,9419573818,-68062258
1638580177,-184739,true,9490482652,22,9400754437,-89728215
1638581645,-184741,true,9488584840,22,9351999823,-136585017
1638581787,-184737,true,9492380843,22,9351999823,-140381020
1638582025,-184738,true,9491431700,22,9352935023,-138496677
1638582279,-184735,true,9494279414,22,9354805704,-139473710
1638582622,-184736,true,9493330081,22,9382910852,-110419229
1638583665,-184732,true,9497127983,22,9428054826,-69073157
1638583904,-184734,true,9495228842,22,9427112115,-68116727
1638584169,-184731,true,9498077696,22,9428054826,-70022870
1638584201,-184733,true,9496178365,22,9429940531,-66237834
1638584561,-184727,true,9501877497,22,9460163160,-41714337
1638584791,-184728,true,9500927404,22,9475310779,-25616625
1638585458,-184725,true,9503777967,22,9485738834,-18039133
1638585573,-184726,true,9502827685,22,9485738834,-17088851
1638585614,-184720,true,9508530807,22,9485738834,-22791973
1638585648,-184722,true,9506629386,22,9484790355,-21839031
1638585905,-184719,true,9509481660,22,9478153656,-31328004
1638586050,-184721,true,9507580049,22,9474363343,-33216706
1638586091,-184716,true,9512334790,22,9473416001,-38918789
1638586280,-184718,true,9510432608,22,9475310779,-35121829
1638586334,-184715,true,9513286023,22,9476258310,-37027713
1638586585,-184718,true,9510432608,22,9478153656,-32278952
1638587157,-184713,true,9515188775,22,9489533698,-25655077
1638587434,-184716,true,9512334790,22,9488584840,-23749950
1638588223,-184712,true,9516140294,22,9562881467,46741173
1638588333,-184714,true,9514237352,22,9573405898,59168546
1638588925,-184709,true,9518995422,22,9539959215,20963793
1638589266,-184714,true,9514237352,22,9521851406,7614054
1638589897,-184713,true,9515188775,22,9515188775,0
1638589915,-184715,true,9513286023,22,9515188775,1902752
1638589977,-184710,true,9518043618,22,9509481660,-8561958
1638590002,-184715,true,9513286023,22,9508530807,-4755216
1638590407,-184713,true,9515188775,22,9505678818,-9509957
1638590617,-184715,true,9513286023,22,9493330081,-19955942
1638590829,-184712,true,9516140294,22,9476258310,-39881984
1638591091,-184717,true,9511383651,22,9458271411,-53112240
1638591212,-184717,true,9511383651,22,9454489049,-56894602
1638591299,-184720,true,9508530807,22,9456380041,-52150766
1638591314,-184715,true,9513286023,22,9456380041,-56905982
1638591649,-184717,true,9511383651,22,9485738834,-25644817
1638591684,-184717,true,9511383651,22,9489533698,-21849953
1638591901,-184718,true,9510432608,22,9526613284,16180676
1638592067,-184713,true,9515188775,22,9550458419,35269644
1638592255,-184716,true,9512334790,22,9561925275,49590485
1638593480,-184717,true,9511383651,22,9569577493,58193842
1638593597,-184719,true,9509481660,22,9567663864,58182204
1638593694,-184714,true,9514237352,22,9560969178,46731826
1638593737,-184717,true,9511383651,22,9556190127,44806476
1638593851,-184722,true,9506629386,22,9537097800,30468414
1638593961,-184727,true,9501877497,22,9509481660,7604163
1638594218,-184727,true,9501877497,22,9391358851,-110518646
1638594414,-184730,true,9499027504,22,9320258602,-178768902
1638595516,-184738,true,9491431700,22,9169577309,-321854391
1638595568,-184744,true,9485738834,22,9166826986,-318911848
1638595585,-184744,true,9485738834,22,9163161171,-322577663
1638595791,-184751,true,9479101472,22,9060205393,-418896079
1638595821,-184773,true,9458271411,22,9051150169,-407121242
1638595930,-184780,true,9451653269,22,9026746244,-424907025
1638596003,-184783,true,9448818340,22,9015019684,-433798656
1638596308,-184788,true,9444095348,22,8899478550,-544616798
1638596669,-184815,true,9418631955,22,8792449045,-626182910
1638596784,-184824,true,9410159423,22,8762606971,-647552452
1638596846,-184829,true,9405455754,22,8726755620,-678700134
1638596907,-184836,true,9398874568,22,8710191354,-688683214
1638597095,-184855,true,9381034552,22,8740728906,-640305646
1638597315,-184858,true,9378220804,22,8795087043,-583133761
1638597344,-184860,true,9376345441,22,8800365415,-575980026
1638597466,-184866,true,9370721602,22,8829453135,-541268467
1638597476,-184886,true,9351999823,22,8831219114,-520780709
1638597486,-184892,true,9346390587,22,8833868745,-512521842
1638597632,-184889,true,9349194784,22,8894140731,-455054053
1638597683,-184892,true,9346390587,22,8914619773,-431770814
1638597806,-184915,true,9324919663,22,8946768630,-378151033
1638598217,-184923,true,9317463083,22,8891473022,-425990061
1638598251,-184922,true,9318394829,22,8891473022,-426921807
1638598399,-184925,true,9315599870,22,8893251406,-422348464
1638598427,-184948,true,9294199680,22,8886140005,-408059675
1638598473,-184954,true,9288625111,22,8878146476,-410478635
1638598586,-184956,true,9286767665,22,8854209008,-432558657
1638598762,-184959,true,9283982192,22,8855094429,-428887763
1638598788,-184982,true,9262654635,22,8855094429,-407560206
1638598905,-184987,true,9258024697,22,8872821453,-385203244
1638599022,-184982,true,9262654635,22,8915511235,-347143400
1638599459,-184973,true,9270994360,22,9110171305,-160823055
1638599859,-184995,true,9250621609,22,9221068408,-29553201
1638599887,-184998,true,9247846977,22,9221068408,-26778569
1638599905,-184993,true,9252471826,22,9221068408,-31403418
1638600036,-184984,true,9260802382,22,9210010315,-50792067
1638600498,-185010,true,9236756771,22,9126583560,-110173211
1638600636,-185011,true,9235833188,22,9111082322,-124750866
1638600925,-185006,true,9240452028,22,9081066804,-159385224
1638601009,-184998,true,9247846977,22,9075620071,-172226906
1638601070,-185024,true,9223835005,22,9071990730,-151844275
1638601282,-185027,true,9221068408,22,9059299464,-161768944
1638601296,-185025,true,9222912714,22,9058393624,-164519090
1638601337,-185017,true,9230293627,22,9055676650,-174616977
1638601654,-185044,true,9205406691,22,9033970169,-171436522
1638601671,-185048,true,9201725448,22,9029454539,-172270909
1638602087,-185048,true,9201725448,22,8994310000,-207415448
1638602110,-185042,true,9207247864,22,8992511407,-214736457
1638602534,-185070,true,9181504914,22,8956614997,-224889917
1638602997,-185073,true,9178751014,22,8979931329,-198819685
1638603336,-185072,true,9179668889,22,9035777053,-143891836
1638603746,-185065,true,9186096585,22,9046625951,-139470634
1638603812,-185091,true,9162244947,22,9047530614,-114714333
1638604145,-185094,true,9159496823,22,9019528096,-139968727
1638604334,-185094,true,9159496823,22,8996108952,-163387871
1638604476,-185089,true,9164077488,22,8986219167,-177858321
1638604531,-185116,true,9139369085,22,8981727405,-157641680
1638604686,-185120,true,9135714251,22,8972750615,-162963636
1638604922,-185119,true,9136627823,22,8976340254,-160287569
1638605064,-185113,true,9142111170,22,8983523840,-158587330
1638605494,-185141,true,9116550339,22,9016822778,-99727561
1638605636,-185145,true,9112904630,22,9024038762,-88865868
1638605842,-185144,true,9113815920,22,9033066862,-80749058
1638605871,-185138,true,9119285577,22,9032163646,-87121931
1638605924,-185165,true,9094697944,22,9034873566,-59824378
1638606329,-185166,true,9093788565,22,9078343029,-15445536
1638606437,-185166,true,9093788565,22,9063830019,-29958546
1638606641,-185161,true,9098336369,22,9046625951,-51710418
1638607094,-185188,true,9073805219,22,9010513526,-63291693
1638607971,-185189,true,9072897929,22,9043912506,-28985423
1638608012,-185188,true,9073805219,22,9044816898,-28988321
1638608265,-185182,true,9079250863,22,9046625951,-32624912
1638608806,-185208,true,9055676650,22,9008711694,-46964956
1638608849,-185211,true,9052960490,22,9006009621,-46950869
1638608864,-185211,true,9052960490,22,9006009621,-46950869
1638609322,-185208,true,9055676650,22,8986219167,-69457483
1638609838,-185235,true,9031260520,22,8985320635,-45939885
1638610166,-185239,true,9027648919,22,8982625577,-45023342
1638610735,-185239,true,9027648919,22,8972750615,-54898304
1638610936,-185237,true,9029454539,22,8982625577,-46828962
1638610993,-185264,true,9005109110,22,8986219167,-18889943
1638611208,-185267,true,9002408117,22,8997008562,-5399555
1638611727,-185266,true,9003308358,22,9009612565,6304207
1638611737,-185264,true,9005109110,22,9010513526,5404416
1638613102,-185286,true,8985320635,22,9064736402,79415767
1638613228,-185286,true,8985320635,22,9063830019,78509384
1638613236,-185277,true,8993410659,22,9063830019,70419360
1638613301,-185274,true,8996108952,22,9062923727,66814775
1638613714,-185293,true,8979033425,22,9055676650,76643225
1638613877,-185292,true,8979931329,22,9052055284,72123955
1638613978,-185284,true,8987117789,22,9040295846,53178057
1638614382,-185278,true,8992511407,22,9005109110,12597703
1638614387,-185284,true,8987117789,22,9002408117,15290328
1638614422,-185284,true,8987117789,22,9001507967,14390178
1638615076,-185280,true,8990713175,22,8926215734,-64497441
1638615420,-185277,true,8993410659,22,8904819572,-88591087
1638615461,-185278,true,8992511407,22,8904819572,-87691835
1638615489,-185276,true,8994310000,22,8903929179,-90380821
1638615587,-185270,true,8999707935,22,8899478550,-100229385
1638616215,-185266,true,9003308358,22,8869273211,-134035147
1638616915,-185274,true,8996108952,22,8862180984,-133927968
1638617070,-185278,true,8992511407,22,8861294855,-131216552
1638617513,-185274,true,8996108952,22,8845359667,-150749285
1638617585,-185271,true,8998808054,22,8837402822,-161405232
1638617881,-185280,true,8990713175,22,8803886089,-186827086
1638617961,-185281,true,8989814193,22,8794207623,-195606570
1638618249,-185285,true,8986219167,22,8755600038,-230619129
1638618384,-185286,true,8985320635,22,8738107212,-247213423
1638618549,-185292,true,8979931329,22,8737233488,-242697841
1638618926,-185289,true,8982625577,22,8758226981,-224398596
1638619388,-185288,true,8983523840,22,8824157317,-159366523
1638619565,-185287,true,8984422192,22,8837402822,-147019370
1638619882,-185292,true,8979931329,22,8889694994,-90236335
1638620163,-185287,true,8984422192,22,8927108356,-57313836
1638620443,-185282,true,8988915302,22,9003308358,14393056
1638620513,-185278,true,8992511407,22,9029454539,36943132
1638620782,-185278,true,8992511407,22,9120197506,127686099
1638620964,-185271,true,8998808054,22,9179668889,180860835
1638620996,-185268,true,9001507967,22,9187933896,186425929
1638621264,-185276,true,8994310000,22,9229370690,235060690
1638621448,-185278,true,8992511407,22,9216459256,223947849
1638621765,-185274,true,8996108952,22,9165910395,169801443
1638622146,-185272,true,8997908263,22,9123846132,125937869
1638622344,-185278,true,8992511407,22,9122021636,129510229
1638622911,-185277,true,8993410659,22,9125670992,132260333
1638623209,-185272,true,8997908263,22,9141197050,143288787
1638623463,-185270,true,8999707935,22,9151257396,151549461
1638623643,-185274,true,8996108952,22,9171411316,175302364
1638623954,-185271,true,8998808054,22,9201725448,202917394
1638624068,-185265,true,9004208689,22,9201725448,197516759
1638624146,-185260,true,9008711694,22,9198045678,189333984
1638624162,-185265,true,9004208689,22,9198045678,193836989
1638624219,-185265,true,9004208689,22,9190690552,186481863
1638624220,-185260,true,9008711694,22,9190690552,181978858
1638624223,-185256,true,9012315719,22,9190690552,178374833
1638624373,-185260,true,9008711694,22,9180586856,171875162
1638624492,-185257,true,9011414578,22,9164993895,153579317
1638624872,-185253,true,9015019684,22,9116550339,101530655
1638624947,-185251,true,9016822778,22,9111993431,95170653
1638624973,-185255,true,9013216951,22,9108349544,95132593
1638625107,-185253,true,9015019684,22,9115638775,100619091
1638625309,-185249,true,9018626233,22,9115638775,97012542
1638625524,-185244,true,9023136448,22,9125670992,102534544
1638625615,-185247,true,9020430048,22,9138455240,118025192
1638625780,-185243,true,9024038762,22,9163161171,139122409
1638625849,-185237,true,9029454539,22,9173245690,143791151
1638626269,-185231,true,9034873566,22,9231216656,196343090
1638626460,-185234,true,9032163646,22,9247846977,215683331
1638626765,-185231,true,9034873566,22,9245073178,210199612
1638626969,-185226,true,9039391906,22,9243224441,203832535
1638627031,-185221,true,9043912506,22,9243224441,199311935
1638627161,-185224,true,9041199875,22,9242300211,201100336
1638627271,-185222,true,9043008206,22,9241376073,198367867
1638627308,-185218,true,9046625951,22,9241376073,194750122
1638627456,-185212,true,9052055284,22,9241376073,189320789
1638627525,-185214,true,9050245145,22,9242300211,192055066
1638627543,-185211,true,9052960490,22,9243224441,190263951
1638627563,-185206,true,9057487875,22,9247846977,190359102
1638627877,-185195,true,9067456095,22,9308150743,240694648
1638628004,-185196,true,9066549440,22,9332382210,265832770
1638628308,-185192,true,9070176604,22,9386664580,316487976
1638628803,-185186,true,9075620071,22,9398874568,323254497
1638628916,-185175,true,9085608246,22,9396995075,311386829
1638629021,-185175,true,9085608246,22,9396055469,310447223
1638629194,-185172,true,9088334201,22,9394176540,305842339
1638629327,-185167,true,9092879277,22,9386664580,293785303
1638629390,-185155,true,9103796735,22,9392297987,288501252
1638629499,-185155,true,9103796735,22,9390419809,286623074
1638629631,-185152,true,9106528148,22,9390419809,283891661
1638629669,-185147,true,9111082322,22,9388542006,277459684
1638629880,-185137,true,9120197506,22,9383849143,263651637
1638630117,-185135,true,9122021636,22,9403574945,281553309
1638630195,-185133,true,9123846132,22,9424284547,300438415
1638630527,-185125,true,9131147764,22,9483841970,352694206
1638630530,-185114,true,9141197050,22,9483841970,342644920
1638630542,-185111,true,9143939684,22,9487636076,343696392
1638630549,-185108,true,9146683140,22,9489533698,342850558
1638630689,-185092,true,9161328814,22,9549503469,388174655
1638630738,-185081,true,9171411316,22,9565750618,394339302
1638630799,-185077,true,9175080431,22,9582983613,407903182
1638630908,-185073,true,9178751014,22,9606009242,427258228
1638630986,-185059,true,9191609621,22,9617542795,425933174
1638631445,-185050,true,9199885379,22,9603128016,403242637
1638631623,-185045,true,9204486242,22,9563837755,359351513
1638631825,-185042,true,9207247864,22,9534237243,326989379
1638632002,-185029,true,9219224471,22,9505678818,286454347
1638632555,-185022,true,9225679864,22,9429940531,204260667
1638632961,-185018,true,9229370690,22,9389480861,160110171
1638633676,-185016,true,9231216656,22,9366037647,134820991
1638633908,-185003,true,9243224441,22,9366974251,123749810
1638633993,-184996,true,9249696639,22,9366974251,117277612
1638634364,-184992,true,9253397073,22,9350129704,96732631
1638634569,-184989,true,9256173370,22,9341718793,85545423
1638634871,-184976,true,9268213618,22,9336115723,67902105
1638634887,-184966,true,9277486003,22,9336115723,58629720
1638635505,-184961,true,9282125674,22,9348259958,66134284
1638635566,-184958,true,9284910590,22,9346390587,61479997
1638635670,-184946,true,9296058613,22,9346390587,50331974
1638636265,-184939,true,9302567806,22,9348259958,45692152
1638636337,-184935,true,9306289392,22,9349194784,42905392
1638636421,-184934,true,9307220021,22,9350129704,42909683
1638636652,-184924,true,9316531430,22,9352935023,36403593
1638636719,-184921,true,9319326669,22,9349194784,29868115
1638636831,-184920,true,9320258602,22,9343587230,23328628
1638637025,-184924,true,9316531430,22,9336115723,19584293
1638639553,-184919,true,9321190627,22,9317463083,-3727544
1638639581,-184918,true,9322122746,22,9313737029,-8385717
1638639717,-184916,true,9323987264,22,9311874561,-12112703
1638640001,-184918,true,9322122746,22,9307220021,-14902725
1638640150,-184911,true,9328650190,22,9305358856,-23291334
1638640168,-184910,true,9329583055,22,9305358856,-24224199
1638640642,-184907,true,9332382210,22,9300707572,-31674638
1638641305,-184907,true,9332382210,22,9381034552,48652342
1638643146,-184899,true,9339850730,22,9402634682,62783952
1638643406,-184898,true,9340784715,22,9399814455,59029740
1638644457,-184895,true,9343587230,22,9389480861,45893631
1638645113,-184897,true,9341718793,22,9386664580,44945787
1638645121,-184890,true,9348259958,22,9386664580,38404622
1638645840,-184890,true,9348259958,22,9388542006,40282048
1638646235,-184886,true,9351999823,22,9385726007,33726184
1638646749,-184885,true,9352935023,22,9381972655,29037632
1638646921,-184876,true,9361356033,22,9372595840,11239807
1638647117,-184875,true,9362292168,22,9360419991,-1872177
1638647242,-184873,true,9364164720,22,9354805704,-9359016
1638647322,-184873,true,9364164720,22,9351999823,-12164897
1638647369,-184865,true,9371658675,22,9348259958,-23398717
1638647552,-184865,true,9371658675,22,9333315448,-38343227
1638648197,-184865,true,9371658675,22,9271921459,-99737216
1638648610,-184868,true,9368847739,22,9201725448,-167122291
1638649071,-184860,true,9376345441,22,9168660443,-207684998
1638649573,-184861,true,9375407900,22,9214616241,-160791659
1638649920,-184863,true,9373533100,22,9230293627,-143239473
1638650017,-184866,true,9370721602,22,9232139778,-138581824
1638650093,-184859,true,9377283076,22,9228447845,-148835231
1638650255,-184862,true,9374470453,22,9216459256,-158011197
1638650439,-184866,true,9370721602,22,9203565886,-167155716
1638650915,-184870,true,9366974251,22,9168660443,-198313808
1638650947,-184863,true,9373533100,22,9166826986,-206706114
1638651264,-184866,true,9370721602,22,9161328814,-209392788
1638651676,-184870,true,9366974251,22,9156749524,-210224727
1638651733,-184874,true,9363228397,22,9155833940,-207394457
1638651792,-184868,true,9368847739,22,9155833940,-213013799
1638652188,-184871,true,9366037647,22,9137541485,-228496162
1638652487,-184876,true,9361356033,22,9125670992,-235685041
1638653890,-184880,true,9357612426,22,9119285577,-238326849
1638654096,-184875,true,9362292168,22,9128408968,-233883200
1638655036,-184884,true,9353870317,22,9158580965,-195289352
1638656070,-184890,true,9348259958,22,9115638775,-232621183
1638656331,-184893,true,9345456041,22,9131147764,-214308277
1638656540,-184887,true,9351064717,22,9143025381,-208039336
1638656610,-184897,true,9341718793,22,9146683140,-195035653
1638656950,-184901,true,9337983040,22,9164077488,-173905552
1638657211,-184904,true,9335182205,22,9175080431,-160101774
1638657286,-184897,true,9341718793,22,9174163015,-167555778
1638657291,-184907,true,9332382210,22,9173245690,-159136520
1638657490,-184912,true,9327717419,22,9167743668,-159973751
1638657591,-184916,true,9323987264,22,9167743668,-156243596
1638657764,-184910,true,9329583055,22,9164077488,-165505567
1638657808,-184919,true,9321190627,22,9164993895,-156196732
1638657899,-184924,true,9316531430,22,9161328814,-155202616
1638658025,-184930,true,9310943467,22,9151257396,-159686071
1638658116,-184928,true,9312805749,22,9139369085,-173436664
1638658144,-184938,true,9303498063,22,9137541485,-165956578
1638658203,-184947,true,9295129100,22,9133887382,-161241718
1638658256,-184953,true,9289553974,22,9132060879,-157493095
1638658370,-184959,true,9283982192,22,9124758517,-159223675
1638658553,-184969,true,9274703314,22,9110171305,-164532009
1638658668,-184977,true,9267286889,22,9101976249,-165310640
1638658905,-184983,true,9261728462,22,9083791397,-177937065
1638659185,-184985,true,9259876394,22,9093788565,-166087829
1638659710,-184992,true,9253397073,22,9113815920,-139581153
1638660524,-184998,true,9247846977,22,9147597808,-100249169
1638660913,-185003,true,9243224441,22,9144854078,-98370363
1638661130,-185004,true,9242300211,22,9138455240,-103844971
1638661137,-185007,true,9239528075,22,9128408968,-111119107
1638661151,-185013,true,9233986298,22,9123846132,-110140166
1638661156,-185018,true,9229370690,22,9123846132,-105524558
1638661353,-185022,true,9225679864,22,9101066143,-124613721
1638661417,-185023,true,9224757388,22,9092879277,-131878111
1638661424,-185030,true,9218302640,22,9081974911,-136327729
1638661433,-185035,true,9213694872,22,9077435285,-136259587
1638661525,-185042,true,9207247864,22,9061111414,-146136450
1638661589,-185046,true,9203565886,22,9045721379,-157844507
1638661603,-185056,true,9194367380,22,9019528096,-174839284
1638661659,-185064,true,9187015195,22,8985320635,-201694560
1638661675,-185077,true,9175080431,22,8979931329,-195149102
1638661711,-185086,true,9166826986,22,8964679176,-202147810
1638661716,-185089,true,9164077488,22,8962886509,-201190979
1638661873,-185091,true,9162244947,22,8909272872,-252972075
1638661935,-185104,true,9150342362,22,8887917322,-262425040
1638662226,-185114,true,9141197050,22,8802125576,-339071474
1638662293,-185117,true,9138455240,22,8781026858,-357428382
1638662315,-185119,true,9136627823,22,8774882597,-361745226
1638662351,-185132,true,9124758517,22,8776637662,-348120855
1638662500,-185140,true,9117461994,22,8775760086,-341701908
1638662681,-185142,true,9115638775,22,8797725833,-317912942
1638662732,-185165,true,9094697944,22,8601996995,-492700949
1638662750,-185185,true,9076527633,22,8548832252,-527695381
1638662796,-185204,true,9059299464,22,8545413574,-513885890
1638663365,-185188,true,9073805219,22,8499395004,-574410215
1638663371,-185202,true,9061111414,22,8492598547,-568512867
1638663379,-185220,true,9044816898,22,8491749372,-553067526
1638663391,-185239,true,9027648919,22,8487504770,-540144149
1638663592,-185226,true,9039391906,22,8495146581,-544245325
1638663824,-185239,true,9027648919,22,8683232915,-344416004
1638663865,-185256,true,9012315719,22,8680628466,-331687253
1638663952,-185275,true,8995209431,22,8684101239,-311108192
1638664029,-185261,true,9007810913,22,8682364679,-325446234
1638664033,-185273,true,8997008562,22,8679760490,-317248072
1638664083,-185291,true,8980829322,22,8672819806,-308009516
1638664090,-185312,true,8961990310,22,8671952610,-290037700
1638664118,-185299,true,8973647890,22,8671085502,-302562388
1638664396,-185309,true,8964679176,22,8660686960,-303992216
1638664458,-185327,true,8948558073,22,8658089273,-290468800
1638664519,-185347,true,8930679735,22,8654626903,-276052832
1638664622,-185333,true,8943190817,22,8640791263,-302399554
1638664647,-185341,true,8936039482,22,8638199544,-297839938
1638664668,-185359,true,8919969882,22,8637335811,-282634071
1638664849,-185378,true,8903038875,22,8626115130,-276923745
1638664863,-185362,true,8917294426,22,8621803366,-295491060
1638664879,-185372,true,8908382034,22,8616632094,-291749940
1638664982,-185391,true,8891473022,22,8610602864,-280870158
1638665359,-185412,true,8872821453,22,8573658606,-299162847
1638665384,-185395,true,8887917322,22,8576230960,-311686362
1638665529,-185402,true,8881698268,22,8589963226,-291735042
1638665953,-185419,true,8866612961,22,8624390166,-242222795
1638666256,-185438,true,8849783231,22,8648571087,-201212144
1638667091,-185421,true,8864839905,22,8632155222,-232684683
1638667256,-185429,true,8857751223,22,8633018438,-224732785
1638667276,-185446,true,8842706590,22,8632155222,-210551368
1638667389,-185463,true,8827687509,22,8641655342,-186032167
1638667453,-185444,true,8844475219,22,8647706316,-196768903
1638667477,-185450,true,8839170391,22,8649435944,-189734447
1638667872,-185468,true,8823274989,22,8674554456,-148720533
1638667889,-185486,true,8807408172,22,8675421912,-131986260
1638668012,-185467,true,8824157317,22,8683232915,-140924402
1638668050,-185473,true,8818864675,22,8684101239,-134763436
1638668176,-185492,true,8802125576,22,8686706730,-115418846
1638668207,-185510,true,8786296792,22,8684969649,-101327143
1638668290,-185492,true,8802125576,22,8687575400,-114550176
1638668438,-185497,true,8797725833,22,8693658528,-104067305
1638668449,-185515,true,8781904961,22,8692789249,-89115712
1638668452,-185532,true,8766989150,22,8692789249,-74199901
1638669245,-185515,true,8781904961,22,8708449577,-73455384
1638669354,-185520,true,8777515325,22,8705837564,-71677761
1638669493,-185537,true,8762606971,22,8706708148,-55898823
1638669742,-185555,true,8746849252,22,8704096658,-42752594
1638669802,-185538,true,8761730797,22,8702356099,-59374698
1638670211,-185543,true,8757351246,22,8687575400,-69775846
1638670271,-185560,true,8742477139,22,8687575400,-54901739
1638670926,-185576,true,8728501058,22,8706708148,-21792910
1638670942,-185559,true,8743351387,22,8707578819,-35772568
1638670961,-185563,true,8739854920,22,8708449577,-31405343
1638671117,-185579,true,8725883032,22,8721521399,-4361633
1638671137,-185594,true,8712804672,22,8722393551,9588879
1638671204,-185577,true,8727628296,22,8718905466,-8722830
1638671590,-185583,true,8722393551,22,8693658528,-28735023
1638671948,-185601,true,8706708148,22,8666751259,-39956889
1638672666,-185617,true,8692789249,22,8657223551,-35565698
1638672815,-185601,true,8706708148,22,8655492366,-51215782
1638672833,-185607,true,8701485951,22,8652896237,-48589714
1638672990,-185625,true,8685838146,22,8654626903,-31211243
1638673005,-185642,true,8671085502,22,8653761527,-17323975
1638673852,-185622,true,8688444158,22,8704967067,16522909
1638674016,-185627,true,8684101239,22,8701485951,17384712
1638674157,-185641,true,8671952610,22,8693658528,21705918
1638674314,-185659,true,8656357915,22,8693658528,37300613
1638674777,-185639,true,8673687088,22,8695397346,21710258
1638675072,-185642,true,8671085502,22,8721521399,50435897
1638675466,-185652,true,8662419184,22,8735486304,73067120
1638675519,-185667,true,8649435944,22,8737233488,87797544
1638675560,-185643,true,8670218480,22,8743351387,73132907
1638675566,-185643,true,8670218480,22,8745100145,74881665
1638675795,-185642,true,8671085502,22,8778393077,107307575
1638675910,-185651,true,8663285425,22,8792449045,129163620
1638676183,-185634,true,8678024799,22,8828570278,150545479
1638676422,-185640,true,8672819806,22,8857751223,184931417
1638676615,-185640,true,8672819806,22,8855979938,183160132
1638676765,-185648,true,8665884671,22,8855094429,189209758
1638677046,-185630,true,8681496529,22,8853323676,171827147
1638677118,-185636,true,8676289454,22,8850668210,174378756
1638677148,-185636,true,8676289454,22,8848898341,172608887
1638677317,-185647,true,8666751259,22,8832985446,166234187
1638677735,-185633,true,8678892601,22,8790690819,111798218
1638678013,-185618,true,8691920057,22,8743351387,51431330
1638678076,-185611,true,8698006226,22,8743351387,45345161
1638678161,-185611,true,8698006226,22,8742477139,44470913
1638678551,-185614,true,8695397346,22,8743351387,47954041
1638679154,-185611,true,8698006226,22,8761730797,63724571
1638679227,-185608,true,8700615889,22,8762606971,61991082
1638679536,-185607,true,8701485951,22,8765236015,63750064
1638679803,-185608,true,8700615889,22,8766989150,66373261
1638679978,-185606,true,8702356099,22,8768742636,66386537
1638680170,-185602,true,8705837564,22,8769619510,63781946
1638680379,-185603,true,8704967067,22,8759102804,54135737
1638680844,-185605,true,8703226335,22,8738107212,34880877
1638681402,-185604,true,8704096658,22,8727628296,23531638
1638681545,-185599,true,8708449577,22,8735486304,27036727
1638681779,-185596,true,8711062373,22,8792449045,81386672
1638681937,-185594,true,8712804672,22,8831219114,118414442
1638681985,-185590,true,8716290317,22,8840054308,123763991
1638682003,-185584,true,8721521399,22,8841822407,120301008
1638682043,-185582,true,8723265790,22,8848013540,124747750
1638682212,-185581,true,8724138117,22,8875483565,151345448
1638682312,-185574,true,8730246846,22,8901258534,171011688
1638682437,-185567,true,8736359852,22,8921753965,185394113
1638682570,-185566,true,8737233488,22,8918186155,180952667
1638682589,-185565,true,8738107212,22,8916402786,178295574
1638682941,-185559,true,8743351387,22,8904819572,161468185
1638683038,-185551,true,8750348517,22,8906600625,156252108
1638683183,-185546,true,8754724566,22,8930679735,175955169
1638683198,-185545,true,8755600038,22,8931572803,175972765
1638683300,-185537,true,8762606971,22,8946768630,184161659
1638683869,-185531,true,8767865849,22,9006910222,239044373
1638684059,-185528,true,8770496472,22,8996108952,225612480
1638684410,-185529,true,8769619510,22,8944979544,175360034
1638684587,-185521,true,8776637662,22,8925323202,148685540
1638685444,-185517,true,8780148843,22,8899478550,119329707
1638685544,-185514,true,8782783151,22,8899478550,116695399
1638685724,-185517,true,8780148843,22,8898588691,118439848
1638685968,-185510,true,8786296792,22,8897698921,111402129
1638686431,-185506,true,8789811838,22,8895030145,105218307
1638686541,-185504,true,8791569888,22,8894140731,102570843
1638687262,-185506,true,8789811838,22,8898588691,108776853
1638687712,-185500,true,8795087043,22,8896809240,101722197
1638687815,-185494,true,8800365415,22,8905710054,105344639
1638688196,-185491,true,8803005789,22,8917294426,114288637
1638688229,-185494,true,8800365415,22,8918186155,117820740
1638689581,-185489,true,8804766478,22,8903038875,98272397
1638689657,-185485,true,8808288913,22,8903038875,94749962
1638689696,-185483,true,8810050659,22,8903038875,92988216
1638689966,-185484,true,8809169742,22,8892362170,83192428
1638689980,-185480,true,8812693938,22,8892362170,79668232
1638690571,-185476,true,8816219545,22,8877258751,61039206
1638691102,-185474,true,8817982877,22,8882586438,64603561
1638691387,-185475,true,8817101167,22,8884363044,67261877
1638691504,-185470,true,8821510599,22,8884363044,62852445
1638691860,-185466,true,8825039732,22,8882586438,57546706
1638692343,-185465,true,8825922236,22,8850668210,24745974
1638692818,-185467,true,8824157317,22,8825039732,882415
1638692857,-185463,true,8827687509,22,8825039732,-2647777
1638693131,-185460,true,8830336080,22,8840054308,9718228
1638693187,-185460,true,8830336080,22,8842706590,12370510
1638693239,-185460,true,8830336080,22,8845359667,15023587
1638693286,-185454,true,8835635607,22,8848013540,12377933
1638693982,-185450,true,8839170391,22,8850668210,11497819
1638695533,-185451,true,8838286562,22,8839170391,883829
1638695993,-185451,true,8838286562,22,8814456565,-23829997
1638696279,-185444,true,8844475219,22,8800365415,-44109804
1638696976,-185442,true,8846244203,22,8784539796,-61704407
1638697172,-185444,true,8844475219,22,8778393077,-66082142
1638697921,-185447,true,8841822407,22,8765236015,-76586392
1638697983,-185441,true,8847128827,22,8765236015,-81892812
1638698301,-185438,true,8849783231,22,8766112539,-83670692
1638699545,-185442,true,8846244203,22,8710191354,-136052849
1638700194,-185445,true,8843590860,22,8743351387,-100239473
1638700502,-185439,true,8848898341,22,8756475598,-92422743
1638700668,-185438,true,8849783231,22,8756475598,-93307633
1638700799,-185440,true,8848013540,22,8756475598,-91537942
1638701423,-185443,true,8845359667,22,8788932944,-56426723
1638701572,-185437,true,8850668210,22,8797725833,-52942377
1638701604,-185440,true,8848013540,22,8799485467,-48528073
1638702047,-185443,true,8845359667,22,8801245452,-44114215
1638702099,-185446,true,8842706590,22,8806527519,-36179071
1638702651,-185436,true,8851553276,22,8897698921,46145645
1638703697,-185437,true,8850668210,22,8943190817,92522607
1638703814,-185439,true,8848898341,22,8942296587,93398246
1638704562,-185442,true,8846244203,22,8902148660,55904457
1638706087,-185433,true,8854209008,22,8896809240,42600232
1638707824,-185434,true,8853323676,22,8897698921,44375245
1638708129,-185435,true,8852438432,22,8895919648,43481216
1638708143,-185435,true,8852438432,22,8895919648,43481216
1638708914,-185426,true,8860408814,22,8852438432,-7970382
1638710174,-185429,true,8857751223,22,8846244203,-11507020
1638711257,-185430,true,8856865536,22,8794207623,-62657913
1638711825,-185431,true,8855979938,22,8825039732,-30940206
1638712207,-185422,true,8863953509,22,8842706590,-21246919
1638712424,-185426,true,8860408814,22,8841822407,-18586407
1638712526,-185427,true,8859522862,22,8835635607,-23887255
1638712665,-185428,true,8858636998,22,8827687509,-30949489
1638713439,-185420,true,8865726389,22,8827687509,-38038880
1638713472,-185423,true,8863067202,22,8829453135,-33614067
1638713544,-185423,true,8863067202,22,8829453135,-33614067
1638713845,-185424,true,8862180984,22,8817101167,-45079817
1638714019,-185416,true,8869273211,22,8810050659,-59222552
1638716140,-185419,true,8866612961,22,8806527519,-60085442
1638716275,-185421,true,8864839905,22,8796846149,-67993756
1638716717,-185426,true,8860408814,22,8710191354,-150217460
1638716771,-185423,true,8863067202,22,8702356099,-160711103
1638716976,-185434,true,8853323676,22,8674554456,-178769220
1638717099,-185435,true,8852438432,22,8663285425,-189153007
1638717504,-185436,true,8851553276,22,8667617935,-183935341
1638717974,-185435,true,8852438432,22,8662419184,-190019248
1638718571,-185446,true,8842706590,22,8665018169,-177688421
1638718718,-185449,true,8840054308,22,8630429050,-209625258
1638718731,-185451,true,8838286562,22,8626115130,-212171432
1638718857,-185451,true,8838286562,22,8598557056,-239729506
1638719756,-185466,true,8825039732,22,8529193513,-295846219
1638720142,-185469,true,8822392750,22,8558240671,-264152079
1638720658,-185470,true,8821510599,22,8642519508,-178991091
1638720966,-185472,true,8819746561,22,8667617935,-152128626
1638721736,-185485,true,8808288913,22,8673687088,-134601825
1638722522,-185486,true,8807408172,22,8673687088,-133721084
1638722606,-185485,true,8808288913,22,8665018169,-143270744
1638722612,-185486,true,8807408172,22,8665018169,-142390003
1638722853,-185498,true,8796846149,22,8645112523,-151733626
1638723034,-185502,true,8793328290,22,8627840439,-165487851
1638723169,-185501,true,8794207623,22,8614909026,-179298597
1638723806,-185502,true,8793328290,22,8592540473,-200787817
1638723928,-185513,true,8783661430,22,8593399727,-190261703
1638724593,-185517,true,8780148843,22,8590822222,-189326621
1638724728,-185517,true,8780148843,22,8579661967,-200486876
1638724778,-185519,true,8778393077,22,8574515971,-203877106
1638725245,-185531,true,8767865849,22,8559952405,-207913444
1638725753,-185533,true,8766112539,22,8633881740,-132230799
1638725916,-185532,true,8766989150,22,8657223551,-109765599
1638726722,-185532,true,8766989150,22,8689313002,-77676148
1638726752,-185542,true,8758226981,22,8689313002,-68913979
1638727677,-185544,true,8756475598,22,8688444158,-68031440
1638727748,-185542,true,8758226981,22,8683232915,-74994066
1638728864,-185544,true,8756475598,22,8622665546,-133810052
1638728968,-185554,true,8747723937,22,8622665546,-125058391
1638728989,-185557,true,8745100145,22,8622665546,-122434599
1638729100,-185556,true,8745974655,22,8622665546,-123309109
1638729358,-185558,true,8744225722,22,8619217342,-125008380
1638729565,-185568,true,8735486304,22,8615770517,-119715787
1638729584,-185570,true,8733739468,22,8613186303,-120553165
1638730376,-185571,true,8732866182,22,8541142149,-191724033
1638730483,-185573,true,8731119871,22,8541142149,-189977722
1638731004,-185582,true,8723265790,22,8577088583,-146177207
1638731447,-185585,true,8720649334,22,8593399727,-127249607
1638731802,-185585,true,8720649334,22,8590822222,-129827112
1638732254,-185587,true,8718905466,22,8589963226,-128942240
1638732345,-185596,true,8711062373,22,8589963226,-121099147
1638732488,-185598,true,8709320421,22,8589963226,-119357195
1638733159,-185598,true,8709320421,22,8592540473,-116779948
1638733277,-185600,true,8707578819,22,8588245491,-119333328
1638733424,-185608,true,8700615889,22,8582236123,-118379766
1638734536,-185608,true,8700615889,22,8585669533,-114946356
1638735062,-185608,true,8700615889,22,8585669533,-114946356
1638735291,-185610,true,8698876027,22,8584811052,-114064975
1638735518,-185617,true,8692789249,22,8583952656,-108836593
1638735682,-185616,true,8693658528,22,8583094347,-110564181
1638735959,-185616,true,8693658528,22,8582236123,-111422405
1638736526,-185617,true,8692789249,22,8588245491,-104543758
1638737443,-185625,true,8685838146,22,8593399727,-92438419
1638737596,-185625,true,8685838146,22,8593399727,-92438419
1638738009,-185626,true,8684969649,22,8578804087,-106165562
1638738538,-185628,true,8683232915,22,8560808400,-122424515
1638738928,-185637,true,8675421912,22,8562520647,-112901265
1638739970,-185637,true,8675421912,22,8563376900,-112045012
1638740052,-185639,true,8673687088,22,8563376900,-110310188
1638740257,-185645,true,8668484696,22,8575373423,-93111273
1638741157,-185654,true,8660686960,22,8605438310,-55248650
1638742683,-185655,true,8659820977,22,8604577852,-55243125
1638742967,-185656,true,8658955082,22,8602857194,-56097888
1638743030,-185661,true,8654626903,22,8602857194,-51769709
1638744759,-185670,true,8646841632,22,8585669533,-61172099
1638744891,-185671,true,8645977034,22,8584811052,-61165982
1638744936,-185672,true,8645112523,22,8583952656,-61159867
1638745003,-185676,true,8641655342,22,8583952656,-57702686
1638745608,-185684,true,8634745128,22,8581377986,-53367142
1638745859,-185684,true,8634745128,22,8572801325,-61943803
1638746280,-185686,true,8633018438,22,8552252298,-80766140
1638746493,-185690,true,8629566094,22,8542850463,-86715631
1638747456,-185696,true,8624390166,22,8641655342,17265176
1638747551,-185697,true,8623527813,22,8641655342,18127529
1638747565,-185696,true,8624390166,22,8641655342,17265176
1638747799,-185700,true,8620941272,22,8642519508,21578236
1638748331,-185705,true,8616632094,22,8645977034,29344940
1638748743,-185706,true,8615770517,22,8642519508,26748991
1638749036,-185706,true,8615770517,22,8639063364,23292847
1638749317,-185708,true,8614047621,22,8633018438,18970817
1638749397,-185714,true,8608881001,22,8632155222,23274221
1638749440,-185715,true,8608020199,22,8627840439,19820240
1638749616,-185715,true,8608020199,22,8612325070,4304871
1638749888,-185721,true,8602857194,22,8568516210,-34340984
1638750177,-185722,true,8601996995,22,8524077788,-77919207
1638750633,-185723,true,8601136881,22,8491749372,-109387509
1638750861,-185724,true,8600276853,22,8492598547,-107678306
1638750915,-185731,true,8594259067,22,8473088990,-121170077
1638750935,-185733,true,8592540473,22,8468006915,-124533558
1638751259,-185736,true,8589963226,22,8435891154,-154072072
1638751598,-185738,true,8588245491,22,8398856620,-189388871
1638751826,-185742,true,8584811052,22,8397177100,-187633952
1638751868,-185739,true,8587386753,22,8398016818,-189369935
1638752341,-185744,true,8583094347,22,8377886750,-205207597
1638752554,-185749,true,8578804087,22,8372024574,-206779513
1638752601,-185754,true,8574515971,22,8368676602,-205839369
1638752845,-185754,true,8574515971,22,8371187456,-203328515
1638753917,-185759,true,8570229999,22,8398856620,-171373379
1638754527,-185763,true,8566802764,22,8413146104,-153656660
1638754820,-185768,true,8562520647,22,8421563037,-140957610
1638755255,-185767,true,8563376900,22,8424089759,-139287141
1638755659,-185768,true,8562520647,22,8424089759,-138430888
1638756430,-185772,true,8559096495,22,8422405194,-136691301
1638756531,-185777,true,8554818231,22,8422405194,-132413037
1638756914,-185776,true,8555673712,22,8421563037,-134110675
1638757266,-185778,true,8553962834,22,8419037074,-134925760
1638757512,-185780,true,8552252298,22,8443486493,-108765805
1638758296,-185783,true,8549687136,22,8508749014,-40938122
1638759074,-185780,true,8552252298,22,8507898225,-44354073
1638759455,-185783,true,8549687136,22,8507047520,-42639616
1638760376,-185787,true,8546268116,22,8501094968,-45173148
1638760548,-185791,true,8542850463,22,8501094968,-41755495
1638760876,-185790,true,8543704748,22,8502795272,-40909476
1638761841,-185793,true,8541142149,22,8514706926,-26435223
1638762019,-185796,true,8538580319,22,8513855540,-24724779
1638762222,-185798,true,8536872859,22,8513004240,-23868619
1638762306,-185797,true,8537726546,22,8512153025,-25573521
1638762474,-185799,true,8536019257,22,8511301894,-24717363
1638762844,-185802,true,8533458963,22,8507898225,-25560738
1638763152,-185804,true,8531752527,22,8507898225,-23854302
1638763431,-185803,true,8532605703,22,8508749014,-23856689
1638763613,-185804,true,8531752527,22,8507047520,-24705007
1638764025,-185805,true,8530899437,22,8501945077,-28954360
1638764091,-185807,true,8529193513,22,8506196900,-22996613
1638764116,-185806,true,8530046433,22,8507898225,-22148208
1638764295,-185806,true,8530046433,22,8517261593,-12784840
1638764493,-185808,true,8528340679,22,8521521076,-6819603
1638764495,-185809,true,8527487931,22,8521521076,-5966855
1638764531,-185808,true,8528340679,22,8523225465,-5115214
1638764728,-185810,true,8526635267,22,8529193513,2558246
1638765588,-185812,true,8524930196,22,8518113320,-6816876
1638766281,-185813,true,8524077788,22,8522373228,-1704560
1638767035,-185813,true,8524077788,22,8447709081,-76368707
1638767076,-185815,true,8522373228,22,8444330842,-78042386
1638767346,-185818,true,8519817027,22,8435891154,-83925873
1638767838,-185821,true,8517261593,22,8440109943,-77151650
1638768985,-185821,true,8517261593,22,8438422174,-78839419
1638769685,-185823,true,8515558397,22,8432517641,-83040756
1638769757,-185826,true,8513004240,22,8430831390,-82172850
1638770219,-185829,true,8510450849,22,8427459900,-82990949
1638770475,-185830,true,8509599889,22,8425774661,-83825228
1638770654,-185832,true,8507898225,22,8425774661,-82123564
1638770845,-185834,true,8506196900,22,8421563037,-84633863
1638770992,-185838,true,8502795272,22,8408099983,-94695289
1638771167,-185839,true,8501945077,22,8402216667,-99728410
1638771295,-185841,true,8500244943,22,8397177100,-103067843
1638771696,-185844,true,8497695380,22,8384591406,-113103974
1638772034,-185848,true,8494297151,22,8389623418,-104673733
1638772265,-185849,true,8493447806,22,8399696506,-93751300
1638772302,-185852,true,8490900282,22,8401376529,-89523753
1638773278,-185854,true,8489202356,22,8430831390,-58370966
1638773381,-185857,true,8486656105,22,8435891154,-50764951
1638773412,-185857,true,8486656105,22,8437578416,-49077689
1638773688,-185860,true,8484110617,22,8454469614,-29641003
1638774095,-185859,true,8484959028,22,8474783693,-10175335
1638774449,-185862,true,8482414049,22,8486656105,4242056
1638774843,-185862,true,8482414049,22,8496845695,14431646
1638774918,-185864,true,8480717821,22,8493447806,12729985
1638775096,-185864,true,8480717821,22,8482414049,1696228
1638775772,-185867,true,8478174115,22,8446864394,-31309721
1638775815,-185870,true,8475631171,22,8445175275,-30455896
1638776505,-185874,true,8472241766,22,8396337467,-75904299
1638776899,-185875,true,8471394626,22,8375373887,-96020739
1638776906,-185881,true,8466313568,22,8375373887,-90939681
1638776947,-185884,true,8463774182,22,8374536433,-89237749
1638777156,-185889,true,8459543564,22,8373699063,-85844501
1638777263,-185889,true,8459543564,22,8373699063,-85844501
1638777268,-185895,true,8454469614,22,8373699063,-80770551
1638777437,-185898,true,8451933780,22,8373699063,-78234717
1638777507,-185902,true,8448553852,22,8376211424,-72342428
1638777587,-185901,true,8449398707,22,8377886750,-71511957
1638777757,-185903,true,8447709081,22,8382076531,-65632550
1638779042,-185902,true,8448553852,22,8445175275,-3378577
1638779843,-185905,true,8446019792,22,8446019792,0
1638780134,-185903,true,8447709081,22,8446864394,-844687
1638780508,-185905,true,8446019792,22,8446864394,844602
1638780893,-185903,true,8447709081,22,8434204228,-13504853
1638781241,-185904,true,8446864394,22,8421563037,-25301357
1638781845,-185900,true,8450243647,22,8456160592,5916945
1638781877,-185902,true,8448553852,22,8458697694,10143842
1638782006,-185900,true,8450243647,22,8466313568,16069921
1638782870,-185900,true,8450243647,22,8426617239,-23626408
1638783733,-185894,true,8455315061,22,8518965131,63650070
1638783990,-185896,true,8453624252,22,8507047520,53423268
1638784673,-185894,true,8455315061,22,8479869834,24554773
1638784935,-185895,true,8454469614,22,8482414049,27944435
1638785114,-185890,true,8458697694,22,8478174115,19476421
1638785408,-185892,true,8457006209,22,8480717821,23711612
1638785974,-185891,true,8457851909,22,8468853716,11001807
1638786209,-185893,true,8456160592,22,8446864394,-9296198
1638787015,-185890,true,8458697694,22,8390462381,-68235313
1638787653,-185893,true,8456160592,22,8382076531,-74084061
1638788648,-185893,true,8456160592,22,8411463727,-44696865
1638789090,-185893,true,8456160592,22,8437578416,-18582176
1638789418,-185892,true,8457006209,22,8430831390,-26174819
1638789540,-185896,true,8453624252,22,8436734743,-16889509
1638789546,-185896,true,8453624252,22,8436734743,-16889509
1638789593,-185899,true,8451088671,22,8431674473,-19414198
1638789645,-185897,true,8452778974,22,8425774661,-27004313
1638790673,-185903,true,8447709081,22,8367839818,-79869263
1638791229,-185902,true,8448553852,22,8393819069,-54734783
1638791287,-185906,true,8445175275,22,8396337467,-48837808
1638792103,-185903,true,8447709081,22,8414828818,-32880263
1638792518,-185909,true,8442642229,22,8414828818,-27813411
1638792920,-185908,true,8443486493,22,8413146104,-30340389
1638793046,-185911,true,8440953954,22,8405578057,-35375897
1638793354,-185909,true,8442642229,22,8392140557,-50501672
1638793692,-185915,true,8437578416,22,8375373887,-62204529
1638796054,-185915,true,8437578416,22,8366166501,-71411915
1638796733,-185919,true,8434204228,22,8365329968,-68874260
1638796858,-185916,true,8436734743,22,8367003117,-69731626
1638797684,-185923,true,8430831390,22,8377886750,-52944640
1638797856,-185922,true,8431674473,22,8377049045,-54625428
1638797996,-185927,true,8427459900,22,8377049045,-50410855
1638798000,-185925,true,8429145477,22,8377049045,-52096432
1638798273,-185931,true,8424089759,22,8387107035,-36982724
1638798871,-185930,true,8424932168,22,8400536475,-24395693
1638799285,-185933,true,8422405194,22,8398016818,-24388376
1638799529,-185932,true,8423247434,22,8398016818,-25230616
1638800600,-185937,true,8419037074,22,8398856620,-20180454
1638800821,-185935,true,8420720965,22,8398016818,-22704147
1638800909,-185938,true,8418195254,22,8397177100,-21018154
1638800984,-185936,true,8419878977,22,8397177100,-22701877
1638801478,-185940,true,8416511868,22,8386268408,-30243460
1638801510,-185938,true,8418195254,22,8385429865,-32765389
1638801531,-185941,true,8415670301,22,8385429865,-30240436
1638801665,-185939,true,8417353519,22,8381238407,-36115112
1638801951,-185944,true,8413146104,22,8373699063,-39447041
1638802146,-185941,true,8415670301,22,8370350421,-45319880
1638802291,-185944,true,8413146104,22,8367003117,-46142987
1638802428,-185942,true,8414828818,22,8365329968,-49498850
1638802684,-185946,true,8411463727,22,8361148557,-50315170
1638803073,-185944,true,8413146104,22,8355298094,-57848010
1638803238,-185946,true,8411463727,22,8352792005,-58671722
1638803275,-185944,true,8413146104,22,8351956810,-61189294
1638803422,-185947,true,8410622665,22,8365329968,-45292697
1638804480,-185942,true,8414828818,22,8439266016,24437198
1638804574,-185944,true,8413146104,22,8439266016,26119912
1638804911,-185941,true,8415670301,22,8485807524,70137223
1638805206,-185945,true,8412304874,22,8525782689,113477815
1638805616,-185935,true,8420720965,22,8576230960,155509995
1638805651,-185937,true,8419037074,22,8578804087,159767013
1638805910,-185937,true,8419037074,22,8571944131,152907057
1638805921,-185940,true,8416511868,22,8573658606,157146738
1638805981,-185931,true,8424089759,22,8579661967,155572208
1638806444,-185931,true,8424089759,22,8611463924,187374165
1638807336,-185928,true,8426617239,22,8639927270,213310031
1638807443,-185930,true,8424932168,22,8637335811,212403643
1638807809,-185921,true,8432517641,22,8631292093,198774452
1638808923,-185920,true,8433360892,22,8577946292,144585400
1638809296,-185918,true,8435047649,22,8588245491,153197842
1638809590,-185919,true,8434204228,22,8595978005,161773777
1638810208,-185909,true,8442642229,22,8606298853,163656624
1638810696,-185908,true,8443486493,22,8600276853,156790360
1638810992,-185906,true,8445175275,22,8591681305,146506030
1638811833,-185909,true,8442642229,22,8492598547,49956318
1638811994,-185901,true,8449398707,22,8487504770,38106063
1638812295,-185902,true,8448553852,22,8474783693,26229841
1638813276,-185902,true,8448553852,22,8449398707,844855
1638813286,-185906,true,8445175275,22,8448553852,3378577
1638813321,-185900,true,8450243647,22,8448553852,-1689795
1638813358,-185901,true,8449398707,22,8447709081,-1689626
1638813398,-185903,true,8447709081,22,8446019792,-1689289
1638813589,-185908,true,8443486493,22,8430831390,-12655103
1638813607,-185903,true,8447709081,22,8429988391,-17720690
1638814279,-185903,true,8447709081,22,8406418615,-41290466
1638814311,-185905,true,8446019792,22,8408940793,-37078999
1638814381,-185910,true,8441798049,22,8412304874,-29493175
1638815236,-185905,true,8446019792,22,8411463727,-34556065
1638815286,-185904,true,8446864394,22,8414828818,-32035576
1638815933,-185908,true,8443486493,22,8413987419,-29499074
1638816155,-185913,true,8439266016,22,8411463727,-27802289
1638816313,-185909,true,8442642229,22,8409781687,-32860542
1638816349,-185909,true,8442642229,22,8411463727,-31178502
1638816565,-185911,true,8440953954,22,8418195254,-22758700
1638816663,-185916,true,8436734743,22,8421563037,-15171706
1638816932,-185910,true,8441798049,22,8430831390,-10966659
1638816976,-185910,true,8441798049,22,8431674473,-10123576
1638817093,-185911,true,8440953954,22,8427459900,-13494054
1638817200,-185915,true,8437578416,22,8424932168,-12646248
1638817572,-185911,true,8440953954,22,8403897194,-37056760
1638817669,-185911,true,8440953954,22,8398016818,-42937136
1638817705,-185912,true,8440109943,22,8395497917,-44612026
1638817952,-185918,true,8435047649,22,8382914739,-52132910
1638818249,-185914,true,8438422174,22,8377049045,-61373129
1638818435,-185912,true,8440109943,22,8385429865,-54680078
1638819230,-185913,true,8439266016,22,8423247434,-16018582
1638819782,-185915,true,8437578416,22,8419878977,-17699439
1638819805,-185912,true,8440109943,22,8417353519,-22756424
1638820345,-185911,true,8440953954,22,8404737584,-36216370
1638820908,-185913,true,8439266016,22,8385429865,-53836151
1638821342,-185917,true,8435891154,22,8371187456,-64703698
1638821782,-185914,true,8438422174,22,8361984672,-76437502
1638821792,-185913,true,8439266016,22,8360312526,-78953490
1638821832,-185915,true,8437578416,22,8359476578,-78101838
1638821855,-185919,true,8434204228,22,8358640714,-75563514
1638821869,-185916,true,8436734743,22,8357804934,-78929809
1638821964,-185915,true,8437578416,22,8351956810,-85621606
1638822000,-185918,true,8435047649,22,8348616862,-86430787
1638822043,-185923,true,8430831390,22,8343609445,-87221945
1638822481,-185919,true,8434204228,22,8332770341,-101433887
1638823321,-185918,true,8435047649,22,8337771254,-97276395
1638823432,-185921,true,8432517641,22,8331937148,-100580493
1638823735,-185926,true,8428302646,22,8315290758,-113011888
1638823918,-185923,true,8430831390,22,8304488443,-126342947
1638823934,-185924,true,8429988391,22,8303658077,-126330314
1638824271,-185926,true,8428302646,22,8302827794,-125474852
1638824318,-185931,true,8424089759,22,8301997594,-122092165
1638824467,-185928,true,8426617239,22,8303658077,-122959162
1638824686,-185929,true,8425774661,22,8306980038,-118794623
1638824848,-185931,true,8424089759,22,8309472382,-114617377
1638825207,-185936,true,8419878977,22,8299507493,-120371484
1638825416,-185932,true,8423247434,22,8298677625,-124569809
1638825655,-185934,true,8421563037,22,8289554555,-132008482
1638829019,-185931,true,8424089759,22,8395497917,-28591842
1638829057,-185935,true,8420720965,22,8394658451,-26062514
1638829093,-185931,true,8424089759,22,8397177100,-26912659
1638829739,-185931,true,8424089759,22,8440109943,16020184
1638830004,-185927,true,8427459900,22,8437578416,10118516
1638830095,-185931,true,8424089759,22,8432517641,8427882
1638830386,-185927,true,8427459900,22,8429145477,1685577
1638830667,-185927,true,8427459900,22,8432517641,5057741
1638831290,-185922,true,8431674473,22,8457006209,25331736
1638831414,-185926,true,8428302646,22,8456160592,27857946
1638831565,-185925,true,8429145477,22,8455315061,26169584
1638831711,-185926,true,8428302646,22,8459543564,31240918
1638831807,-185922,true,8431674473,22,8461235557,29561084
1638831988,-185927,true,8427459900,22,8466313568,38853668
1638832150,-185930,true,8424932168,22,8470547572,45615404
1638832175,-185931,true,8424089759,22,8470547572,46457813
1638832350,-185927,true,8427459900,22,8473088990,45629090
1638832493,-185932,true,8423247434,22,8474783693,51536259
1638832627,-185932,true,8423247434,22,8501945077,78697643
1638833180,-185933,true,8422405194,22,8585669533,163264339
1638833538,-185930,true,8424932168,22,8583094347,158162179
1638833563,-185935,true,8420720965,22,8581377986,160657021
1638833593,-185935,true,8420720965,22,8575373423,154652458
1638833677,-185938,true,8418195254,22,8559096495,140901241
1638833769,-185937,true,8419037074,22,8547122742,128085668
1638833800,-185942,true,8414828818,22,8541142149,126313331
1638834274,-185941,true,8415670301,22,8499395004,83724703
1638834282,-185944,true,8413146104,22,8499395004,86248900
1638835026,-185942,true,8414828818,22,8498545149,83716331
1638835415,-185945,true,8412304874,22,8487504770,75199896
1638836014,-185944,true,8413146104,22,8453624252,40478148
1638836210,-185945,true,8412304874,22,8447709081,35404207
1638836418,-185943,true,8413987419,22,8454469614,40482195
1638836762,-185943,true,8413987419,22,8516409952,102422533
1638837141,-185938,true,8418195254,22,8580519934,162324680
1638837389,-185938,true,8418195254,22,8600276853,182081599
1638837444,-185933,true,8422405194,22,8599416912,177011718
1638837512,-185933,true,8422405194,22,8594259067,171853873
1638837584,-185928,true,8426617239,22,8589104316,162487077
1638837631,-185930,true,8424932168,22,8584811052,159878884
1638837785,-185927,true,8427459900,22,8571944131,144484231
1638838040,-185927,true,8427459900,22,8549687136,122227236
1638838131,-185922,true,8431674473,22,8541142149,109467676
1638838474,-185922,true,8431674473,22,8569373062,137698589
1638838508,-185918,true,8435047649,22,8573658606,138610957
1638838734,-185915,true,8437578416,22,8605438310,167859894
1638838796,-185910,true,8441798049,22,8614047621,172249572
1638839147,-185909,true,8442642229,22,8649435944,206793715
1638839160,-185905,true,8446019792,22,8649435944,203416152
1638839262,-185904,true,8446864394,22,8650300887,203436493
1638839409,-185899,true,8451088671,22,8650300887,199212216
1638839487,-185898,true,8451933780,22,8649435944,197502164
1638840243,-185891,true,8457851909,22,8695397346,237545437
1638841273,-185889,true,8459543564,22,8704096658,244553094
1638841274,-185882,true,8465467021,22,8704096658,238629637
1638841557,-185881,true,8466313568,22,8735486304,269172736
1638841997,-185871,true,8474783693,22,8820628536,345844843
1638842354,-185864,true,8480717821,22,8864839905,384122084
1638842429,-185857,true,8486656105,22,8869273211,382617106
1638842731,-185856,true,8487504770,22,8848898341,361393571
1638843074,-185850,true,8492598547,22,8803005789,310407242
1638843257,-185845,true,8496845695,22,8771373522,274527827
1638844319,-185840,true,8501094968,22,8710191354,209096386
1638844583,-185840,true,8501094968,22,8710191354,209096386
1638844820,-185833,true,8507047520,22,8710191354,203143834
1638845434,-185827,true,8512153025,22,8708449577,196296552
1638845617,-185822,true,8516409952,22,8707578819,191168867
1638845945,-185822,true,8516409952,22,8707578819,191168867
1638847480,-185815,true,8522373228,22,8690181934,167808706
1638848683,-185809,true,8527487931,22,8689313002,161825071
1638848769,-185803,true,8532605703,22,8688444158,155838455
1638849418,-185802,true,8533458963,22,8653761527,120302564
1638850309,-185796,true,8538580319,22,8630429050,91848731
1638850659,-185791,true,8542850463,22,8628703223,85852760
1638851291,-185787,true,8546268116,22,8625252605,78984489
1638851758,-185787,true,8546268116,22,8624390166,78122050
1638852479,-185781,true,8551397159,22,8625252605,73855446
1638852938,-185775,true,8556529280,22,8624390166,67860886
1638853308,-185770,true,8560808400,22,8618355507,57547107
1638853761,-185769,true,8561664481,22,8609741889,48077408
1638853779,-185764,true,8565946170,22,8610602864,44656694
1638853903,-185758,true,8571087022,22,8612325070,41238048
1638856258,-185754,true,8574515971,22,8626977742,52461771
1638856707,-185752,true,8576230960,22,8626115130,49884170
1638856804,-185746,true,8581377986,22,8626115130,44737144
1638857394,-185741,true,8585669533,22,8628703223,43033690
1638858975,-185736,true,8589963226,22,8628703223,38739997
1638859424,-185734,true,8591681305,22,8626977742,35296437
1638859899,-185733,true,8592540473,22,8624390166,31849693
1638860187,-185728,true,8596837602,22,8622665546,25827944
1638860245,-185723,true,8601136881,22,8622665546,21528665
1638860256,-185722,true,8601996995,22,8622665546,20668551
1638860358,-185722,true,8601996995,22,8627840439,25843444
1638860653,-185718,true,8605438310,22,8620079264,14640954
1638861177,-185714,true,8608881001,22,8607159483,-1721518
1638861200,-185713,true,8609741889,22,8605438310,-4303579
1638861243,-185714,true,8608881001,22,8601136881,-7744120
1638861786,-185710,true,8612325070,22,8615770517,3445447
1638861805,-185705,true,8616632094,22,8616632094,0
1638862007,-185703,true,8618355507,22,8636472163,18116656
1638862437,-185704,true,8617493757,22,8669351545,51857788
1638862735,-185698,true,8622665546,22,8684101239,61435693
1638863379,-185694,true,8626115130,22,8677157083,51041953
1638863470,-185692,true,8627840439,22,8677157083,49316644
1638863934,-185693,true,8626977742,22,8673687088,46709346
1638864494,-185688,true,8631292093,22,8671085502,39793409
1638865123,-185686,true,8633018438,22,8692789249,59770811
1638865287,-185687,true,8632155222,22,8690181934,58026712
1638865533,-185689,true,8630429050,22,8665018169,34589119
1638866328,-185685,true,8633881740,22,8614047621,-19834119
1638866809,-185683,true,8635608602,22,8639927270,4318668
1638867294,-185680,true,8638199544,22,8658955082,20755538
1638867778,-185679,true,8639063364,22,8665018169,25954805
1638868314,-185674,true,8643383760,22,8672819806,29436046
1638868368,-185674,true,8643383760,22,8672819806,29436046
1638869143,-185671,true,8645977034,22,8670218480,24241446
1638869389,-185670,true,8646841632,22,8668484696,21643064
1638871343,-185665,true,8651165917,22,8665884671,14718754
1638871477,-185664,true,8652031034,22,8665018169,12987135
1638872550,-185661,true,8654626903,22,8636472163,-18154740
1638872829,-185660,true,8655492366,22,8635608602,-19883764
1638873063,-185657,true,8658089273,22,8633881740,-24207533
1638874103,-185659,true,8656357915,22,8632155222,-24202693
1638874390,-185658,true,8657223551,22,8635608602,-21614949
1638875379,-185658,true,8657223551,22,8646841632,-10381919
1638875519,-185654,true,8660686960,22,8645977034,-14709926
1638875568,-185656,true,8658955082,22,8645112523,-13842559
1638875665,-185653,true,8661553028,22,8641655342,-19897686
1638876032,-185654,true,8660686960,22,8619217342,-41469618
1638876411,-185651,true,8663285425,22,8585669533,-77615892
1638876897,-185653,true,8661553028,22,8567659444,-93893584
1638877247,-185653,true,8661553028,22,8569373062,-92179966
1638877661,-185655,true,8659820977,22,8571944131,-87876846
1638878110,-185654,true,8660686960,22,8574515971,-86170989
1638878238,-185657,true,8658089273,22,8575373423,-82715850
1638878357,-185657,true,8658089273,22,8574515971,-83573302
1638878695,-185658,true,8657223551,22,8580519934,-76703617
1638878696,-185658,true,8657223551,22,8580519934,-76703617
1638878883,-185661,true,8654626903,22,8574515971,-80110932
1638879043,-185663,true,8652896237,22,8551397159,-101499078
1638879624,-185670,true,8646841632,22,8473936299,-172905333
1638879996,-185670,true,8646841632,22,8459543564,-187298068
1638880890,-185673,true,8644248098,22,8464620559,-179627539
1638880998,-185676,true,8641655342,22,8464620559,-177034783
1638881599,-185685,true,8633881740,22,8465467021,-168414719
1638882009,-185690,true,8629566094,22,8466313568,-163252526
1638882197,-185694,true,8626115130,22,8467160199,-158954931
1638882523,-185697,true,8623527813,22,8468853716,-154674097
1638882681,-185704,true,8617493757,22,8468006915,-149486842
1638882990,-185706,true,8615770517,22,8469700602,-146069915
1638884382,-185708,true,8614047621,22,8466313568,-147734053
1638885914,-185710,true,8612325070,22,8463774182,-148550888
1638888474,-185716,true,8607159483,22,8494297151,-112862332
1638888839,-185718,true,8605438310,22,8493447806,-111990504
1638889010,-185720,true,8603717480,22,8491749372,-111968108
1638889028,-185721,true,8602857194,22,8491749372,-111107822
1638890395,-185724,true,8600276853,22,8567659444,-32617409
1638890440,-185726,true,8598557056,22,8566802764,-31754292
1638891584,-185726,true,8598557056,22,8565946170,-32610886
1638891704,-185727,true,8597697286,22,8565089661,-32607625
1638894151,-185729,true,8595978005,22,8559952405,-36025600
1638894600,-185729,true,8595978005,22,8565946170,-30031835
1638895275,-185730,true,8595118493,22,8572801325,-22317168
1638895467,-185731,true,8594259067,22,8562520647,-31738420
1638895536,-185732,true,8593399727,22,8559096495,-34303232
1638896174,-185734,true,8591681305,22,8523225465,-68455840
1638896857,-185735,true,8590822222,22,8525782689,-65039533
1638897320,-185736,true,8589963226,22,8524930196,-65033030
1638897396,-185737,true,8589104316,22,8524930196,-64174120
1638897707,-185738,true,8588245491,22,8524930196,-63315295
1638898609,-185740,true,8586528100,22,8524077788,-62450312
1638898744,-185741,true,8585669533,22,8523225465,-62444068
1638899048,-185742,true,8584811052,22,8521521076,-63289976
1638899165,-185744,true,8583094347,22,8519817027,-63277320
1638899333,-185746,true,8581377986,22,8518965131,-62412855
1638899647,-185747,true,8580519934,22,8518113320,-62406614
1638900263,-185745,true,8582236123,22,8607159483,24923360
1638900966,-185745,true,8582236123,22,8643383760,61147637
1638901234,-185746,true,8581377986,22,8638199544,56821558
1638901457,-185746,true,8581377986,22,8634745128,53367142
1638902035,-185745,true,8582236123,22,8627840439,45604316
1638902469,-185744,true,8583094347,22,8626115130,43020783
1638902667,-185745,true,8582236123,22,8626115130,43879007
1638902682,-185745,true,8582236123,22,8626115130,43879007
1638903462,-185744,true,8583094347,22,8595978005,12883658
1638903779,-185745,true,8582236123,22,8586528100,4291977
1638903978,-185747,true,8580519934,22,8583952656,3432722
1638904549,-185748,true,8579661967,22,8577946292,-1715675
1638904615,-185749,true,8578804087,22,8578804087,0
1638904660,-185751,true,8577088583,22,8572801325,-4287258
1638905531,-185755,true,8573658606,22,8507047520,-66611086
1638905737,-185757,true,8571944131,22,8508749014,-63195117
1638906400,-185757,true,8571944131,22,8509599889,-62344242
1638906504,-185760,true,8569373062,22,8511301894,-58071168
1638906803,-185764,true,8565946170,22,8513004240,-52941930
1638907301,-185766,true,8564233237,22,8517261593,-46971644
1638907331,-185766,true,8564233237,22,8515558397,-48674840
1638907511,-185767,true,8563376900,22,8518113320,-45263580
1638907523,-185770,true,8560808400,22,8519817027,-40991373
1638907784,-185770,true,8560808400,22,8539434177,-21374223
1638907800,-185770,true,8560808400,22,8540288120,-20520280
1638908105,-185771,true,8559952405,22,8561664481,1712076
1638908547,-185775,true,8556529280,22,8578804087,22274807
1638908716,-185775,true,8556529280,22,8577946292,21417012
1638909193,-185775,true,8556529280,22,8581377986,24848706
1638909368,-185776,true,8555673712,22,8582236123,26562411
1638909384,-185779,true,8553107524,22,8582236123,29128599
1638909533,-185779,true,8553107524,22,8584811052,31703528
1638909762,-185778,true,8553962834,22,8585669533,31706699
1638910539,-185779,true,8553107524,22,8573658606,20551082
1638910759,-185782,true,8550542104,22,8571944131,21402027
1638910952,-185782,true,8550542104,22,8571087022,20544918
1638911489,-185782,true,8550542104,22,8577946292,27404188
1638912257,-185782,true,8550542104,22,8578804087,28261983
1638915568,-185788,true,8545413574,22,8522373228,-23040346
1638916439,-185788,true,8545413574,22,8482414049,-62999525
1638917619,-185787,true,8546268116,22,8461235557,-85032559
1638917962,-185787,true,8546268116,22,8439266016,-107002100
1638918850,-185795,true,8539434177,22,8363657153,-175777024
1638919042,-185796,true,8538580319,22,8380400367,-158179952
1638919101,-185797,true,8537726546,22,8382076531,-155650015
1638919375,-185797,true,8537726546,22,8390462381,-147264165
1638919760,-185805,true,8530899437,22,8402216667,-128682770
1638920593,-185806,true,8530046433,22,8383753030,-146293403
1638920724,-185807,true,8529193513,22,8382914739,-146278774
1638920968,-185808,true,8528340679,22,8386268408,-142072271
1638921481,-185815,true,8522373228,22,8392140557,-130232671
1638921700,-185815,true,8522373228,22,8383753030,-138620198
1638922022,-185813,true,8524077788,22,8368676602,-155401186
1638922464,-185813,true,8524077788,22,8348616862,-175460926
1638922607,-185821,true,8517261593,22,8346947389,-170314204
1638923054,-185821,true,8517261593,22,8345278250,-171983343
1638923108,-185819,true,8518965131,22,8345278250,-173686881
1638923124,-185820,true,8518113320,22,8347782084,-170331236
1638923320,-185826,true,8513004240,22,8362820871,-150183369
1638923856,-185827,true,8512153025,22,8359476578,-152676447
1638924801,-185825,true,8513855540,22,8341106862,-172748678
1638924951,-185826,true,8513004240,22,8344443806,-168560434
1638925082,-185832,true,8507898225,22,8356133623,-151764602
1638925167,-185833,true,8507047520,22,8362820871,-144226649
1638925282,-185829,true,8510450849,22,8372861777,-137589072
1638925702,-185829,true,8510450849,22,8408940793,-101510056
1638926010,-185836,true,8504495916,22,8418195254,-86300662
1638926347,-185837,true,8503645551,22,8413987419,-89658132
1638926555,-185837,true,8503645551,22,8409781687,-93863864
1638926608,-185837,true,8503645551,22,8408940793,-94704758
1638927176,-185845,true,8496845695,22,8401376529,-95469166
1638927231,-185846,true,8495996096,22,8401376529,-94619567
1638927992,-185845,true,8496845695,22,8401376529,-95469166
1638928003,-185846,true,8495996096,22,8401376529,-94619567
1638928673,-185854,true,8489202356,22,8386268408,-102933948
1638929034,-185855,true,8488353521,22,8382076531,-106276990
1638929280,-185854,true,8489202356,22,8398016818,-91185538
1638929825,-185853,true,8490051277,22,8433360892,-56690385
1638930128,-185859,true,8484959028,22,8440953954,-44005074
1638930242,-185860,true,8484110617,22,8440953954,-43156663
1638930619,-185859,true,8484959028,22,8438422174,-46536854
1638930714,-185858,true,8485807524,22,8437578416,-48229108
1638930850,-185864,true,8480717821,22,8435891154,-44826667
1638930864,-185864,true,8480717821,22,8435047649,-45670172
1638930876,-185864,true,8480717821,22,8435047649,-45670172
1638931193,-185862,true,8482414049,22,8445175275,-37238774
1638931874,-185867,true,8478174115,22,8451933780,-26240335
1638933032,-185868,true,8477326382,22,8467160199,-10166183
1638933270,-185871,true,8474783693,22,8465467021,-9316672
1638933517,-185870,true,8475631171,22,8458697694,-16933477
1638933695,-185876,true,8470547572,22,8452778974,-17768598
1638933732,-185878,true,8468853716,22,8451933780,-16919936
1638934552,-185881,true,8466313568,22,8438422174,-27891394
1638935113,-185880,true,8467160199,22,8429988391,-37171808
1638935159,-185886,true,8462081681,22,8430831390,-31250291
1638935359,-185888,true,8460389518,22,8436734743,-23654775
1638935724,-185890,true,8458697694,22,8448553852,-10143842
1638935988,-185887,true,8461235557,22,8456160592,-5074965
1638936487,-185893,true,8456160592,22,8450243647,-5916945
1638937059,-185895,true,8454469614,22,8449398707,-5070907
1638937733,-185897,true,8452778974,22,8448553852,-4225122
1638938564,-185894,true,8455315061,22,8448553852,-6761209
1638938749,-185898,true,8451933780,22,8447709081,-4224699
1638938939,-185898,true,8451933780,22,8457006209,5072429
1638939008,-185899,true,8451088671,22,8460389518,9300847
1638939156,-185895,true,8454469614,22,8473936299,19466685
1638939767,-185898,true,8451933780,22,8523225465,71291685
1638939775,-185897,true,8452778974,22,8524077788,71298814
1638940176,-185899,true,8451088671,22,8523225465,72136794
1638940469,-185895,true,8454469614,22,8528340679,73871065
1638941603,-185897,true,8452778974,22,8548832252,96053278
1638941633,-185898,true,8451933780,22,8547977455,96043675
1638942143,-185900,true,8450243647,22,8534312309,84068662
1638942446,-185897,true,8452778974,22,8525782689,73003715
1638942894,-185900,true,8450243647,22,8522373228,72129581
1638943097,-185901,true,8449398707,22,8522373228,72974521
1638943256,-185903,true,8447709081,22,8521521076,73811995
1638943610,-185900,true,8450243647,22,8518113320,67869673
1638943822,-185903,true,8447709081,22,8516409952,68700871
1638943901,-185905,true,8446019792,22,8515558397,69538605
1638943976,-185907,true,8444330842,22,8514706926,70376084
1638944847,-185904,true,8446864394,22,8506196900,59332506
1638945114,-185907,true,8444330842,22,8506196900,61866058
1638945642,-185909,true,8442642229,22,8507898225,65255996
1638945663,-185911,true,8440953954,22,8507047520,66093566
1638946286,-185908,true,8443486493,22,8499395004,55908511
1638946300,-185909,true,8442642229,22,8501094968,58452739
1638946303,-185910,true,8441798049,22,8501094968,59296919
1638946923,-185911,true,8440953954,22,8507047520,66093566
1638947562,-185909,true,8442642229,22,8469700602,27058373
1638947764,-185906,true,8445175275,22,8462927889,17752614
1638947821,-185907,true,8444330842,22,8457851909,13521067
1638947930,-185907,true,8444330842,22,8454469614,10138772
1638948065,-185906,true,8445175275,22,8441798049,-3377226
1638948120,-185907,true,8444330842,22,8436734743,-7596099
1638948130,-185907,true,8444330842,22,8435891154,-8439688
1638948743,-185907,true,8444330842,22,8390462381,-53868461
1638948778,-185906,true,8445175275,22,8389623418,-55551857
1638948803,-185906,true,8445175275,22,8387945745,-57229530
1638948826,-185906,true,8445175275,22,8387107035,-58068240
1638948839,-185907,true,8444330842,22,8387107035,-57223807
1638948978,-185904,true,8446864394,22,8391301427,-55562967
1638949120,-185904,true,8446864394,22,8392140557,-54723837
1638949277,-185904,true,8446864394,22,8392140557,-54723837
1638950659,-185902,true,8448553852,22,8442642229,-5911623
1638950929,-185899,true,8451088671,22,8441798049,-9290622
1638953131,-185900,true,8450243647,22,8440953954,-9289693
1638956220,-185900,true,8450243647,22,8430831390,-19412257
1638956605,-185897,true,8452778974,22,8430831390,-21947584
1638956977,-185895,true,8454469614,22,8427459900,-27009714
1638957080,-185896,true,8453624252,22,8431674473,-21949779
1638957205,-185895,true,8454469614,22,8435891154,-18578460
1638957865,-185895,true,8454469614,22,8460389518,5919904
1638957882,-185893,true,8456160592,22,8460389518,4228926
1638959532,-185893,true,8456160592,22,8480717821,24557229
1638960297,-185892,true,8457006209,22,8479021932,22015723
1638960390,-185891,true,8457851909,22,8475631171,17779262
1638960522,-185889,true,8459543564,22,8470547572,11004008
1638961552,-185891,true,8457851909,22,8383753030,-74098879
1638961813,-185893,true,8456160592,22,8382914739,-73245853
1638962327,-185892,true,8457006209,22,8367003117,-90003092
1638962982,-185890,true,8458697694,22,8413987419,-44710275
1638962986,-185891,true,8457851909,22,8413987419,-43864490
1638963867,-185893,true,8456160592,22,8377886750,-78273842
1638964087,-185892,true,8457006209,22,8388784540,-68221669
1638964253,-185891,true,8457851909,22,8392979771,-64872138
1638964279,-185893,true,8456160592,22,8393819069,-62341523
1638964823,-185894,true,8455315061,22,8407259257,-48055804
1638964922,-185894,true,8455315061,22,8404737584,-50577477
1638966315,-185892,true,8457006209,22,8407259257,-49746952
1638966316,-185895,true,8454469614,22,8407259257,-47210357
1638966597,-185895,true,8454469614,22,8427459900,-27009714
1638967231,-185893,true,8456160592,22,8472241766,16081174
1638967901,-185891,true,8457851909,22,8469700602,11848693
1638967986,-185894,true,8455315061,22,8470547572,15232511
1638968021,-185895,true,8454469614,22,8470547572,16077958
1638968575,-185893,true,8456160592,22,8472241766,16081174
1638968598,-185891,true,8457851909,22,8472241766,14389857
1638969834,-185893,true,8456160592,22,8469700602,13540010
1638970403,-185894,true,8455315061,22,8442642229,-12672832
1638970831,-185892,true,8457006209,22,8434204228,-22801981
1638970921,-185889,true,8459543564,22,8441798049,-17745515
1638971144,-185892,true,8457006209,22,8461235557,4229348
1638971155,-185892,true,8457006209,22,8462081681,5075472
1638971697,-185889,true,8459543564,22,8501094968,41551404
1638972470,-185887,true,8461235557,22,8503645551,42409994
1638973558,-185891,true,8457851909,22,8448553852,-9298057
1638974138,-185892,true,8457006209,22,8422405194,-34601015
1638975123,-185889,true,8459543564,22,8414828818,-44714746
1638975346,-185888,true,8460389518,22,8413987419,-46402099
1638976546,-185893,true,8456160592,22,8412304874,-43855718
1638977054,-185894,true,8455315061,22,8411463727,-43851334
1638977210,-185892,true,8457006209,22,8410622665,-46383544
1638977462,-185892,true,8457006209,22,8409781687,-47224522
1638977971,-185899,true,8451088671,22,8407259257,-43829414
1638978679,-185900,true,8450243647,22,8420720965,-29522682
1638978741,-185897,true,8452778974,22,8421563037,-31215937
1638978776,-185898,true,8451933780,22,8422405194,-29528586
1638979546,-185905,true,8446019792,22,8420720965,-25298827
1638979687,-185906,true,8445175275,22,8419878977,-25296298
1638979901,-185904,true,8446864394,22,8419037074,-27827320
1638980254,-185905,true,8446019792,22,8417353519,-28666273
1638980891,-185911,true,8440953954,22,8409781687,-31172267
1638981392,-185913,true,8439266016,22,8393819069,-45446947
1638982139,-185911,true,8440953954,22,8392140557,-48813397
1638982201,-185911,true,8440953954,22,8392979771,-47974183
1638982308,-185918,true,8435047649,22,8394658451,-40389198
1638982878,-185919,true,8434204228,22,8395497917,-38706311
1638984743,-185917,true,8435891154,22,8394658451,-41232703
1638985772,-185917,true,8435891154,22,8393819069,-42072085
1638986517,-185924,true,8429988391,22,8376211424,-53776967
1638986979,-185926,true,8428302646,22,8372861777,-55440869
1638987305,-185923,true,8430831390,22,8388784540,-42046850
1638987394,-185924,true,8429988391,22,8393819069,-36169322
1638987643,-185930,true,8424932168,22,8405578057,-19354111
1638989940,-185932,true,8423247434,22,8376211424,-47036010
1638990246,-185930,true,8424932168,22,8380400367,-44531801
1638991001,-185929,true,8425774661,22,8393819069,-31955592
1638991411,-185935,true,8420720965,22,8393819069,-26901896
1638991689,-185936,true,8419878977,22,8393819069,-26059908
1638991778,-185933,true,8422405194,22,8393819069,-28586125
1638991886,-185931,true,8424089759,22,8393819069,-30270690
1638992199,-185935,true,8420720965,22,8395497917,-25223048
1638992308,-185936,true,8419878977,22,8396337467,-23541510
1638992895,-185933,true,8422405194,22,8402216667,-20188527
1638993648,-185931,true,8424089759,22,8402216667,-21873092
1638993879,-185934,true,8421563037,22,8402216667,-19346370
1638993941,-185935,true,8420720965,22,8402216667,-18504298
1638994214,-185932,true,8423247434,22,8402216667,-21030767
1638994798,-185930,true,8424932168,22,8400536475,-24395693
1638994922,-185934,true,8421563037,22,8399696506,-21866531
1638994952,-185935,true,8420720965,22,8395497917,-25223048
1638995857,-185935,true,8420720965,22,8359476578,-61244387
1638996390,-185934,true,8421563037,22,8357804934,-63758103
1638996957,-185939,true,8417353519,22,8345278250,-72075269
1638997445,-185940,true,8416511868,22,8335270422,-81241446
1638997555,-185940,true,8416511868,22,8334436979,-82074889
1638997622,-185940,true,8416511868,22,8333603618,-82908250
1638997834,-185944,true,8413146104,22,8332770341,-80375763
1638997999,-185945,true,8412304874,22,8336937560,-75367314
1638998112,-185946,true,8411463727,22,8339438891,-72024836
1638998452,-185945,true,8412304874,22,8357804934,-54499940
1638998757,-185949,true,8408940793,22,8372024574,-36916219
1638999289,-185950,true,8408099983,22,8376211424,-31888559
1638999630,-185951,true,8407259257,22,8368676602,-38582655
1638999789,-185951,true,8407259257,22,8361148557,-46110700
1639001357,-185954,true,8404737584,22,8325274596,-79462988
1639001424,-185954,true,8404737584,22,8324442152,-80295432
1639001695,-185954,true,8404737584,22,8324442152,-80295432
1639002195,-185954,true,8404737584,22,8351121698,-53615886
1639002410,-185956,true,8403056888,22,8361984672,-41072216
1639003116,-185955,true,8403897194,22,8367003117,-36894077
1639003441,-185956,true,8403056888,22,8360312526,-42744362
1639003721,-185956,true,8403056888,22,8354462647,-48594241
1639004161,-185958,true,8401376529,22,8347782084,-53594445
1639004302,-185959,true,8400536475,22,8346947389,-53589086
1639004577,-185959,true,8400536475,22,8344443806,-56092669
1639006689,-185960,true,8399696506,22,8317785594,-81910912
1639006804,-185963,true,8397177100,22,8320281179,-76895921
1639007360,-185964,true,8396337467,22,8337771254,-58566213
1639007610,-185965,true,8395497917,22,8345278250,-50219667
1639007654,-185967,true,8393819069,22,8344443806,-49375263
1639007822,-185969,true,8392140557,22,8344443806,-47696751
1639011348,-185972,true,8389623418,22,8304488443,-85134975
1639011977,-185974,true,8387945745,22,8310303329,-77642416
1639012350,-185976,true,8386268408,22,8315290758,-70977650
1639012811,-185978,true,8384591406,22,8319449235,-65142171
1639013179,-185980,true,8382914739,22,8319449235,-63465504
1639014345,-185981,true,8382076531,22,8326107124,-55969407
1639014848,-185983,true,8380400367,22,8322777513,-57622854
1639015049,-185985,true,8378724539,22,8319449235,-59275304
1639015318,-185988,true,8376211424,22,8312796669,-63414755
1639015920,-185992,true,8372861777,22,8304488443,-68373334
1639015981,-185994,true,8371187456,22,8304488443,-66699013
1639016194,-185995,true,8370350421,22,8301997594,-68352827
1639016296,-185997,true,8368676602,22,8300337444,-68339158
1639016709,-186000,true,8366166501,22,8295358984,-70807517
1639017039,-186001,true,8365329968,22,8292870874,-72459094
1639017214,-186001,true,8365329968,22,8295358984,-69970984
1639017228,-186003,true,8363657153,22,8296188520,-67468633
1639017318,-186006,true,8361148557,22,8297847841,-63300716
1639018262,-186006,true,8361148557,22,8310303329,-50845228
1639018709,-186007,true,8360312526,22,8307810736,-52501790
1639018753,-186009,true,8358640714,22,8306980038,-51660676
1639019252,-186012,true,8356133623,22,8306149423,-49984200
1639019795,-186013,true,8355298094,22,8302827794,-52470300
1639020038,-186013,true,8355298094,22,8304488443,-50809651
1639020177,-186015,true,8353627285,22,8310303329,-43323956
1639020226,-186018,true,8351121698,22,8311965473,-39156225
1639021020,-186018,true,8351121698,22,8325274596,-25847102
1639021257,-186018,true,8351121698,22,8321945319,-29176379
1639021507,-186020,true,8349451724,22,8319449235,-30002489
1639021621,-186022,true,8347782084,22,8318617373,-29164711
1639021814,-186022,true,8347782084,22,8316953899,-30828185
1639022816,-186022,true,8347782084,22,8308641517,-39140567
1639023072,-186024,true,8346112778,22,8311965473,-34147305
1639023708,-186026,true,8344443806,22,8318617373,-25826433
1639023813,-186026,true,8344443806,22,8325274596,-19169210
1639024231,-186025,true,8345278250,22,8341106862,-4171388
1639024651,-186027,true,8343609445,22,8356133623,12524178
1639024694,-186028,true,8342775167,22,8354462647,11687480
1639025192,-186028,true,8342775167,22,8354462647,11687480
1639025788,-186028,true,8342775167,22,8351121698,8346531
1639026082,-186029,true,8341940973,22,8350286669,8345696
1639026743,-186030,true,8341106862,22,8346112778,5005916
1639026812,-186030,true,8341106862,22,8345278250,4171388
1639026825,-186030,true,8341106862,22,8345278250,4171388
1639026888,-186031,true,8340272835,22,8348616862,8344027
1639026931,-186031,true,8340272835,22,8350286669,10013834
1639026969,-186030,true,8341106862,22,8351956810,10849948
1639027191,-186030,true,8341106862,22,8361148557,20041695
1639027624,-186032,true,8339438891,22,8377886750,38447859
1639027837,-186032,true,8339438891,22,8377049045,37610154
1639027900,-186032,true,8339438891,22,8375373887,35934996
1639028056,-186032,true,8339438891,22,8370350421,30911530
1639028491,-186034,true,8337771254,22,8357804934,20033680
1639028630,-186035,true,8336937560,22,8355298094,18360534
1639028867,-186034,true,8337771254,22,8352792005,15020751
1639029774,-186035,true,8336937560,22,8350286669,13349109
1639030109,-186037,true,8335270422,22,8348616862,13346440
1639030685,-186036,true,8336103949,22,8345278250,9174301
1639031804,-186035,true,8336937560,22,8343609445,6671885
1639032129,-186035,true,8336937560,22,8342775167,5837607
1639033814,-186037,true,8335270422,22,8339438891,4168469
1639034013,-186036,true,8336103949,22,8337771254,1667305
1639034277,-186034,true,8337771254,22,8353627285,15856031
1639034756,-186034,true,8337771254,22,8374536433,36765179
1639034985,-186036,true,8336103949,22,8379562411,43458462
1639037935,-186035,true,8336937560,22,8367839818,30902258
1639037952,-186034,true,8337771254,22,8369513469,31742215
1639039041,-186033,true,8338605031,22,8431674473,93069442
1639039615,-186035,true,8336937560,22,8432517641,95580081
1639039798,-186032,true,8339438891,22,8432517641,93078750
1639040928,-186030,true,8341106862,22,8424932168,83825306
1639042535,-186029,true,8341940973,22,8422405194,80464221
1639042858,-186030,true,8341106862,22,8420720965,79614103
1639042883,-186026,true,8344443806,22,8420720965,76277159
1639042944,-186026,true,8344443806,22,8424932168,80488362
1639043054,-186024,true,8346112778,22,8431674473,85561695
1639043103,-186024,true,8346112778,22,8434204228,88091450
1639043718,-186021,true,8348616862,22,8456160592,107543730
1639043928,-186021,true,8348616862,22,8450243647,101626785
1639043955,-186019,true,8350286669,22,8447709081,97422412
1639044005,-186018,true,8351121698,22,8446864394,95742696
1639044179,-186016,true,8352792005,22,8447709081,94917076
1639044422,-186014,true,8354462647,22,8446019792,91557145
1639044810,-186013,true,8355298094,22,8435047649,79749555
1639045080,-186012,true,8356133623,22,8452778974,96645351
1639045298,-186009,true,8358640714,22,8466313568,107672854
1639045469,-186007,true,8360312526,22,8479021932,118709406
1639048126,-186005,true,8361984672,22,8486656105,124671433
1639048860,-186002,true,8364493518,22,8484959028,120465510
1639049483,-185999,true,8367003117,22,8479021932,112018815
1639049698,-185998,true,8367839818,22,8477326382,109486564
1639049876,-185996,true,8369513469,22,8492598547,123085078
1639049981,-185992,true,8372861777,22,8501945077,129083300
1639050568,-185987,true,8377049045,22,8553962834,176913789
1639052329,-185985,true,8378724539,22,8554818231,176093692
1639052938,-185983,true,8380400367,22,8552252298,171851931
1639053905,-185980,true,8382914739,22,8543704748,160790009
1639053944,-185974,true,8387945745,22,8543704748,155759003
1639053958,-185972,true,8389623418,22,8543704748,154081330
1639055033,-185971,true,8390462381,22,8529193513,138731132
1639056283,-185967,true,8393819069,22,8541996263,148177194
1639056475,-185961,true,8398856620,22,8541142149,142285529
1639056553,-185959,true,8400536475,22,8541142149,140605674
1639057606,-185957,true,8402216667,22,8535165740,132949073
1639058424,-185954,true,8404737584,22,8533458963,128721379
1639058565,-185949,true,8408940793,22,8530046433,121105640
1639059140,-185946,true,8411463727,22,8567659444,156195717
1639060318,-185943,true,8413987419,22,8589963226,175975807
1639060363,-185939,true,8417353519,22,8587386753,170033234
1639060592,-185934,true,8421563037,22,8574515971,152952934
1639060658,-185932,true,8423247434,22,8569373062,146125628
1639060868,-185932,true,8423247434,22,8550542104,127294670
1639061653,-185928,true,8426617239,22,8524930196,98312957
1639061669,-185922,true,8431674473,22,8525782689,94108216
1639062442,-185921,true,8432517641,22,8524930196,92412555
1639062753,-185921,true,8432517641,22,8520669009,88151368
1639063544,-185917,true,8435891154,22,8513004240,77113086
1639063616,-185912,true,8440109943,22,8512153025,72043082
1639064734,-185910,true,8441798049,22,8508749014,66950965
1639065430,-185910,true,8441798049,22,8524077788,82279739
1639065464,-185906,true,8445175275,22,8524930196,79754921
1639065579,-185901,true,8449398707,22,8528340679,78941972
1639065882,-185899,true,8451088671,22,8530046433,78957762
1639066226,-185900,true,8450243647,22,8521521076,71277429
1639066385,-185896,true,8453624252,22,8514706926,61082674
1639066665,-185893,true,8456160592,22,8501094968,44934376
1639066825,-185891,true,8457851909,22,8493447806,35595897
1639066917,-185892,true,8457006209,22,8490900282,33894073
1639067283,-185888,true,8460389518,22,8511301894,50912376
1639067348,-185883,true,8464620559,22,8515558397,50937838
1639067976,-185881,true,8466313568,22,8547977455,81663887
1639068296,-185882,true,8465467021,22,8546268116,80801095
1639068606,-185877,true,8469700602,22,8544559118,74858516
1639069084,-185874,true,8472241766,22,8538580319,66338553
1639069657,-185872,true,8473936299,22,8540288120,66351821
1639069742,-185873,true,8473088990,22,8541142149,68053159
1639070633,-185869,true,8476478734,22,8527487931,51009197
1639070662,-185866,true,8479021932,22,8526635267,47613335
1639070942,-185865,true,8479869834,22,8519817027,39947193
1639071188,-185865,true,8479869834,22,8513855540,33985706
1639071401,-185861,true,8483262291,22,8509599889,26337598
1639071504,-185858,true,8485807524,22,8505346366,19538842
1639071528,-185856,true,8487504770,22,8506196900,18692130
1639071689,-185856,true,8487504770,22,8512153025,24648255
1639072173,-185851,true,8491749372,22,8530899437,39150065
1639072268,-185847,true,8495146581,22,8532605703,37459122
1639072707,-185846,true,8495996096,22,8536019257,40023161
1639073420,-185847,true,8495146581,22,8508749014,13602433
1639073602,-185841,true,8500244943,22,8514706926,14461983
1639074926,-185837,true,8503645551,22,8555673712,52028161
1639074984,-185835,true,8505346366,22,8554818231,49471865
1639075339,-185836,true,8504495916,22,8552252298,47756382
1639076952,-185832,true,8507898225,22,8544559118,36660893
1639077289,-185828,true,8511301894,22,8528340679,17038785
1639077666,-185827,true,8512153025,22,8509599889,-2553136
1639078177,-185828,true,8511301894,22,8494297151,-17004743
1639079035,-185827,true,8512153025,22,8471394626,-40758399
1639079153,-185825,true,8513855540,22,8471394626,-42460914
1639079290,-185824,true,8514706926,22,8473088990,-41617936
1639079870,-185826,true,8513004240,22,8477326382,-35677858
1639080416,-185824,true,8514706926,22,8464620559,-50086367
1639080671,-185823,true,8515558397,22,8444330842,-71227555
1639081496,-185823,true,8515558397,22,8407259257,-108299140
1639081586,-185826,true,8513004240,22,8407259257,-105744983
1639081714,-185828,true,8511301894,22,8404737584,-106564310
1639081801,-185826,true,8513004240,22,8404737584,-108266656
1639082201,-185826,true,8513004240,22,8399696506,-113307734
1639082656,-185829,true,8510450849,22,8390462381,-119988468
1639083132,-185831,true,8508749014,22,8386268408,-122480606
1639083224,-185829,true,8510450849,22,8387107035,-123343814
1639083515,-185830,true,8509599889,22,8382076531,-127523358
1639084094,-185833,true,8507047520,22,8374536433,-132511087
1639084400,-185834,true,8506196900,22,8387945745,-118251155
1639084592,-185833,true,8507047520,22,8395497917,-111549603
1639085461,-185833,true,8507047520,22,8411463727,-95583793
1639085627,-185837,true,8503645551,22,8411463727,-92181824
1639085912,-185839,true,8501945077,22,8410622665,-91322412
1639086204,-185837,true,8503645551,22,8408940793,-94704758
1639086466,-185838,true,8502795272,22,8407259257,-95536015
1639086632,-185841,true,8500244943,22,8406418615,-93826328
1639087567,-185845,true,8496845695,22,8341940973,-154904722
1639087984,-185847,true,8495146581,22,8344443806,-150702775
1639088015,-185849,true,8493447806,22,8344443806,-149004000
1639088236,-185852,true,8490900282,22,8346112778,-144787504
1639088349,-185856,true,8487504770,22,8346112778,-141391992
1639088640,-185856,true,8487504770,22,8366166501,-121338269
1639088772,-185858,true,8485807524,22,8375373887,-110433637
1639088834,-185860,true,8484110617,22,8378724539,-105386078
1639089112,-185863,true,8481565893,22,8398856620,-82709273
1639090819,-185863,true,8481565893,22,8412304874,-69261019
1639091343,-185864,true,8480717821,22,8413146104,-67571717
1639091965,-185867,true,8478174115,22,8412304874,-65869241
1639092119,-185870,true,8475631171,22,8411463727,-64167444
1639092143,-185869,true,8476478734,22,8411463727,-65015007
1639092286,-185871,true,8474783693,22,8410622665,-64161028
1639092304,-185875,true,8471394626,22,8409781687,-61612939
1639093008,-185880,true,8467160199,22,8400536475,-66623724
1639093039,-185879,true,8468006915,22,8399696506,-68310409
1639093090,-185881,true,8466313568,22,8398856620,-67456948
1639093738,-185883,true,8464620559,22,8389623418,-74997141
1639093916,-185887,true,8461235557,22,8387107035,-74128522
1639094182,-185886,true,8462081681,22,8385429865,-76651816
1639094211,-185888,true,8460389518,22,8385429865,-74959653
1639094262,-185890,true,8458697694,22,8381238407,-77459287
1639094518,-185894,true,8455315061,22,8382914739,-72400322
1639094821,-185894,true,8455315061,22,8384591406,-70723655
1639095316,-185895,true,8454469614,22,8391301427,-63168187
1639095334,-185897,true,8452778974,22,8388784540,-63994434
1639095344,-185901,true,8449398707,22,8388784540,-60614167
1639095410,-185900,true,8450243647,22,8389623418,-60620229
1639096742,-185902,true,8448553852,22,8403897194,-44656658
1639096932,-185903,true,8447709081,22,8402216667,-45492414
1639097031,-185907,true,8444330842,22,8402216667,-42114175
1639097315,-185906,true,8445175275,22,8398856620,-46318655
1639097729,-185907,true,8444330842,22,8394658451,-49672391
1639097743,-185908,true,8443486493,22,8393819069,-49667424
1639098338,-185912,true,8440109943,22,8432517641,-7592302
1639098462,-185911,true,8440953954,22,8440953954,0
1639098738,-185912,true,8440109943,22,8451088671,10978728
1639099041,-185914,true,8438422174,22,8448553852,10131678
1639100867,-185918,true,8435047649,22,8442642229,7594580
1639100907,-185916,true,8436734743,22,8441798049,5063306
1639101429,-185918,true,8435047649,22,8435891154,843505
1639101493,-185919,true,8434204228,22,8435891154,1686926
1639101618,-185923,true,8430831390,22,8433360892,2529502
1639101680,-185922,true,8431674473,22,8432517641,843168
1639102006,-185923,true,8430831390,22,8425774661,-5056729
1639102289,-185925,true,8429145477,22,8417353519,-11791958
1639102622,-185928,true,8426617239,22,8408940793,-17676446
1639102739,-185927,true,8427459900,22,8406418615,-21041285
1639103427,-185929,true,8425774661,22,8397177100,-28597561
1639105800,-185931,true,8424089759,22,8394658451,-29431308
1639106229,-185936,true,8419878977,22,8380400367,-39478610
1639106769,-185935,true,8420720965,22,8372024574,-48696391
1639107187,-185937,true,8419037074,22,8378724539,-40312535
1639108808,-185939,true,8417353519,22,8392140557,-25212962
1639109691,-185943,true,8413987419,22,8391301427,-22685992
1639110048,-185943,true,8413987419,22,8387945745,-26041674
1639110216,-185944,true,8413146104,22,8403897194,-9248910
1639110326,-185947,true,8410622665,22,8413146104,2523439
1639110494,-185949,true,8408940793,22,8427459900,18519107
1639110689,-185948,true,8409781687,22,8428302646,18520959
1639110767,-185950,true,8408099983,22,8424089759,15989776
1639111173,-185952,true,8406418615,22,8422405194,15986579
1639111196,-185954,true,8404737584,22,8421563037,16825453
1639111210,-185952,true,8406418615,22,8420720965,14302350
1639111242,-185953,true,8405578057,22,8416511868,10933811
1639111652,-185958,true,8401376529,22,8391301427,-10075102
1639111844,-185959,true,8400536475,22,8382076531,-18459944
1639111892,-185957,true,8402216667,22,8378724539,-23492128
1639112109,-185957,true,8402216667,22,8365329968,-36886699
1639112710,-185961,true,8398856620,22,8372861777,-25994843
1639113968,-185960,true,8399696506,22,8406418615,6722109
1639114033,-185957,true,8402216667,22,8406418615,4201948
1639115114,-185957,true,8402216667,22,8409781687,7565020
1639115128,-185960,true,8399696506,22,8408940793,9244287
1639115497,-185958,true,8401376529,22,8433360892,31984363
1639116594,-185955,true,8403897194,22,8465467021,61569827
1639116624,-185953,true,8405578057,22,8464620559,59042502
1639117537,-185956,true,8403056888,22,8435891154,32834266
1639117636,-185955,true,8403897194,22,8435047649,31150455
1639119347,-185952,true,8406418615,22,8429988391,23569776
1639119379,-185951,true,8407259257,22,8431674473,24415216
1639119573,-185955,true,8403897194,22,8443486493,39589299
1639120284,-185953,true,8405578057,22,8484959028,79380971
1639120927,-185948,true,8409781687,22,8482414049,72632362
1639122785,-185947,true,8410622665,22,8479021932,68399267
1639122879,-185951,true,8407259257,22,8479021932,71762675
1639123186,-185947,true,8410622665,22,8478174115,67551450
1639123195,-185942,true,8414828818,22,8478174115,63345297
1639123347,-185940,true,8416511868,22,8478174115,61662247
1639123364,-185944,true,8413146104,22,8477326382,64180278
1639123787,-185938,true,8418195254,22,8492598547,74403293
1639123984,-185935,true,8420720965,22,8500244943,79523978
1639125249,-185933,true,8422405194,22,8501094968,78689774
1639125467,-185938,true,8418195254,22,8500244943,82049689
1639126823,-185934,true,8421563037,22,8495996096,74433059
1639126869,-185930,true,8424932168,22,8495146581,70214413
1639127370,-185930,true,8424932168,22,8471394626,46462458
1639127518,-185934,true,8421563037,22,8462927889,41364852
1639129326,-185932,true,8423247434,22,8442642229,19394795
1639129776,-185928,true,8426617239,22,8441798049,15180810
1639129807,-185928,true,8426617239,22,8441798049,15180810
1639132021,-185932,true,8423247434,22,8441798049,18550615
1639133590,-185930,true,8424932168,22,8425774661,842493
1639133648,-185927,true,8427459900,22,8423247434,-4212466
1639133689,-185926,true,8428302646,22,8424932168,-3370478
1639133858,-185930,true,8424932168,22,8432517641,7585473
1639134194,-185926,true,8428302646,22,8443486493,15183847
1639135150,-185923,true,8430831390,22,8457851909,27020519
1639135518,-185922,true,8431674473,22,8458697694,27023221
1639135786,-185926,true,8428302646,22,8458697694,30395048
1639136365,-185922,true,8431674473,22,8452778974,21104501
1639136671,-185918,true,8435047649,22,8472241766,37194117
1639137024,-185917,true,8435891154,22,8495996096,60104942
1639137500,-185921,true,8432517641,22,8492598547,60080906
1639138055,-185918,true,8435047649,22,8453624252,18576603
1639138243,-185914,true,8438422174,22,8446864394,8442220
1639138414,-185914,true,8438422174,22,8440953954,2531780
1639139546,-185919,true,8434204228,22,8456160592,21956364
1639139684,-185915,true,8437578416,22,8456160592,18582176
1639139889,-185911,true,8440953954,22,8457006209,16052255
1639140101,-185911,true,8440953954,22,8451088671,10134717
1639141500,-185916,true,8436734743,22,8436734743,0
1639141542,-185914,true,8438422174,22,8435047649,-3374525
1639141798,-185911,true,8440953954,22,8439266016,-1687938
1639142337,-185912,true,8440109943,22,8445175275,5065332
1639142402,-185916,true,8436734743,22,8450243647,13508904
1639143655,-185912,true,8440109943,22,8506196900,66086957
1639143755,-185908,true,8443486493,22,8505346366,61859873
1639143857,-185908,true,8443486493,22,8505346366,61859873
1639145148,-185913,true,8439266016,22,8502795272,63529256
1639145192,-185908,true,8443486493,22,8501945077,58458584
1639145470,-185905,true,8446019792,22,8502795272,56775480
1639145680,-185904,true,8446864394,22,8504495916,57631522
1639145911,-185908,true,8443486493,22,8505346366,61859873
1639145982,-185903,true,8447709081,22,8504495916,56786835
1639146405,-185898,true,8451933780,22,8532605703,80671923
1639146954,-185897,true,8452778974,22,8521521076,68742102
1639147559,-185902,true,8448553852,22,8493447806,44893954
1639147563,-185896,true,8453624252,22,8494297151,40672899
1639150209,-185889,true,8459543564,22,8594259067,134715503
1639151383,-185887,true,8461235557,22,8589104316,127868759
1639151457,-185890,true,8458697694,22,8588245491,129547797
1639151471,-185885,true,8462927889,22,8587386753,124458864
1639151701,-185878,true,8468853716,22,8583094347,114240631
1639151710,-185878,true,8468853716,22,8583094347,114240631
1639151793,-185881,true,8466313568,22,8587386753,121073185
1639151825,-185877,true,8469700602,22,8587386753,117686151
1639152243,-185870,true,8475631171,22,8592540473,116909302
1639152434,-185868,true,8477326382,22,8595118493,117792111
1639152520,-185871,true,8474783693,22,8595978005,121194312
1639152978,-185867,true,8478174115,22,8586528100,108353985
1639153268,-185861,true,8483262291,22,8581377986,98115695
1639153324,-185860,true,8484110617,22,8578804087,94693470
1639154139,-185859,true,8484959028,22,8585669533,100710505
1639154468,-185855,true,8488353521,22,8588245491,99891970
1639155346,-185849,true,8493447806,22,8582236123,88788317
1639155916,-185848,true,8494297151,22,8588245491,93948340
1639156097,-185848,true,8494297151,22,8589963226,95666075
1639156117,-185845,true,8496845695,22,8592540473,95694778
1639157021,-185835,true,8505346366,22,8693658528,188312162
1639158502,-185833,true,8507047520,22,8692789249,185741729
1639158538,-185833,true,8507047520,22,8691920057,184872537
1639158581,-185831,true,8508749014,22,8691050952,182301938
1639158583,-185822,true,8516409952,22,8691050952,174641000
1639158828,-185822,true,8516409952,22,8681496529,165086577
1639158886,-185821,true,8517261593,22,8682364679,165103086
1639159041,-185820,true,8518113320,22,8674554456,156441136
1639159181,-185810,true,8526635267,22,8666751259,140115992
1639159854,-185811,true,8525782689,22,8640791263,115008574
1639159876,-185811,true,8525782689,22,8640791263,115008574
1639160117,-185809,true,8527487931,22,8639063364,111575433
1639160128,-185802,true,8533458963,22,8639063364,105604401
1639160277,-185803,true,8532605703,22,8637335811,104730108
1639160299,-185802,true,8533458963,22,8639063364,105604401
1639160758,-185799,true,8536019257,22,8665018169,128998912
1639160867,-185791,true,8542850463,22,8671085502,128235039
1639160941,-185792,true,8541996263,22,8674554456,132558193
1639161280,-185791,true,8542850463,22,8684969649,142119186
1639161557,-185789,true,8544559118,22,8681496529,136937411
1639161624,-185782,true,8550542104,22,8680628466,130086362
1639161718,-185782,true,8550542104,22,8678024799,127482695
1639161849,-185782,true,8550542104,22,8676289454,125747350
1639162144,-185780,true,8552252298,22,8671952610,119700312
1639162208,-185773,true,8558240671,22,8671085502,112844831
1639162452,-185773,true,8558240671,22,8665884671,107644000
1639162792,-185773,true,8558240671,22,8660686960,102446289
1639163114,-185769,true,8561664481,22,8659820977,98156496
1639163859,-185761,true,8568516210,22,8662419184,93902974
1639164424,-185761,true,8568516210,22,8662419184,93902974
1639164791,-185761,true,8568516210,22,8661553028,93036818
1639165129,-185757,true,8571944131,22,8658089273,86145142
1639165162,-185750,true,8577946292,22,8658089273,80142981
1639165678,-185750,true,8577946292,22,8652896237,74949945
1639165892,-185749,true,8578804087,22,8651165917,72361830
1639166486,-185747,true,8580519934,22,8647706316,67186382
1639167210,-185740,true,8586528100,22,8639927270,53399170
1639167517,-185740,true,8586528100,22,8640791263,54263163
1639168546,-185737,true,8589104316,22,8731992983,142888667
1639168611,-185734,true,8591681305,22,8731119871,139438566
1639168629,-185727,true,8597697286,22,8731119871,133422585
1639168683,-185726,true,8598557056,22,8731119871,132562815
1639168851,-185724,true,8600276853,22,8728501058,128224205
1639169379,-185722,true,8601996995,22,8719777356,117780361
1639169503,-185713,true,8609741889,22,8724138117,114396228
1639170435,-185712,true,8610602864,22,8713675953,103073089
1639170485,-185710,true,8612325070,22,8712804672,100479602
1639171121,-185708,true,8614047621,22,8708449577,94401956
1639171304,-185699,true,8621803366,22,8706708148,84904782
1639171410,-185699,true,8621803366,22,8705837564,84034198
1639171619,-185696,true,8624390166,22,8705837564,81447398
1639171841,-185694,true,8626115130,22,8704967067,78851937
1639172241,-185685,true,8633881740,22,8703226335,69344595
1639172274,-185685,true,8633881740,22,8703226335,69344595
1639172492,-185683,true,8635608602,22,8702356099,66747497
1639172883,-185682,true,8636472163,22,8702356099,65883936
1639172900,-185674,true,8643383760,22,8702356099,58972339
1639173701,-185675,true,8642519508,22,8691050952,48531444
1639173870,-185673,true,8644248098,22,8689313002,45064904
1639173935,-185672,true,8645112523,22,8689313002,44200479
1639173985,-185664,true,8652031034,22,8687575400,35544366
1639174637,-185666,true,8650300887,22,8671952610,21651723
1639175763,-185664,true,8652031034,22,8665018169,12987135
1639175787,-185664,true,8652031034,22,8666751259,14720225
1639175896,-185657,true,8658089273,22,8673687088,15597815
1639176454,-185658,true,8657223551,22,8681496529,24272978
1639176733,-185655,true,8659820977,22,8680628466,20807489
1639176855,-185655,true,8659820977,22,8677157083,17336106
1639177175,-185651,true,8663285425,22,8675421912,12136487
1639177558,-185653,true,8661553028,22,8666751259,5198231
1639177632,-185651,true,8663285425,22,8665018169,1732744
1639177836,-185651,true,8663285425,22,8660686960,-2598465
1639178304,-185647,true,8666751259,22,8652896237,-13855022
1639178358,-185649,true,8665018169,22,8652031034,-12987135
1639178551,-185648,true,8665884671,22,8646841632,-19043039
1639178714,-185648,true,8665884671,22,8641655342,-24229329
1639178936,-185646,true,8667617935,22,8640791263,-26826672
1639179288,-185647,true,8666751259,22,8641655342,-25095917
1639179334,-185645,true,8668484696,22,8649435944,-19048752
1639179335,-185645,true,8668484696,22,8649435944,-19048752
1639179491,-185641,true,8671952610,22,8658955082,-12997528
1639180174,-185642,true,8671085502,22,8675421912,4336410
1639180485,-185641,true,8671952610,22,8665018169,-6934441
1639181821,-185643,true,8670218480,22,8579661967,-90556513
1639181980,-185639,true,8673687088,22,8579661967,-94025121
1639182120,-185641,true,8671952610,22,8578804087,-93148523
1639184530,-185641,true,8671952610,22,8572801325,-99151285
1639185514,-185644,true,8669351545,22,8571087022,-98264523
1639185543,-185643,true,8670218480,22,8571087022,-99131458
1639185609,-185647,true,8666751259,22,8571087022,-95664237
1639185741,-185648,true,8665884671,22,8572801325,-93083346
1639185892,-185650,true,8664151754,22,8572801325,-91350429
1639186557,-185649,true,8665018169,22,8573658606,-91359563
1639186839,-185652,true,8662419184,22,8571944131,-90475053
1639187759,-185653,true,8661553028,22,8551397159,-110155869
1639188201,-185655,true,8659820977,22,8548832252,-110988725
1639188915,-185655,true,8659820977,22,8547122742,-112698235
1639189982,-185657,true,8658089273,22,8547122742,-110966531
1639190649,-185658,true,8657223551,22,8547122742,-110100809
1639190983,-185660,true,8655492366,22,8546268116,-109224250
1639191014,-185660,true,8655492366,22,8543704748,-111787618
1639191348,-185663,true,8652896237,22,8519817027,-133079210
1639191415,-185665,true,8651165917,22,8513855540,-137310377
1639191779,-185671,true,8645977034,22,8482414049,-163562985
1639191831,-185671,true,8645977034,22,8478174115,-167802919
1639191966,-185675,true,8642519508,22,8470547572,-171971936
1639192246,-185677,true,8640791263,22,8462927889,-177863374
1639192251,-185683,true,8635608602,22,8462927889,-172680713
1639192500,-185683,true,8635608602,22,8456160592,-179448010
1639192596,-185687,true,8632155222,22,8453624252,-178530970
1639192615,-185689,true,8630429050,22,8452778974,-177650076
1639193017,-185694,true,8626115130,22,8460389518,-165725612
1639193257,-185693,true,8626977742,22,8466313568,-160664174
1639193914,-185698,true,8622665546,22,8451088671,-171576875
1639193925,-185700,true,8620941272,22,8449398707,-171542565
1639194551,-185706,true,8615770517,22,8413146104,-202624413
1639194658,-185706,true,8615770517,22,8407259257,-208511260
1639194697,-185712,true,8610602864,22,8406418615,-204184249
1639194970,-185713,true,8609741889,22,8407259257,-202482632
1639195647,-185719,true,8604577852,22,8418195254,-186382598
1639196594,-185719,true,8604577852,22,8420720965,-183856887
1639196714,-185724,true,8600276853,22,8414828818,-185448035
1639197017,-185726,true,8598557056,22,8405578057,-192978999
1639197062,-185732,true,8593399727,22,8403056888,-190342839
1639197272,-185732,true,8593399727,22,8400536475,-192863252
1639197335,-185737,true,8589104316,22,8399696506,-189407810
1639197692,-185741,true,8585669533,22,8402216667,-183452866
1639197884,-185746,true,8581377986,22,8416511868,-164866118
1639198655,-185747,true,8580519934,22,8458697694,-121822240
1639199159,-185752,true,8576230960,22,8457851909,-118379051
1639199578,-185755,true,8573658606,22,8457006209,-116652397
1639199622,-185759,true,8570229999,22,8461235557,-108994442
1639199633,-185760,true,8569373062,22,8462927889,-106445173
1639199677,-185765,true,8565089661,22,8471394626,-93695035
1639199714,-185761,true,8568516210,22,8476478734,-92037476
1639200386,-185763,true,8566802764,22,8616632094,49829330
1639200562,-185764,true,8565946170,22,8633881740,67935570
1639201222,-185770,true,8560808400,22,8574515971,13707571
1639201286,-185767,true,8563376900,22,8563376900,0
1639201319,-185771,true,8559952405,22,8559952405,0
1639202143,-185774,true,8557384933,22,8491749372,-65635561
1639202214,-185782,true,8550542104,22,8491749372,-58792732
1639203855,-185778,true,8553962834,22,8483262291,-70700543
1639204343,-185782,true,8550542104,22,8501945077,-48597027
1639204692,-185785,true,8547977455,22,8515558397,-32419058
1639204992,-185792,true,8541996263,22,8519817027,-22179236
1639205751,-185788,true,8545413574,22,8518965131,-26448443
1639205832,-185791,true,8542850463,22,8517261593,-25588870
1639205971,-185794,true,8540288120,22,8513855540,-26432580
1639206460,-185800,true,8535165740,22,8525782689,-9383051
1639206476,-185795,true,8539434177,22,8526635267,-12798910
1639206490,-185798,true,8536872859,22,8526635267,-10237592
1639206635,-185801,true,8534312309,22,8530046433,-4265876
1639206765,-185807,true,8529193513,22,8536019257,6825744
1639208238,-185802,true,8533458963,22,8544559118,11100155
1639208348,-185806,true,8530046433,22,8541996263,11949830
1639208545,-185808,true,8528340679,22,8536019257,7678578
1639209643,-185814,true,8523225465,22,8516409952,-6815513
1639210056,-185810,true,8526635267,22,8513855540,-12779727
1639210221,-185813,true,8524077788,22,8512153025,-11924763
1639210798,-185816,true,8521521076,22,8510450849,-11070227
1639210989,-185822,true,8516409952,22,8500244943,-16165009
1639211457,-185819,true,8518965131,22,8476478734,-42486397
1639211788,-185822,true,8516409952,22,8457851909,-58558043
1639212683,-185826,true,8513004240,22,8442642229,-70362011
1639213220,-185832,true,8507898225,22,8435891154,-72007071
1639214916,-185830,true,8509599889,22,8430831390,-78768499
1639214920,-185834,true,8506196900,22,8429988391,-76208509
1639215518,-185838,true,8502795272,22,8431674473,-71120799
1639215567,-185845,true,8496845695,22,8435047649,-61798046
1639215660,-185842,true,8499395004,22,8440109943,-59285061
1639215770,-185843,true,8498545149,22,8446019792,-52525357
1639216487,-185846,true,8495996096,22,8478174115,-17821981
1639216870,-185851,true,8491749372,22,8474783693,-16965679
1639217289,-185848,true,8494297151,22,8471394626,-22902525
1639218125,-185849,true,8493447806,22,8469700602,-23747204
1639218215,-185851,true,8491749372,22,8468853716,-22895656
1639218469,-185857,true,8486656105,22,8466313568,-20342537
1639218659,-185853,true,8490051277,22,8464620559,-25430718
1639219547,-185855,true,8488353521,22,8457851909,-30501612
1639221299,-185857,true,8486656105,22,8451933780,-34722325
1639221369,-185863,true,8481565893,22,8451088671,-30477222
1639221573,-185859,true,8484959028,22,8451088671,-33870357
1639222255,-185860,true,8484110617,22,8457851909,-26258708
1639222366,-185863,true,8481565893,22,8457851909,-23713984
1639222815,-185869,true,8476478734,22,8447709081,-28769653
1639223115,-185864,true,8480717821,22,8439266016,-41451805
1639223308,-185866,true,8479021932,22,8435891154,-43130778
1639223898,-185868,true,8477326382,22,8442642229,-34684153
1639224264,-185873,true,8473088990,22,8446864394,-26224596
1639224439,-185868,true,8477326382,22,8446019792,-31306590
1639224634,-185868,true,8477326382,22,8443486493,-33839889
1639224722,-185870,true,8475631171,22,8442642229,-32988942
1639224757,-185875,true,8471394626,22,8442642229,-28752397
1639225384,-185869,true,8476478734,22,8433360892,-43117842
1639226240,-185869,true,8476478734,22,8433360892,-43117842
1639226372,-185871,true,8474783693,22,8433360892,-41422801
1639226490,-185876,true,8470547572,22,8433360892,-37186680
1639226492,-185870,true,8475631171,22,8433360892,-42270279
1639226643,-185871,true,8474783693,22,8435047649,-39736044
1639226788,-185873,true,8473088990,22,8436734743,-36354247
1639227317,-185876,true,8470547572,22,8440953954,-29593618
1639228018,-185871,true,8474783693,22,8440953954,-33829739
1639228759,-185870,true,8475631171,22,8439266016,-36365155
1639228799,-185871,true,8474783693,22,8439266016,-35517677
1639228892,-185874,true,8472241766,22,8440953954,-31287812
1639229649,-185868,true,8477326382,22,8479021932,1695550
1639229858,-185867,true,8478174115,22,8480717821,2543706
1639230575,-185868,true,8477326382,22,8468853716,-8472666
1639230904,-185871,true,8474783693,22,8468853716,-5929977
1639230928,-185865,true,8479869834,22,8468853716,-11016118
1639231133,-185863,true,8481565893,22,8479869834,-1696059
1639231469,-185863,true,8481565893,22,8494297151,12731258
1639231560,-185865,true,8479869834,22,8495146581,15276747
1639231649,-185860,true,8484110617,22,8497695380,13584763
1639231808,-185860,true,8484110617,22,8493447806,9337189
1639232169,-185862,true,8482414049,22,8465467021,-16947028
1639232236,-185866,true,8479021932,22,8457851909,-21170023
1639232464,-185861,true,8483262291,22,8434204228,-49058063
1639233264,-185862,true,8482414049,22,8403056888,-79357161
1639233753,-185866,true,8479021932,22,8395497917,-83524015
1639235624,-185870,true,8475631171,22,8393819069,-81812102
1639236175,-185872,true,8473936299,22,8399696506,-74239793
1639236299,-185875,true,8471394626,22,8400536475,-70858151
1639236814,-185879,true,8468006915,22,8402216667,-65790248
1639236917,-185881,true,8466313568,22,8403056888,-63256680
1639237699,-185883,true,8464620559,22,8366166501,-98454058
1639237767,-185885,true,8462927889,22,8363657153,-99270736
1639238112,-185887,true,8461235557,22,8361148557,-100087000
1639238653,-185888,true,8460389518,22,8359476578,-100912940
1639238852,-185890,true,8458697694,22,8369513469,-89184225
1639239434,-185891,true,8457851909,22,8396337467,-61514442
1639239770,-185893,true,8456160592,22,8397177100,-58983492
1639240291,-185894,true,8455315061,22,8382914739,-72400322
1639240650,-185897,true,8452778974,22,8374536433,-78242541
1639243673,-185899,true,8451088671,22,8370350421,-80738250
1639244247,-185901,true,8449398707,22,8369513469,-79885238
1639244566,-185902,true,8448553852,22,8383753030,-64800822
1639245224,-185905,true,8446019792,22,8409781687,-36238105
1639245416,-185906,true,8445175275,22,8410622665,-34552610
1639245449,-185908,true,8443486493,22,8410622665,-32863828
1639245983,-185909,true,8442642229,22,8395497917,-47144312
1639246172,-185913,true,8439266016,22,8389623418,-49642598
1639246985,-185914,true,8438422174,22,8383753030,-54669144
1639247120,-185916,true,8436734743,22,8390462381,-46272362
1639247667,-185916,true,8436734743,22,8415670301,-21064442
1639248007,-185919,true,8434204228,22,8423247434,-10956794
1639248577,-185919,true,8434204228,22,8422405194,-11799034
1639248839,-185921,true,8432517641,22,8423247434,-9270207
1639248942,-185920,true,8433360892,22,8435047649,1686757
1639249518,-185920,true,8433360892,22,8496845695,63484803
1639249572,-185919,true,8434204228,22,8496845695,62641467
1639249693,-185918,true,8435047649,22,8498545149,63497500
1639249969,-185918,true,8435047649,22,8479021932,43974283
1639250137,-185920,true,8433360892,22,8464620559,31259667
1639250254,-185918,true,8435047649,22,8454469614,19421965
1639250464,-185917,true,8435891154,22,8439266016,3374862
1639250648,-185918,true,8435047649,22,8439266016,4218367
1639250771,-185920,true,8433360892,22,8440109943,6749051
1639251190,-185919,true,8434204228,22,8436734743,2530515
1639252384,-185920,true,8433360892,22,8431674473,-1686419
1639252425,-185920,true,8433360892,22,8430831390,-2529502
1639252585,-185922,true,8431674473,22,8434204228,2529755
1639253157,-185921,true,8432517641,22,8436734743,4217102
1639253193,-185922,true,8431674473,22,8435891154,4216681
1639253320,-185922,true,8431674473,22,8440109943,8435470
1639253718,-185924,true,8429988391,22,8443486493,13498102
1639253766,-185922,true,8431674473,22,8442642229,10967756
1639254638,-185921,true,8432517641,22,8479869834,47352193
1639254833,-185921,true,8432517641,22,8482414049,49896408
1639255131,-185923,true,8430831390,22,8461235557,30404167
1639257136,-185923,true,8430831390,22,8413146104,-17685286
1639257320,-185923,true,8430831390,22,8413146104,-17685286
1639257331,-185923,true,8430831390,22,8413146104,-17685286
1639257393,-185925,true,8429145477,22,8413146104,-15999373
1639257556,-185924,true,8429988391,22,8412304874,-17683517
1639257797,-185925,true,8429145477,22,8410622665,-18522812
1639258068,-185925,true,8429145477,22,8405578057,-23567420
1639258275,-185927,true,8427459900,22,8400536475,-26923425
1639258278,-185927,true,8427459900,22,8400536475,-26923425
1639258455,-185926,true,8428302646,22,8412304874,-15997772
1639258532,-185925,true,8429145477,22,8418195254,-10950223
1639258628,-185925,true,8429145477,22,8424089759,-5055718
1639258712,-185925,true,8429145477,22,8426617239,-2528238
1639258970,-185926,true,8428302646,22,8436734743,8432097
1639259228,-185925,true,8429145477,22,8442642229,13496752
1639259312,-185925,true,8429145477,22,8439266016,10120539
1639260463,-185925,true,8429145477,22,8429145477,0
1639261934,-185926,true,8428302646,22,8428302646,0
1639262674,-185926,true,8428302646,22,8407259257,-21043389
1639263005,-185926,true,8428302646,22,8401376529,-26926117
1639263521,-185927,true,8427459900,22,8413146104,-14313796
1639263684,-185928,true,8426617239,22,8417353519,-9263720
1639264239,-185927,true,8427459900,22,8422405194,-5054706
1639265027,-185929,true,8425774661,22,8422405194,-3369467
1639265075,-185930,true,8424932168,22,8424932168,0
1639265315,-185930,true,8424932168,22,8438422174,13490006
1639265358,-185929,true,8425774661,22,8440953954,15179293
1639265540,-185928,true,8426617239,22,8449398707,22781468
1639265808,-185930,true,8424932168,22,8461235557,36303389
1639265810,-185932,true,8423247434,22,8461235557,37988123
1639266991,-185933,true,8422405194,22,8433360892,10955698
1639267216,-185932,true,8423247434,22,8446019792,22772358
1639267552,-185932,true,8423247434,22,8463774182,40526748
1639267938,-185932,true,8423247434,22,8483262291,60014857
1639267996,-185931,true,8424089759,22,8484110617,60020858
1639268194,-185929,true,8425774661,22,8486656105,60881444
1639268920,-185928,true,8426617239,22,8494297151,67679912
1639268994,-185927,true,8427459900,22,8492598547,65138647
1639269324,-185925,true,8429145477,22,8487504770,58359293
1639269684,-185924,true,8429988391,22,8481565893,51577502
1639269957,-185923,true,8430831390,22,8479021932,48190542
1639270205,-185922,true,8431674473,22,8482414049,50739576
1639270411,-185921,true,8432517641,22,8485807524,53289883
1639270514,-185918,true,8435047649,22,8487504770,52457121
1639270720,-185917,true,8435891154,22,8491749372,55858218
1639271016,-185915,true,8437578416,22,8495146581,57568165
1639271202,-185914,true,8438422174,22,8491749372,53327198
1639271589,-185912,true,8440109943,22,8484959028,44849085
1639272858,-185910,true,8441798049,22,8526635267,84837218
1639273462,-185909,true,8442642229,22,8496845695,54203466
1639273889,-185908,true,8443486493,22,8481565893,38079400
1639274282,-185905,true,8446019792,22,8480717821,34698029
1639274328,-185904,true,8446864394,22,8480717821,33853427
1639274690,-185903,true,8447709081,22,8468006915,20297834
1639275105,-185903,true,8447709081,22,8455315061,7605980
1639275597,-185901,true,8449398707,22,8453624252,4225545
1639275781,-185901,true,8449398707,22,8462927889,13529182
1639276167,-185900,true,8450243647,22,8482414049,32170402
1639276596,-185898,true,8451933780,22,8524077788,72144008
1639277006,-185894,true,8455315061,22,8541996263,86681202
1639277036,-185893,true,8456160592,22,8543704748,87544156
1639277227,-185891,true,8457851909,22,8542850463,84998554
1639277499,-185891,true,8457851909,22,8536019257,78167348
1639277833,-185887,true,8461235557,22,8530899437,69663880
1639277855,-185887,true,8461235557,22,8530899437,69663880
1639278059,-185886,true,8462081681,22,8527487931,65406250
1639278405,-185886,true,8462081681,22,8523225465,61143784
1639278461,-185884,true,8463774182,22,8522373228,58599046
1639278521,-185886,true,8462081681,22,8522373228,60291547
1639278785,-185885,true,8462927889,22,8519817027,56889138
1639278999,-185884,true,8463774182,22,8519817027,56042845
1639279007,-185880,true,8467160199,22,8519817027,52656828
1639279084,-185882,true,8465467021,22,8515558397,50091376
1639279286,-185882,true,8465467021,22,8503645551,38178530
1639279662,-185883,true,8464620559,22,8471394626,6774067
1639280857,-185880,true,8467160199,22,8440109943,-27050256
1639281444,-185882,true,8465467021,22,8440109943,-25357078
1639281613,-185882,true,8465467021,22,8440109943,-25357078
1639281766,-185883,true,8464620559,22,8441798049,-22822510
1639282858,-185879,true,8468006915,22,8446019792,-21987123
1639283122,-185881,true,8466313568,22,8440953954,-25359614
1639284601,-185882,true,8465467021,22,8422405194,-43061827
1639284654,-185883,true,8464620559,22,8422405194,-42215365
1639285307,-185880,true,8467160199,22,8424089759,-43070440
1639286285,-185882,true,8465467021,22,8437578416,-27888605
1639286576,-185884,true,8463774182,22,8438422174,-25352008
1639286945,-185885,true,8462927889,22,8439266016,-23661873
1639287139,-185882,true,8465467021,22,8439266016,-26201005
1639287166,-185882,true,8465467021,22,8439266016,-26201005
1639287351,-185883,true,8464620559,22,8438422174,-26198385
1639289780,-185884,true,8463774182,22,8436734743,-27039439
1639290085,-185880,true,8467160199,22,8436734743,-30425456
1639290330,-185881,true,8466313568,22,8435047649,-31265919
1639290370,-185882,true,8465467021,22,8434204228,-31262793
1639290430,-185882,true,8465467021,22,8434204228,-31262793
1639290854,-185879,true,8468006915,22,8429988391,-38018524
1639292935,-185879,true,8468006915,22,8422405194,-45601721
1639293365,-185881,true,8466313568,22,8420720965,-45592603
1639293904,-185883,true,8464620559,22,8418195254,-46425305
1639294977,-185881,true,8466313568,22,8417353519,-48960049
1639295679,-185881,true,8466313568,22,8440953954,-25359614
1639295995,-185882,true,8465467021,22,8447709081,-17757940
1639296246,-185883,true,8464620559,22,8447709081,-16911478
1639296297,-185881,true,8466313568,22,8446864394,-19449174
1639296451,-185880,true,8467160199,22,8444330842,-22829357
1639296808,-185881,true,8466313568,22,8438422174,-27891394
1639297159,-185882,true,8465467021,22,8435891154,-29575867
1639297339,-185880,true,8467160199,22,8437578416,-29581783
1639297826,-185879,true,8468006915,22,8440109943,-27896972
1639298783,-185880,true,8467160199,22,8439266016,-27894183
1639298944,-185881,true,8466313568,22,8446019792,-20293776
1639300249,-185878,true,8468853716,22,8481565893,12712177
1639301055,-185877,true,8469700602,22,8479869834,10169232
1639304384,-185877,true,8469700602,22,8480717821,11017219
1639304699,-185879,true,8468006915,22,8479869834,11862919
1639304956,-185877,true,8469700602,22,8479869834,10169232
1639305321,-185876,true,8470547572,22,8479021932,8474360
1639306228,-185876,true,8470547572,22,8476478734,5931162
1639306705,-185877,true,8469700602,22,8476478734,6778132
1639307901,-185875,true,8471394626,22,8476478734,5084108
1639308398,-185875,true,8471394626,22,8473088990,1694364
1639308871,-185875,true,8471394626,22,8471394626,0
1639309140,-185877,true,8469700602,22,8470547572,846970
1639311005,-185876,true,8470547572,22,8467160199,-3387373
1639312068,-185876,true,8470547572,22,8464620559,-5927013
1639312080,-185877,true,8469700602,22,8463774182,-5926420
1639312803,-185879,true,8468006915,22,8462081681,-5925234
1639313789,-185879,true,8468006915,22,8413146104,-54860811
1639313919,-185879,true,8468006915,22,8413146104,-54860811
1639315649,-185880,true,8467160199,22,8403897194,-63263005
1639315801,-185883,true,8464620559,22,8409781687,-54838872
1639315946,-185883,true,8464620559,22,8415670301,-48950258
1639316841,-185883,true,8464620559,22,8440109943,-24510616
1639316863,-185883,true,8464620559,22,8440109943,-24510616
1639317792,-185885,true,8462927889,22,8445175275,-17752614
1639318030,-185885,true,8462927889,22,8440953954,-21973935
1639318225,-185886,true,8462081681,22,8436734743,-25346938
1639318243,-185887,true,8461235557,22,8437578416,-23657141
1639318444,-185889,true,8459543564,22,8439266016,-20277548
1639318721,-185889,true,8459543564,22,8437578416,-21965148
1639318838,-185888,true,8460389518,22,8439266016,-21123502
1639319113,-185888,true,8460389518,22,8446864394,-13525124
1639319154,-185890,true,8458697694,22,8446864394,-11833300
1639319536,-185889,true,8459543564,22,8451933780,-7609784
1639319713,-185888,true,8460389518,22,8457851909,-2537609
1639319777,-185888,true,8460389518,22,8459543564,-845954
1639320653,-185891,true,8457851909,22,8473936299,16084390
1639320682,-185892,true,8457006209,22,8472241766,15235557
1639320739,-185891,true,8457851909,22,8471394626,13542717
1639320803,-185892,true,8457006209,22,8468853716,11847507
1639321920,-185897,true,8452778974,22,8424932168,-27846806
1639322018,-185897,true,8452778974,22,8422405194,-30373780
1639322115,-185897,true,8452778974,22,8424932168,-27846806
1639322591,-185897,true,8452778974,22,8449398707,-3380267
1639323004,-185899,true,8451088671,22,8495996096,44907425
1639323116,-185899,true,8451088671,22,8501945077,50856406
1639323384,-185898,true,8451933780,22,8514706926,62773146
1639324683,-185897,true,8452778974,22,8529193513,76414539
1639324836,-185899,true,8451088671,22,8524930196,73841525
1639325090,-185898,true,8451933780,22,8541996263,90062483
1639325137,-185897,true,8452778974,22,8550542104,97763130
1639325299,-185891,true,8457851909,22,8580519934,122668025
1639325444,-185888,true,8460389518,22,8617493757,157104239
1639325516,-185882,true,8465467021,22,8640791263,175324242
1639325554,-185880,true,8467160199,22,8656357915,189197716
1639325561,-185872,true,8473936299,22,8658955082,185018783
1639325603,-185864,true,8480717821,22,8682364679,201646858
1639325629,-185855,true,8488353521,22,8696266886,207913365
1639325740,-185852,true,8490900282,22,8752098674,261198392
1639325746,-185843,true,8498545149,22,8754724566,256179417
1639325810,-185836,true,8504495916,22,8780148843,275652927
1639325909,-185827,true,8512153025,22,8820628536,308475511
1639325989,-185822,true,8516409952,22,8869273211,352863259
1639326013,-185813,true,8524077788,22,8879922195,355844407
1639326023,-185804,true,8531752527,22,8884363044,352610517
1639326025,-185792,true,8541996263,22,8885251480,343255217
1639326058,-185786,true,8547122742,22,8901258534,354135792
1639326071,-185777,true,8554818231,22,8907491285,352673054
1639326094,-185768,true,8562520647,22,8919077974,356557327
1639326096,-185755,true,8573658606,22,8920861879,347203273
1639326134,-185746,true,8581377986,22,8944979544,363601558
1639326544,-185734,true,8591681305,22,9145768563,554087258
1639326626,-185725,true,8599416912,22,9170494267,571077355
1639326663,-185713,true,8609741889,22,9180586856,570844967
1639326839,-185704,true,8617493757,22,9220146393,602652636
1639326908,-185695,true,8625252605,22,9220146393,594893788
1639326917,-185687,true,8632155222,22,9221068408,588913186
1639327002,-185674,true,8643383760,22,9221990515,578606755
1639327222,-185665,true,8651165917,22,9206327231,555161314
1639327406,-185655,true,8659820977,22,9195286816,535465839
1639327547,-185647,true,8666751259,22,9184259641,517508382
1639327624,-185636,true,8676289454,22,9181504914,505215460
1639327727,-185628,true,8683232915,22,9173245690,490012775
1639327804,-185619,true,8691050952,22,9171411316,480360364
1639327913,-185612,true,8697136513,22,9164077488,466940975
1639327941,-185601,true,8706708148,22,9160412773,453704625
1639327988,-185593,true,8713675953,22,9154918448,441242495
1639328324,-185585,true,8720649334,22,9111993431,391344097
1639328416,-185578,true,8726755620,22,9106528148,379772528
1639328525,-185568,true,8735486304,22,9100156127,364669823
1639328721,-185561,true,8741602979,22,9086516807,344913828
1639328926,-185554,true,8747723937,22,9086516807,338792870
1639328956,-185547,true,8753849181,22,9087425458,333576277
1639329377,-185536,true,8763483231,22,9095607414,332124183
1639329595,-185529,true,8769619510,22,9111082322,341462812
1639329685,-185520,true,8777515325,22,9115638775,338123450
1639329713,-185514,true,8782783151,22,9114727302,331944151
1639329787,-185503,true,8792449045,22,9113815920,321366875
1639329810,-185496,true,8798605606,22,9113815920,315210314
1639330206,-185489,true,8804766478,22,9103796735,299030257
1639330532,-185482,true,8810931664,22,9083791397,272859733
1639330544,-185471,true,8820628536,22,9081974911,261346375
1639331874,-185466,true,8825039732,22,9033066862,208027130
1639331971,-185459,true,8831219114,22,9033066862,201847748
1639332375,-185453,true,8836519170,22,9034873566,198354396
1639332717,-185440,true,8848013540,22,9066549440,218535900
1639332806,-185433,true,8854209008,22,9071990730,217781722
1639333094,-185425,true,8861294855,22,9086516807,225221952
1639333293,-185418,true,8867499622,22,9086516807,219017185
1639333973,-185408,true,8876371114,22,9006009621,129638507
1639334024,-185401,true,8882586438,22,9001507967,118921529
1639334426,-185396,true,8887028619,22,8988915302,101886683
1639334583,-185389,true,8893251406,22,8988915302,95663896
1639334649,-185379,true,8902148660,22,8988915302,86766642
1639334845,-185373,true,8907491285,22,8975442710,67951425
1639334998,-185369,true,8911054816,22,8958406410,47351594
1639336032,-185365,true,8914619773,22,8895030145,-19589628
1639336072,-185355,true,8923538405,22,8894140731,-29397674
1639336126,-185350,true,8928001067,22,8894140731,-33860336
1639336604,-185346,true,8931572803,22,8887917322,-43655481
1639338292,-185345,true,8932465960,22,8803886089,-128579871
1639338918,-185336,true,8940508396,22,8809169742,-131338654
1639339603,-185331,true,8944979544,22,8808288913,-136690631
1639339730,-185328,true,8947663306,22,8803886089,-143777217
1639340005,-185327,true,8948558073,22,8793328290,-155229783
1639340238,-185319,true,8955719425,22,8783661430,-172057995
1639340653,-185316,true,8958406410,22,8760854712,-197551698
1639340916,-185313,true,8961094201,22,8752973884,-208120317
1639342139,-185311,true,8962886509,22,8725010531,-237875978
1639342204,-185303,true,8970059328,22,8724138117,-245921211
1639343106,-185299,true,8973647890,22,8771373522,-202274368
1639343329,-185296,true,8976340254,22,8782783151,-193557103
1639343643,-185295,true,8977237888,22,8800365415,-176872473
1639343897,-185287,true,8984422192,22,8814456565,-169965627
1639344350,-185282,true,8988915302,22,8818864675,-170050627
1639344558,-185281,true,8989814193,22,8817101167,-172713026
1639344632,-185280,true,8990713175,22,8817101167,-173612008
1639344673,-185272,true,8997908263,22,8816219545,-181688718
1639344820,-185268,true,9001507967,22,8815338011,-186169956
1639344821,-185270,true,8999707935,22,8815338011,-184369924
1639345373,-185272,true,8997908263,22,8808288913,-189619350
1639345646,-185269,true,9000607906,22,8804766478,-195841428
1639345867,-185265,true,9004208689,22,8816219545,-187989144
1639347333,-185268,true,9001507967,22,8850668210,-150839757
1639347871,-185274,true,8996108952,22,8895030145,-101078807
1639348456,-185273,true,8997008562,22,8919077974,-77930588
1639348499,-185270,true,8999707935,22,8919077974,-80629961
1639348545,-185271,true,8998808054,22,8918186155,-80621899
1639348963,-185277,true,8993410659,22,8910163800,-83246859
1639349595,-185276,true,8994310000,22,8896809240,-97500760
1639349810,-185275,true,8995209431,22,8894140731,-101068700
1639351133,-185278,true,8992511407,22,8892362170,-100149237
1639351793,-185284,true,8987117789,22,8894140731,-92977058
1639351997,-185288,true,8983523840,22,8894140731,-89383109
1639352239,-185287,true,8984422192,22,8895030145,-89392047
1639352272,-185290,true,8981727405,22,8895919648,-85807757
1639352393,-185297,true,8975442710,22,8895919648,-79523062
1639353525,-185303,true,8970059328,22,8824157317,-145902011
1639353762,-185306,true,8967368849,22,8825922236,-141446613
1639355072,-185311,true,8962886509,22,8825039732,-137846777
1639355244,-185318,true,8956614997,22,8825039732,-131575265
1639355991,-185324,true,8951242909,22,8825922236,-125320673
1639356104,-185327,true,8948558073,22,8825039732,-123518341
1639356507,-185330,true,8945874042,22,8825039732,-120834310
1639356859,-185336,true,8940508396,22,8840938314,-99570082
1639356883,-185341,true,8936039482,22,8841822407,-94217075
1639356985,-185344,true,8933359207,22,8846244203,-87115004
1639358190,-185346,true,8931572803,22,8881698268,-49874535
1639358459,-185351,true,8927108356,22,8880810187,-46298169
1639358984,-185356,true,8922646140,22,8879922195,-42723945
1639359177,-185358,true,8920861879,22,8879034291,-41827588
1639359698,-185359,true,8919969882,22,8864839905,-55129977
1639360097,-185364,true,8915511235,22,8855979938,-59531297
1639360179,-185369,true,8911054816,22,8855979938,-55074878
1639361707,-185371,true,8909272872,22,8848013540,-61259332
1639361914,-185372,true,8908382034,22,8846244203,-62137831
1639361971,-185377,true,8903929179,22,8846244203,-57684976
1639362451,-185382,true,8899478550,22,8843590860,-55887690
1639362717,-185383,true,8898588691,22,8841822407,-56766284
1639362769,-185384,true,8897698921,22,8842706590,-54992331
1639362848,-185389,true,8893251406,22,8845359667,-47891739
1639362950,-185394,true,8888806114,22,8848013540,-40792574
1639363249,-185396,true,8887028619,22,8855979938,-31048681
1639363540,-185396,true,8887028619,22,8866612961,-20415658
1639365160,-185401,true,8882586438,22,8878146476,-4439962
1639365395,-185406,true,8878146476,22,8876371114,-1775362
1639365614,-185408,true,8876371114,22,8873708735,-2662379
1639366580,-185407,true,8877258751,22,8863953509,-13305242
1639366814,-185412,true,8872821453,22,8862180984,-10640469
1639367912,-185417,true,8868386372,22,8858636998,-9749374
1639368246,-185417,true,8868386372,22,8859522862,-8863510
1639368609,-185417,true,8868386372,22,8860408814,-7977558
1639368622,-185421,true,8864839905,22,8860408814,-4431091
1639369490,-185427,true,8859522862,22,8858636998,-885864
1639370165,-185428,true,8858636998,22,8863953509,5316511
1639370414,-185427,true,8859522862,22,8865726389,6203527
1639370622,-185432,true,8855094429,22,8865726389,10631960
1639370682,-185435,true,8852438432,22,8865726389,13287957
1639370760,-185436,true,8851553276,22,8864839905,13286629
1639370939,-185434,true,8853323676,22,8863953509,10629833
1639371299,-185440,true,8848013540,22,8839170391,-8843149
1639373455,-185444,true,8844475219,22,8800365415,-44109804
1639374179,-185445,true,8843590860,22,8766989150,-76601710
1639374428,-185442,true,8846244203,22,8748598709,-97645494
1639374784,-185447,true,8841822407,22,8734612842,-107209565
1639374790,-185452,true,8837402822,22,8734612842,-102789980
1639376724,-185455,true,8834752131,22,8691920057,-142832074
1639377775,-185452,true,8837402822,22,8711933479,-125469343
1639378127,-185453,true,8836519170,22,8706708148,-129811022
1639378345,-185459,true,8831219114,22,8704096658,-127122456
1639378656,-185461,true,8829453135,22,8700615889,-128837246
1639379135,-185458,true,8832102236,22,8679760490,-152341746
1639379435,-185460,true,8830336080,22,8665884671,-164451409
1639379958,-185466,true,8825039732,22,8633018438,-192021294
1639382221,-185468,true,8823274989,22,8603717480,-219557509
1639382808,-185466,true,8825039732,22,8612325070,-212714662
1639384294,-185467,true,8824157317,22,8567659444,-256497873
1639388539,-185474,true,8817982877,22,8569373062,-248609815
1639388624,-185477,true,8815338011,22,8569373062,-245964949
1639389180,-185475,true,8817101167,22,8569373062,-247728105
1639389435,-185478,true,8814456565,22,8571087022,-243369543
1639389686,-185485,true,8808288913,22,8572801325,-235487588
1639389800,-185490,true,8803886089,22,8573658606,-230227483
1639390673,-185488,true,8805646955,22,8575373423,-230273532
1639390684,-185491,true,8803005789,22,8575373423,-227632366
1639391071,-185498,true,8796846149,22,8572801325,-224044824
1639391672,-185502,true,8793328290,22,8601996995,-191331295
1639391681,-185499,true,8795966552,22,8602857194,-193109358
1639392146,-185502,true,8793328290,22,8619217342,-174110948
1639392656,-185508,true,8788054139,22,8615770517,-172283622
1639393268,-185512,true,8784539796,22,8614909026,-169630770
1639393386,-185511,true,8785418250,22,8615770517,-169647733
1639393612,-185514,true,8782783151,22,8627840439,-154942712
1639394676,-185520,true,8777515325,22,8658089273,-119426052
1639396323,-185524,true,8774005197,22,8657223551,-116781646
1639396475,-185524,true,8774005197,22,8656357915,-117647282
1639396933,-185527,true,8771373522,22,8649435944,-121937578
1639397200,-185533,true,8766112539,22,8645112523,-121000016
1639398011,-185537,true,8762606971,22,8649435944,-113171027
1639398857,-185537,true,8762606971,22,8645112523,-117494448
1639398958,-185540,true,8759978714,22,8645977034,-114001680
1639399161,-185545,true,8755600038,22,8655492366,-100107672
1639399342,-185549,true,8752098674,22,8664151754,-87946920
1639399685,-185549,true,8752098674,22,8666751259,-85347415
1639400011,-185553,true,8748598709,22,8643383760,-105214949
1639400270,-185556,true,8745974655,22,8636472163,-109502492
1639400303,-185559,true,8743351387,22,8634745128,-108606259
1639400661,-185560,true,8742477139,22,8620079264,-122397875
1639402717,-185564,true,8738981022,22,8601996995,-136984027
1639402740,-185567,true,8736359852,22,8600276853,-136082999
1639402776,-185571,true,8732866182,22,8600276853,-132589329
1639403227,-185572,true,8731992983,22,8602857194,-129135789
1639403377,-185576,true,8728501058,22,8604577852,-123923206
1639403554,-185579,true,8725883032,22,8611463924,-114419108
1639403709,-185582,true,8723265790,22,8626115130,-97150660
1639404861,-185582,true,8723265790,22,8682364679,-40901111
1639405329,-185586,true,8719777356,22,8678892601,-40884755
1639405585,-185590,true,8716290317,22,8676289454,-40000863
1639405898,-185592,true,8714547320,22,8696266886,-18280434
1639405945,-185591,true,8715418775,22,8699745915,-15672860
1639406286,-185594,true,8712804672,22,8725883032,13078360
1639406612,-185596,true,8711062373,22,8738981022,27918649
1639406848,-185598,true,8709320421,22,8736359852,27039431
1639406881,-185597,true,8710191354,22,8739854920,29663566
1639406917,-185599,true,8708449577,22,8745974655,37525078
1639407107,-185598,true,8709320421,22,8775760086,66439665
1639407161,-185596,true,8711062373,22,8784539796,73477423
1639407369,-185593,true,8713675953,22,8840054308,126378355
1639407469,-185594,true,8712804672,22,8867499622,154694950
1639407678,-185592,true,8714547320,22,8921753965,207206645
1639407689,-185591,true,8715418775,22,8924430759,209011984
1639407995,-185589,true,8717161946,22,8944085136,226923190
1639408035,-185592,true,8714547320,22,8943190817,228643497
1639408156,-185591,true,8715418775,22,8927108356,211689581
1639408337,-185591,true,8715418775,22,8898588691,183169916
1639408825,-185591,true,8715418775,22,8836519170,121100395
1639409199,-185595,true,8711933479,22,8799485467,87551988
1639409214,-185594,true,8712804672,22,8800365415,87560743
1639409888,-185595,true,8711933479,22,8771373522,59440043
1639410123,-185596,true,8711062373,22,8770496472,59434099
1639410378,-185599,true,8708449577,22,8768742636,60293059
1639410507,-185599,true,8708449577,22,8773127884,64678307
1639410792,-185599,true,8708449577,22,8784539796,76090219
1639410993,-185599,true,8708449577,22,8803005789,94556212
1639411362,-185599,true,8708449577,22,8867499622,159050045
1639411997,-185597,true,8710191354,22,8924430759,214239405
1639413592,-185596,true,8711062373,22,8919077974,208015601
1639413616,-185596,true,8711062373,22,8917294426,206232053
1639414048,-185595,true,8711933479,22,8895919648,183986169
1639415032,-185593,true,8713675953,22,8872821453,159145500
1639415381,-185591,true,8715418775,22,8900368498,184949723
1639415836,-185591,true,8715418775,22,8908382034,192963259
1639416572,-185589,true,8717161946,22,8901258534,184096588
1639416888,-185584,true,8721521399,22,8903929179,182407780
1639417465,-185581,true,8724138117,22,8891473022,167334905
1639417573,-185581,true,8724138117,22,8888806114,164667997
1639418084,-185579,true,8725883032,22,8874596106,148713074
1639418362,-185575,true,8729373908,22,8866612961,137239053
1639418473,-185573,true,8731119871,22,8861294855,130174984
1639419221,-185572,true,8731992983,22,8832102236,100109253
1639419998,-185571,true,8732866182,22,8827687509,94821327
1639420873,-185566,true,8737233488,22,8826804829,89571341
1639420942,-185562,true,8740728906,22,8825922236,85193330
1639421182,-185562,true,8740728906,22,8802125576,61396670
1639421314,-185561,true,8741602979,22,8789811838,48208859
1639421390,-185557,true,8745100145,22,8780148843,35048698
1639421890,-185554,true,8747723937,22,8722393551,-25330386
1639422234,-185554,true,8747723937,22,8714547320,-33176617
1639422245,-185553,true,8748598709,22,8716290317,-32308392
1639422467,-185549,true,8752098674,22,8726755620,-25343054
1639422586,-185546,true,8754724566,22,8732866182,-21858384
1639422632,-185545,true,8755600038,22,8731119871,-24480167
1639422846,-185544,true,8756475598,22,8735486304,-20989294
1639422880,-185541,true,8759102804,22,8734612842,-24489962
1639422954,-185538,true,8761730797,22,8736359852,-25370945
1639422974,-185538,true,8761730797,22,8731992983,-29737814
1639423118,-185539,true,8760854712,22,8733739468,-27115244
1639423219,-185536,true,8763483231,22,8732866182,-30617049
1639423411,-185532,true,8766989150,22,8730246846,-36742304
1639423672,-185532,true,8766989150,22,8733739468,-33249682
1639423789,-185533,true,8766112539,22,8731992983,-34119556
1639423936,-185532,true,8766989150,22,8712804672,-54184478
1639424171,-185531,true,8767865849,22,8688444158,-79421691
1639424582,-185532,true,8766989150,22,8645977034,-121012116
1639424653,-185533,true,8766112539,22,8641655342,-124457197
1639425009,-185532,true,8766989150,22,8654626903,-112362247
1639425069,-185531,true,8767865849,22,8658089273,-109776576
1639425373,-185532,true,8766989150,22,8656357915,-110631235
1639426138,-185533,true,8766112539,22,8649435944,-116676595
1639426795,-185532,true,8766989150,22,8649435944,-117553206
1639426854,-185531,true,8767865849,22,8649435944,-118429905
1639427384,-185533,true,8766112539,22,8647706316,-118406223
1639428003,-185533,true,8766112539,22,8639927270,-126185269
1639428080,-185533,true,8766112539,22,8629566094,-136546445
1639428206,-185531,true,8767865849,22,8627840439,-140025410
1639428285,-185532,true,8766989150,22,8626115130,-140874020
1639429775,-185529,true,8769619510,22,8699745915,-69873595
1639430126,-185528,true,8770496472,22,8698876027,-71620445
1639430220,-185526,true,8772250659,22,8698006226,-74244433
1639430499,-185527,true,8771373522,22,8691920057,-79453465
1639431079,-185525,true,8773127884,22,8674554456,-98573428
1639431090,-185525,true,8773127884,22,8674554456,-98573428
1639431160,-185524,true,8774005197,22,8675421912,-98583285
1639431440,-185527,true,8771373522,22,8676289454,-95084068
1639431489,-185525,true,8773127884,22,8677157083,-95970801
1639431491,-185525,true,8773127884,22,8677157083,-95970801
1639431798,-185523,true,8774882597,22,8692789249,-82093348
1639432035,-185526,true,8772250659,22,8702356099,-69894560
1639432191,-185526,true,8772250659,22,8703226335,-69024324
1639432368,-185526,true,8772250659,22,8704967067,-67283592
1639432593,-185525,true,8773127884,22,8696266886,-76860998
1639433013,-185529,true,8769619510,22,8681496529,-88122981
1639433622,-185529,true,8769619510,22,8667617935,-102001575
1639434107,-185533,true,8766112539,22,8674554456,-91558083
1639434155,-185536,true,8763483231,22,8675421912,-88061319
1639434241,-185542,true,8758226981,22,8677157083,-81069898
1639434353,-185542,true,8758226981,22,8679760490,-78466491
1639434860,-185548,true,8752973884,22,8685838146,-67135738
1639435860,-185550,true,8751223551,22,8700615889,-50607662
1639436270,-185555,true,8746849252,22,8698006226,-48843026
1639436818,-185555,true,8746849252,22,8694527894,-52321358
1639437026,-185558,true,8744225722,22,8694527894,-49697828
1639437428,-185560,true,8742477139,22,8694527894,-47949245
1639438008,-185562,true,8740728906,22,8684969649,-55759257
1639438665,-185561,true,8741602979,22,8680628466,-60974513
1639438821,-185564,true,8738981022,22,8681496529,-57484493
1639439297,-185565,true,8738107212,22,8682364679,-55742533
