Timestamp,OAT,Success,Quote,Observations,Regular_Quote,Difference
1640444108,193238,true,4056952039,28,4076878889,19926850
1640446833,193237,true,4057357734,28,4076471242,19113508
1640448159,193237,true,4057357734,28,4076471242,19113508
1640449247,193237,true,4057357734,28,4084223512,26865778
1640450095,193236,true,4057763470,28,4087900784,30137314
1640452217,193235,true,4058169247,28,4085857446,27688199
1640452667,193235,true,4058169247,28,4083406790,25237543
1640452716,193235,true,4058169247,28,4082998490,24829243
1640452760,193234,true,4058575063,28,4082590231,24015168
1640452839,193234,true,4058575063,28,4081773835,23198772
1640452863,193234,true,4058575063,28,4081365699,22790636
1640452902,193234,true,4058575063,28,4080957603,22382540
1640453184,193235,true,4058169247,28,4076063635,17894388
1640455033,193235,true,4058169247,28,4054924172,-3245075
1640455124,193235,true,4058169247,28,4055329664,-2839583
1640455778,193235,true,4058169247,28,4056546385,-1622862
1640455845,193234,true,4058575063,28,4056546385,-2028678
1640455981,193235,true,4058169247,28,4056952039,-1217208
1640456148,193233,true,4058980921,28,4057357734,-1623187
1640456295,193232,true,4059386819,28,4058169247,-1217572
1640456356,193232,true,4059386819,28,4058169247,-1217572
1640456376,193233,true,4058980921,28,4058575063,-405858
1640456639,193231,true,4059792758,28,4060604757,811999
1640456706,193230,true,4060198737,28,4061010817,812080
1640457066,193230,true,4060198737,28,4064667189,4468452
1640457087,193230,true,4060198737,28,4064667189,4468452
1640457278,193228,true,4061010817,28,4066699930,5689113
1640459661,193227,true,4061416918,28,4080957603,19540685
1640460249,193226,true,4061823060,28,4080957603,19134543
1640461012,193227,true,4061416918,28,4080957603,19540685
1640461047,193225,true,4062229242,28,4080957603,18728361
1640462107,193223,true,4063041729,28,4080957603,17915874
1640465171,193223,true,4063041729,28,4080957603,17915874
1640465510,193224,true,4062635465,28,4080957603,18322138
1640465539,193223,true,4063041729,28,4081365699,18323970
1640465689,193221,true,4063854378,28,4082182012,18327634
1640465721,193221,true,4063854378,28,4082590231,18735853
1640466062,193221,true,4063854378,28,4085040397,21186019
1640466117,193219,true,4064667189,28,4085448901,20781712
1640466147,193218,true,4065073656,28,4085448901,20375245
1640466176,193218,true,4065073656,28,4085857446,20783790
1640466184,193218,true,4065073656,28,4085857446,20783790
1640466185,193217,true,4065480163,28,4085857446,20377283
1640466368,193215,true,4066293300,28,4087900784,21607484
1640466391,193214,true,4066699930,28,4088309574,21609644
1640466424,193214,true,4066699930,28,4088718405,22018475
1640466537,193212,true,4067513310,28,4090354137,22840827
1640466630,193210,true,4068326853,28,4091990524,23663671
1640466734,193210,true,4068326853,28,4093627566,25300713
1640466738,193209,true,4068733686,28,4093627566,24893880
1640466763,193207,true,4069547474,28,4094036929,24489455
1640466791,193204,true,4070768460,28,4094855777,24087317
1640467708,193203,true,4071175537,28,4111267181,40091644
1640467880,193202,true,4071582654,28,4113734558,42151904
1640467904,193200,true,4072397012,28,4114145931,41748919
1640468343,193198,true,4073211532,28,4119085623,45874091
1640468501,193197,true,4073618853,28,4120321472,46702619
1640468555,193195,true,4074433617,28,4120321472,45887855
1640469487,193192,true,4075656070,28,4125681105,50025035
1640469992,193190,true,4076471242,28,4127744358,51273116
1640470329,193189,true,4076878889,28,4128569948,51691059
1640470388,193187,true,4077694305,28,4128569948,50875643
1640470407,193185,true,4078509885,28,4128157132,49647247
1640471017,193183,true,4079325628,28,4124856092,45530464
1640471161,193183,true,4079325628,28,4123618883,44293255
1640471169,193181,true,4080141534,28,4123618883,43477349
1640471842,193180,true,4080549548,28,4117438400,36888852
1640471866,193178,true,4081365699,28,4117438400,36072701
1640471958,193177,true,4081773835,28,4116203416,34429581
1640472052,193176,true,4082182012,28,4114968802,32786790
1640472068,193175,true,4082590231,28,4114968802,32378571
1640473291,193174,true,4082998490,28,4102643009,19644519
1640475137,193173,true,4083406790,28,4096903615,13496825
1640475266,193172,true,4083815130,28,4096903615,13088485
1640477038,193170,true,4084631934,28,4096903615,12271681
1640478515,193169,true,4085040397,28,4096903615,11863218
1640479336,193168,true,4085448901,28,4096903615,11454714
1640479398,193167,true,4085857446,28,4096903615,11046169
1640479415,193165,true,4086674659,28,4096903615,10228956
1640479457,193164,true,4087083326,28,4096903615,9820289
1640480595,193164,true,4087083326,28,4091581366,4498040
1640483061,193163,true,4087492034,28,4088718405,1226371
1640483155,193161,true,4088309574,28,4089127276,817702
1640483599,193160,true,4088718405,28,4089127276,408871
1640483946,193160,true,4088718405,28,4089536189,817784
1640486011,193159,true,4089127276,28,4090354137,1226861
1640486080,193158,true,4089536189,28,4090354137,817948
1640486083,193157,true,4089945143,28,4090354137,408994
1640486152,193158,true,4089536189,28,4089945143,408954
1640486157,193157,true,4089945143,28,4089945143,0
1640486174,193157,true,4089945143,28,4089536189,-408954
1640486256,193157,true,4089945143,28,4089127276,-817867
1640486314,193157,true,4089945143,28,4088309574,-1635569
1640487118,193157,true,4089945143,28,4078917736,-11027407
1640487547,193157,true,4089945143,28,4073618853,-16326290
1640487634,193157,true,4089945143,28,4072804251,-17140892
1640487979,193158,true,4089536189,28,4069547474,-19988715
1640488238,193158,true,4089536189,28,4069140560,-20395629
1640488798,193158,true,4089536189,28,4068326853,-21209336
1640489812,193158,true,4089536189,28,4067106599,-22429590
1640489855,193159,true,4089127276,28,4066699930,-22427346
1640489936,193160,true,4088718405,28,4066293300,-22425105
1640489941,193160,true,4088718405,28,4066293300,-22425105
1640490012,193160,true,4088718405,28,4065886712,-22831693
1640490028,193162,true,4087900784,28,4065886712,-22014072
1640490048,193163,true,4087492034,28,4065480163,-22011871
1640490362,193164,true,4087083326,28,4061823060,-25260266
1640490387,193164,true,4087083326,28,4061416918,-25666408
1640490909,193166,true,4086266032,28,4051681692,-34584340
1640490945,193167,true,4085857446,28,4050871477,-34985969
1640491140,193168,true,4085448901,28,4047227515,-38221386
1640491218,193169,true,4085040397,28,4045609028,-39431369
1640491254,193170,true,4084631934,28,4044800028,-39831906
1640491268,193171,true,4084223512,28,4044800028,-39423484
1640491310,193173,true,4083406790,28,4043586830,-39819960
1640491500,193173,true,4083406790,28,4039545467,-43861323
1640491656,193175,true,4082590231,28,4035911693,-46678538
1640492822,193176,true,4082182012,28,4025835019,-56346993
1640494129,193178,true,4081365699,28,4024225087,-57140612
1640497455,193179,true,4080957603,28,4024225087,-56732516
1640498052,193180,true,4080549548,28,4024225087,-56324461
1640498870,193181,true,4080141534,28,4023420363,-56721171
1640499419,193182,true,4079733560,28,4024225087,-55508473
1640501327,193182,true,4079733560,28,4026640226,-53093334
1640501890,193183,true,4079325628,28,4026640226,-52685402
1640504008,193183,true,4079325628,28,4026640226,-52685402
1640504359,193184,true,4078917736,28,4026640226,-52277510
1640505546,193185,true,4078509885,28,4026640226,-51869659
1640506755,193186,true,4078102075,28,4027848339,-50253736
1640506941,193186,true,4078102075,28,4028251124,-49850951
1640506963,193187,true,4077694305,28,4028251124,-49443181
1640507016,193188,true,4077286577,28,4028251124,-49035453
1640507035,193188,true,4077286577,28,4028653949,-48632628
1640507095,193188,true,4077286577,28,4028653949,-48632628
1640507360,193190,true,4076471242,28,4030265652,-46205590
1640508656,193190,true,4076471242,28,4036718916,-39752326
1640509507,193191,true,4076063635,28,4037122587,-38941048
1640512114,193191,true,4076063635,28,4037122587,-38941048
1640516313,193193,true,4075248545,28,4041161527,-34087018
1640516402,193194,true,4074841061,28,4041161527,-33679534
1640516921,193195,true,4074433617,28,4041161527,-33272090
1640516953,193195,true,4074433617,28,4041565643,-32867974
1640517498,193196,true,4074026215,28,4042373997,-31652218
1640518022,193197,true,4073618853,28,4043586830,-30032023
1640518269,193198,true,4073211532,28,4043991189,-29220343
1640518850,193198,true,4073211532,28,4044800028,-28411504
1640518899,193199,true,4072804251,28,4044800028,-28004223
1640519217,193201,true,4071989813,28,4043991189,-27998624
1640519243,193202,true,4071582654,28,4043991189,-27591465
1640519290,193203,true,4071175537,28,4043991189,-27184348
1640519541,193205,true,4070361424,28,4041565643,-28795781
1640522493,193206,true,4069954428,28,4029056814,-40897614
1640522645,193207,true,4069547474,28,4029862666,-39684808
1640522978,193209,true,4068733686,28,4031071745,-37661941
1640523058,193210,true,4068326853,28,4031071745,-37255108
1640523253,193212,true,4067513310,28,4031878000,-35635310
1640523261,193213,true,4067106599,28,4032281188,-34825411
1640523287,193214,true,4066699930,28,4032281188,-34418742
1640523540,193216,true,4065886712,28,4033490993,-32395719
1640523824,193218,true,4065073656,28,4034701162,-30372494
1640527698,193220,true,4064260763,28,4037526300,-26734463
1640529769,193221,true,4063854378,28,4037526300,-26328078
1640529891,193223,true,4063041729,28,4037526300,-25515429
1640530065,193225,true,4062229242,28,4037526300,-24702942
1640530144,193227,true,4061416918,28,4037526300,-23890618
1640530483,193228,true,4061010817,28,4037526300,-23484517
1640530517,193230,true,4060198737,28,4037930052,-22268685
1640531014,193232,true,4059386819,28,4039141553,-20245266
1640531782,193234,true,4058575063,28,4041969800,-16605263
1640531808,193235,true,4058169247,28,4042373997,-15795250
1640532190,193237,true,4057357734,28,4044800028,-12557706
1640534471,193238,true,4056952039,28,4055329664,-1622375
1640534694,193240,true,4056140770,28,4055329664,-811106
1640534845,193241,true,4055735197,28,4055329664,-405533
1640535234,193243,true,4054924172,28,4055329664,405492
1640536324,193244,true,4054518720,28,4055329664,810944
1640536343,193246,true,4053707938,28,4055735197,2027259
1640537258,193246,true,4053707938,28,4059792758,6084820
1640537403,193248,true,4052897318,28,4060604757,7707439
1640538159,193249,true,4052492068,28,4063854378,11362310
1640539651,193250,true,4052086860,28,4063854378,11767518
1640539849,193250,true,4052086860,28,4064260763,12173903
1640540623,193252,true,4051276564,28,4065480163,14203599
1640540680,193252,true,4051276564,28,4065480163,14203599
1640543106,193252,true,4051276564,28,4067513310,16236746
1640546298,193253,true,4050871477,28,4072397012,21525535
1640547628,193254,true,4050466430,28,4072397012,21930582
1640548991,193254,true,4050466430,28,4072397012,21930582
1640550504,193255,true,4050061424,28,4072397012,22335588
1640550867,193255,true,4050061424,28,4072397012,22335588
1640552086,193256,true,4049656458,28,4072397012,22740554
1640552849,193256,true,4049656458,28,4072397012,22740554
1640552937,193256,true,4049656458,28,4072397012,22740554
1640552997,193256,true,4049656458,28,4072397012,22740554
1640553034,193258,true,4048846648,28,4072397012,23550364
1640553046,193258,true,4048846648,28,4072397012,23550364
1640553051,193258,true,4048846648,28,4072397012,23550364
1640553133,193259,true,4048441804,28,4071989813,23548009
1640553189,193260,true,4048037001,28,4071582654,23545653
1640553260,193260,true,4048037001,28,4071175537,23138536
1640553408,193260,true,4048037001,28,4069954428,21917427
1640554114,193261,true,4047632237,28,4064667189,17034952
1640554158,193262,true,4047227515,28,4064667189,17439674
1640554244,193261,true,4047632237,28,4064260763,16628526
1640554432,193262,true,4047227515,28,4063448033,16220518
1640554466,193261,true,4047632237,28,4063448033,15815796
1640554488,193262,true,4047227515,28,4063448033,16220518
1640554519,193262,true,4047227515,28,4063448033,16220518
1640554730,193261,true,4047632237,28,4064260763,16628526
1640554812,193260,true,4048037001,28,4064667189,16630188
1640555032,193261,true,4047632237,28,4067106599,19474362
1640555176,193260,true,4048037001,28,4069140560,21103559
1640555239,193259,true,4048441804,28,4069954428,21512624
1640555301,193259,true,4048441804,28,4070768460,22326656
1640555382,193259,true,4048441804,28,4071989813,23548009
1640555414,193258,true,4048846648,28,4072397012,23550364
1640555487,193257,true,4049251533,28,4073618853,24367320
1640555554,193256,true,4049656458,28,4074841061,25184603
1640557713,193255,true,4050061424,28,4090763173,40701749
1640560046,193254,true,4050466430,28,4090763173,40296743
1640560559,193252,true,4051276564,28,4090763173,39486609
1640560723,193251,true,4051681692,28,4090763173,39081481
1640560910,193250,true,4052086860,28,4090763173,38676313
1640561172,193249,true,4052492068,28,4089536189,37044121
1640561317,193248,true,4052897318,28,4088718405,35821087
1640561704,193247,true,4053302607,28,4085857446,32554839
1640562544,193246,true,4053707938,28,4079325628,25617690
1640565749,193245,true,4054113308,28,4076471242,22357934
1640566053,193243,true,4054924172,28,4076471242,21547070
1640566442,193242,true,4055329664,28,4076063635,20733971
1640566581,193242,true,4055329664,28,4075656070,20326406
1640566906,193240,true,4056140770,28,4075248545,19107775
1640567049,193239,true,4056546385,28,4074841061,18294676
1640567461,193238,true,4056952039,28,4072804251,15852212
1640567569,193237,true,4057357734,28,4072397012,15039278
1640567654,193236,true,4057763470,28,4071989813,14226343
1640567805,193235,true,4058169247,28,4071175537,13006290
1640571242,193235,true,4058169247,28,4064260763,6091516
1640571330,193234,true,4058575063,28,4064260763,5685700
1640572630,193233,true,4058980921,28,4064260763,5279842
1640572795,193232,true,4059386819,28,4064667189,5280370
1640573348,193231,true,4059792758,28,4065886712,6093954
1640573718,193231,true,4059792758,28,4066699930,6907172
1640573797,193230,true,4060198737,28,4066699930,6501193
1640573966,193228,true,4061010817,28,4067513310,6502493
1640574196,193228,true,4061010817,28,4067920061,6909244
1640575472,193228,true,4061010817,28,4069954428,8943611
1640575530,193227,true,4061416918,28,4070361424,8944506
1640576222,193225,true,4062229242,28,4071989813,9760571
1640576564,193225,true,4062229242,28,4072804251,10575009
1640578289,193225,true,4062229242,28,4074433617,12204375
1640579359,193224,true,4062635465,28,4074433617,11798152
1640583878,193222,true,4063448033,28,4074433617,10985584
1640584177,193222,true,4063448033,28,4074433617,10985584
1640584433,193222,true,4063448033,28,4074433617,10985584
1640585584,193221,true,4063854378,28,4074433617,10579239
1640586239,193220,true,4064260763,28,4073618853,9358090
1640586554,193220,true,4064260763,28,4073211532,8950769
1640586651,193219,true,4064667189,28,4073211532,8544343
1640588269,193218,true,4065073656,28,4070768460,5694804
1640589507,193217,true,4065480163,28,4070361424,4881261
1640590492,193217,true,4065480163,28,4070361424,4881261
1640591191,193216,true,4065886712,28,4069140560,3253848
1640591394,193215,true,4066293300,28,4068733686,2440386
1640591433,193214,true,4066699930,28,4068733686,2033756
1640592149,193214,true,4066699930,28,4066293300,-406630
1640592861,193213,true,4067106599,28,4064667189,-2439410
1640594312,193212,true,4067513310,28,4063854378,-3658932
1640594843,193211,true,4067920061,28,4063854378,-4065683
1640595115,193211,true,4067920061,28,4063448033,-4472028
1640595347,193211,true,4067920061,28,4063041729,-4878332
1640595404,193210,true,4068326853,28,4062635465,-5691388
1640595430,193209,true,4068733686,28,4062635465,-6098221
1640595432,193210,true,4068326853,28,4062635465,-5691388
1640595435,193209,true,4068733686,28,4062635465,-6098221
1640596049,193209,true,4068733686,28,4057357734,-11375952
1640598238,193208,true,4069140560,28,4048441804,-20698756
1640598383,193209,true,4068733686,28,4048441804,-20291882
1640598394,193208,true,4069140560,28,4048441804,-20698756
1640599051,193209,true,4068733686,28,4048441804,-20291882
1640599298,193208,true,4069140560,28,4048441804,-20698756
1640599754,193208,true,4069140560,28,4048441804,-20698756
1640603162,193208,true,4069140560,28,4050466430,-18674130
1640603199,193209,true,4068733686,28,4050871477,-17862209
1640603357,193208,true,4069140560,28,4050871477,-18269083
1640603597,193209,true,4068733686,28,4050871477,-17862209
1640608163,193208,true,4069140560,28,4054518720,-14621840
1640608182,193209,true,4068733686,28,4054924172,-13809514
1640608197,193208,true,4069140560,28,4054924172,-14216388
1640608217,193209,true,4068733686,28,4054924172,-13809514
1640608235,193208,true,4069140560,28,4054924172,-14216388
1640608251,193209,true,4068733686,28,4054924172,-13809514
1640608281,193209,true,4068733686,28,4054924172,-13809514
1640608293,193209,true,4068733686,28,4055329664,-13404022
1640608437,193208,true,4069140560,28,4056140770,-12999790
1640608465,193209,true,4068733686,28,4056546385,-12187301
1640608507,193208,true,4069140560,28,4056952039,-12188521
1640608514,193209,true,4068733686,28,4056952039,-11781647
1640608549,193208,true,4069140560,28,4057357734,-11782826
1640608640,193209,true,4068733686,28,4058575063,-10158623
1640608822,193208,true,4069140560,28,4061010817,-8129743
1640608881,193209,true,4068733686,28,4061823060,-6910626
1640609865,193207,true,4069547474,28,4076063635,6516161
1640611042,193208,true,4069140560,28,4080549548,11408988
1640611540,193207,true,4069547474,28,4080549548,11002074
1640611817,193208,true,4069140560,28,4080549548,11408988
1640613139,193206,true,4069954428,28,4083815130,13860702
1640613895,193207,true,4069547474,28,4084631934,15084460
1640615180,193206,true,4069954428,28,4087083326,17128898
1640617237,193206,true,4069954428,28,4088309574,18355146
1640617302,193204,true,4070768460,28,4088718405,17949945
1640617328,193204,true,4070768460,28,4088718405,17949945
1640617559,193203,true,4071175537,28,4089945143,18769606
1640617576,193203,true,4071175537,28,4089945143,18769606
1640618094,193200,true,4072397012,28,4093627566,21230554
1640620129,193201,true,4071989813,28,4101412463,29422650
1640620208,193200,true,4072397012,28,4101412463,29015451
1640621528,193199,true,4072804251,28,4101002362,28198111
1640621848,193197,true,4073618853,28,4101002362,27383509
1640622276,193198,true,4073211532,28,4100182285,26970753
1640622484,193198,true,4073211532,28,4099772308,26560776
1640624769,193198,true,4073211532,28,4094855777,21644245
1640625871,193196,true,4074026215,28,4098952476,24926261
1640625975,193197,true,4073618853,28,4099772308,26153455
1640626646,193196,true,4074026215,28,4103873925,29847710
1640626897,193196,true,4074026215,28,4105105211,31078996
1640627048,193194,true,4074841061,28,4105515721,30674660
1640627214,193195,true,4074433617,28,4106336865,31903248
1640627921,193194,true,4074841061,28,4109623085,34782024
1640628035,193194,true,4074841061,28,4109623085,34782024
1640629462,193192,true,4075656070,28,4112500684,36844614
1640630028,193193,true,4075248545,28,4112500684,37252139
1640632194,193192,true,4075656070,28,4108390444,32734374
1640632762,193192,true,4075656070,28,4108390444,32734374
1640633302,193190,true,4076471242,28,4106747499,30276257
1640633475,193191,true,4076063635,28,4105515721,29452086
1640633564,193191,true,4076063635,28,4105105211,29041576
1640633586,193191,true,4076063635,28,4105105211,29041576
1640633836,193189,true,4076878889,28,4102643009,25764120
1640633961,193190,true,4076471242,28,4101822604,25351362
1640634424,193189,true,4076878889,28,4097313305,20434416
1640634507,193189,true,4076878889,28,4096903615,20024726
1640637522,193188,true,4077286577,28,4091990524,14703947
1640637737,193188,true,4077286577,28,4091990524,14703947
1640639490,193188,true,4077286577,28,4088309574,11022997
1640641696,193188,true,4077286577,28,4087900784,10614207
1640642034,193186,true,4078102075,28,4087492034,9389959
1640642040,193187,true,4077694305,28,4087492034,9797729
1640642134,193186,true,4078102075,28,4087083326,8981251
1640642227,193186,true,4078102075,28,4086266032,8163957
1640642379,193185,true,4078509885,28,4085448901,6939016
1640642399,193186,true,4078102075,28,4085040397,6938322
1640642485,193185,true,4078509885,28,4084223512,5713627
1640642520,193185,true,4078509885,28,4084223512,5713627
1640642532,193185,true,4078509885,28,4083815130,5305245
1640644261,193185,true,4078509885,28,4071175537,-7334348
1640644871,193185,true,4078509885,28,4070768460,-7741425
1640645057,193185,true,4078509885,28,4070768460,-7741425
1640645131,193184,true,4078917736,28,4070768460,-8149276
1640645159,193185,true,4078509885,28,4070768460,-7741425
1640645182,193185,true,4078509885,28,4070768460,-7741425
1640645237,193186,true,4078102075,28,4070768460,-7333615
1640645264,193185,true,4078509885,28,4070361424,-8148461
1640647158,193186,true,4078102075,28,4060198737,-17903338
1640647216,193187,true,4077694305,28,4060198737,-17495568
1640647296,193187,true,4077694305,28,4060198737,-17495568
1640647408,193187,true,4077694305,28,4059792758,-17901547
1640647421,193188,true,4077286577,28,4059792758,-17493819
1640647506,193188,true,4077286577,28,4059386819,-17899758
1640648475,193189,true,4076878889,28,4055329664,-21549225
1640649511,193189,true,4076878889,28,4050061424,-26817465
1640649630,193190,true,4076471242,28,4050061424,-26409818
1640649722,193190,true,4076471242,28,4049656458,-26814784
1640649762,193191,true,4076063635,28,4049251533,-26812102
1640649775,193191,true,4076063635,28,4049251533,-26812102
1640649930,193192,true,4075656070,28,4048037001,-27619069
1640650037,193193,true,4075248545,28,4047227515,-28021030
1640650052,193193,true,4075248545,28,4047227515,-28021030
1640650174,193193,true,4075248545,28,4046013589,-29234956
1640650685,193195,true,4074433617,28,4040353416,-34080201
1640650733,193195,true,4074433617,28,4039949421,-34484196
1640650912,193196,true,4074026215,28,4037526300,-36499915
1640651669,193196,true,4074026215,28,4027848339,-46177876
1640651692,193198,true,4073211532,28,4027848339,-45363193
1640651974,193199,true,4072804251,28,4025029972,-47774279
1640652427,193200,true,4072397012,28,4021409256,-50987756
1640652464,193200,true,4072397012,28,4021409256,-50987756
1640654139,193201,true,4071989813,28,4022213578,-49776235
1640654297,193201,true,4071989813,28,4021811397,-50178416
1640655542,193202,true,4071582654,28,4018193576,-53389078
1640655546,193203,true,4071175537,28,4018193576,-52981961
1640655615,193204,true,4070768460,28,4017390058,-53378402
1640655641,193204,true,4070768460,28,4016988359,-53780101
1640655742,193206,true,4069954428,28,4015783503,-54170925
1640655900,193207,true,4069547474,28,4013374876,-56172598
1640655911,193208,true,4069140560,28,4013374876,-55765684
1640657693,193209,true,4068733686,28,3990564850,-78168836
1640657979,193211,true,4067920061,28,3990165834,-77754227
1640658063,193213,true,4067106599,28,3990165834,-76940765
1640658949,193214,true,4066699930,28,3986975137,-79724793
1640659231,193216,true,4065886712,28,3984982247,-80904465
1640659737,193218,true,4065073656,28,3980601396,-84472260
1640659919,193220,true,4064260763,28,3979009553,-85251210
1640660954,193222,true,4063448033,28,3972648546,-90799487
1640661077,193224,true,4062635465,28,3971854136,-90781329
1640661088,193226,true,4061823060,28,3971854136,-89968924
1640661103,193228,true,4061010817,28,3971456990,-89553827
1640661108,193231,true,4059792758,28,3971456990,-88335768
1640661127,193233,true,4058980921,28,3971456990,-87523931
1640661185,193237,true,4057357734,28,3970662818,-86694916
1640661244,193239,true,4056546385,28,3969868804,-86677581
1640661294,193242,true,4055329664,28,3969074949,-86254715
1640663057,193245,true,4054113308,28,3950069988,-104043320
1640663230,193248,true,4052897318,28,3949675021,-103222297
1640664832,193251,true,4051681692,28,3949675021,-102006671
1640664911,193254,true,4050466430,28,3949675021,-100791409
1640665019,193256,true,4049656458,28,3949280093,-100376365
1640665106,193260,true,4048037001,28,3948490355,-99546646
1640665118,193263,true,4046822832,28,3948490355,-98332477
1640665121,193267,true,4045204508,28,3948490355,-96714153
1640665187,193270,true,4043991189,28,3947306045,-96685144
1640665202,193274,true,4042373997,28,3947306045,-95067952
1640665233,193278,true,4040757452,28,3946516702,-94240750
1640665279,193282,true,4039141553,28,3945727517,-93414036
1640665281,193286,true,4037526300,28,3945727517,-91798783
1640665474,193290,true,4035911693,28,3941783959,-94127734
1640665538,193295,true,4033894342,28,3940601660,-93292682
1640665652,193299,true,4032281188,28,3937844342,-94436846
1640666085,193303,true,4030668679,28,3928012518,-102656161
1640666141,193308,true,4028653949,28,3926441706,-102212243
1640666649,193312,true,4027042890,28,3913506450,-113536440
1640666893,193316,true,4025432475,28,3908422451,-117010024
1640667057,193320,true,4023822705,28,3906859472,-116963233
1640667113,193325,true,4021811397,28,3906859472,-114951925
1640667171,193329,true,4020203074,28,3906468826,-113734248
1640669527,193333,true,4018595395,28,3908813293,-109782102
1640670044,193337,true,4016988359,28,3908813293,-108175066
1640670317,193342,true,4014980467,28,3908813293,-106167174
1640670469,193347,true,4012973579,28,3908813293,-104160286
1640670671,193351,true,4011368791,28,3909204174,-102164617
1640672459,193355,true,4009764644,28,3914289190,-95475454
1640672792,193360,true,4007760363,28,3914680619,-93079744
1640672912,193364,true,4006157660,28,3914680619,-91477041
1640672993,193368,true,4004555597,28,3914680619,-89874978
1640673145,193372,true,4002954175,28,3915072087,-87882088
1640673349,193377,true,4000953299,28,3916246726,-84706573
1640676033,193381,true,3999353317,28,3922909674,-76443643
1640676077,193385,true,3997753976,28,3922909674,-74844302
1640676236,193388,true,3996554889,28,3922909674,-73645215
1640676286,193392,true,3994956667,28,3922909674,-72046993
1640678611,193397,true,3992959788,28,3917030015,-75929773
1640679126,193400,true,3991762139,28,3916246726,-75515413
1640679319,193404,true,3990165834,28,3916246726,-73919108
1640679465,193408,true,3988570166,28,3916638351,-71931815
1640679501,193412,true,3986975137,28,3916638351,-70336786
1640680648,193416,true,3985380746,28,3919772758,-65607988
1640682466,193419,true,3984185370,28,3920948808,-63236562
1640683274,193423,true,3982592095,28,3920948808,-61643287
1640683289,193427,true,3980999456,28,3920948808,-60050648
1640683299,193431,true,3979407454,28,3920948808,-58458646
1640683374,193434,true,3978213871,28,3920948808,-57265063
1640683573,193438,true,3976622983,28,3920556752,-56066231
1640683811,193442,true,3975032731,28,3919772758,-55259973
1640684580,193445,true,3973840460,28,3915855141,-57985319
1640684608,193448,true,3972648546,28,3915463594,-57184952
1640685196,193452,true,3971059884,28,3910768091,-60291793
1640689188,193457,true,3969074949,28,3899443857,-69631092
1640690535,193460,true,3967884465,28,3899443857,-68440608
1640690558,193463,true,3966694338,28,3899833802,-66860536
1640690629,193468,true,3964711585,28,3899833802,-64877783
1640690674,193472,true,3963126097,28,3899833802,-63292295
1640691316,193475,true,3961937397,28,3902954761,-58982636
1640691676,193478,true,3960749054,28,3904906629,-55842425
1640691740,193482,true,3959165150,28,3905297119,-53868031
1640691860,193486,true,3957581880,28,3905687649,-51894231
1640692439,193489,true,3956394843,28,3908813293,-47581550
1640692669,193491,true,3955603682,28,3909204174,-46399508
1640692694,193495,true,3954021836,28,3909204174,-44817662
1640692734,193500,true,3952045418,28,3909204174,-42841244
1640694763,193501,true,3951650253,28,3913506450,-38143803
1640695637,193504,true,3950464995,28,3916638351,-33826644
1640697034,193508,true,3948885204,28,3919380820,-29504384
1640698635,193512,true,3947306045,28,3918597062,-28708983
1640699753,193513,true,3946911354,28,3918205241,-28706113
1640700201,193516,true,3945727517,28,3918205241,-27522276
1640700364,193519,true,3944544036,28,3918205241,-26338795
1640700448,193523,true,3942966612,28,3917813460,-25153152
1640701243,193525,true,3942178137,28,3914289190,-27888947
1640701803,193527,true,3941389820,28,3910377053,-31012767
1640702325,193531,true,3939813658,28,3907640883,-32172775
1640702331,193535,true,3938238127,28,3907640883,-30597244
1640702360,193536,true,3937844342,28,3907640883,-30203459
1640702469,193539,true,3936663225,28,3905687649,-30975576
1640702656,193544,true,3934695484,28,3902564504,-32130980
1640702687,193548,true,3933121999,28,3902174287,-30947712
1640702734,193549,true,3932728726,28,3901393969,-31334757
1640702737,193552,true,3931549143,28,3901393969,-30155174
1640703319,193555,true,3930369915,28,3899443857,-30926058
1640703533,193558,true,3929191039,28,3898664086,-30526953
1640703629,193560,true,3928405319,28,3898664086,-29741233
1640703675,193562,true,3927619756,28,3898664086,-28955670
1640705421,193565,true,3926441706,28,3909595095,-16846611
1640707036,193568,true,3925264009,28,3909986054,-15277955
1640707328,193569,true,3924871521,28,3909986054,-14885467
1640707357,193572,true,3923694295,28,3909986054,-13708241
1640707384,193574,true,3922909674,28,3909986054,-12923620
1640707604,193577,true,3921733037,28,3908813293,-12919744
1640707661,193578,true,3921340903,28,3908422451,-12918452
1640707702,193580,true,3920556752,28,3908031648,-12525104
1640707785,193582,true,3919772758,28,3907250158,-12522600
1640707958,193586,true,3918205241,28,3905297119,-12908122
1640707985,193587,true,3917813460,28,3904906629,-12906831
1640707996,193589,true,3917030015,28,3904906629,-12123386
1640708081,193591,true,3916246726,28,3903345056,-12901670
1640708550,193595,true,3914680619,28,3893988728,-20691891
1640708559,193596,true,3914289190,28,3893988728,-20300462
1640708571,193598,true,3913506450,28,3893599368,-19907082
1640708582,193599,true,3913115138,28,3893210047,-19905091
1640708592,193604,true,3911159167,28,3893210047,-17949120
1640708598,193605,true,3910768091,28,3892820765,-17947326
1640708626,193606,true,3910377053,28,3892042318,-18334735
1640708693,193608,true,3909595095,28,3890096880,-19498215
1640708851,193613,true,3907640883,28,3885431797,-22209086
1640708855,193613,true,3907640883,28,3885431797,-22209086
1640709211,193615,true,3906859472,28,3873018907,-33840565
1640710422,193617,true,3906078218,28,3851776834,-54301384
1640710456,193622,true,3904125764,28,3851391695,-52734069
1640710512,193622,true,3904125764,28,3851391695,-52734069
1640710522,193624,true,3903345056,28,3851391695,-51953361
1640710765,193626,true,3902564504,28,3851776834,-50787670
1640711391,193630,true,3901003869,28,3852932483,-48071386
1640711591,193630,true,3901003869,28,3853317776,-47686093
1640711645,193632,true,3900223785,28,3853317776,-46906009
1640711722,193632,true,3900223785,28,3853317776,-46906009
1640711854,193636,true,3898664086,28,3852932483,-45731603
1640711857,193636,true,3898664086,28,3852932483,-45731603
1640712058,193638,true,3897884470,28,3851006594,-46877876
1640712070,193639,true,3897494720,28,3851006594,-46488126
1640712147,193643,true,3895936112,28,3850236509,-45699603
1640712204,193644,true,3895546557,28,3849466577,-46079980
1640712533,193646,true,3894767565,28,3844465772,-50301793
1640712571,193647,true,3894378127,28,3843696994,-50681133
1640712704,193651,true,3892820765,28,3841007482,-51813283
1640712855,193652,true,3892431522,28,3837168586,-55262936
1640712985,193655,true,3891264026,28,3832950232,-58313794
1640713058,193656,true,3890874939,28,3830651267,-60223672
1640713109,193661,true,3888930085,28,3829119389,-59810696
1640713489,193662,true,3888541230,28,3815741565,-72799665
1640714140,193665,true,3887374901,28,3803551316,-83823585
1640714354,193666,true,3886986203,28,3801650111,-85336092
1640714814,193670,true,3885431797,28,3803931671,-81500126
1640714830,193672,true,3884654827,28,3803931671,-80723156
1640714873,193674,true,3883878013,28,3804312064,-79565949
1640714887,193675,true,3883489664,28,3804312064,-79177600
1640716229,193681,true,3881160385,28,3805072965,-76087420
1640716538,193682,true,3880772308,28,3802790720,-77981588
1640716883,193685,true,3879608309,28,3802410479,-77197830
1640717040,193686,true,3879220387,28,3802410479,-76809908
1640717616,193692,true,3876893669,28,3803170999,-73722670
1640718193,193693,true,3876506019,28,3802410479,-74095540
1640718306,193696,true,3875343299,28,3802030276,-73313023
1640718427,193697,true,3874955804,28,3801269984,-73685820
1640718489,193703,true,3872631644,28,3800509844,-72121800
1640718490,193705,true,3871857234,28,3800509844,-71347390
1640718573,193708,true,3870695909,28,3799369919,-71325990
1640719185,193711,true,3869534932,28,3788747093,-80787839
1640719332,193716,true,3867600745,28,3786474640,-81126105
1640719407,193719,true,3866440697,28,3785338925,-81101772
1640719428,193722,true,3865280997,28,3784960429,-80320568
1640719691,193724,true,3864508056,28,3781933823,-82574233
1640719972,193729,true,3862576382,28,3778531784,-84044598
1640720030,193732,true,3861417841,28,3778153968,-83263873
1640720557,193735,true,3860259647,28,3778531784,-81727863
1640720659,193736,true,3859873660,28,3779665457,-80208203
1640720851,193741,true,3857944302,28,3781555667,-76388635
1640720921,193743,true,3857172828,28,3782312016,-74860812
1640720939,193746,true,3856015908,28,3782690247,-73325661
1640722492,193747,true,3855630345,28,3800889895,-54740450
1640722522,193751,true,3854088478,28,3801269984,-52818494
1640722854,193752,true,3853703108,28,3803170999,-50532109
1640722902,193755,true,3852547228,28,3803170999,-49376229
1640722950,193755,true,3852547228,28,3803551316,-48995912
1640722986,193759,true,3851006594,28,3803551316,-47455278
1640723583,193761,true,3850236509,28,3805834018,-44402491
1640723854,193764,true,3849081669,28,3806975882,-42105787
1640724097,193764,true,3849081669,28,3808498901,-40582768
1640724123,193768,true,3847542421,28,3808879751,-38662670
1640724273,193770,true,3846773028,28,3810784571,-35988457
1640724344,193773,true,3845619227,28,3811546766,-34072461
1640724364,193772,true,3846003789,28,3811546766,-34457023
1640724483,193776,true,3844465772,28,3813071614,-31394158
1640724596,193778,true,3843696994,28,3814597071,-29099923
1640725025,193780,true,3842928370,28,3819940980,-22987390
1640727776,193780,true,3842928370,28,3829885251,-13043119
1640728068,193784,true,3841391582,28,3829502301,-11889281
1640728114,193786,true,3840623419,28,3829502301,-11121118
1640729563,193789,true,3839471463,28,3820322974,-19148489
1640729634,193789,true,3839471463,28,3819559024,-19912439
1640729652,193793,true,3837936058,28,3819559024,-18377034
1640729670,193795,true,3837168586,28,3819177106,-17991480
1640729715,193798,true,3836017666,28,3818413385,-17604281
1640730151,193799,true,3835634102,28,3813071614,-22562488
1640730828,193803,true,3834100232,28,3806214601,-27885631
1640732013,193805,true,3833333527,28,3800129831,-33203696
1640732506,193808,true,3832183757,28,3802030276,-30153481
1640733064,193807,true,3832566975,28,3804312064,-28254911
1640733295,193811,true,3831034332,28,3805072965,-25961367
1640733475,193812,true,3830651267,28,3804692496,-25958771
1640733588,193815,true,3829502301,28,3804692496,-24809805
1640734230,193816,true,3829119389,28,3803931671,-25187718
1640734264,193820,true,3827588124,28,3803931671,-23656453
1640736291,193821,true,3827205404,28,3803931671,-23273733
1640736668,193824,true,3826057472,28,3802790720,-23266752
1640736820,193825,true,3825674904,28,3802790720,-22884184
1640738374,193829,true,3824145017,28,3808879751,-15265266
1640738754,193830,true,3823762640,28,3809260639,-14502001
1640739956,193834,true,3822233518,28,3806595222,-15638296
1640740046,193835,true,3821851332,28,3806595222,-15256110
1640740055,193839,true,3820322974,28,3806595222,-13727752
1640740087,193839,true,3820322974,28,3806595222,-13727752
1640740122,193842,true,3819177106,28,3806595222,-12581884
1640740497,193843,true,3818795227,28,3807737315,-11057912
1640740717,193846,true,3817649817,28,3808498901,-9150916
1640741392,193846,true,3817649817,28,3811165650,-6484167
1640741591,193849,true,3816504751,28,3812309114,-4195637
1640742409,193850,true,3816123139,28,3811546766,-4576373
1640743814,193852,true,3815360029,28,3808498901,-6861128
1640744570,193853,true,3814978531,28,3808498901,-6479630
1640744995,193855,true,3814215650,28,3808118089,-6097561
1640746415,193856,true,3813834266,28,3808118089,-5716177
1640747152,193858,true,3813071614,28,3808118089,-4953525
1640748091,193858,true,3813071614,28,3810403531,-2668083
1640750396,193860,true,3812309114,28,3818031582,5722468
1640751220,193860,true,3812309114,28,3818031582,5722468
1640751277,193862,true,3811546766,28,3818031582,6484816
1640752401,193862,true,3811546766,28,3818031582,6484816
1640752774,193863,true,3811165650,28,3817268090,6102440
1640753068,193863,true,3811165650,28,3816886402,5720752
1640753145,193865,true,3810403531,28,3816504751,6101220
1640755010,193866,true,3810022529,28,3800129831,-9892698
1640755409,193868,true,3809260639,28,3800129831,-9130808
1640756745,193868,true,3809260639,28,3800129831,-9130808
1640757184,193870,true,3808498901,28,3797091095,-11407806
1640757256,193871,true,3808118089,28,3796711424,-11406665
1640759849,193873,true,3807356580,28,3793675421,-13681159
1640760026,193874,true,3806975882,28,3794434194,-12541688
1640762939,193875,true,3806595222,28,3798230336,-8364886
1640765131,193876,true,3806214601,28,3797850551,-8364050
1640767374,193877,true,3805834018,28,3797850551,-7983467
1640769121,193878,true,3805453472,28,3797850551,-7602921
1640769434,193879,true,3805072965,28,3797850551,-7222414
1640769453,193880,true,3804692496,28,3797850551,-6841945
1640769677,193880,true,3804692496,28,3795952195,-8740301
1640769913,193881,true,3804312064,28,3793675421,-10636643
1640770504,193883,true,3803551316,28,3787610696,-15940620
1640771241,193883,true,3803551316,28,3780799470,-22751846
1640771264,193883,true,3803551316,28,3780799470,-22751846
1640771355,193884,true,3803170999,28,3781177550,-21993449
1640771382,193885,true,3802790720,28,3781177550,-21613170
1640771414,193884,true,3803170999,28,3781177550,-21993449
1640771421,193884,true,3803170999,28,3781555667,-21615332
1640771437,193885,true,3802790720,28,3781555667,-21235053
1640771678,193885,true,3802790720,28,3784960429,-17830291
1640774741,193884,true,3803170999,28,3811165650,7994651
1640775023,193884,true,3803170999,28,3810403531,7232532
1640775052,193885,true,3802790720,28,3810403531,7612811
1640776483,193884,true,3803170999,28,3802410479,-760520
1640776819,193884,true,3803170999,28,3801269984,-1901015
1640776962,193884,true,3803170999,28,3800509844,-2661155
1640777121,193885,true,3802790720,28,3800129831,-2660889
1640777803,193885,true,3802790720,28,3796331790,-6458930
1640778640,193885,true,3802790720,28,3792158330,-10632390
1640779629,193885,true,3802790720,28,3790641846,-12148874
1640779673,193886,true,3802410479,28,3790641846,-11768633
1640779711,193885,true,3802790720,28,3790262819,-12527901
1640779746,193885,true,3802790720,28,3789883831,-12906889
1640779938,193887,true,3802030276,28,3786853288,-15176988
1640779960,193887,true,3802030276,28,3786474640,-15555636
1640779969,193886,true,3802410479,28,3786096031,-16314448
1640780183,193886,true,3802410479,28,3781177550,-21232929
1640780393,193889,true,3801269984,28,3776643084,-24626900
1640780424,193889,true,3801269984,28,3775887869,-25382115
1640780769,193889,true,3801269984,28,3766837056,-34432928
1640780898,193890,true,3800889895,28,3763448597,-37441298
1640780922,193892,true,3800129831,28,3762696020,-37433811
1640781020,193893,true,3799749856,28,3760063186,-39686670
1640781240,193894,true,3799369919,28,3753676828,-45693091
1640782428,193894,true,3799369919,28,3737571474,-61798445
1640783861,193898,true,3797850551,28,3736076820,-61773731
1640784042,193899,true,3797470804,28,3736076820,-61393984
1640784072,193900,true,3797091095,28,3736076820,-61014275
1640784112,193901,true,3796711424,28,3736076820,-60634604
1640784142,193904,true,3795572638,28,3735703249,-59869389
1640784335,193908,true,3794054788,28,3733462612,-60592176
1640784450,193909,true,3793675421,28,3732342797,-61332624
1640784562,193910,true,3793296091,28,3730850233,-62445858
1640784581,193913,true,3792158330,28,3730850233,-61308097
1640784765,193917,true,3790641846,28,3727866895,-62774951
1640785407,193919,true,3789883831,28,3715957382,-73926449
1640785560,193920,true,3789504881,28,3713728588,-75776293
1640785568,193924,true,3787989457,28,3713728588,-74260869
1640785766,193928,true,3786474640,28,3711501130,-74973510
1640785888,193929,true,3786096031,28,3710758941,-75337090
1640785898,193930,true,3785717459,28,3710758941,-74958518
1640785964,193935,true,3783825168,28,3710758941,-73066227
1640785988,193938,true,3782690247,28,3711130017,-71560230
1640786040,193938,true,3782690247,28,3711872280,-70817967
1640786106,193939,true,3782312016,28,3712614692,-69697324
1640786175,193942,true,3781177550,28,3713728588,-67448962
1640786963,193944,true,3780421427,28,3735329716,-45091711
1640787007,193944,true,3780421427,28,3736824072,-43597355
1640787424,193945,true,3780043423,28,3749175343,-30868080
1640788094,193947,true,3779287528,28,3757807938,-21479590
1640788373,193948,true,3778909637,28,3756680821,-22228816
1640788407,193948,true,3778909637,28,3756680821,-22228816
1640788437,193949,true,3778531784,28,3756680821,-21850963
1640788473,193952,true,3777398451,28,3757056489,-20341962
1640788648,193952,true,3777398451,28,3758183719,-19214732
1640788866,193952,true,3777398451,28,3759687218,-17711233
1640790483,193952,true,3777398451,28,3779287528,1889077
1640792467,193954,true,3776643084,28,3780799470,4156386
1640793050,193954,true,3776643084,28,3781177550,4534466
1640793254,193954,true,3776643084,28,3781933823,5290739
1640793302,193954,true,3776643084,28,3781933823,5290739
1640793543,193956,true,3775887869,28,3783068517,7180648
1640794756,193955,true,3776265458,28,3789504881,13239423
1640795393,193955,true,3776265458,28,3790262819,13997361
1640795872,193956,true,3775887869,28,3790262819,14374950
1640795964,193958,true,3775132805,28,3790262819,15130014
1640796045,193957,true,3775510318,28,3790262819,14752501
1640797254,193957,true,3775510318,28,3786096031,10585713
1640798725,193958,true,3775132805,28,3783825168,8692363
1640799126,193960,true,3774377891,28,3783825168,9447277
1640799131,193960,true,3774377891,28,3783825168,9447277
1640799660,193960,true,3774377891,28,3779665457,5287566
1640800243,193961,true,3774000491,28,3775132805,1132314
1640800321,193964,true,3772868518,28,3774377891,1509373
1640801138,193964,true,3772868518,28,3766083802,-6784716
1640801812,193964,true,3772868518,28,3763448597,-9419921
1640801929,193966,true,3772114057,28,3763072290,-9041767
1640802782,193968,true,3771359748,28,3762319788,-9039960
1640803010,193968,true,3771359748,28,3762319788,-9039960
1640803053,193969,true,3770982649,28,3762696020,-8286629
1640803783,193970,true,3770605589,28,3762696020,-7909569
1640803896,193973,true,3769474633,28,3762696020,-6778613
1640804890,193973,true,3769474633,28,3760439193,-9035440
1640804910,193974,true,3769097723,28,3760439193,-8658530
1640805153,193976,true,3768344017,28,3759311287,-9032730
1640805531,193979,true,3767213740,28,3756680821,-10532919
1640806431,193980,true,3766837056,28,3750300208,-16536848
1640806527,193980,true,3766837056,28,3749175343,-17661713
1640806610,193981,true,3766460410,28,3748425620,-18034790
1640806689,193984,true,3765330698,28,3747676047,-17654651
1640806884,193986,true,3764577745,28,3744679255,-19898490
1640808125,193987,true,3764201325,28,3731223318,-32978007
1640808159,193988,true,3763824942,28,3730850233,-32974709
1640808484,193991,true,3762696020,28,3728239682,-34456338
1640808787,193992,true,3762319788,28,3727494146,-34825642
1640808860,193994,true,3761567437,28,3727494146,-34073291
1640808866,193994,true,3761567437,28,3727494146,-34073291
1640809315,193998,true,3760063186,28,3727121434,-32941752
1640809685,193999,true,3759687218,28,3726748759,-32938459
1640809804,194000,true,3759311287,28,3727121434,-32189853
1640809917,194001,true,3758935393,28,3727494146,-31441247
1640811321,194002,true,3758559537,28,3750300208,-8259329
1640811440,194002,true,3758559537,28,3752175733,-6383804
1640811784,194003,true,3758183719,28,3754427601,-3756118
1640811862,194004,true,3757807938,28,3753676828,-4131110
1640811993,194005,true,3757432195,28,3752175733,-5256462
1640812207,194006,true,3757056489,28,3749925215,-7131274
1640812260,194007,true,3756680821,28,3749175343,-7505478
1640812295,194009,true,3755929597,28,3748425620,-7503977
1640812305,194011,true,3755178524,28,3748425620,-6752904
1640812530,194012,true,3754803044,28,3744304825,-10498219
1640813018,194016,true,3753301498,28,3731969600,-21331898
1640813640,194018,true,3752550950,28,3719675012,-32875938
1640813978,194020,true,3751800553,28,3716328978,-35471575
1640816615,194021,true,3751425410,28,3715957382,-35468028
1640816646,194024,true,3750300208,28,3716328978,-33971230
1640816812,194026,true,3749550260,28,3717072281,-32477979
1640816884,194028,true,3748800462,28,3717072281,-31728181
1640816969,194029,true,3748425620,28,3717443988,-30981632
1640817034,194031,true,3747676047,28,3717815732,-29860315
1640817092,194032,true,3747301317,28,3718187514,-29113803
1640817460,194034,true,3746551969,28,3720418984,-26132985
1640817555,194035,true,3746177352,28,3721163105,-25014247
1640817618,194037,true,3745428228,28,3721535222,-23893006
1640818411,194038,true,3745053723,28,3729358266,-15695457
1640818454,194037,true,3745428228,28,3729731202,-15697026
1640818483,194038,true,3745053723,28,3729731202,-15322521
1640818580,194040,true,3744304825,28,3730104175,-14200650
1640819032,194040,true,3744304825,28,3731223318,-13081507
1640819731,194040,true,3744304825,28,3725630958,-18673867
1640819873,194041,true,3743930432,28,3724141078,-19789354
1640820014,194043,true,3743181758,28,3722279566,-20902192
1640820024,194043,true,3743181758,28,3722279566,-20902192
1640820031,194043,true,3743181758,28,3722279566,-20902192
1640820081,194045,true,3742433234,28,3720046980,-22386254
1640820102,194049,true,3740936635,28,3719303082,-21633553
1640820147,194051,true,3740188559,28,3717072281,-23116278
1640820159,194051,true,3740188559,28,3716700611,-23487948
1640820172,194053,true,3739440634,28,3715957382,-23483252
1640820216,194058,true,3737571474,28,3713728588,-23842886
1640820244,194059,true,3737197755,28,3712614692,-24583063
1640820261,194059,true,3737197755,28,3711872280,-25325475
1640820279,194060,true,3736824072,28,3710758941,-26065131
1640820290,194065,true,3734956221,28,3710387903,-24568318
1640820316,194066,true,3734582762,28,3709275009,-25307753
1640820350,194065,true,3734956221,28,3707420928,-27535293
1640820497,194065,true,3734956221,28,3701864243,-33091978
1640820570,194070,true,3733089303,28,3698534230,-34555073
1640820675,194071,true,3732716031,28,3693729499,-38986532
1640820957,194071,true,3732716031,28,3680456642,-52259389
1640821007,194072,true,3732342797,28,3678616966,-53725831
1640821087,194077,true,3730477185,28,3675307865,-55169320
1640821155,194079,true,3729731202,28,3672736179,-56995023
1640821371,194079,true,3729731202,28,3663199944,-66531258
1640821380,194080,true,3729358266,28,3662833661,-66524605
1640821395,194086,true,3727121434,28,3662101204,-65020230
1640821495,194088,true,3726376121,28,3657343803,-69032318
1640821521,194090,true,3725630958,28,3656246819,-69384139
1640821575,194092,true,3724885943,28,3653323138,-71562805
1640821765,194099,true,3722279566,28,3643108651,-79170915
1640821804,194102,true,3721163105,28,3641287643,-79875462
1640822853,194103,true,3720791026,28,3628203227,-92587799
1640823018,194105,true,3720046980,28,3626389670,-93657310
1640823048,194111,true,3717815732,28,3626389670,-91426062
1640823130,194114,true,3716700611,28,3625664501,-91036110
1640823163,194115,true,3716328978,28,3625301970,-91027008
1640823166,194119,true,3714842818,28,3625301970,-89540848
1640823175,194126,true,3712243468,28,3624939476,-87303992
1640823207,194130,true,3710758941,28,3624577019,-86181922
1640823468,194131,true,3710387903,28,3622765274,-87622629
1640823529,194135,true,3708904118,28,3622403034,-86501084
1640823541,194142,true,3706308924,28,3622403034,-83905890
1640823561,194147,true,3704456325,28,3622040829,-82415496
1640823604,194149,true,3703715545,28,3621678662,-82036883
1640823613,194153,true,3702234429,28,3621678662,-80555767
1640823735,194161,true,3699273974,28,3619144500,-80129474
1640823781,194166,true,3697424892,28,3618420780,-79004112
1640823832,194168,true,3696685517,28,3617697204,-78988313
1640823849,194172,true,3695207213,28,3617335471,-77871742
1640823863,194179,true,3692621602,28,3617335471,-75286131
1640823884,194183,true,3691144923,28,3617335471,-73809452
1640823911,194183,true,3691144923,28,3617335471,-73809452
1640823937,194187,true,3689668834,28,3617697204,-71971630
1640823970,194193,true,3687455807,28,3618058974,-69396833
1640824245,194196,true,3686349792,28,3619868365,-66481427
1640824403,194196,true,3686349792,28,3621678662,-64671130
1640824472,194199,true,3685244108,28,3622765274,-62478834
1640824693,194204,true,3683402038,28,3626027067,-57374971
1640824773,194207,true,3682297239,28,3627477695,-54819544
1640824887,194206,true,3682665468,28,3629654726,-53010742
1640825179,194209,true,3681560890,28,3637284628,-44276262
1640825348,194214,true,3679720661,28,3642015936,-37704725
1640825434,194217,true,3678616966,28,3644930569,-33686397
1640825805,194216,true,3678984828,28,3654784686,-24200142
1640826231,194218,true,3678249141,28,3658441116,-19808025
1640826326,194224,true,3676042964,28,3658806960,-17236004
1640826333,194226,true,3675307865,28,3658806960,-16500905
1640826339,194225,true,3675675396,28,3658806960,-16868436
1640826367,194227,true,3674940371,28,3658806960,-16133411
1640826506,194233,true,3672736179,28,3658806960,-13929219
1640826569,194235,true,3672001742,28,3658806960,-13194782
1640826622,194234,true,3672368942,28,3658441116,-13927826
1640826913,194235,true,3672001742,28,3657709537,-14292205
1640827102,194240,true,3670166291,28,3656978105,-13188186
1640827158,194242,true,3669432368,28,3656612444,-12819924
1640827573,194241,true,3669799312,28,3655881231,-13918081
1640827939,194242,true,3669432368,28,3655150165,-14282203
1640828039,194247,true,3667598202,28,3654784686,-12813516
1640828125,194249,true,3666864793,28,3654419244,-12445549
1640828142,194248,true,3667231479,28,3654419244,-12812235
1640828657,194249,true,3666864793,28,3654419244,-12445549
1640829017,194255,true,3664665444,28,3653688470,-10976974
1640829035,194257,true,3663932621,28,3653688470,-10244151
1640829076,194257,true,3663932621,28,3653688470,-10244151
1640829368,194259,true,3663199944,28,3654053839,-9146105
1640829829,194264,true,3661368893,28,3654419244,-6949649
1640829844,194266,true,3660636729,28,3654419244,-6217485
1640829858,194266,true,3660636729,28,3654419244,-6217485
1640829894,194267,true,3660270702,28,3654419244,-5851458
1640830028,194272,true,3658441116,28,3654053839,-4387277
1640830335,194275,true,3657343803,28,3652592583,-4751220
1640831318,194275,true,3657343803,28,3641651771,-15692032
1640832114,194276,true,3656978105,28,3634376110,-22601995
1640832177,194280,true,3655515680,28,3634012708,-21502972
1640832367,194282,true,3654784686,28,3634376110,-20408576
1640832560,194283,true,3654419244,28,3634739547,-19679697
1640833432,194283,true,3654419244,28,3637648357,-16770887
1640833496,194287,true,3652957842,28,3638012122,-14945720
1640833649,194290,true,3651862174,28,3638739760,-13122414
1640834169,194290,true,3651862174,28,3642744376,-9117798
1640834392,194290,true,3651862174,28,3644201692,-7660482
1640834491,194295,true,3650036790,28,3644930569,-5106221
1640835155,194297,true,3649306892,28,3646753399,-2553493
1640835697,194298,true,3648941998,28,3647847534,-1094464
1640835852,194298,true,3648941998,28,3648212319,-729679
1640836125,194302,true,3647482786,28,3648212319,729533
1640836637,194305,true,3646388760,28,3648941998,2553238
1640837034,194306,true,3646024158,28,3650766834,4742676
1640837255,194306,true,3646024158,28,3651497024,5472866
1640837525,194310,true,3644566113,28,3652957842,8391729
1640837621,194312,true,3643837309,28,3653323138,9485829
1640837759,194312,true,3643837309,28,3654784686,10947377
1640838040,194311,true,3644201692,28,3658075308,13873616
1640838110,194315,true,3642744376,28,3658806960,16062584
1640838386,194317,true,3642015936,28,3662467414,20451478
1640838926,194316,true,3642380138,28,3668698592,26318454
1640839244,194314,true,3643108651,28,3672001742,28893091
1640840418,194314,true,3643108651,28,3676042964,32934313
1640840944,194315,true,3642744376,28,3675307865,32563489
1640841079,194314,true,3643108651,28,3675307865,32199214
1640841336,194312,true,3643837309,28,3674572914,30735605
1640842135,194312,true,3643837309,28,3672001742,28164433
1640842271,194313,true,3643472961,28,3671267451,27794490
1640842513,194312,true,3643837309,28,3669799312,25962003
1640843156,194310,true,3644566113,28,3664665444,20099331
1640843562,194311,true,3644201692,28,3660270702,16069010
1640843769,194312,true,3643837309,28,3658441116,14603807
1640843915,194311,true,3644201692,28,3657343803,13142111
1640845466,194309,true,3644930569,28,3666131530,21200961
1640845483,194310,true,3644566113,28,3666498143,21932030
1640846408,194310,true,3644566113,28,3667598202,23032089
1640846439,194309,true,3644930569,28,3667598202,22667633
1640846594,194307,true,3645659592,28,3668331759,22672167
1640846630,194307,true,3645659592,28,3668331759,22672167
1640846901,194306,true,3646024158,28,3670533308,24509150
1640847307,194305,true,3646388760,28,3675307865,28919105
1640847857,194302,true,3647482786,28,3683770379,36287593
1640847873,194302,true,3647482786,28,3683770379,36287593
1640849674,194300,true,3648212319,28,3705567773,57355454
1640850863,194298,true,3648941998,28,3706308924,57366926
1640851345,194294,true,3650401794,28,3706308924,55907130
1640851470,194294,true,3650401794,28,3706679555,56277761
1640851543,194292,true,3651131911,28,3707050223,55918312
1640851787,194289,true,3652227360,28,3707420928,55193568
1640852334,194285,true,3653688470,28,3712614692,58926222
1640852433,194285,true,3653688470,28,3713357252,59668782
1640852469,194282,true,3654784686,28,3713728588,58943902
1640852518,194280,true,3655515680,28,3714099961,58584281
1640852530,194276,true,3656978105,28,3714099961,57121856
1640852565,194276,true,3656978105,28,3714099961,57121856
1640852964,194273,true,3658075308,28,3715214302,57138994
1640853714,194270,true,3659172841,28,3714842818,55669977
1640853931,194266,true,3660636729,28,3712985953,52349224
1640854033,194266,true,3660636729,28,3712243468,51606739
1640854641,194263,true,3661735030,28,3707791670,46056640
1640854792,194260,true,3662833661,28,3707420928,44587267
1640854814,194256,true,3664299014,28,3707420928,43121914
1640856833,194255,true,3664665444,28,3702974913,38309469
1640856859,194252,true,3665764953,28,3702974913,37209960
1640857415,194250,true,3666498143,28,3701494093,34995950
1640857853,194245,true,3668331759,28,3699273974,30942215
1640858517,194246,true,3667964962,28,3695576734,27611772
1640860753,194244,true,3668698592,28,3693360163,24661571
1640860820,194243,true,3669065462,28,3693360163,24294701
1640861778,194240,true,3670166291,28,3689668834,19502543
1640861936,194241,true,3669799312,28,3689299904,19500592
1640862153,194239,true,3670533308,28,3688562154,18028846
1640863338,194238,true,3670900361,28,3691514037,20613676
1640863653,194235,true,3672001742,28,3692621602,20619860
1640864165,194236,true,3671634578,28,3693360163,21725585
1640864203,194235,true,3672001742,28,3693729499,21727757
1640864246,194234,true,3672368942,28,3694098872,21729930
1640864348,194231,true,3673470763,28,3694837729,21366966
1640864505,194232,true,3673103452,28,3696315886,23212434
1640864557,194230,true,3673838110,28,3697055186,23217076
1640864659,194229,true,3674205494,28,3698904083,24698589
1640866800,194224,true,3676042964,28,3731969600,55926636
1640866856,194225,true,3675675396,28,3732342797,56667401
1640866883,194223,true,3676410568,28,3732342797,55932229
1640866900,194222,true,3676778209,28,3732342797,55564588
1640866956,194217,true,3678616966,28,3732342797,53725831
1640867278,194216,true,3678984828,28,3733462612,54477784
1640867336,194215,true,3679352726,28,3733835958,54483232
1640867723,194213,true,3680088633,28,3735329716,55241083
1640868758,194209,true,3681560890,28,3739066727,57505837
1640870037,194208,true,3681929046,28,3738692858,56763812
1640871106,194207,true,3682297239,28,3738319026,56021787
1640871222,194205,true,3683033735,28,3738319026,55285291
1640872057,194200,true,3684875620,28,3738319026,53443406
1640872159,194200,true,3684875620,28,3738319026,53443406
1640872211,194199,true,3685244108,28,3738319026,53074918
1640872270,194197,true,3685981193,28,3738319026,52337833
1640872825,194193,true,3687455807,28,3735703249,48247442
1640873800,194193,true,3687455807,28,3728612506,41156699
1640873850,194192,true,3687824553,28,3728239682,40415129
1640873963,194190,true,3688562154,28,3727494146,38931992
1640874304,194186,true,3690037801,28,3725630958,35593157
1640874332,194187,true,3689668834,28,3725258432,35589598
1640874353,194185,true,3690406804,28,3725258432,34851628
1640874564,194184,true,3690775845,28,3723396361,32620516
1640875621,194180,true,3692252377,28,3717072281,24819904
1640876727,194181,true,3691883189,28,3711872280,19989091
1640877809,194179,true,3692621602,28,3714842818,22221216
1640877838,194177,true,3693360163,28,3714842818,21482655
1640881227,194173,true,3694837729,28,3718559333,23721604
1640881502,194172,true,3695207213,28,3719303082,24095869
1640881521,194170,true,3695946291,28,3719303082,23356791
1640881551,194168,true,3696685517,28,3719675012,22989495
1640881820,194164,true,3698164414,28,3720791026,22626612
1640882260,194163,true,3698534230,28,3725258432,26724202
1640882409,194161,true,3699273974,28,3727494146,28220172
1640882413,194160,true,3699643901,28,3727494146,27850245
1640884108,194155,true,3701494093,28,3748425620,46931527
1640887042,194154,true,3701864243,28,3746926624,45062381
1640887472,194152,true,3702604652,28,3746926624,44321972
1640887761,194150,true,3703345210,28,3746926624,43581414
1640887786,194145,true,3705197253,28,3746926624,41729371
1640888233,194144,true,3705567773,28,3745053723,39485950
1640888400,194143,true,3705938330,28,3744304825,38366495
1640888850,194141,true,3706679555,28,3742433234,35753679
1640888906,194137,true,3708162449,28,3742433234,34270785
1640889254,194136,true,3708533265,28,3741310728,32777463
1640890524,194134,true,3709275009,28,3741684859,32409850
1640890626,194133,true,3709645936,28,3741684859,32038923
1640890651,194129,true,3711130017,28,3741684859,30554842
1640892939,194128,true,3711501130,28,3752175733,40674603
1640894715,194127,true,3711872280,28,3758183719,46311439
1640896943,194126,true,3712243468,28,3756680821,44437353
1640896968,194121,true,3714099961,28,3756680821,42580860
1640897049,194121,true,3714099961,28,3756305190,42205229
1640897193,194119,true,3714842818,28,3755178524,40335706
1640897378,194119,true,3714842818,28,3753301498,38458680
1640897481,194115,true,3716328978,28,3751800553,35471575
1640898241,194115,true,3716328978,28,3739440634,23111656
1640898251,194113,true,3717072281,28,3739440634,22368353
1640898315,194113,true,3717072281,28,3738319026,21246745
1640899047,194109,true,3718559333,28,3725258432,6699099
1640899072,194109,true,3718559333,28,3724885943,6326610
1640899323,194107,true,3719303082,28,3724141078,4837996
1640899456,194107,true,3719303082,28,3724141078,4837996
1640899874,194103,true,3720791026,28,3724141078,3350052
1640899933,194103,true,3720791026,28,3724141078,3350052
1640900221,194101,true,3721535222,28,3725258432,3723210
1640900256,194101,true,3721535222,28,3725258432,3723210
1640902741,194097,true,3723024059,28,3731596440,8572381
1640902789,194097,true,3723024059,28,3731596440,8572381
1640903614,194096,true,3723396361,28,3728985367,5589006
1640904003,194097,true,3723024059,28,3726003521,2979462
1640904009,194094,true,3724141078,28,3726003521,1862443
1640905296,194095,true,3723768701,28,3704826771,-18941930
1640905355,194096,true,3723396361,28,3703715545,-19680816
1640905702,194097,true,3723024059,28,3699273974,-23750085
1640905750,194095,true,3723768701,28,3698904083,-24864618
1640906582,194095,true,3723768701,28,3701494093,-22274608
1640908942,194096,true,3723396361,28,3705567773,-17828588
1640908964,194098,true,3722651794,28,3705938330,-16713464
1640909093,194096,true,3723396361,28,3706679555,-16716806
1640909348,194096,true,3723396361,28,3708162449,-15233912
1640909628,194096,true,3723396361,28,3710387903,-13008458
1640910814,194098,true,3722651794,28,3720791026,-1860768
1640910873,194096,true,3723396361,28,3720791026,-2605335
1640910912,194096,true,3723396361,28,3720791026,-2605335
1640910985,194095,true,3723768701,28,3720791026,-2977675
1640911088,194097,true,3723024059,28,3720418984,-2605075
1640911152,194096,true,3723396361,28,3720046980,-3349381
1640911817,194096,true,3723396361,28,3713728588,-9667773
1640912054,194096,true,3723396361,28,3710758941,-12637420
1640912911,194097,true,3723024059,28,3703715545,-19308514
1640913721,194096,true,3723396361,28,3701123981,-22272380
1640913754,194096,true,3723396361,28,3701494093,-21902268
1640913838,194096,true,3723396361,28,3701864243,-21532118
1640913872,194098,true,3722651794,28,3701864243,-20787551
1640913890,194095,true,3723768701,28,3702234429,-21534272
1640913920,194095,true,3723768701,28,3702234429,-21534272
1640914367,194094,true,3724141078,28,3705567773,-18573305
1640914758,194095,true,3723768701,28,3710016901,-13751800
1640915578,194092,true,3724885943,28,3722651794,-2234149
1640916231,194092,true,3724885943,28,3726003521,1117578
1640916937,194090,true,3725630958,28,3725258432,-372526
1640917042,194092,true,3724885943,28,3725258432,372489
1640917458,194089,true,3726003521,28,3724513492,-1490029
1640917553,194089,true,3726003521,28,3724141078,-1862443
1640917614,194087,true,3726748759,28,3724141078,-2607681
1640917699,194089,true,3726003521,28,3723768701,-2234820
1640918159,194087,true,3726748759,28,3721535222,-5213537
1640921022,194088,true,3726376121,28,3716700611,-9675510
1640921286,194086,true,3727121434,28,3717072281,-10049153
1640921673,194089,true,3726003521,28,3718187514,-7816007
1640922203,194088,true,3726376121,28,3721535222,-4840899
1640922221,194089,true,3726003521,28,3721907375,-4096146
1640922232,194087,true,3726748759,28,3721907375,-4841384
1640922863,194088,true,3726376121,28,3731596440,5220319
1640923885,194087,true,3726748759,28,3743556076,16807317
1640924153,194088,true,3726376121,28,3744679255,18303134
1640924416,194086,true,3727121434,28,3744304825,17183391
1640924447,194088,true,3726376121,28,3744304825,17928704
1640924556,194087,true,3726748759,28,3744304825,17556066
1640925187,194087,true,3726748759,28,3745802771,19054012
1640926141,194085,true,3727494146,28,3748425620,20931474
1640927160,194087,true,3726748759,28,3748800462,22051703
1640929557,194086,true,3727121434,28,3748800462,21679028
1640929577,194086,true,3727121434,28,3748800462,21679028
1640930211,194085,true,3727494146,28,3745802771,18308625
1640930280,194086,true,3727121434,28,3745428228,18306794
1640931330,194085,true,3727494146,28,3740562578,13068432
1640932891,194085,true,3727494146,28,3737945232,10451086
1640934049,194083,true,3728239682,28,3737197755,8958073
1640934291,194085,true,3727494146,28,3737571474,10077328
1640935182,194083,true,3728239682,28,3739066727,10827045
1640935316,194084,true,3727866895,28,3739066727,11199832
1640935495,194082,true,3728612506,28,3739066727,10454221
1640935598,194083,true,3728239682,28,3738692858,10453176
1640935786,194081,true,3728985367,28,3738692858,9707491
1640935958,194082,true,3728612506,28,3737945232,9332726
1640936004,194080,true,3729358266,28,3737571474,8213208
1640936084,194081,true,3728985367,28,3737197755,8212388
1640936131,194080,true,3729358266,28,3736824072,7465806
1640936183,194081,true,3728985367,28,3736450427,7465060
1640936335,194080,true,3729358266,28,3734582762,5224496
1640936417,194081,true,3728985367,28,3733462612,4477245
1640936470,194081,true,3728985367,28,3732716031,3730664
1640936563,194082,true,3728612506,28,3731223318,2610812
1640936677,194082,true,3728612506,28,3728985367,372861
1640936693,194084,true,3727866895,28,3728985367,1118472
1640937227,194085,true,3727494146,28,3717443988,-10050158
1640937335,194087,true,3726748759,28,3715585823,-11162936
1640937560,194086,true,3727121434,28,3711130017,-15991417
1640937591,194088,true,3726376121,28,3710758941,-15617180
1640937863,194089,true,3726003521,28,3707791670,-18211851
1640938582,194090,true,3725630958,28,3707791670,-17839288
1640939045,194089,true,3726003521,28,3711501130,-14502391
1640939098,194090,true,3725630958,28,3713357252,-12273706
1640939116,194091,true,3725258432,28,3714099961,-11158471
1640939126,194092,true,3724885943,28,3714099961,-10785982
1640939140,194087,true,3726748759,28,3714471371,-12277388
1640939159,194090,true,3725630958,28,3715214302,-10416656
1640939168,194090,true,3725630958,28,3715214302,-10416656
1640939172,194091,true,3725258432,28,3715585823,-9672609
1640939235,194087,true,3726748759,28,3717443988,-9304771
1640939428,194089,true,3726003521,28,3723396361,-2607160
1640939474,194090,true,3725630958,28,3724885943,-745015
1640939546,194091,true,3725258432,28,3727121434,1863002
1640939591,194087,true,3726748759,28,3728612506,1863747
1640939600,194087,true,3726748759,28,3728985367,2236608
1640939655,194087,true,3726748759,28,3730850233,4101474
1640939660,194087,true,3726748759,28,3731223318,4474559
1640939690,194082,true,3728612506,28,3732342797,3730291
1640939722,194082,true,3728612506,28,3733462612,4850106
1640939870,194081,true,3728985367,28,3739440634,10455267
1640939931,194081,true,3728985367,28,3742059028,13073661
1640940376,194075,true,3731223318,28,3761567437,30344119
1640940549,194075,true,3731223318,28,3769851581,38628263
1640942693,194074,true,3731596440,28,3803551316,71954876
1640943466,194074,true,3731596440,28,3803551316,71954876
1640943966,194068,true,3733835958,28,3803551316,69715358
1640945307,194068,true,3733835958,28,3803170999,69335041
1640945331,194067,true,3734209341,28,3803170999,68961658
1640945554,194067,true,3734209341,28,3802410479,68201138
1640945616,194061,true,3736450427,28,3802030276,65579849
1640945733,194061,true,3736450427,28,3801650111,65199684
1640945766,194060,true,3736824072,28,3801650111,64826039
1640945831,194059,true,3737197755,28,3801269984,64072229
1640946227,194053,true,3739440634,28,3800129831,60689197
1640946309,194052,true,3739814578,28,3799749856,59935278
1640946967,194051,true,3740188559,28,3797470804,57282245
1640947010,194050,true,3740562578,28,3797091095,56528517
1640948198,194044,true,3742807477,28,3796331790,53524313
1640948245,194043,true,3743181758,28,3796331790,53150032
1640948310,194042,true,3743556076,28,3795952195,52396119
1640950607,194042,true,3743556076,28,3777776191,34220115
1640951018,194038,true,3745053723,28,3778531784,33478061
1640951603,194038,true,3745053723,28,3779287528,34233805
1640953371,194037,true,3745428228,28,3780043423,34615195
1640954443,194037,true,3745428228,28,3781933823,36505595
1640954494,194032,true,3747301317,28,3782312016,35010699
1640955585,194031,true,3747676047,28,3785338925,37662878
1640958128,194030,true,3748050815,28,3786474640,38423825
1640958190,194029,true,3748425620,28,3786853288,38427668
1640958931,194024,true,3750300208,28,3787610696,37310488
1640960887,194023,true,3750675238,28,3791400012,40724774
1640960937,194021,true,3751425410,28,3791400012,39974602
1640961272,194020,true,3751800553,28,3791400012,39599459
1640961374,194016,true,3753301498,28,3791779152,38477654
1640963100,194014,true,3754052196,28,3798610159,44557963
1640963388,194013,true,3754427601,28,3798610159,44182558
1640965405,194012,true,3754803044,28,3798610159,43807115
1640965523,194008,true,3756305190,28,3798610159,42304969
1640965786,194007,true,3756680821,28,3797850551,41169730
1640965790,194006,true,3757056489,28,3797850551,40794062
1640966214,194006,true,3757056489,28,3795572638,38516149
1640966299,194002,true,3758559537,28,3795193119,36633582
1640966371,194001,true,3758935393,28,3794813637,35878244
1640967746,193999,true,3759687218,28,3787989457,28302239
1640968362,193999,true,3759687218,28,3787610696,27923478
1640968675,193996,true,3760815237,28,3787610696,26795459
1640968751,193994,true,3761567437,28,3787610696,26043259
1640968875,193993,true,3761943594,28,3787231973,25288379
1640969402,193993,true,3761943594,28,3785338925,23395331
1640969415,193989,true,3763448597,28,3785338925,21890328
1640969443,193988,true,3763824942,28,3784960429,21135487
1640969720,193988,true,3763824942,28,3781555667,17730725
1640969913,193989,true,3763448597,28,3778153968,14705371
1640970361,193986,true,3764577745,28,3769097723,4519978
1640970707,193987,true,3764201325,28,3763072290,-1129035
1640970985,193987,true,3764201325,28,3757432195,-6769130
1640971262,193989,true,3763448597,28,3752175733,-11272864
1640971419,193986,true,3764577745,28,3749925215,-14652530
1640971441,193987,true,3764201325,28,3749550260,-14651065
1640971711,193988,true,3763824942,28,3744304825,-19520117
1640971767,193991,true,3762696020,28,3743181758,-19514262
1640971823,193989,true,3763448597,28,3742433234,-21015363
1640972796,193989,true,3763448597,28,3726003521,-37445076
1640975336,193990,true,3763072290,28,3718931189,-44141101
1640975353,193993,true,3761943594,28,3718931189,-43012405
1640975770,193991,true,3762696020,28,3717072281,-45623739
1640976095,193992,true,3762319788,28,3715214302,-47105486
1640976968,193994,true,3761567437,28,3706679555,-54887882
1640978047,193997,true,3760439193,28,3701123981,-59315212
1640978122,193995,true,3761191318,28,3701123981,-60067337
1640978129,193996,true,3760815237,28,3701123981,-59691256
1640978341,193998,true,3760063186,28,3699273974,-60789212
1640978368,194002,true,3758559537,28,3698904083,-59655454
1640978373,194000,true,3759311287,28,3698904083,-60407204
1640978580,194001,true,3758935393,28,3696315886,-62619507
1640978697,194003,true,3758183719,28,3694468282,-63715437
1640978874,194007,true,3756680821,28,3691514037,-65166784
1640978930,194006,true,3757056489,28,3690406804,-66649685
1640979040,194007,true,3756680821,28,3688193335,-68487486
1640979097,194009,true,3755929597,28,3687087098,-68842499
1640979204,194013,true,3754427601,28,3685244108,-69183493
1640979221,194011,true,3755178524,28,3684875620,-70302904
1640979295,194013,true,3754427601,28,3683033735,-71393866
1640979390,194015,true,3753676828,28,3680456642,-73220186
1640979532,194020,true,3751800553,28,3676042964,-75757589
1640980155,194017,true,3752926205,28,3658806960,-94119245
1640980300,194019,true,3752175733,28,3656246819,-95928914
1640980423,194021,true,3751425410,28,3654053839,-97371571
1640980453,194025,true,3749925215,28,3653323138,-96602077
1640980681,194023,true,3750675238,28,3649671823,-101003415
1640980693,194025,true,3749925215,28,3649306892,-100618323
1640980832,194027,true,3749175343,28,3646753399,-102421944
1640980899,194032,true,3747301317,28,3644930569,-102370748
1640980928,194031,true,3747676047,28,3644566113,-103109934
1640980995,194033,true,3746926624,28,3643472961,-103453663
1640981059,194035,true,3746177352,28,3642744376,-103432976
1640981157,194040,true,3744304825,28,3642380138,-101924687
1640981158,194043,true,3743181758,28,3642380138,-100801620
1640981200,194043,true,3743181758,28,3642015936,-101165822
1640981483,194045,true,3742433234,28,3643108651,-99324583
1640981903,194050,true,3740562578,28,3645295062,-95267516
1640982638,194052,true,3739814578,28,3651497024,-88317554
1640983892,194053,true,3739440634,28,3654784686,-84655948
1640984034,194055,true,3738692858,28,3654784686,-83908172
1640984103,194060,true,3736824072,28,3654784686,-82039386
1640984167,194063,true,3735703249,28,3654784686,-80918563
1640984686,194064,true,3735329716,28,3652957842,-82371874
1640984746,194067,true,3734209341,28,3652957842,-81251499
1640984880,194072,true,3732342797,28,3652592583,-79750214
1640984956,194075,true,3731223318,28,3652592583,-78630735
1640985021,194077,true,3730477185,28,3652592583,-77884602
1640985036,194080,true,3729358266,28,3652227360,-77130906
1640985389,194086,true,3727121434,28,3650401794,-76719640
1640985432,194089,true,3726003521,28,3650401794,-75601727
1640986009,194091,true,3725258432,28,3646753399,-78505033
1640986148,194095,true,3723768701,28,3646388760,-77379941
1640986206,194101,true,3721535222,28,3646388760,-75146462
1640986246,194104,true,3720418984,28,3647482786,-72936198
1640986573,194105,true,3720046980,28,3651497024,-68549956
1640986627,194107,true,3719303082,28,3652227360,-67075722
1640986894,194113,true,3717072281,28,3657709537,-59362744
1640987602,194116,true,3715957382,28,3674205494,-41751888
1640988366,194115,true,3716328978,28,3685612632,-30716346
1640988381,194118,true,3715214302,28,3685612632,-29601670
1640988590,194123,true,3713357252,28,3685981193,-27376059
1640988660,194126,true,3712243468,28,3685981193,-26262275
1640988739,194126,true,3712243468,28,3685981193,-26262275
1640988975,194128,true,3711501130,28,3687455807,-24045323
1640989854,194133,true,3709645936,28,3694098872,-15547064
1640989896,194136,true,3708533265,28,3694468282,-14064983
1640989972,194135,true,3708904118,28,3694837729,-14066389
1640990103,194137,true,3708162449,28,3695946291,-12216158
1640990435,194141,true,3706679555,28,3697794634,-8884921
1640990549,194143,true,3705938330,28,3698164414,-7773916
1640990709,194143,true,3705938330,28,3697424892,-8513438
1640992146,194146,true,3704826771,28,3687824553,-17002218
1640992489,194150,true,3703345210,28,3686718427,-16626783
1640992722,194152,true,3702604652,28,3686718427,-15886225
1640992774,194152,true,3702604652,28,3686718427,-15886225
1640994656,194155,true,3701494093,28,3689668834,-11825259
1640994672,194159,true,3700013866,28,3689668834,-10345032
1640995138,194162,true,3698904083,28,3688931011,-9973072
1640995212,194162,true,3698904083,28,3688931011,-9973072
1640995562,194165,true,3697794634,28,3687824553,-9970081
1640995630,194169,true,3696315886,28,3687824553,-8491333
1640995933,194172,true,3695207213,28,3688562154,-6645059
1640997212,194172,true,3695207213,28,3692621602,-2585611
1640997489,194175,true,3694098872,28,3693360163,-738709
1640997515,194179,true,3692621602,28,3693729499,1107897
1640997518,194182,true,3691514037,28,3693729499,2215462
1640997817,194181,true,3691883189,28,3695207213,3324024
1640997858,194184,true,3690775845,28,3695576734,4800889
1640998081,194187,true,3689668834,28,3697424892,7756058
1640998217,194189,true,3688931011,28,3699273974,10342963
1640998235,194189,true,3688931011,28,3699273974,10342963
1640998542,194191,true,3688193335,28,3702974913,14781578
1640999095,194194,true,3687087098,28,3711130017,24042919
1640999544,194196,true,3686349792,28,3716328978,29979186
1640999743,194195,true,3686718427,28,3717443988,30725561
1640999787,194198,true,3685612632,28,3717815732,32203100
1640999790,194200,true,3684875620,28,3717815732,32940112
1640999832,194202,true,3684138756,28,3718187514,34048758
1641000044,194200,true,3684875620,28,3720418984,35543364
1641000276,194202,true,3684138756,28,3723024059,38885303
1641000830,194203,true,3683770379,28,3728239682,44469303
1641001772,194204,true,3683402038,28,3736076820,52674782
1641001859,194202,true,3684138756,28,3736076820,51938064
1641002043,194203,true,3683770379,28,3736076820,52306441
1641004453,194204,true,3683402038,28,3734956221,51554183
1641004670,194205,true,3683033735,28,3734956221,51922486
1641004723,194203,true,3683770379,28,3734956221,51185842
1641004806,194203,true,3683770379,28,3734956221,51185842
1641009927,194204,true,3683402038,28,3731969600,48567562
1641010443,194204,true,3683402038,28,3731969600,48567562
1641010526,194202,true,3684138756,28,3731596440,47457684
1641010547,194202,true,3684138756,28,3731223318,47084562
1641011138,194203,true,3683770379,28,3727494146,43723767
1641011289,194204,true,3683402038,28,3726003521,42601483
1641011454,194202,true,3684138756,28,3724513492,40374736
1641011494,194201,true,3684507170,28,3723768701,39261531
1641011708,194202,true,3684138756,28,3720791026,36652270
1641011778,194204,true,3683402038,28,3719675012,36272974
1641011964,194201,true,3684507170,28,3717072281,32565111
1641012019,194200,true,3684875620,28,3716328978,31453358
1641012031,194201,true,3684507170,28,3715957382,31450212
1641012054,194202,true,3684138756,28,3715585823,31447067
1641012097,194199,true,3685244108,28,3714842818,29598710
1641012116,194198,true,3685612632,28,3714842818,29230186
1641012278,194198,true,3685612632,28,3712614692,27002060
1641012309,194199,true,3685244108,28,3712243468,26999360
1641012320,194196,true,3686349792,28,3712243468,25893676
1641012358,194194,true,3687087098,28,3711872280,24785182
1641012398,194194,true,3687087098,28,3711501130,24414032
1641012527,194195,true,3686718427,28,3710387903,23669476
1641012552,194192,true,3687824553,28,3710016901,22192348
1641014427,194189,true,3688931011,28,3710758941,21827930
1641014515,194188,true,3689299904,28,3710758941,21459037
1641014600,194189,true,3688931011,28,3711501130,22570119
1641014676,194186,true,3690037801,28,3711872280,21834479
1641014700,194182,true,3691514037,28,3712243468,20729431
1641014826,194180,true,3692252377,28,3714471371,22218994
1641015013,194180,true,3692252377,28,3717815732,25563355
1641015189,194175,true,3694098872,28,3721535222,27436350
1641015730,194171,true,3695576734,28,3733835958,38259224
1641015984,194169,true,3696315886,28,3738319026,42003140
1641016007,194168,true,3696685517,28,3738692858,42007341
1641016047,194164,true,3698164414,28,3739440634,41276220
1641018389,194161,true,3699273974,28,3736076820,36802846
1641019219,194160,true,3699643901,28,3736076820,36432919
1641019324,194159,true,3700013866,28,3736076820,36062954
1641019497,194155,true,3701494093,28,3736076820,34582727
1641019667,194153,true,3702234429,28,3735703249,33468820
1641019691,194152,true,3702604652,28,3735703249,33098597
1641020096,194151,true,3702974913,28,3733462612,30487699
1641020189,194148,true,3704085916,28,3732716031,28630115
1641020446,194146,true,3704826771,28,3730850233,26023462
1641020505,194145,true,3705197253,28,3730104175,24906922
1641021061,194145,true,3705197253,28,3724141078,18943825
1641022440,194142,true,3706308924,28,3714842818,8533894
1641022896,194140,true,3707050223,28,3711872280,4822057
1641023175,194139,true,3707420928,28,3711501130,4080202
1641023390,194139,true,3707420928,28,3711130017,3709089
1641023442,194136,true,3708533265,28,3710758941,2225676
1641023785,194134,true,3709275009,28,3710387903,1112894
1641024988,194133,true,3709645936,28,3711872280,2226344
1641025406,194133,true,3709645936,28,3711872280,2226344
1641025520,194130,true,3710758941,28,3712243468,1484527
1641027091,194127,true,3711872280,28,3719303082,7430802
1641027181,194126,true,3712243468,28,3719675012,7431544
1641028145,194126,true,3712243468,28,3720046980,7803512
1641028158,194124,true,3712985953,28,3720046980,7061027
1641030137,194122,true,3713728588,28,3724513492,10784904
1641030355,194122,true,3713728588,28,3724513492,10784904
1641031409,194122,true,3713728588,28,3720418984,6690396
1641031831,194121,true,3714099961,28,3719675012,5575051
1641031949,194119,true,3714842818,28,3718931189,4088371
1641032685,194118,true,3715214302,28,3717815732,2601430
1641032915,194119,true,3714842818,28,3717443988,2601170
1641033004,194118,true,3715214302,28,3716700611,1486309
1641033121,194117,true,3715585823,28,3715585823,0
1641033231,194118,true,3715214302,28,3714099961,-1114341
1641033653,194120,true,3714471371,28,3705938330,-8533041
1641033897,194119,true,3714842818,28,3701864243,-12978575
1641033918,194118,true,3715214302,28,3701864243,-13350059
1641034233,194118,true,3715214302,28,3698164414,-17049888
1641035992,194120,true,3714471371,28,3695946291,-18525080
1641036022,194119,true,3714842818,28,3696315886,-18526932
1641038279,194117,true,3715585823,28,3698904083,-16681740
1641040019,194117,true,3715585823,28,3698904083,-16681740
1641040171,194118,true,3715214302,28,3698904083,-16310219
1641040227,194118,true,3715214302,28,3698904083,-16310219
1641040324,194116,true,3715957382,28,3698904083,-17053299
1641041197,194116,true,3715957382,28,3701123981,-14833401
1641041504,194117,true,3715585823,28,3701864243,-13721580
1641041924,194116,true,3715957382,28,3703345210,-12612172
1641042028,194115,true,3716328978,28,3703715545,-12613433
1641043239,194114,true,3716700611,28,3711501130,-5199481
1641044086,194115,true,3716328978,28,3714471371,-1857607
1641045580,194114,true,3716700611,28,3714471371,-2229240
1641046978,194112,true,3717443988,28,3714471371,-2972617
1641047625,194112,true,3717443988,28,3714471371,-2972617
1641047676,194113,true,3717072281,28,3714471371,-2600910
1641047680,194113,true,3717072281,28,3714471371,-2600910
1641047712,194111,true,3717815732,28,3714471371,-3344361
1641047983,194112,true,3717443988,28,3712985953,-4458035
1641048355,194113,true,3717072281,28,3710387903,-6684378
1641051120,194114,true,3716700611,28,3701494093,-15206518
1641051149,194113,true,3717072281,28,3701864243,-15208038
1641051195,194113,true,3717072281,28,3702234429,-14837852
1641051232,194115,true,3716328978,28,3702604652,-13724326
1641051251,194114,true,3716700611,28,3702604652,-14095959
1641051261,194113,true,3717072281,28,3702604652,-14467629
1641051666,194112,true,3717443988,28,3709275009,-8168979
1641051696,194114,true,3716700611,28,3709645936,-7054675
1641051738,194114,true,3716700611,28,3710387903,-6312708
1641052181,194113,true,3717072281,28,3718559333,1487052
1641052240,194113,true,3717072281,28,3719303082,2230801
1641053631,194114,true,3716700611,28,3732342797,15642186
1641054502,194114,true,3716700611,28,3732716031,16015420
1641054574,194113,true,3717072281,28,3732716031,15643750
1641054601,194113,true,3717072281,28,3732716031,15643750
1641054613,194114,true,3716700611,28,3732716031,16015420
1641054653,194114,true,3716700611,28,3733089303,16388692
1641054937,194113,true,3717072281,28,3733835958,16763677
1641056419,194112,true,3717443988,28,3738692858,21248870
1641056460,194114,true,3716700611,28,3738692858,21992247
1641056858,194114,true,3716700611,28,3736076820,19376209
1641058338,194113,true,3717072281,28,3727121434,10049153
1641058713,194112,true,3717443988,28,3728985367,11541379
1641058714,194113,true,3717072281,28,3728985367,11913086
1641058939,194113,true,3717072281,28,3731596440,14524159
1641058965,194111,true,3717815732,28,3731969600,14153868
1641059020,194108,true,3718931189,28,3732716031,13784842
1641060265,194109,true,3718559333,28,3750300208,31740875
1641060428,194108,true,3718931189,28,3752175733,33244544
1641060705,194106,true,3719675012,28,3753676828,34001816
1641062231,194103,true,3720791026,28,3753676828,32885802
1641063583,194104,true,3720418984,28,3753676828,33257844
1641063786,194103,true,3720791026,28,3753676828,32885802
1641065039,194101,true,3721535222,28,3753301498,31766276
1641065720,194099,true,3722279566,28,3751800553,29520987
1641068960,194100,true,3721907375,28,3746177352,24269977
1641069033,194099,true,3722279566,28,3746177352,23897786
1641069111,194098,true,3722651794,28,3746551969,23900175
1641069356,194095,true,3723768701,28,3748050815,24282114
1641069393,194095,true,3723768701,28,3748425620,24656919
1641069537,194094,true,3724141078,28,3749925215,25784137
1641073830,194092,true,3724885943,28,3765707231,40821288
1641073911,194090,true,3725630958,28,3765707231,40076273
1641074190,194090,true,3725630958,28,3764954202,39323244
1641074217,194089,true,3726003521,28,3764577745,38574224
1641074438,194088,true,3726376121,28,3763824942,37448821
1641074483,194087,true,3726748759,28,3763448597,36699838
1641074900,194088,true,3726376121,28,3760815237,34439116
1641076744,194088,true,3726376121,28,3750675238,24299117
1641076787,194088,true,3726376121,28,3751050305,24674184
1641077519,194087,true,3726748759,28,3752175733,25426974
1641077714,194088,true,3726376121,28,3752550950,26174829
1641077832,194087,true,3726748759,28,3752550950,25802191
1641078659,194087,true,3726748759,28,3754427601,27678842
1641080444,194085,true,3727494146,28,3754427601,26933455
1641081260,194086,true,3727121434,28,3754427601,27306167
1641083841,194085,true,3727494146,28,3762319788,34825642
1641084742,194084,true,3727866895,28,3764201325,36334430
1641085780,194082,true,3728612506,28,3765707231,37094725
1641085975,194083,true,3728239682,28,3765707231,37467549
1641085999,194082,true,3728612506,28,3765707231,37094725
1641088239,194081,true,3728985367,28,3755929597,26944230
1641088267,194079,true,3729731202,28,3755929597,26198395
1641088712,194080,true,3729358266,28,3755178524,25820258
1641091286,194078,true,3730104175,28,3752550950,22446775
1641091918,194077,true,3730477185,28,3752550950,22073765
1641094165,194075,true,3731223318,28,3751425410,20202092
1641094709,194076,true,3730850233,28,3751425410,20575177
1641096859,194074,true,3731596440,28,3751425410,19828970
1641097413,194073,true,3731969600,28,3752175733,20206133
1641097548,194071,true,3732716031,28,3752175733,19459702
1641097989,194072,true,3732342797,28,3752926205,20583408
1641098702,194070,true,3733089303,28,3753301498,20212195
1641098746,194070,true,3733089303,28,3753301498,20212195
1641098790,194068,true,3733835958,28,3753301498,19465540
1641098878,194069,true,3733462612,28,3752550950,19088338
1641099290,194068,true,3733835958,28,3748050815,14214857
1641099334,194068,true,3733835958,28,3747301317,13465359
1641099519,194067,true,3734209341,28,3745428228,11218887
1641099652,194068,true,3733835958,28,3743556076,9720118
1641101550,194068,true,3733835958,28,3726376121,-7459837
1641102450,194068,true,3733835958,28,3726748759,-7087199
1641102694,194066,true,3734582762,28,3726003521,-8579241
1641103095,194067,true,3734209341,28,3727494146,-6715195
1641103682,194067,true,3734209341,28,3729731202,-4478139
1641103870,194066,true,3734582762,28,3730477185,-4105577
1641105451,194063,true,3735703249,28,3736824072,1120823
1641106321,194063,true,3735703249,28,3737197755,1494506
1641107311,194062,true,3736076820,28,3737197755,1120935
1641108226,194061,true,3736450427,28,3737197755,747328
1641108978,194059,true,3737197755,28,3737197755,0
1641111760,194058,true,3737571474,28,3742059028,4487554
1641113651,194058,true,3737571474,28,3742059028,4487554
1641115243,194057,true,3737945232,28,3742059028,4113796
1641115337,194055,true,3738692858,28,3742059028,3366170
1641116226,194054,true,3739066727,28,3750675238,11608511
1641120032,194052,true,3739814578,28,3759311287,19496709
1641121075,194051,true,3740188559,28,3757432195,17243636
1641121253,194049,true,3740936635,28,3757056489,16119854
1641121368,194048,true,3741310728,28,3756680821,15370093
1641121537,194047,true,3741684859,28,3755929597,14244738
1641121634,194047,true,3741684859,28,3755554042,13869183
1641123961,194045,true,3742433234,28,3748800462,6367228
1641124958,194045,true,3742433234,28,3748800462,6367228
1641125129,194044,true,3742807477,28,3748800462,5992985
1641125182,194043,true,3743181758,28,3748800462,5618704
1641125325,194042,true,3743556076,28,3748425620,4869544
1641126106,194043,true,3743181758,28,3742433234,-748524
1641127054,194042,true,3743556076,28,3735703249,-7852827
1641127237,194041,true,3743930432,28,3735703249,-8227183
1641127306,194039,true,3744679255,28,3736076820,-8602435
1641127621,194039,true,3744679255,28,3737945232,-6734023
1641135504,194038,true,3745053723,28,3745428228,374505
1641135656,194037,true,3745428228,28,3745802771,374543
1641136132,194035,true,3746177352,28,3745802771,-374581
1641136169,194035,true,3746177352,28,3745802771,-374581
1641136206,194035,true,3746177352,28,3746177352,0
1641136416,194034,true,3746551969,28,3746926624,374655
1641136480,194033,true,3746926624,28,3747301317,374693
1641136534,194033,true,3746926624,28,3747676047,749423
1641136787,194032,true,3747301317,28,3749175343,1874026
1641138409,194031,true,3747676047,28,3760815237,13139190
1641138419,194030,true,3748050815,28,3760815237,12764422
1641139070,194030,true,3748050815,28,3767213740,19162925
1641139778,194029,true,3748425620,28,3773623129,25197509
1641140107,194027,true,3749175343,28,3777020749,27845406
1641141241,194026,true,3749550260,28,3781177550,31627290
1641141888,194025,true,3749925215,28,3783825168,33899953
1641141938,194024,true,3750300208,28,3783825168,33524960
1641141985,194022,true,3751050305,28,3783825168,32774863
1641142035,194021,true,3751425410,28,3784203551,32778141
1641142237,194020,true,3751800553,28,3785338925,33538372
1641142476,194019,true,3752175733,28,3787231973,35056240
1641142528,194016,true,3753301498,28,3788368256,35066758
1641142749,194014,true,3754052196,28,3794813637,40761441
1641142843,194012,true,3754803044,28,3797470804,42667760
1641143212,194009,true,3755929597,28,3808118089,52188492
1641143641,194007,true,3756680821,28,3820322974,63642153
1641143648,194006,true,3757056489,28,3820322974,63266485
1641143748,194004,true,3757807938,28,3822998002,65190064
1641143755,194001,true,3758935393,28,3822998002,64062609
1641144044,194000,true,3759311287,28,3828353680,69042393
1641144268,193999,true,3759687218,28,3832183757,72496539
1641146294,193997,true,3760439193,28,3824909884,64470691
1641147622,193994,true,3761567437,28,3824909884,63342447
1641147763,193993,true,3761943594,28,3824909884,62966290
1641147782,193992,true,3762319788,28,3824909884,62590096
1641147801,193990,true,3763072290,28,3824909884,61837594
1641147987,193988,true,3763824942,28,3824145017,60320075
1641148081,193987,true,3764201325,28,3822998002,58796677
1641148176,193986,true,3764577745,28,3821851332,57273587
1641148328,193985,true,3764954202,28,3819559024,54604822
1641148380,193984,true,3765330698,28,3818795227,53464529
1641148398,193984,true,3765330698,28,3818413385,53082687
1641148416,193983,true,3765707231,28,3818031582,52324351
1641149549,193983,true,3765707231,28,3793296091,27588860
1641149589,193982,true,3766083802,28,3792537546,26453744
1641149698,193982,true,3766083802,28,3790641846,24558044
1641150301,193980,true,3766837056,28,3785717459,18880403
1641150400,193980,true,3766837056,28,3786096031,19258975
1641150455,193978,true,3767590461,28,3786474640,18884179
1641154324,193977,true,3767967220,28,3796711424,28744204
1641158267,193976,true,3768344017,28,3803931671,35587654
1641159675,193975,true,3768720851,28,3803931671,35210820
1641159852,193974,true,3769097723,28,3804692496,35594773
1641159898,193973,true,3769474633,28,3805072965,35598332
1641161768,193971,true,3770228566,28,3812690345,42461779
1641161783,193970,true,3770605589,28,3813071614,42466025
1641162641,193969,true,3770982649,28,3814215650,43233001
1641163047,193968,true,3771359748,28,3814978531,43618783
1641163098,193966,true,3772114057,28,3814978531,42864474
1641164971,193965,true,3772491269,28,3822233518,49742249
1641166237,193963,true,3773245805,28,3822233518,48987713
1641167361,193962,true,3773623129,28,3824527431,50904302
1641167375,193959,true,3774755329,28,3824527431,49772102
1641168642,193958,true,3775132805,28,3826057472,50924667
1641168712,193957,true,3775510318,28,3826057472,50547154
1641169510,193955,true,3776265458,28,3824527431,48261973
1641170027,193953,true,3777020749,28,3822998002,45977253
1641170741,193952,true,3777398451,28,3821469185,44070734
1641173173,193951,true,3777776191,28,3810022529,32246338
1641173193,193949,true,3778531784,28,3810403531,31871747
1641173235,193947,true,3779287528,28,3810403531,31116003
1641173305,193946,true,3779665457,28,3810403531,30738074
1641174303,193945,true,3780043423,28,3810403531,30360108
1641174362,193944,true,3780421427,28,3810403531,29982104
1641174385,193941,true,3781555667,28,3810403531,28847864
1641174443,193941,true,3781555667,28,3810022529,28466862
1641174927,193939,true,3782312016,28,3809260639,26948623
1641175642,193937,true,3783068517,28,3807737315,24668798
1641176059,193935,true,3783825168,28,3805834018,22008850
1641176142,193934,true,3784203551,28,3805453472,21249921
1641176421,193931,true,3785338925,28,3803931671,18592746
1641181121,193930,true,3785717459,28,3797470804,11753345
1641181331,193928,true,3786474640,28,3797091095,10616455
1641182382,193927,true,3786853288,28,3792537546,5684258
1641183637,193925,true,3787610696,28,3789883831,2273135
1641184837,193924,true,3787989457,28,3789883831,1894374
1641186356,193923,true,3788368256,28,3789883831,1515575
1641186968,193922,true,3788747093,28,3789883831,1136738
1641187624,193920,true,3789504881,28,3789504881,0
1641187808,193919,true,3789883831,28,3789883831,0
1641188022,193918,true,3790262819,28,3791779152,1516333
1641188049,193917,true,3790641846,28,3792158330,1516484
1641188122,193914,true,3791779152,28,3792916799,1137647
1641188160,193913,true,3792158330,28,3793296091,1137761
1641188867,193911,true,3792916799,28,3801269984,8353185
1641189058,193911,true,3792916799,28,3802410479,9493680
1641189110,193909,true,3793675421,28,3802790720,9115299
1641189344,193909,true,3793675421,28,3804692496,11017075
1641191272,193907,true,3794434194,28,3805072965,10638771
1641193611,193907,true,3794434194,28,3805072965,10638771
1641195306,193905,true,3795193119,28,3805072965,9879846
1641197295,193904,true,3795572638,28,3805072965,9500327
1641197525,193902,true,3796331790,28,3805453472,9121682
1641197703,193901,true,3796711424,28,3805834018,9122594
1641200796,193899,true,3797470804,28,3808498901,11028097
1641201453,193898,true,3797850551,28,3808498901,10648350
1641201603,193896,true,3798610159,28,3808498901,9888742
1641202889,193895,true,3798990020,28,3804692496,5702476
1641204152,193893,true,3799749856,28,3803170999,3421143
1641204216,193892,true,3800129831,28,3803551316,3421485
1641204618,193890,true,3800889895,28,3803551316,2661421
1641204742,193889,true,3801269984,28,3803551316,2281332
1641204779,193887,true,3802030276,28,3803931671,1901395
1641204861,193886,true,3802410479,28,3804312064,1901585
1641206478,193883,true,3803551316,28,3813834266,10282950
1641206762,193882,true,3803931671,28,3814215650,10283979
1641207662,193880,true,3804692496,28,3816123139,11430643
1641207903,193880,true,3804692496,28,3817649817,12957321
1641208297,193877,true,3805834018,28,3821469185,15635167
1641209148,193875,true,3806595222,28,3827588124,20992902
1641209883,193873,true,3807356580,28,3830651267,23294687
1641210365,193873,true,3807356580,28,3830651267,23294687
1641213128,193870,true,3808498901,28,3830651267,22152366
1641213661,193869,true,3808879751,28,3830651267,21771516
1641214319,193868,true,3809260639,28,3830651267,21390628
1641214547,193868,true,3809260639,28,3830651267,21390628
1641214615,193865,true,3810403531,28,3830651267,20247736
1641215590,193865,true,3810403531,28,3830268240,19864709
1641218351,193863,true,3811165650,28,3829885251,18719601
1641218522,193864,true,3810784571,28,3829885251,19100680
1641218775,193861,true,3811927921,28,3829885251,17957330
1641218884,193861,true,3811927921,28,3829885251,17957330
1641219087,193860,true,3812309114,28,3828736515,16427401
1641220524,193862,true,3811546766,28,3821851332,10304566
1641220571,193860,true,3812309114,28,3821469185,9160071
1641220596,193861,true,3811927921,28,3821469185,9541264
1641220630,193861,true,3811927921,28,3821469185,9541264
1641220640,193862,true,3811546766,28,3821851332,10304566
1641221251,193860,true,3812309114,28,3827205404,14896290
1641221307,193861,true,3811927921,28,3827205404,15277483
1641221354,193861,true,3811927921,28,3827588124,15660203
1641221426,193862,true,3811546766,28,3827588124,16041358
1641221616,193860,true,3812309114,28,3827970883,15661769
1641221742,193861,true,3811927921,28,3827588124,15660203
1641221773,193862,true,3811546766,28,3827588124,16041358
1641222439,193862,true,3811546766,28,3825674904,14128138
1641222587,193861,true,3811927921,28,3822998002,11070081
1641223252,193862,true,3811546766,28,3811165650,-381116
1641224751,193863,true,3811165650,28,3803931671,-7233979
1641225074,193863,true,3811165650,28,3804312064,-6853586
1641225186,193862,true,3811546766,28,3804312064,-7234702
1641225414,193863,true,3811165650,28,3802790720,-8374930
1641225667,193863,true,3811165650,28,3801269984,-9895666
1641226023,193864,true,3810784571,28,3798990020,-11794551
1641226073,193862,true,3811546766,28,3798610159,-12936607
1641226087,193862,true,3811546766,28,3798610159,-12936607
1641226213,193863,true,3811165650,28,3796331790,-14833860
1641226622,193865,true,3810403531,28,3788747093,-21656438
1641226643,193863,true,3811165650,28,3788368256,-22797394
1641226645,193864,true,3810784571,28,3788368256,-22416315
1641226840,193865,true,3810403531,28,3783825168,-26578363
1641226887,193868,true,3809260639,28,3782690247,-26570392
1641227118,193867,true,3809641565,28,3777776191,-31865374
1641227230,193868,true,3809260639,28,3775132805,-34127834
1641227912,193869,true,3808879751,28,3758935393,-49944358
1641228877,193873,true,3807356580,28,3749925215,-57431365
1641229499,193873,true,3807356580,28,3749550260,-57806320
1641229875,193874,true,3806975882,28,3749550260,-57425622
1641230921,193875,true,3806595222,28,3750675238,-55919984
1641230959,193879,true,3805072965,28,3750675238,-54397727
1641231227,193879,true,3805072965,28,3752550950,-52522015
1641231255,193880,true,3804692496,28,3752926205,-51766291
1641235573,193881,true,3804312064,28,3761567437,-42744627
1641239968,193885,true,3802790720,28,3757056489,-45734231
1641239988,193885,true,3802790720,28,3757056489,-45734231
1641240248,193886,true,3802410479,28,3755178524,-47231955
1641240282,193888,true,3801650111,28,3755178524,-46471587
1641240407,193893,true,3799749856,28,3753676828,-46073028
1641241216,193893,true,3799749856,28,3743930432,-55819424
1641241259,193894,true,3799369919,28,3743181758,-56188161
1641241362,193895,true,3798990020,28,3740936635,-58053385
1641241515,193901,true,3796711424,28,3736450427,-60260997
1641241694,193903,true,3795952195,28,3730477185,-65475010
1641241764,193904,true,3795572638,28,3728239682,-67332956
1641242783,193906,true,3794813637,28,3702974913,-91838724
1641242991,193912,true,3792537546,28,3698164414,-94373132
1641243457,193914,true,3791779152,28,3694098872,-97680280
1641244125,193915,true,3791400012,28,3693729499,-97670513
1641244820,193917,true,3790641846,28,3695207213,-95434633
1641245239,193922,true,3788747093,28,3695946291,-92800802
1641245453,193924,true,3787989457,28,3697424892,-90564565
1641245488,193925,true,3787610696,28,3697424892,-90185804
1641245579,193927,true,3786853288,28,3698164414,-88688874
1641245664,193931,true,3785338925,28,3699273974,-86064951
1641245727,193932,true,3784960429,28,3700013866,-84946563
1641245793,193933,true,3784581971,28,3701123981,-83457990
1641247598,193934,true,3784203551,28,3721163105,-63040446
1641247637,193938,true,3782690247,28,3721535222,-61155025
1641247651,193939,true,3782312016,28,3721535222,-60776794
1641248026,193940,true,3781933823,28,3721907375,-60026448
1641248044,193940,true,3781933823,28,3721907375,-60026448
1641248400,193944,true,3780421427,28,3723024059,-57397368
1641248446,193945,true,3780043423,28,3723396361,-56647062
1641248581,193946,true,3779665457,28,3724513492,-55151965
1641248788,193947,true,3779287528,28,3726376121,-52911407
1641248801,193950,true,3778153968,28,3726376121,-51777847
1641248889,193952,true,3777398451,28,3727494146,-49904305
1641249048,193952,true,3777398451,28,3730477185,-46921266
1641249824,193951,true,3777776191,28,3749550260,-28225931
1641250147,193954,true,3776643084,28,3756305190,-20337894
1641250166,193956,true,3775887869,28,3756680821,-19207048
1641250278,193955,true,3776265458,28,3758559537,-17705921
1641251138,193955,true,3776265458,28,3762319788,-13945670
1641253046,193959,true,3774755329,28,3755554042,-19201287
1641253068,193960,true,3774377891,28,3755929597,-18448294
1641253071,193960,true,3774377891,28,3755929597,-18448294
1641253124,193960,true,3774377891,28,3755929597,-18448294
1641253423,193963,true,3773245805,28,3757432195,-15813610
1641254208,193964,true,3772868518,28,3761567437,-11301081
1641257280,193964,true,3772868518,28,3764954202,-7914316
1641257293,193964,true,3772868518,28,3764954202,-7914316
1641257335,193967,true,3771736883,28,3764954202,-6782681
1641257472,193968,true,3771359748,28,3764954202,-6405546
1641257541,193968,true,3771359748,28,3764954202,-6405546
1641257640,193968,true,3771359748,28,3764577745,-6782003
1641257710,193971,true,3770228566,28,3764577745,-5650821
1641257857,193973,true,3769474633,28,3763448597,-6026036
1641257876,193973,true,3769474633,28,3763072290,-6402343
1641258307,193974,true,3769097723,28,3758935393,-10162330
1641258675,193977,true,3767967220,28,3755554042,-12413178
1641260212,193980,true,3766837056,28,3747301317,-19535739
1641260719,193981,true,3766460410,28,3746926624,-19533786
1641260798,193982,true,3766083802,28,3746926624,-19157178
1641260900,193985,true,3764954202,28,3746926624,-18027578
1641260905,193988,true,3763824942,28,3746926624,-16898318
1641261919,193989,true,3763448597,28,3743556076,-19892521
1641261940,193990,true,3763072290,28,3743181758,-19890532
1641262027,193994,true,3761567437,28,3742059028,-19508409
1641263992,193998,true,3760063186,28,3722651794,-37411392
1641264491,193999,true,3759687218,28,3722651794,-37035424
1641264550,194000,true,3759311287,28,3723024059,-36287228
1641264578,194004,true,3757807938,28,3723024059,-34783879
1641265149,194008,true,3756305190,28,3724513492,-31791698
1641265563,194009,true,3755929597,28,3725258432,-30671165
1641267177,194010,true,3755554042,28,3727121434,-28432608
1641267787,194013,true,3754427601,28,3728612506,-25815095
1641268871,194016,true,3753301498,28,3733835958,-19465540
1641268917,194018,true,3752550950,28,3734209341,-18341609
1641269053,194018,true,3752550950,28,3735329716,-17221234
1641270761,194021,true,3751425410,28,3744304825,-7120585
1641271347,194025,true,3749925215,28,3744304825,-5620390
1641271999,194026,true,3749550260,28,3744304825,-5245435
1641272483,194026,true,3749550260,28,3744304825,-5245435
1641272531,194030,true,3748050815,28,3743930432,-4120383
1641273466,194033,true,3746926624,28,3739814578,-7112046
1641275273,194034,true,3746551969,28,3736076820,-10475149
1641275450,194035,true,3746177352,28,3734956221,-11221131
1641275540,194037,true,3745428228,28,3734582762,-10845466
1641275883,194041,true,3743930432,28,3732716031,-11214401
1641276008,194042,true,3743556076,28,3732342797,-11213279
1641276162,194042,true,3743556076,28,3731969600,-11586476
1641276751,194044,true,3742807477,28,3732342797,-10464680
1641277708,194047,true,3741684859,28,3736824072,-4860787
1641277760,194048,true,3741310728,28,3737197755,-4112973
1641277995,194048,true,3741310728,28,3738319026,-2991702
1641278047,194049,true,3740936635,28,3738692858,-2243777
1641278242,194052,true,3739814578,28,3739440634,-373944
1641279871,194053,true,3739440634,28,3750675238,11234604
1641281467,194051,true,3740188559,28,3750675238,10486679
1641283197,194051,true,3740188559,28,3753301498,13112939
1641283287,194054,true,3739066727,28,3753676828,14610101
1641283536,194054,true,3739066727,28,3754427601,15360874
1641283585,194053,true,3739440634,28,3754803044,15362410
1641283804,194052,true,3739814578,28,3756305190,16490612
1641284088,194053,true,3739440634,28,3758559537,19118903
1641284232,194053,true,3739440634,28,3759687218,20246584
1641284352,194051,true,3740188559,28,3760439193,20250634
1641285034,194050,true,3740562578,28,3766083802,25521224
1641285399,194051,true,3740188559,28,3767590461,27401902
1641286031,194052,true,3739814578,28,3767967220,28152642
1641286179,194049,true,3740936635,28,3767967220,27030585
1641287346,194048,true,3741310728,28,3767590461,26279733
1641290979,194050,true,3740562578,28,3767590461,27027883
1641291841,194050,true,3740562578,28,3767590461,27027883
1641291967,194049,true,3740936635,28,3767590461,26653826
1641292138,194048,true,3741310728,28,3767967220,26656492
1641293022,194049,true,3740936635,28,3772868518,31931883
1641293297,194049,true,3740936635,28,3775510318,34573683
1641293414,194047,true,3741684859,28,3777020749,35335890
1641293663,194044,true,3742807477,28,3780421427,37613950
1641294143,194044,true,3742807477,28,3787610696,44803219
1641294167,194043,true,3743181758,28,3787989457,44807699
1641294190,194041,true,3743930432,28,3788368256,44437824
1641295147,194036,true,3745802771,28,3806975882,61173111
1641295617,194033,true,3746926624,28,3812309114,65382490
1641296375,194032,true,3747301317,28,3815360029,68058712
1641296468,194029,true,3748425620,28,3815360029,66934409
1641297140,194024,true,3750300208,28,3818031582,67731374
1641297165,194022,true,3751050305,28,3818031582,66981277
1641297623,194020,true,3751800553,28,3820322974,68522421
1641297656,194017,true,3752926205,28,3820705006,67778801
1641299766,194012,true,3754803044,28,3825674904,70871860
1641300656,194009,true,3755929597,28,3825674904,69745307
1641301038,194008,true,3756305190,28,3825674904,69369714
1641302331,194005,true,3757432195,28,3825674904,68242709
1641303197,194001,true,3758935393,28,3825292375,66356982
1641303228,193999,true,3759687218,28,3825674904,65987686
1641303455,193997,true,3760439193,28,3825674904,65235711
1641303462,193995,true,3761191318,28,3825674904,64483586
1641303714,193990,true,3763072290,28,3826822721,63750431
1641304172,193988,true,3763824942,28,3830268240,66443298
1641304376,193987,true,3764201325,28,3831800577,67599252
1641304487,193984,true,3765330698,28,3833716860,68386162
1641304510,193979,true,3767213740,28,3834100232,66886492
1641304818,193976,true,3768344017,28,3839471463,71127446
1641304831,193975,true,3768720851,28,3839855410,71134559
1641304839,193972,true,3769851581,28,3839855410,70003829
1641304854,193968,true,3771359748,28,3840239395,68879647
1641304970,193964,true,3772868518,28,3842544115,69675597
1641307167,193963,true,3773245805,28,3862190163,88944358
1641307679,193963,true,3773245805,28,3862190163,88944358
1641307685,193959,true,3774755329,28,3862576382,87821053
1641307773,193955,true,3776265458,28,3862576382,86310924
1641307813,193954,true,3776643084,28,3862962639,86319555
1641308224,193952,true,3777398451,28,3867214024,89815573
1641309836,193947,true,3779287528,28,3881160385,101872857
1641310226,193944,true,3780421427,28,3880772308,100350881
1641310370,193943,true,3780799470,28,3880772308,99972838
1641310720,193940,true,3781933823,28,3879996270,98062447
1641310762,193936,true,3783446823,28,3879996270,96549447
1641310787,193933,true,3784581971,28,3879996270,95414299
1641311101,193932,true,3784960429,28,3878056854,93096425
1641311121,193930,true,3785717459,28,3878056854,92339395
1641311653,193927,true,3786853288,28,3874180929,87327641
1641311753,193923,true,3788368256,28,3873406209,85037953
1641311762,193923,true,3788368256,28,3873406209,85037953
1641311788,193921,true,3789125968,28,3873406209,84280241
1641311884,193917,true,3790641846,28,3872244419,81602573
1641311925,193914,true,3791779152,28,3871857234,80078082
1641311958,193913,true,3792158330,28,3871470087,79311757
1641312054,193910,true,3793296091,28,3870308878,77012787
1641313096,193907,true,3794434194,28,3858330096,63895902
1641313734,193904,true,3795572638,28,3853703108,58130470
1641313762,193903,true,3795952195,28,3853703108,57750913
1641314312,193901,true,3796711424,28,3852162012,55450588
1641315225,193897,true,3798230336,28,3850236509,52006173
1641316034,193894,true,3799369919,28,3849851524,50481605
1641316947,193893,true,3799749856,28,3850236509,50486653
1641319187,193890,true,3800889895,28,3851776834,50886939
1641320748,193887,true,3802030276,28,3849081669,47051393
1641320840,193882,true,3803931671,28,3848696799,44765128
1641320998,193880,true,3804692496,28,3847542421,42849925
1641321055,193878,true,3805453472,28,3847157705,41704233
1641321071,193876,true,3806214601,28,3847157705,40943104
1641321143,193872,true,3807737315,28,3846003789,38266474
1641321171,193871,true,3808118089,28,3845619227,37501138
1641321204,193869,true,3808879751,28,3845234703,36354952
1641321355,193867,true,3809641565,28,3842544115,32902550
1641321396,193864,true,3810784571,28,3841775722,30991151
1641321402,193863,true,3811165650,28,3841775722,30610072
1641321414,193862,true,3811546766,28,3841391582,29844816
1641321419,193860,true,3812309114,28,3841391582,29082468
1641321636,193858,true,3813071614,28,3836401267,23329653
1641321675,193857,true,3813452921,28,3835634102,22181181
1641322006,193856,true,3813834266,28,3827588124,13753858
1641322290,193854,true,3814597071,28,3819559024,4961953
1641322384,193852,true,3815360029,28,3816504751,1144722
1641322395,193851,true,3815741565,28,3816123139,381574
1641322827,193851,true,3815741565,28,3800889895,-14851670
1641322997,193850,true,3816123139,28,3796331790,-19791349
1641323137,193848,true,3816886402,28,3793296091,-23590311
1641323387,193846,true,3817649817,28,3790262819,-27386998
1641323398,193846,true,3817649817,28,3789883831,-27765986
1641323419,193845,true,3818031582,28,3789883831,-28147751
1641323489,193842,true,3819177106,28,3789883831,-29293275
1641323552,193839,true,3820322974,28,3789883831,-30439143
1641323621,193839,true,3820322974,28,3790641846,-29681128
1641325135,193837,true,3821087077,28,3821087077,0
1641325200,193835,true,3821851332,28,3822615741,764409
1641325443,193832,true,3822998002,28,3823762640,764638
1641325599,193832,true,3822998002,28,3823380302,382300
1641325856,193831,true,3823380302,28,3822998002,-382300
1641326013,193829,true,3824145017,28,3822233518,-1911499
1641326050,193826,true,3825292375,28,3821851332,-3441043
1641326720,193826,true,3825292375,28,3818413385,-6878990
1641326739,193826,true,3825292375,28,3818031582,-7260793
1641327477,193824,true,3826057472,28,3813071614,-12985858
1641327814,193822,true,3826822721,28,3811546766,-15275955
1641328188,193822,true,3826822721,28,3811165650,-15657071
1641328197,193822,true,3826822721,28,3811165650,-15657071
1641331892,193820,true,3827588124,28,3816504751,-11083373
1641332867,193817,true,3828736515,28,3816504751,-12231764
1641333585,193818,true,3828353680,28,3816886402,-11467278
1641333604,193817,true,3828736515,28,3816886402,-11850113
1641336322,193815,true,3829502301,28,3818031582,-11470719
1641337629,193813,true,3830268240,28,3818031582,-12236658
1641337984,193813,true,3830268240,28,3818031582,-12236658
1641338037,193813,true,3830268240,28,3818031582,-12236658
1641338270,193811,true,3831034332,28,3817268090,-13766242
1641338345,193809,true,3831800577,28,3817268090,-14532487
1641338721,193810,true,3831417435,28,3815360029,-16057406
1641339630,193810,true,3831417435,28,3811546766,-19870669
1641339765,193809,true,3831800577,28,3810784571,-21016006
1641339834,193808,true,3832183757,28,3810022529,-22161228
1641340885,193810,true,3831417435,28,3798610159,-32807276
1641341141,193811,true,3831034332,28,3795193119,-35841213
1641341257,193811,true,3831034332,28,3793296091,-37738241
1641341744,193810,true,3831417435,28,3786853288,-44564147
1641342719,193813,true,3830268240,28,3783446823,-46821417
1641342932,193815,true,3829502301,28,3784203551,-45298750
1641343486,193814,true,3829885251,28,3787989457,-41895794
1641344160,193814,true,3829885251,28,3790641846,-39243405
1641344460,193815,true,3829502301,28,3792537546,-36964755
1641344993,193818,true,3828353680,28,3795193119,-33160561
1641348339,193817,true,3828736515,28,3799369919,-29366596
1641351951,193816,true,3829119389,28,3799369919,-29749470
1641352249,193818,true,3828353680,28,3799369919,-28983761
1641352528,193820,true,3827588124,28,3800129831,-27458293
1641352731,193819,true,3827970883,28,3801650111,-26320772
1641354097,193818,true,3828353680,28,3812690345,-15663335
1641357607,193819,true,3827970883,28,3813834266,-14136617
1641359816,193821,true,3827205404,28,3813834266,-13371138
1641359822,193821,true,3827205404,28,3813834266,-13371138
1641361113,193820,true,3827588124,28,3813452921,-14135203
1641361709,193821,true,3827205404,28,3813071614,-14133790
1641363442,193825,true,3825674904,28,3805453472,-20221432
1641363482,193825,true,3825674904,28,3805453472,-20221432
1641366348,193824,true,3826057472,28,3806975882,-19081590
1641366947,193826,true,3825292375,28,3807356580,-17935795
1641367197,193829,true,3824145017,28,3807356580,-16788437
1641367349,193830,true,3823762640,28,3807737315,-16025325
1641367556,193829,true,3824145017,28,3808118089,-16026928
1641367989,193831,true,3823380302,28,3808498901,-14881401
1641371844,193834,true,3822233518,28,3809641565,-12591953
1641372340,193835,true,3821851332,28,3809641565,-12209767
1641372567,193834,true,3822233518,28,3810403531,-11829987
1641373287,193837,true,3821087077,28,3812309114,-8777963
1641373825,193840,true,3819940980,28,3813834266,-6106714
1641374681,193841,true,3819559024,28,3814597071,-4961953
1641374750,193841,true,3819559024,28,3814978531,-4580493
1641374924,193843,true,3818795227,28,3814978531,-3816696
1641375382,193846,true,3817649817,28,3816504751,-1145066
1641375583,193847,true,3817268090,28,3817268090,0
1641375707,193846,true,3817649817,28,3817649817,0
1641375747,193848,true,3816886402,28,3818031582,1145180
1641375810,193850,true,3816123139,28,3818413385,2290246
1641375999,193851,true,3815741565,28,3819559024,3817459
1641376613,193850,true,3816123139,28,3822998002,6874863
1641376922,193852,true,3815360029,28,3824145017,8784988
1641376964,193854,true,3814597071,28,3824527431,9930360
1641377029,193854,true,3814597071,28,3824527431,9930360
1641377045,193853,true,3814978531,28,3824909884,9931353
1641377179,193855,true,3814215650,28,3825674904,11459254
1641380560,193856,true,3813834266,28,3834100232,20265966
1641380682,193856,true,3813834266,28,3834100232,20265966
1641380735,193854,true,3814597071,28,3834100232,19503161
1641381120,193856,true,3813834266,28,3832950232,19115966
1641381177,193858,true,3813071614,28,3832950232,19878618
1641381199,193858,true,3813071614,28,3832950232,19878618
1641381604,193857,true,3813452921,28,3830651267,17198346
1641381788,193859,true,3812690345,28,3829502301,16811956
1641382031,193860,true,3812309114,28,3827588124,15279010
1641382351,193861,true,3811927921,28,3824145017,12217096
1641382422,193860,true,3812309114,28,3823380302,11071188
1641382439,193862,true,3811546766,28,3822998002,11451236
1641382559,193863,true,3811165650,28,3821469185,10303535
1641382575,193863,true,3811165650,28,3821087077,9921427
1641382763,193862,true,3811546766,28,3818031582,6484816
1641383073,193864,true,3810784571,28,3813452921,2668350
1641383544,193865,true,3810403531,28,3806595222,-3808309
1641385233,193865,true,3810403531,28,3794813637,-15589894
1641385248,193864,true,3810784571,28,3794813637,-15970934
1641385379,193866,true,3810022529,28,3794054788,-15967741
1641385627,193867,true,3809641565,28,3792916799,-16724766
1641385853,193867,true,3809641565,28,3791400012,-18241553
1641385913,193866,true,3810022529,28,3791020910,-19001619
1641386333,193868,true,3809260639,28,3788747093,-20513546
1641386458,193869,true,3808879751,28,3787989457,-20890294
1641387756,193869,true,3808879751,28,3780421427,-28458324
1641388391,193868,true,3809260639,28,3780799470,-28461169
1641388694,193868,true,3809260639,28,3781555667,-27704972
1641388850,193869,true,3808879751,28,3782690247,-26189504
1641388900,193869,true,3808879751,28,3782690247,-26189504
1641389388,193867,true,3809641565,28,3786096031,-23545534
1641389484,193868,true,3809260639,28,3786853288,-22407351
1641389687,193868,true,3809260639,28,3787989457,-21271182
1641390087,193869,true,3808879751,28,3790262819,-18616932
1641390311,193868,true,3809260639,28,3791400012,-17860627
1641390547,193869,true,3808879751,28,3792916799,-15962952
1641390969,193871,true,3808118089,28,3793675421,-14442668
1641392329,193871,true,3808118089,28,3802030276,-6087813
1641392686,193870,true,3808498901,28,3803551316,-4947585
1641392942,193871,true,3808118089,28,3803931671,-4186418
1641393423,193872,true,3807737315,28,3804692496,-3044819
1641393695,193872,true,3807737315,28,3804312064,-3425251
1641393727,193872,true,3807737315,28,3804692496,-3044819
1641393794,193872,true,3807737315,28,3805072965,-2664350
1641393807,193873,true,3807356580,28,3805072965,-2283615
1641394027,193872,true,3807737315,28,3806214601,-1522714
1641394330,193872,true,3807737315,28,3805834018,-1903297
1641394718,193872,true,3807737315,28,3806595222,-1142093
1641394875,193873,true,3807356580,28,3806975882,-380698
1641394913,193873,true,3807356580,28,3807356580,0
1641396492,193872,true,3807737315,28,3813071614,5334299
1641396778,193873,true,3807356580,28,3813071614,5715034
1641400974,193874,true,3806975882,28,3813071614,6095732
1641401026,193873,true,3807356580,28,3813071614,5715034
1641401120,193873,true,3807356580,28,3812690345,5333765
1641401137,193873,true,3807356580,28,3812690345,5333765
1641401209,193875,true,3806595222,28,3812309114,5713892
1641404185,193875,true,3806595222,28,3802790720,-3804502
1641404432,193874,true,3806975882,28,3802030276,-4945606
1641404602,193874,true,3806975882,28,3801650111,-5325771
1641405025,193876,true,3806214601,28,3800129831,-6084770
1641405260,193876,true,3806214601,28,3799369919,-6844682
1641405264,193875,true,3806595222,28,3799369919,-7225303
1641405560,193875,true,3806595222,28,3797091095,-9504127
1641405723,193876,true,3806214601,28,3795193119,-11021482
1641405793,193876,true,3806214601,28,3794434194,-11780407
1641405934,193876,true,3806214601,28,3791400012,-14814589
1641406128,193876,true,3806214601,28,3786096031,-20118570
1641406143,193878,true,3805453472,28,3785717459,-19736013
1641406200,193879,true,3805072965,28,3784203551,-20869414
1641406234,193879,true,3805072965,28,3783446823,-21626142
1641406236,193880,true,3804692496,28,3783446823,-21245673
1641406296,193882,true,3803931671,28,3781555667,-22376004
1641406396,193884,true,3803170999,28,3778531784,-24639215
1641406400,193885,true,3802790720,28,3778531784,-24258936
1641406891,193886,true,3802410479,28,3763072290,-39338189
1641406970,193888,true,3801650111,28,3760815237,-40834874
1641407213,193890,true,3800889895,28,3753676828,-47213067
1641407289,193891,true,3800509844,28,3751425410,-49084434
1641407290,193893,true,3799749856,28,3751425410,-48324446
1641407476,193895,true,3798990020,28,3746926624,-52063396
1641407964,193896,true,3798610159,28,3745802771,-52807388
1641408414,193897,true,3798230336,28,3749550260,-48680076
1641409471,193898,true,3797850551,28,3757432195,-40418356
1641409510,193900,true,3797091095,28,3757432195,-39658900
1641409620,193901,true,3796711424,28,3756680821,-40030603
1641409787,193902,true,3796331790,28,3755929597,-40402193
1641409944,193904,true,3795572638,28,3754052196,-41520442
1641409964,193906,true,3794813637,28,3753676828,-41136809
1641409975,193907,true,3794434194,28,3753676828,-40757366
1641410100,193909,true,3793675421,28,3751425410,-42250011
1641410114,193912,true,3792537546,28,3751425410,-41112136
1641410135,193914,true,3791779152,28,3750675238,-41103914
1641410852,193916,true,3791020910,28,3732716031,-58304879
1641411300,193918,true,3790262819,28,3723024059,-67238760
1641411310,193921,true,3789125968,28,3723024059,-66101909
1641411336,193923,true,3788368256,28,3722279566,-66088690
1641411911,193926,true,3787231973,28,3710016901,-77215072
1641411967,193929,true,3786096031,28,3709275009,-76821022
1641411981,193932,true,3784960429,28,3709275009,-75685420
1641412013,193934,true,3784203551,28,3708162449,-76041102
1641412094,193939,true,3782312016,28,3706679555,-75632461
1641412190,193942,true,3781177550,28,3705567773,-75609777
1641412201,193945,true,3780043423,28,3704826771,-75216652
1641412351,193948,true,3778909637,28,3701494093,-77415544
1641412461,193954,true,3776643084,28,3698904083,-77739001
1641412486,193957,true,3775510318,28,3698164414,-77345904
1641412709,193961,true,3774000491,28,3691144923,-82855568
1641413034,193964,true,3772868518,28,3680456642,-92411876
1641413044,193970,true,3770605589,28,3680088633,-90516956
1641413055,193973,true,3769474633,28,3679720661,-89753972
1641413117,193978,true,3767590461,28,3677145887,-90444574
1641413136,193983,true,3765707231,28,3676410568,-89296663
1641413272,193989,true,3763448597,28,3670533308,-92915289
1641413283,193993,true,3761943594,28,3670166291,-91777303
1641413327,193998,true,3760063186,28,3667964962,-92098224
1641413376,194003,true,3758183719,28,3665398413,-92785306
1641413387,194010,true,3755554042,28,3665031910,-90522132
1641413407,194013,true,3754427601,28,3663932621,-90494980
1641413559,194018,true,3752550950,28,3656246819,-96304131
1641413576,194023,true,3750675238,28,3655515680,-95159558
1641413629,194030,true,3748050815,28,3653323138,-94727677
1641413736,194032,true,3747301317,28,3649306892,-97994425
1641413993,194036,true,3745802771,28,3642744376,-103058395
1641414133,194040,true,3744304825,28,3639831492,-104473333
1641414151,194047,true,3741684859,28,3639467545,-102217314
1641414185,194049,true,3740936635,28,3639103634,-101833001
1641414193,194052,true,3739814578,28,3638739760,-101074818
1641414209,194056,true,3738319026,28,3638375923,-99943103
1641414274,194062,true,3736076820,28,3637284628,-98792192
1641414294,194064,true,3735329716,28,3636920936,-98408780
1641414744,194067,true,3734209341,28,3632559467,-101649874
1641414827,194071,true,3732716031,28,3630743732,-101972299
1641414875,194077,true,3730477185,28,3630017692,-100459493
1641414908,194079,true,3729731202,28,3629654726,-100076476
1641414943,194083,true,3728239682,28,3629291797,-98947885
1641414947,194087,true,3726748759,28,3629291797,-97456962
1641415035,194092,true,3724885943,28,3628928904,-95957039
1641415143,194094,true,3724141078,28,3629654726,-94486352
1641415330,194098,true,3722651794,28,3631469917,-91181877
1641415364,194102,true,3721163105,28,3631833064,-89330041
1641415371,194107,true,3719303082,28,3631469917,-87833165
1641415422,194109,true,3718559333,28,3631469917,-87089416
1641415458,194115,true,3716328978,28,3630743732,-85585246
1641415471,194120,true,3714471371,28,3630743732,-83727639
1641415503,194125,true,3712614692,28,3630380694,-82233998
1641415758,194127,true,3711872280,28,3627477695,-84394585
1641415837,194133,true,3709645936,28,3625664501,-83981435
1641415866,194138,true,3707791670,28,3624939476,-82852194
1641415941,194144,true,3705567773,28,3623127550,-82440223
1641416069,194147,true,3704456325,28,3620954434,-83501891
1641416288,194153,true,3702234429,28,3615165829,-87068600
1641416445,194158,true,3700383867,28,3611191531,-89192336
1641416466,194164,true,3698164414,28,3610830448,-87333966
1641416473,194167,true,3697055186,28,3610469402,-86585784
1641416769,194173,true,3694837729,28,3607221603,-87616126
1641416781,194178,true,3692990864,28,3607221603,-85769261
1641416853,194184,true,3690775845,28,3607221603,-83554242
1641417400,194186,true,3690037801,28,3606860917,-83176884
1641417422,194191,true,3688193335,28,3606860917,-81332418
1641417868,194196,true,3686349792,28,3609747416,-76602376
1641417948,194202,true,3684138756,28,3610469402,-73669354
1641418007,194205,true,3683033735,28,3610830448,-72203287
1641418277,194211,true,3680824688,28,3610108391,-70716297
1641418298,194217,true,3678616966,28,3609747416,-68869550
1641418317,194224,true,3676042964,28,3609747416,-66295548
1641418340,194227,true,3674940371,28,3609025575,-65914796
1641418509,194234,true,3672368942,28,3606139653,-66229289
1641418711,194240,true,3670166291,28,3601094842,-69071449
1641418718,194246,true,3667964962,28,3600734769,-67230193
1641418802,194249,true,3666864793,28,3598215262,-68649531
1641419080,194257,true,3663932621,28,3589590331,-74342290
1641419142,194263,true,3661735030,28,3587437330,-74297700
1641419150,194269,true,3659538758,28,3587078622,-72460136
1641419209,194272,true,3658441116,28,3585285621,-73155495
1641419447,194279,true,3655881231,28,3579196117,-76685114
1641419464,194285,true,3653688470,28,3578838234,-74850236
1641419554,194290,true,3651862174,28,3577049351,-74812823
1641419796,194292,true,3651131911,28,3572045236,-79086675
1641419826,194298,true,3648941998,28,3571688067,-77253931
1641419973,194303,true,3647118074,28,3569902759,-77215315
1641420197,194308,true,3645295062,28,3567761567,-77533495
1641420237,194311,true,3644201692,28,3567761567,-76440125
1641420680,194316,true,3642380138,28,3565621659,-76758479
1641420718,194321,true,3640559494,28,3565265132,-75294362
1641420729,194326,true,3638739760,28,3564908641,-73831119
1641420742,194329,true,3637648357,28,3564908641,-72739716
1641421127,194337,true,3634739547,28,3556719182,-78020365
1641421298,194343,true,3632559467,28,3552098682,-80460785
1641421384,194348,true,3630743732,28,3549613208,-81130524
1641421417,194350,true,3630017692,28,3548548537,-81469155
1641421421,194359,true,3626752309,28,3548548537,-78203772
1641421497,194365,true,3624577019,28,3545710975,-78866044
1641421505,194371,true,3622403034,28,3545710975,-76692059
1641421529,194374,true,3621316530,28,3544647474,-76669056
1641421533,194383,true,3618058974,28,3544647474,-73411500
1641421570,194389,true,3615888898,28,3543229970,-72658928
1641421586,194395,true,3613720124,28,3542521430,-71198694
1641421672,194398,true,3612636225,28,3539688688,-72947537
1641421691,194406,true,3609747416,28,3538980856,-70766560
1641421694,194412,true,3607582325,28,3538980856,-68601469
1641421706,194419,true,3605058028,28,3538273166,-66784862
1641421782,194423,true,3603616365,28,3534383400,-69232965
1641421808,194431,true,3600734769,28,3532970000,-67764769
1641421919,194437,true,3598575084,28,3527322050,-71253034
1641422014,194444,true,3596057088,28,3520978898,-75078190
1641422071,194449,true,3594259599,28,3517108144,-77151455
1641422103,194457,true,3591385485,28,3514647153,-76738332
1641422127,194465,true,3588513669,28,3512890356,-75623313
1641422134,194471,true,3586361314,28,3512187883,-74173431
1641422141,194477,true,3584210250,28,3511836700,-72373550
1641422164,194484,true,3581702306,28,3510432316,-71269990
1641422172,194491,true,3579196117,28,3509730335,-69465782
1641422183,194495,true,3577764797,28,3509028494,-68736303
1641422205,194500,true,3575976451,28,3507975996,-68000455
1641422216,194506,true,3573831616,28,3507274506,-66557110
1641422298,194511,true,3572045236,28,3503769160,-68276076
1641422311,194514,true,3570973837,28,3503418818,-67555019
1641422365,194518,true,3569545804,28,3501317502,-68228302
1641422405,194524,true,3567404826,28,3500267317,-67137509
1641422491,194526,true,3566691452,28,3498167892,-68523560
1641422516,194530,true,3565265132,28,3497818110,-67447022
1641422550,194532,true,3564552186,28,3497468363,-67083823
1641422623,194538,true,3562414203,28,3496768974,-65645229
1641422701,194539,true,3562057997,28,3496768974,-65289023
1641422732,194541,true,3561345693,28,3496768974,-64576719
1641422863,194543,true,3560633530,28,3497468363,-63165167
1641423059,194546,true,3559565554,28,3499217447,-60348107
1641423238,194547,true,3559209633,28,3500967406,-58242227
1641423288,194548,true,3558853747,28,3501317502,-57536245
1641423293,194550,true,3558142083,28,3501317502,-56824581
1641423377,194554,true,3556719182,28,3502368003,-54351179
1641423404,194555,true,3556363546,28,3502718239,-53645307
1641423622,194557,true,3555652380,28,3506573157,-49079223
1641423703,194560,true,3554585898,28,3508677627,-45908271
1641423744,194565,true,3552809138,28,3510432316,-42376822
1641423883,194566,true,3552453892,28,3517108144,-35345748
1641423897,194568,true,3551743508,28,3518163382,-33580126
1641423931,194571,true,3550678198,28,3519922815,-30755383
1641424112,194576,true,3548903391,28,3525206397,-23696994
1641424174,194577,true,3548548537,28,3525911474,-22637063
1641424285,194580,true,3547484185,28,3526264065,-21220120
1641424361,194582,true,3546774794,28,3526264065,-20510729
1641424405,194588,true,3544647474,28,3526616691,-18030783
1641424514,194589,true,3544293045,28,3526969353,-17323692
1641424703,194591,true,3543584293,28,3526616691,-16967602
1641424860,194593,true,3542875682,28,3526264065,-16611617
1641424905,194597,true,3541458886,28,3526616691,-14842195
1641424974,194597,true,3541458886,28,3526969353,-14489533
1641425280,194598,true,3541104776,28,3530144895,-10959881
1641425296,194600,true,3540396661,28,3530144895,-10251766
1641425425,194605,true,3538626993,28,3532616738,-6010255
1641425780,194605,true,3538626993,28,3538273166,-353827
1641425833,194606,true,3538273166,28,3538980856,707690
1641426437,194608,true,3537565618,28,3547129472,9563854
1641426538,194611,true,3536504560,28,3548193717,11689157
1641427094,194610,true,3536858211,28,3551388369,14530158
1641427147,194611,true,3536504560,28,3551388369,14883809
1641427177,194613,true,3535797365,28,3551388369,15591004
1641427234,194617,true,3534383400,28,3551033266,16649866
1641427264,194617,true,3534383400,28,3550678198,16294798
1641427291,194618,true,3534029997,28,3550323166,16293169
1641427338,194620,true,3533323297,28,3549613208,16289911
1641427734,194624,true,3531910321,28,3544293045,12382724
1641428315,194623,true,3532263512,28,3538626993,6363481
1641428332,194625,true,3531557165,28,3538273166,6716001
1641428448,194626,true,3531204045,28,3536858211,5654166
1641428487,194631,true,3529438972,28,3536150945,6711973
1641428507,194631,true,3529438972,28,3535797365,6358393
1641428703,194633,true,3528733190,28,3530497910,1764720
1641428732,194637,true,3527322050,28,3529791916,2469866
1641428797,194642,true,3525558918,28,3528380352,2821434
1641429113,194641,true,3525911474,28,3523796667,-2114807
1641429170,194643,true,3525206397,28,3523796667,-1409730
1641429283,194646,true,3524149047,28,3523796667,-352380
1641429365,194650,true,3522739739,28,3524149047,1409308
1641429406,194648,true,3523444323,28,3524149047,704724
1641430788,194649,true,3523092013,28,3536504560,13412547
1641430856,194651,true,3522387501,28,3537211896,14824395
1641431201,194653,true,3521683129,28,3539334754,17651625
1641431274,194651,true,3522387501,28,3539334754,16947253
1641431486,194652,true,3522035297,28,3538626993,16591696
1641431560,194654,true,3521330996,28,3538273166,16942170
1641431584,194656,true,3520626835,28,3538273166,17646331
1641431614,194654,true,3521330996,28,3537919374,16588378
1641431925,194656,true,3520626835,28,3535443821,14816986
1641432009,194658,true,3519922815,28,3534736838,14814023
1641433950,194660,true,3519218936,28,3526616691,7397755
1641433982,194658,true,3519922815,28,3526616691,6693876
1641434236,194660,true,3519218936,28,3524501462,5282526
1641435174,194663,true,3518163382,28,3519922815,1759433
1641435220,194666,true,3517108144,28,3519570858,2462714
1641435261,194664,true,3517811601,28,3519218936,1407335
1641435712,194665,true,3517459855,28,3516404828,-1055027
1641435731,194668,true,3516404828,28,3516053222,-351606
1641435886,194671,true,3515350117,28,3516053222,703105
1641435936,194669,true,3516053222,28,3515701652,-351570
1641436193,194670,true,3515701652,28,3514647153,-1054499
1641436789,194673,true,3514647153,28,3509730335,-4916818
1641436859,194673,true,3514647153,28,3509028494,-5618659
1641436943,194671,true,3515350117,28,3508677627,-6672490
1641436990,194672,true,3514998617,28,3508326794,-6671823
1641437033,194675,true,3513944329,28,3507975996,-5968333
1641437041,194675,true,3513944329,28,3507975996,-5968333
1641437090,194672,true,3514998617,28,3507975996,-7022621
1641437213,194673,true,3514647153,28,3507274506,-7372647
1641437303,194675,true,3513944329,28,3507274506,-6669823
1641437465,194675,true,3513944329,28,3506573157,-7371172
1641437475,194672,true,3514998617,28,3506573157,-8425460
1641438025,194673,true,3514647153,28,3507975996,-6671157
1641438344,194675,true,3513944329,28,3509379397,-4564932
1641438457,194675,true,3513944329,28,3509730335,-4213994
1641438667,194672,true,3514998617,28,3509730335,-5268282
1641438917,194673,true,3514647153,28,3509028494,-5618659
1641439023,194673,true,3514647153,28,3508677627,-5969526
1641440027,194673,true,3514647153,28,3494322215,-20324938
1641440066,194670,true,3515701652,28,3493623455,-22078197
1641440169,194670,true,3515701652,28,3492226355,-23475297
1641440194,194670,true,3515701652,28,3491877167,-23824485
1641440395,194670,true,3515701652,28,3489782774,-25918878
1641440450,194665,true,3517459855,28,3488736049,-28723806
1641440502,194665,true,3517459855,28,3488038406,-29421449
1641440925,194664,true,3517811601,28,3481765897,-36045704
1641441163,194666,true,3517108144,28,3480025537,-37082607
1641441378,194662,true,3518515198,28,3478286046,-40229152
1641441395,194663,true,3518163382,28,3477938252,-40225130
1641441416,194662,true,3518515198,28,3477938252,-40576946
1641441430,194664,true,3517811601,28,3477590493,-40221108
1641441463,194663,true,3518163382,28,3477242769,-40920613
1641441482,194664,true,3517811601,28,3476895079,-40916522
1641441496,194665,true,3517459855,28,3476895079,-40564776
1641441516,194667,true,3516756468,28,3476547424,-40209044
1641441551,194668,true,3516404828,28,3475852219,-40552609
1641441568,194669,true,3516053222,28,3475504669,-40548553
1641441892,194671,true,3515350117,28,3469601625,-45748492
1641441900,194673,true,3514647153,28,3469601625,-45045528
1641441944,194674,true,3514295723,28,3468560953,-45734770
1641441988,194676,true,3513592969,28,3467867344,-45725625
1641442035,194679,true,3512539102,28,3466827192,-45711910
1641442129,194683,true,3511134438,28,3464747824,-46386614
1641442162,194684,true,3510783359,28,3463708607,-47074752
1641442179,194685,true,3510432316,28,3463362271,-47070045
1641442222,194688,true,3509379397,28,3462323470,-47055927
1641442225,194692,true,3507975996,28,3462323470,-45652526
1641442356,194693,true,3507625234,28,3459554857,-48070377
1641442364,194694,true,3507274506,28,3459554857,-47719649
1641442392,194697,true,3506222534,28,3458863050,-47359484
1641442452,194701,true,3504820396,28,3458171381,-46649015
1641442502,194701,true,3504820396,28,3457479851,-47340545
1641442516,194703,true,3504119537,28,3457134137,-46985400
1641442621,194705,true,3503418818,28,3456097205,-47321613
1641442983,194708,true,3502368003,28,3452988272,-49379731
1641443104,194708,true,3502368003,28,3451607422,-50760581
1641443115,194709,true,3502017801,28,3451607422,-50410379
1641443216,194712,true,3500967406,28,3450572146,-50395260
1641443362,194715,true,3499917325,28,3449537182,-50380143
1641443403,194716,true,3499567369,28,3449192263,-50375106
1641443412,194717,true,3499217447,28,3449192263,-50025184
1641443534,194721,true,3497818110,28,3448502528,-49315582
1641443586,194724,true,3496768974,28,3447468184,-49300790
1641443613,194726,true,3496069725,28,3447468184,-48601541
1641443670,194728,true,3495370616,28,3446778794,-48591822
1641443685,194732,true,3493972817,28,3446778794,-47194023
1641443693,194736,true,3492575578,28,3446778794,-45796784
1641443796,194738,true,3491877167,28,3445400427,-46476740
1641443877,194741,true,3490829814,28,3444367013,-46462801
1641443934,194745,true,3489433831,28,3443678243,-45755588
1641444053,194749,true,3488038406,28,3441956920,-46081486
1641444085,194752,true,3486992204,28,3440924540,-46067664
1641444132,194756,true,3485597756,28,3439892469,-45705287
1641444137,194761,true,3483855479,28,3439892469,-43963010
1641444207,194765,true,3482462285,28,3438173038,-44289247
1641444317,194767,true,3481765897,28,3436110856,-45655041
1641444468,194769,true,3481069649,28,3433019902,-48049747
1641444533,194773,true,3479677569,28,3431303907,-48373662
1641444592,194777,true,3478286046,28,3429931729,-48354317
1641444663,194778,true,3477938252,28,3428560099,-49378153
1641444712,194781,true,3476895079,28,3427531737,-49363342
1641445042,194783,true,3476199804,28,3425475937,-50723867
1641445196,194786,true,3475157153,28,3425475937,-49681216
1641445264,194787,true,3474809672,28,3425818485,-48991187
1641445310,194788,true,3474462226,28,3425818485,-48643741
1641445500,194790,true,3473767438,28,3427531737,-46235701
1641445608,194793,true,3472725516,28,3428902955,-43822561
1641445866,194794,true,3472378278,28,3434736756,-37641522
1641446135,194795,true,3472031075,28,3442301116,-29729959
1641446173,194796,true,3471683906,28,3443333910,-28349996
1641446419,194799,true,3470642610,28,3449537182,-21105428
1641446455,194801,true,3469948585,28,3450572146,-19376439
1641447028,194803,true,3469254699,28,3458171381,-11083318
1641447681,194804,true,3468907809,28,3464054978,-4852831
1641447693,194807,true,3467867344,28,3464054978,-3812366
1641447740,194808,true,3467520592,28,3463708607,-3811985
1641448103,194810,true,3466827192,28,3462323470,-4503722
1641448505,194813,true,3465787352,28,3459554857,-6232495
1641448516,194815,true,3465094299,28,3459554857,-5539442
1641449008,194816,true,3464747824,28,3457479851,-7267973
1641449033,194818,true,3464054978,28,3457134137,-6920841
1641449098,194820,true,3463362271,28,3455751629,-7610642
1641449865,194823,true,3462323470,28,3448157712,-14165758
1641450002,194825,true,3461631109,28,3448157712,-13473397
1641450099,194826,true,3461284981,28,3447812931,-13472050
1641450222,194828,true,3460592828,28,3447812931,-12779897
1641450278,194830,true,3459900813,28,3448157712,-11743101
1641450886,194831,true,3459554857,28,3448157712,-11397145
1641451180,194833,true,3458863050,28,3449537182,-9325868
1641451388,194834,true,3458517198,28,3450227124,-8290074
1641451472,194837,true,3457479851,28,3449882136,-7597715
1641451910,194839,true,3456788459,28,3447123471,-9664988
1641452602,194840,true,3456442814,28,3437485507,-18957307
1641452726,194842,true,3455751629,28,3436110856,-19640773
1641452765,194844,true,3455060583,28,3436110856,-18949727
1641452834,194846,true,3454369674,28,3436110856,-18258818
1641453236,194846,true,3454369674,28,3436798113,-17571561
1641453447,194848,true,3453678904,28,3438516856,-15162048
1641453835,194850,true,3452988272,28,3442301116,-10687156
1641454298,194852,true,3452297778,28,3447812931,-4484847
1641455256,194852,true,3452297778,28,3451262295,-1035483
1641455339,194853,true,3451952582,28,3451262295,-690287
1641455508,194856,true,3450917204,28,3451607422,690218
1641456194,194858,true,3450227124,28,3450917204,690080
1641456746,194858,true,3450227124,28,3450572146,345022
1641456777,194860,true,3449537182,28,3450227124,689942
1641456861,194862,true,3448847378,28,3449882136,1034758
1641456951,194864,true,3448157712,28,3449537182,1379470
1641457007,194865,true,3447812931,28,3449192263,1379332
1641457475,194866,true,3447468184,28,3446778794,-689390
1641457548,194868,true,3446778794,28,3446089541,-689253
1641457679,194870,true,3446089541,28,3444022611,-2066930
1641457905,194870,true,3446089541,28,3440580482,-5509059
1641458286,194873,true,3445055921,28,3432676635,-12379286
1641458354,194875,true,3444367013,28,3430960811,-13406202
1641458558,194877,true,3443678243,28,3425133424,-18544819
1641458610,194878,true,3443333910,28,3423763713,-19570197
1641459008,194881,true,3442301116,28,3412825726,-29475390
1641459084,194882,true,3441956920,28,3411802083,-30154837
1641459333,194885,true,3440924540,28,3406688472,-34236068
1641459949,194886,true,3440580482,28,3401242401,-39338081
1641460566,194889,true,3439548514,28,3396823879,-42724635
1641460669,194890,true,3439204594,28,3396823879,-42380715
1641460763,194892,true,3438516856,28,3396823879,-41692977
1641460852,194893,true,3438173038,28,3396823879,-41349159
1641460871,194896,true,3437141793,28,3396484231,-40657562
1641460978,194897,true,3436798113,28,3395805036,-40993077
1641461158,194899,true,3436110856,28,3394786498,-41324358
1641461253,194900,true,3435767280,28,3394107642,-41659638
1641461277,194903,true,3434736756,28,3393768266,-40968490
1641461283,194904,true,3434393316,28,3393428923,-40964393
1641461611,194908,true,3433019902,28,3386649186,-46370716
1641461649,194910,true,3432333401,28,3385294865,-47038536
1641461733,194912,true,3431647038,28,3382587847,-49059191
1641461857,194913,true,3431303907,28,3379545040,-51758867
1641461934,194918,true,3429588770,28,3377518022,-52070748
1641462001,194920,true,3428902955,28,3375492220,-53410735
1641462034,194923,true,3427874490,28,3374479775,-53394715
1641462055,194924,true,3427531737,28,3374142361,-53389376
1641462059,194928,true,3426161067,28,3374142361,-52018706
1641462192,194930,true,3425475937,28,3370770074,-54705863
1641462385,194932,true,3424790945,28,3366391138,-58399807
1641462456,194933,true,3424448500,28,3364708448,-59740052
1641462511,194939,true,3422394550,28,3363362901,-59031649
1641462546,194940,true,3422052345,28,3362354094,-59698251
1641462608,194943,true,3421025934,28,3360337387,-60688547
1641462785,194945,true,3420341832,28,3354965415,-65376417
1641462840,194951,true,3418290345,28,3352953140,-65337205
1641462909,194953,true,3417606789,28,3350607011,-66999778
1641462917,194956,true,3416581712,28,3350271984,-66309728
1641463100,194959,true,3415556942,28,3342909855,-72647087
1641463149,194965,true,3413508325,28,3340904811,-72603514
1641463263,194967,true,3412825726,28,3337899499,-74926227
1641463273,194970,true,3411802083,28,3337565743,-74236340
1641463395,194973,true,3410778747,28,3333896622,-76882125
1641463411,194978,true,3409073869,28,3333563266,-75510603
1641463579,194980,true,3408392157,28,3331230705,-77161452
1641463632,194982,true,3407710581,28,3330564559,-77146022
1641463684,194985,true,3406688472,28,3329898546,-76789926
1641463779,194990,true,3404985638,28,3329232666,-75752972
1641463904,194991,true,3404645174,28,3327901306,-76743868
1641464119,194992,true,3404304743,28,3325240182,-79064561
1641464199,194995,true,3403283656,28,3324242810,-79040846
1641464497,194999,true,3401922683,28,3321252486,-80670197
1641464524,194999,true,3401922683,28,3321252486,-80670197
1641464643,195001,true,3401242401,28,3320588336,-80654065
1641464714,195003,true,3400562254,28,3320920394,-79641860
1641464901,195007,true,3399202369,28,3322581187,-76621182
1641465030,195008,true,3398862483,28,3324575234,-74287249
1641465086,195009,true,3398522631,28,3325240182,-73282449
1641465113,195011,true,3397843028,28,3325572706,-72270322
1641465165,195016,true,3396144616,28,3326570478,-69574138
1641465168,195016,true,3396144616,28,3326570478,-69574138
1641465204,195019,true,3395125976,28,3327235825,-67890151
1641465208,195021,true,3394447053,28,3327235825,-67211228
1641465481,195026,true,3392750339,28,3331563828,-61186511
1641465485,195026,true,3392750339,28,3331563828,-61186511
1641465751,195029,true,3391732717,28,3336898330,-54834387
1641465764,195031,true,3391054472,28,3336898330,-54156142
1641466005,195036,true,3389359454,28,3339902740,-49456714
1641466102,195037,true,3389020552,28,3341238901,-47781651
1641467503,195039,true,3388342849,28,3351947455,-36395394
1641467642,195042,true,3387326549,28,3351612294,-35714255
1641467755,195047,true,3385633394,28,3351947455,-33685939
1641467778,195048,true,3385294865,28,3351947455,-33347410
1641467828,195052,true,3383941085,28,3351947455,-31993630
1641467894,195054,true,3383264399,28,3351947455,-31316944
1641467899,195059,true,3381573274,28,3352282650,-29290624
1641468625,195059,true,3381573274,28,3354294522,-27278752
1641468636,195061,true,3380897060,28,3354294522,-26602538
1641468684,195064,true,3379882994,28,3354294522,-25588472
1641468697,195069,true,3378193560,28,3354294522,-23899038
1641468962,195070,true,3377855774,28,3354294522,-23561252
1641469075,195072,true,3377180304,28,3353959126,-23221178
1641469427,195075,true,3376167353,28,3352617878,-23549475
1641470150,195080,true,3374479775,28,3346254269,-28225506
1641470439,195080,true,3374479775,28,3343912828,-30566947
1641470484,195083,true,3373467634,28,3343578470,-29889164
1641470653,195086,true,3372455796,28,3343244146,-29211650
1641471437,195091,true,3370770074,28,3344581644,-26188430
1641471611,195092,true,3370433030,28,3345585119,-24847911
1641471726,195094,true,3369759045,28,3345585119,-24173926
1641472078,195097,true,3368748319,28,3344247219,-24501100
1641472145,195102,true,3367064450,28,3343912828,-23151622
1641472194,195102,true,3367064450,28,3343578470,-23485980
1641472251,195105,true,3366054533,28,3343244146,-22810387
1641473167,195108,true,3365044919,28,3333229943,-31814976
1641473382,195113,true,3363362901,28,3331563828,-31799073
1641473426,195114,true,3363026598,28,3331563828,-31462770
1641473541,195117,true,3362017892,28,3331563828,-30454064
1641473596,195120,true,3361009488,28,3331896984,-29112504
1641473605,195124,true,3359665420,28,3331896984,-27768436
1641474022,195125,true,3359329487,28,3335563904,-23765583
1641474157,195127,true,3358657722,28,3337899499,-20758223
1641474166,195131,true,3357314595,28,3338233289,-19081306
1641474203,195134,true,3356307602,28,3338900969,-17406633
1641474285,195134,true,3356307602,28,3340904811,-15402791
1641474647,195135,true,3355972005,28,3352617878,-3354127
1641474676,195137,true,3355300911,28,3353623764,-1677147
1641474701,195141,true,3353959126,28,3354294522,335396
1641474739,195140,true,3354294522,28,3355300911,1006389
1641474833,195142,true,3353623764,28,3357650327,4026563
1641474853,195145,true,3352617878,28,3357986092,5368214
1641474943,195148,true,3351612294,28,3360337387,8725093
1641474991,195146,true,3352282650,28,3361345589,9062939
1641475252,195146,true,3352282650,28,3367737897,15455247
1641475341,195149,true,3351277166,28,3368748319,17471153
1641475457,195152,true,3350271984,28,3370096021,19824037
1641476869,195150,true,3350942072,28,3374479775,23537703
1641476918,195148,true,3351612294,28,3374479775,22867481
1641476954,195151,true,3350607011,28,3374479775,23872764
1641476997,195154,true,3349602030,28,3374479775,24877745
1641477050,195151,true,3350607011,28,3375492220,24885209
1641477072,195149,true,3351277166,28,3375829770,24552604
1641477522,195150,true,3350942072,28,3384279479,33337407
1641478422,195153,true,3349936990,28,3399202369,49265379
1641478477,195150,true,3350942072,28,3399882244,48940172
1641478558,195148,true,3351612294,28,3401242401,49630107
1641478682,195150,true,3350942072,28,3403283656,52341584
1641478723,195152,true,3350271984,28,3403623985,53352001
1641478729,195148,true,3351612294,28,3403964347,52352053
1641479161,195146,true,3352282650,28,3403964347,51681697
1641479185,195148,true,3351612294,28,3403964347,52352053
1641479290,195149,true,3351277166,28,3403623985,52346819
1641479660,195144,true,3352953140,28,3401922683,48969543
1641479672,195142,true,3353623764,28,3401582525,47958761
1641479743,195144,true,3352953140,28,3401582525,48629385
1641479779,195143,true,3353288435,28,3401242401,47953966
1641479788,195138,true,3354965415,28,3401242401,46276986
1641479811,195136,true,3355636441,28,3401242401,45605960
1641480184,195136,true,3355636441,28,3403964347,48327906
1641480469,195135,true,3355972005,28,3406347837,50375832
1641480556,195131,true,3357314595,28,3407029141,49714546
1641480865,195129,true,3357986092,28,3407710581,49724489
1641481009,195129,true,3357986092,28,3408392157,50406065
1641481151,195128,true,3358321890,28,3409414777,51092887
1641481256,195124,true,3359665420,28,3409755718,50090298
1641481455,195123,true,3360001387,28,3409755718,49754331
1641481546,195123,true,3360001387,28,3409073869,49072482
1641481647,195122,true,3360337387,28,3408051352,47713965
1641481881,195119,true,3361345589,28,3403623985,42278396
1641481922,195117,true,3362017892,28,3402603102,40585210
1641482985,195117,true,3362017892,28,3377180304,15162412
1641483158,195116,true,3362354094,28,3374817223,12463129
1641483323,195112,true,3363699237,28,3373130321,9431084
1641483352,195111,true,3364035607,28,3373467634,9432027
1641483373,195110,true,3364372011,28,3373804981,9432970
1641483385,195108,true,3365044919,28,3373804981,8760062
1641483389,195104,true,3366391138,28,3373804981,7413843
1641483403,195103,true,3366727778,28,3373804981,7077203
1641483997,195102,true,3367064450,28,3380559005,13494555
1641485155,195101,true,3367401157,28,3396144616,28743459
1641485674,195096,true,3369085194,28,3395805036,26719842
1641485700,195095,true,3369422103,28,3395805036,26382933
1641485806,195094,true,3369759045,28,3396484231,26725186
1641486212,195092,true,3370433030,28,3399202369,28769339
1641486213,195087,true,3372118584,28,3399202369,27083785
1641486457,195086,true,3372455796,28,3400902310,28446514
1641486635,195085,true,3372793041,28,3401922683,29129642
1641486727,195084,true,3373130321,28,3402262875,29132554
1641486765,195079,true,3374817223,28,3402262875,27445652
1641488531,195080,true,3374479775,28,3393089614,18609839
1641488635,195079,true,3374817223,28,3393428923,18611700
1641488676,195078,true,3375154705,28,3393428923,18274218
1641488715,195073,true,3376842620,28,3393768266,16925646
1641489995,195073,true,3376842620,28,3402603102,25760482
1641490058,195072,true,3377180304,28,3402943362,25763058
1641490342,195072,true,3377180304,28,3405666670,28486366
1641490438,195067,true,3378869232,28,3406347837,27478605
1641490631,195067,true,3378869232,28,3407369844,28500612
1641490805,195066,true,3379207119,28,3408392157,29185038
1641490984,195065,true,3379545040,28,3409755718,30210678
1641491144,195060,true,3381235150,28,3411460937,30225787
1641491231,195060,true,3381235150,28,3412143263,30908113
1641492425,195059,true,3381573274,28,3422394550,40821276
1641493578,195058,true,3381911431,28,3426846333,44934902
1641493614,195053,true,3383602725,28,3427189018,43586293
1641493658,195052,true,3383941085,28,3427189018,43247933
1641493685,195050,true,3384617907,28,3427189018,42571111
1641494685,195050,true,3384617907,28,3425818485,41200578
1641494753,195045,true,3386310555,28,3425818485,39507930
1641494790,195045,true,3386310555,28,3425818485,39507930
1641494993,195043,true,3386987851,28,3427189018,40201167
1641495236,195042,true,3387326549,28,3428560099,41233550
1641495302,195036,true,3389359454,28,3428902955,39543501
1641495377,195035,true,3389698390,28,3429588770,39890380
1641495457,195033,true,3390376363,28,3430274722,39898359
1641495566,195031,true,3391054472,28,3431303907,40249435
1641495701,195026,true,3392750339,28,3433019902,40269563
1641496380,195024,true,3393428923,28,3442645346,49216423
1641498406,195023,true,3393768266,28,3441268632,47500366
1641498487,195021,true,3394447053,28,3441612759,47165706
1641498777,195016,true,3396144616,28,3441612759,45468143
1641499030,195014,true,3396823879,28,3441956920,45133041
1641500281,195012,true,3397503278,28,3446089541,48586263
1641500410,195010,true,3398182812,28,3446089541,47906729
1641500447,195004,true,3400222232,28,3446089541,45867309
1641500528,195002,true,3400902310,28,3446089541,45187231
1641501523,195000,true,3401582525,28,3442989611,41407086
1641502060,194998,true,3402262875,28,3439548514,37285639
1641502070,194992,true,3404304743,28,3439204594,34899851
1641502618,194991,true,3404645174,28,3436454468,31809294
1641503358,194990,true,3404985638,28,3432333401,27347763
1641503367,194989,true,3405326137,28,3432333401,27007264
1641506085,194984,true,3407029141,28,3423421371,16392230
1641506424,194983,true,3407369844,28,3423421371,16051527
1641507221,194982,true,3407710581,28,3423421371,15710790
1641508345,194981,true,3408051352,28,3421368037,13316685
1641508589,194978,true,3409073869,28,3421025934,11952065
1641508628,194979,true,3408732996,28,3421025934,12292938
1641508706,194979,true,3408732996,28,3421025934,12292938
1641508748,194977,true,3409414777,28,3421025934,11611157
1641508912,194974,true,3410437703,28,3421368037,10930334
1641510623,194974,true,3410437703,28,3426503683,16065980
1641510654,194973,true,3410778747,28,3426503683,15724936
1641510781,194972,true,3411119825,28,3426503683,15383858
1641511317,194969,true,3412143263,28,3425818485,13675222
1641511750,194969,true,3412143263,28,3423421371,11278108
1641512104,194968,true,3412484478,28,3421368037,8883559
1641513258,194967,true,3412825726,28,3416581712,3755986
1641513331,194964,true,3413849676,28,3416581712,2732036
1641513361,194965,true,3413508325,28,3416581712,3073387
1641513424,194964,true,3413849676,28,3416581712,2732036
1641513453,194963,true,3414191061,28,3416240088,2049027
1641513996,194962,true,3414532480,28,3414873933,341453
1641514154,194963,true,3414191061,28,3414191061,0
1641514375,194963,true,3414191061,28,3412825726,-1365335
1641514387,194963,true,3414191061,28,3412825726,-1365335
1641514525,194962,true,3414532480,28,3411802083,-2730397
1641514537,194963,true,3414191061,28,3411802083,-2388978
1641514888,194964,true,3413849676,28,3408051352,-5798324
1641514936,194963,true,3414191061,28,3407710581,-6480480
1641514975,194962,true,3414532480,28,3407369844,-7162636
1641515162,194963,true,3414191061,28,3405326137,-8864924
1641515278,194964,true,3413849676,28,3404304743,-9544933
1641515489,194964,true,3413849676,28,3401922683,-11926993
1641515554,194963,true,3414191061,28,3401242401,-12948660
1641515622,194964,true,3413849676,28,3400562254,-13287422
1641515659,194965,true,3413508325,28,3400222232,-13286093
1641515679,194964,true,3413849676,28,3399882244,-13967432
1641515704,194963,true,3414191061,28,3399542289,-14648772
1641516036,194965,true,3413508325,28,3394786498,-18721827
1641516187,194968,true,3412484478,28,3392411098,-20073380
1641516205,194968,true,3412484478,28,3392411098,-20073380
1641516212,194967,true,3412825726,28,3392071890,-20753836
1641516552,194970,true,3411802083,28,3387326549,-24475534
1641516626,194972,true,3411119825,28,3386310555,-24809270
1641516974,194972,true,3411119825,28,3380897060,-30222765
1641516983,194971,true,3411460937,28,3380559005,-30901932
1641517331,194973,true,3410778747,28,3374817223,-35961524
1641518644,194975,true,3410096694,28,3372455796,-37640898
1641518731,194974,true,3410437703,28,3372793041,-37644662
1641519514,194972,true,3411119825,28,3374817223,-36302602
1641520051,194974,true,3410437703,28,3374479775,-35957928
1641520217,194975,true,3410096694,28,3374817223,-35279471
1641520225,194974,true,3410437703,28,3374817223,-35620480
1641520244,194972,true,3411119825,28,3374479775,-36640050
1641522087,194973,true,3410778747,28,3381235150,-29543597
1641522823,194974,true,3410437703,28,3381235150,-29202553
1641523403,194974,true,3410437703,28,3379882994,-30554709
1641523443,194974,true,3410437703,28,3379545040,-30892663
1641523603,194975,true,3410096694,28,3378869232,-31227462
1641523655,194977,true,3409414777,28,3378531379,-30883398
1641523777,194977,true,3409414777,28,3377180304,-32234473
1641524425,194977,true,3409414777,28,3371107151,-38307626
1641524758,194979,true,3408732996,28,3368411478,-40321518
1641524786,194980,true,3408392157,28,3368074671,-40317486
1641524825,194981,true,3408051352,28,3367737897,-40313455
1641525024,194982,true,3407710581,28,3365381423,-42329158
1641525706,194984,true,3407029141,28,3359665420,-47363721
1641525792,194986,true,3406347837,28,3358993588,-47354249
1641526031,194987,true,3406007236,28,3352953140,-53054096
1641526062,194989,true,3405326137,28,3351947455,-53378682
1641526073,194991,true,3404645174,28,3351612294,-53032880
1641526085,194994,true,3403623985,28,3351277166,-52346819
1641526272,194996,true,3402943362,28,3345250594,-57692768
1641526278,194998,true,3402262875,28,3344916102,-57346773
1641526377,195003,true,3400562254,28,3339902740,-60659514
1641526463,195006,true,3399542289,28,3335563904,-63978385
1641526503,195010,true,3398182812,28,3333229943,-64952869
1641526575,195013,true,3397163561,28,3329565589,-67597972
1641526927,195019,true,3395125976,28,3311635287,-83490689
1641526957,195022,true,3394107642,28,3310310964,-83796678
1641526963,195026,true,3392750339,28,3309979966,-82770373
1641526991,195029,true,3391732717,28,3308325472,-83407245
1641527011,195037,true,3389020552,28,3307002473,-82018079
1641527042,195041,true,3387665282,28,3304688497,-82976785
1641527102,195047,true,3385633394,28,3301055519,-84577875
1641527141,195049,true,3384956369,28,3298415863,-86540506
1641527152,195057,true,3382249622,28,3297756279,-84493343
1641527154,195062,true,3380559005,28,3297756279,-82802726
1641527180,195066,true,3379207119,28,3296107895,-83099224
1641527211,195068,true,3378531379,28,3294130922,-84400457
1641527221,195076,true,3375829770,28,3293472195,-82357575
1641527234,195081,true,3374142361,28,3292813599,-81328762
1641527261,195086,true,3372455796,28,3291167686,-81288110
1641527300,195089,true,3371444261,28,3288864790,-82579471
1641527314,195096,true,3369085194,28,3288207116,-80878078
1641527335,195101,true,3367401157,28,3286892162,-80508995
1641527413,195107,true,3365381423,28,3282293962,-83087461
1641527437,195110,true,3364372011,28,3280653307,-83718704
1641527468,195118,true,3361681724,28,3279013473,-82668251
1641527483,195122,true,3360337387,28,3278029965,-82307422
1641527511,195128,true,3358321890,28,3276391442,-81930448
1641527524,195131,true,3357314595,28,3275408721,-81905874
1641527608,195139,true,3354629952,28,3271153669,-83476283
1641527678,195144,true,3352953140,28,3268537923,-84415217
1641527737,195149,true,3351277166,28,3266250862,-85026304
1641527756,195152,true,3350271984,28,3265271182,-85000802
1641527822,195160,true,3347592972,28,3262333907,-85259065
1641527865,195165,true,3345919677,28,3260377192,-85542485
1641527874,195171,true,3343912828,28,3260051187,-83861641
1641527914,195174,true,3342909855,28,3258747492,-84162363
1641527957,195182,true,3340236730,28,3257118607,-83118123
1641527989,195186,true,3338900969,28,3255490536,-83410433
1641527995,195192,true,3336898330,28,3255165020,-81733310
1641528022,195195,true,3335897460,28,3253863279,-82034181
1641528040,195203,true,3333229943,28,3253212604,-80017339
1641528090,195207,true,3331896984,28,3251261359,-80635625
1641528137,195213,true,3329898546,28,3250286176,-79612370
1641528147,195215,true,3329232666,28,3249961180,-79271486
1641528187,195224,true,3326237854,28,3248986387,-77251467
1641528222,195227,true,3325240182,28,3248661520,-76578662
1641528262,195233,true,3323245736,28,3248011886,-75233850
1641528296,195236,true,3322248962,28,3247362381,-74886581
1641528361,195245,true,3319260432,28,3245414645,-73845787
1641528384,195249,true,3317933060,28,3245090136,-72842924
1641528463,195255,true,3315942997,28,3242819481,-73123516
1641528466,195258,true,3314948413,28,3242819481,-72128932
1641528485,195266,true,3312297647,28,3242171015,-70126632
1641528645,195270,true,3310973059,28,3238606765,-72366294
1641528717,195276,true,3308987170,28,3236987948,-71999222
1641528750,195279,true,3307994673,28,3236017045,-71977628
1641528786,195287,true,3305349467,28,3235046434,-70303033
1641528809,195291,true,3304027658,28,3235046434,-68981224
1641528907,195297,true,3302045935,28,3234076115,-67969820
1641528911,195300,true,3301055519,28,3234076115,-66979404
1641528969,195308,true,3298415863,28,3233106086,-65309777
1641528997,195312,true,3297096826,28,3232459562,-64637264
1641529018,195319,true,3294789782,28,3231813167,-62976615
1641529056,195322,true,3293801542,28,3230520764,-63280778
1641529083,195331,true,3290838603,28,3229874757,-60963846
1641529120,195334,true,3289851548,28,3228583130,-61268418
1641529151,195341,true,3287549573,28,3227937510,-59612063
1641529182,195344,true,3286563506,28,3226646658,-59916848
1641529189,195354,true,3283278749,28,3226324026,-56954723
1641529204,195358,true,3281965766,28,3225678858,-56286908
1641529261,195365,true,3279669308,28,3223099476,-56569832
1641529302,195369,true,3278357768,28,3221488409,-56869359
1641529382,195378,true,3275408721,28,3218268692,-57140029
1641529439,195382,true,3274098885,28,3216016805,-58082080
1641529521,195389,true,3271807932,28,3212802556,-59005376
1641529523,195392,true,3270826586,28,3212802556,-58024030
1641529578,195400,true,3268211102,28,3210554493,-57656609
1641529602,195404,true,3266904145,28,3209912479,-56991666
1641529636,195411,true,3264618226,28,3208949698,-55668528
1641529643,195414,true,3263639036,28,3208628835,-55010201
1641529662,195421,true,3261355403,28,3208308004,-53047399
1641529701,195425,true,3260051187,28,3207025002,-53026185
1641529749,195432,true,3257770063,28,3205421970,-52348093
1641529859,195435,true,3256792928,28,3202538532,-54254396
1641529920,195442,true,3254514084,28,3200617681,-53896403
1641529944,195446,true,3253212604,28,3199657688,-53554916
1641530016,195453,true,3250936266,28,3197099113,-53837153
1641530046,195457,true,3249636216,28,3195820593,-53815623
1641530118,195465,true,3247037677,28,3193265087,-53772590
1641530149,195469,true,3245739186,28,3192307299,-53431887
1641530183,195477,true,3243143763,28,3190711624,-52432139
1641530193,195481,true,3241846830,28,3190392585,-51454245
1641530265,195489,true,3239254519,28,3188160203,-51094316
1641530316,195494,true,3237635378,28,3186247976,-51387402
1641530467,195501,true,3235369939,28,3181154310,-54215629
1641530498,195504,true,3234399522,28,3180200155,-54199367
1641530510,195513,true,3231490018,28,3179882167,-51607851
1641530529,195516,true,3230520764,28,3179564210,-50956554
1641530553,195522,true,3228583130,28,3179246286,-49336844
1641530670,195525,true,3227614749,28,3176704033,-50910716
1641530750,195533,true,3225033819,28,3174798677,-50235142
1641530760,195537,true,3223744128,28,3174481229,-49262899
1641530806,195542,true,3222132739,28,3174481229,-47651510
1641530825,195544,true,3221488409,28,3174798677,-46689732
1641530968,195550,true,3219556192,28,3175433669,-44122523
1641530992,195553,true,3218590519,28,3176068787,-42521732
1641531007,195557,true,3217303404,28,3176386394,-40917010
1641531175,195559,true,3216660040,28,3179882167,-36777873
1641531329,195562,true,3215695235,28,3182745206,-32950029
1641531410,195565,true,3214730719,28,3184655330,-30075389
1641531507,195568,true,3213766493,28,3186247976,-27518517
1641531512,195569,true,3213445149,28,3186247976,-27197173
1641531523,195571,true,3212802556,28,3186247976,-26554580
1641531562,195573,true,3212160092,28,3186885258,-25274834
1641531573,195575,true,3211517756,28,3186885258,-24632498
1641531692,195576,true,3211196636,28,3189435658,-21760978
1641531939,195577,true,3210875549,28,3196459789,-14415760
1641532114,195579,true,3210233470,28,3202538532,-7694938
1641532123,195580,true,3209912479,28,3202858786,-7053693
1641532280,195581,true,3209591520,28,3207987205,-1604315
1641532336,195580,true,3209912479,28,3209270593,-641886
1641532358,195581,true,3209591520,28,3209591520,0
1641532362,195582,true,3209270593,28,3209912479,641886
1641532451,195583,true,3208949698,28,3211517756,2568058
1641532477,195583,true,3208949698,28,3212160092,3210394
1641532527,195584,true,3208628835,28,3213445149,4816314
1641532691,195585,true,3208308004,28,3215695235,7387231
1641532825,195585,true,3208308004,28,3217303404,8995400
1641532848,195585,true,3208308004,28,3217625135,9317131
1641532975,195585,true,3208308004,28,3219556192,11248188
1641533661,195586,true,3207987205,28,3229228879,21241674
1641533870,195586,true,3207987205,28,3231813167,23825962
1641533895,195586,true,3207987205,28,3231813167,23825962
1641533963,195586,true,3207987205,28,3232136348,24149143
1641533970,195587,true,3207666439,28,3232136348,24469909
1641534070,195588,true,3207345704,28,3232782808,25437104
1641534124,195588,true,3207345704,28,3233106086,25760382
1641534185,195588,true,3207345704,28,3233752739,26407035
1641534243,195589,true,3207025002,28,3234722962,27697960
1641534248,195589,true,3207025002,28,3234722962,27697960
1641534386,195590,true,3206704331,28,3234722962,28018631
1641534470,195590,true,3206704331,28,3234722962,28018631
1641534538,195591,true,3206383693,28,3234722962,28339269
1641534747,195592,true,3206063086,28,3233429396,27366310
1641534878,195592,true,3206063086,28,3232459562,26396476
1641534905,195592,true,3206063086,28,3232459562,26396476
1641535010,195593,true,3205742512,28,3231490018,25747506
1641535195,195593,true,3205742512,28,3229874757,24132245
1641535212,195593,true,3205742512,28,3229874757,24132245
1641535213,195593,true,3205742512,28,3229874757,24132245
1641535267,195594,true,3205421970,28,3229551802,24129832
1641535490,195593,true,3205742512,28,3227937510,22194998
1641535495,195593,true,3205742512,28,3227937510,22194998
1641535522,195593,true,3205742512,28,3227937510,22194998
1641535537,195594,true,3205421970,28,3227937510,22515540
1641535607,195594,true,3205421970,28,3227292020,21870050
1641535626,195594,true,3205421970,28,3226969323,21547353
1641535802,195595,true,3205101460,28,3225678858,20577398
1641535942,195596,true,3204780982,28,3224711348,19930366
1641536007,195596,true,3204780982,28,3223744128,18963146
1641536048,195595,true,3205101460,28,3223421785,18320325
1641536081,195596,true,3204780982,28,3223099476,18318494
1641536102,195597,true,3204460536,28,3222777198,18316662
1641536232,195597,true,3204460536,28,3221166292,16705756
1641536523,195597,true,3204460536,28,3216338406,11877870
1641536541,195599,true,3203819740,28,3216016805,12197065
1641536725,195600,true,3203499390,28,3212802556,9303166
1641536739,195601,true,3203179072,28,3212481308,9302236
1641536772,195600,true,3203499390,28,3212160092,8660702
1641536909,195601,true,3203179072,28,3210233470,7054398
1641536964,195602,true,3202858786,28,3209270593,6411807
1641537085,195603,true,3202538532,28,3207345704,4807172
1641537309,195603,true,3202538532,28,3203179072,640540
1641537481,195603,true,3202538532,28,3200297652,-2240880
1641537529,195603,true,3202538532,28,3199337754,-3200778
1641537551,195604,true,3202218310,28,3199017852,-3200458
1641537614,195604,true,3202218310,28,3197418823,-4799487
1641537640,195605,true,3201898120,28,3196779435,-5118685
1641537648,195606,true,3201577963,28,3196779435,-4798528
1641537990,195607,true,3201257837,28,3187841419,-13416418
1641538007,195606,true,3201577963,28,3187522667,-14055296
1641538025,195607,true,3201257837,28,3187203946,-14053891
1641538069,195606,true,3201577963,28,3185929383,-15648580
1641538091,195608,true,3200937743,28,3185610822,-15326921
1641538124,195609,true,3200617681,28,3184655330,-15962351
1641538270,195610,true,3200297652,28,3181472426,-18825226
1641538498,195609,true,3200617681,28,3176386394,-24231287
1641538514,195611,true,3199977654,28,3176068787,-23908867
1641538559,195611,true,3199977654,28,3175116157,-24861497
1641538581,195612,true,3199657688,28,3174481229,-25176459
1641538695,195611,true,3199977654,28,3172259981,-27717673
1641538893,195612,true,3199657688,28,3169406374,-30251314
1641538920,195613,true,3199337754,28,3168772588,-30565166
1641538937,195614,true,3199017852,28,3168772588,-30245264
1641539057,195613,true,3199337754,28,3166238710,-33099044
1641539080,195615,true,3198697983,28,3165922118,-32775865
1641539127,195616,true,3198378145,28,3164339631,-34038514
1641539250,195617,true,3198058339,28,3160544891,-37513448
1641539295,195617,true,3198058339,28,3159280989,-38777350
1641539389,195619,true,3197418823,28,3156123445,-41295378
1641539467,195620,true,3197099113,28,3154230433,-42868680
1641539516,195622,true,3196459789,28,3152969057,-43490732
1641539659,195621,true,3196779435,28,3149502871,-47276564
1641539712,195623,true,3196140175,28,3147928592,-48211583
1641539735,195624,true,3195820593,28,3147613830,-48206763
1641539751,195626,true,3195181525,28,3146984402,-48197123
1641539765,195626,true,3195181525,28,3146669735,-48511790
1641539917,195627,true,3194862039,28,3144467947,-50394092
1641539937,195628,true,3194542585,28,3144153531,-50389054
1641539985,195630,true,3193903772,28,3143524795,-50378977
1641540006,195631,true,3193584414,28,3143210474,-50373940
1641540039,195633,true,3192945792,28,3142896184,-50049608
1641540071,195633,true,3192945792,28,3142581926,-50363866
1641540098,195635,true,3192307299,28,3142581926,-49725373
1641540116,195636,true,3191988100,28,3142581926,-49406174
1641540184,195638,true,3191349798,28,3142267699,-49082099
1641540217,195639,true,3191030695,28,3142267699,-48762996
1641540298,195641,true,3190392585,28,3141953504,-48439081
1641540334,195642,true,3190073578,28,3141953504,-48120074
1641540542,195643,true,3189754602,28,3141953504,-47801098
1641540602,195645,true,3189116747,28,3141639340,-47477407
1641540675,195646,true,3188797867,28,3141639340,-47158527
1641540692,195647,true,3188479019,28,3141639340,-46839679
1641540705,195648,true,3188160203,28,3141639340,-46520863
1641540802,195649,true,3187841419,28,3142581926,-45259493
1641541308,195650,true,3187522667,28,3153599682,-33922985
1641541366,195651,true,3187203946,28,3155176797,-32027149
1641541421,195652,true,3186885258,28,3156754701,-30130557
1641541531,195654,true,3186247976,28,3159280989,-26966987
1641541599,195656,true,3185610822,28,3160860945,-24749877
1641541695,195656,true,3185610822,28,3162757936,-22852886
1641541781,195658,true,3184973796,28,3164972531,-20001265
1641541798,195660,true,3184336896,28,3165289028,-19047868
1641541909,195661,true,3184018495,28,3167822146,-16196349
1641542114,195661,true,3184018495,28,3171942786,-12075709
1641542371,195662,true,3183700125,28,3175751212,-7948913
1641542548,195663,true,3183381786,28,3177657139,-5724647
1641542581,195665,true,3182745206,28,3177974905,-4770301
1641542647,195664,true,3183063480,28,3178928393,-4135087
1641542729,195665,true,3182745206,28,3180200155,-2545051
1641542785,195666,true,3182426963,28,3180836227,-1590736
1641543050,195668,true,3181790573,28,3185292293,3501720
1641543084,195668,true,3181790573,28,3185929383,4138810
1641543272,195670,true,3181154310,28,3188160203,7005893
1641543276,195671,true,3180836227,28,3188160203,7323976
1641543405,195673,true,3180200155,28,3190392585,10192430
1641543604,195673,true,3180200155,28,3193265087,13064932
1641543764,195673,true,3180200155,28,3194223162,14023007
1641543983,195675,true,3179564210,28,3195501043,15936833
1641543996,195677,true,3178928393,28,3195501043,16572650
1641544025,195677,true,3178928393,28,3196140175,17211782
1641544032,195678,true,3178610532,28,3196140175,17529643
1641544063,195676,true,3179246286,28,3197099113,17852827
1641544116,195677,true,3178928393,28,3198378145,19449752
1641544127,195676,true,3179246286,28,3198697983,19451697
1641544159,195677,true,3178928393,28,3199337754,20409361
1641544170,195675,true,3179564210,28,3199657688,20093478
1641544185,195676,true,3179246286,28,3199977654,20731368
1641544213,195676,true,3179246286,28,3200297652,21051366
1641544223,195676,true,3179246286,28,3200617681,21371395
1641544508,195674,true,3179882167,28,3207666439,27784272
1641544523,195675,true,3179564210,28,3207987205,28422995
1641544556,195674,true,3179882167,28,3208628835,28746668
1641544605,195675,true,3179564210,28,3209591520,30027310
1641544837,195672,true,3180518175,28,3214087870,33569695
1641544859,195674,true,3179882167,28,3214087870,34205703
1641544928,195673,true,3180200155,28,3215052192,34852037
1641545112,195675,true,3179564210,28,3218268692,38704482
1641545362,195672,true,3180518175,28,3223744128,43225953
1641545742,195673,true,3180200155,28,3232136348,51936193
1641546054,195672,true,3180518175,28,3233429396,52911221
1641546398,195673,true,3180200155,28,3232459562,52259407
1641546609,195670,true,3181154310,28,3231813167,50658857
1641546742,195671,true,3180836227,28,3232459562,51623335
1641546865,195670,true,3181154310,28,3234722962,53568652
1641546975,195669,true,3181472426,28,3236340647,54868221
1641547583,195665,true,3182745206,28,3242171015,59425809
1641547709,195665,true,3182745206,28,3243792424,61047218
1641547757,195663,true,3183381786,28,3243792424,60410638
1641547832,195662,true,3183700125,28,3244765659,61065534
1641547867,195658,true,3184973796,28,3245090136,60116340
1641548084,195658,true,3184973796,28,3248661520,63687724
1641548230,195656,true,3185610822,28,3250936266,65325444
1641548615,195655,true,3185929383,28,3257118607,71189224
1641548762,195651,true,3187203946,28,3257770063,70566117
1641548793,195650,true,3187522667,28,3257770063,70247396
1641548954,195649,true,3187841419,28,3259073367,71231948
1641549257,195647,true,3188479019,28,3260377192,71898173
1641549521,195643,true,3189754602,28,3261029300,71274698
1641549824,195641,true,3190392585,28,3260703229,70310644
1641549844,195640,true,3190711624,28,3260377192,69665568
1641549913,195638,true,3191349798,28,3259725214,68375416
1641550190,195633,true,3192945792,28,3256467281,63521489
1641550276,195633,true,3192945792,28,3255816085,62870293
1641551099,195630,true,3193903772,28,3251911644,58007872
1641551500,195627,true,3194862039,28,3250286176,55424137
1641552020,195622,true,3196459789,28,3250286176,53826387
1641552059,195622,true,3196459789,28,3250286176,53826387
1641552074,195620,true,3197099113,28,3250286176,53187063
1641552868,195617,true,3198058339,28,3246063760,48005421
1641553088,195613,true,3199337754,28,3244116804,44779050
1641553198,195612,true,3199657688,28,3243143763,43486075
1641553735,195611,true,3199977654,28,3236987948,37010294
1641554261,195610,true,3200297652,28,3229874757,29577105
1641554395,195606,true,3201577963,28,3228260304,26682341
1641555613,195606,true,3201577963,28,3222777198,21199235
1641555728,195605,true,3201898120,28,3223099476,21201356
1641556216,195603,true,3202538532,28,3223421785,20883253
1641556833,195599,true,3203819740,28,3222777198,18957458
1641556987,195597,true,3204460536,28,3223099476,18638940
1641557157,195595,true,3205101460,28,3224066502,18965042
1641557171,195593,true,3205742512,28,3224066502,18323990
1641557768,195587,true,3207666439,28,3228905989,21239550
1641558027,195585,true,3208308004,28,3231813167,23505163
1641558418,195582,true,3209270593,28,3236017045,26746452
1641558618,195579,true,3210233470,28,3238930626,28697156
1641558885,195573,true,3212160092,28,3241846830,29686738
1641559693,195570,true,3213123836,28,3247037677,33913841
1641559962,195568,true,3213766493,28,3248011886,34245393
1641560095,195566,true,3214409278,28,3248661520,34252242
1641560156,195559,true,3216660040,28,3248661520,32001480
1641560261,195557,true,3217303404,28,3248986387,31682983
1641560802,195554,true,3218268692,28,3247687117,29418425
1641560816,195552,true,3218912378,28,3247362381,28450003
1641561020,195547,true,3220522156,28,3245414645,24892489
1641561116,195545,true,3221166292,28,3244765659,23599367
1641561178,195544,true,3221488409,28,3244116804,22628395
1641561343,195543,true,3221810558,28,3241846830,20036272
1641561351,195538,true,3223421785,28,3241522678,18100893
1641561954,195538,true,3223421785,28,3229874757,6452972
1641562130,195537,true,3223744128,28,3226646658,2902530
1641562206,195537,true,3223744128,28,3225678858,1934730
1641562216,195532,true,3225356322,28,3225678858,322536
1641562231,195532,true,3225356322,28,3225356322,0
1641562241,195530,true,3226001426,28,3225356322,-645104
1641562266,195529,true,3226324026,28,3225356322,-967704
1641562269,195524,true,3227937510,28,3225356322,-2581188
1641562325,195523,true,3228260304,28,3225678858,-2581446
1641562570,195521,true,3228905989,28,3226969323,-1936666
1641562679,195520,true,3229228879,28,3227292020,-1936859
1641562711,195516,true,3230520764,28,3227292020,-3228744
1641562815,195514,true,3231166901,28,3226969323,-4197578
1641562823,195514,true,3231166901,28,3226646658,-4520243
1641562830,195514,true,3231166901,28,3226646658,-4520243
1641562849,195510,true,3232459562,28,3226324026,-6135536
1641562896,195514,true,3231166901,28,3224388909,-6777992
1641562899,195515,true,3230843817,28,3224388909,-6454908
1641562917,195515,true,3230843817,28,3223744128,-7099689
1641562929,195511,true,3232136348,28,3223744128,-8392220
1641562948,195515,true,3230843817,28,3223099476,-7744341
1641562971,195516,true,3230520764,28,3222454952,-8065812
1641563029,195517,true,3230197745,28,3220522156,-9675589
1641563054,195515,true,3230843817,28,3219556192,-11287625
1641563150,195519,true,3229551802,28,3216338406,-13213396
1641563189,195520,true,3229228879,28,3215052192,-14176687
1641563263,195522,true,3228583130,28,3212802556,-15780574
1641563268,195519,true,3229551802,28,3212802556,-16749246
1641563290,195522,true,3228583130,28,3212160092,-16423038
1641563379,195523,true,3228260304,28,3210233470,-18026834
1641563750,195524,true,3227937510,28,3201577963,-26359547
1641564364,195522,true,3228583130,28,3177021703,-51561427
1641564436,195526,true,3227292020,28,3172894464,-54397556
1641564527,195527,true,3226969323,28,3169723314,-57246009
1641564578,195528,true,3226646658,28,3168138928,-58507730
1641564587,195529,true,3226324026,28,3167822146,-58501880
1641564626,195531,true,3225678858,28,3167822146,-57856712
1641564655,195531,true,3225678858,28,3167822146,-57856712
1641565657,195531,true,3225678858,28,3185292293,-40386565
1641565784,195532,true,3225356322,28,3188160203,-37196119
1641565821,195534,true,3224711348,28,3188797867,-35913481
1641565950,195534,true,3224711348,28,3191668933,-33042415
1641566096,195534,true,3224711348,28,3195501043,-29210305
1641566101,195536,true,3224066502,28,3195501043,-28565459
1641566141,195538,true,3223421785,28,3196459789,-26961996
1641566144,195537,true,3223744128,28,3196459789,-27284339
1641566205,195538,true,3223421785,28,3198378145,-25043640
1641566221,195539,true,3223099476,28,3199017852,-24081624
1641566286,195542,true,3222132739,28,3199977654,-22155085
1641566338,195542,true,3222132739,28,3200617681,-21515058
1641566346,195542,true,3222132739,28,3200617681,-21515058
1641566563,195544,true,3221488409,28,3199657688,-21830721
1641566612,195547,true,3220522156,28,3199337754,-21184402
1641566650,195546,true,3220844208,28,3199657688,-21186520
1641566658,195547,true,3220522156,28,3199657688,-20864468
1641566719,195547,true,3220522156,28,3199977654,-20544502
1641566802,195549,true,3219878148,28,3200297652,-19580496
1641567670,195549,true,3219878148,28,3205421970,-14456178
1641567676,195550,true,3219556192,28,3205421970,-14134222
1641567688,195551,true,3219234269,28,3205421970,-13812299
1641567891,195554,true,3218268692,28,3204460536,-13808156
1641567911,195555,true,3217946897,28,3204460536,-13486361
1641568055,195557,true,3217303404,28,3203179072,-14124332
1641568195,195558,true,3216981706,28,3202858786,-14122920
1641568203,195562,true,3215695235,28,3202858786,-12836449
1641568225,195563,true,3215373698,28,3202858786,-12514912
1641568748,195566,true,3214409278,28,3195501043,-18908235
1641568887,195568,true,3213766493,28,3192945792,-20820701
1641569559,195572,true,3212481308,28,3180200155,-32281153
1641569648,195573,true,3212160092,28,3178292702,-33867390
1641569868,195576,true,3211196636,28,3176068787,-35127849
1641569905,195577,true,3210875549,28,3175751212,-35124337
1641569991,195582,true,3209270593,28,3174798677,-34471916
1641569999,195583,true,3208949698,28,3174481229,-34468469
1641570063,195586,true,3207987205,28,3173529075,-34458130
1641570188,195587,true,3207666439,28,3171942786,-35723653
1641570238,195592,true,3206063086,28,3170991394,-35071692
1641570479,195594,true,3205421970,28,3166871989,-38549981
1641570520,195597,true,3204460536,28,3165922118,-38538418
1641570562,195599,true,3203819740,28,3164972531,-38847209
1641570586,195604,true,3202218310,28,3164656065,-37562245
1641570623,195606,true,3201577963,28,3163390519,-38187444
1641570633,195610,true,3200297652,28,3163074212,-37223440
1641570704,195612,true,3199657688,28,3160860945,-38796743
1641570748,195617,true,3198058339,28,3159280989,-38777350
1641570812,195620,true,3197099113,28,3157070377,-40028736
1641570825,195622,true,3196459789,28,3156439057,-40020732
1641570871,195625,true,3195501043,28,3154545856,-40955187
1641570983,195629,true,3194223162,28,3151708184,-42514978
1641571178,195631,true,3193584414,28,3146984402,-46600012
1641571194,195633,true,3192945792,28,3146669735,-46276057
1641571245,195636,true,3191988100,28,3145411382,-46576718
1641571277,195640,true,3190711624,28,3144782394,-45929230
1641571317,195641,true,3190392585,28,3144153531,-46239054
1641571845,195642,true,3190073578,28,3137871822,-52201756
1641571868,195646,true,3188797867,28,3137558066,-51239801
1641571934,195650,true,3187522667,28,3136616987,-50905680
1641571969,195652,true,3186885258,28,3135989758,-50895500
1641572038,195655,true,3185929383,28,3135049149,-50880234
1641572341,195660,true,3184336896,28,3130037332,-54299564
1641572343,195665,true,3182745206,28,3130037332,-52707874
1641572516,195667,true,3182108752,28,3127534428,-54574324
1641572578,195671,true,3180836227,28,3126909015,-53927212
1641572621,195677,true,3178928393,28,3126909015,-52019378
1641572644,195681,true,3177657139,28,3126909015,-50748124
1641572709,195683,true,3177021703,28,3126596355,-50425348
1641572715,195687,true,3175751212,28,3126596355,-49154857
1641572760,195690,true,3174798677,28,3127221706,-47576971
1641572767,195694,true,3173529075,28,3127221706,-46307369
1641572773,195693,true,3173846428,28,3127221706,-46624722
1641572815,195695,true,3173211754,28,3128159966,-45051788
1641572848,195698,true,3172259981,28,3128159966,-44100015
1641572891,195701,true,3171308493,28,3128785630,-42522863
1641572943,195700,true,3171625624,28,3129411418,-42214206
1641572975,195702,true,3170991394,28,3129724359,-41267035
1641573010,195705,true,3170040287,28,3130350335,-39689952
1641573070,195707,true,3169406374,28,3131602663,-37803711
1641573088,195706,true,3169723314,28,3131602663,-38120651
1641573249,195710,true,3168455742,28,3134422233,-34033509
1641573333,195712,true,3167822146,28,3135989758,-31832388
1641573822,195715,true,3166871989,28,3147613830,-19258159
1641573974,195715,true,3166871989,28,3152969057,-13902932
1641574098,195717,true,3166238710,28,3157386084,-8852626
1641574212,195720,true,3165289028,28,3162757936,-2531092
1641574433,195722,true,3164656065,28,3173846428,9190363
1641574541,195719,true,3165605557,28,3177974905,12369348
1641574578,195721,true,3164972531,28,3179246286,14273755
1641574643,195723,true,3164339631,28,3180836227,16496596
1641574685,195720,true,3165289028,28,3181790573,16501545
1641574736,195716,true,3166555334,28,3183381786,16826452
1641574805,195718,true,3165922118,28,3185292293,19370175
1641575342,195719,true,3165605557,28,3193903772,28298215
1641575372,195717,true,3166238710,28,3194542585,28303875
1641575455,195714,true,3167188676,28,3195501043,28312367
1641575697,195714,true,3167188676,28,3199017852,31829176
1641575737,195715,true,3166871989,28,3199337754,32465765
1641576009,195713,true,3167505395,28,3202218310,34712915
1641576030,195709,true,3168772588,28,3202218310,33445722
1641577017,195711,true,3168138928,28,3197099113,28960185
1641577039,195712,true,3167822146,28,3196779435,28957289
1641577246,195710,true,3168455742,28,3194223162,25767420
1641577524,195707,true,3169406374,28,3191030695,21624321
1641578086,195709,true,3168772588,28,3187203946,18431358
1641578104,195710,true,3168455742,28,3186885258,18429516
1641578474,195707,true,3169406374,28,3186885258,17478884
1641578481,195704,true,3170357291,28,3186885258,16527967
1641578743,195706,true,3169723314,28,3187522667,17799353
1641578847,195706,true,3169723314,28,3187841419,18118105
1641579111,195705,true,3170040287,28,3190392585,20352298
1641579707,195703,true,3170674326,28,3195820593,25146267
1641579817,195706,true,3169723314,28,3196779435,27056121
1641580083,195706,true,3169723314,28,3197418823,27695509
1641580199,195706,true,3169723314,28,3197099113,27375799
1641580538,195705,true,3170040287,28,3194542585,24502298
1641580583,195708,true,3169089465,28,3193903772,24814307
1641581236,195709,true,3168772588,28,3186566601,17794013
1641581393,195709,true,3168772588,28,3184336896,15564308
1641581500,195708,true,3169089465,28,3182745206,13655741
1641582424,195712,true,3167822146,28,3174163813,6341667
1641582500,195713,true,3167505395,28,3173529075,6023680
1641582571,195712,true,3167822146,28,3172577207,4755061
1641582590,195711,true,3168138928,28,3172577207,4438279
1641582621,195715,true,3166871989,28,3172259981,5387992
1641583051,195717,true,3166238710,28,3166555334,316624
1641583427,195716,true,3166555334,28,3162441692,-4113642
1641583572,195715,true,3166871989,28,3160860945,-6011044
1641583702,195719,true,3165605557,28,3159912877,-5692680
1641583809,195722,true,3164656065,28,3159280989,-5375076
1641583879,195722,true,3164656065,28,3158965092,-5690973
1641584192,195721,true,3164972531,28,3158333394,-6639137
1641584311,195724,true,3164023229,28,3158333394,-5689835
1641584341,195727,true,3163074212,28,3158649227,-4424985
1641584464,195726,true,3163390519,28,3159596917,-3793602
1641584479,195724,true,3164023229,28,3159596917,-4426312
1641584551,195727,true,3163074212,28,3160228868,-2845344
1641584567,195729,true,3162441692,28,3160544891,-1896801
1641584600,195727,true,3163074212,28,3160860945,-2213267
1641584907,195725,true,3163706858,28,3165289028,1582170
1641585677,195726,true,3163390519,28,3179882167,16491648
1641585924,195728,true,3162757936,28,3184018495,21260559
1641585979,195726,true,3163390519,28,3184973796,21583277
1641586022,195723,true,3164339631,28,3185929383,21589752
1641586112,195723,true,3164339631,28,3187522667,23183036
1641586611,195725,true,3163706858,28,3194542585,30835727
1641587115,195722,true,3164656065,28,3197738565,33082500
1641587348,195719,true,3165605557,28,3198697983,33092426
1641587766,195719,true,3165605557,28,3198697983,33092426
1641587810,195720,true,3165289028,28,3199017852,33728824
1641587838,195717,true,3166238710,28,3199017852,32779142
1641588497,195714,true,3167188676,28,3199337754,32149078
1641588589,195713,true,3167505395,28,3199977654,32472259
1641588893,195714,true,3167188676,28,3201577963,34389287
1641589057,195710,true,3168455742,28,3202538532,34082790
1641589181,195705,true,3170040287,28,3203499390,33459103
1641589436,195704,true,3170357291,28,3206063086,35705795
1641591009,195704,true,3170357291,28,3210554493,40197202
1641591228,195700,true,3171625624,28,3210554493,38928869
1641591432,195695,true,3173211754,28,3210875549,37663795
1641591713,195693,true,3173846428,28,3211196636,37350208
1641592150,195692,true,3174163813,28,3211838908,37675095
1641592266,195689,true,3175116157,28,3211838908,36722751
1641592881,195685,true,3176386394,28,3214409278,38022884
1641592960,195683,true,3177021703,28,3214730719,37709016
1641593100,195682,true,3177339405,28,3215052192,37712787
1641593401,195680,true,3177974905,28,3215695235,37720330
1641593482,195676,true,3179246286,28,3216016805,36770519
1641593504,195675,true,3179564210,28,3216016805,36452595
1641593762,195674,true,3179882167,28,3216016805,36134638
1641593769,195672,true,3180518175,28,3216016805,35498630
1641593784,195668,true,3181790573,28,3216016805,34226232
1641594068,195665,true,3182745206,28,3215052192,32306986
1641594306,195664,true,3183063480,28,3213766493,30703013
1641594430,195662,true,3183700125,28,3213123836,29423711
1641594473,195657,true,3185292293,28,3212802556,27510263
1641594680,195654,true,3186247976,28,3211838908,25590932
1641595116,195652,true,3186885258,28,3209591520,22706262
1641595164,195650,true,3187522667,28,3209270593,21747926
1641595217,195645,true,3189116747,28,3209270593,20153846
1641595269,195643,true,3189754602,28,3208949698,19195096
1641595309,195643,true,3189754602,28,3208628835,18874233
1641595478,195641,true,3190392585,28,3207345704,16953119
1641595944,195639,true,3191030695,28,3203179072,12148377
1641595963,195638,true,3191349798,28,3203179072,11829274
1641595992,195638,true,3191349798,28,3202538532,11188734
1641596024,195637,true,3191668933,28,3202218310,10549377
1641596042,195635,true,3192307299,28,3201898120,9590821
1641596057,195635,true,3192307299,28,3201898120,9590821
1641596079,195635,true,3192307299,28,3201257837,8950538
1641596162,195635,true,3192307299,28,3199657688,7350389
1641596213,195634,true,3192626530,28,3198697983,6071453
1641596327,195635,true,3192307299,28,3196459789,4152490
1641596480,195636,true,3191988100,28,3193265087,1276987
1641597877,195635,true,3192307299,28,3177021703,-15285596
1641598211,195635,true,3192307299,28,3177974905,-14332394
1641598401,195635,true,3192307299,28,3179564210,-12743089
1641598682,195636,true,3191988100,28,3181790573,-10197527
1641599585,195635,true,3192307299,28,3188160203,-4147096
1641599646,195634,true,3192626530,28,3188479019,-4147511
1641599787,195635,true,3192307299,28,3189116747,-3190552
1641599836,195636,true,3191988100,28,3189116747,-2871353
1641600016,195636,true,3191988100,28,3189754602,-2233498
1641600048,195636,true,3191988100,28,3189754602,-2233498
1641600102,195637,true,3191668933,28,3190073578,-1595355
1641600197,195637,true,3191668933,28,3190711624,-957309
1641600320,195637,true,3191668933,28,3191668933,0
1641600414,195637,true,3191668933,28,3191988100,319167
1641600695,195637,true,3191668933,28,3192945792,1276859
1641600907,195638,true,3191349798,28,3193584414,2234616
1641601166,195637,true,3191668933,28,3194542585,2873652
1641601316,195637,true,3191668933,28,3195181525,3512592
1641601399,195637,true,3191668933,28,3195820593,4151660
1641601407,195638,true,3191349798,28,3195820593,4470795
1641601672,195636,true,3191988100,28,3199337754,7349654
1641601709,195635,true,3192307299,28,3199977654,7670355
1641603336,195633,true,3192945792,28,3215695235,22749443
1641603786,195634,true,3192626530,28,3218268692,25642162
1641605238,195631,true,3193584414,28,3233106086,39521672
1641606827,195631,true,3193584414,28,3231490018,37905604
1641606909,195629,true,3194223162,28,3231166901,36943739
1641607310,195630,true,3193903772,28,3229874757,35970985
1641607808,195628,true,3194542585,28,3228260304,33717719
1641608084,195628,true,3194542585,28,3226324026,31781441
1641608374,195627,true,3194862039,28,3224066502,29204463
1641609068,195627,true,3194862039,28,3218912378,24050339
1641609328,195626,true,3195181525,28,3216660040,21478515
1641609758,195625,true,3195501043,28,3212481308,16980265
1641610933,195624,true,3195820593,28,3201898120,6077527
1641611551,195625,true,3195501043,28,3199977654,4476611
1641611614,195623,true,3196140175,28,3199977654,3837479
1641612246,195623,true,3196140175,28,3200297652,4157477
1641612276,195621,true,3196779435,28,3200297652,3518217
1641612298,195622,true,3196459789,28,3200617681,4157892
1641612354,195620,true,3197099113,28,3200297652,3198539
1641613608,195620,true,3197099113,28,3195501043,-1598070
1641614297,195618,true,3197738565,28,3192945792,-4792773
1641615011,195617,true,3198058339,28,3195820593,-2237746
1641616008,195615,true,3198697983,28,3202538532,3840549
1641616675,195615,true,3198697983,28,3204460536,5762553
1641616748,195612,true,3199657688,28,3204780982,5123294
1641616803,195612,true,3199657688,28,3205101460,5443772
1641616846,195610,true,3200297652,28,3205101460,4803808
1641616896,195610,true,3200297652,28,3205101460,4803808
1641617296,195607,true,3201257837,28,3207025002,5767165
1641617542,195606,true,3201577963,28,3207987205,6409242
1641620841,195604,true,3202218310,28,3215373698,13155388
1641623647,195605,true,3201898120,28,3215373698,13475578
1641623651,195602,true,3202858786,28,3215373698,12514912
1641623855,195602,true,3202858786,28,3214087870,11229084
1641624704,195600,true,3203499390,28,3207666439,4167049
1641624814,195602,true,3202858786,28,3206704331,3845545
1641624835,195601,true,3203179072,28,3206704331,3525259
1641624943,195600,true,3203499390,28,3206063086,2563696
1641625097,195599,true,3203819740,28,3205101460,1281720
1641625439,195600,true,3203499390,28,3204780982,1281592
1641626151,195599,true,3203819740,28,3209912479,6092739
1641626347,195599,true,3203819740,28,3211517756,7698016
1641626353,195597,true,3204460536,28,3211517756,7057220
1641626767,195599,true,3203819740,28,3214087870,10268130
1641627807,195597,true,3204460536,28,3214087870,9627334
1641629253,195597,true,3204460536,28,3213445149,8984613
1641629344,195595,true,3205101460,28,3213766493,8665033
1641629593,195597,true,3204460536,28,3214409278,9948742
1641630030,195596,true,3204780982,28,3217303404,12522422
1641630331,195595,true,3205101460,28,3219556192,14454732
1641630704,195593,true,3205742512,28,3222132739,16390227
1641630983,195595,true,3205101460,28,3223744128,18642668
1641632337,195594,true,3205421970,28,3220200136,14778166
1641632915,195594,true,3205421970,28,3218590519,13168549
1641632927,195592,true,3206063086,28,3218912378,12849292
1641634115,195594,true,3205421970,28,3220522156,15100186
1641634889,195593,true,3205742512,28,3221166292,15423780
1641635039,195593,true,3205742512,28,3221810558,16068046
1641636060,195591,true,3206383693,28,3226324026,19940333
1641636130,195593,true,3205742512,28,3226969323,21226811
1641637597,195592,true,3206063086,28,3231490018,25426932
1641638015,195591,true,3206383693,28,3231490018,25106325
1641638228,195589,true,3207025002,28,3231490018,24465016
1641638785,195591,true,3206383693,28,3233106086,26722393
1641638814,195590,true,3206704331,28,3233106086,26401755
1641638880,195589,true,3207025002,28,3233106086,26081084
1641638945,195587,true,3207666439,28,3232782808,25116369
1641643631,195590,true,3206704331,28,3219878148,13173817
1641644046,195589,true,3207025002,28,3219878148,12853146
1641644545,195588,true,3207345704,28,3219878148,12532444
1641645573,195586,true,3207987205,28,3219878148,11890943
1641645730,195589,true,3207025002,28,3219556192,12531190
1641645806,195588,true,3207345704,28,3219234269,11888565
1641645858,195587,true,3207666439,28,3218912378,11245939
1641646140,195586,true,3207987205,28,3216338406,8351201
1641647785,195590,true,3206704331,28,3203179072,-3525259
1641647839,195588,true,3207345704,28,3202858786,-4486918
1641649249,195587,true,3207666439,28,3193903772,-13762667
1641649265,195586,true,3207987205,28,3193903772,-14083433
1641649336,195590,true,3206704331,28,3193584414,-13119917
1641649839,195588,true,3207345704,28,3193584414,-13761290
1641649889,195587,true,3207666439,28,3193584414,-14082025
1641649930,195586,true,3207987205,28,3193903772,-14083433
1641650529,195589,true,3207025002,28,3196140175,-10884827
1641651453,195587,true,3207666439,28,3198378145,-9288294
1641651839,195585,true,3208308004,28,3198378145,-9929859
1641652590,195583,true,3208949698,28,3195820593,-13129105
1641653854,195587,true,3207666439,28,3188160203,-19506236
1641654198,195585,true,3208308004,28,3186885258,-21422746
1641654266,195584,true,3208628835,28,3186247976,-22380859
1641654312,195582,true,3209270593,28,3185292293,-23978300
1641654790,195587,true,3207666439,28,3178292702,-29373737
1641654934,195587,true,3207666439,28,3176068787,-31597652
1641655066,195586,true,3207987205,28,3173846428,-34140777
1641655495,195586,true,3207987205,28,3167505395,-40481810
1641655853,195591,true,3206383693,28,3161809298,-44574395
1641656339,195590,true,3206704331,28,3158965092,-47739239
1641656509,195590,true,3206704331,28,3158965092,-47739239
1641657360,195589,true,3207025002,28,3158017592,-49007410
1641658078,195594,true,3205421970,28,3157386084,-48035886
1641658250,195594,true,3205421970,28,3158017592,-47404378
1641658421,195593,true,3205742512,28,3158965092,-46777420
1641658436,195593,true,3205742512,28,3158965092,-46777420
1641659250,195598,true,3204140122,28,3164656065,-39484057
1641659528,195597,true,3204460536,28,3165922118,-38538418
1641659568,195597,true,3204460536,28,3165922118,-38538418
1641659584,195597,true,3204460536,28,3165922118,-38538418
1641659775,195602,true,3202858786,28,3165289028,-37569758
1641659819,195603,true,3202538532,28,3164972531,-37566001
1641660056,195602,true,3202858786,28,3162757936,-40100850
1641660086,195603,true,3202538532,28,3162441692,-40096840
1641660192,195609,true,3200617681,28,3160860945,-39756736
1641660598,195611,true,3199977654,28,3153915042,-46062612
1641660643,195611,true,3199977654,28,3153284353,-46693301
1641661105,195613,true,3199337754,28,3145411382,-53926372
1641661217,195619,true,3197418823,28,3143524795,-53894028
1641661233,195621,true,3196779435,28,3143210474,-53568961
1641661250,195622,true,3196459789,28,3142896184,-53563605
1641661270,195624,true,3195820593,28,3142581926,-53238667
1641661557,195630,true,3193903772,28,3138499428,-55404344
1641661743,195632,true,3193265087,28,3136616987,-56648100
1641661757,195632,true,3193265087,28,3136303357,-56961730
1641662614,195634,true,3192626530,28,3126909015,-65717515
1641662669,195640,true,3190711624,28,3126283727,-64427897
1641662748,195642,true,3190073578,28,3125033526,-65040052
1641662761,195641,true,3190392585,28,3124721054,-65671531
1641662802,195644,true,3189435658,28,3124096204,-65339454
1641663135,195650,true,3187522667,28,3121285922,-66236745
1641663200,195651,true,3187203946,28,3120661759,-66542187
1641663334,195651,true,3187203946,28,3119101896,-68102050
1641663352,195654,true,3186247976,28,3118790017,-67457959
1641663414,195660,true,3184336896,28,3117542813,-66794083
1641663429,195662,true,3183700125,28,3117231090,-66469035
1641663457,195663,true,3183381786,28,3116607737,-66774049
1641663546,195666,true,3182426963,28,3114738427,-67688536
1641663598,195673,true,3180200155,28,3113804192,-66395963
1641663744,195675,true,3179564210,28,3110692100,-68872110
1641663895,195676,true,3179246286,28,3107893876,-71352410
1641663912,195680,true,3177974905,28,3107583118,-70391787
1641664033,195686,true,3176068787,28,3105098170,-70970617
1641664116,195689,true,3175116157,28,3103546086,-71570071
1641664137,195690,true,3174798677,28,3103235763,-71562914
1641664171,195694,true,3173529075,28,3102615208,-70913867
1641664210,195701,true,3171308493,28,3101684610,-69623883
1641664224,195704,true,3170357291,28,3101374473,-68982818
1641664244,195705,true,3170040287,28,3100754291,-69285996
1641664258,195709,true,3168772588,28,3100444246,-68328342
1641664466,195716,true,3166555334,28,3095178232,-71377102
1641664487,195718,true,3165922118,28,3094559289,-71362829
1641664489,195720,true,3165289028,28,3094559289,-70729739
1641664591,195725,true,3163706858,28,3091466431,-72240427
1641664615,195733,true,3161177031,28,3090539177,-70637854
1641664671,195737,true,3159912877,28,3088376664,-71536213
1641664707,195739,true,3159280989,28,3086832939,-72448050
1641664734,195744,true,3157701822,28,3085598514,-72103308
1641664776,195752,true,3155176797,28,3084056178,-71120619
1641664791,195756,true,3153915042,28,3083439459,-70475583
1641664804,195758,true,3153284353,28,3082822864,-70461489
1641664831,195763,true,3151708184,28,3081898202,-69809982
1641664856,195772,true,3148873065,28,3080665751,-68207314
1641664863,195776,true,3147613830,28,3080357715,-67256115
1641664907,195778,true,3146984402,28,3078817998,-68166404
1641664967,195783,true,3145411382,28,3076663687,-68747695
1641664980,195792,true,3142581926,28,3076356052,-66225874
1641665042,195795,true,3141639340,28,3073896074,-67743266
1641665060,195798,true,3140697037,28,3073281387,-67415650
1641665077,195803,true,3139127159,28,3072666823,-66460336
1641665240,195813,true,3135989758,28,3066221315,-69768443
1641665252,195817,true,3134735676,28,3065608163,-69127513
1641665275,195820,true,3133795443,28,3064688664,-69106779
1641665293,195826,true,3131915824,28,3063769441,-68146383
1641665580,195838,true,3128159966,28,3051844605,-76315361
1641665665,195842,true,3126909015,28,3048489590,-78419425
1641665689,195845,true,3125971130,28,3047575226,-78395904
1641665719,195851,true,3124096204,28,3046661136,-77435068
1641665751,195862,true,3120661759,28,3045747320,-74914439
1641665765,195866,true,3119413806,28,3045442776,-73971030
1641665805,195868,true,3118790017,28,3044529326,-74260691
1641665829,195873,true,3117231090,28,3043920511,-73310579
1641665846,195882,true,3114426984,28,3043616150,-70810834
1641665891,195887,true,3112870237,28,3042094798,-70775439
1641665899,195889,true,3112247757,28,3041790619,-70457138
1641666226,195894,true,3110692100,28,3035713421,-74978679
1641666289,195902,true,3108204665,28,3035106369,-73098296
1641666301,195906,true,3106961694,28,3035106369,-71855325
1641666306,195909,true,3106029792,28,3035106369,-70923423
1641666395,195911,true,3105408679,28,3035409880,-69998799
1641666618,195918,true,3103235763,28,3037839058,-65396705
1641667066,195922,true,3101994778,28,3045138262,-56856516
1641667347,195924,true,3101374473,28,3053065526,-48308947
1641667378,195926,true,3100754291,28,3053981538,-46772753
1641667481,195933,true,3098584631,28,3056119966,-42464665
1641668062,195938,true,3097035803,28,3059177462,-37858341
1641668093,195940,true,3096416489,28,3058871574,-37544915
1641668230,195943,true,3095487750,28,3057648332,-37839418
1641668283,195950,true,3093321775,28,3056731221,-36590554
1641668291,195956,true,3091466431,28,3056731221,-34735210
1641668315,195958,true,3090848230,28,3056425578,-34422652
1641668438,195962,true,3089612200,28,3053065526,-36546674
1641668449,195969,true,3087450336,28,3052760250,-34690086
1641668478,195975,true,3085598514,28,3051844605,-33753909
1641668504,195978,true,3084673020,28,3050929235,-33743785
1641668521,195983,true,3083131146,28,3050319141,-32812005
1641668575,195988,true,3081590043,28,3049099318,-32490725
1641668585,195992,true,3080357715,28,3048794439,-31563276
1641668751,195995,true,3079433792,28,3044224903,-35208889
1641668781,195999,true,3078202327,28,3043311818,-34890509
1641669221,196002,true,3077279051,28,3037535304,-39743747
1641669505,196007,true,3075740873,28,3035409880,-40330993
1641669544,196009,true,3075125817,28,3035106369,-40019448
1641669641,196013,true,3073896074,28,3033589271,-40306803
1641669697,196017,true,3072666823,28,3032679376,-39987447
1641669858,196023,true,3070823868,28,3029345430,-41478438
1641669959,196025,true,3070209795,28,3027528458,-42681337
1641670002,196030,true,3068675151,28,3026620382,-42054769
1641670127,196035,true,3067141273,28,3024805045,-42336228
1641670462,196041,true,3065301632,28,3024502595,-40799037
1641670463,196043,true,3064688664,28,3024502595,-40186069
1641670465,196048,true,3063156779,28,3024502595,-38654184
1641670550,196051,true,3062238016,28,3025107525,-37130491
1641670643,196055,true,3061013427,28,3024805045,-36208382
1641670657,196057,true,3060401316,28,3024805045,-35596271
1641670673,196062,true,3058871574,28,3024805045,-34066529
1641670881,196065,true,3057954096,28,3024200174,-33753922
1641670921,196068,true,3057036894,28,3023897785,-33139109
1641671063,196070,true,3056425578,28,3023293096,-33132482
1641671140,196075,true,3054897824,28,3022990797,-31907027
1641671190,196077,true,3054286936,28,3022386289,-31900647
1641671270,196081,true,3053065526,28,3021781903,-31283623
1641671402,196084,true,3052149790,28,3020573492,-31576298
1641671801,196088,true,3050929235,28,3020271465,-30657770
1641671820,196091,true,3050014139,28,3020271465,-29742674
1641672029,196094,true,3049099318,28,3021781903,-27317415
1641672417,196096,true,3048489590,28,3025107525,-23382065
1641672573,196099,true,3047575226,28,3024805045,-22770181
1641672679,196101,true,3046965802,28,3024502595,-22463207
1641672739,196104,true,3046051895,28,3024200174,-21851721
1641672806,196106,true,3045442776,28,3023897785,-21544991
1641672808,196109,true,3044529326,28,3023897785,-20631541
1641672861,196112,true,3043616150,28,3023595425,-20020725
1641672898,196115,true,3042703247,28,3023595425,-19107822
1641673025,196117,true,3042094798,28,3023293096,-18801702
1641673131,196120,true,3041182352,28,3023293096,-17889256
1641673570,196122,true,3040574207,28,3024200174,-16374033
1641673602,196125,true,3039662217,28,3024502595,-15159622
1641673958,196126,true,3039358281,28,3023595425,-15762856
1641674012,196128,true,3038750501,28,3023293096,-15457405
1641674107,196130,true,3038142842,28,3023293096,-14849746
1641674130,196132,true,3037535304,28,3023293096,-14242208
1641674351,196132,true,3037535304,28,3024502595,-13032709
1641675057,196134,true,3036927888,28,3032982644,-3945244
1641675225,196135,true,3036624226,28,3035106369,-1517857
1641675925,196137,true,3036016992,28,3039662217,3645225
1641675931,196137,true,3036016992,28,3039662217,3645225
1641676939,196139,true,3035409880,28,3041182352,5772472
1641677049,196140,true,3035106369,28,3041486470,6380101
1641677074,196142,true,3034499439,28,3041486470,6987031
1641677397,196141,true,3034802889,28,3044224903,9422014
1641677421,196142,true,3034499439,28,3044529326,10029887
1641677475,196142,true,3034499439,28,3045442776,10943337
1641677481,196144,true,3033892630,28,3045442776,11550146
1641678019,196142,true,3034499439,28,3053065526,18566087
1641678175,196142,true,3034499439,28,3055814385,21314946
1641678259,196141,true,3034802889,28,3057954096,23151207
1641678371,196142,true,3034499439,28,3061319528,26820089
1641678435,196138,true,3035713421,28,3062850494,27137073
1641678746,196137,true,3036016992,28,3069902805,33885813
1641678796,196136,true,3036320594,28,3070823868,34503274
1641679467,196138,true,3035713421,28,3078817998,43104577
1641679529,196134,true,3036927888,28,3079433792,42505904
1641679712,196134,true,3036927888,28,3081281915,44354027
1641679797,196132,true,3037535304,28,3082514612,44979308
1641679848,196133,true,3037231581,28,3082822864,45591283
1641679995,196129,true,3038446656,28,3084056178,45609522
1641680006,196129,true,3038446656,28,3084056178,45609522
1641680063,196127,true,3039054376,28,3084364584,45310208
1641680541,196127,true,3039054376,28,3088994370,49939994
1641680650,196123,true,3040270180,28,3090848230,50578050
1641680951,196121,true,3040878264,28,3096416489,55538225
1641681073,196118,true,3041790619,28,3098584631,56794012
1641681738,196117,true,3042094798,28,3109448134,67353336
1641681805,196112,true,3043616150,28,3110381061,66764911
1641682024,196110,true,3044224903,28,3112247757,68022854
1641682121,196106,true,3045442776,28,3113181524,67738748
1641682345,196104,true,3046051895,28,3115049900,68998005
1641682415,196100,true,3047270499,28,3115672942,68402443
1641682456,196098,true,3047879983,28,3115984509,68104526
1641683085,196094,true,3049099318,28,3117231090,68131772
1641683475,196094,true,3049099318,28,3116296107,67196789
1641683509,196091,true,3050014139,28,3116296107,66281968
1641683959,196089,true,3050624173,28,3113181524,62557351
1641684277,196087,true,3051234328,28,3110692100,59457772
1641684408,196086,true,3051539451,28,3109759079,58219628
1641684680,196083,true,3052455005,28,3107583118,55128113
1641685003,196082,true,3052760250,28,3105098170,52337920
1641685828,196080,true,3053370833,28,3101064366,47693533
1641685957,196080,true,3053370833,28,3100444246,47073413
1641686027,196076,true,3054592364,28,3099824250,45231886
1641686449,196078,true,3053981538,28,3097345507,43363969
1641686516,196077,true,3054286936,28,3097035803,42748867
1641686569,196077,true,3054286936,28,3096726130,42439194
1641686779,196074,true,3055203313,28,3094249864,39046551
1641686859,196076,true,3054592364,28,3093012473,38420109
1641686945,196075,true,3054897824,28,3091775578,36877754
1641687323,196075,true,3054897824,28,3085907074,31009250
1641688724,196071,true,3056119966,28,3075433329,19313363
1641689091,196073,true,3055508834,28,3076971354,21462520
1641689138,196072,true,3055814385,28,3077279051,21464666
1641689140,196071,true,3056119966,28,3077279051,21159085
1641689156,196066,true,3057648332,28,3077586779,19938447
1641689477,196065,true,3057954096,28,3082206392,24252296
1641689694,196062,true,3058871574,28,3086215665,27344091
1641689857,196061,true,3059177462,28,3088994370,29816908
1641690311,196055,true,3061013427,28,3097965007,36951580
1641690948,196052,true,3061931823,28,3114115572,52183749
1641690967,196050,true,3062544240,28,3114426984,51882744
1641691130,196049,true,3062850494,28,3115984509,53134015
1641691664,196043,true,3064688664,28,3118790017,54101353
1641691714,196040,true,3065608163,28,3118790017,53181854
1641691741,196040,true,3065608163,28,3118790017,53181854
1641691807,196039,true,3065914723,28,3118790017,52875294
1641692230,196035,true,3067141273,28,3116296107,49154834
1641693092,196032,true,3068061508,28,3108204665,40143157
1641693528,196032,true,3068061508,28,3105408679,37347171
1641693775,196029,true,3068982018,28,3105719220,36737202
1641694598,196025,true,3070209795,28,3108204665,37994870
1641694661,196021,true,3071438063,28,3108515486,37077423
1641694800,196020,true,3071745207,28,3109448134,37702927
1641694860,196017,true,3072666823,28,3109759079,37092256
1641695017,196012,true,3074203464,28,3111314269,37110805
1641695246,196009,true,3075125817,28,3113492843,38367026
1641695416,196008,true,3075433329,28,3115049900,39616571
1641696222,196006,true,3076048447,28,3120973825,44925378
1641696257,196001,true,3077586779,28,3121285922,43699143
1641696734,195997,true,3078817998,28,3126596355,47778357
1641697206,195996,true,3079125880,28,3130350335,51224455
1641698940,195994,true,3079741736,28,3135989758,56248022
1641700023,195989,true,3081281915,28,3135989758,54707843
1641700043,195985,true,3082514612,28,3135989758,53475146
1641700391,195984,true,3082822864,28,3135676190,52853326
1641700455,195981,true,3083747803,28,3135676190,51928387
1641700730,195976,true,3085289985,28,3134735676,49445691
1641700774,195971,true,3086832939,28,3134735676,47902737
1641701140,195970,true,3087141622,28,3133482095,46340473
1641701328,195968,true,3087759081,28,3132542238,44783157
1641701512,195964,true,3088994370,28,3131915824,42921454
1641701785,195960,true,3090230154,28,3130663370,40433216
1641702832,195959,true,3090539177,28,3128472782,37933605
1641703824,195957,true,3091157315,28,3128159966,37002651
1641704095,195952,true,3092703203,28,3128785630,36082427
1641704286,195948,true,3093940470,28,3129098508,35158038
1641705151,195946,true,3094559289,28,3131602663,37043374
1641705315,195944,true,3095178232,28,3131915824,36737592
1641707593,195939,true,3096726130,28,3133482095,36755965
1641709059,195934,true,3098274803,28,3131602663,33327860
1641709565,195933,true,3098584631,28,3130976437,32391806
1641710973,195931,true,3099204379,28,3130976437,31772058
1641714673,195926,true,3100754291,28,3130976437,30222146
1641716501,195922,true,3101994778,28,3130976437,28981659
1641716571,195921,true,3102304978,28,3130976437,28671459
1641716856,195919,true,3102925470,28,3130037332,27111862
1641718587,195916,true,3103856441,28,3116607737,12751296
1641719395,195913,true,3104787691,28,3115984509,11196818
1641719885,195912,true,3105098170,28,3115984509,10886339
1641720290,195910,true,3105719220,28,3114426984,8707764
1641720368,195907,true,3106651029,28,3113804192,7153163
1641721021,195905,true,3107272390,28,3107583118,310728
1641723143,195905,true,3107272390,28,3102925470,-4346920
1641723838,195903,true,3107893876,28,3100444246,-7449630
1641724038,195901,true,3108515486,28,3099824250,-8691236
1641725080,195899,true,3109137220,28,3096106878,-13030342
1641726026,195900,true,3108826337,28,3098274803,-10551534
1641726096,195898,true,3109448134,28,3098584631,-10863503
1641726459,195897,true,3109759079,28,3100134233,-9624846
1641726527,195896,true,3110070054,28,3100444246,-9625808
1641726559,195896,true,3110070054,28,3100754291,-9315763
1641726735,195895,true,3110381061,28,3101994778,-8386283
1641726837,195894,true,3110692100,28,3103235763,-7456337
1641726840,195893,true,3111003169,28,3103235763,-7767406
1641727949,195893,true,3111003169,28,3114738427,3735258
1641728316,195890,true,3111936563,28,3117854567,5918004
1641728806,195890,true,3111936563,28,3120349724,8413161
1641729743,195888,true,3112558982,28,3121910211,9351229
1641730397,195888,true,3112558982,28,3122846877,10287895
1641730552,195886,true,3113181524,28,3122534624,9353100
1641730597,195886,true,3113181524,28,3122534624,9353100
1641730772,195885,true,3113492843,28,3122222402,8729559
1641730928,195885,true,3113492843,28,3121910211,8417368
1641730957,195884,true,3113804192,28,3121598051,7793859
1641730964,195884,true,3113804192,28,3121598051,7793859
1641731686,195883,true,3114115572,28,3119413806,5298234
1641731854,195884,true,3113804192,28,3118790017,4985825
1641732063,195883,true,3114115572,28,3118166352,4050780
1641732307,195884,true,3113804192,28,3117231090,3426898
1641732505,195883,true,3114115572,28,3116919398,2803826
1641732613,195884,true,3113804192,28,3116919398,3115206
1641734223,195884,true,3113804192,28,3115672942,1868750
1641734834,195884,true,3113804192,28,3116919398,3115206
1641734855,195884,true,3113804192,28,3116919398,3115206
1641734978,195884,true,3113804192,28,3116919398,3115206
1641735029,195884,true,3113804192,28,3116919398,3115206
1641735057,195884,true,3113804192,28,3116919398,3115206
1641735069,195883,true,3114115572,28,3116919398,2803826
1641735496,195884,true,3113804192,28,3114426984,622792
1641735640,195884,true,3113804192,28,3113804192,0
1641736243,195884,true,3113804192,28,3109759079,-4045113
1641736327,195883,true,3114115572,28,3109137220,-4978352
1641739334,195884,true,3113804192,28,3096726130,-17078062
1641739937,195884,true,3113804192,28,3099824250,-13979942
1641740460,195884,true,3113804192,28,3101994778,-11809414
1641740940,195883,true,3114115572,28,3104477243,-9638329
1641741271,195883,true,3114115572,28,3104477243,-9638329
1641741330,195882,true,3114426984,28,3103856441,-10570543
1641741392,195882,true,3114426984,28,3103546086,-10880898
1641742117,195882,true,3114426984,28,3095487750,-18939234
1641742123,195882,true,3114426984,28,3095487750,-18939234
1641742208,195881,true,3114738427,28,3094559289,-20179138
1641742331,195881,true,3114738427,28,3093631107,-21107320
1641742789,195880,true,3115049900,28,3091157315,-23892585
1641743446,195880,true,3115049900,28,3092084755,-22965145
1641745521,195879,true,3115361405,28,3095178232,-20183173
1641745539,195879,true,3115361405,28,3095487750,-19873655
1641745577,195880,true,3115049900,28,3095487750,-19562150
1641745720,195881,true,3114738427,28,3095797298,-18941129
1641745920,195879,true,3115361405,28,3096416489,-18944916
1641745942,195880,true,3115049900,28,3096416489,-18633411
1641745991,195882,true,3114426984,28,3096726130,-17700854
1641746954,195882,true,3114426984,28,3107272390,-7154594
1641746970,195880,true,3115049900,28,3107583118,-7466782
1641747061,195881,true,3114738427,28,3108826337,-5912090
1641747076,195882,true,3114426984,28,3109137220,-5289764
1641747083,195881,true,3114738427,28,3109137220,-5601207
1641747320,195879,true,3115361405,28,3113804192,-1557213
1641747386,195878,true,3115672942,28,3115361405,-311537
1641747430,195879,true,3115361405,28,3116296107,934702
1641747565,195877,true,3115984509,28,3119725747,3741238
1641747605,195874,true,3116919398,28,3120973825,4054427
1641747667,195874,true,3116919398,28,3122534624,5615226
1641747685,195875,true,3116607737,28,3123159162,6551425
1641748329,195872,true,3117542813,28,3140068992,22526179
1641748362,195869,true,3118478169,28,3141011107,22532938
1641748388,195869,true,3118478169,28,3141639340,23161171
1641748696,195870,true,3118166352,28,3148873065,30706713
1641749609,195868,true,3118790017,28,3161177031,42387014
1641750830,195864,true,3120037720,28,3165922118,45884398
1641751883,195864,true,3120037720,28,3165289028,45251308
1641752266,195866,true,3119413806,28,3164656065,45242259
1641753027,195864,true,3120037720,28,3163706858,43669138
1641753457,195861,true,3120973825,28,3164972531,43998706
1641755233,195861,true,3120973825,28,3169089465,48115640
1641755853,195862,true,3120661759,28,3169089465,48427706
1641755861,195860,true,3121285922,28,3169406374,48120452
1641756020,195857,true,3122222402,28,3169723314,47500912
1641756281,195856,true,3122534624,28,3170674326,48139702
1641756374,195857,true,3122222402,28,3171308493,49086091
1641756399,195855,true,3122846877,28,3171625624,48778747
1641756405,195852,true,3123783825,28,3171625624,47841799
1641756516,195850,true,3124408613,28,3172259981,47851368
1641756548,195851,true,3124096204,28,3172577207,48481003
1641756575,195848,true,3125033526,28,3173211754,48178228
1641756591,195845,true,3125971130,28,3173211754,47240624
1641758559,195843,true,3126596355,28,3194542585,67946230
1641758589,195844,true,3126283727,28,3194862039,68578312
1641759566,195841,true,3127221706,28,3197418823,70197117
1641763906,195838,true,3128159966,28,3200617681,72457715
1641764058,195835,true,3129098508,28,3200617681,71519173
1641764825,195836,true,3128785630,28,3200617681,71832051
1641764856,195833,true,3129724359,28,3200617681,70893322
1641764900,195830,true,3130663370,28,3200617681,69954311
1641764928,195827,true,3131602663,28,3200617681,69015018
1641765231,195829,true,3130976437,28,3199977654,69001217
1641765708,195826,true,3131915824,28,3198378145,66462321
1641768393,195823,true,3132855492,28,3195181525,62326033
1641768749,195819,true,3134108822,28,3194862039,60753217
1641768934,195820,true,3133795443,28,3193903772,60108329
1641768988,195817,true,3134735676,28,3193584414,58848738
1641769650,195814,true,3135676190,28,3190073578,54397388
1641770076,195811,true,3136616987,28,3185610822,48993835
1641770193,195811,true,3136616987,28,3184018495,47401508
1641770428,195808,true,3137558066,28,3180836227,43278161
1641770578,195806,true,3138185609,28,3177974905,39789296
1641770701,195804,true,3138813278,28,3176068787,37255509
1641771296,195804,true,3138813278,28,3166238710,27425432
1641771389,195802,true,3139441072,28,3164656065,25214993
1641773767,195800,true,3140068992,28,3151077937,11008945
1641773916,195798,true,3140697037,28,3151077937,10380900
1641774014,195799,true,3140382998,28,3151393045,11010047
1641774198,195796,true,3141325208,28,3151393045,10067837
1641774290,195795,true,3141639340,28,3151708184,10068844
1641775076,195793,true,3142267699,28,3156123445,13855746
1641775378,195793,true,3142267699,28,3157070377,14802678
1641775491,195791,true,3142896184,28,3157070377,14174193
1641775573,195790,true,3143210474,28,3157070377,13859903
1641775608,195789,true,3143524795,28,3157070377,13545582
1641775646,195790,true,3143210474,28,3157070377,13859903
1641776398,195788,true,3143839148,28,3153915042,10075894
1641776475,195787,true,3144153531,28,3153284353,9130822
1641776525,195786,true,3144467947,28,3152653791,8185844
1641776556,195787,true,3144153531,28,3152023355,7869824
1641776617,195786,true,3144467947,28,3151393045,6925098
1641777439,195785,true,3144782394,28,3142267699,-2514695
1641778081,195784,true,3145096872,28,3138185609,-6911263
1641778512,195785,true,3144782394,28,3137244342,-7538052
1641778558,195784,true,3145096872,28,3137244342,-7852530
1641779216,195783,true,3145411382,28,3140068992,-5342390
1641780386,195781,true,3146040495,28,3144467947,-1572548
1641780495,195781,true,3146040495,28,3144782394,-1258101
1641782759,195780,true,3146355099,28,3145411382,-943717
1641782787,195779,true,3146669735,28,3145725923,-943812
1641783016,195777,true,3147299100,28,3146040495,-1258605
1641783266,195778,true,3146984402,28,3146355099,-629303
1641784495,195777,true,3147299100,28,3149187952,1888852
1641785379,195776,true,3147613830,28,3149187952,1574122
1641788210,195773,true,3148558209,28,3149502871,944662
1641788360,195774,true,3148243384,28,3150132803,1889419
1641789250,195771,true,3149187952,28,3158017592,8829640
1641790340,195770,true,3149502871,28,3166871989,17369118
1641790516,195767,true,3150447816,28,3166871989,16424173
1641792527,195767,true,3150447816,28,3168138928,17691112
1641792740,195763,true,3151708184,28,3168455742,16747558
1641794032,195762,true,3152023355,28,3168455742,16432387
1641795997,195759,true,3152969057,28,3168455742,15486685
1641796118,195759,true,3152969057,28,3168455742,15486685
1641797330,195756,true,3153915042,28,3166238710,12323668
1641797849,195755,true,3154230433,28,3165289028,11058595
1641799060,195751,true,3155492315,28,3164972531,9480216
1641799305,195751,true,3155492315,28,3164972531,9480216
1641800379,195747,true,3156754701,28,3163074212,6319511
1641801307,195746,true,3157070377,28,3161809298,4738921
1641801633,195743,true,3158017592,28,3161809298,3791706
1641802924,195743,true,3158017592,28,3161809298,3791706
1641803006,195740,true,3158965092,28,3161809298,2844206
1641803147,195739,true,3159280989,28,3161177031,1896042
1641803442,195735,true,3160544891,28,3159912877,-632014
1641803632,195736,true,3160228868,28,3158965092,-1263776
1641803786,195733,true,3161177031,28,3158333394,-2843637
1641804146,195733,true,3161177031,28,3155807864,-5369167
1641804902,195730,true,3162125479,28,3151393045,-10732434
1641805332,195731,true,3161809298,28,3150132803,-11676495
1641805425,195729,true,3162441692,28,3150132803,-12308889
1641806338,195729,true,3162441692,28,3144782394,-17659298
1641806417,195726,true,3163390519,28,3144782394,-18608125
1641806949,195727,true,3163074212,28,3144153531,-18920681
1641808231,195726,true,3163390519,28,3146984402,-16406117
1641808245,195727,true,3163074212,28,3146984402,-16089810
1641808445,195725,true,3163706858,28,3147299100,-16407758
1641809997,195726,true,3163390519,28,3148558209,-14832310
1641810001,195725,true,3163706858,28,3148558209,-15148649
1641810036,195726,true,3163390519,28,3148873065,-14517454
1641810045,195724,true,3164023229,28,3148873065,-15150164
1641810820,195725,true,3163706858,28,3152023355,-11683503
1641810957,195725,true,3163706858,28,3152653791,-11053067
1641811120,195727,true,3163074212,28,3152969057,-10105155
1641812279,195725,true,3163706858,28,3153915042,-9791816
1641812381,195726,true,3163390519,28,3153599682,-9790837
1641812398,195726,true,3163390519,28,3153599682,-9790837
1641812411,195728,true,3162757936,28,3153599682,-9158254
1641812558,195727,true,3163074212,28,3152653791,-10420421
1641812576,195728,true,3162757936,28,3152338557,-10419379
1641812684,195729,true,3162441692,28,3151077937,-11363755
1641812732,195731,true,3161809298,28,3150447816,-11361482
1641812854,195731,true,3161809298,28,3148558209,-13251089
1641812859,195732,true,3161493149,28,3148558209,-12934940
1641813030,195734,true,3160860945,28,3146040495,-14820450
1641813037,195736,true,3160228868,28,3146040495,-14188373
1641813121,195736,true,3160228868,28,3144467947,-15760921
1641813126,195738,true,3159596917,28,3144467947,-15128970
1641813147,195740,true,3158965092,28,3143839148,-15125944
1641813783,195742,true,3158333394,28,3132229015,-26104379
1641813794,195743,true,3158017592,28,3131915824,-26101768
1641813936,195745,true,3157386084,28,3129411418,-27974666
1641814036,195747,true,3156754701,28,3127221706,-29532995
1641815746,195751,true,3155492315,28,3108826337,-46665978
1641815834,195753,true,3154861311,28,3108515486,-46345825
1641815892,195755,true,3154230433,28,3108204665,-46025768
1641815924,195757,true,3153599682,28,3108204665,-45395017
1641815931,195761,true,3152338557,28,3108204665,-44133892
1641815950,195764,true,3151393045,28,3108204665,-43188380
1641816081,195766,true,3150762861,28,3107583118,-43179743
1641816111,195769,true,3149817821,28,3107272390,-42545431
1641816847,195773,true,3148558209,28,3103235763,-45322446
1641816900,195776,true,3147613830,28,3102925470,-44688360
1641818082,195778,true,3146984402,28,3093631107,-53353295
1641818124,195781,true,3146040495,28,3093631107,-52409388
1641818175,195785,true,3144782394,28,3093012473,-51769921
1641818625,195788,true,3143839148,28,3086832939,-57006209
1641818752,195792,true,3142581926,28,3085598514,-56983412
1641818848,195794,true,3141953504,28,3084673020,-57280484
1641818861,195798,true,3140697037,28,3084364584,-56332453
1641818988,195800,true,3140068992,28,3083131146,-56937846
1641818999,195804,true,3138813278,28,3082822864,-55990414
1641819029,195807,true,3137871822,28,3082206392,-55665430
1641819120,195810,true,3136930649,28,3080357715,-56572934
1641819609,195814,true,3135676190,28,3067754732,-67921458
1641819974,195817,true,3134735676,28,3058565718,-76169958
1641820294,195820,true,3133795443,28,3053065526,-80729917
1641820326,195823,true,3132855492,28,3052149790,-80705702
1641820468,195827,true,3131602663,28,3049099318,-82503345
1641820480,195830,true,3130663370,28,3048794439,-81868931
1641820542,195833,true,3129724359,28,3047270499,-82453860
1641820670,195836,true,3128785630,28,3044529326,-84256304
1641820745,195841,true,3127221706,28,3043007518,-84214188
1641820811,195845,true,3125971130,28,3041486470,-84484660
1641821047,195848,true,3125033526,28,3039358281,-85675245
1641821100,195851,true,3124096204,28,3038750501,-85345703
1641821260,195856,true,3122534624,28,3036927888,-85606736
1641821383,195859,true,3121598051,28,3035713421,-85884630
1641821410,195862,true,3120661759,28,3035409880,-85251879
1641821414,195866,true,3119413806,28,3035106369,-84307437
1641821483,195870,true,3118166352,28,3034196019,-83970333
1641821685,195874,true,3116919398,28,3031466608,-85452790
1641821738,195876,true,3116296107,28,3031163491,-85132616
1641821813,195879,true,3115361405,28,3030860405,-84501000
1641822393,195882,true,3114426984,28,3030557350,-83869634
1641822488,195885,true,3113492843,28,3030860405,-82632438
1641822494,195888,true,3112558982,28,3030860405,-81698577
1641822702,195890,true,3111936563,28,3031466608,-80469955
1641822829,195895,true,3110381061,28,3031466608,-78914453
1641822900,195898,true,3109448134,28,3031163491,-78284643
1641823066,195901,true,3108515486,28,3030860405,-77655081
1641823711,195904,true,3107583118,28,3029951329,-77631789
1641823823,195909,true,3106029792,28,3028739652,-77290140
1641823888,195913,true,3104787691,28,3027831211,-76956480
1641823977,195916,true,3103856441,28,3026620382,-77236059
1641824012,195920,true,3102615208,28,3026317750,-76297458
1641824165,195925,true,3101064366,28,3024200174,-76864192
1641824193,195929,true,3099824250,28,3023897785,-75926465
1641824202,195932,true,3098894489,28,3023595425,-75299064
1641824291,195937,true,3097345507,28,3022084081,-75261426
1641824326,195944,true,3095178232,28,3021177637,-74000595
1641824336,195948,true,3093940470,28,3020875549,-73064921
1641824368,195952,true,3092703203,28,3019667501,-73035702
1641824374,195958,true,3090848230,28,3019667501,-71180729
1641824420,195966,true,3088376664,28,3018158120,-70218544
1641824485,195969,true,3087450336,28,3016649494,-70800842
1641824494,195974,true,3085907074,28,3016046254,-69860820
1641824657,195980,true,3084056178,28,3011525802,-72530376
1641824739,195988,true,3081590043,28,3008816784,-72773259
1641824755,195992,true,3080357715,28,3008215111,-72142604
1641824766,195996,true,3079125880,28,3007613558,-71512322
1641824776,196004,true,3076663687,28,3007312827,-69350860
1641824841,196012,true,3074203464,28,3004908059,-69295405
1641824852,196017,true,3072666823,28,3004307167,-68359656
1641824860,196021,true,3071438063,28,3004006766,-67431297
1641824865,196029,true,3068982018,28,3003706396,-65275622
1641824873,196038,true,3066221315,28,3003406055,-62815260
1641824999,196040,true,3065608163,28,2998304857,-67303306
1641825077,196044,true,3064382226,28,2995308201,-69074025
1641825171,196052,true,3061931823,28,2991716166,-70215657
1641825206,196061,true,3059177462,28,2990220757,-68956705
1641825217,196064,true,3058259892,28,2989622802,-68637090
1641825345,196068,true,3057036894,28,2983649830,-73387064
1641825422,196076,true,3054592364,28,2980071777,-74520587
1641825560,196085,true,3051844605,28,2973523152,-78321453
1641825588,196088,true,3050929235,28,2972334040,-78595195
1641825666,196093,true,3049404228,28,2969066434,-80337794
1641825683,196101,true,3046965802,28,2968175892,-78789910
1641825700,196109,true,3044529326,28,2967582346,-76946980
1641825703,196112,true,3043616150,28,2967582346,-76033804
1641825731,196115,true,3042703247,28,2966988918,-75714329
1641825792,196121,true,3040878264,28,2965802419,-75075845
1641825838,196128,true,3038750501,28,2965505869,-73244632
1641825884,196131,true,3037839058,28,2965209348,-72629710
1641825889,196133,true,3037231581,28,2965209348,-72022233
1641825926,196139,true,3035409880,28,2964616395,-70793485
1641825941,196147,true,3032982644,28,2964616395,-68366249
1641825989,196150,true,3032072931,28,2964023561,-68049370
1641826008,196152,true,3031466608,28,2963727188,-67739420
1641826223,196157,true,3029951329,28,2964616395,-65334934
1641826252,196164,true,3027831211,28,2964912857,-62918354
1641826340,196166,true,3027225736,28,2966988918,-60236818
1641826375,196168,true,3026620382,28,2967582346,-59038036
1641826688,196171,true,3025712577,28,2978284359,-47428218
1641826761,196177,true,3023897785,28,2980965888,-42931897
1641827017,196179,true,3023293096,28,2989921765,-33371331
1641827091,196181,true,3022688528,28,2992613771,-30074757
1641827188,196184,true,3021781903,28,2996206883,-25575020
1641827331,196190,true,3019969468,28,3001604642,-18364826
1641827615,196193,true,3019063658,28,3008515932,-10547726
1641827671,196195,true,3018459936,28,3008515932,-9944004
1641827719,196198,true,3017554579,28,3008515932,-9038647
1641827736,196204,true,3015744680,28,3008515932,-7228748
1641827763,196208,true,3014538684,28,3008816784,-5721900
1641828335,196209,true,3014237260,28,3003406055,-10831205
1641828547,196212,true,3013333170,28,3000704341,-12628829
1641828562,196218,true,3011525802,28,3000404300,-11121502
1641828614,196221,true,3010622525,28,3000104290,-10518235
1641828667,196222,true,3010321493,28,2999504359,-10817134
1641828744,196224,true,3009719519,28,2999204439,-10515080
1641828766,196230,true,3007914319,28,2999204439,-8709880
1641828798,196232,true,3007312827,28,2998904548,-8408279
1641828809,196233,true,3007012125,28,2998904548,-8107577
1641828816,196234,true,3006711454,28,2998904548,-7806906
1641828892,196239,true,3005208549,28,2999504359,-5704190
1641829085,196241,true,3004607598,28,3001604642,-3002956
1641829335,196241,true,3004607598,28,3004307167,-300431
1641829339,196242,true,3004307167,28,3004307167,0
1641829605,196247,true,3002805464,28,3007613558,4808094
1641829679,196247,true,3002805464,28,3008816784,6011320
1641829715,196248,true,3002505214,28,3009418577,6913363
1641829734,196249,true,3002204993,28,3009719519,7514526
1641829807,196253,true,3001004411,28,3010622525,9618114
1641829888,196254,true,3000704341,28,3011224680,10520339
1641829942,196254,true,3000704341,28,3011826955,11122614
1641830173,196255,true,3000404300,28,3013634503,13230203
1641830648,196258,true,2999504359,28,3012730593,13226234
1641830978,196259,true,2999204439,28,3008816784,9612345
1641831151,196259,true,2999204439,28,3007914319,8709880
1641831171,196260,true,2998904548,28,3007613558,8709010
1641831373,196262,true,2998304857,28,3007012125,8707268
1641831430,196262,true,2998304857,28,3006711454,8406597
1641831464,196261,true,2998604688,28,3006711454,8106766
1641831476,196262,true,2998304857,28,3006711454,8406597
1641831497,196264,true,2997705286,28,3006711454,9006168
1641831527,196262,true,2998304857,28,3007312827,9007970
1641831583,196259,true,2999204439,28,3009117665,9913226
1641831609,196259,true,2999204439,28,3009719519,10515080
1641831617,196260,true,2998904548,28,3010020491,11115943
1641831705,196258,true,2999504359,28,3012730593,13226234
1641831887,196254,true,3000704341,28,3018761782,18057441
1641832185,196254,true,3000704341,28,3029951329,29246988
1641835021,196254,true,3000704341,28,3071130950,70426609
1641835041,196252,true,3001304512,28,3071130950,69826438
1641835235,196248,true,3002505214,28,3070516816,68011602
1641835604,196248,true,3002505214,28,3066527937,64022723
1641835625,196252,true,3001304512,28,3065914723,64610211
1641835639,196250,true,3001904803,28,3065608163,63703360
1641835650,196247,true,3002805464,28,3065301632,62496168
1641835674,196250,true,3001904803,28,3064688664,62783861
1641835693,196253,true,3001004411,28,3064075818,63071407
1641835757,196251,true,3001604642,28,3062544240,60939598
1641835787,196247,true,3002805464,28,3061625660,58820196
1641835819,196251,true,3001604642,28,3060707356,59102714
1641835823,196253,true,3001004411,28,3060707356,59702945
1641835885,196251,true,3001604642,28,3058565718,56961076
1641835890,196248,true,3002505214,28,3058259892,55754678
1641835940,196252,true,3001304512,28,3056425578,55121066
1641836169,196256,true,3000104290,28,3045747320,45643030
1641836235,196254,true,3000704341,28,3042703247,41998906
1641836382,196251,true,3001604642,28,3035713421,34108779
1641836523,196254,true,3000704341,28,3029042526,28338185
1641836845,196257,true,2999804309,28,3014840137,15035828
1641836963,196255,true,3000404300,28,3012128138,11723838
1641837020,196251,true,3001604642,28,3010622525,9017883
1641837105,196252,true,3001304512,28,3008816784,7512272
1641837127,196253,true,3001004411,28,3008215111,7210700
1641837175,196251,true,3001604642,28,3007312827,5708185
1641837579,196246,true,3003105745,28,3004307167,1201422
1641837664,196247,true,3002805464,28,3004607598,1802134
1641837803,196247,true,3002805464,28,3006110202,3304738
1641837822,196245,true,3003406055,28,3006410813,3004758
1641837833,196241,true,3004607598,28,3006711454,2103856
1641838279,196241,true,3004607598,28,3012128138,7520540
1641838726,196240,true,3004908059,28,3016951159,12043100
1641839490,196237,true,3005809621,28,3017554579,11744958
1641839517,196233,true,3007012125,28,3017554579,10542454
1641839574,196232,true,3007312827,28,3018158120,10845293
1641839666,196230,true,3007914319,28,3019063658,11149339
1641840258,196227,true,3008816784,28,3026015148,17198364
1641840687,196223,true,3010020491,28,3029648364,19627873
1641840710,196222,true,3010321493,28,3029951329,19629836
1641841316,196219,true,3011224680,28,3038446656,27221976
1641841323,196216,true,3012128138,28,3038750501,26622363
1641841509,196211,true,3013634503,28,3039966183,26331680
1641841562,196210,true,3013935866,28,3040574207,26638341
1641843208,196206,true,3015141622,28,3044833779,29692157
1641844256,196204,true,3015744680,28,3044529326,28784646
1641844410,196198,true,3017554579,28,3043920511,26365932
1641844411,196197,true,3017856335,28,3043920511,26064176
1641844923,196195,true,3018459936,28,3040270180,21810244
1641845165,196193,true,3019063658,28,3038750501,19686843
1641845757,196190,true,3019969468,28,3034196019,14226551
1641846565,196190,true,3019969468,28,3030557350,10587882
1641846863,196189,true,3020271465,28,3030254324,9982859
1641847090,196188,true,3020573492,28,3030557350,9983858
1641847265,196185,true,3021479755,28,3031769754,10289999
1641847459,196186,true,3021177637,28,3033285943,12108306
1641847546,196184,true,3021781903,28,3034196019,12414116
1641847626,196182,true,3022386289,28,3035106369,12720080
1641847797,196178,true,3023595425,28,3037231581,13636156
1641847842,196179,true,3023293096,28,3037839058,14545962
1641847959,196178,true,3023595425,28,3039358281,15762856
1641848110,196176,true,3024200174,28,3041486470,17286296
1641848185,196172,true,3025410036,28,3043007518,17597482
1641848217,196175,true,3024502595,28,3043616150,19113555
1641848268,196173,true,3025107525,28,3044529326,19421801
1641848340,196170,true,3026015148,28,3046356500,20341352
1641848358,196166,true,3027225736,28,3046661136,19435400
1641848762,196167,true,3026923044,28,3057342597,30419553
1641848803,196165,true,3027528458,28,3058565718,31037260
1641848968,196161,true,3028739652,28,3062850494,34110842
1641848995,196157,true,3029951329,28,3063463095,33511766
1641849230,196157,true,3029951329,28,3068675151,38723822
1641850652,196155,true,3030557350,28,3083747803,53190453
1641851391,196151,true,3031769754,28,3083439459,51669705
1641851405,196146,true,3033285943,28,3083439459,50153516
1641851541,196147,true,3032982644,28,3083439459,50456815
1641851681,196145,true,3033589271,28,3083439459,49850188
1641852228,196141,true,3034802889,28,3082822864,48019975
1641852247,196136,true,3036320594,28,3082822864,46502270
1641852333,196138,true,3035713421,28,3082822864,47109443
1641852350,196136,true,3036320594,28,3082822864,46502270
1641852372,196132,true,3037535304,28,3082514612,44979308
1641852475,196128,true,3038750501,28,3081898202,43147701
1641852853,196130,true,3038142842,28,3079741736,41598894
1641854940,196129,true,3038446656,28,3074203464,35756808
1641854995,196126,true,3039358281,28,3074203464,34845183
1641855161,196122,true,3040574207,28,3073896074,33321867
1641855222,196124,true,3039966183,28,3073896074,33929891
1641856707,196124,true,3039966183,28,3067447987,27481804
1641857077,196121,true,3040878264,28,3066221315,25343051
1641857349,196117,true,3042094798,28,3066834590,24739792
1641857926,196119,true,3041486470,28,3067754732,26268262
1641858006,196118,true,3041790619,28,3068061508,26270889
1641858198,196114,true,3043007518,28,3068982018,25974500
1641858710,196110,true,3044224903,28,3072052382,27827479
1641859008,196111,true,3043920511,28,3073588715,29668204
1641859542,196109,true,3044529326,28,3075740873,31211547
1641860566,196105,true,3045747320,28,3077279051,31531731
1641861006,196101,true,3046965802,28,3076356052,29390250
1641862654,196102,true,3046661136,28,3072359587,25698451
1641862782,196101,true,3046965802,28,3071745207,24779405
1641863204,196098,true,3047879983,28,3070209795,22329812
1641864779,196095,true,3048794439,28,3064995133,16200694
1641864930,196097,true,3048184771,28,3065301632,17116861
1641865084,196096,true,3048489590,28,3066221315,17731725
1641865495,196094,true,3049099318,28,3068675151,19575833
1641866242,196092,true,3049709168,28,3073588715,23879547
1641866380,196094,true,3049099318,28,3074510884,25411566
1641867341,196094,true,3049099318,28,3079125880,30026562
1641867711,196092,true,3049709168,28,3081590043,31880875
1641867776,196090,true,3050319141,28,3082206392,31887251
1641867898,196093,true,3049404228,28,3084056178,34651950
1641867932,196091,true,3050014139,28,3084673020,34658881
1641867991,196089,true,3050624173,28,3085598514,34974341
1641868003,196086,true,3051539451,28,3085598514,34059063
1641868050,196088,true,3050929235,28,3086524287,35595052
1641868336,196085,true,3051844605,28,3091157315,39312710
1641868441,196082,true,3052760250,28,3093012473,40252223
1641868512,196079,true,3053676170,28,3094249864,40573694
1641868523,196078,true,3053981538,28,3094559289,40577751
1641868814,196075,true,3054897824,28,3099514299,44616475
1641869497,196072,true,3055814385,28,3111003169,55188784
1641871151,196069,true,3056731221,28,3115361405,58630184
1641873821,196067,true,3057342597,28,3115361405,58018808
1641874649,196064,true,3058259892,28,3115361405,57101513
1641874987,196060,true,3059483379,28,3115361405,55878026
1641875515,196057,true,3060401316,28,3115361405,54960089
1641876009,196054,true,3061319528,28,3115361405,54041877
1641877842,196050,true,3062544240,28,3115361405,52817165
1641878526,196046,true,3063769441,28,3115361405,51591964
1641883087,196042,true,3064995133,28,3111314269,46319136
1641884040,196040,true,3065608163,28,3111314269,45706106
1641884302,196035,true,3067141273,28,3111003169,43861896
1641885005,196032,true,3068061508,28,3109759079,41697571
1641885890,196029,true,3068982018,28,3108515486,39533468
1641885895,196027,true,3069595845,28,3108515486,38919641
1641887791,196025,true,3070209795,28,3109137220,38927425
1641887797,196021,true,3071438063,28,3109448134,38010071
1641887841,196019,true,3072052382,28,3109448134,37395752
1641888157,196017,true,3072666823,28,3112558982,39892159
1641888246,196013,true,3073896074,28,3113492843,39596769
1641888323,196009,true,3075125817,28,3114426984,39301167
1641889737,196006,true,3076048447,28,3134108822,58060375
1641889906,196003,true,3076971354,28,3134422233,57450879
1641889950,195999,true,3078202327,28,3134735676,56533349
1641890056,195995,true,3079433792,28,3134422233,54988441
1641890459,195993,true,3080049710,28,3131915824,51866114
1641891229,195991,true,3080665751,28,3123159162,42493411
1641892138,195988,true,3081590043,28,3115984509,34394466
1641892438,195986,true,3082206392,28,3114426984,32220592
1641892636,195984,true,3082822864,28,3114115572,31292708
1641893884,195982,true,3083439459,28,3109759079,26319620
1641894277,195980,true,3084056178,28,3110381061,26324883
1641894445,195978,true,3084673020,28,3111314269,26641249
1641894516,195976,true,3085289985,28,3111625401,26335416
1641894567,195974,true,3085907074,28,3111936563,26029489
1641896233,195971,true,3086832939,28,3123471478,36638539
1641896330,195969,true,3087450336,28,3123471478,36021142
1641896433,195967,true,3088067857,28,3123159162,35091305
1641896516,195965,true,3088685502,28,3122846877,34161375
1641896701,195962,true,3089612200,28,3122222402,32610202
1641896738,195959,true,3090539177,28,3122222402,31683225
1641896804,195957,true,3091157315,28,3121910211,30752896
1641896809,195955,true,3091775578,28,3121910211,30134633
1641897738,195952,true,3092703203,28,3117542813,24839610
1641898519,195949,true,3093631107,28,3113804192,20173085
1641898647,195948,true,3093940470,28,3113181524,19241054
1641898683,195946,true,3094559289,28,3112870237,18310948
1641899443,195944,true,3095178232,28,3106651029,11472797
1641899615,195942,true,3095797298,28,3105408679,9611381
1641899647,195942,true,3095797298,28,3105408679,9611381
1641899716,195941,true,3096106878,28,3105098170,8991292
1641900650,195938,true,3097035803,28,3101684610,4648807
1641900741,195937,true,3097345507,28,3101994778,4649271
1641900851,195936,true,3097655241,28,3102925470,5270229
1641902007,195935,true,3097965007,28,3108515486,10550479
1641902561,195932,true,3098894489,28,3110692100,11797611
1641902919,195932,true,3098894489,28,3110692100,11797611
1641902929,195931,true,3099204379,28,3111003169,11798790
1641903089,195931,true,3099204379,28,3111314269,12109890
1641903134,195929,true,3099824250,28,3111314269,11490019
1641903220,195928,true,3100134233,28,3111936563,11802330
1641903666,195927,true,3100444246,28,3114738427,14294181
1641904833,195926,true,3100754291,28,3124721054,23966763
1641905028,195924,true,3101374473,28,3125658564,24284091
1641906851,195923,true,3101684610,28,3126283727,24599117
1641908166,195922,true,3101994778,28,3125971130,23976352
1641908259,195921,true,3102304978,28,3125971130,23666152
1641908346,195919,true,3102925470,28,3125658564,22733094
1641908400,195918,true,3103235763,28,3125658564,22422801
1641908519,195917,true,3103546086,28,3125346030,21799944
1641910773,195917,true,3103546086,28,3116919398,13373312
1641910805,195915,true,3104166826,28,3117231090,13064264
1641910910,195913,true,3104787691,28,3117542813,12755122
1641911098,195912,true,3105098170,28,3117854567,12756397
1641911264,195912,true,3105098170,28,3117854567,12756397
1641911307,195910,true,3105719220,28,3117542813,11823593
1641911563,195909,true,3106029792,28,3115049900,9020108
1641911613,195909,true,3106029792,28,3114426984,8397192
1641911728,195909,true,3106029792,28,3112558982,6529190
1641911811,195906,true,3106961694,28,3111003169,4041475
1641912327,195907,true,3106651029,28,3102615208,-4035821
1641912657,195906,true,3106961694,28,3098584631,-8377063
1641912700,195906,true,3106961694,28,3097965007,-8996687
1641913241,195903,true,3107893876,28,3097035803,-10858073
1641913273,195903,true,3107893876,28,3097345507,-10548369
1641913441,195902,true,3108204665,28,3099824250,-8380415
1641913500,195902,true,3108204665,28,3101374473,-6830192
1641913556,195897,true,3109759079,28,3102925470,-6833609
1641914130,195896,true,3110070054,28,3121285922,11215868
1641914174,195894,true,3110692100,28,3122222402,11530302
1641914854,195894,true,3110692100,28,3135989758,25297658
1641914867,195889,true,3112247757,28,3135989758,23742001
1641914949,195888,true,3112558982,28,3137244342,24685360
1641914974,195886,true,3113181524,28,3137871822,24690298
1641915297,195886,true,3113181524,28,3140697037,27515513
1641915317,195881,true,3114738427,28,3140697037,25958610
1641915674,195880,true,3115049900,28,3138499428,23449528
1641915699,195879,true,3115361405,28,3138185609,22824204
1641916386,195880,true,3115049900,28,3130976437,15926537
1641916712,195876,true,3116296107,28,3128159966,11863859
1641916994,195875,true,3116607737,28,3126596355,9988618
1641917030,195874,true,3116919398,28,3126596355,9676957
1641917162,195875,true,3116607737,28,3127534428,10926691
1641917188,195871,true,3117854567,28,3127534428,9679861
1641917324,195869,true,3118478169,28,3129724359,11246190
1641917555,195868,true,3118790017,28,3134422233,15632216
1641917565,195868,true,3118790017,28,3134735676,15945659
1641917706,195864,true,3120037720,28,3138499428,18461708
1641917743,195863,true,3120349724,28,3139441072,19091348
1641917745,195861,true,3120973825,28,3139441072,18467247
1641918342,195861,true,3120973825,28,3159280989,38307164
1641918364,195856,true,3122534624,28,3160228868,37694244
1641918380,195855,true,3122846877,28,3160544891,37698014
1641918423,195853,true,3123471478,28,3162125479,38654001
1641918451,195853,true,3123471478,28,3163074212,39602734
1641918594,195848,true,3125033526,28,3167822146,42788620
1641918648,195847,true,3125346030,28,3169723314,44377284
1641918654,195845,true,3125971130,28,3170040287,44069157
1641919042,195843,true,3126596355,28,3184336896,57740541
1641919105,195838,true,3128159966,28,3185929383,57769417
1641919207,195836,true,3128785630,28,3188797867,60012237
1641919218,195834,true,3129411418,28,3189116747,59705329
1641919243,195832,true,3130037332,28,3190073578,60036246
1641919590,195826,true,3131915824,28,3199977654,68061830
1641920795,195823,true,3132855492,28,3221810558,88955066
1641920820,195821,true,3133482095,28,3222132739,88650644
1641920948,195819,true,3134108822,28,3223099476,88990654
1641921015,195813,true,3135989758,28,3223744128,87754370
1641921261,195809,true,3137244342,28,3227292020,90047678
1641921808,195806,true,3138185609,28,3236664281,98478672
1641921824,195803,true,3139127159,28,3236987948,97860789
1641921869,195799,true,3140382998,28,3236987948,96604950
1641922014,195796,true,3141325208,28,3236664281,95339073
1641922386,195796,true,3141325208,28,3234722962,93397754
1641922457,195794,true,3141953504,28,3234076115,92122611
1641922857,195790,true,3143210474,28,3231166901,87956427
1641922914,195786,true,3144467947,28,3230520764,86052817
1641923223,195786,true,3144467947,28,3226001426,81533479
1641923318,195783,true,3145411382,28,3224388909,78977527
1641924701,195778,true,3146984402,28,3225033819,78049417
1641924705,195774,true,3148243384,28,3225033819,76790435
1641925133,195773,true,3148558209,28,3226324026,77765817
1641925190,195770,true,3149502871,28,3226646658,77143787
1641925303,195764,true,3151393045,28,3227292020,75898975
1641925330,195761,true,3152338557,28,3227614749,75276192
1641925399,195759,true,3152969057,28,3227937510,74968453
1641926817,195755,true,3154230433,28,3241522678,87292245
1641927313,195751,true,3155492315,28,3243143763,87651448
1641927531,195747,true,3156754701,28,3242819481,86064780
1641928148,195746,true,3157070377,28,3240874470,83804093
1641928251,195742,true,3158333394,28,3240226393,81892999
1641929842,195738,true,3159596917,28,3229874757,70277840
1641930697,195734,true,3160860945,28,3229551802,68690857
1641930788,195733,true,3161177031,28,3229874757,68697726
1641931659,195730,true,3162125479,28,3233752739,71627260
1641931679,195725,true,3163706858,28,3233752739,70045881
1641933170,195721,true,3164972531,28,3237635378,72662847
1641934565,195719,true,3165605557,28,3238606765,73001208
1641940088,195715,true,3166871989,28,3238606765,71734776
1641940106,195710,true,3168455742,28,3238606765,70151023
1641940312,195705,true,3170040287,28,3238606765,68566478
1641941439,195704,true,3170357291,28,3237311646,66954355
1641943034,195700,true,3171625624,28,3236664281,65038657
1641944103,195695,true,3173211754,28,3237635378,64423624
1641944324,195690,true,3174798677,28,3237959141,63160464
1641945858,195689,true,3175116157,28,3238606765,63490608
1641945938,195685,true,3176386394,28,3239254519,62868125
1641947384,195680,true,3177974905,28,3248986387,71011482
1641947775,195675,true,3179564210,28,3250611205,71046995
1641948037,195673,true,3180200155,28,3250286176,70086021
1641948227,195670,true,3181154310,28,3249311285,68156975
1641948385,195665,true,3182745206,28,3248336687,65591481
1641948480,195661,true,3184018495,28,3247362381,63343886
1641948773,195660,true,3184336896,28,3245414645,61077749
1641953760,195657,true,3185292293,28,3236664281,51371988
1641955565,195652,true,3186885258,28,3236664281,49779023
1641955668,195648,true,3188160203,28,3236664281,48504078
1641955737,195647,true,3188479019,28,3236340647,47861628
1641955978,195645,true,3189116747,28,3235046434,45929687
1641956723,195641,true,3190392585,28,3230520764,40128179
1641958417,195637,true,3191668933,28,3226001426,34332493
1641958425,195636,true,3191988100,28,3226324026,34335926
1641958555,195633,true,3192945792,28,3226324026,33378234
1641958638,195628,true,3194542585,28,3226324026,31781441
1641958649,195624,true,3195820593,28,3226324026,30503433
1641959377,195623,true,3196140175,28,3227937510,31797335
1641960519,195620,true,3197099113,28,3229551802,32452689
1641960714,195616,true,3198378145,28,3229874757,31496612
1641964529,195611,true,3199977654,28,3232459562,32481908
1641968883,195609,true,3200617681,28,3232782808,32165127
1641969009,195605,true,3201898120,28,3232782808,30884688
1641969017,195600,true,3203499390,28,3233106086,29606696
1641969081,195594,true,3205421970,28,3233106086,27684116
1641969145,195592,true,3206063086,28,3233752739,27689653
1641969151,195588,true,3207345704,28,3233752739,26407035
1641970238,195583,true,3208949698,28,3243792424,34842726
1641970380,195578,true,3210554493,28,3245090136,34535643
1641970442,195577,true,3210875549,28,3245739186,34863637
1641971062,195573,true,3212160092,28,3247362381,35202289
1641971088,195570,true,3213123836,28,3247362381,34238545
1641971435,195566,true,3214409278,28,3245739186,31329908
1641971447,195566,true,3214409278,28,3245739186,31329908
1641971553,195562,true,3215695235,28,3245090136,29394901
1641971596,195559,true,3216660040,28,3244765659,28105619
1641971858,195556,true,3217625135,28,3242171015,24545880
1641971925,195555,true,3217946897,28,3241522678,23575781
1641972079,195551,true,3219234269,28,3239254519,20020250
1641972702,195549,true,3219878148,28,3230197745,10319597
1641973261,195546,true,3220844208,28,3222777198,1932990
1641974502,195545,true,3221166292,28,3218268692,-2897600
1641974575,195541,true,3222454952,28,3218268692,-4186260
1641975182,195539,true,3223099476,28,3218268692,-4830784
1641975302,195536,true,3224066502,28,3218268692,-5797810
1641975402,195535,true,3224388909,28,3218590519,-5798390
1641975728,195531,true,3225678858,28,3219234269,-6444589
1641976069,195529,true,3226324026,28,3220844208,-5479818
1641977486,195527,true,3226969323,28,3225678858,-1290465
1641978106,195527,true,3226969323,28,3227614749,645426
1641978155,195524,true,3227937510,28,3227614749,-322761
1641978190,195522,true,3228583130,28,3227614749,-968381
1641978273,195520,true,3229228879,28,3228260304,-968575
1641978298,195520,true,3229228879,28,3228260304,-968575
1641978711,195517,true,3230197745,28,3230843817,646072
1641979200,195516,true,3230520764,28,3234722962,4202198
1641979216,195514,true,3231166901,28,3234722962,3556061
1641979468,195514,true,3231166901,28,3237311646,6144745
1641979875,195510,true,3232459562,28,3243468078,11008516
1641980057,195508,true,3233106086,28,3246388367,13282281
1641980583,195506,true,3233752739,28,3252887315,19134576
1641980768,195506,true,3233752739,28,3255165020,21412281
1641980773,195504,true,3234399522,28,3255165020,20765498
1641982171,195503,true,3234722962,28,3257118607,22395645
1641982935,195501,true,3235369939,28,3258747492,23377553
1641983734,195501,true,3235369939,28,3261029300,25659361
1641983927,195499,true,3236017045,28,3261681538,25664493
1641984104,195498,true,3236340647,28,3261681538,25340891
1641984150,195497,true,3236664281,28,3261681538,25017257
1641984343,195496,true,3236987948,28,3261355403,24367455
1641984386,195495,true,3237311646,28,3261355403,24043757
1641985310,195494,true,3237635378,28,3259725214,22089836
1641987076,195495,true,3237311646,28,3258095840,20784194
1641987227,195495,true,3237311646,28,3257770063,20458417
1641987279,195494,true,3237635378,28,3257770063,20134685
1641987565,195493,true,3237959141,28,3257444319,19485178
1641987586,195493,true,3237959141,28,3257444319,19485178
1641987676,195491,true,3238606765,28,3257770063,19163298
1641989328,195488,true,3239578445,28,3274753738,35175293
1641989350,195487,true,3239902402,28,3274753738,34851336
1641989882,195487,true,3239902402,28,3276391442,36489040
1641990011,195484,true,3240874470,28,3277046753,36172283
1641990061,195481,true,3241846830,28,3277374458,35527628
1641990146,195481,true,3241846830,28,3277702195,35855365
1641990283,195480,true,3242171015,28,3279013473,36842458
1641990756,195477,true,3243143763,28,3283278749,40134986
1641990862,195474,true,3244116804,28,3284920717,40803913
1641990914,195474,true,3244116804,28,3285577734,41460930
1641991493,195472,true,3244765659,28,3297426536,52660877
1641991728,195469,true,3245739186,28,3301385625,55646439
1641991962,195466,true,3246713006,28,3304358061,57645055
1641993874,195467,true,3246388367,28,3308656305,62267938
1641994189,195465,true,3247037677,28,3308656305,61618628
1641994196,195462,true,3248011886,28,3308987170,60975284
1641994213,195459,true,3248986387,28,3308987170,60000783
1641994310,195457,true,3249636216,28,3310641995,61005779
1641994577,195453,true,3250936266,28,3315279907,64343641
1641994706,195450,true,3251911644,28,3317601300,65689656
1641994753,195447,true,3252887315,28,3318928539,66041224
1641994964,195445,true,3253537925,28,3324242810,70704885
1641995119,195441,true,3254839536,28,3328234096,73394560
1641995421,195437,true,3256141667,28,3336898330,80756663
1641995683,195434,true,3257118607,28,3344581644,87463037
1641996202,195432,true,3257770063,28,3357650327,99880264
1641996969,195427,true,3259399274,28,3363362901,103963627
1641997029,195423,true,3260703229,28,3363362901,102659672
1641997704,195420,true,3261681538,28,3364035607,102354069
1641998441,195418,true,3262333907,28,3364035607,101701700
1641998454,195414,true,3263639036,28,3364372011,100732975
1641999120,195410,true,3264944688,28,3365717961,100773273
1642000446,195406,true,3266250862,28,3372118584,105867722
1642000658,195404,true,3266904145,28,3373467634,106563489
1642001652,195400,true,3268211102,28,3376167353,107956251
1642001663,195396,true,3269518583,28,3375829770,106311187
1642001970,195392,true,3270826586,28,3375492220,104665634
1642002142,195390,true,3271480784,28,3375154705,103673921
1642002840,195386,true,3272789573,28,3371107151,98317578
1642002944,195382,true,3274098885,28,3370433030,96334145
1642003652,195378,true,3275408721,28,3366727778,91319057
1642003693,195376,true,3276063836,28,3366391138,90327302
1642003749,195372,true,3277374458,28,3366391138,89016680
1642004120,195368,true,3278685604,28,3365044919,86359315
1642004187,195364,true,3279997275,28,3365044919,85047644
1642004239,195362,true,3280653307,28,3364708448,84055141
1642005024,195358,true,3281965766,28,3358657722,76691956
1642005140,195355,true,3282950454,28,3357650327,74699873
1642005237,195351,true,3284263831,28,3357314595,73050764
1642005491,195348,true,3285249209,28,3355636441,70387232
1642006050,195344,true,3286563506,28,3354965415,68401909
1642006089,195341,true,3287549573,28,3354965415,67415842
1642006352,195337,true,3288864790,28,3356307602,67442812
1642006578,195334,true,3289851548,28,3357314595,67463047
1642006799,195330,true,3291167686,28,3358321890,67154204
1642007961,195327,true,3292155135,28,3361009488,68854353
1642008087,195323,true,3293472195,28,3361345589,67873394
1642008127,195320,true,3294460336,28,3361681724,67221388
1642008178,195316,true,3295778317,28,3361681724,65903407
1642008684,195313,true,3296767150,28,3363699237,66932087
1642008967,195309,true,3298086054,28,3365381423,67295369
1642009724,195306,true,3299075579,28,3372455796,73380217
1642011451,195303,true,3300065401,28,3377855774,77790373
1642011920,195299,true,3301385625,28,3376167353,74781728
1642011998,195295,true,3302706377,28,3376167353,73460976
1642012105,195292,true,3303697288,28,3376167353,72470065
1642012127,195288,true,3305018965,28,3376167353,71148388
1642013018,195284,true,3306341171,28,3377855774,71514603
1642013417,195280,true,3307663906,28,3379207119,71543213
1642013459,195277,true,3308656305,28,3379545040,70888735
1642014330,195273,true,3309979966,28,3379882994,69903028
1642014481,195268,true,3311635287,28,3379545040,67909753
1642014572,195264,true,3312960140,28,3379207119,66246979
1642015262,195260,true,3314285522,28,3377180304,62894782
1642020651,195256,true,3315611435,28,3375829770,60218335
1642020937,195251,true,3317269573,28,3376842620,59573047
1642021014,195247,true,3318596680,28,3376842620,58245940
1642021404,195243,true,3319924317,28,3378869232,58944915
1642022651,195238,true,3321584612,28,3383941085,62356473
1642022681,195233,true,3323245736,28,3384279479,61033743
1642022693,195229,true,3324575234,28,3384279479,59704245
1642022819,195226,true,3325572706,28,3385294865,59722159
1642023092,195219,true,3327901306,28,3387326549,59425243
1642023127,195215,true,3329232666,28,3387665282,58432616
1642023379,195211,true,3330564559,28,3388004049,57439490
1642023425,195208,true,3331563828,28,3388004049,56440221
1642023437,195203,true,3333229943,28,3388004049,54774106
1642023696,195199,true,3334563435,28,3387665282,53101847
1642023812,195196,true,3335563904,28,3387665282,52101378
1642023860,195192,true,3336898330,28,3387665282,50766952
1642024437,195187,true,3338567113,28,3386310555,47743442
1642025363,195184,true,3339568783,28,3379882994,40314211
1642025439,195181,true,3340570754,28,3379545040,38974286
1642027118,195179,true,3341238901,28,3377855774,36616873
1642028755,195174,true,3342909855,28,3377180304,34270449
1642032264,195171,true,3343912828,28,3368748319,24835491
1642033493,195169,true,3344581644,28,3373130321,28548677
1642034798,195167,true,3345250594,28,3374817223,29566629
1642035032,195162,true,3346923554,28,3374142361,27218807
1642037532,195160,true,3347592972,28,3354294522,6701550
1642037707,195158,true,3348262524,28,3354294522,6031998
1642037750,195156,true,3348932210,28,3354294522,5362312
1642037798,195152,true,3350271984,28,3353959126,3687142
1642037912,195151,true,3350607011,28,3352953140,2346129
1642038527,195150,true,3350942072,28,3347258246,-3683826
1642043396,195148,true,3351612294,28,3337232020,-14380274
1642043496,195144,true,3352953140,28,3337232020,-15721120
1642043499,195142,true,3353623764,28,3337232020,-16391744
1642043565,195141,true,3353959126,28,3336898330,-17060796
1642043696,195140,true,3354294522,28,3335897460,-18397062
1642043737,195136,true,3355636441,28,3335563904,-20072537
1642044845,195135,true,3355972005,28,3324242810,-31729195
1642046788,195135,true,3355972005,28,3333229943,-22742062
1642046889,195134,true,3356307602,28,3333563266,-22744336
1642047334,195130,true,3357650327,28,3334230012,-23420315
1642047404,195129,true,3357986092,28,3334230012,-23756080
1642047435,195129,true,3357986092,28,3334563435,-23422657
1642049340,195128,true,3358321890,28,3343244146,-15077744
1642050471,195124,true,3359665420,28,3343244146,-16421274
1642050487,195124,true,3359665420,28,3343244146,-16421274
1642050738,195123,true,3360001387,28,3343244146,-16757241
1642050900,195123,true,3360001387,28,3342575597,-17425790
1642052856,195121,true,3360673421,28,3333563266,-27110155
1642053804,195121,true,3360673421,28,3333563266,-27110155
1642054869,195121,true,3360673421,28,3333563266,-27110155
1642055358,195120,true,3361009488,28,3333563266,-27446222
1642055600,195118,true,3361681724,28,3333563266,-28118458
1642055739,195118,true,3361681724,28,3333563266,-28118458
1642055921,195118,true,3361681724,28,3333896622,-27785102
1642055924,195118,true,3361681724,28,3333896622,-27785102
1642055964,195119,true,3361345589,28,3333896622,-27448967
1642058537,195119,true,3361345589,28,3335563904,-25781685
1642058591,195119,true,3361345589,28,3335897460,-25448129
1642059009,195119,true,3361345589,28,3336231050,-25114539
1642059057,195120,true,3361009488,28,3336231050,-24778438
1642059983,195121,true,3360673421,28,3338233289,-22440132
1642061196,195121,true,3360673421,28,3338900969,-21772452
1642061702,195122,true,3360337387,28,3338900969,-21436418
1642061741,195123,true,3360001387,28,3339234859,-20766528
1642062723,195123,true,3360001387,28,3341238901,-18762486
1642062853,195124,true,3359665420,28,3341238901,-18426519
1642062944,195124,true,3359665420,28,3341573025,-18092395
1642064377,195125,true,3359329487,28,3345250594,-14078893
1642066047,195125,true,3359329487,28,3348262524,-11066963
1642066068,195126,true,3358993588,28,3348262524,-10731064
1642066194,195127,true,3358657722,28,3349267103,-9390619
1642066275,195128,true,3358321890,28,3349602030,-8719860
1642066293,195127,true,3358657722,28,3349602030,-9055692
1642066304,195128,true,3358321890,28,3349936990,-8384900
1642069028,195128,true,3358321890,28,3362690329,4368439
1642069076,195128,true,3358321890,28,3363026598,4704708
1642069287,195128,true,3358321890,28,3363362901,5041011
1642069738,195128,true,3358321890,28,3364708448,6386558
1642070908,195128,true,3358321890,28,3367737897,9416007
1642071632,195128,true,3358321890,28,3367737897,9416007
1642071665,195127,true,3358657722,28,3367737897,9080175
1642071894,195128,true,3358321890,28,3367401157,9079267
1642072284,195127,true,3358657722,28,3366054533,7396811
1642072329,195127,true,3358657722,28,3366054533,7396811
1642072374,195126,true,3358993588,28,3365717961,6724373
1642072391,195127,true,3358657722,28,3365717961,7060239
1642072455,195127,true,3358657722,28,3365044919,6387197
1642072600,195127,true,3358657722,28,3364035607,5377885
1642073129,195127,true,3358657722,28,3358321890,-335832
1642075650,195128,true,3358321890,28,3341573025,-16748865
1642075734,195129,true,3357986092,28,3341573025,-16413067
1642077159,195129,true,3357986092,28,3344247219,-13738873
1642077338,195129,true,3357986092,28,3344247219,-13738873
1642077356,195130,true,3357650327,28,3344247219,-13403108
1642077576,195131,true,3357314595,28,3344916102,-12398493
1642077642,195131,true,3357314595,28,3345250594,-12064001
1642078427,195131,true,3357314595,28,3349267103,-8047492
1642078648,195132,true,3356978897,28,3350271984,-6706913
1642078673,195133,true,3356643233,28,3350607011,-6036222
1642078769,195133,true,3356643233,28,3351277166,-5366067
1642078852,195133,true,3356643233,28,3351612294,-5030939
1642079336,195134,true,3356307602,28,3355300911,-1006691
1642080741,195135,true,3355972005,28,3358321890,2349885
1642080808,195135,true,3355972005,28,3358657722,2685717
1642081389,195135,true,3355972005,28,3362017892,6045887
1642082348,195136,true,3355636441,28,3367401157,11764716
1642083526,195136,true,3355636441,28,3368411478,12775037
1642084107,195136,true,3355636441,28,3372118584,16482143
1642084112,195136,true,3355636441,28,3372118584,16482143
1642084344,195136,true,3355636441,28,3373804981,18168540
1642084375,195136,true,3355636441,28,3374142361,18505920
1642084495,195135,true,3355972005,28,3375154705,19182700
1642084688,195135,true,3355972005,28,3377180304,21208299
1642084694,195135,true,3355972005,28,3377180304,21208299
1642084708,195135,true,3355972005,28,3377518022,21546017
1642084709,195135,true,3355972005,28,3377518022,21546017
1642084783,195134,true,3356307602,28,3378531379,22223777
1642085131,195134,true,3356307602,28,3384279479,27971877
1642085154,195133,true,3356643233,28,3384617907,27974674
1642085225,195135,true,3355972005,28,3385294865,29322860
1642085358,195134,true,3356307602,28,3386310555,30002953
1642086768,195135,true,3355972005,28,3382926106,26954101
1642086838,195134,true,3356307602,28,3381911431,25603829
1642086865,195135,true,3355972005,28,3381573274,25601269
1642086909,195135,true,3355972005,28,3380559005,24587000
1642087016,195137,true,3355300911,28,3378531379,23230468
1642087058,195137,true,3355300911,28,3377855774,22554863
1642087215,195138,true,3354965415,28,3374479775,19514360
1642087292,195138,true,3354965415,28,3372793041,17827626
1642087359,195141,true,3353959126,28,3371107151,17148025
1642087373,195141,true,3353959126,28,3370770074,16810948
1642087462,195143,true,3353288435,28,3368411478,15123043
1642087574,195142,true,3353623764,28,3365044919,11421155
1642087588,195145,true,3352617878,28,3364708448,12090570
1642087604,195145,true,3352617878,28,3364372011,11754133
1642087762,195148,true,3351612294,28,3358657722,7045428
1642087896,195147,true,3351947455,28,3353623764,1676309
1642087962,195150,true,3350942072,28,3351277166,335094
1642088155,195150,true,3350942072,28,3342909855,-8032217
1642088231,195153,true,3349936990,28,3339568783,-10368207
1642088571,195152,true,3350271984,28,3324575234,-25696750
1642089031,195154,true,3349602030,28,3310641995,-38960035
1642089051,195154,true,3349602030,28,3309979966,-39622064
1642089130,195157,true,3348597350,28,3307994673,-40602677
1642089136,195156,true,3348932210,28,3307994673,-40937537
1642089456,195160,true,3347592972,28,3300725447,-46867525
1642089580,195158,true,3348262524,28,3299075579,-49186945
1642090077,195161,true,3347258246,28,3296437506,-50820740
1642090117,195159,true,3347927731,28,3296437506,-51490225
1642090159,195163,true,3346588895,28,3296107895,-50481000
1642090181,195162,true,3346923554,28,3296437506,-50486048
1642090185,195164,true,3346254269,28,3296437506,-49816763
1642090398,195162,true,3346923554,28,3297096826,-49826728
1642090502,195166,true,3345585119,28,3297426536,-48158583
1642090651,195166,true,3345585119,28,3297426536,-48158583
1642091092,195168,true,3344916102,28,3298745705,-46170397
1642092051,195167,true,3345250594,28,3302706377,-42544217
1642092203,195170,true,3344247219,28,3302376140,-41871079
1642092217,195170,true,3344247219,28,3302376140,-41871079
1642093004,195171,true,3343912828,28,3306010570,-37902258
1642093654,195170,true,3344247219,28,3307002473,-37244746
1642093782,195173,true,3343244146,28,3307002473,-36241673
1642093957,195173,true,3343244146,28,3307002473,-36241673
1642094015,195175,true,3342575597,28,3307002473,-35573124
1642094051,195173,true,3343244146,28,3306671805,-36572341
1642094088,195177,true,3341907182,28,3306341171,-35566011
1642094170,195177,true,3341907182,28,3305349467,-36557715
1642094215,195179,true,3341238901,28,3305018965,-36219936
1642094236,195178,true,3341573025,28,3304688497,-36884528
1642094380,195183,true,3339902740,28,3302045935,-37856805
1642094555,195184,true,3339568783,28,3298086054,-41482729
1642095256,195186,true,3338900969,28,3283607077,-55293892
1642097193,195185,true,3339234859,28,3277702195,-61532664
1642097226,195189,true,3337899499,28,3278029965,-59869534
1642097420,195191,true,3337232020,28,3278357768,-58874252
1642097443,195193,true,3336564673,28,3278357768,-58206905
1642097600,195191,true,3337232020,28,3279013473,-58218547
1642097752,195196,true,3335563904,28,3279341374,-56222530
1642097937,195197,true,3335230381,28,3279997275,-55233106
1642098107,195199,true,3334563435,28,3280653307,-53910128
1642100018,195197,true,3335230381,28,3287220851,-48009530
1642100073,195202,true,3333563266,28,3287220851,-46342415
1642100114,195203,true,3333229943,28,3287220851,-46009092
1642100141,195206,true,3332230174,28,3287220851,-45009323
1642101068,195206,true,3332230174,28,3282950454,-49279720
1642101736,195211,true,3330564559,28,3279997275,-50567284
1642102701,195213,true,3329898546,28,3277702195,-52196351
1642102802,195215,true,3329232666,28,3277046753,-52185913
1642102875,195215,true,3329232666,28,3276719081,-52513585
1642102937,195220,true,3327568549,28,3276063836,-51504713
1642103773,195224,true,3326237854,28,3268537923,-57699931
1642103990,195227,true,3325240182,28,3266904145,-58336037
1642104323,195226,true,3325572706,28,3264291797,-61280909
1642104350,195232,true,3323578061,28,3263965400,-59612661
1642104437,195235,true,3322581187,28,3262986407,-59594780
1642104457,195238,true,3321584612,28,3262660141,-58924471
1642104461,195238,true,3321584612,28,3262660141,-58924471
1642104496,195244,true,3319592358,28,3262333907,-57258451
1642104518,195247,true,3318596680,28,3262007706,-56588974
1642104724,195249,true,3317933060,28,3259725214,-58207846
1642104742,195249,true,3317933060,28,3259399274,-58533786
1642105533,195254,true,3316274591,28,3251911644,-64362947
1642105805,195257,true,3315279907,28,3249961180,-65318727
1642105868,195260,true,3314285522,28,3249311285,-64974237
1642106588,195259,true,3314616951,28,3248661520,-65955431
1642107600,195264,true,3312960140,28,3254188665,-58771475
1642107612,195267,true,3311966450,28,3254514084,-57452366
1642107829,195269,true,3311304156,28,3255816085,-55488071
1642108506,195269,true,3311304156,28,3259399274,-51904882
1642108797,195274,true,3309649001,28,3260703229,-48945772
1642108800,195277,true,3308656305,28,3260703229,-47953076
1642108824,195279,true,3307994673,28,3260703229,-47291444
1642110491,195279,true,3307994673,28,3264618226,-43376447
1642111190,195284,true,3306341171,28,3264944688,-41396483
1642111303,195287,true,3305349467,28,3264944688,-40404779
1642113604,195289,true,3304688497,28,3265597709,-39090788
1642113693,195289,true,3304688497,28,3265597709,-39090788
1642113756,195294,true,3303036648,28,3265597709,-37438939
1642113807,195298,true,3301715764,28,3265597709,-36118055
1642114038,195301,true,3300725447,28,3265271182,-35454265
1642114595,195301,true,3300725447,28,3262660141,-38065306
1642114613,195307,true,3298745705,28,3262660141,-36085564
1642114895,195311,true,3297426536,28,3261355403,-36071133
1642114917,195314,true,3296437506,28,3261029300,-35408206
1642115830,195315,true,3296107895,28,3256467281,-39640614
1642116724,195321,true,3294130922,28,3255490536,-38640386
1642118181,195325,true,3292813599,28,3255490536,-37323063
1642118286,195328,true,3291825953,28,3255165020,-36660933
1642118541,195330,true,3291167686,28,3253863279,-37304407
1642119307,195336,true,3289193677,28,3247037677,-42156000
1642119487,195342,true,3287220851,28,3245739186,-41481665
1642120546,195345,true,3286234882,28,3244441215,-41793667
1642120849,195346,true,3285906291,28,3246713006,-39193285
1642121173,195351,true,3284263831,28,3248986387,-35277444
1642121615,195356,true,3282622192,28,3250936266,-31685926
1642128189,195358,true,3281965766,28,3260051187,-21914579
1642128698,195359,true,3281637602,28,3261029300,-20608302
1642128726,195362,true,3280653307,28,3261029300,-19624007
1642129033,195367,true,3279013473,28,3261681538,-17331935
1642131572,195367,true,3279013473,28,3264618226,-14395247
1642133250,195368,true,3278685604,28,3264618226,-14067378
1642133281,195370,true,3278029965,28,3264944688,-13085277
1642133521,195375,true,3276391442,28,3265271182,-11120260
1642134914,195374,true,3276719081,28,3272462327,-4256754
1642135696,195375,true,3276391442,28,3273771508,-2619934
1642137551,195377,true,3275736262,28,3273771508,-1964754
1642137993,195381,true,3274426295,28,3273771508,-654787
1642138123,195380,true,3274753738,28,3274426295,-327443
1642138182,195379,true,3275081213,28,3274426295,-654918
1642139388,195381,true,3274426295,28,3278029965,3603670
1642139407,195384,true,3273444164,28,3278029965,4585801
1642139506,195383,true,3273771508,28,3278685604,4914096
1642139642,195382,true,3274098885,28,3279997275,5898390
1642139980,195382,true,3274098885,28,3283278749,9179864
1642141163,195385,true,3273116852,28,3293472195,20355343
1642141432,195383,true,3273771508,28,3295778317,22006809
1642143672,195382,true,3274098885,28,3302376140,28277255
1642143780,195381,true,3274426295,28,3302376140,27949845
1642144384,195384,true,3273444164,28,3301715764,28271600
1642145562,195382,true,3274098885,28,3300065401,25966516
1642145725,195381,true,3274426295,28,3299405487,24979192
1642145810,195380,true,3274753738,28,3299075579,24321841
1642145837,195384,true,3273444164,28,3299075579,25631415
1642146310,195384,true,3273444164,28,3294460336,21016172
1642147085,195384,true,3273444164,28,3285906291,12462127
1642147258,195383,true,3273771508,28,3283607077,9835569
1642147335,195386,true,3272789573,28,3282622192,9832619
1642147354,195386,true,3272789573,28,3282293962,9504389
1642147517,195387,true,3272462327,28,3279997275,7534948
1642147535,195386,true,3272789573,28,3279997275,7207702
1642147587,195390,true,3271480784,28,3279013473,7532689
1642147677,195391,true,3271153669,28,3277702195,6548526
1642147813,195392,true,3270826586,28,3276063836,5237250
1642147931,195391,true,3271153669,28,3274426295,3272626
1642148199,195395,true,3269845535,28,3270826586,981051
1642148587,195396,true,3269518583,28,3265271182,-4247401
1642151532,195397,true,3269191664,28,3254188665,-15002999
1642152073,195396,true,3269518583,28,3254514084,-15004499
1642152208,195399,true,3268537923,28,3254839536,-13698387
1642152749,195400,true,3268211102,28,3255490536,-12720566
1642153156,195401,true,3267884314,28,3256467281,-11417033
1642153279,195399,true,3268537923,28,3257118607,-11419316
1642153825,195401,true,3267884314,28,3259073367,-8810947
1642156151,195401,true,3267884314,28,3262986407,-4897907
1642156183,195402,true,3267557558,28,3262986407,-4571151
1642156200,195401,true,3267884314,28,3262986407,-4897907
1642156679,195403,true,3267230835,28,3262660141,-4570694
1642157605,195403,true,3267230835,28,3261355403,-5875432
1642157621,195404,true,3266904145,28,3261355403,-5548742
1642157647,195403,true,3267230835,28,3261029300,-6201535
1642157748,195405,true,3266577487,28,3259725214,-6852273
1642157768,195407,true,3265924269,28,3259725214,-6199055
1642157829,195409,true,3265271182,28,3258747492,-6523690
1642157852,195408,true,3265597709,28,3258421650,-7176059
1642157864,195411,true,3264618226,28,3258095840,-6522386
1642157910,195413,true,3263965400,28,3257444319,-6521081
1642158111,195415,true,3263312705,28,3253863279,-9449426
1642158155,195414,true,3263639036,28,3253212604,-10426432
1642158171,195416,true,3262986407,28,3252887315,-10099092
1642158207,195418,true,3262333907,28,3252236835,-10097072
1642158363,195420,true,3261681538,28,3248986387,-12695151
1642158434,195419,true,3262007706,28,3247687117,-14320589
1642158533,195420,true,3261681538,28,3245414645,-16266893
1642159210,195423,true,3260703229,28,3229228879,-31474350
1642159307,195425,true,3260051187,28,3226969323,-33081864
1642159432,195424,true,3260377192,28,3224066502,-36310690
1642159539,195425,true,3260051187,28,3222454952,-37596235
1642159771,195428,true,3259073367,28,3219234269,-39839098
1642160729,195430,true,3258421650,28,3210875549,-47546101
1642160758,195429,true,3258747492,28,3210554493,-48192999
1642161444,195430,true,3258421650,28,3204780982,-53640668
1642161511,195433,true,3257444319,28,3204460536,-52983783
1642162383,195435,true,3256792928,28,3201898120,-54894808
1642162673,195434,true,3257118607,28,3201577963,-55540644
1642163213,195435,true,3256792928,28,3204460536,-52332392
1642163426,195437,true,3256141667,28,3206063086,-50078581
1642163562,195440,true,3255165020,28,3206704331,-48460689
1642163684,195438,true,3255816085,28,3207666439,-48149646
1642163785,195439,true,3255490536,28,3208308004,-47182532
1642163844,195442,true,3254514084,28,3208628835,-45885249
1642164013,195444,true,3253863279,28,3210233470,-43629809
1642164305,195443,true,3254188665,28,3213123836,-41064829
1642165140,195444,true,3253863279,28,3220844208,-33019071
1642165148,195446,true,3253212604,28,3220844208,-32368396
1642165263,195449,true,3252236835,28,3221166292,-31070543
1642165364,195448,true,3252562059,28,3221488409,-31073650
1642166044,195449,true,3252236835,28,3221166292,-31070543
1642166131,195452,true,3251261359,28,3220844208,-30417151
1642166177,195454,true,3250611205,28,3220522156,-30089049
1642166473,195453,true,3250936266,28,3219556192,-31380074
1642167223,195454,true,3250611205,28,3218590519,-32020686
1642167990,195456,true,3249961180,28,3221488409,-28472771
1642168262,195458,true,3249311285,28,3222132739,-27178546
1642168282,195457,true,3249636216,28,3222132739,-27503477
1642168513,195458,true,3249311285,28,3221810558,-27500727
1642169725,195460,true,3248661520,28,3218268692,-30392828
1642169748,195463,true,3247687117,28,3218268692,-29418425
1642169861,195461,true,3248336687,28,3218268692,-30067995
1642170556,195462,true,3248011886,28,3219556192,-28455694
1642170908,195464,true,3247362381,28,3220200136,-27162245
1642170977,195466,true,3246713006,28,3220200136,-26512870
1642171062,195464,true,3247362381,28,3220200136,-27162245
1642171074,195465,true,3247037677,28,3220200136,-26837541
1642171093,195467,true,3246388367,28,3220522156,-25866211
1642171240,195468,true,3246063760,28,3221810558,-24253202
1642171249,195466,true,3246713006,28,3221810558,-24902448
1642171572,195466,true,3246713006,28,3226001426,-20711580
1642171602,195469,true,3245739186,28,3226324026,-19415160
1642171639,195470,true,3245414645,28,3226969323,-18445322
1642172116,195467,true,3246388367,28,3235693476,-10694891
1642172293,195466,true,3246713006,28,3239902402,-6810604
1642172306,195470,true,3245414645,28,3240226393,-5188252
1642172333,195471,true,3245090136,28,3240874470,-4215666
1642172335,195467,true,3246388367,28,3240874470,-5513897
1642172817,195466,true,3246713006,28,3254839536,8126530
1642172873,195470,true,3245414645,28,3256792928,11378283
1642173132,195471,true,3245090136,28,3262660141,17570005
1642173548,195467,true,3246388367,28,3270172519,23784152
1642173574,195465,true,3247037677,28,3270499536,23461859
1642173593,195469,true,3245739186,28,3270826586,25087400
1642174679,195470,true,3245414645,28,3283935437,38520792
1642174844,195466,true,3246713006,28,3284592257,37879251
1642176524,195465,true,3247037677,28,3281637602,34599925
1642176853,195469,true,3245739186,28,3280653307,34914121
1642176901,195470,true,3245414645,28,3280653307,35238662
1642176923,195467,true,3246388367,28,3280325275,33936908
1642176961,195467,true,3246388367,28,3280325275,33936908
1642177944,195471,true,3245090136,28,3275081213,29991077
1642178297,195472,true,3244765659,28,3274098885,29333226
1642178391,195470,true,3245414645,28,3274426295,29011650
1642178747,195469,true,3245739186,28,3275408721,29669535
1642179201,195474,true,3244116804,28,3277702195,33585391
1642179365,195474,true,3244116804,28,3279013473,34896669
1642179678,195472,true,3244765659,28,3281309471,36543812
1642179688,195471,true,3245090136,28,3281637602,36547466
1642180378,195473,true,3244441215,28,3288207116,43765901
1642180455,195473,true,3244441215,28,3288535937,44094722
1642180506,195470,true,3245414645,28,3289193677,43779032
1642180719,195469,true,3245739186,28,3290838603,45099417
1642180727,195471,true,3245090136,28,3290838603,45748467
1642181038,195471,true,3245090136,28,3293472195,48382059
1642181960,195467,true,3246388367,28,3297096826,50708459
1642182009,195466,true,3246713006,28,3297096826,50383820
1642182238,195468,true,3246063760,28,3296767150,50703390
1642182568,195467,true,3246388367,28,3296437506,50049139
1642183013,195464,true,3247362381,28,3294789782,47427401
1642183782,195463,true,3247687117,28,3290180534,42493417
1642184568,195465,true,3247037677,28,3287220851,40183174
1642184843,195463,true,3247687117,28,3286563506,38876389
1642184849,195460,true,3248661520,28,3286563506,37901986
1642184963,195459,true,3248986387,28,3286563506,37577119
1642185554,195461,true,3248336687,28,3286234882,37898195
1642186652,195460,true,3248661520,28,3285249209,36587689
1642186906,195457,true,3249636216,28,3285249209,35612993
1642187428,195457,true,3249636216,28,3286563506,36927290
1642187642,195459,true,3248986387,28,3286892162,37905775
1642187679,195457,true,3249636216,28,3287220851,37584635
1642187955,195454,true,3250611205,28,3288535937,37924732
1642187972,195453,true,3250936266,28,3288864790,37928524
1642188826,195455,true,3250286176,28,3295448772,45162596
1642188934,195453,true,3250936266,28,3296107895,45171629
1642188940,195450,true,3251911644,28,3296107895,44196251
1642189035,195449,true,3252236835,28,3297096826,44859991
1642189115,195448,true,3252562059,28,3298086054,45523995
1642189647,195445,true,3253537925,28,3304358061,50820136
1642190412,195442,true,3254514084,28,3310310964,55796880
1642193322,195440,true,3255165020,28,3312628877,57463857
1642193502,195439,true,3255490536,28,3312628877,57138341
1642193578,195437,true,3256141667,28,3312628877,56487210
1642197195,195433,true,3257444319,28,3311966450,54522131
1642197229,195431,true,3258095840,28,3312297647,54201807
1642197309,195430,true,3258421650,28,3312628877,54207227
1642197363,195427,true,3259399274,28,3312960140,53560866
1642197376,195423,true,3260703229,28,3312960140,52256911
1642200917,195420,true,3261681538,28,3326570478,64888940
1642201342,195419,true,3262007706,28,3326570478,64562772
1642201371,195415,true,3263312705,28,3326570478,63257773
1642201477,195411,true,3264618226,28,3326237854,61619628
1642202791,195409,true,3265271182,28,3317933060,52661878
1642203357,195408,true,3265597709,28,3313291436,47693727
1642203524,195404,true,3266904145,28,3312628877,45724732
1642204865,195400,true,3268211102,28,3305680002,37468900
1642204880,195398,true,3268864777,28,3305680002,36815225
1642204911,195397,true,3269191664,28,3305680002,36488338
1642206232,195392,true,3270826586,28,3314616951,43790365
1642207065,195387,true,3272462327,28,3317933060,45470733
1642207411,195386,true,3272789573,28,3317269573,44480000
1642210795,195385,true,3273116852,28,3313954127,40837275
1642211142,195381,true,3274426295,28,3313291436,38865141
1642214088,195376,true,3276063836,28,3308656305,32592469
1642215261,195375,true,3276391442,28,3308987170,32595728
1642215986,195374,true,3276719081,28,3308987170,32268089
1642218086,195370,true,3278029965,28,3312297647,34267682
1642220410,195366,true,3279341374,28,3312297647,32956273
1642220840,195365,true,3279669308,28,3312297647,32628339
1642221650,195364,true,3279997275,28,3311635287,31638012
1642222411,195361,true,3280981373,28,3308987170,28005797
1642223459,195357,true,3282293962,28,3305680002,23386040
1642225652,195356,true,3282622192,28,3305680002,23057810
1642226308,195355,true,3282950454,28,3305680002,22729548
1642227673,195351,true,3284263831,28,3307002473,22738642
1642228963,195347,true,3285577734,28,3307333173,21755439
1642229700,195346,true,3285906291,28,3307333173,21426882
1642229824,195345,true,3286234882,28,3307663906,21429024
1642229983,195341,true,3287549573,28,3307994673,20445100
1642230208,195338,true,3288535937,28,3308325472,19789535
1642233162,195336,true,3289193677,28,3310641995,21448318
1642234382,195335,true,3289522596,28,3310641995,21119399
1642234402,195331,true,3290838603,28,3310973059,20134456
1642237004,195327,true,3292155135,28,3319924317,27769182
1642237676,195326,true,3292484351,28,3319924317,27439966
1642240769,195324,true,3293142881,28,3319924317,26781436
1642240849,195320,true,3294460336,28,3320256310,25795974
1642241310,195316,true,3295778317,28,3321584612,25806295
1642241318,195314,true,3296437506,28,3321584612,25147106
1642242452,195313,true,3296767150,28,3325572706,28805556
1642244464,195310,true,3297756279,28,3326570478,28814199
1642244742,195306,true,3299075579,28,3326570478,27494899
1642245771,195305,true,3299405487,28,3326570478,27164991
1642246108,195303,true,3300065401,28,3326570478,26505077
1642248430,195300,true,3301055519,28,3326570478,25514959
1642248706,195298,true,3301715764,28,3326570478,24854714
1642249738,195297,true,3302045935,28,3326237854,24191919
1642249756,195296,true,3302376140,28,3326237854,23861714
1642249907,195293,true,3303366952,28,3325905263,22538311
1642250075,195291,true,3304027658,28,3325240182,21212524
1642250140,195292,true,3303697288,28,3324907691,21210403
1642250229,195291,true,3304027658,28,3324575234,20547576
1642250338,195289,true,3304688497,28,3323578061,18889564
1642250360,195287,true,3305349467,28,3323578061,18228594
1642250389,195288,true,3305018965,28,3323245736,18226771
1642250399,195287,true,3305349467,28,3322913445,17563978
1642250429,195286,true,3305680002,28,3322581187,16901185
1642250455,195285,true,3306010570,28,3322248962,16238392
1642250546,195287,true,3305349467,28,3320588336,15238869
1642251139,195287,true,3305349467,28,3307002473,1653006
1642251186,195286,true,3305680002,28,3305680002,0
1642252079,195285,true,3306010570,28,3283935437,-22075133
1642252163,195286,true,3305680002,28,3282293962,-23386040
1642252487,195286,true,3305680002,28,3279669308,-26010694
1642252731,195285,true,3306010570,28,3279341374,-26669196
1642253314,195284,true,3306341171,28,3279997275,-26343896
1642253350,195286,true,3305680002,28,3279997275,-25682727
1642253366,195286,true,3305680002,28,3280325275,-25354727
1642253436,195285,true,3306010570,28,3280981373,-25029197
1642254086,195283,true,3306671805,28,3287549573,-19122232
1642254509,195284,true,3306341171,28,3291496803,-14844368
1642254562,195285,true,3306010570,28,3291825953,-14184617
1642257681,195284,true,3306341171,28,3300725447,-5615724
1642257688,195282,true,3307002473,28,3301055519,-5946954
1642257705,195284,true,3306341171,28,3301055519,-5285652
1642257739,195284,true,3306341171,28,3301055519,-5285652
1642257759,195282,true,3307002473,28,3301385625,-5616848
1642257761,195281,true,3307333173,28,3301385625,-5947548
1642260320,195279,true,3307994673,28,3341238901,33244228
1642261302,195280,true,3307663906,28,3341238901,33574995
1642261334,195277,true,3308656305,28,3341573025,32916720
1642261661,195275,true,3309318069,28,3344581644,35263575
1642263097,195272,true,3310310964,28,3357986092,47675128
1642264094,195272,true,3310310964,28,3358657722,48346758
1642265663,195270,true,3310973059,28,3358993588,48020529
1642266011,195267,true,3311966450,28,3358993588,47027138
1642266710,195265,true,3312628877,28,3358993588,46364711
1642270090,195264,true,3312960140,28,3358993588,46033448
1642270116,195262,true,3313622765,28,3358993588,45370823
1642270582,195260,true,3314285522,28,3357986092,43700570
1642271182,195257,true,3315279907,28,3355636441,40356534
1642271756,195257,true,3315279907,28,3353288435,38008528
1642273688,195255,true,3315942997,28,3351612294,35669297
1642275218,195253,true,3316606218,28,3351612294,35006076
1642277216,195251,true,3317269573,28,3351612294,34342721
1642277468,195251,true,3317269573,28,3352617878,35348305
1642277993,195249,true,3317933060,28,3355300911,37367851
1642281076,195247,true,3318596680,28,3361009488,42412808
1642281904,195244,true,3319592358,28,3361009488,41417130
1642281974,195246,true,3318928539,28,3361009488,42080949
1642282290,195244,true,3319592358,28,3360673421,41081063
1642282423,195242,true,3320256310,28,3360337387,40081077
1642282431,195239,true,3321252486,28,3360337387,39084901
1642282964,195241,true,3320588336,28,3357650327,37061991
1642283019,195240,true,3320920394,28,3357314595,36394201
1642283092,195238,true,3321584612,28,3356978897,35394285
1642283493,195235,true,3322581187,28,3352617878,30036691
1642283543,195238,true,3321584612,28,3351947455,30362843
1642283636,195236,true,3322248962,28,3350942072,28693110
1642283946,195235,true,3322581187,28,3347258246,24677059
1642284484,195234,true,3322913445,28,3342575597,19662152
1642284782,195236,true,3322248962,28,3340570754,18321792
1642285106,195235,true,3322581187,28,3339902740,17321553
1642290202,195234,true,3322913445,28,3339568783,16655338
1642290279,195232,true,3323578061,28,3339568783,15990722
1642290332,195234,true,3322913445,28,3339568783,16655338
1642291219,195232,true,3323578061,28,3339234859,15656798
1642291439,195231,true,3323910419,28,3339234859,15324440
1642291519,195228,true,3324907691,28,3339234859,14327168
1642291548,195230,true,3324242810,28,3339234859,14992049
1642291600,195229,true,3324575234,28,3338900969,14325735
1642291613,195229,true,3324575234,28,3338567113,13991879
1642298652,195227,true,3325240182,28,3327901306,2661124
1642301063,195229,true,3324575234,28,3327901306,3326072
1642301253,195228,true,3324907691,28,3327901306,2993615
1642301512,195227,true,3325240182,28,3326570478,1330296
1642301714,195225,true,3325905263,28,3325240182,-665081
1642301897,195228,true,3324907691,28,3323578061,-1329630
1642303372,195228,true,3324907691,28,3308656305,-16251386
1642305012,195228,true,3324907691,28,3307333173,-17574518
1642305423,195226,true,3325572706,28,3307994673,-17578033
1642305591,195228,true,3324907691,28,3308325472,-16582219
1642305905,195228,true,3324907691,28,3308987170,-15920521
1642306506,195228,true,3324907691,28,3309979966,-14927725
1642306869,195225,true,3325905263,28,3310641995,-15263268
1642307003,195227,true,3325240182,28,3310973059,-14267123
1642310693,195228,true,3324907691,28,3313954127,-10953564
1642315349,195227,true,3325240182,28,3315611435,-9628747
1642315380,195224,true,3326237854,28,3315942997,-10294857
1642316112,195227,true,3325240182,28,3316274591,-8965591
1642316236,195227,true,3325240182,28,3316274591,-8965591
1642316930,195225,true,3325905263,28,3320588336,-5316927
1642316955,195223,true,3326570478,28,3320920394,-5650084
1642317265,195225,true,3325905263,28,3322913445,-2991818
1642318644,195225,true,3325905263,28,3328899776,2994513
1642323333,195224,true,3326237854,28,3328566919,2329065
1642323348,195222,true,3326903135,28,3328566919,1663784
1642323493,195224,true,3326237854,28,3328566919,2329065
1642328466,195224,true,3326237854,28,3323245736,-2992118
1642328543,195223,true,3326570478,28,3323578061,-2992417
1642329660,195222,true,3326903135,28,3323910419,-2992716
1642330677,195224,true,3326237854,28,3324242810,-1995044
1642330806,195225,true,3325905263,28,3323910419,-1994844
1642330870,195224,true,3326237854,28,3323578061,-2659793
1642331282,195223,true,3326570478,28,3319592358,-6978120
1642331316,195226,true,3325572706,28,3319260432,-6312274
1642331519,195227,true,3325240182,28,3316937879,-8302303
1642331851,195226,true,3325572706,28,3312297647,-13275059
1642332418,195225,true,3325905263,28,3304027658,-21877605
1642333313,195229,true,3324575234,28,3300065401,-24509833
1642333371,195229,true,3324575234,28,3300065401,-24509833
1642333413,195229,true,3324575234,28,3300395407,-24179827
1642335230,195227,true,3325240182,28,3309979966,-15260216
1642335290,195230,true,3324242810,28,3310310964,-13931846
1642335346,195230,true,3324242810,28,3310641995,-13600815
1642336526,195229,true,3324575234,28,3318928539,-5646695
1642337363,195226,true,3325572706,28,3322913445,-2659261
1642337402,195229,true,3324575234,28,3322913445,-1661789
1642337465,195228,true,3324907691,28,3323245736,-1661955
1642338816,195226,true,3325572706,28,3332563397,6990691
1642338995,195222,true,3326903135,28,3333896622,6993487
1642339081,195224,true,3326237854,28,3334230012,7992158
1642339258,195223,true,3326570478,28,3334230012,7659534
1642339293,195221,true,3327235825,28,3334230012,6994187
1642339517,195217,true,3328566919,28,3332563397,3996478
1642339554,195219,true,3327901306,28,3331896984,3995678
1642339567,195219,true,3327901306,28,3331896984,3995678
1642339594,195216,true,3328899776,28,3331230705,2330929
1642339597,195214,true,3329565589,28,3331230705,1665116
1642339598,195216,true,3328899776,28,3331230705,2330929
1642339709,195217,true,3328566919,28,3329232666,665747
1642339729,195216,true,3328899776,28,3328566919,-332857
1642339744,195213,true,3329898546,28,3328234096,-1664450
1642339784,195215,true,3329232666,28,3327568549,-1664117
1642339793,195217,true,3328566919,28,3327235825,-1331094
1642339903,195217,true,3328566919,28,3324242810,-4324109
1642339942,195215,true,3329232666,28,3322913445,-6319221
1642340397,195217,true,3328566919,28,3311635287,-16931632
1642340526,195220,true,3327568549,28,3308656305,-18912244
1642340654,195220,true,3327568549,28,3305680002,-21888547
1642341174,195220,true,3327568549,28,3297426536,-30142013
1642341244,195221,true,3327235825,28,3296767150,-30468675
1642341328,195224,true,3326237854,28,3295778317,-30459537
1642341353,195224,true,3326237854,28,3295778317,-30459537
1642341400,195225,true,3325905263,28,3295778317,-30126946
1642341428,195227,true,3325240182,28,3296107895,-29132287
1642341444,195229,true,3324575234,28,3296437506,-28137728
1642341474,195229,true,3324575234,28,3296767150,-27808084
1642341481,195229,true,3324575234,28,3296767150,-27808084
1642341489,195231,true,3323910419,28,3296767150,-27143269
1642341513,195233,true,3323245736,28,3297096826,-26148910
1642341520,195232,true,3323578061,28,3297426536,-26151525
1642341541,195232,true,3323578061,28,3297756279,-25821782
1642341641,195233,true,3323245736,28,3300065401,-23180335
1642341843,195235,true,3322581187,28,3306010570,-16570617
1642342029,195234,true,3322913445,28,3310973059,-11940386
1642342061,195234,true,3322913445,28,3311966450,-10946995
1642342643,195234,true,3322913445,28,3327901306,4987861
1642343448,195236,true,3322248962,28,3342241373,19992411
1642343760,195235,true,3322581187,28,3343912828,21331641
1642348021,195235,true,3322581187,28,3351612294,29031107
1642348990,195235,true,3322581187,28,3351612294,29031107
1642349744,195237,true,3321916770,28,3351947455,30030685
1642349941,195236,true,3322248962,28,3352617878,30368916
1642350023,195236,true,3322248962,28,3352953140,30704178
1642350068,195235,true,3322581187,28,3353288435,30707248
1642350070,195236,true,3322248962,28,3353288435,31039473
1642350124,195235,true,3322581187,28,3353959126,31377939
1642350708,195233,true,3323245736,28,3362017892,38772156
1642354409,195232,true,3323578061,28,3375829770,52251709
1642354843,195232,true,3323578061,28,3375492220,51914159
1642355113,195231,true,3323910419,28,3374479775,50569356
1642355434,195229,true,3324575234,28,3372118584,47543350
1642355444,195229,true,3324575234,28,3372118584,47543350
1642355701,195230,true,3324242810,28,3370096021,45853211
1642356110,195229,true,3324575234,28,3366054533,41479299
1642357681,195227,true,3325240182,28,3357314595,32074413
1642358285,195227,true,3325240182,28,3357314595,32074413
1642360030,195228,true,3324907691,28,3356307602,31399911
1642360154,195227,true,3325240182,28,3355972005,30731823
1642360272,195225,true,3325905263,28,3355972005,30066742
1642361276,195225,true,3325905263,28,3352282650,26377387
1642361474,195226,true,3325572706,28,3351612294,26039588
1642361529,195225,true,3325905263,28,3351277166,25371903
1642361541,195223,true,3326570478,28,3351277166,24706688
1642362128,195223,true,3326570478,28,3348597350,22026872
1642362270,195225,true,3325905263,28,3347927731,22022468
1642362652,195224,true,3326237854,28,3344581644,18343790
1642362780,195221,true,3327235825,28,3343578470,16342645
1642362824,195221,true,3327235825,28,3342909855,15674030
1642363652,195222,true,3326903135,28,3332896653,5993518
1642363662,195222,true,3326903135,28,3332896653,5993518
1642364024,195220,true,3327568549,28,3328234096,665547
1642365010,195219,true,3327901306,28,3323578061,-4323245
1642366006,195221,true,3327235825,28,3325240182,-1995643
1642366958,195220,true,3327568549,28,3326903135,-665414
1642370700,195218,true,3328234096,28,3327235825,-998271
1642370759,195218,true,3328234096,28,3327568549,-665547
1642370913,195219,true,3327901306,28,3327568549,-332757
1642371100,195219,true,3327901306,28,3327901306,0
1642371245,195216,true,3328899776,28,3328234096,-665680
1642371472,195216,true,3328899776,28,3329232666,332890
1642371608,195217,true,3328566919,28,3329898546,1331627
1642371669,195217,true,3328566919,28,3330231535,1664616
1642371762,195215,true,3329232666,28,3330897615,1664949
1642371764,195215,true,3329232666,28,3330897615,1664949
1642372274,195216,true,3328899776,28,3334230012,5330236
1642372451,195216,true,3328899776,28,3335563904,6664128
1642373918,195213,true,3329898546,28,3340570754,10672208
1642374485,195214,true,3329565589,28,3341573025,12007436
1642374630,195214,true,3329565589,28,3341573025,12007436
1642374646,195214,true,3329565589,28,3341907182,12341593
1642374721,195211,true,3330564559,28,3341907182,11342623
1642374775,195211,true,3330564559,28,3342241373,11676814
1642374937,195212,true,3330231535,28,3343244146,13012611
1642374976,195211,true,3330564559,28,3343578470,13013911
1642376177,195208,true,3331563828,28,3350271984,18708156
1642378881,195207,true,3331896984,28,3351947455,20050471
1642379062,195207,true,3331896984,28,3351612294,19715310
1642379283,195206,true,3332230174,28,3350607011,18376837
1642379428,195202,true,3333563266,28,3349936990,16373724
1642379565,195202,true,3333563266,28,3349267103,15703837
1642379691,195202,true,3333563266,28,3348597350,15034084
1642380105,195202,true,3333563266,28,3345919677,12356411
1642381033,195199,true,3334563435,28,3341907182,7343747
1642381722,195199,true,3334563435,28,3340236730,5673295
1642381751,195199,true,3334563435,28,3340236730,5673295
1642381937,195199,true,3334563435,28,3339902740,5339305
1642382032,195197,true,3335230381,28,3339568783,4338402
1642383021,195198,true,3334896891,28,3334896891,0
1642383390,195198,true,3334896891,28,3333563266,-1333625
1642383877,195199,true,3334563435,28,3331230705,-3332730
1642384971,195197,true,3335230381,28,3327901306,-7329075
1642385541,195198,true,3334896891,28,3327235825,-7661066
1642387240,195199,true,3334563435,28,3322581187,-11982248
1642387475,195200,true,3334230012,28,3322248962,-11981050
1642387690,195198,true,3334896891,28,3321916770,-12980121
1642388317,195199,true,3334563435,28,3319260432,-15303003
1642388460,195199,true,3334563435,28,3318928539,-15634896
1642388492,195200,true,3334230012,28,3318596680,-15633332
1642389327,195197,true,3335230381,28,3316606218,-18624163
1642390345,195198,true,3334896891,28,3317933060,-16963831
1642390386,195197,true,3335230381,28,3317933060,-17297321
1642390456,195198,true,3334896891,28,3317601300,-17295591
1642390511,195195,true,3335897460,28,3317269573,-18627887
1642390554,195196,true,3335563904,28,3317269573,-18294331
1642390564,195196,true,3335563904,28,3316937879,-18626025
1642390855,195196,true,3335563904,28,3314948413,-20615491
1642390914,195193,true,3336564673,28,3314285522,-22279151
1642390978,195195,true,3335897460,28,3313954127,-21943333
1642391169,195195,true,3335897460,28,3312297647,-23599813
1642391446,195195,true,3335897460,28,3308656305,-27241155
1642391822,195193,true,3336564673,28,3303366952,-33197721
1642391876,195195,true,3335897460,28,3302706377,-33191083
1642391956,195195,true,3335897460,28,3301055519,-34841941
1642391959,195196,true,3335563904,28,3301055519,-34508385
1642391976,195195,true,3335897460,28,3300725447,-35172013
1642391986,195198,true,3334896891,28,3300395407,-34501484
1642391989,195199,true,3334563435,28,3300395407,-34168028
1642395603,195202,true,3333563266,28,3266250862,-67312404
1642395622,195201,true,3333896622,28,3266250862,-67645760
1642395649,195204,true,3332896653,28,3266250862,-66645791
1642395668,195205,true,3332563397,28,3266250862,-66312535
1642399012,195210,true,3330897615,28,3250611205,-80286410
1642399307,195209,true,3331230705,28,3251911644,-79319061
1642399499,195213,true,3329898546,28,3252562059,-77336487
1642399586,195214,true,3329565589,28,3252887315,-76678274
1642399588,195218,true,3328234096,28,3252887315,-75346781
1642399704,195218,true,3328234096,28,3253863279,-74370817
1642400231,195221,true,3327235825,28,3258421650,-68814175
1642400387,195223,true,3326570478,28,3259725214,-66845264
1642400517,195227,true,3325240182,28,3261029300,-64210882
1642400561,195227,true,3325240182,28,3261355403,-63884779
1642400598,195230,true,3324242810,28,3261681538,-62561272
1642400824,195232,true,3323578061,28,3264291797,-59286264
1642400983,195236,true,3322248962,28,3265597709,-56651253
1642401306,195235,true,3322581187,28,3268537923,-54043264
1642403187,195239,true,3321252486,28,3272462327,-48790159
1642403403,195241,true,3320588336,28,3272462327,-48126009
1642403413,195245,true,3319260432,28,3272789573,-46470859
1642405493,195246,true,3318928539,28,3287878328,-31050211
1642406114,195248,true,3318264853,28,3287878328,-30386525
1642406358,195250,true,3317601300,28,3287878328,-29722972
1642406530,195255,true,3315942997,28,3287549573,-28393424
1642406560,195255,true,3315942997,28,3287220851,-28722146
1642406584,195257,true,3315279907,28,3287220851,-28059056
1642406639,195259,true,3314616951,28,3286563506,-28053445
1642406778,195265,true,3312628877,28,3284920717,-27708160
1642408304,195265,true,3312628877,28,3267884314,-44744563
1642409507,195267,true,3311966450,28,3264291797,-47674653
1642409601,195269,true,3311304156,28,3264291797,-47012359
1642410380,195274,true,3309649001,28,3265597709,-44051292
1642410625,195275,true,3309318069,28,3266250862,-43067207
1642410743,195276,true,3308987170,28,3266904145,-42083025
1642413597,195278,true,3308325472,28,3271153669,-37171803
1642415550,195283,true,3306671805,28,3271153669,-35518136
1642415682,195283,true,3306671805,28,3271153669,-35518136
1642415951,195285,true,3306010570,28,3270499536,-35511034
1642416444,195286,true,3305680002,28,3269191664,-36488338
1642416596,195291,true,3304027658,28,3268537923,-35489735
1642417120,195291,true,3304027658,28,3266904145,-37123513
1642417184,195292,true,3303697288,28,3266904145,-36793143
1642418322,195293,true,3303366952,28,3266577487,-36789465
1642419478,195297,true,3302045935,28,3268211102,-33834833
1642420493,195297,true,3302045935,28,3268537923,-33508012
1642420799,195298,true,3301715764,28,3268537923,-33177841
1642420824,195299,true,3301385625,28,3268537923,-32847702
1642421093,195304,true,3299735427,28,3267557558,-32177869
1642421106,195304,true,3299735427,28,3267230835,-32504592
1642421496,195306,true,3299075579,28,3264618226,-34457353
1642421667,195307,true,3298745705,28,3263312705,-35433000
1642421905,195312,true,3297096826,28,3261681538,-35415288
1642422264,195312,true,3297096826,28,3257118607,-39978219
1642422267,195314,true,3296437506,28,3257118607,-39318899
1642422288,195316,true,3295778317,28,3256792928,-38985389
1642422301,195321,true,3294130922,28,3256792928,-37337994
1642422400,195321,true,3294130922,28,3256467281,-37663641
1642422483,195323,true,3293472195,28,3255816085,-37656110
1642422527,195324,true,3293142881,28,3255816085,-37326796
1642422566,195330,true,3291167686,28,3255816085,-35351601
1642422626,195329,true,3291496803,28,3255816085,-35680718
1642423011,195331,true,3290838603,28,3257444319,-33394284
1642424690,195332,true,3290509552,28,3268864777,-21644775
1642427211,195338,true,3288535937,28,3268864777,-19671160
1642427324,195337,true,3288864790,28,3268864777,-20000013
1642427657,195339,true,3288207116,28,3268864777,-19342339
1642427890,195341,true,3287549573,28,3268864777,-18684796
1642429056,195346,true,3285906291,28,3268537923,-17368368
1642429167,195346,true,3285906291,28,3268537923,-17368368
1642429831,195348,true,3285249209,28,3268211102,-17038107
1642430094,195350,true,3284592257,28,3268211102,-16381155
1642430354,195355,true,3282950454,28,3268211102,-14739352
1642430803,195355,true,3282950454,28,3268211102,-14739352
1642430946,195356,true,3282622192,28,3268211102,-14411090
1642431015,195358,true,3281965766,28,3268211102,-13754664
1642431180,195363,true,3280325275,28,3267557558,-12767717
1642431225,195364,true,3279997275,28,3267557558,-12439717
1642431391,195365,true,3279669308,28,3266904145,-12765163
1642431440,195367,true,3279013473,28,3266577487,-12435986
1642431700,195372,true,3277374458,28,3265924269,-11450189
1642431875,195372,true,3277374458,28,3264944688,-12429770
1642432019,195373,true,3277046753,28,3263639036,-13407717
1642432103,195375,true,3276391442,28,3262660141,-13731301
1642432151,195380,true,3274753738,28,3262333907,-12419831
1642432177,195380,true,3274753738,28,3262007706,-12746032
1642432834,195383,true,3273771508,28,3249636216,-24135292
1642432883,195385,true,3273116852,28,3248661520,-24455332
1642433042,195390,true,3271480784,28,3246713006,-24767778
1642433911,195390,true,3271480784,28,3236987948,-34492836
1642433997,195392,true,3270826586,28,3236664281,-34162305
1642434378,195393,true,3270499536,28,3237635378,-32864158
1642435756,195398,true,3268864777,28,3241522678,-27342099
1642435801,195398,true,3268864777,28,3241522678,-27342099
1642435805,195400,true,3268211102,28,3241522678,-26688424
1642435873,195402,true,3267557558,28,3241198558,-26359000
1642435944,195407,true,3265924269,28,3240874470,-25049799
1642435960,195408,true,3265597709,28,3240874470,-24723239
1642436300,195410,true,3264944688,28,3237311646,-27633042
1642436642,195411,true,3264618226,28,3233429396,-31188830
1642436795,195416,true,3262986407,28,3231813167,-31173240
1642436837,195416,true,3262986407,28,3231813167,-31173240
1642437838,195418,true,3262333907,28,3226969323,-35364584
1642437990,195419,true,3262007706,28,3227614749,-34392957
1642438153,195424,true,3260377192,28,3228583130,-31794062
1642439127,195424,true,3260377192,28,3229874757,-30502435
1642439201,195425,true,3260051187,28,3229874757,-30176430
1642439328,195426,true,3259725214,28,3229551802,-30173412
1642439586,195431,true,3258095840,28,3229228879,-28866961
1642439600,195430,true,3258421650,28,3229228879,-29192771
1642439654,195431,true,3258095840,28,3228905989,-29189851
1642439687,195432,true,3257770063,28,3228905989,-28864074
1642439801,195436,true,3256467281,28,3228260304,-28206977
1642440543,195435,true,3256792928,28,3223744128,-33048800
1642440552,195436,true,3256467281,28,3223744128,-32723153
1642440570,195437,true,3256141667,28,3223744128,-32397539
1642440948,195440,true,3255165020,28,3217946897,-37218123
1642440964,195440,true,3255165020,28,3217946897,-37218123
1642441025,195442,true,3254514084,28,3216981706,-37532378
1642441496,195442,true,3254514084,28,3212160092,-42353992
1642441508,195446,true,3253212604,28,3211838908,-41373696
1642442495,195446,true,3253212604,28,3208308004,-44904600
1642442634,195448,true,3252562059,28,3208308004,-44254055
1642442672,195448,true,3252562059,28,3208628835,-43933224
1642442740,195452,true,3251261359,28,3208628835,-42632524
1642442755,195453,true,3250936266,28,3208628835,-42307431
1642442826,195455,true,3250286176,28,3208308004,-41978172
1642442917,195456,true,3249961180,28,3207987205,-41973975
1642442944,195460,true,3248661520,28,3207987205,-40674315
1642443031,195461,true,3248336687,28,3207666439,-40670248
1642443168,195463,true,3247687117,28,3207025002,-40662115
1642443177,195464,true,3247362381,28,3206704331,-40658050
1642443654,195468,true,3246063760,28,3202858786,-43204974
1642443718,195470,true,3245414645,28,3202218310,-43196335
1642445083,195473,true,3244441215,28,3193584414,-50856801
1642445295,195474,true,3244116804,28,3193584414,-50532390
1642445394,195478,true,3242819481,28,3193903772,-48915709
1642445430,195480,true,3242171015,28,3193903772,-48267243
1642445823,195482,true,3241522678,28,3196459789,-45062889
1642445991,195483,true,3241198558,28,3197738565,-43459993
1642446045,195486,true,3240226393,28,3198378145,-41848248
1642446151,195487,true,3239902402,28,3199337754,-40564648
1642446225,195489,true,3239254519,28,3200297652,-38956867
1642446818,195488,true,3239578445,28,3207025002,-32553443
1642446860,195491,true,3238606765,28,3207666439,-30940326
1642448203,195493,true,3237959141,28,3214409278,-23549863
1642450720,195495,true,3237311646,28,3214730719,-22580927
1642453741,195494,true,3237635378,28,3214730719,-22904659
1642453823,195498,true,3236340647,28,3214409278,-21931369
1642453951,195499,true,3236017045,28,3213766493,-22250552
1642454149,195501,true,3235369939,28,3212802556,-22567383
1642454166,195502,true,3235046434,28,3212481308,-22565126
1642454183,195504,true,3234399522,28,3212481308,-21918214
1642454223,195506,true,3233752739,28,3212160092,-21592647
1642454293,195508,true,3233106086,28,3211517756,-21588330
1642454695,195509,true,3232782808,28,3207025002,-25757806
1642454877,195512,true,3231813167,28,3204780982,-27032185
1642454908,195514,true,3231166901,28,3204460536,-26706365
1642454963,195517,true,3230197745,28,3203499390,-26698355
1642455008,195518,true,3229874757,28,3202538532,-27336225
1642455172,195522,true,3228583130,28,3199337754,-29245376
1642455385,195524,true,3227937510,28,3194862039,-33075471
1642455410,195526,true,3227292020,28,3194223162,-33068858
1642455593,195527,true,3226969323,28,3190711624,-36257699
1642455724,195531,true,3225678858,28,3187841419,-37837439
1642455868,195533,true,3225033819,28,3184973796,-40060023
1642456061,195535,true,3224388909,28,3181472426,-42916483
1642456066,195536,true,3224066502,28,3181472426,-42594076
1642456077,195540,true,3222777198,28,3181154310,-41622888
1642456218,195543,true,3221810558,28,3178928393,-42882165
1642456251,195545,true,3221166292,28,3178292702,-42873590
1642457739,195547,true,3220522156,28,3164339631,-56182525
1642457751,195550,true,3219556192,28,3164023229,-55532963
1642458105,195554,true,3218268692,28,3161809298,-56459394
1642458522,195557,true,3217303404,28,3159596917,-57706487
1642458621,195559,true,3216660040,28,3158965092,-57694948
1642458712,195563,true,3215373698,28,3158649227,-56724471
1642458746,195567,true,3214087870,28,3158649227,-55438643
1642458765,195569,true,3213445149,28,3158649227,-54795922
1642458783,195572,true,3212481308,28,3158649227,-53832081
1642458818,195575,true,3211517756,28,3158649227,-52868529
1642458829,195578,true,3210554493,28,3158649227,-51905266
1642458854,195580,true,3209912479,28,3158965092,-50947387
1642459025,195581,true,3209591520,28,3160860945,-48730575
1642459038,195584,true,3208628835,28,3160860945,-47767890
1642459039,195587,true,3207666439,28,3160860945,-46805494
1642459082,195589,true,3207025002,28,3161493149,-45531853
1642459132,195590,true,3206704331,28,3162441692,-44262639
1642459137,195592,true,3206063086,28,3162441692,-43621394
1642459159,195595,true,3205101460,28,3163074212,-42027248
1642460322,195596,true,3204780982,28,3192307299,-12473683
1642460465,195596,true,3204780982,28,3196140175,-8640807
1642461099,195599,true,3203819740,28,3202538532,-1281208
1642461169,195601,true,3203179072,28,3202538532,-640540
1642461400,195602,true,3202858786,28,3203179072,320286
1642462454,195602,true,3202858786,28,3208628835,5770049
1642464555,195604,true,3202218310,28,3211196636,8978326
1642464613,195606,true,3201577963,28,3211196636,9618673
1642465274,195605,true,3201898120,28,3215052192,13154072
1642465510,195604,true,3202218310,28,3216981706,14763396
1642468348,195605,true,3201898120,28,3225678858,23780738
1642470312,195607,true,3201257837,28,3233752739,32494902
1642470333,195606,true,3201577963,28,3233752739,32174776
1642470916,195605,true,3201898120,28,3232782808,30884688
1642471802,195606,true,3201577963,28,3228905989,27328026
1642471830,195608,true,3200937743,28,3228905989,27968246
1642472241,195607,true,3201257837,28,3226324026,25066189
1642472970,195607,true,3201257837,28,3223099476,21841639
1642473004,195607,true,3201257837,28,3223099476,21841639
1642474626,195609,true,3200617681,28,3220844208,20226527
1642475851,195608,true,3200937743,28,3220522156,19584413
1642476328,195607,true,3201257837,28,3219556192,18298355
1642476361,195607,true,3201257837,28,3219556192,18298355
1642476602,195610,true,3200297652,28,3217625135,17327483
1642476622,195609,true,3200617681,28,3217303404,16685723
1642477005,195610,true,3200297652,28,3213123836,12826184
1642477178,195610,true,3200297652,28,3210875549,10577897
1642477208,195613,true,3199337754,28,3210233470,10895716
1642479382,195614,true,3199017852,28,3189116747,-9901105
1642479491,195615,true,3198697983,28,3189116747,-9581236
1642479656,195615,true,3198697983,28,3188160203,-10537780
1642479674,195618,true,3197738565,28,3188160203,-9578362
1642479840,195619,true,3197418823,28,3186885258,-10533565
1642480069,195620,true,3197099113,28,3185610822,-11488291
1642481717,195620,true,3197099113,28,3176068787,-21030326
1642486071,195623,true,3196140175,28,3175751212,-20388963
1642486803,195624,true,3195820593,28,3176704033,-19116560
1642486861,195625,true,3195501043,28,3176704033,-18797010
1642486943,195624,true,3195820593,28,3177021703,-18798890
1642487103,195625,true,3195501043,28,3177657139,-17843904
1642487247,195626,true,3195181525,28,3178610532,-16570993
1642488347,195626,true,3195181525,28,3186566601,-8614924
1642488386,195626,true,3195181525,28,3186885258,-8296267
1642488444,195628,true,3194542585,28,3187203946,-7338639
1642488556,195628,true,3194542585,28,3188479019,-6063566
1642488753,195628,true,3194542585,28,3190073578,-4469007
1642488928,195628,true,3194542585,28,3191349798,-3192787
1642490734,195628,true,3194542585,28,3196779435,2236850
1642490785,195629,true,3194223162,28,3196779435,2556273
1642493219,195629,true,3194223162,28,3191988100,-2235062
1642493460,195628,true,3194542585,28,3191668933,-2873652
1642493591,195629,true,3194223162,28,3191349798,-2873364
1642493976,195630,true,3193903772,28,3189435658,-4468114
1642494208,195631,true,3193584414,28,3187522667,-6061747
1642494265,195630,true,3193903772,28,3186885258,-7018514
1642494429,195631,true,3193584414,28,3184655330,-8929084
1642494446,195632,true,3193265087,28,3184336896,-8928191
1642494503,195633,true,3192945792,28,3183700125,-9245667
1642494604,195633,true,3192945792,28,3182108752,-10837040
1642495112,195635,true,3192307299,28,3173529075,-18778224
1642495503,195637,true,3191668933,28,3167822146,-23846787
1642497130,195638,true,3191349798,28,3158965092,-32384706
1642497237,195638,true,3191349798,28,3158965092,-32384706
1642497470,195640,true,3190711624,28,3158649227,-32062397
1642497882,195643,true,3189754602,28,3154861311,-34893291
1642497916,195646,true,3188797867,28,3154230433,-34567434
1642497997,195646,true,3188797867,28,3153599682,-35198185
1642498021,195648,true,3188160203,28,3153284353,-34875850
1642498124,195650,true,3187522667,28,3152969057,-34553610
1642498152,195653,true,3186566601,28,3152969057,-33597544
1642498223,195653,true,3186566601,28,3152653791,-33912810
1642498257,195655,true,3185929383,28,3152653791,-33275592
1642498343,195657,true,3185292293,28,3152969057,-32323236
1642499042,195658,true,3184973796,28,3153915042,-31058754
1642499299,195658,true,3184973796,28,3155176797,-29796999
1642500694,195660,true,3184336896,28,3164972531,-19364365
1642501915,195660,true,3184336896,28,3165605557,-18731339
1642501976,195662,true,3183700125,28,3165922118,-17778007
1642502019,195661,true,3184018495,28,3166238710,-17779785
1642504336,195662,true,3183700125,28,3181472426,-2227699
1642504490,195662,true,3183700125,28,3181154310,-2545815
1642504714,195663,true,3183381786,28,3180518175,-2863611
1642504811,195661,true,3184018495,28,3180200155,-3818340
1642505570,195663,true,3183381786,28,3174798677,-8583109
1642507213,195663,true,3183381786,28,3166871989,-16509797
1642507341,195664,true,3183063480,28,3166871989,-16191491
1642507393,195662,true,3183700125,28,3167188676,-16511449
1642508013,195663,true,3183381786,28,3169089465,-14292321
1642508046,195663,true,3183381786,28,3169089465,-14292321
1642508089,195663,true,3183381786,28,3169089465,-14292321
1642508175,195662,true,3183700125,28,3169089465,-14610660
1642508278,195663,true,3183381786,28,3169089465,-14292321
1642508470,195663,true,3183381786,28,3168455742,-14926044
1642509015,195664,true,3183063480,28,3166238710,-16824770
1642509972,195662,true,3183700125,28,3158965092,-24735033
1642510509,195663,true,3183381786,28,3158333394,-25048392
1642510552,195663,true,3183381786,28,3158333394,-25048392
1642511590,195663,true,3183381786,28,3158017592,-25364194
1642511626,195662,true,3183700125,28,3158017592,-25682533
1642511701,195663,true,3183381786,28,3158017592,-25364194
1642511752,195663,true,3183381786,28,3158017592,-25364194
1642511780,195664,true,3183063480,28,3157701822,-25361658
1642511794,195663,true,3183381786,28,3157701822,-25679964
1642511806,195664,true,3183063480,28,3157701822,-25361658
1642511833,195665,true,3182745206,28,3157701822,-25043384
1642511953,195667,true,3182108752,28,3156754701,-25354051
1642512050,195667,true,3182108752,28,3156123445,-25985307
1642512200,195669,true,3181472426,28,3155176797,-26295629
1642512341,195670,true,3181154310,28,3153915042,-27239268
1642512364,195673,true,3180200155,28,3153599682,-26600473
1642512478,195673,true,3180200155,28,3152023355,-28176800
1642512529,195675,true,3179564210,28,3151077937,-28486273
1642512566,195678,true,3178610532,28,3150447816,-28162716
1642512610,195681,true,3177657139,28,3149502871,-28154268
1642513002,195682,true,3177339405,28,3141953504,-35385901
1642513131,195684,true,3176704033,28,3139441072,-37262961
1642513191,195687,true,3175751212,28,3138499428,-37251784
1642513765,195690,true,3174798677,28,3130976437,-43822240
1642513767,195691,true,3174481229,28,3130976437,-43504792
1642513769,195693,true,3173846428,28,3130976437,-42869991
1642514630,195696,true,3172894464,28,3132229015,-40665449
1642515159,195699,true,3171942786,28,3135362654,-36580132
1642515271,195701,true,3171308493,28,3135676190,-35632303
1642515400,195704,true,3170357291,28,3135989758,-34367533
1642515425,195706,true,3169723314,28,3135989758,-33733556
1642515451,195710,true,3168455742,28,3135989758,-32465984
1642515698,195712,true,3167822146,28,3135362654,-32459492
1642515991,195715,true,3166871989,28,3133482095,-33389894
1642516024,195717,true,3166238710,28,3133168778,-33069932
1642516049,195721,true,3164972531,28,3132855492,-32117039
1642516054,195723,true,3164339631,28,3132855492,-31484139
1642516261,195727,true,3163074212,28,3130663370,-32410842
1642516949,195729,true,3162441692,28,3121285922,-41155770
1642516984,195733,true,3161177031,28,3120973825,-40203206
1642517248,195735,true,3160544891,28,3120037720,-40507171
1642517306,195738,true,3159596917,28,3119725747,-39871170
1642517322,195739,true,3159280989,28,3119725747,-39555242
1642517559,195742,true,3158333394,28,3118478169,-39855225
1642517672,195744,true,3157701822,28,3118166352,-39535470
1642517810,195747,true,3156754701,28,3117542813,-39211888
1642517912,195747,true,3156754701,28,3117231090,-39523611
1642518234,195750,true,3155807864,28,3117231090,-38576774
1642518290,195752,true,3155176797,28,3117231090,-37945707
1642518401,195755,true,3154230433,28,3117854567,-36375866
1642518409,195755,true,3154230433,28,3117854567,-36375866
1642518486,195757,true,3153599682,28,3118478169,-35121513
1642518645,195758,true,3153284353,28,3119725747,-33558606
1642518694,195761,true,3152338557,28,3120349724,-31988833
1642519661,195760,true,3152653791,28,3127847182,-24806609
1642520325,195761,true,3152338557,28,3134422233,-17916324
1642520550,195763,true,3151708184,28,3134735676,-16972508
1642520611,195766,true,3150762861,28,3134735676,-16027185
1642521382,195765,true,3151077937,28,3133168778,-17909159
1642521485,195768,true,3150132803,28,3132855492,-17277311
1642521696,195770,true,3149502871,28,3131602663,-17900208
1642521730,195773,true,3148558209,28,3131289534,-17268675
1642522227,195773,true,3148558209,28,3127847182,-20711027
1642522279,195776,true,3147613830,28,3127534428,-20079402
1642522872,195778,true,3146984402,28,3123159162,-23825240
1642523212,195781,true,3146040495,28,3120973825,-25066670
1642523536,195782,true,3145725923,28,3120037720,-25688203
1642523542,195785,true,3144782394,28,3119725747,-25056647
1642523562,195787,true,3144153531,28,3119725747,-24427784
1642523792,195790,true,3143210474,28,3118478169,-24732305
1642523975,195791,true,3142896184,28,3117231090,-25665094
1642523984,195793,true,3142267699,28,3117231090,-25036609
1642524146,195795,true,3141639340,28,3116919398,-24719942
1642524376,195797,true,3141011107,28,3117542813,-23468294
1642524444,195796,true,3141325208,28,3117854567,-23470641
1642524676,195798,true,3140697037,28,3118790017,-21907020
1642525532,195799,true,3140382998,28,3125033526,-15349472
1642525559,195801,true,3139755016,28,3125346030,-14408986
1642525570,195800,true,3140068992,28,3125346030,-14722962
1642525609,195801,true,3139755016,28,3125658564,-14096452
1642526985,195803,true,3139127159,28,3125346030,-13781129
1642527036,195804,true,3138813278,28,3125346030,-13467248
1642527043,195804,true,3138813278,28,3125033526,-13779752
1642527340,195804,true,3138813278,28,3122534624,-16278654
1642527368,195806,true,3138185609,28,3122534624,-15650985
1642528813,195808,true,3137558066,28,3113492843,-24065223
1642528829,195807,true,3137871822,28,3113492843,-24378979
1642529020,195808,true,3137558066,28,3111314269,-26243797
1642529636,195812,true,3136303357,28,3102615208,-33688149
1642529650,195815,true,3135362654,28,3102615208,-32747446
1642529672,195815,true,3135362654,28,3102304978,-33057676
1642529793,195816,true,3135049149,28,3101064366,-33984783
1642529840,195819,true,3134108822,28,3100754291,-33354531
1642529912,195823,true,3132855492,28,3100134233,-32721259
1642530016,195823,true,3132855492,28,3099824250,-33031242
1642530061,195824,true,3132542238,28,3099514299,-33027939
1642530471,195826,true,3131915824,28,3097345507,-34570317
1642530480,195831,true,3130350335,28,3097345507,-33004828
1642530510,195831,true,3130350335,28,3097035803,-33314532
1642530531,195833,true,3129724359,28,3097035803,-32688556
1642530538,195835,true,3129098508,28,3097035803,-32062705
1642530734,195839,true,3127847182,28,3096416489,-31430693
1642530753,195839,true,3127847182,28,3096416489,-31430693
1642530872,195841,true,3127221706,28,3095797298,-31424408
1642530933,195844,true,3126283727,28,3096106878,-30176849
1642531059,195848,true,3125033526,28,3096106878,-28926648
1642531372,195849,true,3124721054,28,3097035803,-27685251
1642532266,195850,true,3124408613,28,3094249864,-30158749
1642532298,195853,true,3123471478,28,3094249864,-29221614
1642532597,195856,true,3122534624,28,3095487750,-27046874
1642532643,195856,true,3122534624,28,3095797298,-26737326
1642532850,195856,true,3122534624,28,3097965007,-24569617
1642533082,195859,true,3121598051,28,3100134233,-21463818
1642533272,195862,true,3120661759,28,3101684610,-18977149
1642533867,195862,true,3120661759,28,3106029792,-14631967
1642533891,195862,true,3120661759,28,3106340395,-14321364
1642534336,195864,true,3120037720,28,3108826337,-11211383
1642535233,195867,true,3119101896,28,3111936563,-7165333
1642535234,195867,true,3119101896,28,3111936563,-7165333
1642535579,195866,true,3119413806,28,3113804192,-5609614
1642535680,195868,true,3118790017,28,3114426984,-4363033
1642535822,195871,true,3117854567,28,3115049900,-2804667
1642535876,195871,true,3117854567,28,3115361405,-2493162
1642535920,195870,true,3118166352,28,3115984509,-2181843
1642536984,195871,true,3117854567,28,3123159162,5304595
1642537004,195873,true,3117231090,28,3123159162,5928072
1642538302,195873,true,3117231090,28,3121598051,4366961
1642538333,195872,true,3117542813,28,3121285922,3743109
1642538338,195873,true,3117231090,28,3121285922,4054832
1642538424,195875,true,3116607737,28,3120973825,4366088
1642538580,195875,true,3116607737,28,3120037720,3429983
1642538632,195874,true,3116919398,28,3119725747,2806349
1642539467,195875,true,3116607737,28,3115049900,-1557837
1642539702,195877,true,3115984509,28,3114115572,-1868937
1642539841,195876,true,3116296107,28,3113804192,-2491915
1642540200,195875,true,3116607737,28,3113181524,-3426213
1642540206,195876,true,3116296107,28,3113181524,-3114583
1642540218,195878,true,3115672942,28,3113181524,-2491418
1642540295,195878,true,3115672942,28,3113804192,-1868750
1642540507,195876,true,3116296107,28,3115672942,-623165
1642540539,195877,true,3115984509,28,3116296107,311598
1642540605,195879,true,3115361405,28,3117231090,1869685
1642540804,195878,true,3115672942,28,3120349724,4676782
1642540838,195875,true,3116607737,28,3120973825,4366088
1642541024,195876,true,3116296107,28,3124096204,7800097
1642541290,195877,true,3115984509,28,3128785630,12801121
1642541327,195876,true,3116296107,28,3129411418,13115311
1642541352,195874,true,3116919398,28,3130037332,13117934
1642541370,195874,true,3116919398,28,3130350335,13430937
1642541475,195873,true,3117231090,28,3132855492,15624402
1642541501,195871,true,3117854567,28,3133482095,15627528
1642544339,195868,true,3118790017,28,3162757936,43967919
1642544495,195868,true,3118790017,28,3162757936,43967919
1642545208,195868,true,3118790017,28,3162757936,43967919
1642545340,195867,true,3119101896,28,3163074212,43972316
1642545470,195864,true,3120037720,28,3163390519,43352799
1642545485,195863,true,3120349724,28,3163390519,43040795
1642545573,195862,true,3120661759,28,3163706858,43045099
1642545634,195861,true,3120973825,28,3164023229,43049404
1642545668,195857,true,3122222402,28,3164023229,41800827
1642545689,195857,true,3122222402,28,3164023229,41800827
1642545717,195856,true,3122534624,28,3164339631,41805007
1642545725,195855,true,3122846877,28,3164339631,41492754
1642546150,195851,true,3124096204,28,3168455742,44359538
1642546151,195851,true,3124096204,28,3168455742,44359538
1642546153,195850,true,3124408613,28,3168772588,44363975
1642546194,195849,true,3124721054,28,3169089465,44368411
1642547795,195845,true,3125971130,28,3181790573,55819443
1642547974,195846,true,3125658564,28,3181472426,55813862
1642548551,195845,true,3125971130,28,3178610532,52639402
1642548775,195844,true,3126283727,28,3177339405,51055678
1642549034,195841,true,3127221706,28,3175433669,48211963
1642549063,195841,true,3127221706,28,3175433669,48211963
1642550031,195840,true,3127534428,28,3169406374,41871946
1642550888,195839,true,3127847182,28,3166555334,38708152
1642551570,195836,true,3128785630,28,3164972531,36186901
1642553043,195836,true,3128785630,28,3162441692,33656062
1642553165,195836,true,3128785630,28,3162125479,33339849
1642554912,195835,true,3129098508,28,3154861311,25762803
1642554952,195831,true,3130350335,28,3154861311,24510976
1642555381,195831,true,3130350335,28,3156439057,26088722
1642555422,195831,true,3130350335,28,3156439057,26088722
1642556749,195829,true,3130976437,28,3161177031,30200594
1642557846,195825,true,3132229015,28,3164339631,32110616
1642558299,195826,true,3131915824,28,3165289028,33373204
1642559180,195826,true,3131915824,28,3165922118,34006294
1642559930,195824,true,3132542238,28,3165922118,33379880
1642560257,195821,true,3133482095,28,3165922118,32440023
1642560576,195821,true,3133482095,28,3165922118,32440023
1642560769,195822,true,3133168778,28,3165605557,32436779
1642561301,195820,true,3133795443,28,3164023229,30227786
1642561527,195817,true,3134735676,28,3163074212,28338536
1642561797,195817,true,3134735676,28,3161177031,26441355
1642562201,195818,true,3134422233,28,3158017592,23595359
1642563312,195817,true,3134735676,28,3151708184,16972508
1642563350,195814,true,3135676190,28,3151393045,15716855
1642563424,195814,true,3135676190,28,3150132803,14456613
1642563478,195814,true,3135676190,28,3149502871,13826681
1642563643,195816,true,3135049149,28,3146669735,11620586
1642563666,195812,true,3136303357,28,3146355099,10051742
1642563673,195812,true,3136303357,28,3146040495,9737138
1642563980,195811,true,3136616987,28,3140068992,3452005
1642564057,195813,true,3135989758,28,3138499428,2509670
1642564059,195809,true,3137244342,28,3138499428,1255086
1642564082,195809,true,3137244342,28,3138185609,941267
1642564144,195809,true,3137244342,28,3136616987,-627355
1642564183,195812,true,3136303357,28,3135362654,-940703
1642564240,195809,true,3137244342,28,3134108822,-3135520
1642564531,195810,true,3136930649,28,3125346030,-11584619
1642564537,195809,true,3137244342,28,3125346030,-11898312
1642564582,195812,true,3136303357,28,3124408613,-11894744
1642566088,195808,true,3137558066,28,3107893876,-29664190
1642567697,195809,true,3137244342,28,3109137220,-28107122
1642572134,195808,true,3137558066,28,3109137220,-28420846
1642574203,195811,true,3136616987,28,3101684610,-34932377
1642574217,195807,true,3137871822,28,3101684610,-36187212
1642575299,195807,true,3137871822,28,3101684610,-36187212
1642575846,195807,true,3137871822,28,3101684610,-36187212
1642575962,195810,true,3136930649,28,3101684610,-35246039
1642575985,195806,true,3138185609,28,3101374473,-36811136
1642575994,195806,true,3138185609,28,3101374473,-36811136
1642576022,195807,true,3137871822,28,3101374473,-36497349
1642576057,195811,true,3136616987,28,3101064366,-35552621
1642576164,195808,true,3137558066,28,3100134233,-37423833
1642576326,195809,true,3137244342,28,3097655241,-39589101
1642576340,195810,true,3136930649,28,3097655241,-39275408
1642576360,195814,true,3135676190,28,3097345507,-38330683
1642576400,195811,true,3136616987,28,3096726130,-39890857
1642576570,195813,true,3135989758,28,3093940470,-42049288
1642576622,195814,true,3135676190,28,3093321775,-42354415
1642577150,195819,true,3134108822,28,3084056178,-50052644
1642577381,195817,true,3134735676,28,3079741736,-54993940
1642577428,195819,true,3134108822,28,3078510147,-55598675
1642577459,195820,true,3133795443,28,3077894537,-55900906
1642578400,195825,true,3132229015,28,3064688664,-67540351
1642578431,195823,true,3132855492,28,3064688664,-68166828
1642578568,195826,true,3131915824,28,3063769441,-68146383
1642578819,195828,true,3131289534,28,3061625660,-69663874
1642578835,195833,true,3129724359,28,3061625660,-68098699
1642579310,195831,true,3130350335,28,3059177462,-71172873
1642579913,195833,true,3129724359,28,3058565718,-71158641
1642580338,195835,true,3129098508,28,3058259892,-70838616
1642581241,195839,true,3127847182,28,3059789328,-68057854
1642581276,195837,true,3128472782,28,3059789328,-68683454
1642581308,195839,true,3127847182,28,3059789328,-68057854
1642581350,195841,true,3127221706,28,3059483379,-67738327
1642581909,195846,true,3125658564,28,3057342597,-68315967
1642581923,195844,true,3126283727,28,3057342597,-68941130
1642583188,195846,true,3125658564,28,3056119966,-69538598
1642583212,195848,true,3125033526,28,3056119966,-68913560
1642583310,195853,true,3123471478,28,3057342597,-66128881
1642583951,195852,true,3123783825,28,3062850494,-60933331
1642584215,195853,true,3123471478,28,3064995133,-58476345
1642584279,195855,true,3122846877,28,3065608163,-57238714
1642584362,195861,true,3120973825,28,3066221315,-54752510
1642585143,195860,true,3121285922,28,3072359587,-48926335
1642585260,195861,true,3120973825,28,3072666823,-48307002
1642585328,195863,true,3120349724,28,3072974090,-47375634
1642585611,195868,true,3118790017,28,3074203464,-44586553
1642586216,195867,true,3119101896,28,3076356052,-42745844
1642587415,195868,true,3118790017,28,3080665751,-38124266
1642587526,195871,true,3117854567,28,3080973817,-36880750
1642589015,195877,true,3115984509,28,3080973817,-35010692
1642589042,195876,true,3116296107,28,3080973817,-35322290
1642589053,195877,true,3115984509,28,3080973817,-35010692
1642589065,195880,true,3115049900,28,3080973817,-34076083
1642589141,195887,true,3112870237,28,3080357715,-32512522
1642589174,195887,true,3112870237,28,3080049710,-32820527
1642589304,195888,true,3112558982,28,3078817998,-33740984
1642589982,195892,true,3111314269,28,3072359587,-38954682
1642590039,195899,true,3109137220,28,3072052382,-37084838
1642590081,195899,true,3109137220,28,3071745207,-37392013
1642590231,195900,true,3108826337,28,3071438063,-37388274
1642590291,195903,true,3107893876,28,3071438063,-36455813
1642590339,195910,true,3105719220,28,3071438063,-34281157
1642590486,195910,true,3105719220,28,3072359587,-33359633
1642590607,195911,true,3105408679,28,3072974090,-32434589
1642590739,195913,true,3104787691,28,3074203464,-30584227
1642590752,195920,true,3102615208,28,3074510884,-28104324
1642590828,195920,true,3102615208,28,3075433329,-27181879
1642590852,195920,true,3102615208,28,3075740873,-26874335
1642590882,195922,true,3101994778,28,3076356052,-25638726
1642590910,195928,true,3100134233,28,3076971354,-23162879
1642590916,195927,true,3100444246,28,3077279051,-23165195
1642590927,195927,true,3100444246,28,3077586779,-22857467
1642590931,195928,true,3100134233,28,3077586779,-22547454
1642590951,195934,true,3098274803,28,3078202327,-20072476
1642593830,195933,true,3098584631,28,3115049900,16465269
1642593984,195932,true,3098894489,28,3115361405,16466916
1642595349,195933,true,3098584631,28,3119413806,20829175
1642595357,195939,true,3096726130,28,3119413806,22687676
1642595440,195937,true,3097345507,28,3119725747,22380240
1642597747,195936,true,3097655241,28,3123783825,26128584
1642598135,195937,true,3097345507,28,3125658564,28313057
1642599567,195943,true,3095487750,28,3132229015,36741265
1642599624,195941,true,3096106878,28,3132229015,36122137
1642600036,195940,true,3096416489,28,3132229015,35812526
1642600180,195940,true,3096416489,28,3131915824,35499335
1642600359,195947,true,3094249864,28,3131602663,37352799
1642600552,195945,true,3094868745,28,3131289534,36420789
1642600938,195944,true,3095178232,28,3130350335,35172103
1642601074,195945,true,3094868745,28,3130037332,35168587
1642601288,195951,true,3093012473,28,3128785630,35773157
1642602583,195949,true,3093631107,28,3123471478,29840371
1642602610,195948,true,3093940470,28,3123159162,29218692
1642602622,195948,true,3093940470,28,3123159162,29218692
1642602649,195954,true,3092084755,28,3123471478,31386723
1642602724,195952,true,3092703203,28,3123783825,31080622
1642603053,195950,true,3093321775,28,3125658564,32336789
1642603058,195950,true,3093321775,28,3125658564,32336789
1642603111,195953,true,3092393964,28,3126283727,33889763
1642603322,195950,true,3093321775,28,3128159966,34838191
1642603579,195948,true,3093940470,28,3131289534,37349064
1642603678,195947,true,3094249864,28,3132542238,38292374
1642604220,195950,true,3093321775,28,3139755016,46433241
1642604271,195947,true,3094249864,28,3140382998,46133134
1642604349,195944,true,3095178232,28,3141639340,46461108
1642605912,195943,true,3095487750,28,3151708184,56220434
1642605921,195945,true,3094868745,28,3151708184,56839439
1642606489,195942,true,3095797298,28,3151077937,55280639
1642606550,195938,true,3097035803,28,3150762861,53727058
1642606567,195937,true,3097345507,28,3150762861,53417354
1642606884,195940,true,3096416489,28,3148873065,52456576
1642606913,195938,true,3097035803,28,3148873065,51837262
1642607164,195935,true,3097965007,28,3146984402,49019395
1642607282,195934,true,3098274803,28,3145725923,47451120
1642607296,195936,true,3097655241,28,3145725923,48070682
1642607349,195934,true,3098274803,28,3144782394,46507591
1642607433,195932,true,3098894489,28,3143839148,44944659
1642608622,195931,true,3099204379,28,3128785630,29581251
1642608668,195933,true,3098584631,28,3128159966,29575335
1642608689,195932,true,3098894489,28,3128159966,29265477
1642608853,195930,true,3099514299,28,3124721054,25206755
1642608911,195930,true,3099514299,28,3123471478,23957179
1642608989,195932,true,3098894489,28,3122222402,23327913
1642609020,195930,true,3099514299,28,3121598051,22083752
1642609113,195927,true,3100444246,28,3119413806,18969560
1642609820,195928,true,3100134233,28,3107893876,7759643
1642610197,195930,true,3099514299,28,3102304978,2790679
1642610416,195927,true,3100444246,28,3098894489,-1549757
1642610606,195925,true,3101064366,28,3097345507,-3718859
1642611197,195925,true,3101064366,28,3097345507,-3718859
1642611609,195927,true,3100444246,28,3097655241,-2789005
1642611620,195924,true,3101374473,28,3097655241,-3719232
1642611659,195922,true,3101994778,28,3097965007,-4029771
1642611794,195921,true,3102304978,28,3099204379,-3100599
1642611796,195921,true,3102304978,28,3099204379,-3100599
1642612210,195917,true,3103546086,28,3104787691,1241605
1642612512,195914,true,3104477243,28,3110070054,5592811
1642613166,195913,true,3104787691,28,3123159162,18371471
1642614629,195913,true,3104787691,28,3132855492,28067801
1642614682,195909,true,3106029792,28,3133168778,27138986
1642614854,195906,true,3106961694,28,3134108822,27147128
1642616642,195904,true,3107583118,28,3150132803,42549685
1642616798,195902,true,3108204665,28,3150132803,41928138
1642616962,195898,true,3109448134,28,3150132803,40684669
1642617086,195895,true,3110381061,28,3150132803,39751742
1642617133,195893,true,3111003169,28,3149817821,38814652
1642617318,195892,true,3111314269,28,3148873065,37558796
1642617326,195888,true,3112558982,28,3148873065,36314083
1642619127,195886,true,3113181524,28,3137871822,24690298
1642619468,195884,true,3113804192,28,3136303357,22499165
1642620464,195883,true,3114115572,28,3131602663,17487091
1642621004,195880,true,3115049900,28,3129411418,14361518
1642621724,195879,true,3115361405,28,3129411418,14050013
1642624153,195877,true,3115984509,28,3129098508,13113999
1642624275,195876,true,3116296107,28,3128785630,12489523
1642625482,195873,true,3117231090,28,3123783825,6552735
1642625715,195873,true,3117231090,28,3122222402,4991312
1642625775,195872,true,3117542813,28,3121910211,4367398
1642625941,195871,true,3117854567,28,3120661759,2807192
1642625964,195869,true,3118478169,28,3120349724,1871555
1642626011,195869,true,3118478169,28,3120037720,1559551
1642626059,195868,true,3118790017,28,3119725747,935730
1642631048,195867,true,3119101896,28,3115361405,-3740491
1642631096,195865,true,3119725747,28,3115361405,-4364342
1642631158,195865,true,3119725747,28,3115672942,-4052805
1642631188,195864,true,3120037720,28,3115672942,-4364778
1642632067,195862,true,3120661759,28,3117854567,-2807192
1642636080,195859,true,3121598051,28,3119725747,-1872304
1642636107,195859,true,3121598051,28,3119725747,-1872304
1642636223,195858,true,3121910211,28,3118790017,-3120194
1642636241,195855,true,3122846877,28,3118790017,-4056860
1642636274,195855,true,3122846877,28,3118166352,-4680525
1642637559,195855,true,3122846877,28,3101684610,-21162267
1642637597,195855,true,3122846877,28,3101064366,-21782511
1642637945,195853,true,3123471478,28,3097965007,-25506471
1642638325,195853,true,3123471478,28,3099204379,-24267099
1642638845,195853,true,3123471478,28,3101994778,-21476700
1642638921,195854,true,3123159162,28,3102615208,-20543954
1642641769,195851,true,3124096204,28,3112247757,-11848447
1642641897,195851,true,3124096204,28,3112247757,-11848447
1642641975,195852,true,3123783825,28,3112247757,-11536068
1642642140,195853,true,3123471478,28,3112247757,-11223721
1642642295,195851,true,3124096204,28,3111936563,-12159641
1642643647,195852,true,3123783825,28,3107272390,-16511435
1642644049,195853,true,3123471478,28,3106029792,-17441686
1642644127,195854,true,3123159162,28,3106340395,-16818767
1642644145,195851,true,3124096204,28,3106340395,-17755809
1642644242,195852,true,3123783825,28,3106651029,-17132796
1642644298,195853,true,3123471478,28,3106961694,-16509784
1642645950,195854,true,3123159162,28,3115672942,-7486220
1642645984,195852,true,3123783825,28,3115672942,-8110883
1642646029,195853,true,3123471478,28,3115672942,-7798536
1642646350,195854,true,3123159162,28,3116607737,-6551425
1642650079,195854,true,3123159162,28,3120661759,-2497403
1642651402,195852,true,3123783825,28,3120661759,-3122066
1642651695,195854,true,3123159162,28,3121285922,-1873240
1642651863,195855,true,3122846877,28,3121910211,-936666
1642653814,195855,true,3122846877,28,3126909015,4062138
1642656293,195853,true,3123471478,28,3127221706,3750228
1642656475,195854,true,3123159162,28,3127221706,4062544
1642656886,195855,true,3122846877,28,3126596355,3749478
1642656996,195855,true,3122846877,28,3126283727,3436850
1642657475,195853,true,3123471478,28,3125658564,2187086
1642657846,195854,true,3123159162,28,3125033526,1874364
1642658844,195855,true,3122846877,28,3124408613,1561736
1642658926,195855,true,3122846877,28,3124721054,1874177
1642658981,195853,true,3123471478,28,3124721054,1249576
1642659065,195855,true,3122846877,28,3125346030,2499153
1642659501,195855,true,3122846877,28,3127534428,4687551
1642659623,195855,true,3122846877,28,3128159966,5313089
1642659682,195853,true,3123471478,28,3128472782,5001304
1642659709,195855,true,3122846877,28,3128472782,5625905
1642660114,195856,true,3122534624,28,3130976437,8441813
1642660253,195856,true,3122534624,28,3131602663,9068039
1642660258,195854,true,3123159162,28,3131915824,8756662
1642660338,195856,true,3122534624,28,3132229015,9694391
1642661949,195857,true,3122222402,28,3140382998,18160596
1642663245,195857,true,3122222402,28,3140697037,18474635
1642664543,195855,true,3122846877,28,3140697037,17850160
1642665710,195857,true,3122222402,28,3142581926,20359524
1642666577,195858,true,3121910211,28,3143210474,21300263
1642666592,195858,true,3121910211,28,3143210474,21300263
1642666970,195856,true,3122534624,28,3142581926,20047302
1642667009,195858,true,3121910211,28,3142267699,20357488
1642667286,195858,true,3121910211,28,3141011107,19100896
1642669965,195859,true,3121598051,28,3131602663,10004612
1642670563,195856,true,3122534624,28,3131602663,9068039
1642671512,195858,true,3121910211,28,3129098508,7188297
1642671792,195858,true,3121910211,28,3128159966,6249755
1642671822,195858,true,3121910211,28,3128159966,6249755
1642671853,195856,true,3122534624,28,3128159966,5625342
1642671880,195858,true,3121910211,28,3128159966,6249755
1642671912,195857,true,3122222402,28,3128159966,5937564
1642671914,195856,true,3122534624,28,3128159966,5625342
1642672611,195853,true,3123471478,28,3130663370,7191892
1642673683,195854,true,3123159162,28,3138185609,15026447
1642675779,195853,true,3123471478,28,3139441072,15969594
1642675963,195851,true,3124096204,28,3139441072,15344868
1642676709,195848,true,3125033526,28,3139441072,14407546
1642677089,195849,true,3124721054,28,3140068992,15347938
1642677350,195848,true,3125033526,28,3140382998,15349472
1642677444,195846,true,3125658564,28,3140697037,15038473
1642679927,195843,true,3126596355,28,3142267699,15671344
1642679971,195844,true,3126283727,28,3142581926,16298199
1642681355,195843,true,3126596355,28,3145096872,18500517
1642681375,195841,true,3127221706,28,3145096872,17875166
1642681418,195839,true,3127847182,28,3145096872,17249690
1642681912,195841,true,3127221706,28,3144782394,17560688
1642682044,195840,true,3127534428,28,3144467947,16933519
1642682767,195840,true,3127534428,28,3142896184,15361756
1642682942,195838,true,3128159966,28,3142267699,14107733
1642685259,195840,true,3127534428,28,3138499428,10965000
1642685561,195840,true,3127534428,28,3138499428,10965000
1642685654,195840,true,3127534428,28,3138813278,11278850
1642685685,195839,true,3127847182,28,3138813278,10966096
1642685696,195841,true,3127221706,28,3138813278,11591572
1642685708,195841,true,3127221706,28,3139127159,11905453
1642685717,195840,true,3127534428,28,3139127159,11592731
1642686102,195837,true,3128472782,28,3143839148,15366366
1642686125,195839,true,3127847182,28,3144153531,16306349
1642686357,195838,true,3128159966,28,3146984402,18824436
1642686498,195837,true,3128472782,28,3149187952,20715170
1642686508,195834,true,3129411418,28,3149187952,19776534
1642686512,195836,true,3128785630,28,3149187952,20402322
1642686580,195834,true,3129411418,28,3150447816,21036398
1642686890,195833,true,3129724359,28,3155807864,26083505
1642687200,195829,true,3130976437,28,3161809298,30832861
1642687217,195831,true,3130350335,28,3162125479,31775144
1642687691,195828,true,3131289534,28,3171308493,40018959
1642688184,195826,true,3131915824,28,3177657139,45741315
1642689054,195822,true,3133168778,28,3185929383,52760605
1642689099,195823,true,3132855492,28,3185929383,53073891
1642689112,195820,true,3133795443,28,3185929383,52133940
1642689136,195818,true,3134422233,28,3186247976,51825743
1642689166,195813,true,3135989758,28,3186247976,50258218
1642689177,195815,true,3135362654,28,3186566601,51203947
1642689178,195811,true,3136616987,28,3186566601,49949614
1642689225,195809,true,3137244342,28,3186885258,49640916
1642689339,195804,true,3138813278,28,3187841419,49028141
1642689433,195805,true,3138499428,28,3188797867,50298439
1642689749,195802,true,3139441072,28,3191668933,52227861
1642690177,195799,true,3140382998,28,3196140175,55757177
1642690315,195795,true,3141639340,28,3197418823,55779483
1642690388,195794,true,3141953504,28,3198058339,56104835
1642690494,195790,true,3143210474,28,3199337754,56127280
1642690638,195787,true,3144153531,28,3201257837,57104306
1642690652,195782,true,3145725923,28,3201577963,55852040
1642690653,195782,true,3145725923,28,3201577963,55852040
1642690856,195778,true,3146984402,28,3204460536,57476134
1642691042,195774,true,3148243384,28,3207025002,58781618
1642691081,195770,true,3149502871,28,3207345704,57842833
1642691097,195770,true,3149502871,28,3207345704,57842833
1642691117,195766,true,3150762861,28,3207666439,56903578
1642691151,195762,true,3152023355,28,3207987205,55963850
1642691224,195757,true,3153599682,28,3209270593,55670911
1642691251,195756,true,3153915042,28,3209591520,55676478
1642691258,195752,true,3155176797,28,3209591520,54414723
1642691326,195748,true,3156439057,28,3210875549,54436492
1642691334,195743,true,3158017592,28,3211196636,53179044
1642691337,195742,true,3158333394,28,3211196636,52863242
1642693664,195737,true,3159912877,28,3248011886,88099009
1642694050,195733,true,3161177031,28,3248336687,87159656
1642694170,195728,true,3162757936,28,3248336687,85578751
1642694346,195727,true,3163074212,28,3248986387,85912175
1642694585,195722,true,3164656065,28,3250611205,85955140
1642694628,195718,true,3165922118,28,3250936266,85014148
1642694999,195713,true,3167505395,28,3253863279,86357884
1642695007,195712,true,3167822146,28,3253863279,86041133
1642695113,195706,true,3169723314,28,3254514084,84790770
1642695317,195702,true,3170991394,28,3255816085,84824691
1642695502,195698,true,3172259981,28,3256792928,84532947
1642695618,195697,true,3172577207,28,3257118607,84541400
1642695634,195691,true,3174481229,28,3257444319,82963090
1642695954,195688,true,3175433669,28,3258095840,82662171
1642695961,195683,true,3177021703,28,3258095840,81074137
1642695970,195682,true,3177339405,28,3258421650,81082245
1642696030,195677,true,3178928393,28,3258095840,79167447
1642697314,195674,true,3179882167,28,3250936266,71054099
1642697552,195669,true,3181472426,28,3249961180,68488754
1642700439,195668,true,3181790573,28,3249311285,67520712
1642700478,195664,true,3183063480,28,3249311285,66247805
1642700765,195661,true,3184018495,28,3248986387,64967892
1642700879,195656,true,3185610822,28,3248661520,63050698
1642701001,195656,true,3185610822,28,3248661520,63050698
1642701013,195651,true,3187203946,28,3248661520,61457574
1642701084,195649,true,3187841419,28,3248336687,60495268
1642701906,195645,true,3189116747,28,3243792424,54675677
1642701917,195644,true,3189435658,28,3243792424,54356766
1642702054,195640,true,3190711624,28,3242819481,52107857
1642702088,195638,true,3191349798,28,3242171015,50821217
1642702441,195634,true,3192626530,28,3238930626,46304096
1642703197,195634,true,3192626530,28,3233752739,41126209
1642703597,195630,true,3193903772,28,3232782808,38879036
1642705169,195628,true,3194542585,28,3231166901,36624316
1642705209,195624,true,3195820593,28,3231166901,35346308
1642705879,195624,true,3195820593,28,3225678858,29858265
1642705888,195620,true,3197099113,28,3225678858,28579745
1642706832,195617,true,3198058339,28,3228583130,30524791
1642707117,195613,true,3199337754,28,3230520764,31183010
1642707229,195612,true,3199657688,28,3231490018,31832330
1642707453,195608,true,3200937743,28,3233106086,32168343
1642707477,195605,true,3201898120,28,3233106086,31207966
1642707956,195602,true,3202858786,28,3233106086,30247300
1642708025,195601,true,3203179072,28,3232782808,29603736
1642708202,195597,true,3204460536,28,3231813167,27352631
1642708570,195594,true,3205421970,28,3230197745,24775775
1642708712,195592,true,3206063086,28,3229228879,23165793
1642708920,195591,true,3206383693,28,3228260304,21876611
1642708945,195588,true,3207345704,28,3227937510,20591806
1642709152,195585,true,3208308004,28,3227292020,18984016
1642709302,195582,true,3209270593,28,3226324026,17053433
1642709510,195582,true,3209270593,28,3225678858,16408265
1642710412,195579,true,3210233470,28,3219878148,9644678
1642710421,195576,true,3211196636,28,3219878148,8681512
1642710739,195574,true,3211838908,28,3216660040,4821132
1642711108,195574,true,3211838908,28,3212802556,963648
1642711178,195572,true,3212481308,28,3211838908,-642400
1642711241,195569,true,3213445149,28,3211517756,-1927393
1642711476,195567,true,3214087870,28,3209591520,-4496350
1642711525,195567,true,3214087870,28,3208949698,-5138172
1642712115,195565,true,3214730719,28,3203179072,-11551647
1642712150,195562,true,3215695235,28,3202858786,-12836449
1642713396,195561,true,3216016805,28,3195820593,-20196212
1642713433,195561,true,3216016805,28,3195820593,-20196212
1642713930,195559,true,3216660040,28,3194223162,-22436878
1642713982,195556,true,3217625135,28,3193903772,-23721363
1642714169,195555,true,3217946897,28,3193265087,-24681810
1642714186,195555,true,3217946897,28,3192945792,-25001105
1642714213,195554,true,3218268692,28,3192945792,-25322900
1642714227,195552,true,3218912378,28,3192945792,-25966586
1642714243,195553,true,3218590519,28,3192626530,-25963989
1642714246,195553,true,3218590519,28,3192626530,-25963989
1642714522,195552,true,3218912378,28,3190392585,-28519793
1642714539,195550,true,3219556192,28,3190392585,-29163607
1642714566,195551,true,3219234269,28,3190073578,-29160691
1642714665,195551,true,3219234269,28,3189116747,-30117522
1642714685,195551,true,3219234269,28,3188797867,-30436402
1642714763,195549,true,3219878148,28,3187841419,-32036729
1642714769,195550,true,3219556192,28,3187841419,-31714773
1642714797,195551,true,3219234269,28,3187522667,-31711602
1642714811,195551,true,3219234269,28,3187203946,-32030323
1642714830,195551,true,3219234269,28,3186885258,-32349011
1642714838,195552,true,3218912378,28,3186566601,-32345777
1642714850,195553,true,3218590519,28,3186566601,-32023918
1642714907,195555,true,3217946897,28,3184973796,-32973101
1642714940,195555,true,3217946897,28,3184018495,-33928402
1642715005,195557,true,3217303404,28,3182108752,-35194652
1642715048,195559,true,3216660040,28,3180836227,-35823813
1642715071,195561,true,3216016805,28,3180200155,-35816650
1642715115,195561,true,3216016805,28,3178610532,-37406273
1642715127,195564,true,3215052192,28,3178292702,-36759490
1642715189,195566,true,3214409278,28,3176068787,-38340491
1642715285,195569,true,3213445149,28,3172577207,-40867942
1642715341,195570,true,3213123836,28,3170674326,-42449510
1642715346,195573,true,3212160092,28,3170357291,-41802801
1642715656,195575,true,3211517756,28,3156754701,-54763055
1642715705,195579,true,3210233470,28,3154861311,-55372159
1642715727,195580,true,3209912479,28,3153599682,-56312797
1642715797,195583,true,3208949698,28,3150762861,-58186837
1642715814,195587,true,3207666439,28,3149817821,-57848618
1642715829,195591,true,3206383693,28,3149187952,-57195741
1642715962,195593,true,3205742512,28,3142581926,-63160586
1642716015,195597,true,3204460536,28,3139755016,-64705520
1642716019,195600,true,3203499390,28,3139441072,-64058318
1642716050,195605,true,3201898120,28,3137871822,-64026298
1642716172,195609,true,3200617681,28,3130976437,-69641244
1642716188,195613,true,3199337754,28,3130037332,-69300422
1642716190,195617,true,3198058339,28,3130037332,-68021007
1642716570,195620,true,3197099113,28,3112870237,-84228876
1642716675,195624,true,3195820593,28,3108515486,-87305107
1642716759,195629,true,3194223162,28,3105719220,-88503942
1642716993,195633,true,3192945792,28,3098584631,-94361161
1642717100,195639,true,3191030695,28,3095487750,-95542945
1642717583,195643,true,3189754602,28,3084981487,-104773115
1642717585,195648,true,3188160203,28,3084981487,-103178716
1642718463,195653,true,3186566601,28,3078817998,-107748603
1642718467,195658,true,3184973796,28,3078817998,-106155798
1642718578,195663,true,3183381786,28,3078202327,-105179459
1642718628,195669,true,3181472426,28,3077586779,-103885647
1642718652,195674,true,3179882167,28,3077279051,-102603116
1642718663,195680,true,3177974905,28,3077279051,-100695854
1642718852,195686,true,3176068787,28,3075433329,-100635458
1642718868,195691,true,3174481229,28,3075125817,-99355412
1642719075,195698,true,3172259981,28,3071130950,-101129031
1642719142,195704,true,3170357291,28,3069902805,-100454486
1642719153,195710,true,3168455742,28,3069595845,-98859897
1642719179,195716,true,3166555334,28,3069288916,-97266418
1642719394,195721,true,3164972531,28,3066527937,-98444594
1642719493,195727,true,3163074212,28,3065301632,-97772580
1642719782,195732,true,3161493149,28,3061625660,-99867489
1642719815,195738,true,3159596917,28,3061013427,-98583490
1642719852,195743,true,3158017592,28,3060401316,-97616276
1642719940,195749,true,3156123445,28,3058565718,-97557727
1642720338,195755,true,3154230433,28,3052455005,-101775428
1642720499,195760,true,3152653791,28,3050929235,-101724556
1642720583,195765,true,3151077937,28,3050319141,-100758796
1642720698,195771,true,3149187952,28,3049404228,-99783724
1642720767,195778,true,3146984402,28,3049404228,-97580174
1642720978,195783,true,3145411382,28,3048184771,-97226611
1642721015,195789,true,3143524795,28,3047270499,-96254296
1642721145,195796,true,3141325208,28,3044224903,-97100305
1642721277,195803,true,3139127159,28,3041486470,-97640689
1642721367,195808,true,3137558066,28,3039662217,-97895849
1642721657,195813,true,3135989758,28,3034196019,-101793739
1642721685,195820,true,3133795443,28,3033892630,-99902813
1642722327,195827,true,3131602663,28,3020875549,-110727114
1642722350,195833,true,3129724359,28,3020271465,-109452894
1642722548,195838,true,3128159966,28,3017856335,-110303631
1642722690,195844,true,3126283727,28,3016347859,-109935868
1642722899,195852,true,3123783825,28,3014840137,-108943688
1642722999,195858,true,3121910211,28,3013935866,-107974345
1642723124,195864,true,3120037720,28,3012128138,-107909582
1642723159,195871,true,3117854567,28,3011525802,-106328765
1642723162,195879,true,3115361405,28,3011525802,-103835603
1642723167,195885,true,3113492843,28,3011525802,-101967041
1642723188,195891,true,3111625401,28,3010923587,-100701814
1642723202,195898,true,3109448134,28,3010923587,-98524547
1642723216,195906,true,3106961694,28,3010622525,-96339169
1642723241,195912,true,3105098170,28,3010321493,-94776677
1642723388,195918,true,3103235763,28,3008215111,-95020652
1642723431,195925,true,3101064366,28,3007312827,-93751539
1642723516,195933,true,3098584631,28,3005809621,-92775010
1642723534,195939,true,3096726130,28,3005509070,-91217060
1642723777,195945,true,3094868745,28,3001904803,-92963942
1642723927,195952,true,3092703203,28,2999804309,-92898894
1642723969,195960,true,3090230154,28,2999204439,-91025715
1642724010,195965,true,3088685502,28,2998904548,-89780954
1642724023,195972,true,3086524287,28,2997705286,-88819001
1642724110,195977,true,3084981487,28,2996806154,-88175333
1642724808,195985,true,3082514612,28,2989622802,-92891810
1642724818,195990,true,3080973817,28,2989622802,-91351015
1642724853,195996,true,3079125880,28,2989921765,-89204115
1642724877,196001,true,3077586779,28,2990220757,-87366022
1642724934,196007,true,3075740873,28,2990519779,-85221094
1642724955,196011,true,3074510884,28,2990818831,-83692053
1642725333,196017,true,3072666823,28,2995907292,-76759531
1642725370,196022,true,3071130950,28,2996806154,-74324796
1642725409,196027,true,3069595845,28,2997405546,-72190299
1642725721,196031,true,3068368314,28,3003706396,-64661918
1642725775,196036,true,3066834590,28,3004607598,-62226992
1642725827,196040,true,3065608163,28,3006410813,-59197350
1642726621,196046,true,3063769441,28,3019969468,-43799973
1642726685,196050,true,3062544240,28,3020573492,-41970748
1642726857,196055,true,3061013427,28,3021479755,-39533672
1642727071,196059,true,3059789328,28,3021781903,-38007425
1642727098,196064,true,3058259892,28,3021781903,-36477989
1642727168,196068,true,3057036894,28,3021781903,-35254991
1642727282,196074,true,3055203313,28,3021177637,-34025676
1642727320,196078,true,3053981538,28,3020875549,-33105989
1642727365,196083,true,3052455005,28,3020271465,-32183540
1642727443,196088,true,3050929235,28,3019063658,-31865577
1642727453,196094,true,3049099318,28,3018761782,-30337536
1642727955,196098,true,3047879983,28,3010020491,-37859492
1642728031,196104,true,3046051895,28,3008816784,-37235111
1642728047,196109,true,3044529326,28,3008515932,-36013394
1642728751,196113,true,3043311818,28,2998604688,-44707130
1642728814,196117,true,3042094798,28,2997705286,-44389512
1642728836,196122,true,3040574207,28,2997405546,-43168661
1642728917,196126,true,3039358281,28,2996206883,-43151398
1642728930,196131,true,3037839058,28,2995907292,-41931766
1642728999,196135,true,3036624226,28,2995008700,-41615526
1642729103,196140,true,3035106369,28,2992314539,-42791830
1642729124,196145,true,3033589271,28,2992015338,-41573933
1642729173,196151,true,3031769754,28,2990818831,-40950923
1642729179,196154,true,3030860405,28,2990818831,-40041574
1642729202,196160,true,3029042526,28,2990220757,-38821769
1642729214,196165,true,3027528458,28,2989921765,-37606693
1642729426,196170,true,3026015148,28,2985141954,-40873194
1642729449,196174,true,3024805045,28,2984545015,-40260030
1642729610,196180,true,3022990797,28,2980369784,-42621013
1642729780,196185,true,3021479755,28,2974415298,-47064457
1642729844,196191,true,3019667501,28,2971442518,-48224983
1642729938,196195,true,3018459936,28,2966988918,-51471018
1642729942,196201,true,3016649494,28,2966692249,-49957245
1642729954,196207,true,3014840137,28,2966099000,-48741137
1642729983,196213,true,3013031866,28,2964616395,-48415471
1642730052,196217,true,3011826955,28,2961357273,-50469682
1642730072,196223,true,3010020491,28,2960173026,-49847465
1642730107,196228,true,3008515932,28,2958397544,-50118388
1642730211,196234,true,3006711454,28,2953372791,-53338663
1642730235,196239,true,3005208549,28,2952191737,-53016812
1642730245,196245,true,3003406055,28,2951601388,-51804667
1642730306,196250,true,3001904803,28,2948356573,-53548230
1642730328,196257,true,2999804309,28,2946882837,-52921472
1642730444,196262,true,2998304857,28,2940113133,-58191724
1642730477,196267,true,2996806154,28,2938349683,-58456471
1642730484,196273,true,2995008700,28,2938055877,-56952823
1642730532,196279,true,2993212323,28,2935412948,-57799375
1642730569,196283,true,2992015338,28,2933652317,-58363021
1642730580,196288,true,2990519779,28,2933065674,-57454105
1642730602,196294,true,2988726095,28,2931892741,-56833354
1642730640,196298,true,2987530903,28,2930427235,-57103668
1642730720,196301,true,2986634823,28,2927498419,-59136404
1642730778,196305,true,2985440468,28,2925157473,-60282995
1642730830,196311,true,2983649830,28,2922818400,-60831430
1642730888,196315,true,2982456669,28,2920773245,-61683424
1642730943,196318,true,2981562111,28,2919021395,-62540716
1642731040,196321,true,2980667821,28,2916687228,-63980593
1642731068,196327,true,2978880046,28,2915812397,-63067649
1642731206,196332,true,2977391053,28,2912898187,-64492866
1642731303,196337,true,2975902804,28,2908823187,-67079617
1642731311,196341,true,2974712740,28,2908532334,-66180406
1642731335,196347,true,2972928537,28,2907950714,-64977823
1642731390,196352,true,2971442518,28,2906787825,-64654693
1642731405,196355,true,2970551264,28,2906497175,-64054089
1642731456,196358,true,2969660277,28,2905625400,-64034877
1642731538,196364,true,2967879104,28,2904463441,-63415663
1642731540,196370,true,2966099000,28,2904463441,-61635559
1642731574,196372,true,2965505869,28,2903882635,-61623234
1642731604,196375,true,2964616395,28,2903882635,-60733760
1642731624,196380,true,2963134531,28,2903592276,-59542255
1642731631,196385,true,2961653408,28,2903592276,-58061132
1642731648,196386,true,2961357273,28,2903592276,-57764997
1642731681,196390,true,2960173026,28,2903301946,-56871080
1642731711,196394,true,2958989253,28,2903011645,-55977608
1642731733,196400,true,2957214480,28,2902721372,-54493108
1642731747,196402,true,2956623126,28,2902721372,-53901754
1642731750,196405,true,2955736317,28,2902721372,-53014945
1642731803,196408,true,2954849773,28,2902721372,-52128401
1642731810,196413,true,2953372791,28,2902721372,-50651419
1642731838,196414,true,2953077483,28,2902721372,-50356111
1642731868,196416,true,2952486957,28,2903301946,-49185011
1642731899,196418,true,2951896548,28,2903882635,-48013913
1642731977,196421,true,2951011156,28,2905334867,-45676289
1642732000,196422,true,2950716084,28,2905334867,-45381217
1642732014,196423,true,2950421042,28,2905625400,-44795642
1642732038,196424,true,2950126030,28,2906206555,-43919475
1642732085,196429,true,2948651409,28,2906787825,-41863584
1642732086,196429,true,2948651409,28,2906787825,-41863584
1642732249,196430,true,2948356573,28,2911151060,-37205513
1642732268,196432,true,2947766990,28,2911442175,-36324815
1642732293,196436,true,2946588178,28,2912024493,-34563685
1642732351,196436,true,2946588178,28,2912898187,-33689991
1642732796,196437,true,2946293549,28,2918145863,-28147686
1642732984,196439,true,2945704379,28,2920481197,-25223182
1642733005,196443,true,2944526391,28,2920773245,-23753146
1642733158,196443,true,2944526391,28,2923987703,-20538688
1642733173,196445,true,2943937574,28,2923987703,-19949871
1642733500,196447,true,2943348875,28,2926327712,-17021163
1642733534,196451,true,2942171830,28,2926327712,-15844118
1642733620,196452,true,2941877642,28,2926620345,-15257297
1642733667,196454,true,2941289355,28,2926327712,-14961643
1642733721,196457,true,2940407145,28,2925742534,-14664611
1642733790,196461,true,2939231276,28,2924572530,-14658746
1642733902,196461,true,2939231276,28,2923695333,-15535943
1642733984,196465,true,2938055877,28,2922526147,-15529730
1642734009,196468,true,2937174636,28,2921941730,-15232906
1642734032,196473,true,2935706490,28,2921357429,-14349061
1642734053,196475,true,2935119436,28,2921065323,-14054113
1642734122,196480,true,2933652317,28,2919313297,-14339020
1642734178,196483,true,2932772397,28,2918437678,-14334719
1642734325,196488,true,2931306451,28,2916395588,-14910863
1642734338,196489,true,2931013349,28,2916103978,-14909371
1642734359,196494,true,2929548282,28,2915520845,-14027437
1642734372,196498,true,2928376756,28,2915229322,-13147434
1642734471,196504,true,2926620345,28,2912898187,-13722158
1642734487,196505,true,2926327712,28,2912606927,-13720785
1642734633,196510,true,2924864987,28,2909114069,-15750918
1642734645,196513,true,2923987703,28,2908823187,-15164516
1642734699,196520,true,2921941730,28,2907078504,-14863226
1642734800,196522,true,2921357429,28,2903592276,-17765153
1642734830,196527,true,2919897189,28,2902431129,-17466060
1642734967,196530,true,2919021395,28,2898660609,-20360786
1642735059,196536,true,2917270595,28,2896342723,-20927872
1642735123,196537,true,2916978897,28,2894605526,-22373371
1642735594,196542,true,2915520845,28,2882474283,-33046562
1642735607,196545,true,2914646363,28,2882186064,-32460299
1642735624,196551,true,2912898187,28,2881609713,-31288474
1642735718,196553,true,2912315695,28,2878441844,-33873851
1642735750,196560,true,2910277889,28,2877290755,-32987134
1642735754,196563,true,2909404981,28,2877003054,-32401927
1642735852,196569,true,2907659948,28,2873552894,-34107054
1642735876,196571,true,2907078504,28,2872691000,-34387504
1642735908,196578,true,2905044362,28,2871542211,-33502151
1642735916,196580,true,2904463441,28,2871255086,-33208355
1642735933,196586,true,2902721372,28,2870680921,-32040451
1642735965,196588,true,2902140915,28,2869246011,-32894904
1642736049,196593,true,2900690280,28,2866091733,-34598547
1642736058,196595,true,2900110229,28,2865805152,-34305077
1642736109,196601,true,2898370772,28,2863227217,-35143555
1642736111,196603,true,2897791184,28,2863227217,-34563967
1642736114,196609,true,2896053118,28,2862940923,-33112195
1642736128,196612,true,2895184476,28,2861796033,-33388443
1642736215,196616,true,2894026692,28,2858364109,-35662583
1642736227,196617,true,2893737318,28,2858078301,-35659017
1642736293,196622,true,2892290883,28,2855792867,-36498016
1642736362,196623,true,2892001683,28,2853794611,-38207072
1642736531,196626,true,2891134256,28,2850087274,-41046982
1642736549,196626,true,2891134256,28,2849802294,-41331962
1642736605,196630,true,2889978091,28,2849232419,-40745672
1642736819,196630,true,2889978091,28,2846954058,-43024033
1642736831,196633,true,2889111271,28,2846954058,-42157213
1642736907,196633,true,2889111271,28,2846100143,-43011128
1642736972,196637,true,2887955916,28,2845246483,-42709433
1642737149,196638,true,2887667149,28,2842402801,-45264348
1642737272,196640,true,2887089702,28,2840129902,-46959800
1642737312,196640,true,2887089702,28,2839561961,-47527741
1642737354,196645,true,2885646590,28,2838710263,-46936327
1642737372,196646,true,2885358054,28,2838142606,-47215448
1642737387,196648,true,2884781069,28,2838142606,-46638463
1642737421,196649,true,2884492620,28,2837291333,-47201287
1642737583,196654,true,2883050806,28,2835589554,-47461252
1642737585,196655,true,2882762530,28,2835589554,-47172976
1642737609,196658,true,2881897874,28,2835306024,-46591850
1642737629,196660,true,2881321581,28,2835306024,-46015557
1642737660,196664,true,2880169341,28,2835306024,-44863317
1642737668,196665,true,2879881352,28,2835306024,-44575328
1642737734,196667,true,2879305463,28,2835873113,-43432350
1642737761,196668,true,2879017561,28,2835873113,-43144448
1642737786,196672,true,2877866242,28,2835873113,-41993129
1642737792,196673,true,2877578484,28,2835873113,-41705371
1642737980,196675,true,2877003054,28,2838994134,-38008920
1642738047,196674,true,2877290755,28,2840129902,-37160853
1642738059,196678,true,2876140126,28,2840413915,-35726211
1642738062,196678,true,2876140126,28,2840413915,-35726211
1642738231,196678,true,2876140126,28,2842687041,-33453085
1642739820,196680,true,2875564984,28,2857792522,-17772462
1642739872,196684,true,2874415046,28,2857792522,-16622524
1642740008,196684,true,2874415046,28,2858649945,-15765101
1642740178,196683,true,2874702487,28,2859793577,-14908910
1642741219,196684,true,2874415046,28,2866951646,-7463400
1642741902,196688,true,2873265567,28,2867811818,-5453749
1642742174,196688,true,2873265567,28,2866664980,-6600587
1642742245,196688,true,2873265567,28,2866378342,-6887225
1642742281,196689,true,2872978269,28,2866378342,-6599927
1642742364,196693,true,2871829365,28,2866091733,-5737632
1642742378,196693,true,2871829365,28,2866091733,-5737632
1642742395,196692,true,2872116548,28,2865805152,-6311396
1642742433,196693,true,2871829365,28,2865805152,-6024213
1642742592,196697,true,2870680921,28,2864659117,-6021804
1642742673,196698,true,2870393881,28,2864086271,-6307610
1642742712,196698,true,2870393881,28,2863799891,-6593990
1642742758,196700,true,2869819889,28,2863227217,-6592672
1642743494,196704,true,2868672248,28,2858649945,-10022303
1642743632,196707,true,2867811818,28,2858364109,-9447709
1642743813,196708,true,2867525065,28,2858364109,-9160956
1642743942,196710,true,2866951646,28,2858364109,-8587537
1642744696,196713,true,2866091733,28,2861509882,-4581851
1642744857,196716,true,2865232077,28,2862654657,-2577420
1642744934,196716,true,2865232077,28,2862940923,-2291154
1642745864,196718,true,2864659117,28,2863227217,-1431900
1642746051,196722,true,2863513540,28,2862654657,-858883
1642746972,196725,true,2862654657,28,2860079556,-2575101
1642747028,196725,true,2862654657,28,2859793577,-2861080
1642747086,196727,true,2862082212,28,2859507626,-2574586
1642747123,196732,true,2860651600,28,2858364109,-2287491
1642747146,196736,true,2859507626,28,2858364109,-1143517
1642747211,196736,true,2859507626,28,2858078301,-1429325
1642747442,196738,true,2858935810,28,2856649690,-2286120
1642747621,196741,true,2858078301,28,2855792867,-2285434
1642747771,196745,true,2856935355,28,2854650835,-2284520
1642748391,196745,true,2856935355,28,2849802294,-7133061
1642748425,196746,true,2856649690,28,2849517342,-7132348
1642748440,196749,true,2855792867,28,2849232419,-6560448
1642748515,196753,true,2854650835,28,2848947524,-5703311
1642748605,196752,true,2854936300,28,2848662658,-6273642
1642748655,196754,true,2854365399,28,2848377820,-5987579
1642748658,196757,true,2853509260,28,2848377820,-5131440
1642748859,196761,true,2852368142,28,2846954058,-5414084
1642748913,196760,true,2852653379,28,2847523477,-5129902
1642749046,196761,true,2852368142,28,2847238753,-5129389
1642749224,196763,true,2851797754,28,2846954058,-4843696
1642749299,196767,true,2850657320,28,2846954058,-3703262
1642749535,196767,true,2850657320,28,2847523477,-3133843
1642750001,196767,true,2850657320,28,2849802294,-855026
1642750601,196769,true,2850087274,28,2852368142,2280868
1642750790,196773,true,2848947524,28,2853223938,4276414
1642751067,196771,true,2849517342,28,2854650835,5133493
1642751124,196771,true,2849517342,28,2854936300,5418958
1642751164,196773,true,2848947524,28,2855221794,6274270
1642751281,196777,true,2847808230,28,2856364054,8555824
1642751313,196773,true,2848947524,28,2856649690,7702166
1642751356,196772,true,2849232419,28,2857221049,7988630
1642751393,196773,true,2848947524,28,2857792522,8844998
1642751804,196775,true,2848377820,28,2864945583,16567763
1642752430,196771,true,2849517342,28,2875852541,26335199
1642752763,196770,true,2849802294,28,2881609713,31807419
1642752851,196770,true,2849802294,28,2883050806,33248512
1642753849,196772,true,2849232419,28,2887955916,38723497
1642755807,196768,true,2850372282,28,2889111271,38738989
1642756069,196767,true,2850657320,28,2889111271,38453951
1642756671,196766,true,2850942385,28,2887667149,36724764
1642756938,196768,true,2850372282,28,2885358054,34985772
1642758671,196764,true,2851512602,28,2881033478,29520876
1642759214,196762,true,2852082933,28,2881033478,28950545
1642759241,196760,true,2852653379,28,2881033478,28380099
1642759636,196762,true,2852082933,28,2879017561,26934628
1642759745,196758,true,2853223938,28,2878441844,25217906
1642759962,196757,true,2853509260,28,2877290755,23781495
1642760143,196756,true,2853794611,28,2876140126,22345515
1642760375,196757,true,2853509260,28,2875564984,22055724
1642760632,196753,true,2854650835,28,2874702487,20051652
1642760972,196751,true,2855221794,28,2873840249,18618455
1642762488,196749,true,2855792867,28,2876140126,20347259
1642762603,196749,true,2855792867,28,2876140126,20347259
1642762983,196744,true,2857221049,28,2875852541,18631492
1642763190,196743,true,2857506771,28,2875564984,18058213
1642763350,196742,true,2857792522,28,2874989958,17197436
1642763935,196743,true,2857506771,28,2871255086,13748315
1642763990,196740,true,2858364109,28,2870967989,12603880
1642764034,196739,true,2858649945,28,2870393881,11743936
1642764059,196739,true,2858649945,28,2870106871,11456926
1642764089,196741,true,2858078301,28,2869819889,11741588
1642764445,196740,true,2858364109,28,2865805152,7441043
1642764581,196739,true,2858649945,28,2864086271,5436326
1642764862,196738,true,2858935810,28,2860365564,1429754
1642765067,196740,true,2858364109,28,2857221049,-1143060
1642765242,196739,true,2858649945,28,2855221794,-3428151
1642766074,196738,true,2858935810,28,2847523477,-11412333
1642766096,196737,true,2859221704,28,2847238753,-11982951
1642766223,196739,true,2858649945,28,2846100143,-12549802
1642766332,196737,true,2859221704,28,2845531008,-13690696
1642766408,196736,true,2859507626,28,2844961987,-14545639
1642766540,196736,true,2859507626,28,2844108669,-15398957
1642766610,196737,true,2859221704,28,2844108669,-15113035
1642766720,196735,true,2859793577,28,2843824287,-15969290
1642766763,196735,true,2859793577,28,2843539933,-16253644
1642766820,196734,true,2860079556,28,2843255607,-16823949
1642766883,196736,true,2859507626,28,2842402801,-17104825
1642766911,196736,true,2859507626,28,2842118589,-17389037
1642766994,196736,true,2859507626,28,2841266124,-18241502
1642767022,196736,true,2859507626,28,2840982026,-18525600
1642767046,196739,true,2858649945,28,2840413915,-18236030
1642767057,196739,true,2858649945,28,2840413915,-18236030
1642767256,196741,true,2858078301,28,2837007633,-21070668
1642767304,196741,true,2858078301,28,2836440316,-21637985
1642767346,196743,true,2857506771,28,2835589554,-21917217
1642767362,196744,true,2857221049,28,2835589554,-21631495
1642767383,196745,true,2856935355,28,2835022521,-21912834
1642767422,196746,true,2856649690,28,2834172185,-22477505
1642767459,196749,true,2855792867,28,2833605435,-22187432
1642767876,196749,true,2855792867,28,2829358425,-26434442
1642768137,196751,true,2855221794,28,2826530623,-28691171
1642768153,196752,true,2854936300,28,2826247998,-28688302
1642768322,196754,true,2854365399,28,2823705646,-30659753
1642768330,196755,true,2854079991,28,2823705646,-30374345
1642768385,196758,true,2853223938,28,2822576446,-30647492
1642768401,196758,true,2853223938,28,2822294217,-30929721
1642768424,196761,true,2852368142,28,2822012015,-30356127
1642768454,196762,true,2852082933,28,2821165581,-30917352
1642768531,196765,true,2851227480,28,2819191555,-32035925
1642768535,196766,true,2850942385,28,2818909664,-32032721
1642768556,196770,true,2849802294,28,2818064160,-31738134
1642768612,196772,true,2849232419,28,2816092304,-33140115
1642768620,196777,true,2847808230,28,2815810723,-31997507
1642768664,196777,true,2847808230,28,2814403240,-33404990
1642768706,196781,true,2846669391,28,2812996460,-33672931
1642768725,196783,true,2846100143,28,2812433945,-33666198
1642768768,196788,true,2844677519,28,2811028150,-33649369
1642768791,196789,true,2844393080,28,2810185010,-34208070
1642768800,196793,true,2843255607,28,2809904020,-33351587
1642768854,196796,true,2842402801,28,2807657108,-34745693
1642768908,196802,true,2840697956,28,2805692534,-35005422
1642768939,196805,true,2839845917,28,2803729334,-36116583
1642768942,196809,true,2838710263,28,2803448990,-35261273
1642768943,196813,true,2837575062,28,2803448990,-34126072
1642768954,196823,true,2834739047,28,2802608123,-32130924
1642768967,196822,true,2835022521,28,2802327890,-32694631
1642768996,196823,true,2834739047,28,2801207239,-33531808
1642769003,196827,true,2833605435,28,2800927147,-32678288
1642769024,196835,true,2831339571,28,2800367045,-30972526
1642769046,196834,true,2831622705,28,2799807056,-31815649
1642769071,196833,true,2831905867,28,2798967282,-32938585
1642769104,196837,true,2830773388,28,2797847974,-32925414
1642769142,196846,true,2828226965,28,2796449470,-31777495
1642769163,196845,true,2828509788,28,2795610703,-32899085
1642769192,196845,true,2828509788,28,2794772187,-33737601
1642769211,196850,true,2827095957,28,2794213317,-32882640
1642769277,196858,true,2824835298,28,2792258150,-32577148
1642769301,196857,true,2825117781,28,2791420640,-33697141
1642769368,196856,true,2825400293,28,2789188508,-36211785
1642769397,196860,true,2824270415,28,2788351919,-35918496
1642769443,196867,true,2822294217,28,2786958161,-35336056
1642769492,196866,true,2822576446,28,2785565100,-37011346
1642769494,196865,true,2822858704,28,2785286571,-37572133
1642769499,196870,true,2821447698,28,2785008070,-36439628
1642769514,196879,true,2818909664,28,2784451152,-34458512
1642769522,196880,true,2818627801,28,2784172735,-34455066
1642769577,196878,true,2819191555,28,2781946399,-37245156
1642769580,196883,true,2817782382,28,2781946399,-35835983
1642769877,196891,true,2815529170,28,2771395589,-44133581
1642769967,196893,true,2814966149,28,2768625717,-46340432
1642769979,196891,true,2815529170,28,2768348882,-47180288
1642770053,196896,true,2814121828,28,2766688454,-47433374
1642770156,196904,true,2811871543,28,2764476099,-47395444
1642770314,196905,true,2811590384,28,2762817994,-48772390
1642770377,196904,true,2811871543,28,2763370585,-48500958
1642770506,196909,true,2810466029,28,2764752547,-45713482
1642770748,196917,true,2808218667,28,2770010307,-38208360
1642770771,196917,true,2808218667,28,2770564337,-37654330
1642770794,196917,true,2808218667,28,2771118477,-37100190
1642770858,196923,true,2806534326,28,2771118477,-35415849
1642770872,196931,true,2804290108,28,2771395589,-32894519
1642771018,196931,true,2804290108,28,2773336148,-30953960
1642771135,196931,true,2804290108,28,2774168232,-30121876
1642771263,196936,true,2802888384,28,2775000566,-27887818
1642771998,196944,true,2800647082,28,2783894345,-16752737
1642772089,196944,true,2800647082,28,2783615984,-17031098
1642772137,196943,true,2800927147,28,2783337650,-17589497
1642772371,196948,true,2799527103,28,2780833898,-18693205
1642772395,196956,true,2797288489,28,2780555843,-16732646
1642772413,196957,true,2797008788,28,2780555843,-16452945
1642772506,196956,true,2797288489,28,2780277815,-17010674
1642772542,196959,true,2796449470,28,2780277815,-16171655
1642772547,196968,true,2793933923,28,2780277815,-13656108
1642772605,196968,true,2793933923,28,2780833898,-13100025
1642772735,196966,true,2794492738,28,2782502816,-11989922
1642773095,196969,true,2793654558,28,2787236857,-6417701
1642773118,196977,true,2791420640,28,2787515580,-3905060
1642773176,196977,true,2791420640,28,2788073111,-3347529
1642773282,196974,true,2792258150,28,2789188508,-3069642
1642773400,196977,true,2791420640,28,2790304351,-1116289
1642773424,196985,true,2789188508,28,2790583381,1394873
1642773755,196985,true,2789188508,28,2793654558,4466050
1642773878,196982,true,2790025348,28,2794492738,4467390
1642773898,196984,true,2789467427,28,2794772187,5304760
1642774726,196993,true,2786958161,28,2796169853,9211692
1642775102,196993,true,2786958161,28,2791978952,5020791
1642775110,196990,true,2787794332,28,2791978952,4184620
1642775171,196991,true,2787515580,28,2791699782,4184202
1642775466,197000,true,2785008070,28,2791141526,6133456
1642775496,196998,true,2785565100,28,2791420640,5855540
1642775625,196995,true,2786400853,28,2792258150,5857297
1642775643,196996,true,2786122241,28,2792537375,6415134
1642775673,197003,true,2784172735,28,2792816629,8643894
1642775764,197001,true,2784729597,28,2794492738,9763141
1642775846,196997,true,2785843656,28,2796449470,10605814
1642775851,196998,true,2785565100,28,2796449470,10884370
1642775901,197005,true,2783615984,28,2797568218,13952234
1642775918,197003,true,2784172735,28,2797847974,13675239
1642775977,196999,true,2785286571,28,2798967282,13680711
1642776016,197000,true,2785008070,28,2799527103,14519033
1642776071,197006,true,2783337650,28,2800087036,16749386
1642776104,197004,true,2783894345,28,2800647082,16752737
1642776280,197001,true,2784729597,28,2801487360,16757763
1642776302,197002,true,2784451152,28,2801767509,17316357
1642776342,197008,true,2782781066,28,2801767509,18986443
1642776406,197007,true,2783059344,28,2801767509,18708165
1642776427,197004,true,2783894345,28,2801767509,17873164
1642776529,197005,true,2783615984,28,2802047685,18431701
1642776603,197012,true,2781668232,28,2802327890,20659658
1642776616,197009,true,2782502816,28,2802608123,20105307
1642776672,197007,true,2783059344,28,2802888384,19829040
1642776898,197009,true,2782502816,28,2803729334,21226518
1642776955,197016,true,2780555843,28,2803729334,23173491
1642776964,197013,true,2781390093,28,2803448990,22058897
1642776965,197011,true,2781946399,28,2803448990,21502591
1642777297,197014,true,2781111982,28,2799527103,18415121
1642777527,197020,true,2779443898,28,2794772187,15328289
1642777580,197018,true,2779999815,28,2793654558,13654743
1642777901,197015,true,2780833898,28,2786958161,6124263
1642778659,197018,true,2779999815,28,2779443898,-555917
1642778691,197023,true,2778610232,28,2779165982,555750
1642778895,197020,true,2779443898,28,2780555843,1111945
1642779039,197016,true,2780555843,28,2782224593,1668750
1642779191,197015,true,2780833898,28,2784729597,3895699
1642779218,197019,true,2779721843,28,2785286571,5564728
1642779256,197015,true,2780833898,28,2785843656,5009758
1642779283,197010,true,2782224593,28,2786679493,4454900
1642779324,197009,true,2782502816,28,2787515580,5012764
1642779347,197012,true,2781668232,28,2788073111,6404879
1642779938,197007,true,2783059344,28,2805131479,22072135
1642780113,197002,true,2784451152,28,2810466029,26014877
1642780170,196999,true,2785286571,28,2812433945,27147374
1642780220,197001,true,2784729597,28,2814121828,29392231
1642780284,196994,true,2786679493,28,2816655551,29976058
1642780648,196987,true,2788630754,28,2829641361,41010607
1642780653,196984,true,2789467427,28,2829924325,40456898
1642780702,196982,true,2790025348,28,2831339571,41314223
1642780713,196978,true,2791141526,28,2831622705,40481179
1642780727,196973,true,2792537375,28,2831905867,39368492
1642780813,196971,true,2793095911,28,2833605435,40509524
1642780897,196971,true,2793095911,28,2835022521,41926610
1642780964,196968,true,2793933923,28,2835873113,41939190
1642781202,196965,true,2794772187,28,2836440316,41668129
1642781221,196963,true,2795331170,28,2836440316,41109146
1642781293,196962,true,2795610703,28,2836723960,41113257
1642782076,196958,true,2796729115,28,2837858820,41129705
1642782123,196955,true,2797568218,28,2837575062,40006844
1642782128,196952,true,2798407572,28,2837575062,39167490
1642782518,196952,true,2798407572,28,2837858820,39451248
1642782540,196947,true,2799807056,28,2837858820,38051764
1642782635,196944,true,2800647082,28,2838426420,37779338
1642782683,196942,true,2801207239,28,2838710263,37503024
1642782769,196942,true,2801207239,28,2838994134,37786895
1642783135,196938,true,2802327890,28,2840413915,38086025
1642783183,196935,true,2803168673,28,2840413915,37245242
1642783248,196933,true,2803729334,28,2840129902,36400568
1642783282,196933,true,2803729334,28,2840129902,36400568
1642783336,196928,true,2805131479,28,2839845917,34714438
1642783665,196927,true,2805411993,28,2836156700,30744707
1642783677,196925,true,2805973103,28,2836156700,30183597
1642783684,196925,true,2805973103,28,2836156700,30183597
1642783698,196920,true,2807376370,28,2835873113,28496743
1642784106,196921,true,2807095661,28,2826530623,19434962
1642784459,196919,true,2807657108,28,2817218910,9561802
1642784505,196921,true,2807095661,28,2816373913,9278252
1642784528,196917,true,2808218667,28,2815810723,7592056
1642784557,196918,true,2807937874,28,2815529170,7591296
1642784596,196917,true,2808218667,28,2814684680,6466013
1642785045,196918,true,2807937874,28,2807937874,0
1642785139,196914,true,2809061217,28,2806814979,-2246238
1642785157,196915,true,2808780339,28,2806534326,-2246013
1642785159,196913,true,2809342123,28,2806534326,-2807797
1642785427,196915,true,2808780339,28,2803168673,-5611666
1642785469,196912,true,2809623058,28,2802608123,-7014935
1642785500,196913,true,2809342123,28,2802327890,-7014233
1642785674,196912,true,2809623058,28,2801207239,-8415819
1642786021,196914,true,2809061217,28,2799247178,-9814039
1642786111,196911,true,2809904020,28,2798687413,-11216607
1642786623,196912,true,2809623058,28,2794492738,-15130320
1642786658,196911,true,2809904020,28,2793933923,-15970097
1642787061,196912,true,2809623058,28,2789467427,-20155631
1642787063,196909,true,2810466029,28,2789467427,-20998602
1642787305,196911,true,2809904020,28,2788073111,-21830909
1642787323,196910,true,2810185010,28,2788073111,-22111899
1642787395,196912,true,2809623058,28,2787515580,-22107478
1642787746,196909,true,2810466029,28,2785843656,-24622373
1642787780,196913,true,2809342123,28,2785565100,-23777023
1642788072,196913,true,2809342123,28,2783059344,-26282779
1642788495,196915,true,2808780339,28,2780833898,-27946441
1642788529,196913,true,2809342123,28,2780833898,-28508225
1642788574,196916,true,2808499489,28,2780833898,-27665591
1642788604,196916,true,2808499489,28,2780833898,-27665591
1642788630,196918,true,2807937874,28,2780833898,-27103976
1642788634,196915,true,2808780339,28,2780833898,-27946441
1642788708,196918,true,2807937874,28,2780833898,-27103976
1642788945,196917,true,2808218667,28,2782781066,-25437601
1642789090,196917,true,2808218667,28,2784172735,-24045932
1642789177,196914,true,2809061217,28,2784451152,-24610065
1642789225,196917,true,2808218667,28,2784729597,-23489070
1642789302,196916,true,2808499489,28,2784729597,-23769892
1642789426,196918,true,2807937874,28,2784451152,-23486722
1642789544,196917,true,2808218667,28,2783615984,-24602683
1642789555,196920,true,2807376370,28,2783615984,-23760386
1642789603,196920,true,2807376370,28,2783337650,-24038720
1642789884,196924,true,2806253700,28,2782224593,-24029107
1642789947,196924,true,2806253700,28,2781668232,-24585468
1642789967,196928,true,2805131479,28,2781390093,-23741386
1642790017,196928,true,2805131479,28,2781390093,-23741386
1642790153,196930,true,2804570537,28,2781668232,-22902305
1642790321,196929,true,2804850994,28,2781668232,-23182762
1642790837,196933,true,2803729334,28,2779999815,-23729519
1642790937,196932,true,2804009707,28,2779721843,-24287864
1642790957,196934,true,2803448990,28,2779443898,-24005092
1642791395,196933,true,2803729334,28,2780555843,-23173491
1642791584,196936,true,2802888384,28,2781946399,-20941985
1642792331,196935,true,2803168673,28,2780555843,-22612830
1642792414,196937,true,2802608123,28,2779999815,-22608308
1642792473,196936,true,2802888384,28,2779443898,-23444486
1642792531,196937,true,2802608123,28,2778888093,-23720030
1642792598,196938,true,2802327890,28,2778610232,-23717658
1642793067,196939,true,2802047685,28,2776943649,-25104036
1642793209,196938,true,2802327890,28,2776943649,-25384241
1642793320,196940,true,2801767509,28,2776665982,-25101527
1642793736,196940,true,2801767509,28,2775555594,-26211915
1642793922,196942,true,2801207239,28,2774445649,-26761590
1642793975,196941,true,2801487360,28,2774168232,-27319128
1642794688,196942,true,2801207239,28,2771949896,-29257343
1642794729,196941,true,2801487360,28,2771672729,-29814631
1642795115,196943,true,2800927147,28,2767518544,-33408603
1642795141,196942,true,2801207239,28,2767241819,-33965420
1642795209,196945,true,2800367045,28,2766411813,-33955232
1642795220,196944,true,2800647082,28,2766135199,-34511883
1642795339,196947,true,2799807056,28,2764752547,-35054509
1642795622,196946,true,2800087036,28,2762541740,-37545296
1642795660,196949,true,2799247178,28,2762265513,-36981665
1642795728,196950,true,2798967282,28,2761436999,-37530283
1642795768,196953,true,2798127759,28,2760884795,-37242964
1642795892,196955,true,2797568218,28,2758401240,-39166978
1642795895,196959,true,2796449470,28,2758401240,-38048230
1642795920,196961,true,2795890264,28,2757573885,-38316379
1642796010,196965,true,2794772187,28,2755368819,-39403368
1642796042,196968,true,2793933923,28,2754542373,-39391550
1642796045,196973,true,2792537375,28,2754266946,-38270429
1642796050,196975,true,2791978952,28,2754266946,-37712006
1642796089,196982,true,2790025348,28,2752614965,-37410383
1642796123,196987,true,2788630754,28,2751239070,-37391684
1642796166,196992,true,2787236857,28,2749588904,-37647953
1642796215,196995,true,2786400853,28,2746840827,-39560026
1642796251,197001,true,2784729597,28,2746016939,-38712658
1642796299,197005,true,2783615984,28,2744918807,-38697177
1642796380,197008,true,2782781066,28,2743272432,-39508634
1642796395,197009,true,2782502816,28,2742998132,-39504684
1642796424,197014,true,2781111982,28,2742449615,-38662367
1642796527,197018,true,2779999815,28,2739982644,-40017171
1642796812,197022,true,2778888093,28,2734508428,-44379665
1642796858,197023,true,2778610232,28,2733688240,-44921992
1642796883,197028,true,2777221343,28,2732868297,-44353046
1642796899,197033,true,2775833149,28,2732595038,-43238111
1642796952,197037,true,2774723093,28,2731229150,-43493943
1642797105,197039,true,2774168232,28,2727953805,-46214427
1642797134,197045,true,2772504314,28,2727408296,-45096018
1642797193,197050,true,2771118477,28,2726317605,-44800872
1642797255,197054,true,2770010307,28,2725499873,-44510434
1642797610,197054,true,2770010307,28,2721959202,-48051105
1642797650,197059,true,2768625717,28,2722231398,-46394319
1642797842,197063,true,2767518544,28,2724682387,-42836157
1642797887,197067,true,2766411813,28,2725499873,-40911940
1642798066,197066,true,2766688454,28,2729590986,-37097468
1642798085,197071,true,2765305525,28,2729590986,-35714539
1642798191,197075,true,2764199679,28,2729863945,-34335734
1642798199,197077,true,2763646922,28,2729863945,-33782977
1642798218,197077,true,2763646922,28,2729863945,-33782977
1642798284,197082,true,2762265513,28,2729863945,-32401568
1642798736,197087,true,2760884795,28,2730136932,-30747863
1642798889,197087,true,2760884795,28,2732595038,-28289757
1642799807,197085,true,2761436999,28,2738613064,-22823935
1642799852,197090,true,2760056695,28,2738886925,-21169770
1642799963,197094,true,2758952948,28,2738339230,-20613718
1642800585,197096,true,2758401240,28,2736696801,-21704439
1642800617,197095,true,2758677080,28,2736149544,-22527536
1642800678,197101,true,2757022453,28,2734781879,-22240574
1642800741,197106,true,2755644355,28,2733414898,-22229457
1642800752,197109,true,2754817827,28,2733141584,-21676243
1642800757,197109,true,2754817827,28,2733141584,-21676243
1642800776,197113,true,2753716176,28,2732595038,-21121138
1642800788,197118,true,2752339731,28,2732048601,-20291130
1642800831,197123,true,2750963973,28,2730682986,-20280987
1642800848,197123,true,2750963973,28,2729863945,-21100028
1642800865,197128,true,2749588904,28,2729045150,-20543754
1642800927,197133,true,2748214522,28,2726590237,-21624285
1642800997,197138,true,2746840827,28,2723592786,-23248041
1642801018,197139,true,2746566170,28,2722775872,-23790298
1642801056,197143,true,2745467818,28,2720870691,-24597127
1642801081,197149,true,2743821114,28,2719782615,-24038499
1642801094,197154,true,2742449615,28,2719238740,-23210875
1642801132,197155,true,2742175397,28,2717336034,-24839363
1642801178,197160,true,2740804721,28,2714620192,-26184529
1642801332,197167,true,2738886925,28,2705947724,-32939201
1642801351,197171,true,2737791644,28,2704865615,-32926029
1642801381,197172,true,2737517892,28,2702972967,-34544925
1642801398,197178,true,2735875956,28,2701892048,-33983908
1642801422,197185,true,2733961609,28,2700271480,-33690129
1642801432,197190,true,2732595038,28,2699731506,-32863532
1642801491,197192,true,2732048601,28,2695954716,-36093885
1642801503,197197,true,2730682986,28,2695146091,-35536895
1642801529,197205,true,2728499423,28,2693529569,-34969854
1642801580,197211,true,2726862896,28,2690030430,-36832466
1642801617,197215,true,2725772423,28,2686535838,-39236585
1642801665,197222,true,2723865146,28,2683045785,-40819361
1642801692,197230,true,2721687034,28,2681168404,-40518630
1642801709,197237,true,2719782615,28,2679560265,-40222350
1642801719,197241,true,2718694974,28,2679024434,-39670540
1642801759,197248,true,2716792648,28,2675544139,-41248509
1642801783,197255,true,2714891654,28,2674206768,-40684886
1642801794,197262,true,2712991989,28,2673404666,-39587323
1642801803,197265,true,2712178255,28,2672602805,-39575450
1642801827,197271,true,2710551517,28,2670732731,-39818786
1642801852,197280,true,2708113240,28,2668863966,-39249274
1642801889,197287,true,2706218319,28,2665663410,-40554909
1642801892,197291,true,2705136102,28,2665396870,-39739232
1642801910,197298,true,2703243264,28,2664064572,-39178692
1642801929,197307,true,2700811561,28,2662466692,-38344869
1642801957,197315,true,2698651884,28,2660337677,-38314207
1642801962,197319,true,2697572693,28,2659805689,-37767004
1642802044,197324,true,2696224311,28,2654226237,-41998074
1642802047,197333,true,2693798922,28,2653960841,-39838081
1642802086,197340,true,2691914017,28,2651043235,-40870782
1642802126,197343,true,2691106604,28,2648658488,-42448116
1642802148,197347,true,2690030430,28,2647334556,-42695874
1642802149,197356,true,2687610613,28,2647334556,-40276057
1642802152,197362,true,2685998611,28,2647069849,-38928762
1642802172,197364,true,2685461492,28,2646011286,-39450206
1642802237,197370,true,2683850779,28,2641517112,-42333667
1642802244,197379,true,2681436520,28,2641252987,-40183533
1642802261,197385,true,2679828221,28,2639932757,-39895464
1642802296,197388,true,2679024434,28,2637821761,-41202673
1642802416,197392,true,2677953092,28,2630446559,-47506533
1642802489,197401,true,2675544139,28,2627029371,-48514768
1642802545,197406,true,2674206768,28,2624141371,-50065397
1642802622,197408,true,2673672007,28,2621256547,-52415460
1642802663,197412,true,2672602805,28,2620470327,-52132478
1642802676,197419,true,2670732731,28,2620208306,-50524425
1642802721,197423,true,2669664705,28,2619160485,-50504220
1642802758,197424,true,2669397765,28,2618636732,-50761033
1642802788,197427,true,2668597106,28,2617851298,-50745808
1642802838,197436,true,2666196569,28,2616542765,-49653804
1642802851,197440,true,2665130357,28,2616281136,-48849221
1642802858,197441,true,2664863871,28,2616281136,-48582735
1642802871,197444,true,2664064572,28,2615757959,-48306613
1642802928,197452,true,2661934279,28,2614450472,-47483807
1642802968,197456,true,2660869771,28,2613666294,-47203477
1642803021,197457,true,2660603711,28,2612882351,-47721360
1642803041,197459,true,2660071670,28,2612359853,-47711817
1642803118,197466,true,2658210364,28,2611315170,-46895194
1642803242,197470,true,2657147346,28,2610009904,-47137442
1642803264,197471,true,2656881658,28,2609748929,-47132729
1642803329,197471,true,2656881658,28,2609227057,-47654601
1642803386,197477,true,2655288086,28,2608966161,-46321925
1642803403,197481,true,2654226237,28,2609227057,-44999180
1642803415,197481,true,2654226237,28,2609487980,-44738257
1642803452,197483,true,2653695471,28,2609487980,-44207491
1642803467,197490,true,2651838627,28,2609487980,-42350647
1642803490,197497,true,2649983082,28,2609227057,-40756025
1642803596,197499,true,2649453165,28,2609227057,-40226108
1642803674,197502,true,2648658488,28,2609748929,-38909559
1642803685,197509,true,2646805169,28,2610009904,-36795265
1642803708,197515,true,2645217641,28,2610009904,-35207737
1642803761,197518,true,2644424235,28,2610531932,-33892303
1642803799,197520,true,2643895429,28,2610531932,-33363497
1642803844,197527,true,2642045442,28,2610270905,-31774537
1642803889,197532,true,2640724816,28,2610270905,-30453911
1642803898,197534,true,2640196750,28,2610270905,-29925845
1642803977,197535,true,2639932757,28,2610009904,-29922853
1642804029,197541,true,2638349351,28,2610531932,-27817419
1642804036,197546,true,2637030572,28,2610792985,-26237587
1642804117,197549,true,2636239621,28,2611576301,-24663320
1642804302,197550,true,2635976024,28,2612621088,-23354936
1642804312,197557,true,2634131578,28,2612621088,-21510490
1642804462,197561,true,2633078189,28,2612359853,-20718336
1642804773,197566,true,2631762045,28,2609487980,-22274065
1642804825,197567,true,2631498895,28,2609227057,-22271838
1642804855,197574,true,2629657582,28,2608705290,-20952292
1642804890,197579,true,2628343148,28,2607922835,-20420313
1642804895,197585,true,2626766694,28,2607922835,-18843859
1642804940,197588,true,2625978821,28,2606358629,-19620192
1642804954,197595,true,2624141371,28,2606098019,-18043352
1642804961,197602,true,2622305207,28,2605837435,-16467772
1642804975,197609,true,2620470327,28,2605316346,-15153981
1642804989,197612,true,2619684343,28,2604795361,-14888982
1642805006,197620,true,2617589539,28,2604274480,-13315059
1642805015,197625,true,2616281136,28,2604014079,-12267057
1642805066,197630,true,2614973388,28,2602972733,-12000655
1642805076,197632,true,2614450472,28,2602712462,-11738010
1642805100,197639,true,2612621088,28,2601931804,-10689284
1642805133,197643,true,2611576301,28,2601151381,-10424920
1642805172,197648,true,2610270905,28,2600371192,-9899713
1642805219,197651,true,2609487980,28,2599071396,-10416584
1642805234,197657,true,2607922835,28,2598811515,-9111320
1642805235,197660,true,2607140615,28,2598811515,-8329100
1642805248,197665,true,2605837435,28,2598291831,-7545604
1642805281,197670,true,2604534907,28,2596993074,-7541833
1642805325,197676,true,2602972733,28,2595694967,-7277766
1642805367,197679,true,2602191998,28,2594138095,-8053903
1642805394,197685,true,2600631229,28,2593100699,-7530530
1642805416,197690,true,2599331303,28,2592322925,-7008378
1642805436,197696,true,2597772250,28,2591286255,-6485995
1642805448,197699,true,2596993074,28,2591027152,-5965922
1642805457,197704,true,2595694967,28,2590509024,-5185943
1642805471,197708,true,2594656949,28,2589991000,-4665949
1642805494,197713,true,2593360009,28,2589214158,-4145851
1642805520,197716,true,2592582157,28,2588178731,-4403426
1642805555,197720,true,2591545383,28,2586885030,-4660353
1642805564,197725,true,2590249999,28,2586367731,-3882268
1642805608,197731,true,2588696393,28,2584041163,-4655230
1642805647,197734,true,2587919939,28,2582233058,-5686881
1642805665,197739,true,2586626368,28,2581458543,-5167825
1642805684,197743,true,2585591976,28,2580684260,-4907716
1642805697,197747,true,2584557997,28,2580168201,-4389796
1642805700,197750,true,2583782785,28,2579910210,-3872575
1642805744,197752,true,2583266106,28,2577847210,-5418896
1642805752,197755,true,2582491281,28,2577589451,-4901830
1642805764,197758,true,2581716689,28,2577074010,-4642679
1642805791,197758,true,2581716689,28,2576043438,-5673251
1642805799,197759,true,2581458543,28,2575785860,-5672683
1642805819,197762,true,2580684260,28,2574755803,-5928457
1642805863,197765,true,2579910210,28,2573211490,-6698720
1642805873,197766,true,2579652244,28,2572696925,-6955319
1642805915,197766,true,2579652244,28,2570639693,-9012551
1642805926,197768,true,2579136391,28,2570125642,-9010749
1642805941,197771,true,2578362805,28,2569354759,-9008046
1642805946,197772,true,2578104995,28,2569097849,-9007146
1642805952,197773,true,2577847210,28,2568840965,-9006245
1642806005,197774,true,2577589451,28,2566273536,-11315915
1642806026,197776,true,2577074010,28,2565503808,-11570202
1642806069,197777,true,2576816329,28,2563196009,-13620320
1642806135,197778,true,2576558673,28,2560122172,-16436501
1642806142,197782,true,2575528307,28,2559866185,-15662122
1642806177,197784,true,2575013279,28,2558330803,-16682476
1642806185,197785,true,2574755803,28,2557819214,-16936589
1642806213,197787,true,2574240929,28,2556540688,-17700241
1642806240,197792,true,2572954195,28,2555007300,-17946895
1642806275,197794,true,2572439681,28,2553474832,-18964849
1642806306,197797,true,2571668103,28,2551943283,-19724820
1642806346,197798,true,2571410962,28,2550412653,-20998309
1642806356,197802,true,2570382655,28,2549902647,-20480008
1642806376,197805,true,2569611694,28,2548882941,-20728753
1642806387,197807,true,2569097849,28,2548373241,-20724608
1642806403,197810,true,2568327274,28,2547608882,-20718392
1642806468,197813,true,2567556930,28,2544553737,-23003193
1642806482,197817,true,2566530164,28,2543790524,-22739640
1642806530,197819,true,2566016935,28,2541502257,-24514678
1642806547,197823,true,2564990784,28,2540739958,-24250826
1642806588,197828,true,2563708674,28,2538708281,-25000393
1642806593,197831,true,2562939715,28,2538454435,-24485280
1642806626,197836,true,2561658629,28,2536678228,-24980401
1642806646,197840,true,2560634222,28,2535663810,-24970412
1642806655,197846,true,2559098379,28,2535156753,-23941626
1642806687,197851,true,2557819214,28,2533382853,-24436361
1642806709,197856,true,2556540688,28,2532116542,-24424146
1642806715,197860,true,2555518327,28,2531863355,-23654972
1642806756,197867,true,2553730180,28,2529838776,-23891404
1642806785,197870,true,2552964214,28,2528827093,-24137121
1642806789,197875,true,2551688114,28,2528574236,-23113878
1642806795,197880,true,2550412653,28,2528068597,-22344056
1642806822,197886,true,2548882941,28,2526552286,-22330655
1642806833,197889,true,2548118429,28,2526299657,-21818772
1642806846,197893,true,2547099436,28,2526047052,-21052384
1642806864,197896,true,2546335459,28,2525541918,-20793541
1642806883,197899,true,2545571711,28,2525036886,-20534825
1642806915,197903,true,2544553737,28,2524027123,-20526614
1642806918,197906,true,2543790524,28,2523774746,-20015778
1642806938,197910,true,2542773262,28,2523017765,-19755497
1642806948,197914,true,2541756407,28,2522513237,-19243170
1642806962,197918,true,2540739958,28,2522008810,-18731148
1642806965,197920,true,2540231887,28,2522008810,-18223077
1642806971,197922,true,2539723916,28,2522008810,-17715106
1642806994,197921,true,2539977889,28,2521756634,-18221255
1642807025,197924,true,2539216048,28,2521504484,-17711564
1642807033,197926,true,2538708281,28,2521504484,-17203797
1642807060,197927,true,2538454435,28,2521756634,-16697801
1642807066,197927,true,2538454435,28,2521756634,-16697801
1642807110,197930,true,2537693051,28,2522008810,-15684241
1642807121,197932,true,2537185589,28,2522261011,-14924578
1642807144,197933,true,2536931896,28,2522513237,-14418659
1642807176,197933,true,2536931896,28,2523017765,-13914131
1642807187,197936,true,2536170968,28,2523522394,-12648574
1642807214,197938,true,2535663810,28,2524027123,-11636687
1642807250,197939,true,2535410269,28,2525289389,-10120880
1642807274,197940,true,2535156753,28,2526047052,-9109701
1642807312,197942,true,2534649798,28,2527310328,-7339470
1642807356,197944,true,2534142944,28,2528827093,-5315851
1642807459,197943,true,2534396358,28,2533636192,-760166
1642807634,197943,true,2534396358,28,2539216048,4819690
1642807669,197945,true,2533889555,28,2539977889,6088334
1642807677,197946,true,2533636192,28,2540485910,6849718
1642807686,197944,true,2534142944,28,2540739958,6597014
1642807707,197939,true,2535410269,28,2541502257,6091988
1642807729,197940,true,2535156753,28,2542264783,7108030
1642807738,197940,true,2535156753,28,2542773262,7616509
1642807773,197938,true,2535663810,28,2543790524,8126714
1642807782,197934,true,2536678228,28,2544299307,7621079
1642807792,197935,true,2536424585,28,2544553737,8129152
1642807794,197936,true,2536170968,28,2544553737,8382769
1642807828,197935,true,2536424585,28,2545317180,8892595
1642807850,197932,true,2537185589,28,2546080851,8895262
1642807865,197932,true,2537185589,28,2546590093,9404504
1642807868,197933,true,2536931896,28,2546590093,9658197
1642807987,197933,true,2536931896,28,2549902647,12970751
1642808007,197929,true,2537946821,28,2550412653,12465832
1642808021,197930,true,2537693051,28,2550922761,13229710
1642808032,197931,true,2537439307,28,2551177853,13738546
1642808092,197930,true,2537693051,28,2552964214,15271163
1642808127,197924,true,2539216048,28,2553730180,14514132
1642808163,197925,true,2538962152,28,2554496375,15534223
1642808178,197925,true,2538962152,28,2555007300,16045148
1642808184,197924,true,2539216048,28,2555007300,15791252
1642808195,197919,true,2540485910,28,2555262801,14776891
1642808228,197918,true,2540739958,28,2556285059,15545101
1642808332,197917,true,2540994032,28,2559610224,18616192
1642808362,197917,true,2540994032,28,2560634222,19640190
1642808395,197911,true,2542519010,28,2561658629,19139619
1642808403,197910,true,2542773262,28,2561914795,19141533
1642808408,197910,true,2542773262,28,2562170987,19397725
1642808505,197911,true,2542519010,28,2566273536,23754526
1642808517,197905,true,2544044903,28,2567043495,22998592
1642808573,197903,true,2544553737,28,2569611694,25057957
1642808611,197905,true,2544044903,28,2569611694,25566791
1642808640,197906,true,2543790524,28,2570125642,26335118
1642808676,197901,true,2545062673,28,2570896757,25834084
1642808680,197902,true,2544808193,28,2570896757,26088564
1642808686,197900,true,2545317180,28,2570896757,25579577
1642808703,197902,true,2544808193,28,2571410962,26602769
1642808718,197895,true,2546590093,28,2571925270,25335177
1642808747,197897,true,2546080851,28,2572954195,26873344
1642808790,197896,true,2546335459,28,2573468811,27133352
1642808825,197900,true,2545317180,28,2573468811,28151631
1642808843,197894,true,2546844752,28,2573468811,26624059
1642808876,197897,true,2546080851,28,2573211490,27130639
1642808885,197896,true,2546335459,28,2573211490,26876031
1642808921,197906,true,2543790524,28,2570896757,27106233
1642808933,197900,true,2545317180,28,2570896757,25579577
1642808958,197902,true,2544808193,28,2570639693,25831500
1642809235,197896,true,2546335459,28,2564990784,18655325
1642809295,197904,true,2544299307,28,2563452328,19153021
1642809448,197899,true,2545571711,28,2559866185,14294474
1642809449,197901,true,2545062673,28,2559866185,14803512
1642809511,197895,true,2546590093,28,2558330803,11740710
1642809521,197902,true,2544808193,28,2558074996,13266803
1642809536,197895,true,2546590093,28,2557819214,11229121
1642809637,197897,true,2546080851,28,2556285059,10204208
1642809678,197890,true,2547863643,28,2555773879,7910236
1642809734,197897,true,2546080851,28,2555518327,9437476
1642809749,197889,true,2548118429,28,2555518327,7399898
1642809760,197890,true,2547863643,28,2555773879,7910236
1642809839,197882,true,2549902647,28,2556285059,6382412
1642809843,197888,true,2548373241,28,2556285059,7911818
1642809883,197881,true,2550157637,28,2556540688,6383051
1642809925,197882,true,2549902647,28,2556540688,6638041
1642809950,197873,true,2552198478,28,2556796342,4597864
1642809960,197879,true,2550667694,28,2557052021,6384327
1642809999,197872,true,2552453697,28,2557307727,4854030
1642810001,197873,true,2552198478,28,2557307727,5109249
1642810048,197866,true,2553985553,28,2557307727,3322174
1642810056,197871,true,2552708943,28,2557307727,4598784
1642810067,197864,true,2554496375,28,2557052021,2555646
1642810173,197867,true,2553730180,28,2556285059,2554879
1642810186,197858,true,2556029456,28,2556029456,0
1642810219,197863,true,2554751825,28,2556029456,1277631
1642810353,197856,true,2556540688,28,2555518327,-1022361
1642810451,197858,true,2556029456,28,2557307727,1278271
1642810541,197848,true,2558586636,28,2557819214,-767422
1642810633,197852,true,2557563457,28,2558586636,1023179
1642810736,197844,true,2559610224,28,2561402489,1792265
1642810805,197846,true,2559098379,28,2561658629,2560250
1642810823,197837,true,2561402489,28,2561914795,512306
1642810845,197841,true,2560378184,28,2562170987,1792803
1642810851,197833,true,2562427204,28,2562170987,-256217
1642810949,197834,true,2562170987,28,2563708674,1537687
1642810971,197826,true,2564221441,28,2563965045,-256396
1642810982,197832,true,2562683447,28,2564221441,1537994
1642811004,197827,true,2563965045,28,2564477863,512818
1642811044,197827,true,2563965045,28,2565247284,1282239
1642811075,197818,true,2566273536,28,2565760359,-513177
1642811165,197822,true,2565247284,28,2567300200,2052916
1642811203,197816,true,2566786817,28,2568070467,1283650
1642811381,197814,true,2567300200,28,2570382655,3082455
1642811384,197807,true,2569097849,28,2570382655,1284806
1642811456,197812,true,2567813685,28,2571668103,3854418
1642811582,197809,true,2568584107,28,2572696925,4112818
1642811591,197808,true,2568840965,28,2572696925,3855960
1642811607,197800,true,2570896757,28,2572954195,2057438
1642811715,197805,true,2569611694,28,2574240929,4629235
1642811735,197800,true,2570896757,28,2574498353,3601596
1642811846,197799,true,2571153847,28,2577074010,5920163
1642811931,197791,true,2573211490,28,2579652244,6440754
1642811960,197795,true,2572182463,28,2580684260,8501797
1642811975,197791,true,2573211490,28,2581200423,7988933
1642812037,197790,true,2573468811,28,2583266106,9797295
1642812294,197783,true,2575270780,28,2591286255,16015475
1642812494,197789,true,2573726158,28,2596214132,22487974
1642812508,197786,true,2574498353,28,2596733401,22235048
1642812541,197786,true,2574498353,28,2597772250,23273897
1642812619,197779,true,2576301043,28,2600371192,24070149
1642812659,197785,true,2574755803,28,2601411496,26655693
1642812722,197783,true,2575270780,28,2602972733,27701953
1642813131,197784,true,2575013279,28,2608183627,33170348
1642813191,197778,true,2576558673,28,2608705290,32146617
1642813221,197784,true,2575013279,28,2608705290,33692011
1642813471,197784,true,2575013279,28,2606879927,31866648
1642813652,197786,true,2574498353,28,2604274480,29776127
1642813741,197779,true,2576301043,28,2602972733,26671690
1642813775,197786,true,2574498353,28,2602191998,27693645
1642813813,197785,true,2574755803,28,2601671637,26915834
1642813929,197786,true,2574498353,28,2600631229,26132876
1642813996,197779,true,2576301043,28,2600111181,23810138
1642814143,197785,true,2574755803,28,2598291831,23536028
1642814283,197784,true,2575013279,28,2596993074,21979795
1642814337,197785,true,2574755803,28,2596473754,21717951
1642814666,197778,true,2576558673,28,2595175906,18617233
1642814865,197783,true,2575270780,28,2595954537,20683757
1642814946,197782,true,2575528307,28,2595954537,20426230
1642814991,197783,true,2575270780,28,2595954537,20683757
1642815033,197776,true,2577074010,28,2595954537,18880527
1642815058,197780,true,2576043438,28,2595954537,19911099
1642815143,197780,true,2576043438,28,2595954537,19911099
1642815210,197781,true,2575785860,28,2596214132,20428272
1642815288,197773,true,2577847210,28,2596214132,18366922
1642815335,197777,true,2576816329,28,2596214132,19397803
1642815393,197776,true,2577074010,28,2596473754,19399744
1642815518,197777,true,2576816329,28,2596993074,20176745
1642815549,197770,true,2578620641,28,2596993074,18372433
1642815693,197774,true,2577589451,28,2597772250,20182799
1642815984,197772,true,2578104995,28,2600371192,22266197
1642816035,197773,true,2577847210,28,2600891292,23044082
1642816130,197765,true,2579910210,28,2601671637,21761427
1642816164,197768,true,2579136391,28,2601671637,22535246
1642816197,197766,true,2579652244,28,2601931804,22279560
1642816363,197767,true,2579394305,28,2602191998,22797693
1642816409,197758,true,2581716689,28,2602452217,20735528
1642817053,197758,true,2581716689,28,2604795361,23078672
1642817101,197757,true,2581974860,28,2605055841,23080981
1642817341,197756,true,2582233058,28,2603753703,21520645
1642817377,197750,true,2583782785,28,2603753703,19970918
1642818097,197752,true,2583266106,28,2600111181,16845075
1642818331,197751,true,2583524433,28,2598551660,15027227
1642818372,197751,true,2583524433,28,2598291831,14767398
1642819074,197745,true,2585074935,28,2593878707,8803772
1642819218,197747,true,2584557997,28,2593878707,9320710
1642820260,197746,true,2584816453,28,2594916414,10099961
1642820274,197745,true,2585074935,28,2594916414,9841479
1642820383,197738,true,2586885030,28,2595435424,8550394
1642820453,197734,true,2587919939,28,2595694967,7775028
1642820683,197732,true,2588437549,28,2597772250,9334701
1642821403,197730,true,2588955263,28,2602191998,13236735
1642821873,197728,true,2589473080,28,2604274480,14801400
1642822034,197725,true,2590249999,28,2604795361,14545362
1642822138,197723,true,2590768075,28,2605055841,14287766
1642822195,197721,true,2591286255,28,2605055841,13769586
1642822247,197721,true,2591286255,28,2605055841,13769586
1642822632,197719,true,2591804538,28,2602191998,10387460
1642822667,197718,true,2592063718,28,2601931804,9868086
1642822673,197717,true,2592322925,28,2601931804,9608879
1642822714,197717,true,2592322925,28,2601151381,8828456
1642822731,197718,true,2592063718,28,2600891292,8827574
1642822869,197719,true,2591804538,28,2597772250,5967712
1642822916,197719,true,2591804538,28,2596473754,4669216
1642822924,197721,true,2591286255,28,2596214132,4927877
1642823051,197722,true,2591027152,28,2592322925,1295773
1642823078,197724,true,2590509024,28,2591545383,1036359
1642823098,197724,true,2590509024,28,2590768075,259051
1642823160,197726,true,2589991000,28,2588955263,-1035737
1642823200,197727,true,2589732027,28,2587919939,-1812088
1642823406,197728,true,2589473080,28,2582491281,-6981799
1642823436,197728,true,2589473080,28,2581716689,-7756391
1642823453,197729,true,2589214158,28,2581200423,-8013735
1642823471,197730,true,2588955263,28,2580684260,-8271003
1642823561,197732,true,2588437549,28,2577589451,-10848098
1642823664,197731,true,2588696393,28,2574240929,-14455464
1642823852,197730,true,2588955263,28,2569354759,-19600504
1642823885,197731,true,2588696393,28,2568584107,-20112286
1642824018,197732,true,2588437549,28,2565760359,-22677190
1642824069,197730,true,2588955263,28,2564734311,-24220952
1642824424,197729,true,2589214158,28,2559866185,-29347973
1642824805,197730,true,2588955263,28,2560122172,-28833091
1642824896,197732,true,2588437549,28,2560634222,-27803327
1642825132,197729,true,2589214158,28,2561914795,-27299363
1642825247,197728,true,2589473080,28,2562683447,-26789633
1642825463,197729,true,2589214158,28,2565760359,-23453799
1642825574,197730,true,2588955263,28,2566530164,-22425099
1642826040,197729,true,2589214158,28,2568327274,-20886884
1642826111,197728,true,2589473080,28,2568327274,-21145806
1642826147,197729,true,2589214158,28,2568070467,-21143691
1642826229,197730,true,2588955263,28,2567556930,-21398333
1642826373,197731,true,2588696393,28,2566016935,-22679458
1642826391,197731,true,2588696393,28,2566016935,-22679458
1642826402,197732,true,2588437549,28,2566016935,-22420614
1642826540,197734,true,2587919939,28,2564990784,-22929155
1642826619,197735,true,2587661173,28,2564477863,-23183310
1642827064,197734,true,2587919939,28,2563196009,-24723930
1642827075,197736,true,2587402433,28,2563196009,-24206424
1642827253,197738,true,2586885030,28,2561658629,-25226401
1642827672,197740,true,2586367731,28,2560122172,-26245559
1642827696,197739,true,2586626368,28,2559866185,-26760183
1642827911,197742,true,2585850535,28,2558074996,-27775539
1642827989,197745,true,2585074935,28,2557819214,-27255721
1642828145,197749,true,2584041163,28,2557052021,-26989142
1642828312,197749,true,2584041163,28,2556285059,-27756104
1642828338,197753,true,2583007805,28,2556029456,-26978349
1642828502,197756,true,2582233058,28,2555007300,-27225758
1642828529,197759,true,2581458543,28,2555007300,-26451243
1642828770,197758,true,2581716689,28,2554240951,-27475738
1642828794,197761,true,2580942328,28,2553985553,-26956775
1642829122,197765,true,2579910210,28,2551177853,-28732357
1642829148,197768,true,2579136391,28,2550922761,-28213630
1642829461,197767,true,2579394305,28,2546335459,-33058846
1642829521,197771,true,2578362805,28,2545571711,-32791094
1642829542,197775,true,2577331718,28,2545317180,-32014538
1642829638,197777,true,2576816329,28,2544044903,-32771426
1642829685,197777,true,2576816329,28,2543281842,-33534487
1642830146,197782,true,2575528307,28,2537693051,-37835256
1642830207,197785,true,2574755803,28,2536931896,-37823907
1642830321,197787,true,2574240929,28,2534649798,-39591131
1642830402,197787,true,2574240929,28,2532369753,-41871176
1642830428,197793,true,2572696925,28,2531863355,-40833570
1642830741,197796,true,2571925270,28,2525794472,-46130798
1642830782,197799,true,2571153847,28,2525289389,-45864458
1642830850,197799,true,2571153847,28,2523774746,-47379101
1642830926,197804,true,2569868656,28,2521756634,-48112022
1642830973,197809,true,2568584107,28,2520748184,-47835923
1642830997,197812,true,2567813685,28,2520244110,-47569575
1642831017,197813,true,2567556930,28,2519488188,-48068742
1642831024,197819,true,2566016935,28,2519488188,-46528747
1642831219,197825,true,2564477863,28,2513951683,-50526180
1642831225,197828,true,2563708674,28,2513700313,-50008361
1642831231,197829,true,2563452328,28,2513700313,-49752015
1642831246,197835,true,2561914795,28,2513197648,-48717147
1642831284,197839,true,2560890286,28,2512443840,-48446446
1642831394,197841,true,2560378184,28,2510936901,-49441283
1642831402,197842,true,2560122172,28,2510685832,-49436340
1642831453,197848,true,2558586636,28,2509681809,-48904827
1642831460,197852,true,2557563457,28,2509430866,-48132591
1642831474,197856,true,2556540688,28,2509179948,-47360740
1642831488,197857,true,2556285059,28,2508678187,-47606872
1642831509,197865,true,2554240951,28,2508176527,-46064424
1642831564,197868,true,2553474832,28,2507674967,-45799865
1642831673,197871,true,2552708943,28,2506421505,-46287438
1642831678,197872,true,2552453697,28,2506421505,-46032192
1642831776,197879,true,2550667694,28,2505419187,-45248507
1642831801,197882,true,2549902647,28,2505168670,-44733977
1642831983,197884,true,2549392743,28,2503916462,-45476281
1642831992,197886,true,2548882941,28,2503916462,-44966479
1642832034,197893,true,2547099436,28,2503415753,-43683683
1642832300,197896,true,2546335459,28,2501163805,-45171654
1642832433,197899,true,2545571711,28,2499913599,-45658112
1642832531,197900,true,2545317180,28,2499163775,-46153405
1642832632,197907,true,2543536170,28,2498913883,-44622287
1642832839,197909,true,2543027539,28,2500663648,-42363891
1642832874,197911,true,2542519010,28,2501163805,-41355205
1642832902,197912,true,2542264783,28,2501413922,-40850861
1642832933,197918,true,2540739958,28,2501664063,-39075895
1642832948,197921,true,2539977889,28,2501914230,-38063659
1642832980,197924,true,2539216048,28,2501914230,-37301818
1642833077,197926,true,2538708281,28,2502414637,-36293644
1642833282,197933,true,2536931896,28,2501664063,-35267833
1642833357,197937,true,2535917376,28,2501413922,-34503454
1642833408,197940,true,2535156753,28,2500913714,-34243039
1642833473,197942,true,2534649798,28,2499913599,-34736199
1642833504,197950,true,2532622990,28,2499413691,-33209299
1642833550,197954,true,2531610194,28,2498664017,-32946177
1642833586,197957,true,2530850863,28,2498164359,-32686504
1642833593,197959,true,2530344769,28,2498164359,-32180410
1642833644,197965,true,2528827093,28,2497914567,-30912526
1642833698,197968,true,2528068597,28,2497914567,-30154030
1642833723,197970,true,2527563059,28,2497914567,-29648492
1642833783,197971,true,2527310328,28,2498164359,-29145969
1642833804,197975,true,2526299657,28,2498414175,-27885482
1642833860,197975,true,2526299657,28,2499163775,-27135882
1642833890,197977,true,2525794472,28,2499413691,-26380781
1642834042,197977,true,2525794472,28,2501664063,-24130409
1642834343,197980,true,2525036886,28,2505669729,-19367157
1642834394,197979,true,2525289389,28,2505920296,-19369093
1642834445,197981,true,2524784407,28,2506170888,-18613519
1642834465,197981,true,2524784407,28,2506170888,-18613519
1642834522,197986,true,2523522394,28,2505920296,-17602098
1642834629,197987,true,2523270067,28,2505669729,-17600338
1642834802,197988,true,2523017765,28,2505419187,-17598578
1642834969,197989,true,2522765488,28,2506922815,-15842673
1642834982,197993,true,2521756634,28,2507173507,-14583127
1642834985,197992,true,2522008810,28,2507173507,-14835303
1642835072,197994,true,2521504484,28,2507674967,-13829517
1642835095,197996,true,2521000259,28,2507674967,-13325292
1642835096,198001,true,2519740136,28,2507674967,-12065169
1642835098,198000,true,2519992110,28,2507674967,-12317143
1642835107,198003,true,2519236264,28,2507674967,-11561297
1642835111,198005,true,2518732492,28,2507674967,-11057525
1642835126,198009,true,2517725251,28,2507925734,-9799517
1642835288,198008,true,2517977024,28,2510434789,-7542235
1642835335,198011,true,2517221782,28,2511439113,-5782669
1642835723,198012,true,2516970085,28,2513700313,-3269772
1642835735,198016,true,2515963548,28,2513700313,-2263235
1642835762,198015,true,2516215145,28,2513700313,-2514832
1642835766,198018,true,2515460431,28,2513700313,-1760118
1642835915,198020,true,2514957414,28,2512695084,-2262330
1642836102,198024,true,2513951683,28,2511439113,-2512570
1642836120,198023,true,2514203078,28,2511439113,-2763965
1642836177,198024,true,2513951683,28,2511187994,-2763689
1642836223,198025,true,2513700313,28,2511187994,-2512319
1642836248,198029,true,2512695084,28,2511187994,-1507090
1642836282,198029,true,2512695084,28,2511187994,-1507090
1642836404,198031,true,2512192620,28,2510685832,-1506788
1642836416,198034,true,2511439113,28,2510685832,-753281
1642836455,198038,true,2510434789,28,2510183770,-251019
1642836469,198038,true,2510434789,28,2510183770,-251019
1642836525,198041,true,2509681809,28,2509681809,0
1642836528,198044,true,2508929055,28,2509681809,752754
1642836616,198050,true,2507424224,28,2507925734,501510
1642836659,198050,true,2507424224,28,2506421505,-1002719
1642836680,198054,true,2506421505,28,2505669729,-751776
1642836719,198057,true,2505669729,28,2504166853,-1502876
1642836787,198064,true,2503916462,28,2501914230,-2002232
1642836809,198064,true,2503916462,28,2501413922,-2502540
1642836857,198068,true,2502915145,28,2500663648,-2251497
1642836884,198070,true,2502414637,28,2500163590,-2251047
1642836972,198076,true,2500913714,28,2498164359,-2749355
1642836977,198076,true,2500913714,28,2497914567,-2999147
1642837024,198080,true,2499913599,28,2496665985,-3247614
1642837125,198081,true,2499663632,28,2493921299,-5742333
1642837181,198087,true,2498164359,28,2492425470,-5738889
1642837423,198085,true,2498664017,28,2486948435,-11715582
1642837434,198088,true,2497914567,28,2486699765,-11214802
1642837497,198089,true,2497664801,28,2485208267,-12456534
1642837540,198094,true,2496416343,28,2484214432,-12201911
1642837606,198092,true,2496915651,28,2482972698,-13942953
1642837626,198094,true,2496416343,28,2482724425,-13691918
1642837771,198094,true,2496416343,28,2480491090,-15925253
1642837961,198098,true,2495418026,28,2477516434,-17901592
1642837983,198096,true,2495917135,28,2477268708,-18648427
1642838023,198099,true,2495168509,28,2476525676,-18642833
1642838150,198099,true,2495168509,28,2474545346,-20623163
1642838226,198103,true,2494170691,28,2473803131,-20367560
1642838271,198100,true,2494919017,28,2473308445,-21610572
1642838524,198102,true,2494420108,28,2474297917,-20122191
1642838601,198102,true,2494420108,28,2475040280,-19379828
1642838619,198106,true,2493422590,28,2475287784,-18134806
1642838633,198102,true,2494420108,28,2475535313,-18884795
1642838682,198103,true,2494170691,28,2476030445,-18140246
1642838729,198102,true,2494420108,28,2476773328,-17646780
1642838749,198105,true,2493671932,28,2477021006,-16650926
1642838929,198102,true,2494420108,28,2480491090,-13929018
1642839051,198104,true,2493921299,28,2481731584,-12189715
1642839224,198102,true,2494420108,28,2483717664,-10702444
1642839282,198105,true,2493671932,28,2484462854,-9209078
1642839298,198102,true,2494420108,28,2484462854,-9957254
1642839350,198103,true,2494170691,28,2485208267,-8962424
1642839380,198101,true,2494669550,28,2485456788,-9212762
1642839397,198103,true,2494170691,28,2485705334,-8465357
1642839490,198102,true,2494420108,28,2485953904,-8466204
1642839773,198105,true,2493671932,28,2485208267,-8463665
1642839907,198104,true,2493921299,28,2485208267,-8713032
1642839986,198106,true,2493422590,28,2485456788,-7965802
1642840082,198106,true,2493422590,28,2485705334,-7717256
1642840107,198109,true,2492674713,28,2485953904,-6720809
1642840330,198106,true,2493422590,28,2489436503,-3986087
1642840511,198109,true,2492674713,28,2490183408,-2491305
1642840545,198107,true,2493173272,28,2490183408,-2989864
1642840563,198110,true,2492425470,28,2490183408,-2242062
1642840589,198108,true,2492923980,28,2489934415,-2989565
1642840754,198111,true,2492176252,28,2488689821,-3486431
1642840986,198110,true,2492425470,28,2487197130,-5228340
1642841036,198113,true,2491677892,28,2486699765,-4978127
1642841039,198111,true,2492176252,28,2486699765,-5476487
1642841103,198114,true,2491428749,28,2485953904,-5474845
1642841453,198113,true,2491677892,28,2484711300,-6966592
1642841495,198116,true,2490930538,28,2484711300,-6219238
1642841556,198114,true,2491428749,28,2484711300,-6717449
1642841796,198116,true,2490930538,28,2484462854,-6467684
1642841910,198115,true,2491179631,28,2483966036,-7213595
1642841927,198118,true,2490432427,28,2483717664,-6714763
1642841967,198115,true,2491179631,28,2483220995,-7958636
1642842081,198118,true,2490432427,28,2481731584,-8700843
1642842141,198116,true,2490930538,28,2480987213,-9943325
1642842155,198119,true,2490183408,28,2480739139,-9444269
1642842218,198116,true,2490930538,28,2479995066,-10935472
1642842304,198120,true,2489934415,28,2479003316,-10931099
1642842333,198121,true,2489685446,28,2478755440,-10930006
1642842358,198124,true,2488938690,28,2478755440,-10183250
1642842420,198121,true,2489685446,28,2478507590,-11177856
1642842589,198126,true,2488440977,28,2477021006,-11419971
1642842717,198127,true,2488192158,28,2475782866,-12409292
1642842747,198131,true,2487197130,28,2475040280,-12156850
1642842782,198130,true,2487445849,28,2474297917,-13147932
1642842805,198135,true,2486202499,28,2474050511,-12151988
1642842814,198138,true,2485456788,28,2473803131,-11653657
1642842876,198142,true,2484462854,28,2472566601,-11896253
1642842915,198139,true,2485208267,28,2472072161,-13136106
1642842931,198143,true,2484214432,28,2472072161,-12142271
1642843068,198144,true,2483966036,28,2470836496,-13129540
1642843069,198147,true,2483220995,28,2470836496,-12384499
1642843193,198144,true,2483966036,28,2470836496,-13129540
1642843229,198148,true,2482972698,28,2470836496,-12136202
1642843298,198149,true,2482724425,28,2470342403,-12382022
1642843437,198152,true,2481979757,28,2469601448,-12378309
1642843484,198149,true,2482724425,28,2469354513,-13369912
1642843764,198153,true,2481731584,28,2468367018,-13364566
1642843931,198153,true,2481731584,28,2467873419,-13858165
1642844005,198156,true,2480987213,28,2467379918,-13607295
1642844274,198155,true,2481235312,28,2464174568,-17060744
1642844306,198159,true,2480243066,28,2463681807,-16561259
1642844369,198162,true,2479499141,28,2462696581,-16802560
1642844394,198165,true,2478755440,28,2462450336,-16305104
1642844457,198165,true,2478755440,28,2461465602,-17289838
1642844478,198171,true,2477268708,28,2460973383,-16295325
1642844501,198173,true,2476773328,28,2460481262,-16292066
1642844554,198178,true,2475535313,28,2459251390,-16283923
1642844572,198179,true,2475287784,28,2459005490,-16282294
1642844607,198184,true,2474050511,28,2458513762,-15536749
1642844626,198187,true,2473308445,28,2458022133,-15286312
1642844662,198191,true,2472319369,28,2457776356,-14543013
1642844716,198192,true,2472072161,28,2456793491,-15278670
1642844727,198197,true,2470836496,28,2456547836,-14288660
1642844752,198200,true,2470095393,28,2455811019,-14284374
1642844843,198203,true,2469354513,28,2453847254,-15507259
1642844885,198203,true,2469354513,28,2452375461,-16979052
1642844958,198209,true,2467873419,28,2449189603,-18683816
1642844985,198212,true,2467133205,28,2447720604,-19412601
1642845028,198216,true,2466146598,28,2445763308,-20383290
1642845050,198217,true,2465900008,28,2445029726,-20870282
1642845070,198221,true,2464913895,28,2444296364,-20617531
1642845095,198222,true,2464667428,28,2443563221,-21104207
1642845100,198223,true,2464420986,28,2443318889,-21102097
1642845127,198223,true,2464420986,28,2442586040,-21834946
1642845299,198226,true,2463681807,28,2437462248,-26219559
1642845377,198227,true,2463435464,28,2435026125,-28409339
1642845485,198229,true,2462942851,28,2431619644,-31323207
1642845490,198230,true,2462696581,28,2431376507,-31320074
1642845500,198234,true,2461711748,28,2430890304,-30821444
1642845519,198235,true,2461465602,28,2430404199,-31061403
1642845578,198239,true,2460481262,28,2427975131,-32506131
1642845601,198240,true,2460235238,28,2427004184,-33231054
1642845655,198245,true,2459005490,28,2424336080,-34669410
1642845696,198248,true,2458267935,28,2422639724,-35628211
1642845740,198252,true,2457284874,28,2420702484,-36582390
1642845746,198253,true,2457039170,28,2420460438,-36578732
1642845807,198259,true,2455565462,28,2417557772,-38007690
1642845840,198262,true,2454828940,28,2416107745,-38721195
1642845887,198267,true,2453601894,28,2413934335,-39667559
1642845947,198269,true,2453111247,28,2411039496,-42071751
1642845958,198276,true,2451394756,28,2410557360,-40837396
1642845983,198280,true,2450414443,28,2409352443,-41062000
1642845993,198286,true,2448944709,28,2408629782,-40314927
1642846033,198288,true,2448454993,28,2406703745,-41751248
1642846038,198294,true,2446986434,28,2406222476,-40763958
1642846056,198298,true,2446007884,28,2405260228,-40747656
1642846069,198304,true,2444540793,28,2404298364,-40242429
1642846089,198308,true,2443563221,28,2403096576,-40466645
1642846111,198313,true,2442341806,28,2402135577,-40206229
1642846136,198317,true,2441365114,28,2400934870,-40430244
1642846161,198324,true,2439656841,28,2399494813,-40162028
1642846207,198329,true,2438437379,28,2396856952,-41580427
1642846235,198335,true,2436974828,28,2394940329,-42034499
1642846306,198341,true,2435513155,28,2390394489,-45118666
1642846337,198349,true,2433565621,28,2388721882,-44843739
1642846344,198355,true,2432105993,28,2388483034,-43622959
1642846379,198361,true,2430647240,28,2386573107,-44074133
1642846414,198368,true,2428946467,28,2384664707,-44281760
1642846448,198375,true,2427246884,28,2382757834,-44489050
1642846476,198381,true,2425791046,28,2381328679,-44462367
1642846483,198387,true,2424336080,28,2380852485,-43483595
1642846600,198391,true,2423366588,28,2375620628,-47745960
1642846645,198397,true,2421913077,28,2373246314,-48666763
1642846656,198403,true,2420460438,28,2372534482,-47925956
1642846688,198409,true,2419008670,28,2370874372,-48134298
1642846701,198415,true,2417557772,28,2370400268,-47157504
1642846710,198421,true,2416107745,28,2369926260,-46181485
1642846743,198427,true,2414658588,28,2368741652,-45916936
1642846791,198433,true,2413210300,28,2367320904,-45889396
1642846814,198438,true,2412004056,28,2366610850,-45393206
1642846891,198445,true,2410316329,28,2363536408,-46779921
1642846894,198450,true,2409111532,28,2363536408,-45575124
1642846901,198454,true,2408148128,28,2363300078,-44848050
1642846930,198459,true,2406944415,28,2362118783,-44825632
1642846944,198464,true,2405741304,28,2361646430,-44094874
1642846993,198469,true,2404538794,28,2360229938,-44308856
1642847008,198473,true,2403577219,28,2359757963,-43819256
1642847012,198477,true,2402616028,28,2359522010,-43094018
1642847030,198482,true,2401415081,28,2359050177,-42364904
1642847082,198484,true,2400934870,28,2358342603,-42592267
1642847098,198487,true,2400214733,28,2358106792,-42107941
1642847199,198491,true,2399254887,28,2356692423,-42562464
1642847204,198495,true,2398295425,28,2356692423,-41603002
1642847272,198497,true,2397815838,28,2355985557,-41830281
1642847304,198500,true,2397096637,28,2355749982,-41346655
1642847319,198503,true,2396377652,28,2355749982,-40627670
1642847364,198506,true,2395658883,28,2355985557,-39673326
1642847401,198507,true,2395419341,28,2356221156,-39198185
1642847430,198509,true,2394940329,28,2356692423,-38247906
1642847444,198512,true,2394221990,28,2356692423,-37529567
1642847472,198516,true,2393264541,28,2356928093,-36336448
1642847495,198518,true,2392785960,28,2356928093,-35857867
1642847508,198520,true,2392307474,28,2357163786,-35143688
1642847530,198523,true,2391589926,28,2357399502,-34190424
1642847550,198526,true,2390872592,28,2357635242,-33237350
1642847558,198526,true,2390872592,28,2357635242,-33237350
1642847561,198528,true,2390394489,28,2357635242,-32759247
1642847568,198528,true,2390394489,28,2357871005,-32523484
1642847613,198530,true,2389916482,28,2359286082,-30630400
1642847626,198530,true,2389916482,28,2359757963,-30158519
1642847633,198532,true,2389438570,28,2359993938,-29444632
1642847676,198533,true,2389199650,28,2361410289,-27789361
1642847696,198534,true,2388960754,28,2362118783,-26841971
1642847718,198535,true,2388721882,28,2363063772,-25658110
1642847749,198537,true,2388244209,28,2364481965,-23762244
1642847775,198537,true,2388244209,28,2365664442,-22579767
1642847844,198538,true,2388005409,28,2369452345,-18553064
1642847998,198538,true,2388005409,28,2378235118,-9770291
1642848012,198539,true,2387766632,28,2379186555,-8580077
1642848115,198540,true,2387527879,28,2386811764,-716115
1642848195,198540,true,2387527879,28,2392546705,5018826
1642848217,198540,true,2387527879,28,2393982592,6454713
1642848245,198540,true,2387527879,28,2395898448,8370569
1642848304,198540,true,2387527879,28,2399974736,12446857
1642848331,198540,true,2387527879,28,2401655222,14127343
1642848405,198538,true,2388005409,28,2406463099,18457690
1642848431,198538,true,2388005409,28,2408148128,20142719
1642848463,198538,true,2388005409,28,2410557360,22551951
1642848576,198537,true,2388244209,28,2418283112,30038903
1642848584,198534,true,2388960754,28,2418766793,29806039
1642848606,198534,true,2388960754,28,2419976418,31015664
1642848619,198533,true,2389199650,28,2420702484,31502834
1642848641,198534,true,2388960754,28,2421913077,32952323
1642848718,198532,true,2389438570,28,2425791046,36352476
1642848795,198533,true,2389199650,28,2428946467,39746817
1642848846,198533,true,2389199650,28,2430404199,41204549
1642848931,198533,true,2389199650,28,2432592438,43392788
1642849145,198531,true,2389677514,28,2437218526,47541012
1642849176,198530,true,2389916482,28,2437949764,48033282
1642849266,198529,true,2390155474,28,2440144797,49989323
1642849271,198527,true,2390633529,28,2440388812,49755283
1642849280,198524,true,2391350790,28,2440388812,49038022
1642849296,198523,true,2391589926,28,2440876914,49286988
1642849318,198523,true,2391589926,28,2441365114,49775188
1642849355,198523,true,2391589926,28,2442097596,50507670
1642849366,198520,true,2392307474,28,2442341806,50034332
1642849389,198519,true,2392546705,28,2442341806,49795101
1642849390,198520,true,2392307474,28,2442341806,50034332
1642849427,198518,true,2392785960,28,2442830299,50044339
1642849451,198514,true,2393743218,28,2443318889,49575671
1642849560,198511,true,2394461412,28,2445029726,50568314
1642849617,198511,true,2394461412,28,2445763308,51301896
1642849664,198508,true,2395179823,28,2446007884,50828061
1642849704,198504,true,2396138038,28,2446007884,49869846
1642849794,198502,true,2396617290,28,2446252485,49635195
1642849915,198502,true,2396617290,28,2445763308,49146018
1642849927,198498,true,2397576081,28,2445763308,48187227
1642850219,198495,true,2398295425,28,2444051958,45756533
1642850289,198493,true,2398775108,28,2443807578,45032470
1642850309,198492,true,2399014986,28,2443563221,44548235
1642850311,198488,true,2399974736,28,2443563221,43588485
1642850444,198485,true,2400694800,28,2442830299,42135499
1642850496,198482,true,2401415081,28,2443074582,41659501
1642850518,198482,true,2401415081,28,2443074582,41659501
1642850593,198477,true,2402616028,28,2443563221,40947193
1642850613,198473,true,2403577219,28,2443807578,40230359
1642850664,198470,true,2404298364,28,2444051958,39753594
1642850983,198469,true,2404538794,28,2444540793,40001999
1642851042,198464,true,2405741304,28,2444051958,38310654
1642851279,198458,true,2407185110,28,2443074582,35889472
1642851307,198456,true,2407666571,28,2442586040,34919469
1642851575,198456,true,2407666571,28,2438925091,31258520
1642851715,198450,true,2409111532,28,2438193559,29082027
1642851727,198445,true,2410316329,28,2437949764,27633435
1642851730,198441,true,2411280600,28,2437949764,26669164
1642851746,198439,true,2411762880,28,2437949764,26186884
1642851762,198435,true,2412727730,28,2437705994,24978264
1642851805,198429,true,2414175729,28,2437462248,23286519
1642851937,198427,true,2414658588,28,2435513155,20854567
1642851987,198425,true,2415141544,28,2434539193,19397649
1642852000,198421,true,2416107745,28,2434295764,18188019
1642852088,198416,true,2417316041,28,2432592438,15276397
1642852093,198414,true,2417799528,28,2432349203,14549675
1642852214,198416,true,2417316041,28,2429675224,12359183
1642852224,198411,true,2418524940,28,2429432280,10907340
1642852366,198407,true,2419492496,28,2426033625,6541129
1642852384,198405,true,2419976418,28,2425791046,5814628
1642852472,198404,true,2420218416,28,2424336080,4117664
1642852519,198398,true,2421670910,28,2423608925,1938015
1642852569,198394,true,2422639724,28,2422881988,242264
1642852595,198393,true,2422881988,28,2422639724,-242264
1642852828,198390,true,2423608925,28,2422155268,-1453657
1642852943,198385,true,2424820972,28,2421670910,-3150062
1642853044,198380,true,2426033625,28,2420702484,-5331141
1642853074,198379,true,2426276228,28,2420460438,-5815790
1642853104,198377,true,2426761508,28,2420460438,-6301070
1642853503,198373,true,2427732358,28,2420218416,-7513942
1642853522,198368,true,2428946467,28,2420218416,-8728051
1642853766,198367,true,2429189362,28,2423851286,-5338076
1642853820,198365,true,2429675224,28,2425063454,-4611770
1642853829,198360,true,2430890304,28,2425305960,-5584344
1642853921,198358,true,2431376507,28,2427732358,-3644149
1642854367,198357,true,2431619644,28,2440876914,9257270
1642854514,198355,true,2432105993,28,2442341806,10235813
1642854525,198350,true,2433322289,28,2442586040,9263751
1642854538,198349,true,2433565621,28,2442586040,9020419
1642854667,198348,true,2433808978,28,2443318889,9509911
1642854683,198348,true,2433808978,28,2443563221,9754243
1642854747,198344,true,2434782647,28,2443807578,9024931
1642854762,198343,true,2435026125,28,2444051958,9025833
1642854793,198343,true,2435026125,28,2444296364,9270239
1642854964,198342,true,2435269628,28,2445518756,10249128
1642854999,198337,true,2436487506,28,2445763308,9275802
1642855045,198336,true,2436731155,28,2446497110,9765955
1642855490,198335,true,2436974828,28,2451149641,14174813
1642855528,198333,true,2437462248,28,2451394756,13932508
1642855550,198329,true,2438437379,28,2451639895,13202516
1642855602,198328,true,2438681223,28,2452130248,13449025
1642855615,198326,true,2439168983,28,2452375461,13206478
1642855652,198324,true,2439656841,28,2452865960,13209119
1642855749,198321,true,2440388812,28,2454583482,14194670
1642856085,198320,true,2440632851,28,2459989239,19356388
1642856096,198318,true,2441121001,28,2460235238,19114237
1642856799,198316,true,2441609250,28,2476278048,34668798
1642856829,198314,true,2442097596,28,2476773328,34675732
1642856845,198313,true,2442341806,28,2477021006,34679200
1642856852,198312,true,2442586040,28,2477021006,34434966
1642857113,198311,true,2442830299,28,2479995066,37164767
1642857148,198309,true,2443318889,28,2480491090,37172201
1642857164,198308,true,2443563221,28,2480491090,36927869
1642857223,198307,true,2443807578,28,2481483435,37675857
1642857245,198307,true,2443807578,28,2481731584,37924006
1642857360,198304,true,2444540793,28,2483966036,39425243
1642857364,198303,true,2444785247,28,2483966036,39180789
1642857437,198301,true,2445274229,28,2485208267,39934038
1642857465,198300,true,2445518756,28,2485705334,40186578
1642857493,198296,true,2446497110,28,2485953904,39456794
1642857499,198296,true,2446497110,28,2486202499,39705389
1642857563,198293,true,2447231133,28,2486948435,39717302
1642857622,198292,true,2447475856,28,2487943363,40467507
1642857719,198288,true,2448454993,28,2489187584,40732591
1642857749,198287,true,2448699839,28,2489436503,40736664
1642857792,198285,true,2449189603,28,2489934415,40744812
1642857804,198284,true,2449434522,28,2490183408,40748886
1642857945,198279,true,2450659484,28,2491677892,41018408
1642857986,198277,true,2451149641,28,2491927060,40777419
1642858172,198275,true,2451639895,28,2492923980,41284085
1642858594,198274,true,2451885059,28,2494170691,42285632
1642858712,198270,true,2452865960,28,2494669550,41803590
1642858724,198268,true,2453356558,28,2494669550,41312992
1642858789,198266,true,2453847254,28,2494919017,41071763
1642858887,198267,true,2453601894,28,2495168509,41566615
1642859055,198264,true,2454338048,28,2494420108,40082060
1642859143,198263,true,2454583482,28,2494170691,39587209
1642859163,198262,true,2454828940,28,2493921299,39092359
1642859314,198262,true,2454828940,28,2490681470,35852530
1642859571,198259,true,2455565462,28,2486451120,30885658
1642859628,198258,true,2455811019,28,2485208267,29397248
1642860219,198257,true,2456056600,28,2475535313,19478713
1642860454,198258,true,2455811019,28,2471824979,16013960
1642860570,198256,true,2456302206,28,2470342403,14040197
1642860743,198257,true,2456056600,28,2468367018,12310418
1642860798,198258,true,2455811019,28,2467873419,12062400
1642860925,198259,true,2455565462,28,2466639852,11074390
1642860958,198257,true,2456056600,28,2466146598,10089998
1642861223,198258,true,2455811019,28,2464174568,8363549
1642861968,198258,true,2455811019,28,2460235238,4424219
1642862038,198258,true,2455811019,28,2459743265,3932246
1642862228,198256,true,2456302206,28,2458759614,2457408
1642862282,198256,true,2456302206,28,2458759614,2457408
1642862631,198255,true,2456547836,28,2460235238,3687402
1642862656,198255,true,2456547836,28,2460235238,3687402
1642862743,198252,true,2457284874,28,2460481262,3196388
1642862837,198252,true,2457284874,28,2460727310,3442436
1642862974,198251,true,2457530603,28,2460973383,3442780
1642863010,198251,true,2457530603,28,2461219480,3688877
1642863042,198249,true,2458022133,28,2460973383,2951250
1642863054,198248,true,2458267935,28,2460973383,2705448
1642863077,198248,true,2458267935,28,2460973383,2705448
1642863185,198250,true,2457776356,28,2459497315,1720959
1642863216,198248,true,2458267935,28,2459251390,983455
1642863251,198248,true,2458267935,28,2458759614,491679
1642863315,198248,true,2458267935,28,2458267935,0
1642863359,198250,true,2457776356,28,2457284874,-491482
1642863477,198249,true,2458022133,28,2454828940,-3193193
1642863643,198250,true,2457776356,28,2451149641,-6626715
1642863747,198250,true,2457776356,28,2448944709,-8831647
1642863877,198252,true,2457284874,28,2446497110,-10787764
1642863881,198251,true,2457530603,28,2446497110,-11033493
1642863905,198250,true,2457776356,28,2446007884,-11768472
1642864039,198250,true,2457776356,28,2443318889,-14457467
1642864062,198252,true,2457284874,28,2442830299,-14454575
1642864110,198250,true,2457776356,28,2441609250,-16167106
1642864336,198250,true,2457776356,28,2434782647,-22993709
1642864363,198249,true,2458022133,28,2433808978,-24213155
1642864555,198250,true,2457776356,28,2427975131,-29801225
1642864668,198248,true,2458267935,28,2424820972,-33446963
1642864709,198247,true,2458513762,28,2423366588,-35147174
1642864779,198247,true,2458513762,28,2421186649,-37327113
1642864910,198250,true,2457776356,28,2416590991,-41185365
1642865001,198249,true,2458022133,28,2414417146,-43604987
1642865113,198250,true,2457776356,28,2411521728,-46254628
1642865212,198250,true,2457776356,28,2410075321,-47701035
1642865353,198254,true,2456793491,28,2408629782,-48163709
1642865391,198254,true,2456793491,28,2408148128,-48645363
1642865410,198254,true,2456793491,28,2407907337,-48886154
1642865412,198254,true,2456793491,28,2407907337,-48886154
1642865464,198259,true,2455565462,28,2407185110,-48380352
1642865672,198260,true,2455319930,28,2403096576,-52223354
1642865723,198261,true,2455074423,28,2402856290,-52218133
1642865737,198261,true,2455074423,28,2402616028,-52458395
1642865838,198265,true,2454092639,28,2401895388,-52197251
1642865986,198266,true,2453847254,28,2400694800,-53152454
1642866043,198267,true,2453601894,28,2400454755,-53147139
1642866422,198269,true,2453111247,28,2397336347,-55774900
1642866567,198273,true,2452130248,28,2396856952,-55273296
1642866629,198274,true,2451885059,28,2396856952,-55028107
1642866711,198275,true,2451639895,28,2396856952,-54782943
1642866722,198277,true,2451149641,28,2396856952,-54292689
1642866772,198281,true,2450169426,28,2396856952,-53312474
1642866857,198282,true,2449924434,28,2396377652,-53546782
1642866865,198284,true,2449434522,28,2396138038,-53296484
1642866887,198285,true,2449189603,28,2396138038,-53051565
1642867171,198290,true,2447965376,28,2394221990,-53743386
1642867238,198291,true,2447720604,28,2393982592,-53738012
1642867299,198292,true,2447475856,28,2393982592,-53493264
1642867366,198295,true,2446741760,28,2393743218,-52998542
1642867465,198300,true,2445518756,28,2393264541,-52254215
1642867515,198302,true,2445029726,28,2392546705,-52483021
1642867565,198304,true,2444540793,28,2391589926,-52950867
1642867583,198308,true,2443563221,28,2391350790,-52212431
1642867667,198315,true,2441853411,28,2389916482,-51936929
1642867683,198318,true,2441121001,28,2389677514,-51443487
1642867714,198320,true,2440632851,28,2389438570,-51194281
1642867843,198321,true,2440388812,28,2389199650,-51189162
1642867866,198328,true,2438681223,28,2389199650,-49481573
1642867884,198330,true,2438193559,28,2389438570,-48754989
1642867898,198332,true,2437705994,28,2389438570,-48267424
1642867970,198333,true,2437462248,28,2389916482,-47545766
1642867990,198337,true,2436487506,28,2390394489,-46093017
1642868046,198339,true,2436000282,28,2391111679,-44888603
1642868406,198339,true,2436000282,28,2398775108,-37225174
1642868436,198339,true,2436000282,28,2399494813,-36505469
1642868629,198344,true,2434782647,28,2404779248,-30003399
1642868652,198347,true,2434052358,28,2405741304,-28311054
1642868722,198346,true,2434295764,28,2408148128,-26147636
1642868727,198347,true,2434052358,28,2408388943,-25663415
1642868758,198351,true,2433078981,28,2409352443,-23726538
1642868858,198354,true,2432349203,28,2413210300,-19138903
1642868927,198353,true,2432592438,28,2415866159,-16726279
1642868963,198354,true,2432349203,28,2417316041,-15033162
1642869017,198359,true,2431133393,28,2419250571,-11882822
1642869193,198361,true,2430647240,28,2425791046,-4856194
1642869288,198361,true,2430647240,28,2429675224,-972016
1642869329,198362,true,2430404199,28,2431619644,1215445
1642869439,198366,true,2429432280,28,2436487506,7055226
1642869452,198369,true,2428703597,28,2437218526,8514929
1642869461,198368,true,2428946467,28,2437462248,8515781
1642869693,198370,true,2428460750,28,2443563221,15102471
1642870014,198374,true,2427489609,28,2445763308,18273699
1642870058,198376,true,2427004184,28,2445763308,18759124
1642870190,198376,true,2427004184,28,2445274229,18270045
1642870247,198378,true,2426518856,28,2445274229,18755373
1642870279,198382,true,2425548491,28,2444785247,19236756
1642870373,198384,true,2425063454,28,2444051958,18988504
1642870423,198384,true,2425063454,28,2443563221,18499767
1642870514,198386,true,2424578514,28,2442586040,18007526
1642870569,198389,true,2423851286,28,2441853411,18002125
1642870631,198391,true,2423366588,28,2441121001,17754413
1642870790,198391,true,2423366588,28,2438681223,15314635
1642870813,198391,true,2423366588,28,2438437379,15070791
1642870829,198395,true,2422397484,28,2438193559,15796075
1642870845,198396,true,2422155268,28,2438193559,16038291
1642871042,198394,true,2422639724,28,2436974828,14335104
1642871508,198394,true,2422639724,28,2435513155,12873431
1642871600,198398,true,2421670910,28,2434295764,12624854
1642871619,198399,true,2421428767,28,2434052358,12623591
1642871734,198398,true,2421670910,28,2431862806,10191896
1642871801,198401,true,2420944554,28,2430890304,9945750
1642872049,198404,true,2420218416,28,2429432280,9213864
1642872195,198405,true,2419976418,28,2428946467,8970049
1642872206,198404,true,2420218416,28,2428946467,8728051
1642872431,198408,true,2419250571,28,2426518856,7268285
1642872499,198412,true,2418283112,28,2425548491,7265379
1642872570,198414,true,2417799528,28,2424093671,6294143
1642872752,198414,true,2417799528,28,2419492496,1692968
1642873104,198418,true,2416832650,28,2411039496,-5793154
1642873140,198422,true,2415866159,28,2410075321,-5790838
1642873177,198424,true,2415383058,28,2408870645,-6512413
1642873196,198423,true,2415624596,28,2408388943,-7235653
1642873227,198427,true,2414658588,28,2407666571,-6992017
1642873262,198429,true,2414175729,28,2406703745,-7471984
1642873312,198431,true,2413692966,28,2405260228,-8432738
1642873327,198430,true,2413934335,28,2405019726,-8914609
1642873383,198434,true,2412969003,28,2404298364,-8670639
1642873402,198436,true,2412486481,28,2403817577,-8668904
1642873420,198437,true,2412245257,28,2403577219,-8668038
1642873758,198434,true,2412969003,28,2400454755,-12514248
1642873784,198438,true,2412004056,28,2400214733,-11789323
1642873813,198440,true,2411521728,28,2399734762,-11786966
1642873854,198441,true,2411280600,28,2399014986,-12265614
1642873965,198439,true,2411762880,28,2397336347,-14426533
1642874081,198443,true,2410798416,28,2395419341,-15379075
1642874259,198445,true,2410316329,28,2392307474,-18008855
1642874410,198446,true,2410075321,28,2391111679,-18963642
1642874573,198444,true,2410557360,28,2389677514,-20879846
1642874622,198448,true,2409593378,28,2389199650,-20393728
1642874685,198450,true,2409111532,28,2388005409,-21106123
1642874768,198452,true,2408629782,28,2386811764,-21818018
1642874792,198450,true,2409111532,28,2386334474,-22777058
1642874801,198454,true,2408148128,28,2386095864,-22052264
1642874894,198456,true,2407666571,28,2383949451,-23717120
1642874926,198458,true,2407185110,28,2383234409,-23950701
1642875076,198455,true,2407907337,28,2381090570,-26816767
1642875205,198459,true,2406944415,28,2378948660,-27995755
1642875223,198461,true,2406463099,28,2378472942,-27990157
1642875315,198463,true,2405981878,28,2376571019,-29410859
1642875317,198461,true,2406463099,28,2376571019,-29892080
1642875378,198464,true,2405741304,28,2375858190,-29883114
1642875554,198464,true,2405741304,28,2374433174,-31308130
1642875638,198464,true,2405741304,28,2373958359,-31782945
1642876005,198463,true,2405981878,28,2373720987,-32260891
1642876052,198466,true,2405260228,28,2373483638,-31776590
1642876071,198466,true,2405260228,28,2373483638,-31776590
1642876153,198468,true,2404779248,28,2372534482,-32244766
1642876177,198469,true,2404538794,28,2371585706,-32953088
1642876194,198473,true,2403577219,28,2371348571,-32228648
1642876204,198474,true,2403336885,28,2371111460,-32225425
1642876217,198478,true,2402375791,28,2370874372,-31501419
1642876242,198476,true,2402856290,28,2370637308,-32218982
1642876332,198480,true,2401895388,28,2368978526,-32916862
1642876348,198480,true,2401895388,28,2368741652,-33153736
1642876369,198484,true,2400934870,28,2368267975,-32666895
1642876542,198483,true,2401174963,28,2365427899,-35747064
1642876632,198487,true,2400214733,28,2364245540,-35969193
1642876687,198487,true,2400214733,28,2364009139,-36205594
1642876767,198491,true,2399254887,28,2362354995,-36899892
1642876772,198490,true,2399494813,28,2362354995,-37139818
1642876862,198495,true,2398295425,28,2360465961,-37829464
1642877049,198495,true,2398295425,28,2357635242,-40660183
1642877105,198499,true,2397336347,28,2356692423,-40643924
1642877155,198497,true,2397815838,28,2355749982,-42065856
1642877195,198501,true,2396856952,28,2355278903,-41578049
1642877440,198499,true,2397336347,28,2351513658,-45822689
1642877452,198502,true,2396617290,28,2351513658,-45103632
1642877495,198501,true,2396856952,28,2350808345,-46048607
1642877714,198506,true,2395658883,28,2346815565,-48843318
1642877746,198506,true,2395658883,28,2346346272,-49312611
1642877801,198509,true,2394940329,28,2344938957,-50001372
1642877916,198509,true,2394940329,28,2343063850,-51876479
1642878024,198517,true,2393025238,28,2342361071,-50664167
1642878150,198517,true,2393025238,28,2341658503,-51366735
1642878200,198522,true,2391829085,28,2341658503,-50170582
1642878361,198522,true,2391829085,28,2342361071,-49468014
1642878417,198530,true,2389916482,28,2342595307,-47321175
1642878611,198530,true,2389916482,28,2345173451,-44743031
1642878621,198534,true,2388960754,28,2345173451,-43787303
1642878675,198535,true,2388721882,28,2345642509,-43079373
1642878717,198544,true,2386573107,28,2345877073,-40696034
1642878728,198545,true,2386334474,28,2345877073,-40457401
1642878845,198550,true,2385141664,28,2347284952,-37856712
1642878921,198552,true,2384664707,28,2347754432,-36910275
1642878943,198560,true,2382757834,28,2347754432,-35003402
1642878951,198561,true,2382519582,28,2347989208,-34530374
1642879122,198565,true,2381566812,28,2347519680,-34047132
1642879157,198567,true,2381090570,28,2347284952,-33805618
1642879273,198575,true,2379186555,28,2346111661,-33074894
1642879391,198578,true,2378472942,28,2345173451,-33299491
1642879432,198582,true,2377521790,28,2344938957,-32582833
1642879495,198584,true,2377046357,28,2344235616,-32810741
1642879636,198593,true,2374908085,28,2342829567,-32078518
1642879654,198595,true,2374433174,28,2342829567,-31603607
1642879899,198599,true,2373483638,28,2341892669,-31590969
1642879922,198601,true,2373009013,28,2341892669,-31116344
1642879967,198609,true,2371111460,28,2342126859,-28984601
1642880029,198609,true,2371111460,28,2341658503,-29452957
1642880228,198612,true,2370400268,28,2340722074,-29678194
1642880247,198613,true,2370163252,28,2340488025,-29675227
1642880318,198621,true,2368267975,28,2340254000,-28013975
1642880379,198622,true,2368031171,28,2340019998,-28011173
1642880415,198625,true,2367320904,28,2339786019,-27534885
1642880490,198626,true,2367084196,28,2340019998,-27064198
1642880531,198633,true,2365427899,28,2340019998,-25407901
1642880546,198634,true,2365191380,28,2340019998,-25171382
1642880589,198637,true,2364481965,28,2339786019,-24695946
1642880796,198640,true,2363772762,28,2338850339,-24922423
1642880902,198648,true,2361882594,28,2338382639,-23499955
1642880919,198648,true,2361882594,28,2338382639,-23499955
1642880950,198651,true,2361174171,28,2338616477,-22557694
1642880969,198652,true,2360938077,28,2338850339,-22087738
1642881126,198656,true,2359993938,28,2340956146,-19037792
1642881167,198656,true,2359993938,28,2341892669,-18101269
1642881225,198659,true,2359286082,28,2342829567,-16456515
1642881242,198660,true,2359050177,28,2343063850,-15986327
1642881313,198664,true,2358106792,28,2344001216,-14105576
1642881395,198665,true,2357871005,28,2344938957,-12932048
1642881514,198668,true,2357163786,28,2346111661,-11052125
1642881695,198669,true,2356928093,28,2346815565,-10112528
1642881786,198673,true,2355985557,28,2346580907,-9404650
1642881985,198674,true,2355749982,28,2345173451,-10576531
1642882048,198677,true,2355043398,28,2344704487,-10338911
1642882093,198679,true,2354572460,28,2344470040,-10102420
1642882102,198682,true,2353866230,28,2344470040,-9396190
1642882150,198682,true,2353866230,28,2344470040,-9396190
1642882300,198682,true,2353866230,28,2346346272,-7519958
1642882343,198682,true,2353866230,28,2347754432,-6111798
1642882370,198684,true,2353395527,28,2348693675,-4701852
1642882382,198683,true,2353630867,28,2349163437,-4467430
1642882475,198678,true,2354807918,28,2353395527,-1412391
1642882569,198678,true,2354807918,28,2357871005,3063087
1642882642,198680,true,2354337027,28,2361410289,7073262
1642882690,198678,true,2354807918,28,2364009139,9201221
1642882752,198672,true,2356221156,28,2367084196,10863040
1642882758,198671,true,2356456778,28,2367320904,10864126
1642882829,198671,true,2356456778,28,2370637308,14180530
1642882880,198669,true,2356928093,28,2373009013,16080920
1642882908,198663,true,2358342603,28,2374195755,15853152
1642882950,198662,true,2358578437,28,2375620628,17042191
1642883017,198663,true,2358342603,28,2377521790,19179187
1642883043,198662,true,2358578437,28,2378472942,19894505
1642883053,198656,true,2359993938,28,2378710789,18716851
1642883273,198656,true,2359993938,28,2385618716,25624778
1642883408,198658,true,2359522010,28,2389677514,30155504
1642883641,198656,true,2359993938,28,2398295425,38301487
1642883691,198650,true,2361410289,28,2400454755,39044466
1642883814,198650,true,2361410289,28,2405741304,44331015
1642883969,198652,true,2360938077,28,2411521728,50583651
1642884027,198650,true,2361410289,28,2412969003,51558714
1642884201,198643,true,2363063772,28,2414658588,51594816
1642884212,198643,true,2363063772,28,2414417146,51353374
1642884297,198645,true,2362591230,28,2413451621,50860391
1642884334,198645,true,2362591230,28,2412727730,50136500
1642884351,198640,true,2363772762,28,2412486481,48713719
1642884379,198640,true,2363772762,28,2411762880,47990118
1642884407,198644,true,2362827489,28,2411039496,48212007
1642884420,198644,true,2362827489,28,2410798416,47970927
1642884537,198638,true,2364245540,28,2407666571,43421031
1642884626,198635,true,2364954885,28,2405500754,40545869
1642884644,198637,true,2364481965,28,2405019726,40537761
1642884665,198636,true,2364718413,28,2404538794,39820381
1642884806,198626,true,2367084196,28,2403336885,36252689
1642884972,198625,true,2367320904,28,2403817577,36496673
1642885024,198627,true,2366847511,28,2404538794,37691283
1642885041,198626,true,2367084196,28,2404779248,37695052
1642885115,198615,true,2369689291,28,2406463099,36773808
1642885238,198612,true,2370400268,28,2409111532,38711264
1642885387,198614,true,2369926260,28,2411762880,41836620
1642885623,198613,true,2370163252,28,2415141544,44978292
1642885831,198601,true,2373009013,28,2417316041,44307028
1642885918,198598,true,2373720987,28,2417799528,44078541
1642886216,198600,true,2373246314,28,2420944554,47698240
1642886231,198599,true,2373483638,28,2421186649,47703011
1642886336,198587,true,2376333386,28,2423608925,47275539
1642886363,198584,true,2377046357,28,2424093671,47047314
1642886609,198585,true,2376808676,28,2427732358,50923682
1642886865,198586,true,2376571019,28,2429675224,53104205
1642886885,198575,true,2379186555,28,2429675224,50488669
1642886931,198573,true,2379662416,28,2429432280,49769864
1642887060,198573,true,2379662416,28,2429432280,49769864
1642887271,198574,true,2379424473,28,2429675224,50250751
1642887545,198563,true,2382043149,28,2430890304,48847155
1642887587,198559,true,2382996110,28,2430890304,47894194
1642887602,198559,true,2382996110,28,2431133393,48137283
1642888583,198559,true,2382996110,28,2436974828,53978718
1642888617,198547,true,2385857278,28,2437218526,51361248
1642888774,198544,true,2386573107,28,2439412900,52839793
1642888795,198544,true,2386573107,28,2439900807,53327700
1642888843,198543,true,2386811764,28,2440388812,53577048
1642889212,198533,true,2389199650,28,2442830299,53630649
1642889229,198530,true,2389916482,28,2442830299,52913817
1642889273,198530,true,2389916482,28,2442830299,52913817
1642889921,198529,true,2390155474,28,2440632851,50477377
1642889972,198520,true,2392307474,28,2440388812,48081338
1642890154,198518,true,2392785960,28,2438925091,46139131
1642890270,198518,true,2392785960,28,2437705994,44920034
1642890376,198518,true,2392785960,28,2436243882,43457922
1642890408,198509,true,2394940329,28,2435513155,40572826
1642890520,198508,true,2395179823,28,2432592438,37412615
1642890562,198508,true,2395179823,28,2431619644,36439821
1642890596,198508,true,2395179823,28,2430647240,35467417
1642890606,198498,true,2397576081,28,2430404199,32828118
1642890680,198497,true,2397815838,28,2428703597,30887759
1642890697,198496,true,2398055620,28,2428217929,30162309
1642890736,198496,true,2398055620,28,2427489609,29433989
1642890787,198487,true,2400214733,28,2426276228,26061495
1642891106,198486,true,2400454755,28,2418041308,17586553
1642891152,198486,true,2400454755,28,2417074333,16619578
1642891321,198487,true,2400214733,28,2412727730,12512997
1642891586,198479,true,2402135577,28,2405981878,3846301
1642891613,198479,true,2402135577,28,2405260228,3124651
1642891727,198480,true,2401895388,28,2402135577,240189
1642892087,198481,true,2401655222,28,2392785960,-8869262
1642892767,198475,true,2403096576,28,2381566812,-21529764
1642893095,198475,true,2403096576,28,2378710789,-24385787
1642893140,198475,true,2403096576,28,2378472942,-24623634
1642893202,198477,true,2402616028,28,2378472942,-24143086
1642893319,198469,true,2404538794,28,2378472942,-26065852
1642893666,198468,true,2404779248,28,2380852485,-23926763
1642894182,198467,true,2405019726,28,2386811764,-18207962
1642894502,198469,true,2404538794,28,2391111679,-13427115
1642895827,198461,true,2406463099,28,2400214733,-6248366
1642895952,198460,true,2406703745,28,2400454755,-6248990
1642896445,198461,true,2406463099,28,2401895388,-4567711
1642896487,198463,true,2405981878,28,2402135577,-3846301
1642896507,198455,true,2407907337,28,2402375791,-5531546
1642896631,198453,true,2408388943,28,2403336885,-5052058
1642896728,198453,true,2408388943,28,2404298364,-4090579
1642896941,198453,true,2408388943,28,2406944415,-1444528
1642897061,198444,true,2410557360,28,2408388943,-2168417
1642897298,198442,true,2411039496,28,2410316329,-723167
1642897348,198441,true,2411280600,28,2410798416,-482184
1642897567,198440,true,2411521728,28,2413934335,2412607
1642897670,198431,true,2413692966,28,2415624596,1931630
1642897766,198427,true,2414658588,28,2417316041,2657453
1642897881,198426,true,2414900054,28,2419008670,4108616
1642897889,198426,true,2414900054,28,2419250571,4350517
1642898096,198419,true,2416590991,28,2423124276,6533285
1642898407,198417,true,2417074333,28,2428217929,11143596
1642898700,198417,true,2417074333,28,2431376507,14302174
1642899438,198418,true,2416832650,28,2438925091,22092441
1642899621,198416,true,2417316041,28,2439656841,22340800
1642899651,198415,true,2417557772,28,2439656841,22099069
1642899671,198415,true,2417557772,28,2439900807,22343035
1642899743,198416,true,2417316041,28,2440632851,23316810
1642899983,198413,true,2418041308,28,2442341806,24300498
1642900264,198413,true,2418041308,28,2443807578,25766270
1642900276,198414,true,2417799528,28,2444051958,26252430
1642900294,198415,true,2417557772,28,2444051958,26494186
1642901460,198414,true,2417799528,28,2445274229,27474701
1642901571,198413,true,2418041308,28,2444540793,26499485
1642901595,198412,true,2418283112,28,2444296364,26013252
1642902774,198412,true,2418283112,28,2449679466,31396354
1642902923,198409,true,2419008670,28,2450659484,31650814
1642903008,198407,true,2419492496,28,2451149641,31657145
1642903148,198405,true,2419976418,28,2451885059,31908641
1642903627,198404,true,2420218416,28,2452130248,31911832
1642903671,198402,true,2420702484,28,2451885059,31182575
1642903937,198399,true,2421428767,28,2450169426,28740659
1642904408,198399,true,2421428767,28,2445274229,23845462
1642904489,198400,true,2421186649,28,2444296364,23109715
1642904659,198398,true,2421670910,28,2441853411,20182501
1642904765,198396,true,2422155268,28,2440388812,18233544
1642905051,198396,true,2422155268,28,2436731155,14575887
1642905752,198397,true,2421913077,28,2429675224,7762147
1642906057,198394,true,2422639724,28,2427975131,5335407
1642906199,198392,true,2423124276,28,2427004184,3879908
1642906247,198391,true,2423366588,28,2426518856,3152268
1642906293,198391,true,2423366588,28,2426276228,2909640
1642906529,198390,true,2423608925,28,2424820972,1212047
1642906590,198389,true,2423851286,28,2424336080,484794
1642906606,198388,true,2424093671,28,2424336080,242409
1642906654,198389,true,2423851286,28,2423608925,-242361
1642906843,198390,true,2423608925,28,2420944554,-2664371
1642907324,198390,true,2423608925,28,2413934335,-9674590
1642908043,198390,true,2423608925,28,2404538794,-19070131
1642908049,198391,true,2423366588,28,2404298364,-19068224
1642908989,198394,true,2422639724,28,2398295425,-24344299
1642909345,198396,true,2422155268,28,2397815838,-24339430
1642909389,198395,true,2422397484,28,2397815838,-24581646
1642909958,198396,true,2422155268,28,2400934870,-21220398
1642910609,198397,true,2421913077,28,2406463099,-15449978
1642910711,198398,true,2421670910,28,2407425828,-14245082
1642911161,198397,true,2421913077,28,2411280600,-10632477
1642911861,198397,true,2421913077,28,2416349356,-5563721
1642912214,198398,true,2421670910,28,2419734445,-1936465
1642913701,198398,true,2421670910,28,2433078981,11408071
1642914381,198398,true,2421670910,28,2434052358,12381448
1642914654,198397,true,2421913077,28,2434052358,12139281
1642914708,198398,true,2421670910,28,2434052358,12381448
1642914751,198398,true,2421670910,28,2433808978,12138068
1642914856,198398,true,2421670910,28,2433078981,11408071
1642915915,198399,true,2421428767,28,2424820972,3392205
1642915931,198400,true,2421186649,28,2424820972,3634323
1642916057,198400,true,2421186649,28,2424093671,2907022
1642916086,198400,true,2421186649,28,2424093671,2907022
1642916887,198400,true,2421186649,28,2427004184,5817535
1642916934,198401,true,2420944554,28,2427489609,6545055
1642916977,198401,true,2420944554,28,2427975131,7030577
1642917063,198401,true,2420944554,28,2429432280,8487726
1642917097,198401,true,2420944554,28,2429918191,8973637
1642917508,198400,true,2421186649,28,2437218526,16031877
1642918130,198399,true,2421428767,28,2450169426,28740659
1642918137,198399,true,2421428767,28,2450414443,28985676
1642918549,198397,true,2421913077,28,2457039170,35126093
1642918771,198396,true,2422155268,28,2460973383,38818115
1642918967,198394,true,2422639724,28,2462696581,40056857
1642919692,198394,true,2422639724,28,2464913895,42274171
1642919883,198391,true,2423366588,28,2464913895,41547307
1642919949,198389,true,2423851286,28,2464913895,41062609
1642920677,198387,true,2424336080,28,2464420986,40084906
1642920712,198386,true,2424578514,28,2464420986,39842472
1642920761,198383,true,2425305960,28,2464174568,38868608
1642921366,198382,true,2425548491,28,2462696581,37148090
1642921458,198380,true,2426033625,28,2462450336,36416711
1642921621,198379,true,2426276228,28,2462204115,35927887
1642921810,198375,true,2427246884,28,2462696581,35449697
1642922031,198372,true,2427975131,28,2464174568,36199437
1642922111,198369,true,2428703597,28,2464667428,35963831
1642922151,198367,true,2429189362,28,2464913895,35724533
1642922341,198363,true,2430161183,28,2467133205,36972022
1642922611,198359,true,2431133393,28,2470589437,39456044
1642922709,198355,true,2432105993,28,2472319369,40213376
1642923451,198353,true,2432592438,28,2484214432,51621994
1642923663,198347,true,2434052358,28,2486451120,52398762
1642923705,198342,true,2435269628,28,2486948435,51678807
1642923779,198338,true,2436243882,28,2487694594,51450712
1642924593,198335,true,2436974828,28,2493173272,56198444
1642924621,198329,true,2438437379,28,2493173272,54735893
1642924712,198325,true,2439412900,28,2493671932,54259032
1642924736,198323,true,2439900807,28,2493671932,53771125
1642924790,198320,true,2440632851,28,2493921299,53288448
1642925501,198315,true,2441853411,28,2494170691,52317280
1642925573,198312,true,2442586040,28,2494420108,51834068
1642925752,198309,true,2443318889,28,2493671932,50353043
1642925794,198307,true,2443807578,28,2493671932,49864354
1642925801,198302,true,2445029726,28,2493671932,48642206
1642926162,198299,true,2445763308,28,2492923980,47160672
1642926904,198297,true,2446252485,28,2492923980,46671495
1642926982,198296,true,2446497110,28,2493173272,46676162
1642928398,198291,true,2447720604,28,2498664017,50943413
1642928608,198288,true,2448454993,28,2500913714,52458721
1642928962,198284,true,2449434522,28,2504667712,55233190
1642929239,198283,true,2449679466,28,2508427344,58747878
1642929274,198277,true,2451149641,28,2508929055,57779414
1642929290,198273,true,2452130248,28,2509179948,57049700
1642929829,198270,true,2452865960,28,2517725251,64859291
1642929967,198269,true,2453111247,28,2519740136,66628889
1642930010,198263,true,2454583482,28,2520496134,65912652
1642930030,198260,true,2455319930,28,2520748184,65428254
1642930068,198257,true,2456056600,28,2521504484,65447884
1642930118,198256,true,2456302206,28,2522261011,65958805
1642930216,198250,true,2457776356,28,2524279526,66503170
1642930308,198246,true,2458759614,28,2525794472,67034858
1642930420,198243,true,2459497315,28,2527563059,68065744
1642930623,198242,true,2459743265,28,2529838776,70095511
1642930647,198236,true,2461219480,28,2530091760,68872280
1642930799,198234,true,2461711748,28,2532116542,70404794
1642930849,198230,true,2462696581,28,2532369753,69673172
1642930962,198229,true,2462942851,28,2533636192,70693341
1642931032,198223,true,2464420986,28,2534142944,69721958
1642931433,198220,true,2465160386,28,2536678228,71517842
1642931472,198216,true,2466146598,28,2536931896,70785298
1642931528,198215,true,2466393213,28,2537185589,70792376
1642931551,198210,true,2467626656,28,2537439307,69812651
1642931940,198208,true,2468120206,28,2538962152,70841946
1642932635,198205,true,2468860716,28,2534903263,66042547
1642933226,198204,true,2469107602,28,2530597803,61490201
1642933839,198199,true,2470342403,28,2526299657,55957254
1642934025,198197,true,2470836496,28,2525794472,54957976
1642934743,198194,true,2471577821,28,2524279526,52701705
1642934784,198193,true,2471824979,28,2524279526,52454547
1642935118,198186,true,2473555776,28,2524027123,50471347
1642935526,198184,true,2474050511,28,2524279526,50229015
1642936742,198180,true,2475040280,28,2527563059,52522779
1642936778,198178,true,2475535313,28,2527563059,52027746
1642936816,198172,true,2477021006,28,2527563059,50542053
1642936863,198169,true,2477764186,28,2527563059,49798873
1642937114,198167,true,2478259764,28,2527057622,48797858
1642937466,198165,true,2478755440,28,2525036886,46281446
1642937617,198158,true,2480491090,28,2523774746,43283656
1642937625,198155,true,2481235312,28,2523774746,42539434
1642937683,198152,true,2481979757,28,2523017765,41038008
1642937849,198151,true,2482227955,28,2521252359,39024404
1642937859,198145,true,2483717664,28,2521000259,37282595
1642939613,198141,true,2484711300,28,2501664063,16952763
1642939659,198138,true,2485456788,28,2501413922,15957134
1642939716,198137,true,2485705334,28,2501413922,15708588
1642939863,198130,true,2487445849,28,2501163805,13717956
1642940028,198126,true,2488440977,28,2500663648,12222671
1642940139,198123,true,2489187584,28,2500413606,11226022
1642940237,198122,true,2489436503,28,2500163590,10727087
1642940390,198116,true,2490930538,28,2499663632,8733094
1642940578,198113,true,2491677892,28,2499163775,7485883
1642941131,198111,true,2492176252,28,2496665985,4489733
1642941216,198110,true,2492425470,28,2496416343,3990873
1642942089,198105,true,2493671932,28,2493671932,0
1642942152,198103,true,2494170691,28,2493422590,-748101
1642942815,198102,true,2494420108,28,2490930538,-3489570
1642942863,198101,true,2494669550,28,2490930538,-3739012
1642944380,198097,true,2495667568,28,2489187584,-6479984
1642944524,198095,true,2496166726,28,2489685446,-6481280
1642944723,198093,true,2496665985,28,2490681470,-5984515
1642945652,198092,true,2496915651,28,2495418026,-1497625
1642945760,198085,true,2498664017,28,2496166726,-2497291
1642946505,198083,true,2499163775,28,2500413606,1249831
1642946827,198082,true,2499413691,28,2501914230,2500539
1642946848,198080,true,2499913599,28,2501914230,2000631
1642946984,198075,true,2501163805,28,2502164421,1000616
1642947035,198073,true,2501664063,28,2502164421,500358
1642947067,198072,true,2501914230,28,2502164421,250191
1642947259,198072,true,2501914230,28,2500913714,-1000516
1642947316,198069,true,2502664879,28,2500663648,-2001231
1642947344,198068,true,2502915145,28,2500163590,-2751555
1642947381,198068,true,2502915145,28,2499913599,-3001546
1642947415,198069,true,2502664879,28,2499163775,-3501104
1642947885,198068,true,2502915145,28,2489934415,-12980730
1642947903,198067,true,2503165437,28,2489685446,-13479991
1642948806,198068,true,2502915145,28,2469848409,-33066736
1642948857,198069,true,2502664879,28,2468613855,-34051024
1642948928,198068,true,2502915145,28,2467379918,-35535227
1642949197,198068,true,2502915145,28,2462450336,-40464809
1642949223,198070,true,2502414637,28,2462204115,-40210522
1642949237,198070,true,2502414637,28,2461957920,-40456717
1642949418,198071,true,2502164421,28,2458759614,-43404807
1642949424,198072,true,2501914230,28,2458759614,-43154616
1642949513,198074,true,2501413922,28,2456793491,-44620431
1642949587,198075,true,2501163805,28,2455074423,-46089382
1642949861,198076,true,2500913714,28,2449189603,-51724111
1642950316,198077,true,2500663648,28,2441853411,-58810237
1642950892,198079,true,2500163590,28,2434052358,-66111232
1642950912,198081,true,2499663632,28,2433808978,-65854654
1642951847,198082,true,2499413691,28,2434539193,-64874498
1642952402,198084,true,2498913883,28,2434295764,-64618119
1642952604,198087,true,2498164359,28,2434295764,-63868595
1642952763,198089,true,2497664801,28,2434052358,-63612443
1642953041,198091,true,2497165343,28,2433565621,-63599722
1642953744,198093,true,2496665985,28,2430890304,-65775681
1642953887,198096,true,2495917135,28,2430161183,-65755952
1642954101,198098,true,2495418026,28,2429675224,-65742802
1642954103,198100,true,2494919017,28,2429675224,-65243793
1642955060,198101,true,2494669550,28,2436487506,-58182044
1642955076,198104,true,2493921299,28,2436731155,-57190144
1642955100,198106,true,2493422590,28,2436731155,-56691435
1642955152,198108,true,2492923980,28,2436974828,-55949152
1642955217,198110,true,2492425470,28,2437218526,-55206944
1642955686,198113,true,2491677892,28,2437218526,-54459366
1642956603,198115,true,2491179631,28,2429918191,-61261440
1642956628,198117,true,2490681470,28,2429675224,-61006246
1642956864,198119,true,2490183408,28,2427489609,-62693799
1642957006,198123,true,2489187584,28,2427004184,-62183400
1642957291,198125,true,2488689821,28,2427004184,-61685637
1642957478,198127,true,2488192158,28,2427246884,-60945274
1642957554,198129,true,2487694594,28,2427246884,-60447710
1642957591,198133,true,2486699765,28,2427489609,-59210156
1642957990,198136,true,2485953904,28,2428460750,-57493154
1642958644,198139,true,2485208267,28,2431619644,-53588623
1642959603,198142,true,2484462854,28,2435026125,-49436729
1642960345,198147,true,2483220995,28,2436731155,-46489840
1642961386,198149,true,2482724425,28,2439168983,-43555442
1642961949,198152,true,2481979757,28,2438193559,-43786198
1642963348,198155,true,2481235312,28,2427489609,-53745703
1642963791,198161,true,2479747091,28,2425063454,-54683637
1642963873,198163,true,2479251216,28,2424820972,-54430244
1642964807,198168,true,2478011963,28,2420460438,-57551525
1642964862,198172,true,2477021006,28,2420218416,-56802590
1642964883,198178,true,2475535313,28,2420218416,-55316897
1642965524,198181,true,2474792801,28,2415383058,-59409743
1642965781,198187,true,2473308445,28,2414417146,-58891299
1642966023,198191,true,2472319369,28,2414175729,-58143640
1642966253,198196,true,2471083580,28,2414417146,-56666434
1642966290,198200,true,2470095393,28,2413934335,-56161058
1642966698,198205,true,2468860716,28,2414417146,-54443570
1642966714,198208,true,2468120206,28,2414417146,-53703060
1642966754,198214,true,2466639852,28,2414417146,-52222706
1642966791,198217,true,2465900008,28,2414175729,-51724279
1642966804,198224,true,2464174568,28,2414175729,-49998839
1642966812,198227,true,2463435464,28,2413934335,-49501129
1642966871,198234,true,2461711748,28,2413451621,-48260127
1642967524,198238,true,2460727310,28,2405260228,-55467082
1642967770,198244,true,2459251390,28,2401655222,-57596168
1642968161,198247,true,2458513762,28,2395419341,-63094421
1642968343,198254,true,2456793491,28,2391589926,-65203565
1642968410,198258,true,2455811019,28,2390155474,-65655545
1642968477,198264,true,2454338048,28,2389199650,-65138398
1642968638,198268,true,2453356558,28,2388244209,-65112349
1642968872,198273,true,2452130248,28,2389438570,-62691678
1642968882,198277,true,2451149641,28,2389677514,-61472127
1642969070,198282,true,2449924434,28,2391829085,-58095349
1642969747,198285,true,2449189603,28,2401174963,-48014640
1642969797,198289,true,2448210172,28,2401895388,-46314784
1642969989,198292,true,2447475856,28,2404298364,-43177492
1642970313,198298,true,2446007884,28,2408629782,-37378102
1642970768,198300,true,2445518756,28,2411762880,-33755876
1642972183,198303,true,2444785247,28,2418041308,-26743939
1642972241,198306,true,2444051958,28,2418041308,-26010650
1642972415,198311,true,2442830299,28,2418283112,-24547187
1642972743,198312,true,2442586040,28,2417799528,-24786512
1642973089,198316,true,2441609250,28,2416832650,-24776600
1642974106,198318,true,2441121001,28,2416349356,-24771645
1642974957,198322,true,2440144797,28,2424578514,-15566283
1642974993,198323,true,2439900807,28,2424820972,-15079835
1642975314,198326,true,2439168983,28,2427004184,-12164799
1642975545,198328,true,2438681223,28,2428460750,-10220473
1642975566,198332,true,2437705994,28,2428460750,-9245244
1642976302,198333,true,2437462248,28,2429918191,-7544057
1642976375,198336,true,2436731155,28,2429918191,-6812964
1642976860,198337,true,2436487506,28,2429675224,-6812282
1642977074,198341,true,2435513155,28,2429675224,-5837931
1642978279,198342,true,2435269628,28,2434052358,-1217270
1642978386,198344,true,2434782647,28,2434295764,-486883
1642978399,198345,true,2434539193,28,2434295764,-243429
1642978951,198349,true,2433565621,28,2437462248,3896627
1642978991,198348,true,2433808978,28,2437949764,4140786
1642979088,198350,true,2433322289,28,2439656841,6334552
1642979488,198351,true,2433078981,28,2447475856,14396875
1642979513,198353,true,2432592438,28,2448210172,15617734
1642979552,198353,true,2432592438,28,2449189603,16597165
1642979554,198355,true,2432105993,28,2449189603,17083610
1642979621,198353,true,2432592438,28,2451639895,19047457
1642979666,198354,true,2432349203,28,2453111247,20762044
1642979677,198353,true,2432592438,28,2453601894,21009456
1642979742,198354,true,2432349203,28,2456547836,24198633
1642979776,198350,true,2433322289,28,2458267935,24945646
1642979955,198350,true,2433322289,28,2466146598,32824309
1642980011,198349,true,2433565621,28,2468860716,35295095
1642980035,198349,true,2433565621,28,2469848409,36282788
1642980096,198344,true,2434782647,28,2473308445,38525798
1642980565,198340,true,2435756706,28,2499413691,63656985
1642980587,198338,true,2436243882,28,2500413606,64169724
1642980619,198338,true,2436243882,28,2502164421,65920539
1642980633,198333,true,2437462248,28,2502915145,65452897
1642980642,198330,true,2438193559,28,2503415753,65222194
1642980643,198328,true,2438681223,28,2503415753,64734530
1642980811,198328,true,2438681223,28,2510936901,72255678
1642980941,198322,true,2440144797,28,2515208910,75064113
1642981043,198318,true,2441121001,28,2518228821,77107820
1642981123,198315,true,2441853411,28,2520748184,78894773
1642981520,198314,true,2442097596,28,2529838776,87741180
1642981609,198308,true,2443563221,28,2530344769,86781548
1642981698,198303,true,2444785247,28,2531103948,86318701
1642981844,198300,true,2445518756,28,2532622990,87104234
1642982013,198300,true,2445518756,28,2531610194,86091438
1642982026,198294,true,2446986434,28,2531610194,84623760
1642982098,198289,true,2448210172,28,2531610194,83400022
1642982167,198286,true,2448944709,28,2531863355,82918646
1642982249,198284,true,2449434522,28,2532116542,82682020
1642982664,198279,true,2450659484,28,2532876253,82216769
1642982756,198274,true,2451885059,28,2533129540,81244481
1642982797,198270,true,2452865960,28,2533382853,80516893
1642982835,198269,true,2453111247,28,2533382853,80271606
1642982886,198264,true,2454338048,28,2533382853,79044805
1642982933,198260,true,2455319930,28,2533129540,77809610
1642983251,198258,true,2455811019,28,2532116542,76305523
1642983293,198257,true,2456056600,28,2531863355,75806755
1642983554,198253,true,2457039170,28,2530091760,73052590
1642983693,198249,true,2458022133,28,2529079976,71057843
1642983849,198246,true,2458759614,28,2527563059,68803445
1642983869,198244,true,2459251390,28,2527310328,68058938
1642983903,198240,true,2460235238,28,2526552286,66317048
1642983982,198236,true,2461219480,28,2524784407,63564927
1642984022,198235,true,2461465602,28,2523774746,62309144
1642984224,198233,true,2461957920,28,2519740136,57782216
1642984265,198230,true,2462696581,28,2518984366,56287785
1642986998,198227,true,2463435464,28,2494420108,30984644
1642987617,198225,true,2463928175,28,2494420108,30491933
1642987635,198224,true,2464174568,28,2494420108,30245540
1642987814,198220,true,2465160386,28,2493422590,28262204
1642987856,198218,true,2465653443,28,2493173272,27519829
1642988463,198219,true,2465406902,28,2486699765,21292863
1642988654,198218,true,2465653443,28,2484214432,18560989
1642989232,198215,true,2466393213,28,2476030445,9637232
1642989394,198213,true,2466886516,28,2473555776,6669260
1642990029,198214,true,2466639852,28,2467133205,493353
1642990053,198213,true,2466886516,28,2466886516,0
1642990698,198211,true,2467379918,28,2460727310,-6652608
1642993042,198208,true,2468120206,28,2454583482,-13536724
1642993088,198209,true,2467873419,28,2454583482,-13289937
1642993252,198207,true,2468367018,28,2453601894,-14765124
1642993470,198205,true,2468860716,28,2452620698,-16240018
1642995148,198204,true,2469107602,28,2443807578,-25300024
1642995266,198204,true,2469107602,28,2444051958,-25055644
1642995476,198203,true,2469354513,28,2444540793,-24813720
1642996359,198200,true,2470095393,28,2448210172,-21885221
1642996379,198199,true,2470342403,28,2448454993,-21887410
1642996786,198199,true,2470342403,28,2451394756,-18947647
1642996837,198197,true,2470836496,28,2451885059,-18951437
1642998822,198193,true,2471824979,28,2464420986,-7403993
1642999134,198190,true,2472566601,28,2464420986,-8145615
1642999252,198190,true,2472566601,28,2463928175,-8638426
1642999335,198187,true,2473308445,28,2463435464,-9872981
1642999528,198184,true,2474050511,28,2461957920,-12092591
1642999587,198181,true,2474792801,28,2461465602,-13327199
1642999598,198181,true,2474792801,28,2461465602,-13327199
1642999775,198178,true,2475535313,28,2459497315,-16037998
1642999862,198175,true,2476278048,28,2458513762,-17764286
1642999899,198172,true,2477021006,28,2458022133,-18998873
1643000061,198173,true,2476773328,28,2455565462,-21207866
1643000623,198172,true,2477021006,28,2447475856,-29545150
1643000735,198169,true,2477764186,28,2445518756,-32245430
1643001078,198167,true,2478259764,28,2439412900,-38846864
1643003270,198170,true,2477516434,28,2429432280,-48084154
1643003503,198169,true,2477764186,28,2430161183,-47603003
1643003539,198166,true,2478507590,28,2430404199,-48103391
1643003641,198165,true,2478755440,28,2430890304,-47865136
1643005264,198166,true,2478507590,28,2439412900,-39094690
1643005306,198166,true,2478507590,28,2439656841,-38850749
1643005588,198162,true,2479499141,28,2440388812,-39110329
1643006242,198161,true,2479747091,28,2443807578,-35939513
1643006629,198161,true,2479747091,28,2445763308,-33983783
1643007170,198161,true,2479747091,28,2448454993,-31292098
1643007484,198158,true,2480491090,28,2448944709,-31546381
1643007545,198157,true,2480739139,28,2448944709,-31794430
1643007646,198158,true,2480491090,28,2448454993,-32036097
1643007669,198158,true,2480491090,28,2448454993,-32036097
1643007689,198156,true,2480987213,28,2448210172,-32777041
1643007707,198155,true,2481235312,28,2448210172,-33025140
1643007816,198157,true,2480739139,28,2446986434,-33752705
1643008319,198158,true,2480491090,28,2440876914,-39614176
1643010014,198157,true,2480739139,28,2419492496,-61246643
1643010124,198157,true,2480739139,28,2419008670,-61730469
1643010157,198159,true,2480243066,28,2419008670,-61234396
1643010242,198160,true,2479995066,28,2418524940,-61470126
1643010264,198160,true,2479995066,28,2418283112,-61711954
1643010303,198161,true,2479747091,28,2418041308,-61705783
1643010382,198164,true,2479003316,28,2417316041,-61687275
1643010403,198166,true,2478507590,28,2417074333,-61433257
1643010664,198168,true,2478011963,28,2414900054,-63111909
1643010744,198171,true,2477268708,28,2414175729,-63092979
1643011011,198175,true,2476278048,28,2410798416,-65479632
1643011179,198177,true,2475782866,28,2408148128,-67634738
1643011227,198182,true,2474545346,28,2407425828,-67119518
1643011891,198186,true,2473555776,28,2397096637,-76459139
1643012153,198191,true,2472319369,28,2394221990,-78097379
1643012159,198194,true,2471577821,28,2394221990,-77355831
1643012242,198200,true,2470095393,28,2393743218,-76352175
1643012360,198204,true,2469107602,28,2393264541,-75843061
1643013047,198208,true,2468120206,28,2393503867,-74616339
1643013289,198212,true,2467133205,28,2394700859,-72432346
1643013393,198218,true,2465653443,28,2395179823,-70473620
1643013926,198224,true,2464174568,28,2398055620,-66118948
1643013944,198229,true,2462942851,28,2398055620,-64887231
1643013957,198232,true,2462204115,28,2398055620,-64148495
1643014014,198238,true,2460727310,28,2397576081,-63151229
1643014075,198245,true,2459005490,28,2397815838,-61189652
1643014085,198250,true,2457776356,28,2397815838,-59960518
1643014109,198251,true,2457530603,28,2398295425,-59235178
1643014111,198255,true,2456547836,28,2398295425,-58252411
1643014155,198261,true,2455074423,28,2398775108,-56299315
1643014182,198266,true,2453847254,28,2399014986,-54832268
1643014235,198268,true,2453356558,28,2399254887,-54101671
1643014443,198273,true,2452130248,28,2399494813,-52635435
1643014459,198280,true,2450414443,28,2399494813,-50919630
1643014627,198285,true,2449189603,28,2399014986,-50174617
1643014665,198288,true,2448454993,28,2398775108,-49679885
1643015381,198295,true,2446741760,28,2393743218,-52998542
1643015512,198301,true,2445274229,28,2392068267,-53205962
1643015586,198307,true,2443807578,28,2391111679,-52695899
1643015611,198311,true,2442830299,28,2390872592,-51957707
1643015705,198318,true,2441121001,28,2389438570,-51682431
1643015788,198325,true,2439412900,28,2388960754,-50452146
1643015983,198331,true,2437949764,28,2384903174,-53046590
1643016035,198335,true,2436974828,28,2383711080,-53263748
1643016058,198342,true,2435269628,28,2383234409,-52035219
1643016066,198348,true,2433808978,28,2382996110,-50812868
1643016164,198356,true,2431862806,28,2379900382,-51962424
1643016173,198361,true,2430647240,28,2379662416,-50984824
1643016193,198368,true,2428946467,28,2378948660,-49997807
1643016479,198374,true,2427489609,28,2371111460,-56378149
1643016515,198382,true,2425548491,28,2370163252,-55385239
1643016613,198386,true,2424578514,28,2368267975,-56310539
1643016643,198393,true,2422881988,28,2367794392,-55087596
1643016828,198398,true,2421670910,28,2364481965,-57188945
1643016875,198404,true,2420218416,28,2363772762,-56445654
1643016886,198408,true,2419250571,28,2363536408,-55714163
1643016945,198415,true,2417557772,28,2362118783,-55438989
1643017133,198420,true,2416349356,28,2357871005,-58478351
1643017172,198426,true,2414900054,28,2356928093,-57971961
1643017193,198430,true,2413934335,28,2356221156,-57713179
1643017196,198437,true,2412245257,28,2356221156,-56024101
1643017233,198442,true,2411039496,28,2355278903,-55760593
1643017259,198448,true,2409593378,28,2354572460,-55020918
1643017451,198451,true,2408870645,28,2350103243,-58767402
1643017542,198457,true,2407425828,28,2347989208,-59436620
1643017579,198463,true,2405981878,28,2347284952,-58696926
1643017614,198467,true,2405019726,28,2346815565,-58204161
1643017640,198470,true,2404298364,28,2346346272,-57952092
1643017758,198476,true,2402856290,28,2343766839,-59089451
1643017875,198481,true,2401655222,28,2342126859,-59528363
1643017930,198486,true,2400454755,28,2341658503,-58796252
1643018383,198488,true,2399974736,28,2340956146,-59018590
1643018440,198493,true,2398775108,28,2340488025,-58287083
1643018593,198497,true,2397815838,28,2338850339,-58965499
1643018620,198501,true,2396856952,28,2338616477,-58240475
1643018790,198504,true,2396138038,28,2337447520,-58690518
1643018822,198510,true,2394700859,28,2336980100,-57720759
1643018853,198515,true,2393503867,28,2336279147,-57224720
1643018861,198520,true,2392307474,28,2336045542,-56261932
1643018909,198526,true,2390872592,28,2335111357,-55761235
1643018932,198533,true,2389199650,28,2334410964,-54788686
1643019028,198539,true,2387766632,28,2332311044,-55455588
1643019076,198545,true,2386334474,28,2331145238,-55189236
1643019128,198551,true,2384903174,28,2329980015,-54923159
1643019144,198558,true,2383234409,28,2329514089,-53720320
1643019158,198565,true,2381566812,28,2328349682,-53217130
1643019167,198571,true,2380138372,28,2328116870,-52021502
1643019207,198579,true,2378235118,28,2326720489,-51514629
1643019223,198586,true,2376571019,28,2326255214,-50315805
1643019230,198591,true,2375383090,28,2326022612,-49360478
1643019232,198597,true,2373958359,28,2325790033,-48168326
1643019249,198606,true,2371822864,28,2325092436,-46730428
1643019260,198614,true,2369926260,28,2324395047,-45531213
1643019261,198619,true,2368741652,28,2324395047,-44346605
1643019281,198623,true,2367794392,28,2323697868,-44096524
1643019289,198632,true,2365664442,28,2323465522,-42198920
1643019306,198639,true,2364009139,28,2322768621,-41240518
1643019325,198644,true,2362827489,28,2322071930,-40755559
1643019330,198649,true,2361646430,28,2321839746,-39806684
1643019403,198657,true,2359757963,28,2319519183,-40238780
1643019438,198664,true,2358106792,28,2318127958,-39978834
1643019454,198669,true,2356928093,28,2317664402,-39263691
1643019512,198675,true,2355514431,28,2315811105,-39703326
1643019514,198683,true,2353630867,28,2315811105,-37819762
1643019534,198691,true,2351748809,28,2314885012,-36863797
1643019558,198696,true,2350573287,28,2313959289,-36613998
1643019575,198704,true,2348693675,28,2313265240,-35428435
1643019591,198712,true,2346815565,28,2312571400,-34244165
1643019670,198719,true,2345173451,28,2309336227,-35837224
1643019689,198724,true,2344001216,28,2308643564,-35357652
1643019693,198730,true,2342595307,28,2308643564,-33951743
1643019743,198737,true,2340956146,28,2306566824,-34389322
1643019785,198743,true,2339552064,28,2304722400,-34829664
1643019789,198748,true,2338382639,28,2304491951,-33890688
1643019842,198755,true,2336746426,28,2301728357,-35018069
1643019850,198762,true,2335111357,28,2301498207,-33613150
1643019885,198767,true,2333944152,28,2300117792,-33826360
1643019932,198771,true,2333010808,28,2298048720,-34962088
1643020170,198777,true,2331611491,28,2287045067,-44566424
1643020220,198784,true,2329980015,28,2284759279,-45220736
1643020259,198789,true,2328815375,28,2282932294,-45883081
1643020261,198793,true,2327884082,28,2282932294,-44951788
1643020274,198800,true,2326255214,28,2282247551,-44007663
1643020332,198806,true,2324859950,28,2279738584,-45121366
1643020348,198810,true,2323930238,28,2279054800,-44875438
1643020529,198814,true,2323000898,28,2271319557,-51681341
1643020542,198820,true,2321607585,28,2270638298,-50969287
1643020629,198827,true,2319983110,28,2266781684,-53201426
1643020703,198832,true,2318823466,28,2264289720,-54533746
1643020726,198837,true,2317664402,28,2263610569,-54053833
1643020782,198843,true,2316274290,28,2262026675,-54247615
1643020989,198850,true,2314653547,28,2257733119,-56920428
1643021124,198855,true,2313496567,28,2256830252,-56666315
1643021169,198860,true,2312340166,28,2256153338,-56186828
1643021186,198866,true,2310953247,28,2255927745,-55025502
1643021219,198873,true,2309336227,28,2255476627,-53859600
1643021248,198877,true,2308412723,28,2255025600,-53387123
1643021301,198881,true,2307489589,28,2254574662,-52914927
1643021350,198888,true,2305874992,28,2254123815,-51751177
1643021353,198895,true,2304261525,28,2254123815,-50137710
1643021446,198902,true,2302649187,28,2253222391,-49426796
1643021492,198908,true,2301268081,28,2252321327,-48946754
1643021495,198915,true,2299657837,28,2252096118,-47561719
1643021499,198922,true,2298048720,28,2252096118,-45952602
1643021517,198929,true,2296440730,28,2251870930,-44569800
1643021533,198934,true,2295292854,28,2251645766,-43647088
1643021536,198940,true,2293916160,28,2251420624,-42495536
1643021545,198946,true,2292540292,28,2251420624,-41119668
1643021573,198952,true,2291165249,28,2251195504,-39969745
1643021581,198956,true,2290249012,28,2251195504,-39053508
1643021596,198962,true,2288875343,28,2250970407,-37904936
1643021618,198968,true,2287502499,28,2250970407,-36532092
1643021732,198973,true,2286359090,28,2249395358,-36963732
1643021754,198977,true,2285444775,28,2249170441,-36274334
1643021865,198983,true,2284073988,28,2247596651,-36477337
1643021923,198989,true,2282704023,28,2246697837,-36006186
1643022027,198995,true,2281334880,28,2244452375,-36882505
1643022043,198999,true,2280422574,28,2244227952,-36194622
1643022097,199004,true,2279282705,28,2243106174,-36176531
1643022114,199009,true,2278143405,28,2242657621,-35485784
1643022142,199015,true,2276776998,28,2241760782,-35016216
1643022195,199019,true,2275866515,28,2240416196,-35450319
1643022221,199024,true,2274728923,28,2239744205,-34984718
1643022311,199031,true,2273137249,28,2237058259,-36078990
1643022352,199037,true,2271773844,28,2235940065,-35833779
1643022360,199042,true,2270638298,28,2235716493,-34921805
1643022394,199048,true,2269276391,28,2234822430,-34453961
1643022486,199054,true,2267915302,28,2233035377,-34879925
1643022539,199059,true,2266781684,28,2232365600,-34416084
1643022561,199063,true,2265875198,28,2232142386,-33732812
1643022590,199068,true,2264742601,28,2231919194,-32823407
1643022610,199073,true,2263610569,28,2231696024,-31914545
1643022654,199077,true,2262705351,28,2231249752,-31455599
1643022700,199079,true,2262252878,28,2231026649,-31226229
1643022726,199083,true,2261348203,28,2231026649,-30321554
1643022761,199087,true,2260443890,28,2231026649,-29417241
1643022810,199091,true,2259539938,28,2231026649,-28513289
1643022824,199093,true,2259088098,28,2231026649,-28061449
1643022848,199096,true,2258410507,28,2231026649,-27383858
1643022881,199100,true,2257507369,28,2231249752,-26257617
1643022890,199102,true,2257055935,28,2231249752,-25806183
1643022934,199104,true,2256604591,28,2231696024,-24908567
1643022943,199106,true,2256153338,28,2231919194,-24234144
1643022989,199111,true,2255025600,28,2232142386,-22883214
1643023079,199113,true,2254574662,28,2233482006,-21092656
1643023148,199114,true,2254349227,28,2234152118,-20197109
1643023161,199117,true,2253673058,28,2234375533,-19297525
1643023169,199121,true,2252771814,28,2234598970,-18172844
1643023227,199123,true,2252321327,28,2235045912,-17275415
1643023252,199124,true,2252096118,28,2235492944,-16603174
1643023277,199128,true,2251195504,28,2235716493,-15479011
1643023310,199128,true,2251195504,28,2236387275,-14808229
1643023321,199130,true,2250745333,28,2236610914,-14134419
1643023356,199131,true,2250520281,28,2236834575,-13685706
1643023378,199133,true,2250070244,28,2237058259,-13011985
1643023403,199134,true,2249845260,28,2237281964,-12563296
1643023416,199136,true,2249395358,28,2237505693,-11889665
1643023457,199135,true,2249620298,28,2237729443,-11890855
1643023510,199137,true,2249170441,28,2238177011,-10993430
1643023517,199136,true,2249395358,28,2238177011,-11218347
1643023562,199138,true,2248945546,28,2238624669,-10320877
1643023587,199138,true,2248945546,28,2238848532,-10097014
1643023647,199140,true,2248495825,28,2239520253,-8975572
1643023663,199137,true,2249170441,28,2239744205,-9426236
1643023789,199138,true,2248945546,28,2241760782,-7184764
1643023826,199138,true,2248945546,28,2242433377,-6512169
1643023917,199141,true,2248270998,28,2244003552,-4267446
1643024006,199139,true,2248720674,28,2246248565,-2472109
1643024079,199140,true,2248495825,28,2248270998,-224827
1643024083,199140,true,2248495825,28,2248495825,0
1643024117,199143,true,2247821411,28,2249395358,1573947
1643024152,199142,true,2248046193,28,2250070244,2024051
1643024311,199145,true,2247371914,28,2253222391,5850477
1643024352,199145,true,2247371914,28,2253673058,6301144
1643024373,199148,true,2246697837,28,2253898425,7200588
1643024397,199147,true,2246922507,28,2254123815,7201308
1643024495,199148,true,2246697837,28,2255025600,8327763
1643024601,199148,true,2246697837,28,2255251102,8553265
1643024676,199149,true,2246473190,28,2255251102,8777912
1643024680,199148,true,2246697837,28,2255251102,8553265
1643024698,199149,true,2246473190,28,2255025600,8552410
1643024893,199148,true,2246697837,28,2253898425,7200588
1643024988,199150,true,2246248565,28,2253447713,7199148
1643025188,199148,true,2246697837,28,2253447713,6749876
1643025243,199150,true,2246248565,28,2253447713,7199148
1643025323,199149,true,2246473190,28,2253447713,6974523
1643025384,199150,true,2246248565,28,2253222391,6973826
1643025426,199149,true,2246473190,28,2252771814,6298624
1643025660,199152,true,2245799383,28,2251195504,5396121
1643025740,199152,true,2245799383,28,2250520281,4720898
1643025773,199153,true,2245574825,28,2250295251,4720426
1643025875,199153,true,2245574825,28,2249170441,3595616
1643025885,199156,true,2244901288,28,2248945546,4044258
1643025910,199155,true,2245125778,28,2248720674,3594896
1643025934,199157,true,2244676820,28,2248495825,3819005
1643025957,199157,true,2244676820,28,2248270998,3594178
1643025975,199159,true,2244227952,28,2248270998,4043046
1643026023,199159,true,2244227952,28,2248270998,4043046
1643026554,199159,true,2244227952,28,2245574825,1346873
1643026581,199159,true,2244227952,28,2245125778,897826
1643026604,199161,true,2243779174,28,2244676820,897646
1643026641,199160,true,2244003552,28,2244003552,0
1643026792,199162,true,2243554818,28,2241088388,-2466430
1643026839,199162,true,2243554818,28,2240192177,-3362641
1643026880,199165,true,2242881886,28,2239296324,-3585562
1643026900,199163,true,2243330485,28,2238848532,-4481953
1643026910,199167,true,2242433377,28,2238624669,-3808708
1643026966,199168,true,2242209156,28,2237281964,-4927192
1643027018,199170,true,2241760782,28,2236163659,-5597123
1643027023,199169,true,2241984958,28,2236163659,-5821299
1643027077,199172,true,2241312497,28,2235045912,-6266585
1643027110,199174,true,2240864302,28,2233928725,-6935577
1643027126,199176,true,2240416196,28,2233482006,-6934190
1643027161,199174,true,2240864302,28,2233035377,-7828925
1643027178,199177,true,2240192177,28,2232812095,-7380082
1643027222,199178,true,2239968180,28,2232142386,-7825794
1643027289,199178,true,2239968180,28,2231249752,-8718428
1643027399,199177,true,2240192177,28,2229911470,-10280707
1643027411,199180,true,2239520253,28,2229688502,-9831751
1643027413,199181,true,2239296324,28,2229688502,-9607822
1643027423,199182,true,2239072417,28,2229465555,-9606862
1643027472,199181,true,2239296324,28,2229019729,-10276595
1643027603,199184,true,2238624669,28,2227682785,-10941884
1643027634,199185,true,2238400829,28,2227460039,-10940790
1643027669,199186,true,2238177011,28,2227014614,-11162397
1643027755,199185,true,2238400829,28,2226124031,-12276798
1643027791,199188,true,2237729443,28,2225456327,-12273116
1643027824,199188,true,2237729443,28,2224788823,-12940620
1643027904,199189,true,2237505693,28,2223009793,-14495900
1643027931,199188,true,2237729443,28,2222565258,-15164185
1643028071,199190,true,2237281964,28,2219677944,-17604020
1643028100,199191,true,2237058259,28,2219012174,-18046085
1643028164,199191,true,2237058259,28,2217459487,-19598772
1643028170,199190,true,2237281964,28,2217237763,-20044201
1643028183,199192,true,2236834575,28,2216794382,-20040193
1643028198,199193,true,2236610914,28,2216351090,-20259824
1643028279,199194,true,2236387275,28,2213914566,-22472709
1643028381,199194,true,2236387275,28,2210596349,-25790926
1643028448,199196,true,2235940065,28,2209049550,-26890515
1643028456,199197,true,2235716493,28,2209049550,-26666943
1643028500,199199,true,2235269417,28,2207945357,-27324060
1643028513,199198,true,2235492944,28,2207503834,-27989110
1643028613,199201,true,2234822430,28,2205077036,-29745394
1643028617,199203,true,2234375533,28,2205077036,-29298497
1643028647,199206,true,2233705354,28,2204415645,-29289709
1643028698,199206,true,2233705354,28,2203534099,-30171255
1643028701,199209,true,2233035377,28,2203534099,-29501278
1643028704,199212,true,2232365600,28,2203534099,-28831501
1643028750,199215,true,2231696024,28,2202873171,-28822853
1643028889,199215,true,2231696024,28,2201331777,-30364247
1643028915,199218,true,2231026649,28,2201331777,-29694872
1643028927,199221,true,2230357475,28,2201331777,-29025698
1643028957,199225,true,2229465555,28,2201331777,-28133778
1643028975,199224,true,2229688502,28,2201331777,-28356725
1643029029,199227,true,2229019729,28,2201331777,-27687952
1643029049,199230,true,2228351157,28,2201331777,-27019380
1643029095,199234,true,2227460039,28,2201331777,-26128262
1643029112,199233,true,2227682785,28,2201331777,-26351008
1643029151,199236,true,2227014614,28,2200891576,-26123038
1643029180,199240,true,2226124031,28,2200671509,-25452522
1643029251,199245,true,2225011302,28,2199351568,-25659734
1643029267,199244,true,2225233803,28,2199131655,-26102148
1643029275,199248,true,2224343932,28,2199131655,-25212277
1643029288,199252,true,2223454417,28,2199131655,-24322762
1643029410,199254,true,2223009793,28,2198032419,-24977374
1643029438,199253,true,2223232094,28,2197373141,-25858953
1643029499,199257,true,2222343023,28,2196714061,-25628962
1643029500,199261,true,2221454308,28,2196714061,-24740247
1643029532,199265,true,2220565949,28,2196274784,-24291165
1643029538,199264,true,2220788005,28,2196055179,-24732826
1643029588,199269,true,2219677944,28,2195176976,-24500968
1643029650,199272,true,2219012174,28,2194518555,-24493619
1643029730,199276,true,2218124791,28,2193640967,-24483824
1643029754,199275,true,2218346604,28,2193421625,-24924979
1643029798,199279,true,2217459487,28,2193640967,-23818520
1643029889,199281,true,2217016061,28,2194299125,-22716936
1643029903,199282,true,2216794382,28,2194518555,-22275827
1643029926,199280,true,2217237763,28,2194957480,-22280283
1643029949,199284,true,2216351090,28,2195176976,-21174114
1643030041,199286,true,2215907886,28,2196494412,-19413474
1643030113,199288,true,2215464771,28,2197812638,-17652133
1643030202,199286,true,2215907886,28,2199351568,-16556318
1643030237,199290,true,2215021744,28,2200011440,-15010304
1643030331,199292,true,2214578806,28,2201551910,-13026896
1643030341,199293,true,2214357371,28,2201551910,-12805461
1643030415,199292,true,2214578806,28,2202873171,-11705635
1643030558,199297,true,2213471849,28,2203534099,-9937750
1643030602,199299,true,2213029221,28,2203754453,-9274768
1643030662,199300,true,2212807940,28,2204636087,-8171853
1643030965,199298,true,2213250524,28,2206179795,-7070729
1643031007,199302,true,2212365445,28,2206841715,-5523730
1643031096,199304,true,2211923038,28,2208828667,-3094371
1643031114,199305,true,2211701868,28,2209049550,-2652318
1643031152,199303,true,2212144231,28,2209491382,-2652849
1643031239,199307,true,2211259594,28,2210596349,-663245
1643031315,199310,true,2210596349,28,2211259594,663245
1643031331,199312,true,2210154296,28,2211480720,1326424
1643031431,199311,true,2210375311,28,2212586682,2211371
1643031559,199316,true,2209270455,28,2213693196,4422741
1643031763,199318,true,2208828667,28,2210817409,1988742
1643031793,199320,true,2208386968,28,2210375311,1988343
1643031822,199318,true,2208828667,28,2209933303,1104636
1643031854,199323,true,2207724584,28,2209491382,1766798
1643031925,199326,true,2207062399,28,2208166151,1103752
1643032082,199327,true,2206841715,28,2206179795,-661920
1643032279,199325,true,2207283106,28,2204636087,-2647019
1643032298,199330,true,2206179795,28,2204636087,-1543708
1643032355,199333,true,2205518074,28,2204636087,-881987
1643032656,199333,true,2205518074,28,2201331777,-4186297
1643032765,199331,true,2205959199,28,2200231441,-5727758
1643032882,199338,true,2204415645,28,2197592879,-6822766
1643032979,199340,true,2203974828,28,2195396494,-8578334
1643033117,199342,true,2203534099,28,2193421625,-10112474
1643033125,199340,true,2203974828,28,2193202304,-10772524
1643033161,199344,true,2203093459,28,2192983006,-10110453
1643033186,199346,true,2202652906,28,2192763730,-9889176
1643033216,199348,true,2202212442,28,2192325243,-9887199
1643033294,199347,true,2202432663,28,2191229409,-11203254
1643033299,199351,true,2201551910,28,2191229409,-10322501
1643033330,199353,true,2201111666,28,2190791229,-10320437
1643033350,199355,true,2200671509,28,2190353136,-10318373
1643033364,199355,true,2200671509,28,2190134123,-10537386
1643033398,199360,true,2199571504,28,2189477214,-10094290
1643033410,199362,true,2199131655,28,2189258288,-9873367
1643033435,199363,true,2198911764,28,2188820502,-10091262
1643033502,199363,true,2198911764,28,2187507669,-11404095
1643033515,199368,true,2197812638,28,2187288940,-10523698
1643033665,199370,true,2197373141,28,2185102854,-12270287
1643033718,199371,true,2197153426,28,2184665899,-12487527
1643033735,199371,true,2197153426,28,2184665899,-12487527
1643033761,199375,true,2196274784,28,2184447454,-11827330
1643033766,199376,true,2196055179,28,2184447454,-11607725
1643033948,199376,true,2196055179,28,2184229031,-11826148
1643034004,199376,true,2196055179,28,2184010630,-12044549
1643034034,199380,true,2195176976,28,2184010630,-11166346
1643034108,199381,true,2194957480,28,2183573894,-11383586
1643034131,199382,true,2194738007,28,2183355558,-11382449
1643034163,199381,true,2194957480,28,2183355558,-11601922
1643034338,199384,true,2194299125,28,2182700682,-11598443
1643034407,199385,true,2194079717,28,2182700682,-11379035
1643034620,199383,true,2194518555,28,2184010630,-10507925
1643034674,199381,true,2194957480,28,2184447454,-10510026
1643034708,199384,true,2194299125,28,2184884366,-9414759
1643034721,199384,true,2194299125,28,2184884366,-9414759
1643034742,199383,true,2194518555,28,2185321364,-9197191
1643034752,199380,true,2195176976,28,2185539897,-9637079
1643034925,199380,true,2195176976,28,2189258288,-5918688
1643034955,199380,true,2195176976,28,2189696162,-5480814
1643035099,199377,true,2195835595,28,2192983006,-2852589
1643035114,199374,true,2196494412,28,2193421625,-3072787
1643035163,199374,true,2196494412,28,2194957480,-1536932
1643035203,199373,true,2196714061,28,2196933733,219672
1643035248,199368,true,2197812638,28,2198911764,1099126
1643035361,199365,true,2198472048,28,2204195226,5723178
1643035417,199364,true,2198691895,28,2206400413,7708518
1643035430,199363,true,2198911764,28,2206841715,7929951
1643035459,199359,true,2199791461,28,2207945357,8153896
1643035510,199357,true,2200231441,28,2209491382,9259941
1643035535,199358,true,2200011440,28,2210154296,10142856
1643035594,199358,true,2200011440,28,2210817409,10805969
1643035622,199355,true,2200671509,28,2211038490,10366981
1643035705,199355,true,2200671509,28,2212144231,11472722
1643035738,199356,true,2200451464,28,2212365445,11913981
1643035795,199356,true,2200451464,28,2213250524,12799060
1643035868,199353,true,2201111666,28,2214135957,13024291
1643035993,199356,true,2200451464,28,2214800264,14348800
1643036063,199358,true,2200011440,28,2215021744,15010304
1643036121,199358,true,2200011440,28,2215243246,15231806
1643036134,199356,true,2200451464,28,2215464771,15013307
1643036182,199358,true,2200011440,28,2215907886,15896446
1643036227,199359,true,2199791461,28,2216129477,16338016
1643036686,199358,true,2200011440,28,2216351090,16339650
1643036690,199353,true,2201111666,28,2216351090,15239424
1643036702,199354,true,2200891576,28,2216129477,15237901
1643036973,199355,true,2200671509,28,2213250524,12579015
1643037057,199356,true,2200451464,28,2211038490,10587026
1643037078,199354,true,2200891576,28,2210154296,9262720
1643037123,199355,true,2200671509,28,2208828667,8157158
1643037140,199357,true,2200231441,28,2208166151,7934710
1643037261,199358,true,2200011440,28,2204856550,4845110
1643037331,199354,true,2200891576,28,2203754453,2862877
1643037353,199355,true,2200671509,28,2203534099,2862590
1643037377,199356,true,2200451464,28,2203093459,2641995
1643037396,199357,true,2200231441,28,2202873171,2641730
1643037451,199353,true,2201111666,28,2202212442,1100776
1643037561,199355,true,2200671509,28,2200671509,0
1643037600,199357,true,2200231441,28,2200231441,0
1643037687,199359,true,2199791461,28,2199351568,-439893
1643037688,199358,true,2200011440,28,2199351568,-659872
1643037793,199359,true,2199791461,28,2199131655,-659806
1643037809,199361,true,2199351568,28,2199131655,-219913
1643037854,199362,true,2199131655,28,2199571504,439849
1643037902,199360,true,2199571504,28,2199791461,219957
1643037909,199360,true,2199571504,28,2199791461,219957
1643037924,199362,true,2199131655,28,2200011440,879785
1643037979,199361,true,2199351568,28,2200671509,1319941
1643038042,199357,true,2200231441,28,2201551910,1320469
1643038096,199357,true,2200231441,28,2202212442,1981001
1643038112,199357,true,2200231441,28,2202212442,1981001
1643038351,199356,true,2200451464,28,2205077036,4625572
1643038378,199353,true,2201111666,28,2205518074,4406408
1643038393,199353,true,2201111666,28,2205738625,4626959
1643038425,199354,true,2200891576,28,2206400413,5508837
1643038434,199353,true,2201111666,28,2206621053,5509387
1643038486,199348,true,2202212442,28,2207724584,5512142
1643038513,199349,true,2201992242,28,2208607807,6615565
1643038557,199349,true,2201992242,28,2209933303,7941061
1643038656,199346,true,2202652906,28,2213029221,10376315
1643038716,199341,true,2203754453,28,2215021744,11267291
1643038718,199340,true,2203974828,28,2215243246,11268418
1643038732,199339,true,2204195226,28,2215686317,11491091
1643038775,199335,true,2205077036,28,2217459487,12382451
1643038778,199329,true,2206400413,28,2217459487,11059074
1643038818,199328,true,2206621053,28,2219234075,12613022
1643038848,199327,true,2206841715,28,2220565949,13724234
1643038946,199322,true,2207945357,28,2224788823,16843466
1643039032,199317,true,2209049550,28,2228573992,19524442
1643039095,199316,true,2209270455,28,2231026649,21756194
1643039286,199315,true,2209491382,28,2239296324,29804942
1643039535,199311,true,2210375311,28,2248945546,38570235
1643039621,199306,true,2211480720,28,2251420624,39939904
1643039642,199306,true,2211480720,28,2252096118,40615398
1643039656,199305,true,2211701868,28,2252546559,40844691
1643039676,199301,true,2212586682,28,2252997091,40410409
1643039688,199295,true,2213914566,28,2253447713,39533147
1643039743,199293,true,2214357371,28,2254800120,40442749
1643039805,199292,true,2214578806,28,2256378953,41800147
1643039814,199288,true,2215464771,28,2256604591,41139820
1643039923,199281,true,2217016061,28,2259088098,42072037
1643039953,199278,true,2217681233,28,2259765892,42084659
1643040054,199276,true,2218124791,28,2262252878,44128087
1643040275,199271,true,2219234075,28,2266101786,46867711
1643040325,199264,true,2220788005,28,2266328396,45540391
1643040434,199262,true,2221232185,28,2266781684,45549499
1643040970,199259,true,2221898622,28,2266328396,44429774
1643040988,199255,true,2222787514,28,2266328396,43540882
1643041011,199247,true,2224566367,28,2266555029,41988662
1643041028,199244,true,2225233803,28,2266555029,41321226
1643041041,199241,true,2225901440,28,2266781684,40880244
1643041151,199235,true,2227237315,28,2268368908,41131593
1643041250,199229,true,2228573992,28,2269503319,40929327
1643041294,199226,true,2229242631,28,2270184238,40941607
1643041693,199223,true,2229911470,28,2273137249,43225779
1643041816,199219,true,2230803569,28,2273364563,42560994
1643041863,199214,true,2231919194,28,2274046640,42127446
1643042013,199211,true,2232588836,28,2275411409,42822573
1643042019,199207,true,2233482006,28,2275638951,42156945
1643042168,199203,true,2234375533,28,2276549343,42173810
1643042226,199198,true,2235492944,28,2276776998,41284054
1643042314,199196,true,2235940065,28,2276776998,40836933
1643042500,199194,true,2236387275,28,2276776998,40389723
1643042588,199191,true,2237058259,28,2276549343,39491084
1643042634,199187,true,2237953216,28,2276321711,38368495
1643042730,199187,true,2237953216,28,2276094101,38140885
1643042808,199185,true,2238400829,28,2275411409,37010580
1643042872,199183,true,2238848532,28,2274274045,35425513
1643042891,199180,true,2239520253,28,2273819258,34299005
1643042925,199180,true,2239520253,28,2273137249,33616996
1643042936,199181,true,2239296324,28,2272682690,33386366
1643043025,199181,true,2239296324,28,2270411257,31114933
1643043077,199177,true,2240192177,28,2269049486,28857309
1643043093,199178,true,2239968180,28,2268595745,28627565
1643043175,199180,true,2239520253,28,2266101786,26581533
1643043201,199181,true,2239296324,28,2265422091,26125767
1643043268,199179,true,2239744205,28,2263610569,23866364
1643043313,199180,true,2239520253,28,2262705351,23185098
1643043368,199180,true,2239520253,28,2261800495,22280242
1643043917,199179,true,2239744205,28,2252321327,12577122
1643044100,199177,true,2240192177,28,2250070244,9878067
1643044128,199177,true,2240192177,28,2249845260,9653083
1643044154,199176,true,2240416196,28,2249395358,8979162
1643044273,199175,true,2240640237,28,2248046193,7405956
1643044365,199173,true,2241088388,28,2246697837,5609449
1643044524,199172,true,2241312497,28,2244227952,2915455
1643044695,199172,true,2241312497,28,2242209156,896659
1643044760,199171,true,2241536628,28,2241760782,224154
1643044809,199170,true,2241760782,28,2241536628,-224154
1643044891,199169,true,2241984958,28,2241312497,-672461
1643044917,199168,true,2242209156,28,2241312497,-896659
1643045268,199165,true,2242881886,28,2241984958,-896928
1643045313,199163,true,2243330485,28,2241984958,-1345527
1643045331,199162,true,2243554818,28,2241984958,-1569860
1643045603,199161,true,2243779174,28,2242433377,-1345797
1643045660,199158,true,2244452375,28,2242657621,-1794754
1643045669,199155,true,2245125778,28,2242657621,-2468157
1643045797,199154,true,2245350290,28,2244227952,-1122338
1643045973,199151,true,2246023963,28,2246922507,898544
1643046055,199146,true,2247147199,28,2248720674,1573475
1643046081,199143,true,2247821411,28,2249395358,1573947
1643046105,199141,true,2248270998,28,2250295251,2024253
1643046145,199135,true,2249620298,28,2251645766,2025468
1643046177,199128,true,2251195504,28,2252997091,1801587
1643046364,199124,true,2252096118,28,2261348203,9252085
1643046404,199122,true,2252546559,28,2263157915,10611356
1643046497,199115,true,2254123815,28,2268368908,14245093
1643046532,199108,true,2255702175,28,2270411257,14709082
1643046653,199101,true,2257281640,28,2278143405,20861765
1643046717,199098,true,2257958893,28,2281791170,23832277
1643046751,199091,true,2259539938,28,2283388903,23848965
1643046795,199084,true,2261122091,28,2285901887,24779796
1643046847,199077,true,2262705351,28,2288875343,26169992
1643046876,199074,true,2263384231,28,2290478037,27093806
1643046916,199066,true,2265195572,28,2293228123,28032551
1643046945,199059,true,2266781684,28,2295063347,28281663
1643046946,199052,true,2268368908,28,2295292854,26923946
1643046982,199050,true,2268822604,28,2297589180,28766576
1643047055,199043,true,2270411257,28,2302418945,32007688
1643047124,199037,true,2271773844,28,2306566824,34792980
1643047129,199031,true,2273137249,28,2307028160,33890911
1643047284,199030,true,2273364563,28,2315579547,42214984
1643047287,199023,true,2274956395,28,2315811105,40854710
1643047376,199019,true,2275866515,28,2320215108,44348593
1643047402,199013,true,2277232376,28,2321607585,44375209
1643047438,199013,true,2277232376,28,2323233198,46000822
1643047479,199006,true,2278826917,28,2325092436,46265519
1643047555,199003,true,2279510633,28,2327651316,48140683
1643047630,198999,true,2280422574,28,2330679079,50256505
1643047693,198999,true,2280422574,28,2333244109,52821535
1643047701,198993,true,2281791170,28,2333477433,51686263
1643047799,198989,true,2282704023,28,2338382639,55678616
1643047811,198984,true,2283845604,28,2339084224,55238620
1643047966,198982,true,2284302396,28,2345877073,61574677
1643048208,198976,true,2285673320,28,2354807918,69134598
1643048328,198972,true,2286587726,28,2358342603,71754877
1643048347,198967,true,2287731249,28,2358814295,71083046
1643048459,198965,true,2288188818,28,2361882594,73693776
1643048626,198958,true,2289791031,28,2366137599,76346568
1643048758,198954,true,2290707084,28,2367557636,76850552
1643049114,198950,true,2291623505,28,2370400268,78776763
1643049182,198948,true,2292081852,28,2371585706,79503854
1643049434,198941,true,2293686791,28,2377284062,83597271
1643049523,198936,true,2294833864,28,2378472942,83639078
1643050048,198931,true,2295981510,28,2380852485,84870975
1643050110,198929,true,2296440730,28,2380852485,84411755
1643050152,198921,true,2298278525,28,2380852485,82573960
1643050234,198916,true,2299427894,28,2381090570,81662676
1643050556,198911,true,2300577838,28,2383949451,83371613
1643051306,198910,true,2300807896,28,2389677514,88869618
1643051331,198903,true,2302418945,28,2389916482,87497537
1643051563,198898,true,2303570385,28,2390155474,86585089
1643051651,198893,true,2304722400,28,2390155474,85433074
1643051771,198893,true,2304722400,28,2389677514,84955114
1643051799,198887,true,2306105579,28,2389677514,83571935
1643051828,198882,true,2307258863,28,2389438570,82179707
1643052198,198879,true,2307951110,28,2383234409,75283299
1643052620,198880,true,2307720338,28,2374195755,66475417
1643052957,198872,true,2309567160,28,2368504801,58937641
1643053053,198868,true,2310491126,28,2366847511,56356385
1643053182,198865,true,2311184342,28,2364245540,53061198
1643053772,198866,true,2310953247,28,2355514431,44561184
1643053913,198860,true,2312340166,28,2355278903,42938737
1643054139,198857,true,2313033937,28,2355985557,42951620
1643054393,198853,true,2313959289,28,2358342603,44383314
1643054437,198853,true,2313959289,28,2358814295,44855006
1643054607,198846,true,2315579547,28,2360702007,45122460
1643054773,198842,true,2316505918,28,2362591230,46085312
1643055003,198838,true,2317432659,28,2365427899,47995240
1643055072,198838,true,2317432659,28,2366374212,48941553
1643055155,198832,true,2318823466,28,2368031171,49207705
1643055361,198827,true,2319983110,28,2372771736,52788626
1643055582,198822,true,2321143334,28,2378472942,57329608
1643055797,198820,true,2321607585,28,2382043149,60435564
1643056041,198814,true,2323000898,28,2385380178,62379280
1643056409,198807,true,2324627487,28,2388960754,64333267
1643056424,198802,true,2325790033,28,2388960754,63170721
1643056542,198800,true,2326255214,28,2390872592,64617378
1643056550,198792,true,2328116870,28,2390872592,62755722
1643056714,198783,true,2330213013,28,2394700859,64487846
1643056816,198777,true,2331611491,28,2397576081,65964590
1643056827,198774,true,2332311044,28,2397815838,65504794
1643056864,198765,true,2334410964,28,2398775108,64364144
1643056896,198754,true,2336980100,28,2399494813,62514713
1643057001,198748,true,2338382639,28,2401895388,63512749
1643057006,198744,true,2339318132,28,2401895388,62577256
1643057042,198735,true,2341424361,28,2402375791,60951430
1643057133,198724,true,2344001216,28,2404057959,60056743
1643057161,198718,true,2345407968,28,2404298364,58890396
1643057190,198715,true,2346111661,28,2404779248,58667587
1643057209,198708,true,2347754432,28,2405019726,57265294
1643057254,198698,true,2350103243,28,2405741304,55638061
1643057455,198692,true,2351513658,28,2409352443,57838785
1643057462,198688,true,2352454404,28,2409593378,57138974
1643057482,198681,true,2354101617,28,2410075321,55973704
1643057547,198670,true,2356692423,28,2412245257,55552834
1643057663,198660,true,2359050177,28,2415866159,56815982
1643057668,198656,true,2359993938,28,2416107745,56113807
1643057766,198647,true,2362118783,28,2419734445,57615662
1643057774,198635,true,2364954885,28,2419976418,55021533
1643057780,198625,true,2367320904,28,2420460438,53139534
1643057784,198620,true,2368504801,28,2420460438,51955637
1643057811,198610,true,2370874372,28,2421670910,50796538
1643057881,198600,true,2373246314,28,2424820972,51574658
1643058029,198590,true,2375620628,28,2431133393,55512765
1643058053,198586,true,2376571019,28,2432105993,55534974
1643058061,198576,true,2378948660,28,2432349203,53400543
1643058126,198568,true,2380852485,28,2434782647,53930162
1643058292,198560,true,2382757834,28,2439656841,56899007
1643058378,198557,true,2383472733,28,2441609250,58136517
1643058816,198549,true,2385380178,28,2448210172,62829994
1643058826,198542,true,2387050445,28,2448454993,61404548
1643059602,198533,true,2389199650,28,2454583482,65383832
1643059812,198531,true,2389677514,28,2451885059,62207545
1643059845,198525,true,2391111679,28,2451394756,60283077
1643059898,198519,true,2392546705,28,2451149641,58602936
1643059912,198512,true,2394221990,28,2451149641,56927651
1643060092,198509,true,2394940329,28,2451639895,56699566
1643060483,198503,true,2396377652,28,2455074423,58696771
1643060561,198497,true,2397815838,28,2455565462,57749624
1643060640,198493,true,2398775108,28,2456056600,57281492
1643060699,198490,true,2399494813,28,2456302206,56807393
1643060965,198485,true,2400694800,28,2457039170,56344370
1643061177,198480,true,2401895388,28,2457039170,55143782
1643061236,198476,true,2402856290,28,2457039170,54182880
1643061677,198474,true,2403336885,28,2456547836,53210951
1643062332,198471,true,2404057959,28,2448699839,44641880
1643062393,198466,true,2405260228,28,2447965376,42705148
1643062560,198463,true,2405981878,28,2446741760,40759882
1643062831,198462,true,2406222476,28,2445518756,39296280
1643063102,198458,true,2407185110,28,2446007884,38822774
1643063166,198453,true,2408388943,28,2446007884,37618941
1643063224,198450,true,2409111532,28,2446252485,37140953
1643063243,198448,true,2409593378,28,2446252485,36659107
1643063272,198444,true,2410557360,28,2446252485,35695125
1643063305,198440,true,2411521728,28,2446252485,34730757
1643063342,198437,true,2412245257,28,2446007884,33762627
1643063475,198435,true,2412727730,28,2445029726,32301996
1643063616,198431,true,2413692966,28,2443807578,30114612
1643063646,198426,true,2414900054,28,2443318889,28418835
1643063647,198423,true,2415624596,28,2443318889,27694293
1643063694,198423,true,2415624596,28,2442341806,26717210
1643063798,198421,true,2416107745,28,2440388812,24281067
1643063846,198418,true,2416832650,28,2439656841,22824191
1643063858,198416,true,2417316041,28,2439656841,22340800
1643063885,198416,true,2417316041,28,2439168983,21852942
1643064306,198415,true,2417557772,28,2432835697,15277925
1643065135,198412,true,2418283112,28,2419734445,1451333
1643065809,198410,true,2418766793,28,2419976418,1209625
1643065847,198411,true,2418524940,28,2420218416,1693476
1643066173,198410,true,2418766793,28,2421913077,3146284
1643066181,198406,true,2419734445,28,2422155268,2420823
1643066609,198402,true,2420702484,28,2426033625,5331141
1643067115,198403,true,2420460438,28,2429432280,8971842
1643067340,198401,true,2420944554,28,2430404199,9459645
1643067397,198398,true,2421670910,28,2430890304,9219394
1643067696,198394,true,2422639724,28,2433322289,10682565
1643068913,198394,true,2422639724,28,2439656841,17017117
1643069293,198393,true,2422881988,28,2440876914,17994926
1643069407,198389,true,2423851286,28,2440876914,17025628
1643069583,198388,true,2424093671,28,2440388812,16295141
1643069586,198388,true,2424093671,28,2440388812,16295141
1643069661,198387,true,2424336080,28,2439900807,15564727
1643069777,198384,true,2425063454,28,2438925091,13861637
1643069851,198382,true,2425548491,28,2438193559,12645068
1643069856,198381,true,2425791046,28,2438193559,12402513
1643069949,198380,true,2426033625,28,2437462248,11428623
1643070435,198375,true,2427246884,28,2435269628,8022744
1643070548,198372,true,2427975131,28,2434539193,6564062
1643070585,198370,true,2428460750,28,2434295764,5835014
1643071423,198369,true,2428703597,28,2428460750,-242847
1643071588,198365,true,2429675224,28,2428217929,-1457295
1643071619,198362,true,2430404199,28,2428217929,-2186270
1643071984,198360,true,2430890304,28,2426518856,-4371448
1643072073,198359,true,2431133393,28,2425791046,-5342347
1643072113,198355,true,2432105993,28,2425305960,-6800033
1643072225,198353,true,2432592438,28,2423124276,-9468162
1643072358,198354,true,2432349203,28,2420460438,-11888765
1643072381,198355,true,2432105993,28,2420218416,-11887577
1643072803,198352,true,2432835697,28,2413210300,-19625397
1643073373,198350,true,2433322289,28,2403817577,-29504712
1643073643,198352,true,2432835697,28,2399014986,-33820711
1643074296,198353,true,2432592438,28,2393743218,-38849220
1643074682,198351,true,2433078981,28,2392068267,-41010714
1643074775,198350,true,2433322289,28,2391829085,-41493204
1643074950,198352,true,2432835697,28,2390872592,-41963105
1643075163,198353,true,2432592438,28,2389916482,-42675956
1643075579,198352,true,2432835697,28,2388483034,-44352663
1643076413,198351,true,2433078981,28,2386573107,-46505874
1643076736,198353,true,2432592438,28,2386811764,-45780674
1643077358,198355,true,2432105993,28,2389199650,-42906343
1643077457,198356,true,2431862806,28,2389677514,-42185292
1643077564,198355,true,2432105993,28,2389916482,-42189511
1643078435,198358,true,2431376507,28,2392307474,-39069033
1643078753,198359,true,2431133393,28,2392546705,-38586688
1643078758,198361,true,2430647240,28,2392546705,-38100535
1643078771,198360,true,2430890304,28,2392785960,-38104344
1643078830,198362,true,2430404199,28,2393025238,-37378961
1643079309,198362,true,2430404199,28,2395898448,-34505751
1643079568,198363,true,2430161183,28,2397815838,-32345345
1643079598,198362,true,2430404199,28,2398055620,-32348579
1643081490,198364,true,2429918191,28,2406222476,-23695715
1643081810,198364,true,2429918191,28,2408388943,-21529248
1643082336,198365,true,2429675224,28,2411762880,-17912344
1643082414,198365,true,2429675224,28,2412245257,-17429967
1643082483,198365,true,2429675224,28,2412486481,-17188743
1643083156,198366,true,2429432280,28,2415383058,-14049222
1643083625,198368,true,2428946467,28,2415383058,-13563409
1643085176,198370,true,2428460750,28,2414175729,-14285021
1643085272,198370,true,2428460750,28,2414175729,-14285021
1643085418,198371,true,2428217929,28,2413934335,-14283594
1643085453,198374,true,2427489609,28,2413934335,-13555274
1643085493,198377,true,2426761508,28,2413692966,-13068542
1643085814,198379,true,2426276228,28,2411280600,-14995628
1643085972,198382,true,2425548491,28,2409834338,-15714153
1643086125,198385,true,2424820972,28,2408148128,-16672844
1643086199,198388,true,2424093671,28,2407425828,-16667843
1643086309,198390,true,2423608925,28,2405981878,-17627047
1643086552,198394,true,2422639724,28,2402375791,-20263933
1643086567,198396,true,2422155268,28,2402135577,-20019691
1643086664,198398,true,2421670910,28,2400694800,-20976110
1643086708,198400,true,2421186649,28,2399974736,-21211913
1643087428,198404,true,2420218416,28,2389438570,-30779846
1643087527,198406,true,2419734445,28,2388483034,-31251411
1643087530,198408,true,2419250571,28,2388483034,-30767537
1643087628,198410,true,2418766793,28,2387527879,-31238914
1643088495,198414,true,2417799528,28,2384187846,-33611682
1643088823,198416,true,2417316041,28,2384426265,-32889776
1643088933,198417,true,2417074333,28,2383711080,-33363253
1643089225,198421,true,2416107745,28,2382757834,-33349911
1643089253,198426,true,2414900054,28,2382757834,-32142220
1643089324,198429,true,2414175729,28,2382519582,-31656147
1643090067,198430,true,2413934335,28,2381328679,-32605656
1643090148,198433,true,2413210300,28,2381090570,-32119730
1643090180,198437,true,2412245257,28,2381328679,-30916578
1643090184,198440,true,2411521728,28,2381328679,-30193049
1643090412,198440,true,2411521728,28,2381804969,-29716759
1643090877,198442,true,2411039496,28,2384664707,-26374789
1643091053,198446,true,2410075321,28,2385857278,-24218043
1643091254,198448,true,2409593378,28,2387050445,-22542933
1643091313,198448,true,2409593378,28,2387289151,-22304227
1643091357,198450,true,2409111532,28,2387527879,-21583653
1643091392,198454,true,2408148128,28,2387527879,-20620249
1643091451,198457,true,2407425828,28,2387766632,-19659196
1643091615,198457,true,2407425828,28,2388005409,-19420419
1643092320,198461,true,2406463099,28,2384664707,-21798392
1643092441,198465,true,2405500754,28,2383472733,-22028021
1643092465,198467,true,2405019726,28,2383234409,-21785317
1643092873,198467,true,2405019726,28,2380138372,-24881354
1643093117,198470,true,2404298364,28,2377997318,-26301046
1643093446,198473,true,2403577219,28,2375620628,-27956591
1643094354,198476,true,2402856290,28,2373009013,-29847277
1643094410,198476,true,2402856290,28,2372771736,-30084554
1643094547,198477,true,2402616028,28,2372297253,-30318775
1643094666,198479,true,2402135577,28,2371585706,-30549871
1643095259,198482,true,2401415081,28,2367794392,-33620689
1643095667,198483,true,2401174963,28,2365191380,-35983583
1643095783,198485,true,2400694800,28,2364718413,-35976387
1643095812,198487,true,2400214733,28,2364718413,-35496320
1643095873,198491,true,2399254887,28,2364481965,-34772922
1643096003,198490,true,2399494813,28,2364245540,-35249273
1643096111,198492,true,2399014986,28,2364245540,-34769446
1643096675,198495,true,2398295425,28,2366847511,-31447914
1643097209,198498,true,2397576081,28,2370874372,-26701709
1643097246,198499,true,2397336347,28,2371111460,-26224887
1643097271,198501,true,2396856952,28,2371348571,-25508381
1643097473,198503,true,2396377652,28,2373483638,-22894014
1643097708,198506,true,2395658883,28,2375145575,-20513308
1643097763,198507,true,2395419341,28,2375858190,-19561151
1643097774,198510,true,2394700859,28,2375858190,-18842669
1643098491,198511,true,2394461412,28,2382757834,-11703578
1643098504,198514,true,2393743218,28,2382757834,-10985384
1643098529,198514,true,2393743218,28,2383234409,-10508809
1643098532,198517,true,2393025238,28,2383234409,-9790829
1643098981,198516,true,2393264541,28,2390633529,-2631012
1643099140,198517,true,2393025238,28,2393025238,0
1643099205,198518,true,2392785960,28,2393982592,1196632
1643099303,198520,true,2392307474,28,2394940329,2632855
1643099444,198520,true,2392307474,28,2395898448,3590974
1643099479,198523,true,2391589926,28,2396138038,4548112
1643100133,198525,true,2391111679,28,2393264541,2152862
1643100175,198528,true,2390394489,28,2393025238,2630749
1643100367,198526,true,2390872592,28,2392307474,1434882
1643100476,198529,true,2390155474,28,2391350790,1195316
1643100518,198530,true,2389916482,28,2391111679,1195197
1643100576,198533,true,2389199650,28,2390633529,1433879
1643100818,198531,true,2389677514,28,2389916482,238968
1643101111,198533,true,2389199650,28,2389438570,238920
1643101236,198533,true,2389199650,28,2389677514,477864
1643101391,198534,true,2388960754,28,2390394489,1433735
1643101600,198532,true,2389438570,28,2391350790,1912220
1643102007,198533,true,2389199650,28,2393264541,4064891
1643102049,198534,true,2388960754,28,2393503867,4543113
1643102096,198534,true,2388960754,28,2393743218,4782464
1643102471,198531,true,2389677514,28,2394940329,5262815
1643102499,198533,true,2389199650,28,2394940329,5740679
1643102658,198533,true,2389199650,28,2395179823,5980173
1643102777,198533,true,2389199650,28,2395658883,6459233
1643102796,198529,true,2390155474,28,2395658883,5503409
1643102809,198530,true,2389916482,28,2395658883,5742401
1643103264,198529,true,2390155474,28,2399734762,9579288
1643104458,198529,true,2390155474,28,2411762880,21607406
1643104705,198525,true,2391111679,28,2414175729,23064050
1643105368,198526,true,2390872592,28,2419492496,28619904
1643105545,198525,true,2391111679,28,2421186649,30074970
1643105653,198524,true,2391350790,28,2422397484,31046694
1643105716,198520,true,2392307474,28,2423124276,30816802
1643105811,198520,true,2392307474,28,2424578514,32271040
1643105842,198519,true,2392546705,28,2425305960,32759255
1643106058,198517,true,2393025238,28,2428946467,35921229
1643106313,198514,true,2393743218,28,2433078981,39335763
1643106667,198514,true,2393743218,28,2436487506,42744288
1643106930,198513,true,2393982592,28,2438193559,44210967
1643106956,198512,true,2394221990,28,2438437379,44215389
1643106990,198510,true,2394700859,28,2438437379,43736520
1643106993,198510,true,2394700859,28,2438437379,43736520
1643107384,198510,true,2394700859,28,2439412900,44712041
1643107441,198510,true,2394700859,28,2439412900,44712041
1643107498,198507,true,2395419341,28,2439168983,43749642
1643108542,198508,true,2395179823,28,2430161183,34981360
1643108663,198508,true,2395179823,28,2429675224,34495401
1643108872,198508,true,2395179823,28,2429432280,34252457
1643109058,198505,true,2395898448,28,2429189362,33290914
1643109087,198505,true,2395898448,28,2429189362,33290914
1643109325,198504,true,2396138038,28,2429432280,33294242
1643109737,198503,true,2396377652,28,2431376507,34998855
1643109802,198500,true,2397096637,28,2431619644,34523007
1643109852,198500,true,2397096637,28,2431619644,34523007
1643109947,198499,true,2397336347,28,2431619644,34283297
1643109964,198498,true,2397576081,28,2431619644,34043563
1643110119,198495,true,2398295425,28,2430890304,32594879
1643111178,198496,true,2398055620,28,2423124276,25068656
1643111360,198495,true,2398295425,28,2421670910,23375485
1643111571,198494,true,2398535255,28,2420702484,22167229
1643111729,198490,true,2399494813,28,2420460438,20965625
1643111736,198490,true,2399494813,28,2420460438,20965625
1643111745,198488,true,2399974736,28,2420460438,20485702
1643111828,198487,true,2400214733,28,2420702484,20487751
1643112098,198484,true,2400934870,28,2421913077,20978207
1643112350,198483,true,2401174963,28,2423124276,21949313
1643112413,198482,true,2401415081,28,2423124276,21709195
1643112571,198481,true,2401655222,28,2423366588,21711366
1643112983,198477,true,2402616028,28,2423851286,21235258
1643113042,198477,true,2402616028,28,2423608925,20992897
1643113264,198476,true,2402856290,28,2422639724,19783434
1643113517,198475,true,2403096576,28,2422155268,19058692
1643113578,198472,true,2403817577,28,2421913077,18095500
1643113652,198471,true,2404057959,28,2421670910,17612951
1643113720,198471,true,2404057959,28,2421913077,17855118
1643113737,198470,true,2404298364,28,2421913077,17614713
1643113843,198466,true,2405260228,28,2422155268,16895040
1643113971,198465,true,2405500754,28,2422881988,17381234
1643114251,198464,true,2405741304,28,2425063454,19322150
1643114334,198463,true,2405981878,28,2426033625,20051747
1643114362,198459,true,2406944415,28,2426276228,19331813
1643114398,198458,true,2407185110,28,2426518856,19333746
1643114506,198456,true,2407666571,28,2427975131,20308560
1643115145,198453,true,2408388943,28,2438681223,30292280
1643115728,198449,true,2409352443,28,2445274229,35921786
1643115754,198447,true,2409834338,28,2445274229,35439891
1643115886,198446,true,2410075321,28,2446007884,35932563
1643115957,198443,true,2410798416,28,2446252485,35454069
1643116040,198439,true,2411762880,28,2446252485,34489605
1643116072,198437,true,2412245257,28,2446252485,34007228
1643116104,198436,true,2412486481,28,2446007884,33521403
1643116159,198433,true,2413210300,28,2446007884,32797584
1643116180,198429,true,2414175729,28,2445763308,31587579
1643116661,198427,true,2414658588,28,2440388812,25730224
1643117249,198426,true,2414900054,28,2433078981,18178927
1643117259,198423,true,2415624596,28,2433078981,17454385
1643117265,198419,true,2416590991,28,2433078981,16487990
1643117286,198418,true,2416832650,28,2432592438,15759788
1643118767,198418,true,2416832650,28,2417799528,966878
1643118798,198416,true,2417316041,28,2417799528,483487
1643119083,198413,true,2418041308,28,2416349356,-1691952
1643119179,198411,true,2418524940,28,2416590991,-1933949
1643119470,198412,true,2418283112,28,2417799528,-483584
1643119676,198409,true,2419008670,28,2419008670,0
1643119689,198406,true,2419734445,28,2419250571,-483874
1643120129,198404,true,2420218416,28,2423366588,3148172
1643120163,198404,true,2420218416,28,2423608925,3390509
1643120207,198401,true,2420944554,28,2424093671,3149117
1643120228,198399,true,2421428767,28,2424336080,2907313
1643120405,198397,true,2421913077,28,2426761508,4848431
1643120440,198397,true,2421913077,28,2427246884,5333807
1643120473,198394,true,2422639724,28,2427732358,5092634
1643120557,198393,true,2422881988,28,2429189362,6307374
1643120871,198390,true,2423608925,28,2435756706,12147781
1643120923,198390,true,2423608925,28,2436487506,12878581
1643121022,198387,true,2424336080,28,2437949764,13613684
1643121036,198385,true,2424820972,28,2438193559,13372587
1643121195,198383,true,2425305960,28,2439412900,14106940
1643121257,198382,true,2425548491,28,2439900807,14352316
1643121371,198379,true,2426276228,28,2440388812,14112584
1643121406,198377,true,2426761508,28,2440632851,13871343
1643121437,198375,true,2427246884,28,2440876914,13630030
1643121650,198372,true,2427975131,28,2444296364,16321233
1643121723,198369,true,2428703597,28,2445274229,16570632
1643121793,198368,true,2428946467,28,2446007884,17061417
1643121798,198366,true,2429432280,28,2446252485,16820205
1643121957,198364,true,2429918191,28,2447475856,17557665
1643122024,198361,true,2430647240,28,2447965376,17318136
1643122059,198360,true,2430890304,28,2447965376,17075072
1643122097,198358,true,2431376507,28,2447720604,16344097
1643122295,198358,true,2431376507,28,2446252485,14875978
1643122395,198356,true,2431862806,28,2444785247,12922441
1643122432,198356,true,2431862806,28,2444051958,12189152
1643122439,198354,true,2432349203,28,2443807578,11458375
1643122723,198357,true,2431619644,28,2436000282,4380638
1643122781,198355,true,2432105993,28,2434295764,2189771
1643122800,198356,true,2431862806,28,2433808978,1946172
1643122869,198354,true,2432349203,28,2432105993,-243210
1643122902,198358,true,2431376507,28,2431376507,0
1643122918,198358,true,2431376507,28,2430890304,-486203
1643122944,198359,true,2431133393,28,2430161183,-972210
1643122957,198359,true,2431133393,28,2429675224,-1458169
1643123382,198365,true,2429675224,28,2412486481,-17188743
1643123479,198365,true,2429675224,28,2408148128,-21527096
1643123489,198367,true,2429189362,28,2407666571,-21522791
1643123575,198367,true,2429189362,28,2404057959,-25131403
1643123641,198373,true,2427732358,28,2401895388,-25836970
1643123781,198373,true,2427732358,28,2397815838,-29916520
1643123800,198375,true,2427246884,28,2397576081,-29670803
1643123889,198374,true,2427489609,28,2395898448,-31591161
1643123993,198379,true,2426276228,28,2394700859,-31575369
1643124240,198378,true,2426518856,28,2392307474,-34211382
1643124245,198380,true,2426033625,28,2392307474,-33726151
1643124360,198379,true,2426276228,28,2392546705,-33729523
1643124531,198383,true,2425305960,28,2393503867,-31802093
1643124549,198382,true,2425548491,28,2393743218,-31805273
1643124965,198382,true,2425548491,28,2403577219,-21971272
1643125033,198380,true,2426033625,28,2405260228,-20773397
1643125326,198384,true,2425063454,28,2412245257,-12818197
1643125348,198382,true,2425548491,28,2412727730,-12820761
1643125421,198383,true,2425305960,28,2413934335,-11371625
1643125470,198382,true,2425548491,28,2414658588,-10889903
1643125493,198386,true,2424578514,28,2414900054,-9678460
1643125706,198384,true,2425063454,28,2418283112,-6780342
1643126033,198384,true,2425063454,28,2423124276,-1939178
1643126314,198382,true,2425548491,28,2426033625,485134
1643126356,198386,true,2424578514,28,2426276228,1697714
1643126372,198383,true,2425305960,28,2426276228,970268
1643126700,198383,true,2425305960,28,2425791046,485086
1643126730,198382,true,2425548491,28,2425791046,242555
1643126852,198385,true,2424820972,28,2426276228,1455256
1643127016,198382,true,2425548491,28,2427246884,1698393
1643127322,198382,true,2425548491,28,2429432280,3883789
1643127558,198380,true,2426033625,28,2430404199,4370574
1643127604,198384,true,2425063454,28,2430647240,5583786
1643127618,198381,true,2425791046,28,2430647240,4856194
1643127665,198380,true,2426033625,28,2430890304,4856679
1643128543,198378,true,2426518856,28,2438681223,12162367
1643128625,198381,true,2425791046,28,2438925091,13134045
1643128961,198378,true,2426518856,28,2440388812,13869956
1643129014,198377,true,2426761508,28,2440632851,13871343
1643129081,198375,true,2427246884,28,2440876914,13630030
1643129122,198379,true,2426276228,28,2441121001,14844773
1643129520,198375,true,2427246884,28,2441609250,14362366
1643129544,198373,true,2427732358,28,2441853411,14121053
1643129769,198371,true,2428217929,28,2442586040,14368111
1643129855,198375,true,2427246884,28,2442830299,15583415
1643129938,198372,true,2427975131,28,2442830299,14855168
1643130001,198370,true,2428460750,28,2442830299,14369549
1643130069,198370,true,2428460750,28,2442830299,14369549
1643130283,198374,true,2427489609,28,2442586040,15096431
1643130385,198371,true,2428217929,28,2443074582,14856653
1643130424,198370,true,2428460750,28,2443563221,15102471
1643130628,198368,true,2428946467,28,2445029726,16083259
1643131200,198373,true,2427732358,28,2448454993,20722635
1643131215,198370,true,2428460750,28,2448699839,20239089
1643131247,198369,true,2428703597,28,2448944709,20241112
1643131288,198368,true,2428946467,28,2449434522,20488055
1643131954,198369,true,2428703597,28,2458759614,30056017
1643131968,198367,true,2429189362,28,2458759614,29570252
1643132488,198365,true,2429675224,28,2462942851,33267627
1643132539,198364,true,2429918191,28,2463189145,33270954
1643132655,198366,true,2429432280,28,2463928175,34495895
1643132749,198362,true,2430404199,28,2465653443,35249244
1643132850,198360,true,2430890304,28,2467379918,36489614
1643132875,198357,true,2431619644,28,2467873419,36253775
1643132879,198358,true,2431376507,28,2467873419,36496912
1643132956,198355,true,2432105993,28,2468860716,36754723
1643132987,198353,true,2432592438,28,2469107602,36515164
1643133606,198350,true,2433322289,28,2470342403,37020114
1643133744,198349,true,2433565621,28,2470589437,37023816
1643134663,198346,true,2434295764,28,2473803131,39507367
1643134688,198344,true,2434782647,28,2473803131,39020484
1643134854,198342,true,2435269628,28,2474297917,39028289
1643135107,198341,true,2435513155,28,2475287784,39774629
1643135113,198338,true,2436243882,28,2475287784,39043902
1643135230,198336,true,2436731155,28,2476030445,39299290
1643135253,198334,true,2437218526,28,2476278048,39059522
1643135270,198333,true,2437462248,28,2476525676,39063428
1643135516,198329,true,2438437379,28,2479499141,41061762
1643135593,198327,true,2438925091,28,2480243066,41317975
1643135620,198326,true,2439168983,28,2480739139,41570156
1643135632,198325,true,2439412900,28,2480987213,41574313
1643136066,198320,true,2440632851,28,2488192158,47559307
1643136086,198318,true,2441121001,28,2488440977,47319976
1643136127,198318,true,2441121001,28,2488938690,47817689
1643136158,198318,true,2441121001,28,2489187584,48066583
1643136186,198314,true,2442097596,28,2489685446,47587850
1643136232,198312,true,2442586040,28,2489934415,47348375
1643136262,198311,true,2442830299,28,2490183408,47353109
1643136798,198311,true,2442830299,28,2493921299,51091000
1643136830,198306,true,2444051958,28,2494170691,50118733
1643136838,198305,true,2444296364,28,2494170691,49874327
1643137118,198303,true,2444785247,28,2494919017,50133770
1643137208,198305,true,2444296364,28,2494919017,50622653
1643137604,198301,true,2445274229,28,2493671932,48397703
1643138129,198299,true,2445763308,28,2492425470,46662162
1643138170,198298,true,2446007884,28,2492674713,46666829
1643138753,198298,true,2446007884,28,2495418026,49410142
1643138914,198294,true,2446986434,28,2495667568,48681134
1643138938,198292,true,2447475856,28,2495667568,48191712
1643139369,198291,true,2447720604,28,2493422590,45701986
1643139524,198291,true,2447720604,28,2492176252,44455648
1643139901,198287,true,2448699839,28,2488440977,39741138
1643140169,198284,true,2449434522,28,2486699765,37265243
1643140328,198283,true,2449679466,28,2484711300,35031834
1643140406,198281,true,2450169426,28,2483717664,33548238
1643140935,198276,true,2451394756,28,2478259764,26865008
1643141125,198274,true,2451885059,28,2476773328,24888269
1643141132,198273,true,2452130248,28,2476525676,24395428
1643141140,198270,true,2452865960,28,2476525676,23659716
1643141416,198266,true,2453847254,28,2473803131,19955877
1643141429,198263,true,2454583482,28,2473803131,19219649
1643141504,198262,true,2454828940,28,2472813857,17984917
1643141762,198257,true,2456056600,28,2469354513,13297913
1643141888,198254,true,2456793491,28,2467133205,10339714
1643141897,198252,true,2457284874,28,2466886516,9601642
1643142026,198250,true,2457776356,28,2465160386,7384030
1643142065,198246,true,2458759614,28,2464667428,5907814
1643142085,198244,true,2459251390,28,2464420986,5169596
1643142299,198242,true,2459743265,28,2462942851,3199586
1643142517,198241,true,2459989239,28,2460973383,984144
1643142603,198238,true,2460727310,28,2459989239,-738071
1643142804,198237,true,2460973383,28,2457530603,-3442780
1643142828,198235,true,2461465602,28,2457284874,-4180728
1643143112,198236,true,2461219480,28,2453356558,-7862922
1643143219,198233,true,2461957920,28,2452130248,-9827672
1643143317,198232,true,2462204115,28,2451394756,-10809359
1643143450,198231,true,2462450336,28,2450904550,-11545786
1643143776,198232,true,2462204115,28,2450414443,-11789672
1643143798,198229,true,2462942851,28,2450169426,-12773425
1643143836,198229,true,2462942851,28,2449924434,-13018417
1643144526,198228,true,2463189145,28,2444296364,-18892781
1643144639,198228,true,2463189145,28,2444051958,-19137187
1643144723,198226,true,2463681807,28,2444051958,-19629849
1643144777,198226,true,2463681807,28,2443807578,-19874229
1643144839,198226,true,2463681807,28,2443563221,-20118586
1643144891,198228,true,2463189145,28,2443318889,-19870256
1643146050,198227,true,2463435464,28,2429918191,-33517273
1643146098,198227,true,2463435464,28,2429189362,-34246102
1643146128,198227,true,2463435464,28,2428946467,-34488997
1643146518,198228,true,2463189145,28,2424093671,-39095474
1643146534,198227,true,2463435464,28,2423851286,-39584178
1643146585,198228,true,2463189145,28,2423366588,-39822557
1643146597,198228,true,2463189145,28,2423366588,-39822557
1643147242,198231,true,2462450336,28,2419250571,-43199765
1643148143,198230,true,2462696581,28,2416107745,-46588836
1643148670,198231,true,2462450336,28,2416590991,-45859345
1643149058,198232,true,2462204115,28,2418041308,-44162807
1643149126,198234,true,2461711748,28,2418041308,-43670440
1643149180,198234,true,2461711748,28,2418041308,-43670440
1643149191,198234,true,2461711748,28,2418041308,-43670440
1643149519,198236,true,2461219480,28,2417074333,-44145147
1643149917,198238,true,2460727310,28,2416590991,-44136319
1643150065,198237,true,2460973383,28,2416349356,-44624027
1643150218,198238,true,2460727310,28,2416590991,-44136319
1643151520,198239,true,2460481262,28,2424578514,-35902748
1643151610,198241,true,2459989239,28,2425305960,-34683279
1643151662,198240,true,2460235238,28,2426033625,-34201613
1643151891,198241,true,2459989239,28,2428217929,-31771310
1643151906,198241,true,2459989239,28,2428460750,-31528489
1643152030,198242,true,2459743265,28,2429432280,-30310985
1643152108,198241,true,2459989239,28,2429918191,-30071048
1643152401,198242,true,2459743265,28,2431619644,-28123621
1643152524,198242,true,2459743265,28,2432592438,-27150827
1643152525,198244,true,2459251390,28,2432592438,-26658952
1643152526,198243,true,2459497315,28,2432592438,-26904877
1643152732,198243,true,2459497315,28,2435269628,-24227687
1643152740,198242,true,2459743265,28,2435513155,-24230110
1643154458,198243,true,2459497315,28,2457039170,-2458145
1643154501,198245,true,2459005490,28,2457284874,-1720616
1643154631,198244,true,2459251390,28,2458022133,-1229257
1643154940,198243,true,2459497315,28,2459497315,0
1643155036,198243,true,2459497315,28,2459989239,491924
1643155398,198245,true,2459005490,28,2460235238,1229748
1643155983,198245,true,2459005490,28,2459251390,245900
1643156418,198246,true,2458759614,28,2457039170,-1720444
1643156457,198247,true,2458513762,28,2456547836,-1965926
1643156459,198249,true,2458022133,28,2456547836,-1474297
1643156519,198250,true,2457776356,28,2456056600,-1719756
1643157359,198250,true,2457776356,28,2449924434,-7851922
1643157951,198250,true,2457776356,28,2447965376,-9810980
1643158026,198253,true,2457039170,28,2447475856,-9563314
1643158037,198253,true,2457039170,28,2447475856,-9563314
1643158319,198254,true,2456793491,28,2445763308,-11030183
1643158357,198256,true,2456302206,28,2445518756,-10783450
1643158384,198258,true,2455811019,28,2445274229,-10536790
1643158464,198260,true,2455319930,28,2444296364,-11023566
1643159068,198262,true,2454828940,28,2436487506,-18341434
1643159089,198264,true,2454338048,28,2436243882,-18094166
1643159180,198268,true,2453356558,28,2435269628,-18086930
1643159195,198269,true,2453111247,28,2435026125,-18085122
1643160112,198271,true,2452620698,28,2427732358,-24888340
1643160188,198273,true,2452130248,28,2427732358,-24397890
1643160329,198277,true,2451149641,28,2428703597,-22446044
1643161559,198279,true,2450659484,28,2435026125,-15633359
1643161843,198281,true,2450169426,28,2436000282,-14169144
1643162068,198283,true,2449679466,28,2436731155,-12948311
1643162134,198287,true,2448699839,28,2436731155,-11968684
1643162224,198288,true,2448454993,28,2436974828,-11480165
1643162602,198289,true,2448210172,28,2438193559,-10016613
1643162628,198290,true,2447965376,28,2438437379,-9527997
1643162634,198293,true,2447231133,28,2438437379,-8793754
1643163006,198295,true,2446741760,28,2440144797,-6596963
1643163066,198295,true,2446741760,28,2440632851,-6108909
1643163180,198297,true,2446252485,28,2441365114,-4887371
1643163240,198300,true,2445518756,28,2441853411,-3665345
1643163357,198301,true,2445274229,28,2443074582,-2199647
1643163377,198301,true,2445274229,28,2443318889,-1955340
1643164695,198303,true,2444785247,28,2453111247,8326000
1643164708,198306,true,2444051958,28,2453356558,9304600
1643164845,198307,true,2443807578,28,2454583482,10775904
1643165033,198307,true,2443807578,28,2456056600,12249022
1643165056,198307,true,2443807578,28,2456302206,12494628
1643165173,198309,true,2443318889,28,2456793491,13474602
1643165249,198309,true,2443318889,28,2456793491,13474602
1643165295,198311,true,2442830299,28,2456793491,13963192
1643166687,198310,true,2443074582,28,2455565462,12490880
1643167179,198313,true,2442341806,28,2453601894,11260088
1643167228,198313,true,2442341806,28,2453601894,11260088
1643167700,198313,true,2442341806,28,2455811019,13469213
1643168044,198312,true,2442586040,28,2457530603,14944563
1643168471,198314,true,2442097596,28,2461465602,19368006
1643168898,198313,true,2442341806,28,2465653443,23311637
1643168931,198312,true,2442586040,28,2465900008,23313968
1643169060,198311,true,2442830299,28,2467133205,24302906
1643169131,198312,true,2442586040,28,2467626656,25040616
1643169891,198309,true,2443318889,28,2473803131,30484242
1643170093,198309,true,2443318889,28,2474297917,30979028
1643170894,198308,true,2443563221,28,2476525676,32962455
1643171732,198309,true,2443318889,28,2474297917,30979028
1643172504,198307,true,2443807578,28,2473308445,29500867
1643172544,198307,true,2443807578,28,2473308445,29500867
1643172572,198306,true,2444051958,28,2473308445,29256487
1643173184,198306,true,2444051958,28,2479003316,34951358
1643173189,198302,true,2445029726,28,2479003316,33973590
1643173211,198302,true,2445029726,28,2479251216,34221490
1643173234,198299,true,2445763308,28,2479747091,33983783
1643173526,198298,true,2446007884,28,2483469317,37461433
1643173753,198294,true,2446986434,28,2486202499,39216065
1643173988,198294,true,2446986434,28,2489436503,42450069
1643174100,198292,true,2447475856,28,2490681470,43205614
1643176444,198292,true,2447475856,28,2490183408,42707552
1643176468,198288,true,2448454993,28,2490183408,41728415
1643177034,198288,true,2448454993,28,2488440977,39985984
1643178473,198286,true,2448944709,28,2482724425,33779716
1643178515,198286,true,2448944709,28,2482724425,33779716
1643178561,198282,true,2449924434,28,2482476177,32551743
1643178750,198281,true,2450169426,28,2481235312,31065886
1643179067,198281,true,2450169426,28,2478507590,28338164
1643179075,198280,true,2450414443,28,2478507590,28093147
1643179452,198276,true,2451394756,28,2474050511,22655755
1643179702,198276,true,2451394756,28,2471083580,19688824
1643179769,198275,true,2451639895,28,2470095393,18455498
1643179897,198274,true,2451885059,28,2468367018,16481959
1643179959,198270,true,2452865960,28,2467379918,14513958
1643180056,198270,true,2452865960,28,2465900008,13034048
1643180893,198270,true,2452865960,28,2455811019,2945059
1643181548,198269,true,2453111247,28,2452375461,-735786
1643182324,198265,true,2454092639,28,2451639895,-2452744
1643182657,198265,true,2454092639,28,2452375461,-1717178
1643182986,198264,true,2454338048,28,2453356558,-981490
1643184129,198263,true,2454583482,28,2458022133,3438651
1643184328,198259,true,2455565462,28,2459005490,3440028
1643184362,198258,true,2455811019,28,2459251390,3440371
1643184556,198257,true,2456056600,28,2460973383,4916783
1643185707,198255,true,2456547836,28,2469601448,13053612
1643186201,198251,true,2457530603,28,2475040280,17509677
1643186228,198251,true,2457530603,28,2475287784,17757181
1643187628,198250,true,2457776356,28,2484214432,26438076
1643187661,198247,true,2458513762,28,2484214432,25700670
1643188167,198242,true,2459743265,28,2485208267,25465002
1643188408,198243,true,2459497315,28,2485456788,25959473
1643188596,198242,true,2459743265,28,2485705334,25962069
1643188622,198239,true,2460481262,28,2485953904,25472642
1643188927,198235,true,2461465602,28,2486699765,25234163
1643188953,198236,true,2461219480,28,2486699765,25480285
1643189189,198234,true,2461711748,28,2489685446,27973698
1643189243,198231,true,2462450336,28,2490432427,27982091
1643189258,198227,true,2463435464,28,2490681470,27246006
1643189261,198228,true,2463189145,28,2490681470,27492325
1643189277,198227,true,2463435464,28,2490681470,27246006
1643189486,198224,true,2464174568,28,2492425470,28250902
1643189576,198221,true,2464913895,28,2492923980,28010085
1643189602,198222,true,2464667428,28,2493173272,28505844
1643190053,198223,true,2464420986,28,2494420108,29999122
1643190159,198220,true,2465160386,28,2494669550,29509164
1643190175,198216,true,2466146598,28,2494919017,28772419
1643190210,198217,true,2465900008,28,2494919017,29019009
1643190371,198216,true,2466146598,28,2496416343,30269745
1643190922,198213,true,2466886516,28,2498414175,31527659
1643190930,198209,true,2467873419,28,2498414175,30540756
1643190939,198209,true,2467873419,28,2498414175,30540756
1643191293,198209,true,2467873419,28,2496665985,28792566
1643191818,198207,true,2468367018,28,2494669550,26302532
1643192412,198203,true,2469354513,28,2490432427,21077914
1643193041,198203,true,2469354513,28,2486202499,16847986
1643193070,198202,true,2469601448,28,2486202499,16601051
1643193283,198200,true,2470095393,28,2486699765,16604372
1643193627,198195,true,2471330688,28,2488192158,16861470
1643193812,198193,true,2471824979,28,2489436503,17611524
1643193819,198192,true,2472072161,28,2489436503,17364342
1643193832,198189,true,2472813857,28,2489685446,16871589
1643193921,198184,true,2474050511,28,2490681470,16630959
1643194233,198181,true,2474792801,28,2495418026,20625225
1643194485,198180,true,2475040280,28,2499413691,24373411
1643194679,198177,true,2475782866,28,2503666095,27883229
1643194720,198172,true,2477021006,28,2504417270,27396264
1643195138,198168,true,2478011963,28,2514454498,36442535
1643195521,198167,true,2478259764,28,2521504484,43244720
1643195825,198164,true,2479003316,28,2524784407,45781091
1643196262,198159,true,2480243066,28,2527310328,47067262
1643196823,198156,true,2480987213,28,2526047052,45059839
1643196838,198155,true,2481235312,28,2526047052,44811740
1643197397,198152,true,2481979757,28,2525794472,43814715
1643197851,198147,true,2483220995,28,2527057622,43836627
1643197898,198144,true,2483966036,28,2527310328,43344292
1643197924,198143,true,2484214432,28,2527310328,43095896
1643198341,198139,true,2485208267,28,2530597803,45389536
1643200166,198134,true,2486451120,28,2541248132,54797012
1643200265,198131,true,2487197130,28,2541248132,54051002
1643200709,198130,true,2487445849,28,2540739958,53294109
1643200955,198127,true,2488192158,28,2540485910,52293752
1643202402,198122,true,2489436503,28,2540231887,50795384
1643202504,198119,true,2490183408,28,2539977889,49794481
1643202546,198119,true,2490183408,28,2539977889,49794481
1643202561,198116,true,2490930538,28,2540231887,49301349
1643202723,198110,true,2492425470,28,2541502257,49076787
1643203003,198106,true,2493422590,28,2543027539,49604949
1643203381,198106,true,2493422590,28,2545062673,51640083
1643203404,198102,true,2494420108,28,2545317180,50897072
1643203427,198096,true,2495917135,28,2545571711,49654576
1643203455,198092,true,2496915651,28,2545826269,48910618
1643203486,198091,true,2497165343,28,2546335459,49170116
1643203511,198087,true,2498164359,28,2547099436,48935077
1643203514,198080,true,2499913599,28,2547354146,47440547
1643203584,198075,true,2501163805,28,2549137829,47974024
1643203617,198074,true,2501413922,28,2550157637,48743715
1643203630,198070,true,2502414637,28,2550412653,47998016
1643204158,198065,true,2503666095,28,2563708674,60042579
1643204202,198060,true,2504918179,28,2564990784,60072605
1643204680,198058,true,2505419187,28,2576558673,71139486
1643204733,198054,true,2506421505,28,2577847210,71425705
1643204845,198048,true,2507925734,28,2581458543,73532809
1643204870,198043,true,2509179948,28,2582233058,73053110
1643204938,198039,true,2510183770,28,2584816453,74632683
1643204971,198036,true,2510936901,28,2586109120,75172219
1643205004,198030,true,2512443840,28,2587402433,74958593
1643205011,198025,true,2513700313,28,2587661173,73960860
1643205109,198019,true,2515208910,28,2592322925,77114015
1643205137,198016,true,2515963548,28,2593878707,77915159
1643205244,198010,true,2517473504,28,2598811515,81338011
1643205321,198005,true,2518732492,28,2601411496,82679004
1643205344,198000,true,2519992110,28,2601931804,81939694
1643205360,197996,true,2521000259,28,2602191998,81191739
1643205393,197990,true,2522513237,28,2602712462,80199225
1643205486,197986,true,2523522394,28,2604795361,81272967
1643205521,197980,true,2525036886,28,2605576878,80539992
1643205612,197976,true,2526047052,28,2607662069,81615017
1643205825,197970,true,2527563059,28,2612621088,85058029
1643205876,197965,true,2528827093,28,2613666294,84839201
1643205956,197958,true,2530597803,28,2615496409,84898606
1643205973,197954,true,2531610194,28,2616019535,84409341
1643206030,197947,true,2533382853,28,2617327806,83944953
1643206130,197942,true,2534649798,28,2619684343,85034545
1643206290,197934,true,2536678228,28,2623354286,86676058
1643206346,197930,true,2537693051,28,2624666226,86973175
1643206378,197923,true,2539469969,28,2625191185,85721216
1643206412,197917,true,2540994032,28,2625978821,84984789
1643206440,197909,true,2543027539,28,2626766694,83739155
1643206480,197904,true,2544299307,28,2627817558,83518251
1643206484,197897,true,2546080851,28,2627817558,81736707
1643206781,197890,true,2547863643,28,2633604831,85741188
1643206835,197882,true,2549902647,28,2634131578,84228931
1643206860,197877,true,2551177853,28,2634394992,83217139
1643206992,197870,true,2552964214,28,2635448908,82484694
1643207113,197863,true,2554751825,28,2637030572,82278747
1643207577,197855,true,2556796342,28,2644953146,88156804
1643207628,197852,true,2557563457,28,2645482163,87918706
1643207684,197845,true,2559354289,28,2646011286,86656997
1643207737,197838,true,2561146375,28,2646275887,85129512
1643207739,197832,true,2562683447,28,2646275887,83592440
1643207840,197830,true,2563196009,28,2646540515,83344506
1643208606,197824,true,2564734311,28,2645482163,80747852
1643208640,197817,true,2566530164,28,2645217641,78687477
1643209237,197811,true,2568070467,28,2639932757,71862290
1643209248,197809,true,2568584107,28,2639932757,71348650
1643209478,197803,true,2570125642,28,2639404849,69279207
1643209508,197795,true,2572182463,28,2639668790,67486327
1643209959,197790,true,2573468811,28,2643631066,70162255
1643210011,197788,true,2573983531,28,2643895429,69911898
1643210019,197783,true,2575270780,28,2644159819,68889039
1643210068,197776,true,2577074010,28,2644159819,67085809
1643210159,197770,true,2578620641,28,2644424235,65803594
1643210182,197768,true,2579136391,28,2644424235,65287844
1643210383,197764,true,2580168201,28,2643895429,63727228
1643210715,197757,true,2581974860,28,2642838135,60863275
1643210816,197751,true,2583524433,28,2642045442,58521009
1643210827,197749,true,2584041163,28,2642045442,58004279
1643210833,197744,true,2585333442,28,2642045442,56712000
1643210836,197738,true,2586885030,28,2642045442,55160412
1643210887,197734,true,2587919939,28,2641252987,53333048
1643210913,197732,true,2588437549,28,2640988888,52551339
1643210978,197728,true,2589473080,28,2639932757,50459677
1643211036,197722,true,2591027152,28,2638877048,47849896
1643211097,197718,true,2592063718,28,2637558005,45494287
1643211858,197715,true,2592841415,28,2623091977,30250562
1643212035,197710,true,2594138095,28,2620732374,26594279
1643212151,197705,true,2595435424,28,2619160485,23725061
1643212165,197700,true,2596733401,28,2618898595,22165194
1643212788,197698,true,2597252774,28,2608966161,11713387
1643213196,197695,true,2598032027,28,2605837435,7805408
1643213370,197690,true,2599331303,28,2604795361,5464058
1643213678,197685,true,2600631229,28,2603493354,2862125
1643213763,197683,true,2601151381,28,2603233031,2081650
1643213792,197680,true,2601931804,28,2603233031,1301227
1643213811,197676,true,2602972733,28,2603233031,260298
1643215043,197672,true,2604014079,28,2610009904,5995825
1643215083,197670,true,2604534907,28,2610270905,5735998
1643215220,197667,true,2605316346,28,2610531932,5215586
1643216186,197664,true,2606098019,28,2609487980,3389961
1643216270,197661,true,2606879927,28,2609227057,2347130
1643216292,197659,true,2607401329,28,2609227057,1825728
1643216439,197656,true,2608183627,28,2609227057,1043430
1643216477,197653,true,2608966161,28,2609227057,260896
1643216533,197649,true,2610009904,28,2609227057,-782847
1643216674,197646,true,2610792985,28,2610009904,-783081
1643216698,197643,true,2611576301,28,2610270905,-1305396
1643216870,197640,true,2612359853,28,2611576301,-783552
1643216890,197636,true,2613404953,28,2611837459,-1567494
1643217582,197633,true,2614189053,28,2619946312,5757259
1643217743,197631,true,2614711917,28,2622043003,7331086
1643217869,197627,true,2615757959,28,2623616622,7858663
1643218331,197623,true,2616804419,28,2628605982,11801563
1643218395,197621,true,2617327806,28,2628868843,11541037
1643218477,197619,true,2617851298,28,2628605982,10754684
1643218878,197616,true,2618636732,28,2625453704,6816972
1643218982,197613,true,2619422401,28,2624403785,4981384
1643219156,197611,true,2619946312,28,2622567437,2621125
1643219505,197610,true,2620208306,28,2618898595,-1309711
1643219753,197608,true,2620732374,28,2615234886,-5497488
1643220031,197605,true,2621518673,28,2610792985,-10725688
1643220072,197603,true,2622043003,28,2610270905,-11772098
1643220092,197602,true,2622305207,28,2609748929,-12556278
1643220120,197601,true,2622567437,28,2609227057,-13340380
1643220145,197601,true,2622567437,28,2608444446,-14122991
1643220148,197601,true,2622567437,28,2608444446,-14122991
1643220224,197602,true,2622305207,28,2606619265,-15685942
1643220333,197603,true,2622043003,28,2604274480,-17768523
1643220794,197603,true,2622043003,28,2593619345,-28423658
1643220846,197603,true,2622043003,28,2592582157,-29460846
1643221299,197603,true,2622043003,28,2584816453,-37226550
1643221351,197604,true,2621780825,28,2584041163,-37739662
1643221389,197605,true,2621518673,28,2583266106,-38252567
1643221424,197605,true,2621518673,28,2582749530,-38769143
1643221715,197606,true,2621256547,28,2577847210,-43409337
1643222134,197607,true,2620994448,28,2574240929,-46753519
1643222147,197610,true,2620208306,28,2574240929,-45967377
1643222194,197610,true,2620208306,28,2574240929,-45967377
1643222986,197613,true,2619422401,28,2572182463,-47239938
1643223160,197614,true,2619160485,28,2571410962,-47749523
1643223170,197618,true,2618113083,28,2571410962,-46702121
1643223185,197619,true,2617851298,28,2571668103,-46183195
1643223208,197621,true,2617327806,28,2571925270,-45402536
1643223240,197620,true,2617589539,28,2572439681,-45149858
1643223256,197623,true,2616804419,28,2572954195,-43850224
1643223380,197622,true,2617066099,28,2576043438,-41022661
1643223422,197624,true,2616542765,28,2576816329,-39726436
1643223580,197623,true,2616804419,28,2579136391,-37668028
1643223603,197626,true,2616019535,28,2579394305,-36625230
1643223619,197626,true,2616019535,28,2579910210,-36109325
1643223621,197627,true,2615757959,28,2579910210,-35847749
1643223634,197624,true,2616542765,28,2580426217,-36116548
1643223651,197625,true,2616281136,28,2580942328,-35338808
1643223701,197625,true,2616281136,28,2582491281,-33789855
1643223727,197627,true,2615757959,28,2583524433,-32233526
1643223737,197624,true,2616542765,28,2583782785,-32759980
1643223753,197625,true,2616281136,28,2584557997,-31723139
1643223754,197624,true,2616542765,28,2584557997,-31984768
1643223795,197623,true,2616804419,28,2586885030,-29919389
1643223893,197618,true,2618113083,28,2592582157,-25530926
1643223904,197618,true,2618113083,28,2593360009,-24753074
1643223910,197618,true,2618113083,28,2593878707,-24234376
1643224000,197616,true,2618636732,28,2599851195,-18785537
1643224028,197611,true,2619946312,28,2601671637,-18274675
1643224050,197612,true,2619684343,28,2603493354,-16190989
1643224057,197611,true,2619946312,28,2604014079,-15932233
1643224084,197608,true,2620732374,28,2605837435,-14894939
1643224129,197604,true,2621780825,28,2609227057,-12553768
1643224165,197605,true,2621518673,28,2612098643,-9420030
1643224171,197604,true,2621780825,28,2612621088,-9159737
1643224212,197601,true,2622567437,28,2616019535,-6547902
1643224269,197596,true,2623878983,28,2620470327,-3408656
1643224274,197595,true,2624141371,28,2620732374,-3408997
1643224290,197594,true,2624403785,28,2622043003,-2360782
1643224309,197591,true,2625191185,28,2623354286,-1836899
1643224325,197588,true,2625978821,28,2624403785,-1575036
1643224336,197587,true,2626241419,28,2625191185,-1050234
1643224353,197587,true,2626241419,28,2626241419,0
1643224438,197586,true,2626504043,28,2631235771,4731728
1643224457,197583,true,2627292073,28,2632288424,4996351
1643224474,197584,true,2627029371,28,2633341497,6312126
1643224489,197584,true,2627029371,28,2633868192,6838821
1643224575,197586,true,2626504043,28,2637294275,10790232
1643224597,197583,true,2627292073,28,2638349351,11057278
1643224637,197584,true,2627029371,28,2639668790,12639419
1643224646,197584,true,2627029371,28,2639932757,12903386
1643224663,197586,true,2626504043,28,2640460770,13956727
1643224675,197584,true,2627029371,28,2640724816,13695445
1643224741,197586,true,2626504043,28,2642573878,16069835
1643224784,197586,true,2626504043,28,2643631066,17127023
1643224838,197589,true,2625716250,28,2644953146,19236896
1643225076,197586,true,2626504043,28,2648658488,22154445
1643225113,197587,true,2626241419,28,2648658488,22417069
1643225129,197587,true,2626241419,28,2648658488,22417069
1643225152,197588,true,2625978821,28,2648923354,22944533
1643225240,197583,true,2627292073,28,2651043235,23751162
1643225259,197582,true,2627554803,28,2651573470,24018667
1643225293,197582,true,2627554803,28,2652634258,25079455
1643225409,197583,true,2627292073,28,2656084753,28792680
1643225504,197578,true,2628605982,28,2656881658,28275676
1643225673,197578,true,2628605982,28,2653695471,25089489
1643225703,197577,true,2628868843,28,2652634258,23765415
1643225787,197579,true,2628343148,28,2649188246,20845098
1643225815,197574,true,2629657582,28,2647864049,18206467
1643225892,197576,true,2629131730,28,2644424235,15292505
1643225949,197574,true,2629657582,28,2642309647,12652065
1643226117,197575,true,2629394643,28,2636239621,6844978
1643226193,197570,true,2630709603,28,2634658431,3948828
1643226273,197571,true,2630446559,28,2632814908,2368349
1643226294,197570,true,2630709603,28,2632814908,2105305
1643226335,197572,true,2630183540,28,2632025221,1841681
1643226355,197567,true,2631498895,28,2631762045,263150
1643226395,197570,true,2630709603,28,2630972674,263071
1643226420,197570,true,2630709603,28,2630446559,-263044
1643226575,197573,true,2629920548,28,2628080340,-1840208
1643226590,197569,true,2630972674,28,2627817558,-3155116
1643226617,197573,true,2629920548,28,2627292073,-2628475
1643226636,197574,true,2629657582,28,2626766694,-2890888
1643226674,197580,true,2628080340,28,2625716250,-2364090
1643226705,197577,true,2628868843,28,2625191185,-3677658
1643226710,197581,true,2627817558,28,2624928692,-2888866
1643226719,197581,true,2627817558,28,2624928692,-2888866
1643226998,197586,true,2626504043,28,2619684343,-6819700
1643227034,197582,true,2627554803,28,2618374894,-9179909
1643227215,197587,true,2626241419,28,2611054064,-15187355
1643227239,197587,true,2626241419,28,2610270905,-15970514
1643227286,197593,true,2624666226,28,2607922835,-16743391
1643227363,197590,true,2625453704,28,2603753703,-21700001
1643227419,197596,true,2623878983,28,2600891292,-22987691
1643227465,197597,true,2623616622,28,2598291831,-25324791
1643227472,197603,true,2622043003,28,2597772250,-24270753
1643227798,197601,true,2622567437,28,2579394305,-43173132
1643227837,197607,true,2620994448,28,2576558673,-44435775
1643227880,197608,true,2620732374,28,2573726158,-47006216
1643227895,197613,true,2619422401,28,2572696925,-46725476
1643228060,197611,true,2619946312,28,2562427204,-57519108
1643228152,197617,true,2618374894,28,2557307727,-61067167
1643228188,197617,true,2618374894,28,2555518327,-62856567
1643228230,197622,true,2617066099,28,2553730180,-63335919
1643228242,197619,true,2617851298,28,2552964214,-64887084
1643228389,197626,true,2616019535,28,2545317180,-70702355
1643228396,197627,true,2615757959,28,2545062673,-70695286
1643228431,197633,true,2614189053,28,2543536170,-70652883
1643228592,197631,true,2614711917,28,2535410269,-79301648
1643228643,197639,true,2612621088,28,2532369753,-80251335
1643228665,197640,true,2612359853,28,2531103948,-81255905
1643228702,197645,true,2611054064,28,2528827093,-82226971
1643228829,197644,true,2611315170,28,2521252359,-90062811
1643228862,197652,true,2609227057,28,2519488188,-89738869
1643228868,197653,true,2608966161,28,2519236264,-89729897
1643228889,197657,true,2607922835,28,2518228821,-89694014
1643228913,197654,true,2608705290,28,2517473504,-91231786
1643228977,197660,true,2607140615,28,2514957414,-92183201
1643229296,197660,true,2607140615,28,2509932777,-97207838
1643229299,197665,true,2605837435,28,2509932777,-95904658
1643229310,197665,true,2605837435,28,2509681809,-96155626
1643229383,197673,true,2603753703,28,2508427344,-95326359
1643229451,197676,true,2602972733,28,2507424224,-95548509
1643229618,197681,true,2601671637,28,2505168670,-96502967
1643229664,197680,true,2601931804,28,2504918179,-97013625
1643229702,197687,true,2600111181,28,2504667712,-95443469
1643230114,197689,true,2599591236,28,2503415753,-96175483
1643230175,197693,true,2598551660,28,2503666095,-94885565
1643230437,197695,true,2598032027,28,2505920296,-92111731
1643230505,197704,true,2595694967,28,2507173507,-88521460
1643230855,197706,true,2595175906,28,2510183770,-84992136
1643230982,197710,true,2594138095,28,2510183770,-83954325
1643231323,197710,true,2594138095,28,2514454498,-79683597
1643231789,197719,true,2591804538,28,2517473504,-74331034
1643231810,197722,true,2591027152,28,2517473504,-73553648
1643231844,197729,true,2589214158,28,2517473504,-71740654
1643232019,197732,true,2588437549,28,2517725251,-70712298
1643232047,197743,true,2585591976,28,2517725251,-67866725
1643232095,197746,true,2584816453,28,2517725251,-67091202
1643232105,197754,true,2582749530,28,2517725251,-65024279
1643232206,197759,true,2581458543,28,2517221782,-64236761
1643232406,197770,true,2578620641,28,2515460431,-63160210
1643232458,197774,true,2577589451,28,2514705944,-62883507
1643232565,197783,true,2575270780,28,2512946354,-62324426
1643232602,197788,true,2573983531,28,2512695084,-61288447
1643232688,197800,true,2570896757,28,2511439113,-59457644
1643232774,197804,true,2569868656,28,2509932777,-59935879
1643232855,197814,true,2567300200,28,2507925734,-59374466
1643233009,197821,true,2565503808,28,2502915145,-62588663
1643233023,197833,true,2562427204,28,2502664879,-59762325
1643233112,197837,true,2561402489,28,2499663632,-61738857
1643233121,197847,true,2558842495,28,2499413691,-59428804
1643233167,197853,true,2557307727,28,2497914567,-59393160
1643233200,197865,true,2554240951,28,2496665985,-57574966
1643233463,197870,true,2552964214,28,2486451120,-66513094
1643233510,197879,true,2550667694,28,2484711300,-65956394
1643233522,197884,true,2549392743,28,2484214432,-65178311
1643233559,197896,true,2546335459,28,2482724425,-63611034
1643233597,197901,true,2545062673,28,2481235312,-63827361
1643233630,197907,true,2543536170,28,2479995066,-63541104
1643233667,197912,true,2542264783,28,2478507590,-63757193
1643233701,197924,true,2539216048,28,2477021006,-62195042
1643233803,197929,true,2537946821,28,2473061139,-64885682
1643233857,197934,true,2536678228,28,2470836496,-65841732
1643234019,197939,true,2535410269,28,2465160386,-70249883
1643234049,197950,true,2532622990,28,2464174568,-68448422
1643234296,197955,true,2531357059,28,2455319930,-76037129
1643234324,197960,true,2530091760,28,2454583482,-75508278
1643234326,197965,true,2528827093,28,2454338048,-74489045
1643234401,197976,true,2526047052,28,2451639895,-74407157
1643234411,197982,true,2524531954,28,2451149641,-73382313
1643234841,197989,true,2522765488,28,2436000282,-86765206
1643234893,197997,true,2520748184,28,2434295764,-86452420
1643235070,198009,true,2517725251,28,2430161183,-87564068
1643235499,198015,true,2516215145,28,2421913077,-94302068
1643235555,198022,true,2514454498,28,2421186649,-93267849
1643235603,198030,true,2512443840,28,2420702484,-91741356
1643236367,198040,true,2509932777,28,2419250571,-90682206
1643236402,198046,true,2508427344,28,2419492496,-88934848
1643236424,198052,true,2506922815,28,2419492496,-87430319
1643236549,198059,true,2505168670,28,2419976418,-85192252
1643236571,198068,true,2502915145,28,2420218416,-82696729
1643236615,198074,true,2501413922,28,2420460438,-80953484
1643236845,198081,true,2499663632,28,2422155268,-77508364
1643237192,198088,true,2497914567,28,2424820972,-73093595
1643237199,198098,true,2495418026,28,2425063454,-70354572
1643237640,198104,true,2493921299,28,2427489609,-66431690
1643238370,198110,true,2492425470,28,2432835697,-59589773
1643238589,198116,true,2490930538,28,2434052358,-56878180
1643238696,198124,true,2488938690,28,2435026125,-53912565
1643239089,198128,true,2487943363,28,2441853411,-46089952
1643239587,198129,true,2487694594,28,2450169426,-37525168
1643239659,198135,true,2486202499,28,2451394756,-34807743
1643239930,198142,true,2484462854,28,2455565462,-28897392
1643240398,198144,true,2483966036,28,2464420986,-19545050
1643240472,198144,true,2483966036,28,2465406902,-18559134
1643241432,198149,true,2482724425,28,2470589437,-12134988
1643241561,198155,true,2481235312,28,2471083580,-10151732
1643241705,198159,true,2480243066,28,2471083580,-9159486
1643241731,198160,true,2479995066,28,2470836496,-9158570
1643241884,198166,true,2478507590,28,2469848409,-8659181
1643242008,198173,true,2476773328,28,2469107602,-7665726
1643242037,198177,true,2475782866,28,2468860716,-6922150
1643242158,198177,true,2475782866,28,2468860716,-6922150
1643242236,198181,true,2474792801,28,2468860716,-5932085
1643242574,198183,true,2474297917,28,2469848409,-4449508
1643242626,198186,true,2473555776,28,2470095393,-3460383
1643242788,198185,true,2473803131,28,2471577821,-2225310
1643243583,198187,true,2473308445,28,2479499141,6190696
1643243613,198189,true,2472813857,28,2479995066,7181209
1643244063,198192,true,2472072161,28,2483717664,11645503
1643244162,198191,true,2472319369,28,2483717664,11398295
1643245371,198193,true,2471824979,28,2484214432,12389453
1643245385,198195,true,2471330688,28,2483966036,12635348
1643245467,198198,true,2470589437,28,2483966036,13376599
1643245560,198196,true,2471083580,28,2483966036,12882456
1643245615,198199,true,2470342403,28,2483717664,13375261
1643245648,198199,true,2470342403,28,2483717664,13375261
1643245658,198201,true,2469848409,28,2483469317,13620908
1643245719,198200,true,2470095393,28,2483220995,13125602
1643245950,198203,true,2469354513,28,2480243066,10888553
1643246177,198203,true,2469354513,28,2476773328,7418815
1643246343,198205,true,2468860716,28,2474297917,5437201
1643246410,198204,true,2469107602,28,2473061139,3953537
1643246596,198207,true,2468367018,28,2469107602,740584
1643246975,198207,true,2468367018,28,2461219480,-7147538
1643247064,198210,true,2467626656,28,2459005490,-8621166
1643247093,198210,true,2467626656,28,2458267935,-9358721
1643247110,198214,true,2466639852,28,2457776356,-8863496
1643247232,198219,true,2465406902,28,2453847254,-11559648
1643247421,198224,true,2464174568,28,2447965376,-16209192
1643247461,198223,true,2464420986,28,2446741760,-17679226
1643247850,198229,true,2462942851,28,2436974828,-25968023
1643247939,198233,true,2461957920,28,2434782647,-27175273
1643248231,198236,true,2461219480,28,2428703597,-32515883
1643248367,198235,true,2461465602,28,2426518856,-34946746
1643248393,198241,true,2459989239,28,2426033625,-33955614
1643248408,198245,true,2459005490,28,2425791046,-33214444
1643248435,198249,true,2458022133,28,2425305960,-32716173
1643248447,198250,true,2457776356,28,2425063454,-32712902
1643248480,198255,true,2456547836,28,2424336080,-32211756
1643248558,198260,true,2455319930,28,2422155268,-33164662
1643248566,198265,true,2454092639,28,2421913077,-32179562
1643248591,198266,true,2453847254,28,2421428767,-32418487
1643248824,198273,true,2452130248,28,2414900054,-37230194
1643248852,198278,true,2450904550,28,2414175729,-36728821
1643249051,198284,true,2449434522,28,2409834338,-39600184
1643249151,198285,true,2449189603,28,2408148128,-41041475
1643249249,198292,true,2447475856,28,2406222476,-41253380
1643249322,198296,true,2446497110,28,2405019726,-41477384
1643249802,198302,true,2445029726,28,2396856952,-48172774
1643250210,198303,true,2444785247,28,2388721882,-56063365
1643250239,198309,true,2443318889,28,2388244209,-55074680
1643250279,198313,true,2442341806,28,2387527879,-54813927
1643250282,198318,true,2441121001,28,2387527879,-53593122
1643250420,198321,true,2440388812,28,2385141664,-55247148
1643250524,198327,true,2438925091,28,2383472733,-55452358
1643250707,198331,true,2437949764,28,2381090570,-56859194
1643250967,198336,true,2436731155,28,2377997318,-58733837
1643251222,198339,true,2436000282,28,2375383090,-60617192
1643251272,198344,true,2434782647,28,2375145575,-59637072
1643251285,198347,true,2434052358,28,2374908085,-59144273
1643251455,198351,true,2433078981,28,2373720987,-59357994
1643251468,198353,true,2432592438,28,2373720987,-58871451
1643251560,198358,true,2431376507,28,2373246314,-58130193
1643251719,198360,true,2430890304,28,2373009013,-57881291
1643252079,198362,true,2430404199,28,2372771736,-57632463
1643252514,198364,true,2429918191,28,2376095776,-53822415
1643252732,198368,true,2428946467,28,2378948660,-49997807
1643253854,198369,true,2428703597,28,2393743218,-34960379
1643253931,198371,true,2428217929,28,2394461412,-33756517
1643254682,198372,true,2427975131,28,2398535255,-29439876
1643254712,198375,true,2427246884,28,2398535255,-28711629
1643254725,198376,true,2427004184,28,2398535255,-28468929
1643254813,198377,true,2426761508,28,2398295425,-28466083
1643254833,198378,true,2426518856,28,2398295425,-28223431
1643254913,198382,true,2425548491,28,2397336347,-28212144
1643254961,198383,true,2425305960,28,2396856952,-28449008
1643255039,198385,true,2424820972,28,2395658883,-29162089
1643255061,198387,true,2424336080,28,2395179823,-29156257
1643255064,198391,true,2423366588,28,2395179823,-28186765
1643255381,198392,true,2423124276,28,2388960754,-34163522
1643255638,198394,true,2422639724,28,2383949451,-38690273
1643256500,198394,true,2422639724,28,2368741652,-53898072
1643256553,198398,true,2421670910,28,2368031171,-53639739
1643256601,198400,true,2421186649,28,2367557636,-53629013
1643256605,198401,true,2420944554,28,2367557636,-53386918
1643256685,198400,true,2421186649,28,2367557636,-53629013
1643256967,198402,true,2420702484,28,2371111460,-49591024
1643256983,198404,true,2420218416,28,2371348571,-48869845
1643257032,198406,true,2419734445,28,2371822864,-47911581
1643257103,198405,true,2419976418,28,2372297253,-47679165
1643257169,198409,true,2419008670,28,2373009013,-45999657
1643257382,198410,true,2418766793,28,2375858190,-42908603
1643258014,198414,true,2417799528,28,2377759542,-40039986
1643258232,198412,true,2418283112,28,2379186555,-39096557
1643258341,198416,true,2417316041,28,2379900382,-37415659
1643258776,198418,true,2416832650,28,2378472942,-38359708
1643259023,198421,true,2416107745,28,2378948660,-37159085
1643259221,198420,true,2416349356,28,2379424473,-36924883
1643259279,198424,true,2415383058,28,2379900382,-35482676
1643259498,198425,true,2415141544,28,2381804969,-33336575
1643259621,198429,true,2414175729,28,2382757834,-31417895
1643259855,198430,true,2413934335,28,2385141664,-28792671
1643259897,198434,true,2412969003,28,2385380178,-27588825
1643259942,198436,true,2412486481,28,2385857278,-26629203
1643259957,198440,true,2411521728,28,2386095864,-25425864
1643259995,198441,true,2411280600,28,2386573107,-24707493
1643260480,198445,true,2410316329,28,2392068267,-18248062
1643260543,198446,true,2410075321,28,2392546705,-17528616
1643260688,198450,true,2409111532,28,2393743218,-15368314
1643261836,198451,true,2408870645,28,2398295425,-10575220
1643262044,198455,true,2407907337,28,2397096637,-10810700
1643262083,198456,true,2407666571,28,2396856952,-10809619
1643262605,198460,true,2406703745,28,2393743218,-12960527
1643263533,198462,true,2406222476,28,2390155474,-16067002
1643264000,198466,true,2405260228,28,2387766632,-17493596
1643264478,198469,true,2404538794,28,2386095864,-18442930
1643265516,198473,true,2403577219,28,2382757834,-20819385
1643265624,198476,true,2402856290,28,2382996110,-19860180
1643265690,198481,true,2401655222,28,2383234409,-18420813
1643266016,198484,true,2400934870,28,2384664707,-16270163
1643266127,198487,true,2400214733,28,2385141664,-15073069
1643266153,198490,true,2399494813,28,2385380178,-14114635
1643266321,198495,true,2398295425,28,2386573107,-11722318
1643266817,198497,true,2397815838,28,2389916482,-7899356
1643267189,198500,true,2397096637,28,2392785960,-4310677
1643267239,198503,true,2396377652,28,2393025238,-3352414
1643267250,198507,true,2395419341,28,2393264541,-2154800
1643267500,198509,true,2394940329,28,2394700859,-239470
1643267935,198512,true,2394221990,28,2395658883,1436893
1643268004,198514,true,2393743218,28,2395898448,2155230
1643268300,198516,true,2393264541,28,2397096637,3832096
1643268326,198518,true,2392785960,28,2397096637,4310677
1643269735,198519,true,2392546705,28,2409593378,17046673
1643270385,198521,true,2392068267,28,2411762880,19694613
1643270409,198522,true,2391829085,28,2411762880,19933795
1643270459,198523,true,2391589926,28,2411762880,20172954
1643270519,198525,true,2391111679,28,2411762880,20651201
1643270548,198526,true,2390872592,28,2411762880,20890288
1643270820,198528,true,2390394489,28,2411039496,20645007
1643270910,198527,true,2390633529,28,2410557360,19923831
1643271019,198528,true,2390394489,28,2410316329,19921840
1643271234,198529,true,2390155474,28,2409352443,19196969
1643272489,198530,true,2389916482,28,2406463099,16546617
1643272498,198529,true,2390155474,28,2406463099,16307625
1643272520,198529,true,2390155474,28,2406463099,16307625
1643272530,198530,true,2389916482,28,2406463099,16546617
1643272646,198533,true,2389199650,28,2405500754,16301104
1643272689,198532,true,2389438570,28,2405260228,15821658
1643273021,198532,true,2389438570,28,2404298364,14859794
1643273049,198532,true,2389438570,28,2404298364,14859794
1643273067,198534,true,2388960754,28,2404538794,15578040
1643273092,198532,true,2389438570,28,2404538794,15100224
1643273139,198531,true,2389677514,28,2404779248,15101734
1643273198,198530,true,2389916482,28,2405019726,15103244
1643273548,198531,true,2389677514,28,2408629782,18952268
1643273842,198528,true,2390394489,28,2411521728,21127239
1643273937,198526,true,2390872592,28,2412486481,21613889
1643274574,198525,true,2391111679,28,2425063454,33951775
1643274726,198524,true,2391350790,28,2427975131,36624341
1643274754,198521,true,2392068267,28,2428460750,36392483
1643275438,198518,true,2392785960,28,2433808978,41023018
1643275514,198517,true,2393025238,28,2434295764,41270526
1643275557,198517,true,2393025238,28,2434539193,41513955
1643275679,198514,true,2393743218,28,2435513155,41769937
1643275700,198510,true,2394700859,28,2435513155,40812296
1643276766,198507,true,2395419341,28,2437218526,41799185
1643276941,198506,true,2395658883,28,2437705994,42047111
1643277977,198503,true,2396377652,28,2440388812,44011160
1643278321,198500,true,2397096637,28,2441365114,44268477
1643279496,198496,true,2398055620,28,2443563221,45507601
1643279536,198495,true,2398295425,28,2443563221,45267796
1643279594,198492,true,2399014986,28,2443563221,44548235
1643279613,198489,true,2399734762,28,2443563221,43828459
1643279620,198486,true,2400454755,28,2443563221,43108466
1643279629,198485,true,2400694800,28,2443563221,42868421
1643279690,198483,true,2401174963,28,2443563221,42388258
1643279763,198480,true,2401895388,28,2443318889,41423501
1643280007,198477,true,2402616028,28,2442341806,39725778
1643280071,198477,true,2402616028,28,2441853411,39237383
1643280203,198476,true,2402856290,28,2441121001,38264711
1643280624,198474,true,2403336885,28,2438193559,34856674
1643280970,198473,true,2403577219,28,2435269628,31692409
1643281116,198473,true,2403577219,28,2433808978,30231759
1643281363,198472,true,2403817577,28,2431619644,27802067
1643281422,198470,true,2404298364,28,2431133393,26835029
1643281799,198468,true,2404779248,28,2429189362,24410114
1643281924,198467,true,2405019726,28,2428703597,23683871
1643282054,198465,true,2405500754,28,2428460750,22959996
1643282117,198462,true,2406222476,28,2428460750,22238274
1643282778,198459,true,2406944415,28,2430890304,23945889
1643283243,198457,true,2407425828,28,2434539193,27113365
1643283262,198455,true,2407907337,28,2434782647,26875310
1643283304,198451,true,2408870645,28,2435269628,26398983
1643283413,198447,true,2409834338,28,2436731155,26896817
1643283620,198445,true,2410316329,28,2439656841,29340512
1643284797,198442,true,2411039496,28,2449434522,38395026
1643284883,198439,true,2411762880,28,2449924434,38161554
1643285696,198436,true,2412486481,28,2454338048,41851567
1643285775,198435,true,2412727730,28,2454828940,42101210
1643286249,198432,true,2413451621,28,2458022133,44570512
1643286405,198428,true,2414417146,28,2458759614,44342468
1643286446,198425,true,2415141544,28,2459005490,43863946
1643286766,198423,true,2415624596,28,2459497315,43872719
1643286818,198421,true,2416107745,28,2459497315,43389570
1643286933,198417,true,2417074333,28,2459251390,42177057
1643286974,198414,true,2417799528,28,2459005490,41205962
1643286980,198412,true,2418283112,28,2459005490,40722378
1643287089,198410,true,2418766793,28,2458513762,39746969
1643287243,198406,true,2419734445,28,2458022133,38287688
1643287898,198404,true,2420218416,28,2454583482,34365066
1643287955,198402,true,2420702484,28,2454338048,33635564
1643288028,198400,true,2421186649,28,2454092639,32905990
1643288197,198397,true,2421913077,28,2453847254,31934177
1643288706,198393,true,2422881988,28,2454583482,31701494
1643288782,198392,true,2423124276,28,2455074423,31950147
1643288882,198390,true,2423608925,28,2455811019,32202094
1643288981,198386,true,2424578514,28,2456547836,31969322
1643289667,198383,true,2425305960,28,2463928175,38622215
1643290615,198381,true,2425791046,28,2470836496,45045450
1643290632,198380,true,2426033625,28,2470836496,44802871
1643290652,198376,true,2427004184,28,2470836496,43832312
1643291031,198372,true,2427975131,28,2469848409,41873278
1643291074,198371,true,2428217929,28,2469848409,41630480
1643291109,198370,true,2428460750,28,2469848409,41387659
1643291187,198365,true,2429675224,28,2470095393,40420169
1643291202,198360,true,2430890304,28,2470342403,39452099
1643291263,198358,true,2431376507,28,2470589437,39212930
1643291534,198355,true,2432105993,28,2472813857,40707864
1643292056,198351,true,2433078981,28,2477021006,43942025
1643292775,198344,true,2434782647,28,2484214432,49431785
1643292839,198343,true,2435026125,28,2485208267,50182142
1643293059,198340,true,2435756706,28,2487445849,51689143
1643293098,198336,true,2436731155,28,2487694594,50963439
1643293165,198329,true,2438437379,28,2488192158,49754779
1643293503,198327,true,2438925091,28,2491179631,52254540
1643293613,198325,true,2439412900,28,2492176252,52763352
1643293897,198321,true,2440388812,28,2494669550,54280738
1643293995,198314,true,2442097596,28,2495168509,53070913
1643294034,198312,true,2442586040,28,2495667568,53081528
1643294098,198309,true,2443318889,28,2496665985,53347096
1643294148,198305,true,2444296364,28,2496915651,52619287
1643294179,198298,true,2446007884,28,2497165343,51157459
1643294276,198297,true,2446252485,28,2497664801,51412316
1643294297,198295,true,2446741760,28,2497664801,50923041
1643294449,198293,true,2447231133,28,2497664801,50433668
1643294554,198286,true,2448944709,28,2498164359,49219650
1643294612,198285,true,2449189603,28,2498414175,49224572
1643295385,198282,true,2449924434,28,2500663648,50739214
1643295416,198280,true,2450414443,28,2500663648,50249205
1643295622,198272,true,2452375461,28,2500413606,48038145
1643295667,198271,true,2452620698,28,2500163590,47542892
1643295882,198269,true,2453111247,28,2498913883,45802636
1643296134,198267,true,2453601894,28,2499163775,45561881
1643296210,198259,true,2455565462,28,2499663632,44098170
1643296281,198258,true,2455811019,28,2500413606,44602587
1643296304,198255,true,2456547836,28,2500663648,44115812
1643296308,198252,true,2457284874,28,2500663648,43378774
1643296338,198244,true,2459251390,28,2501163805,41912415
1643296347,198240,true,2460235238,28,2501413922,41178684
1643296357,198237,true,2460973383,28,2501413922,40440539
1643296435,198234,true,2461711748,28,2502414637,40702889
1643296518,198226,true,2463681807,28,2503165437,39483630
1643296669,198222,true,2464667428,28,2504417270,39749842
1643296835,198220,true,2465160386,28,2505419187,40258801
1643296867,198219,true,2465406902,28,2505419187,40012285
1643297087,198212,true,2467133205,28,2505669729,38536524
1643297130,198210,true,2467626656,28,2505920296,38293640
1643297137,198208,true,2468120206,28,2505920296,37800090
1643297198,198207,true,2468367018,28,2505669729,37302711
1643297210,198202,true,2469601448,28,2505669729,36068281
1643297232,198200,true,2470095393,28,2505669729,35574336
1643297350,198199,true,2470342403,28,2505419187,35076784
1643297392,198199,true,2470342403,28,2505419187,35076784
1643297433,198193,true,2471824979,28,2505419187,33594208
1643297467,198192,true,2472072161,28,2505168670,33096509
1643298534,198192,true,2472072161,28,2490183408,18111247
1643298549,198192,true,2472072161,28,2489934415,17862254
1643298567,198187,true,2473308445,28,2489685446,16377001
1643298786,198185,true,2473803131,28,2485456788,11653657
1643298813,198187,true,2473308445,28,2484959771,11651326
1643299051,198187,true,2473308445,28,2480491090,7182645
1643299068,198182,true,2474545346,28,2480243066,5697720
1643299084,198181,true,2474792801,28,2480243066,5450265
1643299125,198183,true,2474297917,28,2479499141,5201224
1643299218,198183,true,2474297917,28,2478755440,4457523
1643299220,198178,true,2475535313,28,2478507590,2972277
1643299644,198176,true,2476030445,28,2477516434,1485989
1643299671,198177,true,2475782866,28,2477268708,1485842
1643299719,198177,true,2475782866,28,2477021006,1238140
1643299987,198173,true,2476773328,28,2474050511,-2722817
1643300829,198172,true,2477021006,28,2468120206,-8900800
1643301036,198173,true,2476773328,28,2466886516,-9886812
1643301092,198173,true,2476773328,28,2466393213,-10380115
1643301111,198168,true,2478011963,28,2466393213,-11618750
1643301191,198167,true,2478259764,28,2466146598,-12113166
1643301239,198167,true,2478259764,28,2466146598,-12113166
1643301259,198167,true,2478259764,28,2465900008,-12359756
1643301282,198161,true,2479747091,28,2466146598,-13600493
1643301797,198159,true,2480243066,28,2470589437,-9653629
1643302205,198159,true,2480243066,28,2475040280,-5202786
1643302313,198158,true,2480491090,28,2476030445,-4460645
1643302944,198154,true,2481483435,28,2480491090,-992345
1643303402,198153,true,2481731584,28,2479499141,-2232443
1643303440,198153,true,2481731584,28,2479251216,-2480368
1643303580,198153,true,2481731584,28,2478011963,-3719621
1643303788,198150,true,2482476177,28,2475535313,-6940864
1643303847,198151,true,2482227955,28,2474792801,-7435154
1643304018,198152,true,2481979757,28,2472319369,-9660388
1643304357,198152,true,2481979757,28,2467379918,-14599839
1643304436,198150,true,2482476177,28,2466393213,-16082964
1643304469,198151,true,2482227955,28,2466146598,-16081357
1643304560,198152,true,2481979757,28,2465653443,-16326314
1643304733,198152,true,2481979757,28,2464420986,-17558771
1643304780,198150,true,2482476177,28,2463928175,-18548002
1643304862,198151,true,2482227955,28,2463189145,-19038810
1643304943,198152,true,2481979757,28,2462450336,-19529421
1643305120,198152,true,2481979757,28,2459989239,-21990518
1643305255,198150,true,2482476177,28,2458022133,-24454044
1643306040,198152,true,2481979757,28,2451639895,-30339862
1643306097,198153,true,2481731584,28,2451394756,-30336828
1643306137,198153,true,2481731584,28,2450904550,-30827034
1643306173,198151,true,2482227955,28,2450904550,-31323405
1643306683,198152,true,2481979757,28,2446986434,-34993323
1643306731,198153,true,2481731584,28,2446497110,-35234474
1643306848,198154,true,2481483435,28,2445763308,-35720127
1643307014,198153,true,2481731584,28,2444540793,-37190791
1643307085,198155,true,2481235312,28,2444051958,-37183354
1643307321,198157,true,2480739139,28,2442341806,-38397333
1643307549,198158,true,2480491090,28,2441365114,-39125976
1643307714,198158,true,2480491090,28,2440632851,-39858239
1643307733,198161,true,2479747091,28,2440632851,-39114240
1643307740,198162,true,2479499141,28,2440632851,-38866290
1643307796,198163,true,2479251216,28,2440388812,-38862404
1643307871,198164,true,2479003316,28,2439900807,-39102509
1643307885,198165,true,2478755440,28,2439656841,-39098599
1643308153,198167,true,2478259764,28,2436487506,-41772258
1643308676,198169,true,2477764186,28,2430404199,-47359987
1643308869,198171,true,2477268708,28,2429189362,-48079346
1643309121,198173,true,2476773328,28,2428217929,-48555399
1643309247,198176,true,2476030445,28,2427004184,-49026261
1643309410,198178,true,2475535313,28,2425305960,-50229353
1643309787,198180,true,2475040280,28,2422881988,-52158292
1643309835,198183,true,2474297917,28,2422881988,-51415929
1643310076,198186,true,2473555776,28,2423851286,-49704490
1643310098,198187,true,2473308445,28,2423851286,-49457159
1643310148,198190,true,2472566601,28,2424336080,-48230521
1643310177,198193,true,2471824979,28,2424578514,-47246465
1643310909,198194,true,2471577821,28,2430647240,-40930581
1643311294,198197,true,2470836496,28,2433565621,-37270875
1643311344,198199,true,2470342403,28,2434052358,-36290045
1643311350,198202,true,2469601448,28,2434052358,-35549090
1643311387,198204,true,2469107602,28,2434295764,-34811838
1643311457,198207,true,2468367018,28,2434539193,-33827825
1643311555,198211,true,2467379918,28,2434295764,-33084154
1643311565,198213,true,2466886516,28,2434295764,-32590752
1643311602,198215,true,2466393213,28,2434295764,-32097449
1643311733,198218,true,2465653443,28,2433322289,-32331154
1643312006,198222,true,2464667428,28,2430161183,-34506245
1643312064,198224,true,2464174568,28,2429189362,-34985206
1643312091,198228,true,2463189145,28,2428703597,-34485548
1643312115,198231,true,2462450336,28,2428217929,-34232407
1643312634,198237,true,2460973383,28,2416349356,-44624027
1643312730,198239,true,2460481262,28,2414417146,-46064116
1643313218,198242,true,2459743265,28,2407185110,-52558155
1643313277,198245,true,2459005490,28,2406703745,-52301745
1643313881,198250,true,2457776356,28,2402135577,-55640779
1643314056,198253,true,2457039170,28,2402375791,-54663379
1643314105,198256,true,2456302206,28,2402375791,-53926415
1643314153,198260,true,2455319930,28,2402616028,-52703902
1643314224,198266,true,2453847254,28,2402856290,-50990964
1643314420,198269,true,2453111247,28,2403817577,-49293670
1643314434,198273,true,2452130248,28,2403817577,-48312671
1643314460,198277,true,2451149641,28,2403817577,-47332064
1643314478,198283,true,2449679466,28,2403817577,-45861889
1643314888,198289,true,2448210172,28,2399014986,-49195186
1643314976,198292,true,2447475856,28,2397815838,-49660018
1643315007,198296,true,2446497110,28,2397336347,-49160763
1643315478,198302,true,2445029726,28,2391111679,-53918047
1643315517,198308,true,2443563221,28,2390633529,-52929692
1643315813,198312,true,2442586040,28,2385380178,-57205862
1643315873,198315,true,2441853411,28,2384187846,-57665565
1643315896,198322,true,2440144797,28,2383711080,-56433717
1643315937,198328,true,2438681223,28,2382757834,-55923389
1643316132,198332,true,2437705994,28,2377284062,-60421932
1643316148,198336,true,2436731155,28,2376808676,-59922479
1643316229,198341,true,2435513155,28,2374908085,-60605070
1643316312,198347,true,2434052358,28,2373958359,-60093999
1643316632,198348,true,2433808978,28,2371348571,-62460407
1643316881,198352,true,2432835697,28,2370163252,-62672445
1643316909,198358,true,2431376507,28,2369926260,-61450247
1643316946,198363,true,2430161183,28,2369689291,-60471892
1643317019,198364,true,2429918191,28,2369215424,-60702767
1643317097,198368,true,2428946467,28,2368267975,-60678492
1643317124,198374,true,2427489609,28,2368031171,-59458438
1643317180,198380,true,2426033625,28,2367084196,-58949429
1643317184,198381,true,2425791046,28,2367084196,-58706850
1643317238,198386,true,2424578514,28,2366137599,-58440915
1643317311,198393,true,2422881988,28,2364954885,-57927103
1643317374,198400,true,2421186649,28,2363772762,-57413887
1643317721,198402,true,2420702484,28,2357871005,-62831479
1643317778,198407,true,2419492496,28,2356692423,-62800073
1643318090,198414,true,2417799528,28,2350808345,-66991183
1643318098,198419,true,2416590991,28,2350808345,-65782646
1643318110,198422,true,2415866159,28,2350573287,-65292872
1643318231,198427,true,2414658588,28,2347284952,-67373636
1643318238,198434,true,2412969003,28,2347050247,-65918756
1643318373,198440,true,2411521728,28,2343298156,-68223572
1643318504,198444,true,2410557360,28,2339552064,-71005296
1643318577,198450,true,2409111532,28,2337447520,-71664012
1643318590,198457,true,2407425828,28,2337213798,-70212030
1643318659,198464,true,2405741304,28,2335578403,-70162901
1643318757,198467,true,2405019726,28,2333710781,-71308945
1643318784,198472,true,2403817577,28,2333010808,-70806769
1643318789,198479,true,2402135577,28,2333010808,-69124769
1643318995,198486,true,2400454755,28,2330213013,-70241742
1643319022,198489,true,2399734762,28,2330213013,-69521749
1643319049,198494,true,2398535255,28,2329980015,-68555240
1643319126,198500,true,2397096637,28,2329514089,-67582548
1643319194,198506,true,2395658883,28,2329048256,-66610627
1643319579,198508,true,2395179823,28,2328582517,-66597306
1643319629,198512,true,2394221990,28,2329048256,-65173734
1643319687,198518,true,2392785960,28,2329048256,-63737704
1643319881,198524,true,2391350790,28,2329980015,-61370775
1643319932,198526,true,2390872592,28,2330446035,-60426557
1643319991,198531,true,2389677514,28,2330912147,-58765367
1643320019,198537,true,2388244209,28,2331145238,-57098971
1643320051,198542,true,2387050445,28,2331611491,-55438954
1643320104,198543,true,2386811764,28,2332544275,-54267489
1643320151,198546,true,2386095864,28,2333710781,-52385083
1643320255,198551,true,2384903174,28,2336045542,-48857632
1643320567,198555,true,2383949451,28,2342126859,-41822592
1643320840,198555,true,2383949451,28,2346815565,-37133886
1643321111,198559,true,2382996110,28,2350573287,-32422823
1643321666,198564,true,2381804969,28,2354337027,-27467942
1643321676,198569,true,2380614424,28,2354337027,-26277397
1643321745,198570,true,2380376386,28,2354337027,-26039359
1643321975,198574,true,2379424473,28,2352454404,-26970069
1643322076,198580,true,2377997318,28,2351278530,-26718788
1643322826,198583,true,2377284062,28,2344235616,-33048446
1643323058,198584,true,2377046357,28,2342595307,-34451050
1643323111,198588,true,2376095776,28,2342361071,-33734705
1643323201,198594,true,2374670618,28,2343063850,-31606768
1643323221,198596,true,2374195755,28,2343063850,-31131905
1643323375,198595,true,2374433174,28,2344938957,-29494217
1643323491,198599,true,2373483638,28,2346815565,-26668073
1643323521,198603,true,2372534482,28,2347284952,-25249530
1643323525,198606,true,2371822864,28,2347284952,-24537912
1643323580,198603,true,2372534482,28,2348928544,-23605938
1643323689,198604,true,2372297253,28,2352219182,-20078071
1643323974,198608,true,2371348571,28,2361174171,-10174400
1643324225,198610,true,2370874372,28,2368504801,-2369571
1643324230,198607,true,2371585706,28,2368504801,-3080905
1643324366,198608,true,2371348571,28,2372297253,948682
1643324390,198612,true,2370400268,28,2372771736,2371468
1643324698,198614,true,2369926260,28,2381090570,11164310
1643324817,198612,true,2370400268,28,2384664707,14264439
1643324853,198613,true,2370163252,28,2385857278,15694026
1643324918,198617,true,2369215424,28,2387766632,18551208
1643325129,198619,true,2368741652,28,2393025238,24283586
1643325206,198617,true,2369215424,28,2394700859,25485435
1643325508,198617,true,2369215424,28,2399734762,30519338
1643326214,198622,true,2368031171,28,2404538794,36507623
1643327157,198624,true,2367557636,28,2405981878,38424242
1643327356,198621,true,2368267975,28,2405500754,37232779
1643327602,198620,true,2368504801,28,2406222476,37717675
1643327639,198624,true,2367557636,28,2406222476,38664840
1643327772,198625,true,2367320904,28,2407425828,40104924
1643327987,198621,true,2368267975,28,2409352443,41084468
1643328281,198620,true,2368504801,28,2412727730,44222929
1643328326,198623,true,2367794392,28,2413451621,45657229
1643328366,198623,true,2367794392,28,2414175729,46381337
1643328576,198619,true,2368741652,28,2418283112,49541460
1643329005,198616,true,2369452345,28,2426518856,57066511
1643329020,198617,true,2369215424,28,2426761508,57546084
1643329061,198618,true,2368978526,28,2427489609,58511083
1643329241,198614,true,2369926260,28,2429675224,59748964
1643329348,198611,true,2370637308,28,2430890304,60252996
1643329550,198613,true,2370163252,28,2432592438,62429186
1643329875,198613,true,2370163252,28,2434052358,63889106
1643330016,198609,true,2371111460,28,2434295764,63184304
1643330690,198607,true,2371585706,28,2430404199,58818493
1643331517,198610,true,2370874372,28,2425305960,54431588
1643332019,198610,true,2370874372,28,2425063454,54189082
1643332320,198606,true,2371822864,28,2425791046,53968182
1643333302,198604,true,2372297253,28,2430161183,57863930
1643333312,198606,true,2371822864,28,2430161183,58338319
1643333408,198604,true,2372297253,28,2429918191,57620938
1643333414,198600,true,2373246314,28,2429918191,56671877
1643333451,198598,true,2373720987,28,2429675224,55954237
1643333469,198600,true,2373246314,28,2429675224,56428910
1643333544,198598,true,2373720987,28,2428946467,55225480
1643333640,198594,true,2374670618,28,2427975131,53304513
1643335305,198595,true,2374433174,28,2394700859,20267685
1643335430,198596,true,2374195755,28,2393982592,19786837
1643335464,198594,true,2374670618,28,2393743218,19072600
1643335475,198589,true,2375858190,28,2393743218,17885028
1643335572,198590,true,2375620628,28,2393025238,17404610
1643335675,198593,true,2374908085,28,2391829085,16921000
1643336207,198592,true,2375145575,28,2386334474,11188899
1643336561,198588,true,2376095776,28,2382281354,6185578
1643336910,198590,true,2375620628,28,2379186555,3565927
1643337264,198592,true,2375145575,28,2376333386,1187811
1643337913,198591,true,2375383090,28,2380138372,4755282
1643338236,198586,true,2376571019,28,2382519582,5948563
1643338527,198586,true,2376571019,28,2385380178,8809159
1643338712,198588,true,2376095776,28,2387527879,11432103
1643338754,198586,true,2376571019,28,2387766632,11195613
1643338842,198580,true,2377997318,28,2388483034,10485716
1643338946,198579,true,2378235118,28,2389677514,11442396
1643339000,198580,true,2377997318,28,2390155474,12158156
1643339033,198577,true,2378710789,28,2390633529,11922740
1643339054,198571,true,2380138372,28,2390872592,10734220
1643339103,198569,true,2380614424,28,2391589926,10975502
1643339171,198569,true,2380614424,28,2392546705,11932281
1643339208,198566,true,2381328679,28,2393025238,11696559
1643339509,198558,true,2383234409,28,2398055620,14821211
1643339525,198556,true,2383711080,28,2398295425,14584345
1643339560,198555,true,2383949451,28,2399254887,15305436
1643339614,198551,true,2384903174,28,2400694800,15791626
1643339627,198541,true,2387289151,28,2400934870,13645719
1643339628,198539,true,2387766632,28,2400934870,13168238
1643339645,198538,true,2388005409,28,2401655222,13649813
1643339743,198533,true,2389199650,28,2404538794,15339144
1643339858,198524,true,2391350790,28,2408388943,17038153
1643340373,198522,true,2391829085,28,2424336080,32506995
1643342470,198521,true,2392068267,28,2443807578,51739311
1643342520,198517,true,2393025238,28,2444051958,51026720
1643343453,198507,true,2395419341,28,2449924434,54505093
1643343584,198505,true,2395898448,28,2450659484,54761036
1643344095,198503,true,2396377652,28,2453111247,56733595
1643344109,198498,true,2397576081,28,2453111247,55535166
1643344162,198489,true,2399734762,28,2453356558,53621796
1643344402,198487,true,2400214733,28,2453601894,53387161
1643344455,198485,true,2400694800,28,2453356558,52661758
1643344518,198481,true,2401655222,28,2453111247,51456025
1643344581,198472,true,2403817577,28,2452865960,49048383
1643344593,198470,true,2404298364,28,2452865960,48567596
1643344885,198469,true,2404538794,28,2451639895,47101101
1643345024,198465,true,2405500754,28,2450904550,45403796
1643345240,198457,true,2407425828,28,2449924434,42498606
1643345332,198456,true,2407666571,28,2449434522,41767951
1643345398,198456,true,2407666571,28,2448944709,41278138
1643345404,198453,true,2408388943,28,2448699839,40310896
1643346265,198446,true,2410075321,28,2441365114,31289793
1643347509,198445,true,2410316329,28,2436974828,26658499
1643347754,198443,true,2410798416,28,2437462248,26663832
1643347790,198440,true,2411521728,28,2437462248,25940520
1643348007,198433,true,2413210300,28,2438437379,25227079
1643348103,198430,true,2413934335,28,2438681223,24746888
1643348306,198428,true,2414417146,28,2439656841,25239695
1643348401,198425,true,2415141544,28,2440144797,25003253
1643349825,198416,true,2417316041,28,2449189603,31873562
1643349874,198414,true,2417799528,28,2449434522,31634994
1643350133,198412,true,2418283112,28,2450904550,32621438
1643350226,198409,true,2419008670,28,2451394756,32386086
1643351502,198402,true,2420702484,28,2457039170,36336686
1643351665,198401,true,2420944554,28,2457530603,36586049
1643351723,198399,true,2421428767,28,2457776356,36347589
1643351763,198396,true,2422155268,28,2458022133,35866865
1643352031,198389,true,2423851286,28,2459497315,35646029
1643352072,198389,true,2423851286,28,2459743265,35891979
1643352398,198389,true,2423851286,28,2459251390,35400104
1643352445,198387,true,2424336080,28,2459251390,34915310
1643352502,198381,true,2425791046,28,2459005490,33214444
1643352702,198381,true,2425791046,28,2458267935,32476889
1643352736,198381,true,2425791046,28,2458022133,32231087
1643352793,198378,true,2426518856,28,2457776356,31257500
1643353056,198372,true,2427975131,28,2455565462,27590331
1643353176,198373,true,2427732358,28,2453847254,26114896
1643353221,198374,true,2427489609,28,2453111247,25621638
1643353239,198372,true,2427975131,28,2452865960,24890829
1643353388,198369,true,2428703597,28,2449924434,21220837
1643353597,198371,true,2428217929,28,2445029726,16811797
1643354180,198372,true,2427975131,28,2432349203,4374072
1643355011,198369,true,2428703597,28,2425791046,-2912551
1643355052,198366,true,2429432280,28,2425791046,-3641234
1643355095,198368,true,2428946467,28,2426033625,-2912842
1643355172,198368,true,2428946467,28,2425791046,-3155421
1643355332,198368,true,2428946467,28,2425791046,-3155421
1643355947,198366,true,2429432280,28,2425063454,-4368826
1643356358,198369,true,2428703597,28,2423124276,-5579321
1643356485,198369,true,2428703597,28,2422397484,-6306113
1643356601,198369,true,2428703597,28,2421428767,-7274830
1643356603,198368,true,2428946467,28,2421428767,-7517700
1643356642,198372,true,2427975131,28,2421186649,-6788482
1643356683,198372,true,2427975131,28,2420460438,-7514693
1643356763,198374,true,2427489609,28,2419492496,-7997113
1643356773,198372,true,2427975131,28,2419250571,-8724560
1643356832,198376,true,2427004184,28,2418283112,-8721072
1643357663,198378,true,2426518856,28,2407425828,-19093028
1643357820,198379,true,2426276228,28,2405019726,-21256502
1643358052,198377,true,2426761508,28,2400934870,-25826638
1643358796,198382,true,2425548491,28,2390633529,-34914962
1643359903,198384,true,2425063454,28,2385380178,-39683276
1643359988,198385,true,2424820972,28,2385618716,-39202256
1643360045,198383,true,2425305960,28,2385857278,-39448682
1643360252,198388,true,2424093671,28,2386811764,-37281907
1643360260,198389,true,2423851286,28,2387050445,-36800841
1643360371,198390,true,2423608925,28,2387766632,-35842293
1643360375,198389,true,2423851286,28,2387766632,-36084654
1643360469,198392,true,2423124276,28,2388244209,-34880067
1643361302,198393,true,2422881988,28,2393982592,-28899396
1643361602,198393,true,2422881988,28,2396856952,-26025036
1643361728,198390,true,2423608925,28,2398535255,-25073670
1643362275,198391,true,2423366588,28,2404298364,-19068224
1643362282,198391,true,2423366588,28,2404298364,-19068224
1643362338,198390,true,2423608925,28,2404538794,-19070131
1643362471,198388,true,2424093671,28,2405019726,-19073945
1643362592,198389,true,2423851286,28,2405019726,-18831560
1643362697,198388,true,2424093671,28,2404779248,-19314423
1643362882,198387,true,2424336080,28,2404298364,-20037716
1643362911,198385,true,2424820972,28,2404298364,-20522608
1643363064,198386,true,2424578514,28,2403577219,-21001295
1643363450,198386,true,2424578514,28,2400214733,-24363781
1643363484,198385,true,2424820972,28,2399734762,-25086210
1643363710,198384,true,2425063454,28,2396617290,-28446164
1643364206,198386,true,2424578514,28,2391111679,-33466835
1643364269,198385,true,2424820972,28,2390872592,-33948380
1643364490,198386,true,2424578514,28,2390394489,-34184025
1643364511,198384,true,2425063454,28,2390394489,-34668965
1643364848,198387,true,2424336080,28,2389199650,-35136430
1643365038,198387,true,2424336080,28,2389199650,-35136430
1643365230,198387,true,2424336080,28,2389438570,-34897510
1643365385,198386,true,2424578514,28,2389916482,-34662032
1643365489,198389,true,2423851286,28,2390394489,-33456797
1643366507,198388,true,2424093671,28,2395658883,-28434788
1643366631,198389,true,2423851286,28,2396617290,-27233996
1643366837,198388,true,2424093671,28,2398775108,-25318563
1643367033,198391,true,2423366588,28,2400214733,-23151855
1643367382,198390,true,2423608925,28,2400694800,-22914125
1643367570,198392,true,2423124276,28,2400454755,-22669521
1643367957,198393,true,2422881988,28,2400214733,-22667255
1643368089,198396,true,2422155268,28,2399734762,-22420506
1643368160,198396,true,2422155268,28,2399254887,-22900381
1643368210,198398,true,2421670910,28,2399014986,-22655924
1643368696,198401,true,2420944554,28,2395419341,-25525213
1643368720,198404,true,2420218416,28,2395179823,-25038593
1643370333,198405,true,2419976418,28,2382519582,-37456836
1643370381,198407,true,2419492496,28,2382519582,-36972914
1643370447,198411,true,2418524940,28,2382281354,-36243586
1643370482,198414,true,2417799528,28,2382281354,-35518174
1643370489,198416,true,2417316041,28,2382281354,-35034687
1643371411,198417,true,2417074333,28,2385857278,-31217055
1643371468,198420,true,2416349356,28,2386334474,-30014882
1643372466,198423,true,2415624596,28,2393503867,-22120729
1643372473,198424,true,2415383058,28,2393503867,-21879191
1643372531,198425,true,2415141544,28,2393743218,-21398326
1643372545,198428,true,2414417146,28,2393743218,-20673928
1643373560,198433,true,2413210300,28,2386095864,-27114436
1643373566,198434,true,2412969003,28,2386095864,-26873139
1643373699,198435,true,2412727730,28,2384187846,-28539884
1643373845,198438,true,2412004056,28,2382519582,-29484474
1643374405,198444,true,2410557360,28,2374670618,-35886742
1643374987,198445,true,2410316329,28,2371822864,-38493465
1643375182,198446,true,2410075321,28,2371348571,-38726750
1643375205,198448,true,2409593378,28,2371111460,-38481918
1643375370,198454,true,2408148128,28,2370874372,-37273756
1643375736,198454,true,2408148128,28,2371822864,-36325264
1643375768,198455,true,2407907337,28,2372060047,-35847290
1643375969,198457,true,2407425828,28,2373958359,-33467469
1643376405,198463,true,2405981878,28,2378472942,-27508936
1643376606,198463,true,2405981878,28,2380376386,-25605492
1643376660,198464,true,2405741304,28,2381090570,-24650734
1643376707,198466,true,2405260228,28,2381804969,-23455259
1643376749,198471,true,2404057959,28,2382757834,-21300125
1643376897,198469,true,2404538794,28,2386095864,-18442930
1643376927,198470,true,2404298364,28,2386811764,-17486600
1643376985,198472,true,2403817577,28,2388244209,-15573368
1643377181,198477,true,2402616028,28,2393982592,-8633436
1643377476,198474,true,2403336885,28,2402375791,-961094
1643377517,198474,true,2403336885,28,2403577219,240334
1643377551,198477,true,2402616028,28,2404538794,1922766
1643377563,198482,true,2401415081,28,2404779248,3364167
1643377884,198479,true,2402135577,28,2411039496,8903919
1643378301,198480,true,2401895388,28,2419250571,17355183
1643378718,198482,true,2401415081,28,2424820972,23405891
1643380286,198486,true,2400454755,28,2431376507,30921752
1643380338,198483,true,2401174963,28,2431133393,29958430
1643380345,198483,true,2401174963,28,2431133393,29958430
1643380521,198485,true,2400694800,28,2429432280,28737480
1643380546,198490,true,2399494813,28,2428946467,29451654
1643380563,198488,true,2399974736,28,2428703597,28728861
1643380737,198488,true,2399974736,28,2425305960,25331224
1643380966,198489,true,2399734762,28,2420702484,20967722
1643381258,198494,true,2398535255,28,2414658588,16123333
1643381274,198491,true,2399254887,28,2414417146,15162259
1643381308,198493,true,2398775108,28,2413692966,14917858
1643381465,198494,true,2398535255,28,2409834338,11299083
1643381918,198499,true,2397336347,28,2400214733,2878386
1643382237,198497,true,2397815838,28,2394940329,-2875509
1643382326,198497,true,2397815838,28,2394700859,-3114979
1643382499,198498,true,2397576081,28,2394940329,-2635752
1643382531,198503,true,2396377652,28,2394940329,-1437323
1643382585,198500,true,2397096637,28,2395419341,-1677296
1643382609,198499,true,2397336347,28,2395658883,-1677464
1643382643,198499,true,2397336347,28,2395898448,-1437899
1643382703,198503,true,2396377652,28,2396856952,479300
1643383051,198498,true,2397576081,28,2402616028,5039947
1643383116,198497,true,2397815838,28,2403817577,6001739
1643383145,198497,true,2397815838,28,2404298364,6482526
1643383223,198500,true,2397096637,28,2406222476,9125839
1643383440,198493,true,2398775108,28,2411039496,12264388
1643383450,198492,true,2399014986,28,2411280600,12265614
1643383764,198491,true,2399254887,28,2417074333,17819446
1643383779,198494,true,2398535255,28,2417316041,18780786
1643383978,198488,true,2399974736,28,2420460438,20485702
1643384050,198486,true,2400454755,28,2421670910,21216155
1643384225,198486,true,2400454755,28,2423124276,22669521
1643384238,198489,true,2399734762,28,2423366588,23631826
1643384277,198484,true,2400934870,28,2423851286,22916416
1643384355,198482,true,2401415081,28,2424578514,23163433
1643384822,198482,true,2401415081,28,2424820972,23405891
1643385029,198485,true,2400694800,28,2425063454,24368654
1643385193,198479,true,2402135577,28,2425548491,23412914
1643386235,198477,true,2402616028,28,2436000282,33384254
1643386265,198476,true,2402856290,28,2436243882,33387592
1643386663,198479,true,2402135577,28,2442097596,39962019
1643386668,198474,true,2403336885,28,2442097596,38760711
1643386776,198471,true,2404057959,28,2443807578,39749619
1643386795,198470,true,2404298364,28,2444296364,39998000
1643387974,198470,true,2404298364,28,2463189145,58890781
1643388036,198464,true,2405741304,28,2464174568,58433264
1643388080,198460,true,2406703745,28,2464913895,58210150
1643388580,198459,true,2406944415,28,2472072161,65127746
1643388688,198457,true,2407425828,28,2472566601,65140773
1643388780,198451,true,2408870645,28,2472813857,63943212
1643389150,198448,true,2409593378,28,2473061139,63467761
1643389283,198446,true,2410075321,28,2473308445,63233124
1643389309,198445,true,2410316329,28,2473555776,63239447
1643389565,198439,true,2411762880,28,2474297917,62535037
1643389581,198435,true,2412727730,28,2474545346,61817616
1643390032,198433,true,2413210300,28,2477516434,64306134
1643390222,198431,true,2413692966,28,2478011963,64318997
1643390252,198425,true,2415141544,28,2478011963,62870419
1643390273,198421,true,2416107745,28,2478011963,61904218
1643390441,198420,true,2416349356,28,2478259764,61910408
1643390725,198419,true,2416590991,28,2478259764,61668773
1643390756,198414,true,2417799528,28,2478259764,60460236
1643391393,198410,true,2418766793,28,2476773328,58006535
1643392210,198409,true,2419008670,28,2470836496,51827826
1643392223,198409,true,2419008670,28,2470836496,51827826
1643392400,198404,true,2420218416,28,2469848409,49629993
1643392427,198400,true,2421186649,28,2469848409,48661760
1643392963,198401,true,2420944554,28,2465653443,44708889
1643393357,198400,true,2421186649,28,2463435464,42248815
1643393934,198394,true,2422639724,28,2462450336,39810612
1643394151,198390,true,2423608925,28,2462696581,39087656
1643394173,198390,true,2423608925,28,2462696581,39087656
1643394438,198388,true,2424093671,28,2463681807,39588136
1643394652,198382,true,2425548491,28,2464174568,38626077
1643394776,198379,true,2426276228,28,2464667428,38391200
1643394799,198378,true,2426518856,28,2464913895,38395039
1643394818,198376,true,2427004184,28,2464913895,37909711
1643395040,198369,true,2428703597,28,2467379918,38676321
1643395396,198365,true,2429675224,28,2469848409,40173185
1643395518,198365,true,2429675224,28,2470095393,40420169
1643396456,198365,true,2429675224,28,2472566601,42891377
1643396758,198358,true,2431376507,28,2472072161,40695654
1643397275,198355,true,2432105993,28,2469107602,37001609
1643397309,198354,true,2432349203,28,2468860716,36511513
1643397889,198352,true,2432835697,28,2464667428,31831731
1643398223,198346,true,2434295764,28,2461711748,27415984
1643398234,198343,true,2435026125,28,2461711748,26685623
1643398590,198343,true,2435026125,28,2454828940,19802815
1643398619,198341,true,2435513155,28,2454338048,18824893
1643398794,198335,true,2436974828,28,2452375461,15400633
1643398813,198333,true,2437462248,28,2452375461,14913213
1643399724,198331,true,2437949764,28,2448699839,10750075
1643399725,198329,true,2438437379,28,2448699839,10262460
1643400033,198324,true,2439656841,28,2449189603,9532762
1643400068,198321,true,2440388812,28,2449434522,9045710
1643400082,198320,true,2440632851,28,2449679466,9046615
1643400108,198318,true,2441121001,28,2450169426,9048425
1643400116,198313,true,2442341806,28,2450169426,7827620
1643400119,198310,true,2443074582,28,2450414443,7339861
1643400199,198308,true,2443563221,28,2451885059,8321838
1643400690,198307,true,2443807578,28,2460235238,16427660
1643401310,198303,true,2444785247,28,2466393213,21607966
1643401570,198301,true,2445274229,28,2469107602,23833373
1643402052,198299,true,2445763308,28,2472319369,26556061
1643402150,198299,true,2445763308,28,2472319369,26556061
1643402164,198297,true,2446252485,28,2472319369,26066884
1643402236,198294,true,2446986434,28,2472813857,25827423
1643402453,198292,true,2447475856,28,2474050511,26574655
1643402490,198291,true,2447720604,28,2474297917,26577313
1643402570,198287,true,2448699839,28,2475535313,26835474
1643402601,198285,true,2449189603,28,2476278048,27088445
1643402678,198281,true,2450169426,28,2477516434,27347008
1643402693,198280,true,2450414443,28,2477764186,27349743
1643402893,198277,true,2451149641,28,2481235312,30085671
1643402973,198274,true,2451885059,28,2482724425,30839366
1643403318,198270,true,2452865960,28,2489685446,36819486
1643403507,198266,true,2453847254,28,2493173272,39326018
1643403548,198262,true,2454828940,28,2493921299,39092359
1643404037,198259,true,2455565462,28,2503916462,48351000
1643404134,198253,true,2457039170,28,2505419187,48380017
1643404217,198250,true,2457776356,28,2506672147,48895791
1643404279,198245,true,2459005490,28,2507674967,48669477
1643404356,198241,true,2459989239,28,2508678187,48688948
1643404600,198235,true,2461465602,28,2511690257,50224655
1643404649,198231,true,2462450336,28,2512443840,49993504
1643404670,198226,true,2463681807,28,2512695084,49013277
1643405270,198221,true,2464913895,28,2522008810,57094915
1643405323,198215,true,2466393213,28,2523017765,56624552
1643405360,198211,true,2467379918,28,2523522394,56142476
1643410356,198206,true,2468613855,28,2542010582,73396727
1643410470,198201,true,2469848409,28,2542010582,72162173
1643410533,198196,true,2471083580,28,2541756407,70672827
1643410642,198192,true,2472072161,28,2541502257,69430096
1643410700,198190,true,2472566601,28,2540994032,68427431
1643410862,198186,true,2473555776,28,2539723916,66168140
1643411227,198181,true,2474792801,28,2536424585,61631784
1643411337,198178,true,2475535313,28,2535917376,60382063
1643411439,198176,true,2476030445,28,2535410269,59379824
1643411783,198172,true,2477021006,28,2533129540,56108534
1643412014,198166,true,2478507590,28,2531610194,53102604
1643412329,198163,true,2479251216,28,2530091760,50840544
1643412549,198160,true,2479995066,28,2530597803,50602737
1643413039,198156,true,2480987213,28,2533889555,52902342
1643413132,198149,true,2482724425,28,2534142944,51418519
1643414251,198145,true,2483717664,28,2545571711,61854047
1643414803,198142,true,2484462854,28,2549137829,64674975
1643414804,198137,true,2485705334,28,2549137829,63432495
1643414981,198131,true,2487197130,28,2550667694,63470564
1643415081,198127,true,2488192158,28,2551432971,63240813
1643415146,198123,true,2489187584,28,2551943283,62755699
1643415202,198119,true,2490183408,28,2552708943,62525535
1643415268,198113,true,2491677892,28,2553474832,61796940
1643415622,198108,true,2492923980,28,2558074996,65151016
1643415717,198104,true,2493921299,28,2559610224,65688925
1643416211,198101,true,2494669550,28,2568070467,73400917
1643416307,198095,true,2496166726,28,2569611694,73444968
1643416360,198093,true,2496665985,28,2570382655,73716670
1643416371,198088,true,2497914567,28,2570639693,72725126
1643416407,198086,true,2498414175,28,2570896757,72482582
1643416489,198081,true,2499663632,28,2571925270,72261638
1643417036,198080,true,2499913599,28,2573211490,73297891
1643417212,198076,true,2500913714,28,2572439681,71525967
1643418959,198074,true,2501413922,28,2562427204,61013282
1643419100,198068,true,2502915145,28,2562427204,59512059
1643419411,198067,true,2503165437,28,2562939715,59774278
1643419425,198063,true,2504166853,28,2562939715,58772862
1643419511,198061,true,2504667712,28,2562683447,58015735
1643419658,198057,true,2505669729,28,2561914795,56245066
1643419675,198057,true,2505669729,28,2561914795,56245066
1643420614,198054,true,2506421505,28,2553219510,46798005
1643420656,198052,true,2506922815,28,2552708943,45786128
1643423671,198048,true,2507925734,28,2538200615,30274881
1643423710,198047,true,2508176527,28,2538200615,30024088
1643423946,198045,true,2508678187,28,2537439307,28761120
1643424037,198043,true,2509179948,28,2537185589,28005641
1643424676,198039,true,2510183770,28,2535410269,25226499
1643426380,198039,true,2510183770,28,2529332884,19149114
1643426405,198036,true,2510936901,28,2529332884,18395983
1643426462,198034,true,2511439113,28,2529079976,17640863
1643426565,198029,true,2512695084,28,2528827093,16132009
1643426581,198029,true,2512695084,28,2528827093,16132009
1643427007,198027,true,2513197648,28,2528321404,15123756
1643427175,198025,true,2513700313,28,2528827093,15126780
1643427204,198020,true,2514957414,28,2528827093,13869679
1643427380,198020,true,2514957414,28,2529079976,14122562
1643427690,198017,true,2515711977,28,2529838776,14126799
1643427940,198015,true,2516215145,28,2530344769,14129624
1643428514,198010,true,2517473504,28,2532369753,14896249
1643428594,198010,true,2517473504,28,2532876253,15402749
1643428947,198009,true,2517725251,28,2534396358,16671107
1643429174,198007,true,2518228821,28,2535156753,16927932
1643429192,198002,true,2519488188,28,2535156753,15668565
1643429445,198001,true,2519740136,28,2536424585,16684449
1643429488,197999,true,2520244110,28,2536678228,16434118
1643429515,197996,true,2521000259,28,2536678228,15677969
1643431144,197991,true,2522261011,28,2547099436,24838425
1643432359,197989,true,2522765488,28,2547608882,24843394
1643433041,197987,true,2523270067,28,2546590093,23320026
1643433103,197983,true,2524279526,28,2546335459,22055933
1643433302,197977,true,2525794472,28,2546080851,20286379
1643433466,197975,true,2526299657,28,2545826269,19526612
1643433518,197972,true,2527057622,28,2545571711,18514089
1643433735,197969,true,2527815815,28,2544553737,16737922
1643433856,197964,true,2529079976,28,2543790524,14710548
1643434922,197962,true,2529585817,28,2538962152,9376335
1643434932,197960,true,2530091760,28,2538962152,8870392
1643435251,197957,true,2530850863,28,2537185589,6334726
1643435866,197953,true,2531863355,28,2534649798,2786443
1643436667,197952,true,2532116542,28,2531863355,-253187
1643437312,197949,true,2532876253,28,2532116542,-759711
1643437510,197947,true,2533382853,28,2532622990,-759863
1643437576,197944,true,2534142944,28,2532876253,-1266691
1643437851,197943,true,2534396358,28,2534396358,0
1643438698,197939,true,2535410269,28,2540485910,5075641
1643438881,197937,true,2535917376,28,2541502257,5584881
1643438959,197934,true,2536678228,28,2541756407,5078179
1643441253,197933,true,2536931896,28,2540485910,3554014
1643441290,197930,true,2537693051,28,2540739958,3046907
1643441384,197927,true,2538454435,28,2540994032,2539597
1643441524,197925,true,2538962152,28,2541502257,2540105
1643441559,197924,true,2539216048,28,2541756407,2540359
1643442372,197921,true,2539977889,28,2545826269,5848380
1643442681,197918,true,2540739958,28,2548882941,8142983
1643443074,197917,true,2540994032,28,2552708943,11714911
1643443218,197916,true,2541248132,28,2553985553,12737421
1643443353,197913,true,2542010582,28,2555262801,13252219
1643443383,197910,true,2542773262,28,2555518327,12745065
1643444381,197909,true,2543027539,28,2565247284,22219745
1643444619,197907,true,2543536170,28,2566530164,22993994
1643444719,197904,true,2544299307,28,2567043495,22744188
1643444785,197902,true,2544808193,28,2567300200,22492007
1643445074,197901,true,2545062673,28,2568070467,23007794
1643445557,197900,true,2545317180,28,2567813685,22496505
1643445695,197896,true,2546335459,28,2567556930,21221471
1643445815,197894,true,2546844752,28,2567300200,20455448
1643446414,197894,true,2546844752,28,2565503808,18659056
1643446696,197894,true,2546844752,28,2564990784,18146032
1643447006,197891,true,2547608882,28,2563965045,16356163
1643447034,197890,true,2547863643,28,2563708674,15845031
1643447103,197891,true,2547608882,28,2563196009,15587127
1643447117,197890,true,2547863643,28,2563196009,15332366
1643447161,197890,true,2547863643,28,2562683447,14819804
1643447215,197889,true,2548118429,28,2562170987,14052558
1643447236,197890,true,2547863643,28,2561914795,14051152
1643447826,197890,true,2547863643,28,2555007300,7143657
1643448087,197888,true,2548373241,28,2552453697,4080456
1643448989,197887,true,2548628078,28,2542519010,-6109068
1643449255,197888,true,2548373241,28,2541756407,-6616834
1643449396,197888,true,2548373241,28,2541502257,-6870984
1643449492,197887,true,2548628078,28,2541248132,-7379946
1643449703,197886,true,2548882941,28,2541248132,-7634809
1643450273,197886,true,2548882941,28,2542010582,-6872359
1643452952,197886,true,2548882941,28,2545062673,-3820268
1643454830,197885,true,2549137829,28,2550667694,1529865
1643455550,197884,true,2549392743,28,2550667694,1274951
1643456712,197884,true,2549392743,28,2550667694,1274951
1643457742,197885,true,2549137829,28,2550667694,1529865
1643458421,197884,true,2549392743,28,2552198478,2805735
1643458425,197884,true,2549392743,28,2552198478,2805735
1643458918,197884,true,2549392743,28,2551943283,2550540
1643459046,197886,true,2548882941,28,2552198478,3315537
1643459203,197885,true,2549137829,28,2552964214,3826385
1643459577,197885,true,2549137829,28,2556029456,6891627
1643459649,197885,true,2549137829,28,2556540688,7402859
1643460124,197886,true,2548882941,28,2563452328,14569387
1643460908,197885,true,2549137829,28,2575785860,26648031
1643461294,197884,true,2549392743,28,2579136391,29743648
1643461326,197885,true,2549137829,28,2579394305,30256476
1643462096,197886,true,2548882941,28,2579136391,30253450
1643463106,197885,true,2549137829,28,2575785860,26648031
1643463113,197884,true,2549392743,28,2575785860,26393117
1643463140,197884,true,2549392743,28,2575785860,26393117
1643463817,197884,true,2549392743,28,2580426217,31033474
1643463909,197882,true,2549902647,28,2580942328,31039681
1643463992,197881,true,2550157637,28,2581716689,31559052
1643464185,197880,true,2550412653,28,2584557997,34145344
1643465908,197879,true,2550667694,28,2600111181,49443487
1643466530,197877,true,2551177853,28,2599851195,48673342
1643466596,197876,true,2551432971,28,2599851195,48418224
1643466735,197875,true,2551688114,28,2599851195,48163081
1643466885,197873,true,2552198478,28,2599851195,47652717
1643467017,197870,true,2552964214,28,2599591236,46627022
1643467326,197869,true,2553219510,28,2597772250,44552740
1643467385,197867,true,2553730180,28,2597252774,43522594
1643467861,197866,true,2553985553,28,2593360009,39374456
1643467957,197863,true,2554751825,28,2592582157,37830332
1643468035,197862,true,2555007300,28,2591545383,36538083
1643468050,197860,true,2555518327,28,2591286255,35767928
1643468102,197859,true,2555773879,28,2590249999,34476120
1643468169,197858,true,2556029456,28,2588437549,32408093
1643468178,197858,true,2556029456,28,2588178731,32149275
1643468483,197858,true,2556029456,28,2578878503,22849047
1643468510,197857,true,2556285059,28,2577847210,21562151
1643469244,197856,true,2556540688,28,2556029456,-511232
1643469309,197857,true,2556285059,28,2554496375,-1788684
1643470765,197856,true,2556540688,28,2544808193,-11732495
1643470811,197855,true,2556796342,28,2545062673,-11733669
1643470844,197854,true,2557052021,28,2545062673,-11989348
1643471553,197855,true,2556796342,28,2545317180,-11479162
1643471924,197854,true,2557052021,28,2543536170,-13515851
1643472847,197854,true,2557052021,28,2542010582,-15041439
1643472928,197853,true,2557307727,28,2541756407,-15551320
1643473301,197854,true,2557052021,28,2540485910,-16566111
1643473483,197854,true,2557052021,28,2540739958,-16312063
1643473705,197853,true,2557307727,28,2541248132,-16059595
1643474819,197853,true,2557307727,28,2544299307,-13008420
1643475379,197854,true,2557052021,28,2546335459,-10716562
1643475510,197854,true,2557052021,28,2546590093,-10461928
1643475607,197854,true,2557052021,28,2546844752,-10207269
1643475710,197853,true,2557307727,28,2547354146,-9953581
1643475828,197853,true,2557307727,28,2548118429,-9189298
1643475874,197853,true,2557307727,28,2548373241,-8934486
1643475967,197852,true,2557563457,28,2549137829,-8425628
1643476072,197850,true,2558074996,28,2550157637,-7917359
1643478927,197849,true,2558330803,28,2569868656,11537853
1643480432,197849,true,2558330803,28,2568327274,9996471
1643480439,197847,true,2558842495,28,2568327274,9484779
1643481086,197846,true,2559098379,28,2568584107,9485728
1643481944,197845,true,2559354289,28,2569354759,10000470
1643481984,197844,true,2559610224,28,2569611694,10001470
1643482266,197842,true,2560122172,28,2572439681,12317509
1643482636,197839,true,2560890286,28,2576816329,15926043
1643484827,197836,true,2561658629,28,2592841415,31182786
1643485204,197835,true,2561914795,28,2593619345,31704550
1643486014,197834,true,2562170987,28,2595954537,33783550
1643486589,197832,true,2562683447,28,2597512499,34829052
1643486844,197829,true,2563452328,28,2597772250,34319922
1643487532,197828,true,2563708674,28,2597772250,34063576
1643487843,197826,true,2564221441,28,2597512499,33291058
1643487908,197824,true,2564734311,28,2597252774,32518463
1643487997,197821,true,2565503808,28,2596993074,31489266
1643488245,197821,true,2565503808,28,2596214132,30710324
1643488284,197819,true,2566016935,28,2596733401,30716466
1643488317,197818,true,2566273536,28,2596993074,30719538
1643488362,197814,true,2567300200,28,2597772250,30472050
1643488389,197811,true,2568070467,28,2598032027,29961560
1643488421,197810,true,2568327274,28,2598551660,30224386
1643488788,197808,true,2568840965,28,2604534907,35693942
1643488867,197805,true,2569611694,28,2605837435,36225741
1643489128,197803,true,2570125642,28,2610009904,39884262
1643489184,197802,true,2570382655,28,2610531932,40149277
1643489495,197801,true,2570639693,28,2613143639,42503946
1643489619,197799,true,2571153847,28,2613666294,42512447
1643489811,197798,true,2571410962,28,2614711917,43300955
1643490088,197797,true,2571668103,28,2614973388,43305285
1643490197,197797,true,2571668103,28,2613666294,41998191
1643490219,197794,true,2572439681,28,2613404953,40965272
1643490287,197793,true,2572696925,28,2612359853,39662928
1643490299,197791,true,2573211490,28,2612359853,39148363
1643490313,197791,true,2573211490,28,2612359853,39148363
1643492424,197785,true,2574755803,28,2627554803,52799000
1643492633,197784,true,2575013279,28,2627554803,52541524
1643493017,197782,true,2575528307,28,2627554803,52026496
1643493449,197780,true,2576043438,28,2627292073,51248635
1643493559,197774,true,2577589451,28,2627292073,49702622
1643493753,197773,true,2577847210,28,2627029371,49182161
1643493778,197771,true,2578362805,28,2627029371,48666566
1643493860,197769,true,2578878503,28,2626504043,47625540
1643493887,197763,true,2580426217,28,2626504043,46077826
1643494219,197763,true,2580426217,28,2623878983,43452766
1643494364,197760,true,2581200423,28,2622567437,41367014
1643495086,197759,true,2581458543,28,2614711917,33253374
1643495152,197754,true,2582749530,28,2613927660,31178130
1643495202,197754,true,2582749530,28,2613404953,30655423
1643495473,197752,true,2583266106,28,2610009904,26743798
1643495914,197752,true,2583266106,28,2606879927,23613821
1643497261,197746,true,2584816453,28,2603493354,18676901
1643497280,197746,true,2584816453,28,2603493354,18676901
1643499106,197745,true,2585074935,28,2592322925,7247990
1643500705,197745,true,2585074935,28,2591286255,6211320
1643500720,197741,true,2586109120,28,2591286255,5177135
1643500732,197740,true,2586367731,28,2591286255,4918524
1643501086,197740,true,2586367731,28,2592063718,5695987
1643501206,197739,true,2586626368,28,2592582157,5955789
1643501393,197735,true,2587661173,28,2594138095,6476922
1643502781,197735,true,2587661173,28,2605837435,18176262
1643502943,197735,true,2587661173,28,2606358629,18697456
1643503200,197735,true,2587661173,28,2605837435,18176262
1643503282,197731,true,2588696393,28,2604795361,16098968
1643503316,197732,true,2588437549,28,2604274480,15836931
1643503587,197734,true,2587919939,28,2600111181,12191242
1643504195,197735,true,2587661173,28,2589214158,1552985
1643504316,197731,true,2588696393,28,2587402433,-1293960
1643505381,197732,true,2588437549,28,2574240929,-14196620
1643505861,197735,true,2587661173,28,2573983531,-13677642
1643506037,197737,true,2587143719,28,2574240929,-12902790
1643509284,197733,true,2588178731,28,2577847210,-10331521
1643509645,197734,true,2587919939,28,2577847210,-10072729
1643509951,197738,true,2586885030,28,2577847210,-9037820
1643510833,197740,true,2586367731,28,2577847210,-8520521
1643511617,197736,true,2587402433,28,2578104995,-9297438
1643512602,197737,true,2587143719,28,2580168201,-6975518
1643514606,197740,true,2586367731,28,2581716689,-4651042
1643514668,197743,true,2585591976,28,2581716689,-3875287
1643517396,197739,true,2586626368,28,2570382655,-16243713
1643517775,197740,true,2586367731,28,2570639693,-15728038
1643517864,197743,true,2585591976,28,2570639693,-14952283
1643518551,197745,true,2585074935,28,2572439681,-12635254
1643518615,197740,true,2586367731,28,2572696925,-13670806
1643518945,197740,true,2586367731,28,2575270780,-11096951
1643519051,197742,true,2585850535,28,2576301043,-9549492
1643519154,197742,true,2585850535,28,2577074010,-8776525
1643519313,197736,true,2587402433,28,2578620641,-8781792
1643519385,197735,true,2587661173,28,2579394305,-8266868
1643519449,197736,true,2587402433,28,2580168201,-7234232
1643519600,197735,true,2587661173,28,2582749530,-4911643
1643520722,197727,true,2589732027,28,2600371192,10639165
1643520902,197727,true,2589732027,28,2602191998,12459971
1643522237,197728,true,2589473080,28,2604274480,14801400
1643524058,197727,true,2589732027,28,2603753703,14021676
1643524678,197719,true,2591804538,28,2604014079,12209541
1643525598,197718,true,2592063718,28,2605055841,12992123
1643525869,197719,true,2591804538,28,2605316346,13511808
1643526122,197718,true,2592063718,28,2606358629,14294911
1643526150,197710,true,2594138095,28,2606619265,12481170
1643526245,197708,true,2594656949,28,2607140615,12483666
1643526312,197709,true,2594397509,28,2607662069,13264560
1643526424,197708,true,2594656949,28,2608705290,14048341
1643526799,197699,true,2596993074,28,2612359853,15366779
1643527434,197698,true,2597252774,28,2618898595,21645821
1643528656,197698,true,2597252774,28,2623616622,26363848
1643530046,197697,true,2597512499,28,2619684343,22171844
1643531498,197690,true,2599331303,28,2618636732,19305429
1643531690,197689,true,2599591236,28,2618636732,19045496
1643532071,197690,true,2599331303,28,2617851298,18519995
1643532191,197690,true,2599331303,28,2617589539,18258236
1643532450,197684,true,2600891292,28,2616019535,15128243
1643533423,197683,true,2601151381,28,2610531932,9380551
1643533844,197685,true,2600631229,28,2608966161,8334932
1643534128,197684,true,2600891292,28,2608705290,7813998
1643534249,197679,true,2602191998,28,2608705290,6513292
1643534807,197678,true,2602452217,28,2608705290,6253073
1643535402,197680,true,2601931804,28,2608705290,6773486
1643535471,197680,true,2601931804,28,2608705290,6773486
1643535483,197676,true,2602972733,28,2608705290,5732557
1643535845,197676,true,2602972733,28,2608705290,5732557
1643535865,197678,true,2602452217,28,2608705290,6253073
1643538680,197678,true,2602452217,28,2608705290,6253073
1643538844,197675,true,2603233031,28,2608705290,5472259
1643538857,197674,true,2603493354,28,2608705290,5211936
1643538964,197676,true,2602972733,28,2608705290,5732557
1643539066,197676,true,2602972733,28,2608966161,5993428
1643539107,197673,true,2603753703,28,2608966161,5212458
1643539121,197672,true,2604014079,28,2608966161,4952082
1643539220,197674,true,2603493354,28,2609227057,5733703
1643539491,197674,true,2603493354,28,2611054064,7560710
1643539640,197671,true,2604274480,28,2611837459,7562979
1643540416,197672,true,2604014079,28,2616542765,12528686
1643541415,197674,true,2603493354,28,2619946312,16452958
1643541696,197674,true,2603493354,28,2619946312,16452958
1643542079,197671,true,2604274480,28,2622305207,18030727
1643542539,197673,true,2603753703,28,2623878983,20125280
1643542548,197674,true,2603493354,28,2623878983,20385629
1643543030,197674,true,2603493354,28,2624141371,20648017
1643543089,197670,true,2604534907,28,2624141371,19606464
1643543317,197671,true,2604274480,28,2624403785,20129305
1643543377,197672,true,2604014079,28,2624403785,20389706
1643544004,197671,true,2604274480,28,2621518673,17244193
1643545839,197668,true,2605055841,28,2619422401,14366560
1643545903,197668,true,2605055841,28,2619684343,14628502
1643546030,197669,true,2604795361,28,2619946312,15150951
1643546059,197669,true,2604795361,28,2619946312,15150951
1643546116,197668,true,2605055841,28,2619946312,14890471
1643546229,197668,true,2605055841,28,2620732374,15676533
1643546374,197669,true,2604795361,28,2621518673,16723312
1643546699,197669,true,2604795361,28,2623354286,18558925
1643547061,197668,true,2605055841,28,2624928692,19872851
1643547226,197668,true,2605055841,28,2625191185,20135344
1643547234,197669,true,2604795361,28,2625453704,20658343
1643547270,197669,true,2604795361,28,2625453704,20658343
1643547512,197668,true,2605055841,28,2625191185,20135344
1643548193,197668,true,2605055841,28,2622829694,17773853
1643548408,197669,true,2604795361,28,2621518673,16723312
1643549401,197668,true,2605055841,28,2616019535,10963694
1643549473,197667,true,2605316346,28,2615757959,10441613
1643549656,197667,true,2605316346,28,2615234886,9918540
1643549681,197668,true,2605055841,28,2615234886,10179045
1643549764,197666,true,2605576878,28,2614973388,9396510
1643552029,197666,true,2605576878,28,2614711917,9135039
1643552081,197665,true,2605837435,28,2614711917,8874482
1643552246,197665,true,2605837435,28,2614189053,8351618
1643552480,197664,true,2606098019,28,2612882351,6784332
1643552482,197664,true,2606098019,28,2612882351,6784332
1643552562,197664,true,2606098019,28,2612098643,6000624
1643552613,197664,true,2606098019,28,2611837459,5739440
1643552830,197664,true,2606098019,28,2609748929,3650910
1643552869,197664,true,2606098019,28,2609227057,3129038
1643553159,197665,true,2605837435,28,2606358629,521194
1643555018,197665,true,2605837435,28,2596214132,-9623303
1643555026,197665,true,2605837435,28,2596473754,-9363681
1643556204,197665,true,2605837435,28,2599071396,-6766039
1643556238,197664,true,2606098019,28,2599331303,-6766716
1643557785,197663,true,2606358629,28,2610270905,3912276
1643558368,197661,true,2606879927,28,2611837459,4957532
1643558874,197660,true,2607140615,28,2612359853,5219238
1643560441,197659,true,2607401329,28,2615496409,8095080
1643560458,197657,true,2607922835,28,2615496409,7573574
1643560499,197655,true,2608444446,28,2615496409,7051963
1643560648,197655,true,2608444446,28,2615496409,7051963
1643560891,197655,true,2608444446,28,2614450472,6006026
1643561512,197653,true,2608966161,28,2609487980,521819
1643561660,197652,true,2609227057,28,2608444446,-782611
1643562092,197651,true,2609487980,28,2604795361,-4692619
1643562192,197652,true,2609227057,28,2604014079,-5212978
1643562193,197650,true,2609748929,28,2604014079,-5734850
1643563457,197649,true,2610009904,28,2598291831,-11718073
1643563862,197648,true,2610270905,28,2597772250,-12498655
1643564533,197648,true,2610270905,28,2598811515,-11459390
1643564605,197647,true,2610531932,28,2599071396,-11460536
1643564677,197645,true,2611054064,28,2599331303,-11722761
1643564699,197644,true,2611315170,28,2599591236,-11723934
1643564756,197645,true,2611054064,28,2599851195,-11202869
1643565131,197643,true,2611576301,28,2602191998,-9384303
1643566000,197641,true,2612098643,28,2608705290,-3393353
1643566425,197641,true,2612098643,28,2612359853,261210
1643566736,197641,true,2612098643,28,2614711917,2613274
1643567781,197639,true,2612621088,28,2617589539,4968451
1643567875,197638,true,2612882351,28,2617327806,4445455
1643568013,197639,true,2612621088,28,2617327806,4706718
1643568555,197639,true,2612621088,28,2615234886,2613798
1643568735,197638,true,2612882351,28,2614711917,1829566
1643568737,197637,true,2613143639,28,2614711917,1568278
1643568825,197638,true,2612882351,28,2614189053,1306702
1643568963,197639,true,2612621088,28,2613404953,783865
1643569431,197637,true,2613143639,28,2610531932,-2611707
1643569551,197637,true,2613143639,28,2609487980,-3655659
1643569588,197638,true,2612882351,28,2609227057,-3655294
1643569669,197640,true,2612359853,28,2608444446,-3915407
1643569691,197639,true,2612621088,28,2608183627,-4437461
1643569700,197640,true,2612359853,28,2608183627,-4176226
1643569711,197641,true,2612098643,28,2607922835,-4175808
1643569761,197644,true,2611315170,28,2607140615,-4174555
1643570144,197645,true,2611054064,28,2599591236,-11462828
1643570169,197646,true,2610792985,28,2599071396,-11721589
1643570188,197647,true,2610531932,28,2598811515,-11720417
1643570307,197650,true,2609748929,28,2596214132,-13534797
1643570353,197651,true,2609487980,28,2595435424,-14052556
1643570937,197652,true,2609227057,28,2584557997,-24669060
1643570948,197653,true,2608966161,28,2584299567,-24666594
1643570953,197655,true,2608444446,28,2584299567,-24144879
1643571505,197657,true,2607922835,28,2573726158,-34196677
1643572226,197657,true,2607922835,28,2569611694,-38311141
1643573021,197659,true,2607401329,28,2564990784,-42410545
1643573103,197661,true,2606879927,28,2564477863,-42402064
1643573132,197663,true,2606358629,28,2564221441,-42137188
1643573555,197665,true,2605837435,28,2559866185,-45971250
1643573620,197667,true,2605316346,28,2559354289,-45962057
1643573632,197670,true,2604534907,28,2559098379,-45436528
1643573726,197671,true,2604274480,28,2558842495,-45431985
1643573739,197672,true,2604014079,28,2558586636,-45427443
1643573755,197673,true,2603753703,28,2558586636,-45167067
1643574287,197676,true,2602972733,28,2558586636,-44386097
1643574335,197677,true,2602712462,28,2558586636,-44125826
1643574539,197678,true,2602452217,28,2559610224,-42841993
1643576185,197679,true,2602191998,28,2573726158,-28465840
1643576230,197681,true,2601671637,28,2573726158,-27945479
1643576318,197682,true,2601411496,28,2573726158,-27685338
1643576330,197684,true,2600891292,28,2573726158,-27165134
1643576853,197685,true,2600631229,28,2572439681,-28191548
1643577534,197688,true,2599851195,28,2570896757,-28954438
1643577937,197689,true,2599591236,28,2568840965,-30750271
1643578465,197691,true,2599071396,28,2565503808,-33567588
1643578505,197693,true,2598551660,28,2565247284,-33304376
1643578768,197696,true,2597772250,28,2563708674,-34063576
1643578795,197699,true,2596993074,28,2563452328,-33540746
1643578817,197701,true,2596473754,28,2563452328,-33021426
1643578982,197702,true,2596214132,28,2562427204,-33786928
1643578987,197705,true,2595435424,28,2562427204,-33008220
1643580743,197707,true,2594916414,28,2562427204,-32489210
1643580751,197709,true,2594397509,28,2562427204,-31970305
1643580755,197710,true,2594138095,28,2562427204,-31710891
1643581582,197713,true,2593360009,28,2559098379,-34261630
1643583244,197715,true,2592841415,28,2564734311,-28107104
1643583259,197716,true,2592582157,28,2564990784,-27591373
1643583609,197718,true,2592063718,28,2567043495,-25020223
1643583789,197721,true,2591286255,28,2568327274,-22958981
1643583813,197722,true,2591027152,28,2568584107,-22443045
1643583880,197724,true,2590509024,28,2569354759,-21154265
1643583944,197725,true,2590249999,28,2570125642,-20124357
1643583963,197726,true,2589991000,28,2570382655,-19608345
1643584031,197727,true,2589732027,28,2571668103,-18063924
1643584150,197728,true,2589473080,28,2573983531,-15489549
1643584167,197728,true,2589473080,28,2574240929,-15232151
1643584179,197729,true,2589214158,28,2574498353,-14715805
1643584257,197729,true,2589214158,28,2576043438,-13170720
1643584421,197729,true,2589214158,28,2579910210,-9303948
1643584470,197729,true,2589214158,28,2581200423,-8013735
1643584821,197729,true,2589214158,28,2591286255,2072097
1643585230,197729,true,2589214158,28,2603753703,14539545
1643585746,197728,true,2589473080,28,2616804419,27331339
1643586007,197728,true,2589473080,28,2619684343,30211263
1643586052,197728,true,2589473080,28,2619946312,30473232
1643586132,197728,true,2589473080,28,2620208306,30735226
1643586708,197728,true,2589473080,28,2619160485,29687405
1643587509,197727,true,2589732027,28,2612359853,22627826
1643587524,197727,true,2589732027,28,2612098643,22366616
1643587537,197727,true,2589732027,28,2612098643,22366616
1643587603,197727,true,2589732027,28,2611315170,21583143
1643587624,197727,true,2589732027,28,2611054064,21322037
1643587641,197727,true,2589732027,28,2611054064,21322037
1643587728,197727,true,2589732027,28,2609487980,19755953
1643587814,197727,true,2589732027,28,2608183627,18451600
1643588339,197728,true,2589473080,28,2601931804,12458724
1643589275,197728,true,2589473080,28,2590768075,1294995
1643589475,197729,true,2589214158,28,2588696393,-517765
1643589545,197730,true,2588955263,28,2588437549,-517714
1643589700,197731,true,2588696393,28,2587661173,-1035220
1643589737,197732,true,2588437549,28,2587402433,-1035116
1643589748,197734,true,2587919939,28,2587143719,-776220
1643589774,197735,true,2587661173,28,2586885030,-776143
1643589806,197737,true,2587143719,28,2586626368,-517351
1643589868,197738,true,2586885030,28,2585591976,-1293054
1643589880,197739,true,2586626368,28,2585333442,-1292926
1643589885,197740,true,2586367731,28,2585333442,-1034289
1643589951,197743,true,2585591976,28,2583782785,-1809191
1643590030,197745,true,2585074935,28,2581974860,-3100075
1643590059,197746,true,2584816453,28,2581458543,-3357910
1643590075,197747,true,2584557997,28,2580942328,-3615669
1643590101,197750,true,2583782785,28,2580426217,-3356568
1643590969,197752,true,2583266106,28,2559098379,-24167727
1643593975,197753,true,2583007805,28,2544044903,-38962902
1643593986,197755,true,2582491281,28,2544044903,-38446378
1643594058,197758,true,2581716689,28,2543790524,-37926165
1643594440,197761,true,2580942328,28,2541248132,-39694196
1643594486,197764,true,2580168201,28,2540739958,-39428243
1643594537,197766,true,2579652244,28,2539723916,-39928328
1643594584,197770,true,2578620641,28,2538962152,-39658489
1643594622,197775,true,2577331718,28,2537946821,-39384897
1643594736,197779,true,2576301043,28,2535410269,-40890774
1643595153,197782,true,2575528307,28,2525794472,-49733835
1643595239,197786,true,2574498353,28,2524027123,-50471230
1643597068,197790,true,2573468811,28,2509932777,-63536034
1643597872,197794,true,2572439681,28,2510936901,-61502780
1643598034,197796,true,2571925270,28,2511187994,-60737276
1643598626,197800,true,2570896757,28,2511187994,-59708763
1643598656,197804,true,2569868656,28,2511439113,-58429543
1643600149,197806,true,2569354759,28,2515711977,-53642782
1643600437,197809,true,2568584107,28,2516466766,-52117341
1643601772,197812,true,2567813685,28,2516466766,-51346919
1643601801,197816,true,2566786817,28,2516215145,-50571672
1643602025,197818,true,2566273536,28,2515460431,-50813105
1643602973,197821,true,2565503808,28,2510685832,-54817976
1643603007,197825,true,2564477863,28,2510434789,-54043074
1643603019,197827,true,2563965045,28,2510434789,-53530256
1643603053,197828,true,2563708674,28,2510183770,-53524904
1643603099,197831,true,2562939715,28,2509681809,-53257906
1643603455,197836,true,2561658629,28,2505920296,-55738333
1643603478,197838,true,2561146375,28,2505669729,-55476646
1643603528,197839,true,2560890286,28,2504918179,-55972107
1643603537,197842,true,2560122172,28,2504667712,-55454460
1643603880,197848,true,2558586636,28,2500413606,-58173030
1643604450,197850,true,2558074996,28,2495168509,-62906487
1643604505,197851,true,2557819214,28,2494669550,-63149664
1643604982,197853,true,2557307727,28,2492674713,-64633014
1643605926,197858,true,2556029456,28,2495418026,-60611430
1643607181,197860,true,2555518327,28,2496665985,-58852342
1643607627,197861,true,2555262801,28,2496665985,-58596816
1643607647,197862,true,2555007300,28,2496915651,-58091649
1643607675,197866,true,2553985553,28,2496915651,-57069902
1643607875,197867,true,2553730180,28,2497165343,-56564837
1643608322,197868,true,2553474832,28,2498164359,-55310473
1643608480,197869,true,2553219510,28,2498414175,-54805335
1643608749,197874,true,2551943283,28,2499663632,-52279651
1643609017,197876,true,2551432971,28,2500663648,-50769323
1643609049,197876,true,2551432971,28,2500913714,-50519257
1643610213,197878,true,2550922761,28,2504166853,-46755908
1643610336,197883,true,2549647682,28,2504417270,-45230412
1643610342,197885,true,2549137829,28,2504417270,-44720559
1643610442,197886,true,2548882941,28,2504417270,-44465671
1643611114,197887,true,2548628078,28,2505920296,-42707782
1643611293,197892,true,2547354146,28,2506421505,-40932641
1643613508,197894,true,2546844752,28,2508427344,-38417408
1643614322,197894,true,2546844752,28,2510434789,-36409963
1643614664,197895,true,2546590093,28,2511690257,-34899836
1643614737,197900,true,2545317180,28,2512192620,-33124560
1643614743,197901,true,2545062673,28,2512192620,-32870053
1643615222,197900,true,2545317180,28,2515208910,-30108270
1643615273,197901,true,2545062673,28,2515711977,-29350696
1643615660,197905,true,2544044903,28,2517725251,-26319652
1643615672,197906,true,2543790524,28,2517977024,-25813500
1643615818,197905,true,2544044903,28,2519488188,-24556715
1643618767,197906,true,2543790524,28,2528321404,-15469120
1643619876,197910,true,2542773262,28,2528321404,-14451858
1643620163,197911,true,2542519010,28,2529079976,-13439034
1643621629,197910,true,2542773262,28,2531863355,-10909907
1643621866,197910,true,2542773262,28,2531863355,-10909907
1643621875,197914,true,2541756407,28,2532116542,-9639865
1643622742,197915,true,2541502257,28,2534649798,-6852459
1643623237,197915,true,2541502257,28,2536678228,-4824029
1643625012,197915,true,2541502257,28,2539723916,-1778341
1643625929,197920,true,2540231887,28,2539723916,-507971
1643626177,197922,true,2539723916,28,2540231887,507971
1643627656,197922,true,2539723916,28,2546335459,6611543
1643627929,197922,true,2539723916,28,2547354146,7630230
1643628928,197927,true,2538454435,28,2547354146,8899711
1643629088,197929,true,2537946821,28,2547354146,9407325
1643629095,197929,true,2537946821,28,2547354146,9407325
1643629438,197931,true,2537439307,28,2545826269,8386962
1643629693,197937,true,2535917376,28,2544044903,8127527
1643629709,197940,true,2535156753,28,2543790524,8633771
1643630100,197941,true,2534903263,28,2539723916,4820653
1643630142,197943,true,2534396358,28,2539469969,5073611
1643630219,197949,true,2532876253,28,2539469969,6593716
1643630234,197952,true,2532116542,28,2539723916,7607374
1643630506,197950,true,2532622990,28,2541502257,8879267
1643630623,197951,true,2532369753,28,2542519010,10149257
1643630684,197956,true,2531103948,28,2543281842,12177894
1643630804,197959,true,2530344769,28,2544044903,13700134
1643630823,197957,true,2530850863,28,2544044903,13194040
1643630838,197958,true,2530597803,28,2544044903,13447100
1643630868,197962,true,2529585817,28,2544044903,14459086
1643631327,197968,true,2528068597,28,2543027539,14958942
1643631344,197965,true,2528827093,28,2543027539,14200446
1643632476,197966,true,2528574236,28,2533382853,4808617
1643632520,197971,true,2527310328,28,2532622990,5312662
1643632663,197976,true,2526047052,28,2531357059,5310007
1643632755,197974,true,2526552286,28,2531357059,4804773
1643632993,197973,true,2526804942,28,2531863355,5058413
1643634367,197978,true,2525541918,28,2537439307,11897389
1643634425,197982,true,2524531954,28,2537439307,12907353
1643634785,197980,true,2525036886,28,2536424585,11387699
1643634842,197979,true,2525289389,28,2536170968,10881579
1643635811,197982,true,2524531954,28,2538454435,13922481
1643635902,197986,true,2523522394,28,2538962152,15439758
1643635918,197983,true,2524279526,28,2538962152,14682626
1643635981,197983,true,2524279526,28,2539469969,15190443
1643636097,197984,true,2524027123,28,2540485910,16458787
1643636194,197986,true,2523522394,28,2541248132,17725738
1643636452,197983,true,2524279526,28,2544553737,20274211
1643636491,197982,true,2524531954,28,2545317180,20785226
1643636541,197983,true,2524279526,28,2546080851,21801325
1643636686,197985,true,2523774746,28,2547863643,24088897
1643636942,197981,true,2524784407,28,2550412653,25628246
1643638445,197980,true,2525036886,28,2560378184,35341298
1643639391,197980,true,2525036886,28,2560378184,35341298
1643639413,197982,true,2524531954,28,2560634222,36102268
1643639534,197977,true,2525794472,28,2561146375,35351903
1643639631,197976,true,2526047052,28,2561402489,35355437
1643639938,197974,true,2526552286,28,2563196009,36643723
1643640580,197974,true,2526552286,28,2567300200,40747914
1643640624,197968,true,2528068597,28,2567556930,39488333
1643640626,197966,true,2528574236,28,2567556930,38982694
1643640661,197965,true,2528827093,28,2567556930,38729837
1643640886,197966,true,2528574236,28,2568327274,39753038
1643640928,197960,true,2530091760,28,2568584107,38492347
1643640946,197958,true,2530597803,28,2568584107,37986304
1643641182,197957,true,2530850863,28,2570382655,39531792
1643641204,197957,true,2530850863,28,2570639693,39788830
1643641232,197951,true,2532369753,28,2570896757,38527004
1643641238,197950,true,2532622990,28,2570896757,38273767
1643641250,197947,true,2533382853,28,2570896757,37513904
1643641714,197947,true,2533382853,28,2575785860,42403007
1643642176,197940,true,2535156753,28,2582491281,47334528
1643642270,197938,true,2535663810,28,2584041163,48377353
1643642331,197935,true,2536424585,28,2585074935,48650350
1643642413,197934,true,2536678228,28,2587661173,50982945
1643642676,197925,true,2538962152,28,2595954537,56992385
1643642716,197922,true,2539723916,28,2597252774,57528858
1643642778,197918,true,2540739958,28,2599071396,58331438
1643643021,197916,true,2541248132,28,2606098019,64849887
1643643065,197907,true,2543536170,28,2607140615,63604445
1643643149,197903,true,2544553737,28,2608705290,64151553
1643645122,197899,true,2545571711,28,2623878983,78307272
1643645136,197898,true,2545826269,28,2624141371,78315102
1643645266,197888,true,2548373241,28,2624666226,76292985
1643645340,197885,true,2549137829,28,2625191185,76053356
1643646270,197879,true,2550667694,28,2633341497,82673803
1643647081,197878,true,2550922761,28,2639404849,88482088
1643647142,197868,true,2553474832,28,2639668790,86193958
1643647258,197865,true,2554240951,28,2639932757,85691806
1643647569,197858,true,2556029456,28,2641517112,85487656
1643647625,197857,true,2556285059,28,2641781264,85496205
1643647956,197847,true,2558842495,28,2644424235,85581740
1643647967,197844,true,2559610224,28,2644688677,85078453
1643648080,197837,true,2561402489,28,2646540515,85138026
1643648140,197835,true,2561914795,28,2647599290,85684495
1643648306,197824,true,2564734311,28,2651308339,86574028
1643648371,197820,true,2565760359,28,2652899522,87139163
1643648776,197813,true,2567556930,28,2662466692,94909762
1643648855,197811,true,2568070467,28,2664330978,96260511
1643648929,197799,true,2571153847,28,2665663410,94509563
1643649012,197796,true,2571925270,28,2667263208,95337938
1643649625,197788,true,2573983531,28,2679828221,105844690
1643649925,197786,true,2574498353,28,2684119164,109620811
1643650006,197775,true,2577331718,28,2684387576,107055858
1643650557,197772,true,2578104995,28,2684656015,106551020
1643650590,197764,true,2580168201,28,2684924480,104756279
1643650724,197763,true,2580426217,28,2685192973,104766756
1643651319,197753,true,2583007805,28,2683045785,100037980
1643651822,197750,true,2583782785,28,2681972834,98190049
1643652271,197742,true,2585850535,28,2682241032,96390497
1643652307,197741,true,2586109120,28,2682241032,96131912
1643652408,197731,true,2588696393,28,2682241032,93544639
1643652699,197729,true,2589214158,28,2683314089,94099931
1643652744,197721,true,2591286255,28,2683582421,92296166
1643652806,197719,true,2591804538,28,2683850779,92046241
1643653442,197709,true,2594397509,28,2684656015,90258506
1643653996,197707,true,2594916414,28,2684656015,89739601
1643654437,197700,true,2596733401,28,2684119164,87385763
1643654870,197699,true,2596993074,28,2683582421,86589347
1643654881,197689,true,2599591236,28,2683582421,83991185
1643656026,197687,true,2600111181,28,2685461492,85350311
1643656085,197680,true,2601931804,28,2685730038,83798234
1643656126,197679,true,2602191998,28,2685998611,83806613
1643656157,197670,true,2604534907,28,2686267211,81732304
1643656271,197667,true,2605316346,28,2687073172,81756826
1643656658,197659,true,2607401329,28,2689761454,82360125
1643656766,197658,true,2607662069,28,2690568463,82906394
1643657405,197649,true,2610009904,28,2694068302,84058398
1643657467,197647,true,2610531932,28,2694337709,83805777
1643657610,197638,true,2612882351,28,2694607142,81724791
1643657873,197637,true,2613143639,28,2694607142,81463503
1643657886,197628,true,2615496409,28,2694607142,79110733
1643657973,197625,true,2616281136,28,2694068302,77787166
1643657995,197617,true,2618374894,28,2693798922,75424028
1643658003,197617,true,2618374894,28,2693798922,75424028
1643658529,197612,true,2619684343,28,2687610613,67926270
1643658724,197609,true,2620470327,28,2684924480,64454153
1643659394,197602,true,2622305207,28,2676346882,54041675
1643660150,197601,true,2622567437,28,2674474188,51906751
1643660323,197596,true,2623878983,28,2674474188,50595205
1643660644,197594,true,2624403785,28,2674474188,50070403
1643661180,197585,true,2626766694,28,2674206768,47440074
1643661997,197582,true,2627554803,28,2674474188,46919385
1643662185,197577,true,2628868843,28,2675009110,46140267
1643662264,197574,true,2629657582,28,2675811693,46154111
1643664053,197564,true,2632288424,28,2685730038,53441614
1643665364,197561,true,2633078189,28,2685730038,52651849
1643665415,197556,true,2634394992,28,2685730038,51335046
1643667700,197553,true,2635185389,28,2684119164,48933775
1643667711,197544,true,2637558005,28,2684387576,46829571
1643668306,197540,true,2638613186,28,2688148162,49534976
1643669370,197535,true,2639932757,28,2695415605,55482848
1643669940,197532,true,2640724816,28,2695146091,54421275
1643669979,197523,true,2643102419,28,2695146091,52043672
1643671094,197519,true,2644159819,28,2691106604,46946785
1643671357,197515,true,2645217641,28,2690568463,45350822
1643673723,197512,true,2646011286,28,2687610613,41599327
1643674049,197504,true,2648128836,28,2687073172,38944336
1643674124,197501,true,2648923354,28,2687073172,38149818
1643674146,197496,true,2650248081,28,2687073172,36825091
1643674727,197493,true,2651043235,28,2692452426,41409191
1643674736,197484,true,2653430128,28,2692452426,39022298
1643674815,197481,true,2654226237,28,2692721672,38495435
1643677266,197478,true,2655022584,28,2690568463,35545879
1643677513,197475,true,2655819171,28,2690837520,35018349
1643677640,197466,true,2658210364,28,2690837520,32627156
1643677829,197463,true,2659007907,28,2691106604,32098697
1643677886,197460,true,2659805689,28,2691375715,31570026
1643678003,197457,true,2660603711,28,2691644852,31041141
1643678222,197449,true,2662732939,28,2692183208,29450269
1643678555,197446,true,2663531839,28,2693260243,29728404
1643679112,197443,true,2664330978,28,2694876603,30545625
1643680005,197440,true,2665130357,28,2697572693,32442336
1643680094,197432,true,2667263208,28,2697572693,30309485
1643680105,197429,true,2668063467,28,2697572693,29509226
1643680131,197425,true,2669130852,28,2697572693,28441841
1643680287,197423,true,2669664705,28,2697033259,27368554
1643681020,197416,true,2671534031,28,2693798922,22264891
1643682392,197413,true,2672335572,28,2688148162,15812590
1643682690,197410,true,2673137352,28,2688954687,15817335
1643682876,197407,true,2673939374,28,2689223583,15284209
1643683178,197401,true,2675544139,28,2690299433,14755294
1643683201,197399,true,2676079274,28,2690568463,14489189
1643683269,197396,true,2676882178,28,2690837520,13955342
1643683809,197393,true,2677685323,28,2695146091,17460768
1643683870,197387,true,2679292336,28,2695954716,16662380
1643684410,197385,true,2679828221,28,2701892048,22063827
1643684890,197384,true,2680096204,28,2706218319,26122115
1643685053,197381,true,2680900313,28,2710009488,29109175
1643685092,197375,true,2682509256,28,2710551517,28042261
1643685321,197372,true,2683314089,28,2715163143,31849054
1643685512,197369,true,2684119164,28,2718966843,34847679
1643685676,197366,true,2684924480,28,2721959202,37034722
1643685861,197360,true,2686535838,28,2724682387,38146549
1643685931,197357,true,2687341879,28,2725772423,38430544
1643687258,197354,true,2688148162,28,2740530668,52382506
1643687667,197350,true,2689223583,28,2743272432,54048849
1643688310,197346,true,2690299433,28,2746016939,55717506
1643688323,197343,true,2691106604,28,2746291541,55184937
1643688349,197339,true,2692183208,28,2746291541,54108333
1643688403,197336,true,2692990944,28,2746566170,53575226
1643688491,197331,true,2694337709,28,2747390222,53052513
1643688677,197328,true,2695146091,28,2749039069,53892978
1643688945,197325,true,2695954716,28,2751789345,55834629
1643689033,197321,true,2697033259,28,2752614965,55581706
1643689042,197317,true,2698112234,28,2752890226,54777992
1643689159,197315,true,2698651884,28,2753165515,54513631
1643689183,197314,true,2698921749,28,2753440832,54519083
1643689365,197311,true,2699731506,28,2753991547,54260041
1643689433,197308,true,2700541507,28,2753991547,53450040
1643689626,197305,true,2701351750,28,2754542373,53190623
1643689658,197305,true,2701351750,28,2754542373,53190623
1643689690,197301,true,2702432453,28,2754542373,52109920
1643690251,197299,true,2702972967,28,2753716176,50743209
1643691497,197298,true,2703243264,28,2746566170,43322906
1643692543,197297,true,2703513588,28,2746566170,43052582
1643693203,197293,true,2704595156,28,2745467818,40872662
1643693223,197291,true,2705136102,28,2745467818,40331716
1643693227,197289,true,2705677156,28,2745467818,39790662
1643695208,197289,true,2705677156,28,2743272432,37595276
1643695238,197285,true,2706759589,28,2743272432,36512843
1643695667,197283,true,2707300968,28,2742723860,35422892
1643695684,197281,true,2707842456,28,2742449615,34607159
1643695735,197281,true,2707842456,28,2742175397,34332941
1643696014,197278,true,2708654890,28,2740530668,31875778
1643696095,197277,true,2708925755,28,2739982644,31056889
1643698374,197276,true,2709196648,28,2729318054,20121406
1643698722,197275,true,2709467567,28,2729318054,19850487
1643698735,197272,true,2710280489,28,2729590986,19310497
1643699003,197271,true,2710551517,28,2729863945,19312428
1643699009,197269,true,2711093654,28,2729863945,18770291
1643699033,197269,true,2711093654,28,2730136932,19043278
1643699139,197266,true,2711907064,28,2730409945,18502881
1643699171,197265,true,2712178255,28,2730409945,18231690
1643699371,197263,true,2712720717,28,2731502273,18781556
1643699507,197262,true,2712991989,28,2732321806,19329817
1643701007,197260,true,2713534615,28,2738339230,24804615
1643703171,197259,true,2713805968,28,2738339230,24533262
1643703960,197257,true,2714348757,28,2738339230,23990473
1643704972,197257,true,2714348757,28,2738886925,24538168
1643705065,197255,true,2714891654,28,2739434730,24543076
1643705308,197253,true,2715434659,28,2740804721,25370062
1643705321,197251,true,2715977773,28,2740804721,24826948
1643705451,197249,true,2716520996,28,2742175397,25654401
1643705459,197246,true,2717336034,28,2742449615,25113581
1643705468,197243,true,2718151316,28,2742723860,24572544
1643705486,197241,true,2718694974,28,2742998132,24303158
1643705497,197235,true,2720326598,28,2743272432,22945834
1643705529,197233,true,2720870691,28,2743821114,22950423
1643705565,197231,true,2721414892,28,2744369906,22955014
1643706063,197229,true,2721959202,28,2751239070,29279868
1643706095,197223,true,2723592786,28,2752339731,28746945
1643706102,197221,true,2724137532,28,2752339731,28202199
1643706218,197218,true,2724954855,28,2755093309,30138454
1643706373,197215,true,2725772423,28,2758952948,33180525
1643706408,197209,true,2727408296,28,2760332700,32924404
1643706573,197206,true,2728226600,28,2765582055,37355455
1643706877,197204,true,2728772273,28,2774723093,45950820
1643707030,197200,true,2729863945,28,2778888093,49024148
1643707078,197194,true,2731502273,28,2780277815,48775542
1643707142,197192,true,2732048601,28,2781390093,49341492
1643707307,197190,true,2732595038,28,2783615984,51020946
1643707449,197187,true,2733414898,28,2785008070,51593172
1643707522,197182,true,2734781879,28,2785565100,50783221
1643707573,197180,true,2735328863,28,2786122241,50793378
1643707693,197179,true,2735602396,28,2786679493,51077097
1643707830,197176,true,2736423159,28,2786958161,50535002
1643707912,197171,true,2737791644,28,2786400853,48609209
1643708128,197170,true,2738065423,28,2783894345,45828922
1643708217,197169,true,2738339230,28,2781946399,43607169
1643708301,197167,true,2738886925,28,2780277815,41390890
1643708439,197162,true,2740256642,28,2777499066,37242424
1643708461,197162,true,2740256642,28,2776943649,36687007
1643708475,197162,true,2740256642,28,2776665982,36409340
1643708501,197159,true,2741078801,28,2775833149,34754348
1643708594,197154,true,2742449615,28,2773613482,31163867
1643708611,197154,true,2742449615,28,2773058842,30609227
1643708621,197154,true,2742449615,28,2772781564,30331949
1643709437,197152,true,2742998132,28,2753716176,10718044
1643709484,197147,true,2744369906,28,2752890226,8520320
1643710549,197148,true,2744095496,28,2741901207,-2194289
1643710586,197148,true,2744095496,28,2741627045,-2468451
1643711381,197147,true,2744369906,28,2734508428,-9861478
1643711480,197142,true,2745742365,28,2733961609,-11780756
1643711525,197144,true,2745193299,28,2733688240,-11505059
1643711657,197144,true,2745193299,28,2733141584,-12051715
1643711830,197143,true,2745467818,28,2732321806,-13146012
1643712158,197138,true,2746840827,28,2731229150,-15611677
1643712509,197139,true,2746566170,28,2730956055,-15610115
1643712584,197138,true,2746840827,28,2731229150,-15611677
1643713352,197136,true,2747390222,28,2735055357,-12334865
1643714195,197131,true,2748764192,28,2737244168,-11520024
1643714235,197132,true,2748489343,28,2737517892,-10971451
1643714345,197131,true,2748764192,28,2738339230,-10424962
1643714450,197130,true,2749039069,28,2738613064,-10426005
1643714457,197125,true,2750413863,28,2738613064,-11800799
1643714558,197126,true,2750138849,28,2739434730,-10704119
1643714569,197125,true,2750413863,28,2739434730,-10979133
1643714747,197124,true,2750688905,28,2741352909,-9335996
1643715396,197118,true,2752339731,28,2748214522,-4125209
1643715854,197120,true,2751789345,28,2752890226,1100881
1643716704,197120,true,2751789345,28,2756195512,4406167
1643717744,197119,true,2752064524,28,2759780717,7716193
1643718154,197115,true,2753165515,28,2762541740,9376225
1643718377,197117,true,2752614965,28,2764476099,11861134
1643718685,197116,true,2752890226,28,2766965123,14074897
1643718775,197115,true,2753165515,28,2767795296,14629781
1643718856,197111,true,2754266946,28,2768348882,14081936
1643720341,197113,true,2753716176,28,2778332399,24616223
1643720637,197112,true,2753991547,28,2778888093,24896546
1643720945,197111,true,2754266946,28,2778610232,24343286
1643721334,197107,true,2755368819,28,2778610232,23241413
1643721961,197108,true,2755093309,28,2780555843,25462534
1643722072,197108,true,2755093309,28,2781111982,26018673
1643722290,197107,true,2755368819,28,2782502816,27133997
1643722342,197104,true,2756195512,28,2782781066,26585554
1643722371,197105,true,2755919920,28,2782502816,26582896
1643722809,197105,true,2755919920,28,2781668232,25748312
1643722862,197105,true,2755919920,28,2781946399,26026479
1643722902,197101,true,2757022453,28,2781946399,24923946
1643722928,197102,true,2756746778,28,2782224593,25477815
1643723273,197101,true,2757022453,28,2783894345,26871892
1643723589,197101,true,2757022453,28,2784729597,27707144
1643723821,197097,true,2758125428,28,2785286571,27161143
1643724034,197097,true,2758125428,28,2786400853,28275425
1643724035,197096,true,2758401240,28,2786400853,27999613
1643724204,197094,true,2758952948,28,2787515580,28562632
1643724219,197090,true,2760056695,28,2787794332,27737637
1643724234,197091,true,2759780717,28,2788073111,28292394
1643724462,197089,true,2760332700,28,2791978952,31646252
1643725384,197087,true,2760884795,28,2801767509,40882714
1643725856,197082,true,2762265513,28,2804290108,42024595
1643725934,197083,true,2761989314,28,2804570537,42581223
1643726077,197081,true,2762541740,28,2804009707,41467967
1643726248,197079,true,2763094276,28,2803448990,40354714
1643726537,197075,true,2764199679,28,2801207239,37007560
1643726605,197076,true,2763923287,28,2800647082,36723795
1643726700,197073,true,2764752547,28,2799247178,34494631
1643726742,197072,true,2765029022,28,2798407572,33378550
1643726862,197069,true,2765858614,28,2796449470,30590856
1643726998,197070,true,2765582055,28,2793654558,28072503
1643727020,197067,true,2766411813,28,2793375220,26963407
1643727299,197066,true,2766688454,28,2788909617,22221163
1643727684,197063,true,2767518544,28,2782224593,14706049
1643727743,197065,true,2766965123,28,2781111982,14146859
1643727753,197063,true,2767518544,28,2780833898,13315354
1643727789,197062,true,2767795296,28,2779999815,12204519
1643727876,197061,true,2768072075,28,2777499066,9426991
1643728023,197064,true,2767241819,28,2773058842,5817023
1643728937,197062,true,2767795296,28,2755368819,-12426477
1643729116,197061,true,2768072075,28,2753165515,-14906560
1643729728,197060,true,2768348882,28,2750963973,-17384909
1643730798,197062,true,2767795296,28,2754266946,-13528350
1643730940,197060,true,2768348882,28,2754266946,-14081936
1643731088,197059,true,2768625717,28,2754266946,-14358771
1643731209,197059,true,2768625717,28,2754817827,-13807890
1643731626,197061,true,2768072075,28,2757298155,-10773920
1643732059,197059,true,2768625717,28,2762817994,-5807723
1643733213,197057,true,2769179470,28,2775555594,6376124
1643733370,197060,true,2768348882,28,2776943649,8594767
1643733400,197060,true,2768348882,28,2777221343,8872461
1643734251,197057,true,2769179470,28,2782502816,13323346
1643734296,197055,true,2769733334,28,2782781066,13047732
1643734365,197057,true,2769179470,28,2783337650,14158180
1643734630,197057,true,2769179470,28,2785286571,16107101
1643734687,197054,true,2770010307,28,2785843656,15833349
1643734837,197053,true,2770287308,28,2788351919,18064611
1643734948,197055,true,2769733334,28,2789746373,20013039
1643735083,197056,true,2769456388,28,2791141526,21685138
1643735121,197053,true,2770287308,28,2791420640,21133332
1643735540,197053,true,2770287308,28,2794772187,24484879
1643735641,197055,true,2769733334,28,2795610703,25877369
1643735808,197055,true,2769733334,28,2796449470,26716136
1643736421,197053,true,2770287308,28,2798127759,27840451
1643736447,197052,true,2770564337,28,2798127759,27563422
1643736774,197054,true,2770010307,28,2794772187,24761880
1643736828,197054,true,2770010307,28,2794213317,24203010
1643740145,197053,true,2770287308,28,2777776815,7489507
1643740265,197051,true,2770841393,28,2778332399,7491006
1643740310,197053,true,2770287308,28,2778610232,8322924
1643740322,197053,true,2770287308,28,2778610232,8322924
1643740325,197050,true,2771118477,28,2778610232,7491755
1643741227,197047,true,2771949896,28,2785565100,13615204
1643741395,197049,true,2771395589,28,2786679493,15283904
1643741443,197049,true,2771395589,28,2786958161,15562572
1643741493,197046,true,2772227091,28,2787236857,15009766
1643741800,197043,true,2773058842,28,2788073111,15014269
1643741827,197045,true,2772504314,28,2788073111,15568797
1643742010,197045,true,2772504314,28,2787515580,15011266
1643742569,197042,true,2773336148,28,2782781066,9444918
1643743232,197040,true,2773890843,28,2775833149,1942306
1643743261,197041,true,2773613482,28,2775278066,1664584
1643743487,197041,true,2773613482,28,2771395589,-2217893
1643743874,197039,true,2774168232,28,2766411813,-7756419
1643743975,197037,true,2774723093,28,2765305525,-9417568
1643746462,197038,true,2774445649,28,2761989314,-12456335
1643747868,197037,true,2774723093,28,2765029022,-9694071
1643748192,197035,true,2775278066,28,2765858614,-9419452
1643748223,197033,true,2775833149,28,2765858614,-9974535
1643748322,197034,true,2775555594,28,2766688454,-8867140
1643748958,197031,true,2776388344,28,2771118477,-5269867
1643749395,197029,true,2776943649,28,2775000566,-1943083
1643750597,197027,true,2777499066,28,2781668232,4169166
1643750622,197028,true,2777221343,28,2781946399,4725056
1643751533,197026,true,2777776815,28,2784172735,6395920
1643751665,197023,true,2778610232,28,2784451152,5840920
1643752698,197021,true,2779165982,28,2786400853,7234871
1643752790,197023,true,2778610232,28,2786400853,7790621
1643753040,197020,true,2779443898,28,2787236857,7792959
1643754858,197017,true,2780277815,28,2797008788,16730973
1643754956,197016,true,2780555843,28,2797008788,16452945
1643754970,197017,true,2780277815,28,2797008788,16730973
1643754985,197015,true,2780833898,28,2797008788,16174890
1643755137,197013,true,2781390093,28,2795890264,14500171
1643755346,197012,true,2781668232,28,2794213317,12545085
1643757463,197014,true,2781111982,28,2783894345,2782363
1643757754,197012,true,2781668232,28,2783894345,2226113
1643757896,197011,true,2781946399,28,2784451152,2504753
1643758297,197011,true,2781946399,28,2786400853,4454454
1643758451,197012,true,2781668232,28,2787515580,5847348
1643758696,197010,true,2782224593,28,2788909617,6685024
1643760069,197009,true,2782502816,28,2794772187,12269371
1643760488,197009,true,2782502816,28,2794772187,12269371
1643760550,197010,true,2782224593,28,2794772187,12547594
1643760564,197009,true,2782502816,28,2794772187,12269371
1643760709,197007,true,2783059344,28,2794772187,11712843
1643761118,197007,true,2783059344,28,2794492738,11433394
1643761138,197009,true,2782502816,28,2794492738,11989922
1643761292,197008,true,2782781066,28,2794772187,11991121
1643761891,197005,true,2783615984,28,2795331170,11715186
1643761999,197005,true,2783615984,28,2795051665,11435681
1643762291,197007,true,2783059344,28,2793375220,10315876
1643762327,197006,true,2783337650,28,2792816629,9478979
1643762334,197006,true,2783337650,28,2792816629,9478979
1643763189,197007,true,2783059344,28,2781946399,-1112945
1643763907,197009,true,2782502816,28,2775000566,-7502250
1643764832,197008,true,2782781066,28,2775000566,-7780500
1643765143,197008,true,2782781066,28,2774445649,-8335417
1643765177,197009,true,2782502816,28,2774168232,-8334584
1643765434,197012,true,2781668232,28,2772504314,-9163918
1643765460,197012,true,2781668232,28,2772227091,-9441141
1643766067,197013,true,2781390093,28,2766411813,-14978280
1643767474,197015,true,2780833898,28,2757849643,-22984255
1643767487,197018,true,2779999815,28,2757849643,-22150172
1643768109,197018,true,2779999815,28,2755919920,-24079895
1643768461,197019,true,2779721843,28,2756195512,-23526331
1643768496,197021,true,2779165982,28,2756195512,-22970470
1643769754,197023,true,2778610232,28,2764199679,-14410553
1643770502,197021,true,2779165982,28,2767241819,-11924163
1643770637,197022,true,2778888093,28,2767518544,-11369549
1643770694,197024,true,2778332399,28,2767518544,-10813855
1643770787,197024,true,2778332399,28,2767795296,-10537103
1643771227,197022,true,2778888093,28,2768902580,-9985513
1643771359,197023,true,2778610232,28,2769179470,-9430762
1643771546,197024,true,2778332399,28,2769733334,-8599065
1643771558,197024,true,2778332399,28,2769733334,-8599065
1643771676,197022,true,2778888093,28,2770287308,-8600785
1643771700,197023,true,2778610232,28,2770564337,-8045895
1643774886,197022,true,2778888093,28,2786122241,7234148
1643774915,197020,true,2779443898,28,2786122241,6678343
1643775004,197016,true,2780555843,28,2786122241,5566398
1643775167,197017,true,2780277815,28,2785565100,5287285
1643775261,197018,true,2779999815,28,2785286571,5286756
1643775909,197016,true,2780555843,28,2783059344,2503501
1643776106,197013,true,2781390093,28,2782502816,1112723
1643776407,197014,true,2781111982,28,2780833898,-278084
1643776455,197014,true,2781111982,28,2780555843,-556139
1643776928,197013,true,2781390093,28,2778332399,-3057694
1643777047,197011,true,2781946399,28,2777499066,-4447333
1643777267,197014,true,2781111982,28,2776388344,-4723638
1643777402,197015,true,2780833898,28,2775555594,-5278304
1643779252,197014,true,2781111982,28,2768348882,-12763100
1643780089,197013,true,2781390093,28,2765029022,-16361071
1643780493,197016,true,2780555843,28,2763370585,-17185258
1643781084,197017,true,2780277815,28,2760884795,-19393020
1643781218,197018,true,2779999815,28,2760884795,-19115020
1643781639,197016,true,2780555843,28,2760884795,-19671048
1643782171,197020,true,2779443898,28,2760884795,-18559103
1643782335,197022,true,2778888093,28,2761160883,-17727210
1643782356,197022,true,2778888093,28,2761160883,-17727210
1643782459,197021,true,2779165982,28,2761436999,-17728983
1643782857,197024,true,2778332399,28,2763094276,-15238123
1643783729,197025,true,2778054593,28,2768902580,-9152013
1643783770,197026,true,2777776815,28,2768902580,-8874235
1643784192,197025,true,2778054593,28,2768902580,-9152013
1643784208,197028,true,2777221343,28,2768625717,-8595626
1643784233,197030,true,2776665982,28,2768625717,-8040265
1643784263,197030,true,2776665982,28,2768348882,-8317100
1643785532,197030,true,2776665982,28,2756195512,-20470470
1643788522,197031,true,2776388344,28,2753440832,-22947512
1643790035,197033,true,2775833149,28,2752890226,-22942923
1643791771,197033,true,2775833149,28,2756471131,-19362018
1643792600,197033,true,2775833149,28,2756471131,-19362018
1643792624,197035,true,2775278066,28,2756746778,-18531288
1643793674,197037,true,2774723093,28,2758125428,-16597665
1643794118,197037,true,2774723093,28,2758952948,-15770145
1643794704,197037,true,2774723093,28,2759780717,-14942376
1643794988,197039,true,2774168232,28,2760056695,-14111537
1643795136,197041,true,2773613482,28,2760332700,-13280782
1643795208,197040,true,2773890843,28,2760332700,-13558143
1643795365,197039,true,2774168232,28,2760608734,-13559498
1643795500,197041,true,2773613482,28,2761160883,-12452599
1643797961,197041,true,2773613482,28,2768625717,-4987765
1643800056,197041,true,2773613482,28,2768625717,-4987765
1643800217,197039,true,2774168232,28,2768625717,-5542515
1643800701,197040,true,2773890843,28,2767795296,-6095547
1643800788,197040,true,2773890843,28,2767795296,-6095547
1643801028,197040,true,2773890843,28,2767241819,-6649024
1643801045,197039,true,2774168232,28,2767241819,-6926413
1643801373,197040,true,2773890843,28,2766688454,-7202389
1643801413,197039,true,2774168232,28,2766411813,-7756419
1643801586,197040,true,2773890843,28,2766135199,-7755644
1643803404,197040,true,2773890843,28,2764476099,-9414744
1643803424,197042,true,2773336148,28,2764476099,-8860049
1643803436,197042,true,2773336148,28,2764752547,-8583601
1643803648,197042,true,2773336148,28,2765305525,-8030623
1643803823,197042,true,2773336148,28,2766411813,-6924335
1643803856,197043,true,2773058842,28,2766965123,-6093719
1643805294,197042,true,2773336148,28,2786400853,13064705
1643805314,197042,true,2773336148,28,2786679493,13343345
1643805802,197042,true,2773336148,28,2788351919,15015771
1643805850,197044,true,2772781564,28,2788351919,15570355
1643805883,197043,true,2773058842,28,2788351919,15293077
1643805950,197043,true,2773058842,28,2788630754,15571912
1643806264,197041,true,2773613482,28,2790862439,17248957
1643806361,197042,true,2773336148,28,2791699782,18363634
1643807528,197040,true,2773890843,28,2802327890,28437047
1643807628,197041,true,2773613482,28,2803168673,29555191
1643807701,197039,true,2774168232,28,2803448990,29280758
1643807888,197040,true,2773890843,28,2803168673,29277830
1643807902,197039,true,2774168232,28,2803168673,29000441
1643807932,197040,true,2773890843,28,2802888384,28997541
1643808277,197039,true,2774168232,28,2800927147,26758915
1643808839,197040,true,2773890843,28,2794772187,20881344
1643809482,197040,true,2773890843,28,2788351919,14461076
1643809609,197041,true,2773613482,28,2787236857,13623375
1643810333,197040,true,2773890843,28,2785008070,11117227
1643810421,197042,true,2773336148,28,2785008070,11671922
1643810700,197041,true,2773613482,28,2784172735,10559253
1643811412,197042,true,2773336148,28,2781946399,8610251
1643811516,197042,true,2773336148,28,2781390093,8053945
1643811610,197044,true,2772781564,28,2780833898,8052334
1643811828,197043,true,2773058842,28,2779165982,6107140
1643812308,197045,true,2772504314,28,2775278066,2773752
1643812333,197045,true,2772504314,28,2775000566,2496252
1643812400,197046,true,2772227091,28,2774445649,2218558
1643812428,197044,true,2772781564,28,2773890843,1109279
1643812440,197047,true,2771949896,28,2773613482,1663586
1643812713,197048,true,2771672729,28,2768072075,-3600654
1643812978,197050,true,2771118477,28,2762265513,-8852964
1643812996,197049,true,2771395589,28,2761989314,-9406275
1643813083,197051,true,2770841393,28,2759504766,-11336627
1643813338,197053,true,2770287308,28,2750688905,-19598403
1643813360,197055,true,2769733334,28,2750138849,-19594485
1643813369,197054,true,2770010307,28,2749863863,-20146444
1643813404,197057,true,2769179470,28,2748489343,-20690127
1643813823,197060,true,2768348882,28,2732595038,-35753844
1643813843,197062,true,2767795296,28,2731775423,-36019873
1643814101,197061,true,2768072075,28,2720870691,-47201384
1643814253,197065,true,2766965123,28,2715706203,-51258920
1643814262,197069,true,2765858614,28,2715434659,-50423955
1643814273,197072,true,2765029022,28,2715163143,-49865879
1643814288,197071,true,2765305525,28,2714891654,-50413871
1643814829,197075,true,2764199679,28,2699191641,-65008038
1643814909,197080,true,2762817994,28,2697302962,-65515032
1643815119,197083,true,2761989314,28,2693260243,-68729071
1643815128,197082,true,2762265513,28,2692990944,-69274569
1643815391,197087,true,2760884795,28,2688954687,-71930108
1643815943,197093,true,2759228843,28,2683045785,-76183058
1643816020,197096,true,2758401240,28,2682241032,-76160208
1643816068,197096,true,2758401240,28,2681436520,-76964720
1643816124,197102,true,2756746778,28,2680900313,-75846465
1643816169,197108,true,2755093309,28,2680364214,-74729095
1643816416,197111,true,2754266946,28,2676882178,-77384768
1643816649,197111,true,2754266946,28,2673939374,-80327572
1643816722,197117,true,2752614965,28,2673404666,-79210299
1643817231,197122,true,2751239070,28,2672870065,-78369005
1643817325,197125,true,2750413863,28,2672602805,-77811058
1643817339,197125,true,2750413863,28,2672602805,-77811058
1643817469,197130,true,2749039069,28,2672335572,-76703497
1643817653,197136,true,2747390222,28,2671534031,-75856191
1643817825,197139,true,2746566170,28,2670465685,-76100485
1643817848,197138,true,2746840827,28,2670198665,-76642162
1643818087,197144,true,2745193299,28,2669130852,-76062447
1643818386,197150,true,2743546759,28,2667796687,-75750072
1643818518,197153,true,2742723860,28,2666729835,-75994025
1643818826,197153,true,2742723860,28,2661934279,-80789581
1643818855,197158,true,2741352909,28,2661668112,-79684797
1643819209,197164,true,2739708673,28,2657413061,-82295612
1643819252,197168,true,2738613064,28,2656881658,-81731406
1643819258,197167,true,2738886925,28,2656881658,-82005267
1643819934,197172,true,2737517892,28,2655819171,-81698721
1643820517,197178,true,2735875956,28,2656615996,-79259960
1643820761,197182,true,2734781879,28,2657678802,-77103077
1643820926,197182,true,2734781879,28,2658742033,-76039846
1643821595,197186,true,2733688240,28,2662200472,-71487768
1643821687,197191,true,2732321806,28,2662732939,-69588867
1643821708,197195,true,2731229150,28,2662732939,-68496211
1643822484,197193,true,2731775423,28,2675811693,-55963730
1643822514,197196,true,2730956055,28,2676079274,-54876781
1643823208,197200,true,2729863945,28,2683850779,-46013166
1643823682,197204,true,2728772273,28,2685461492,-43310781
1643823874,197202,true,2729318054,28,2684656015,-44662039
1643825017,197206,true,2728226600,28,2678488709,-49737891
1643825083,197210,true,2727135582,28,2678488709,-48646873
1643825129,197214,true,2726045001,28,2678220887,-47824114
1643826517,197212,true,2726590237,28,2679828221,-46762016
1643827252,197216,true,2725499873,28,2680364214,-45135659
1643827587,197221,true,2724137532,28,2680364214,-43773318
1643827639,197225,true,2723048149,28,2680364214,-42683935
1643828383,197223,true,2723592786,28,2680900313,-42692473
1643828601,197226,true,2722775872,28,2681168404,-41607468
1643828823,197231,true,2721414892,28,2681704664,-39710228
1643828844,197235,true,2720326598,28,2681704664,-38621934
1643829009,197234,true,2720598631,28,2682509256,-38089375
1643829678,197237,true,2719782615,28,2686267211,-33515404
1643830327,197241,true,2718694974,28,2691914017,-26780957
1643830459,197245,true,2717607767,28,2692990944,-24616823
1643830489,197243,true,2718151316,28,2693260243,-24891073
1643830699,197245,true,2717607767,28,2695685147,-21922620
1643830797,197249,true,2716520996,28,2696763583,-19757413
1643831363,197252,true,2715706203,28,2702702696,-13003507
1643832148,197250,true,2716249371,28,2709196648,-7052723
1643832158,197252,true,2715706203,28,2709196648,-6509555
1643832793,197256,true,2714620192,28,2707842456,-6777736
1643832988,197260,true,2713534615,28,2707571699,-5962916
1643833149,197258,true,2714077349,28,2707300968,-6776381
1643833506,197260,true,2713534615,28,2709196648,-4337967
1643833708,197264,true,2712449472,28,2709738514,-2710958
1643834069,197268,true,2711364764,28,2710551517,-813247
1643834087,197267,true,2711635900,28,2710551517,-1084383
1643834141,197270,true,2710822572,28,2710822572,0
1643834338,197274,true,2709738514,28,2711093654,1355140
1643834611,197278,true,2708654890,28,2711635900,2981010
1643835272,197278,true,2708654890,28,2708384051,-270839
1643835330,197280,true,2708113240,28,2708654890,541650
1643835906,197285,true,2706759589,28,2712449472,5689883
1643835928,197289,true,2705677156,28,2712720717,7043561
1643836035,197288,true,2705947724,28,2713263289,7315565
1643836124,197291,true,2705136102,28,2713534615,8398513
1643836148,197297,true,2703513588,28,2713534615,10021027
1643836188,197301,true,2702432453,28,2713534615,11102162
1643836212,197300,true,2702702696,28,2713534615,10831919
1643836273,197303,true,2701892048,28,2713263289,11371241
1643836283,197309,true,2700271480,28,2713263289,12991809
1643836759,197313,true,2699191641,28,2710551517,11359876
1643836773,197312,true,2699461560,28,2710551517,11089957
1643836774,197315,true,2698651884,28,2710551517,11899633
1643836813,197321,true,2697033259,28,2710009488,12976229
1643836827,197326,true,2695685147,28,2710009488,14324341
1643836849,197325,true,2695954716,28,2709738514,13783798
1643836899,197328,true,2695146091,28,2708925755,13779664
1643836938,197334,true,2693529569,28,2708113240,14583671
1643837193,197340,true,2691914017,28,2701081642,9167625
1643837281,197339,true,2692183208,28,2698382046,6198838
1643837683,197341,true,2691644852,28,2687073172,-4571680
1643837715,197347,true,2690030430,28,2686267211,-3763219
1643837721,197353,true,2688416977,28,2685998611,-2418366
1643837736,197351,true,2688954687,28,2685730038,-3224649
1643837783,197353,true,2688416977,28,2684119164,-4297813
1643837797,197358,true,2687073172,28,2683850779,-3222393
1643837807,197364,true,2685461492,28,2683582421,-1879071
1643837822,197362,true,2685998611,28,2683045785,-2952826
1643837880,197367,true,2684656015,28,2680364214,-4291801
1643837975,197371,true,2683582421,28,2676079274,-7503147
1643838076,197376,true,2682241032,28,2672068365,-10172667
1643838405,197374,true,2682777507,28,2661401972,-21375535
1643838485,197378,true,2681704664,28,2658742033,-22962631
1643838565,197380,true,2681168404,28,2656084753,-25083651
1643838582,197384,true,2680096204,28,2655553615,-24542589
1643838610,197382,true,2680632250,28,2654757108,-25875142
1643838622,197386,true,2679560265,28,2654226237,-25334028
1643838883,197389,true,2678756558,28,2648128836,-30627722
1643839042,197393,true,2677685323,28,2644953146,-32732177
1643839055,197391,true,2678220887,28,2644688677,-33532210
1643839144,197394,true,2677417581,28,2642838135,-34579446
1643839209,197396,true,2676882178,28,2642045442,-34836736
1643839318,197398,true,2676346882,28,2640988888,-35357994
1643839466,197395,true,2677149866,28,2639932757,-37217109
1643839494,197397,true,2676614517,28,2639932757,-36681760
1643839716,197398,true,2676346882,28,2640988888,-35357994
1643839995,197400,true,2675811693,28,2644953146,-30858547
1643840042,197398,true,2676346882,28,2645482163,-30864719
1643840554,197400,true,2675811693,28,2651308339,-24503354
1643840561,197400,true,2675811693,28,2651573470,-24238223
1643840614,197402,true,2675276611,28,2652634258,-22642353
1643840624,197399,true,2676079274,28,2652899522,-23179752
1643840747,197399,true,2676079274,28,2655819171,-20260103
1643840768,197401,true,2675544139,28,2656084753,-19459386
1643841425,197401,true,2675544139,28,2665929976,-9614163
1643841465,197399,true,2676079274,28,2666463189,-9616085
1643841513,197399,true,2676079274,28,2667263208,-8816066
1643841530,197400,true,2675811693,28,2667529934,-8281759
1643841662,197399,true,2676079274,28,2669931672,-6147602
1643841963,197396,true,2676882178,28,2675544139,-1338039
1643842000,197395,true,2677149866,28,2676079274,-1070592
1643842500,197395,true,2677149866,28,2685461492,8311626
1643842890,197394,true,2677417581,28,2687341879,9924298
1643842956,197391,true,2678220887,28,2687610613,9389726
1643843008,197390,true,2678488709,28,2687610613,9121904
1643843627,197391,true,2678220887,28,2686804491,8583604
1643843684,197390,true,2678488709,28,2686804491,8315782
1643843742,197387,true,2679292336,28,2686804491,7512155
1643844655,197386,true,2679560265,28,2691106604,11546339
1643844779,197386,true,2679560265,28,2691644852,12084587
1643845012,197385,true,2679828221,28,2694068302,14240081
1643845510,197382,true,2680632250,28,2696763583,16131333
1643845551,197381,true,2680900313,28,2696763583,15863270
1643845558,197382,true,2680632250,28,2696763583,16131333
1643845929,197382,true,2680632250,28,2694876603,14244353
1643845958,197381,true,2680900313,28,2694607142,13706829
1643846001,197381,true,2680900313,28,2694337709,13437396
1643846052,197382,true,2680632250,28,2694068302,13436052
1643846245,197382,true,2680632250,28,2692183208,11550958
1643846519,197381,true,2680900313,28,2689761454,8861141
1643846700,197381,true,2680900313,28,2688685819,7785506
1643846782,197381,true,2680900313,28,2687879374,6979061
1643846813,197381,true,2680900313,28,2687610613,6710300
1643846905,197380,true,2681168404,28,2686804491,5636087
1643847025,197381,true,2680900313,28,2685730038,4829725
1643847054,197381,true,2680900313,28,2685461492,4561179
1643847136,197381,true,2680900313,28,2685192973,4292660
1643847268,197380,true,2681168404,28,2684656015,3487611
1643847304,197380,true,2681168404,28,2684656015,3487611
1643847413,197380,true,2681168404,28,2684924480,3756076
1643847669,197380,true,2681168404,28,2686267211,5098807
1643847714,197379,true,2681436520,28,2686535838,5099318
1643847836,197379,true,2681436520,28,2687073172,5636652
1643847862,197380,true,2681168404,28,2687341879,6173475
1643847901,197379,true,2681436520,28,2687610613,6174093
1643847974,197378,true,2681704664,28,2688685819,6981155
1643848239,197378,true,2681704664,28,2693260243,11555579
1643848410,197379,true,2681436520,28,2696224311,14787791
1643848468,197379,true,2681436520,28,2697302962,15866442
1643848477,197377,true,2681972834,28,2697302962,15330128
1643848499,197377,true,2681972834,28,2697572693,15599859
1643848637,197378,true,2681704664,28,2699731506,18026842
1643849112,197378,true,2681704664,28,2707030265,25325601
1643849206,197377,true,2681972834,28,2707842456,25869622
1643849331,197377,true,2681972834,28,2708384051,26411217
1643849497,197379,true,2681436520,28,2709196648,27760128
1643849959,197379,true,2681436520,28,2709738514,28301994
1643850591,197378,true,2681704664,28,2706488941,24784277
1643850667,197378,true,2681704664,28,2706218319,24513655
1643851133,197380,true,2681168404,28,2704595156,23426752
1643851236,197380,true,2681168404,28,2704595156,23426752
1643852727,197378,true,2681704664,28,2703513588,21808924
1643852809,197378,true,2681704664,28,2702972967,21268303
1643852873,197381,true,2680900313,28,2702702696,21802383
1643853089,197381,true,2680900313,28,2701351750,20451437
1643853339,197383,true,2680364214,28,2698921749,18557535
1643856411,197384,true,2680096204,28,2680900313,804109
1643856615,197385,true,2679828221,28,2680900313,1072092
1643857987,197385,true,2679828221,28,2683850779,4022558
1643858037,197386,true,2679560265,28,2684119164,4558899
1643858274,197386,true,2679560265,28,2684119164,4558899
1643858829,197388,true,2679024434,28,2683850779,4826345
1643859202,197387,true,2679292336,28,2683314089,4021753
1643859879,197388,true,2679024434,28,2681436520,2412086
1643860322,197388,true,2679024434,28,2679024434,0
1643860473,197390,true,2678488709,28,2677953092,-535617
1643860505,197389,true,2678756558,28,2677685323,-1071235
1643860532,197390,true,2678488709,28,2677417581,-1071128
1643860840,197390,true,2678488709,28,2674474188,-4014521
1643861325,197392,true,2677953092,28,2669130852,-8822240
1643862116,197389,true,2678756558,28,2664597411,-14159147
1643862640,197390,true,2678488709,28,2663798192,-14690517
1643862681,197391,true,2678220887,28,2663798192,-14422695
1643863256,197393,true,2677685323,28,2663531839,-14153484
1643864344,197391,true,2678220887,28,2661401972,-16818915
1643864814,197392,true,2677953092,28,2661135858,-16817234
1643864895,197392,true,2677953092,28,2661135858,-16817234
1643866076,197393,true,2677685323,28,2657147346,-20537977
1643866594,197391,true,2678220887,28,2656084753,-22136134
1643867463,197392,true,2677953092,28,2656881658,-21071434
1643869000,197390,true,2678488709,28,2657678802,-20809907
1643869111,197390,true,2678488709,28,2657678802,-20809907
1643869336,197388,true,2679024434,28,2657147346,-21877088
1643869650,197389,true,2678756558,28,2655819171,-22937387
1643869732,197387,true,2679292336,28,2655553615,-23738721
1643869942,197388,true,2679024434,28,2654491659,-24532775
1643872016,197386,true,2679560265,28,2649188246,-30372019
1643872020,197388,true,2679024434,28,2649453165,-29571269
1643872191,197385,true,2679828221,28,2649983082,-29845139
1643872224,197385,true,2679828221,28,2650248081,-29580140
1643872385,197382,true,2680632250,28,2651043235,-29589015
1643873217,197383,true,2680364214,28,2657944570,-22419644
1643873456,197380,true,2681168404,28,2660071670,-21096734
1643874465,197381,true,2680900313,28,2665663410,-15236903
1643874746,197380,true,2681168404,28,2666729835,-14438569
1643875677,197381,true,2680900313,28,2669664705,-11235608
1643875772,197379,true,2681436520,28,2669931672,-11504848
1643876008,197380,true,2681168404,28,2670732731,-10435673
1643876137,197378,true,2681704664,28,2671534031,-10170633
1643876379,197379,true,2681436520,28,2672335572,-9100948
1643876455,197377,true,2681972834,28,2672602805,-9370029
1643877856,197377,true,2681972834,28,2675811693,-6161141
1643878222,197375,true,2682509256,28,2675276611,-7232645
1643879756,197376,true,2682241032,28,2672602805,-9638227
1643879892,197376,true,2682241032,28,2672068365,-10172667
1643879999,197377,true,2681972834,28,2671266905,-10705929
1643880060,197376,true,2682241032,28,2670732731,-11508301
1643882208,197380,true,2681168404,28,2650248081,-30920323
1643882254,197380,true,2681168404,28,2650248081,-30920323
1643882278,197381,true,2680900313,28,2649983082,-30917231
1643882362,197382,true,2680632250,28,2649453165,-31179085
1643882379,197387,true,2679292336,28,2649188246,-30104090
1643882400,197387,true,2679292336,28,2648923354,-30368982
1643882466,197388,true,2679024434,28,2648128836,-30895598
1643882470,197390,true,2678488709,28,2648128836,-30359873
1643882546,197395,true,2677149866,28,2646805169,-30344697
1643882551,197396,true,2676882178,28,2646805169,-30077009
1643882583,197397,true,2676614517,28,2646011286,-30603231
1643882599,197399,true,2676079274,28,2645746711,-30332563
1643882693,197405,true,2674474188,28,2643631066,-30843122
1643882950,197407,true,2673939374,28,2637558005,-36381369
1643883142,197409,true,2673404666,28,2633078189,-40326477
1643883442,197411,true,2672870065,28,2625453704,-47416361
1643883469,197417,true,2671266905,28,2624666226,-46600679
1643883528,197419,true,2670732731,28,2623091977,-47640754
1643883738,197422,true,2669931672,28,2616542765,-53388907
1643883912,197424,true,2669397765,28,2611315170,-58082595
1643883954,197430,true,2667796687,28,2610009904,-57786783
1643884111,197432,true,2667263208,28,2605576878,-61686330
1643884146,197435,true,2666463189,28,2604795361,-61667828
1643884684,197436,true,2666196569,28,2598291831,-67904738
1643885278,197442,true,2664597411,28,2594138095,-70459316
1643886027,197444,true,2664064572,28,2594397509,-69667063
1643886206,197447,true,2663265512,28,2594656949,-68608563
1643887751,197448,true,2662999212,28,2594916414,-68082798
1643887769,197454,true,2661401972,28,2594916414,-66485558
1643887800,197455,true,2661135858,28,2594916414,-66219444
1643887834,197458,true,2660337677,28,2595175906,-65161771
1643887915,197458,true,2660337677,28,2595435424,-64902253
1643887955,197465,true,2658476185,28,2595694967,-62781218
1643887986,197466,true,2658210364,28,2595954537,-62255827
1643888143,197469,true,2657413061,28,2597512499,-59900562
1643888718,197469,true,2657413061,28,2603753703,-53659358
1643889914,197476,true,2655553615,28,2615496409,-40057206
1643889987,197477,true,2655288086,28,2615757959,-39530127
1643890008,197480,true,2654491659,28,2615496409,-38995250
1643890023,197480,true,2654491659,28,2615496409,-38995250
1643890193,197488,true,2652369021,28,2614711917,-37657104
1643891221,197491,true,2651573470,28,2608705290,-42868180
1643891260,197494,true,2650778157,28,2608183627,-42594530
1643891965,197495,true,2650513105,28,2597512499,-53000606
1643891999,197504,true,2648128836,28,2597252774,-50876062
1643892034,197509,true,2646805169,28,2596993074,-49812095
1643892367,197511,true,2646275887,28,2595694967,-50580920
1643892784,197511,true,2646275887,28,2594138095,-52137792
1643893033,197519,true,2644159819,28,2593878707,-50281112
1643893044,197524,true,2642838135,28,2593878707,-48959428
1643893162,197525,true,2642573878,28,2595175906,-47397972
1643893169,197524,true,2642838135,28,2595175906,-47662229
1643893401,197531,true,2640988888,28,2598291831,-42697057
1643894559,197536,true,2639668790,28,2609487980,-30180810
1643895107,197538,true,2639140935,28,2611315170,-27825765
1643895458,197537,true,2639404849,28,2612098643,-27306206
1643895555,197544,true,2637558005,28,2612621088,-24936917
1643895868,197548,true,2636503245,28,2613927660,-22575585
1643895910,197549,true,2636239621,28,2614189053,-22050568
1643895944,197548,true,2636503245,28,2614450472,-22052773
1643896023,197553,true,2635185389,28,2614711917,-20473472
1643896123,197557,true,2634131578,28,2614450472,-19681106
1643897013,197559,true,2633604831,28,2612098643,-21506188
1643897931,197558,true,2633868192,28,2606879927,-26988265
1643898021,197563,true,2632551652,28,2607140615,-25411037
1643898512,197568,true,2631235771,28,2607922835,-23312936
1643898711,197569,true,2630972674,28,2608183627,-22789047
1643898738,197568,true,2631235771,28,2608444446,-22791325
1643898796,197573,true,2629920548,28,2608705290,-21215258
1643898859,197577,true,2628868843,28,2608966161,-19902682
1643898884,197578,true,2628605982,28,2609227057,-19378925
1643898921,197576,true,2629131730,28,2609227057,-19904673
1643898981,197581,true,2627817558,28,2609227057,-18590501
1643898990,197584,true,2627029371,28,2609227057,-17802314
1643898999,197585,true,2626766694,28,2609227057,-17539637
1643899148,197583,true,2627292073,28,2610270905,-17021168
1643899199,197587,true,2626241419,28,2610531932,-15709487
1643899492,197590,true,2625453704,28,2612359853,-13093851
1643900100,197591,true,2625191185,28,2615757959,-9433226
1643900989,197589,true,2625716250,28,2618374894,-7341356
1643901150,197593,true,2624666226,28,2618374894,-6291332
1643901190,197596,true,2623878983,28,2618374894,-5504089
1643901222,197596,true,2623878983,28,2618374894,-5504089
1643901314,197594,true,2624403785,28,2618113083,-6290702
1643901351,197599,true,2623091977,28,2618113083,-4978894
1643901408,197602,true,2622305207,28,2618113083,-4192124
1643901533,197601,true,2622567437,28,2618636732,-3930705
1643901556,197599,true,2623091977,28,2618898595,-4193382
1643901634,197603,true,2622043003,28,2619422401,-2620602
1643901650,197605,true,2621518673,28,2619422401,-2096272
1643901714,197604,true,2621780825,28,2620208306,-1572519
1643903218,197600,true,2622829694,28,2638613186,15783492
1643903339,197604,true,2621780825,28,2639404849,17624024
1643904139,197606,true,2621256547,28,2637030572,15774025
1643904168,197605,true,2621518673,28,2637030572,15511899
1643904514,197603,true,2622043003,28,2635712453,13669450
1643904515,197608,true,2620732374,28,2635712453,14980079
1643904542,197610,true,2620208306,28,2635712453,15504147
1643904586,197609,true,2620470327,28,2635712453,15242126
1643904591,197607,true,2620994448,28,2635712453,14718005
1643904866,197612,true,2619684343,28,2635712453,16028110
1643905767,197613,true,2619422401,28,2642045442,22623041
1643905933,197613,true,2619422401,28,2643102419,23680018
1643906331,197610,true,2620208306,28,2645482163,25273857
1643906991,197616,true,2618636732,28,2643631066,24994334
1643907265,197618,true,2618113083,28,2641781264,23668181
1643907294,197618,true,2618113083,28,2641517112,23404029
1643907504,197616,true,2618636732,28,2639404849,20768117
1643907518,197621,true,2617327806,28,2639404849,22077043
1643907547,197624,true,2616542765,28,2638877048,22334283
1643907774,197624,true,2616542765,28,2635976024,19433259
1643907803,197622,true,2617066099,28,2635448908,18382809
1643907898,197625,true,2616281136,28,2634131578,17850442
1643908185,197628,true,2615496409,28,2629657582,14161173
1643908875,197628,true,2615496409,28,2620732374,5235965
1643908883,197627,true,2615757959,28,2620470327,4712368
1643909732,197628,true,2615496409,28,2614711917,-784492
1643909983,197631,true,2614711917,28,2614973388,261471
1643910489,197630,true,2614973388,28,2616804419,1831031
1643911825,197628,true,2615496409,28,2621256547,5760138
1643913755,197629,true,2615234886,28,2619160485,3925599
1643913903,197631,true,2614711917,28,2619684343,4972426
1643913991,197630,true,2614973388,28,2620208306,5234918
1643915475,197627,true,2615757959,28,2628605982,12848023
1643915603,197627,true,2615757959,28,2628868843,13110884
1643915615,197629,true,2615234886,28,2628868843,13633957
1643917026,197628,true,2615496409,28,2620994448,5498039
1643917166,197626,true,2616019535,28,2619946312,3926777
1643917240,197625,true,2616281136,28,2619160485,2879349
1643917268,197627,true,2615757959,28,2618898595,3140636
1643917302,197626,true,2616019535,28,2618636732,2617197
1643917461,197624,true,2616542765,28,2616804419,261654
1643918018,197624,true,2616542765,28,2611576301,-4966464
1643918636,197626,true,2616019535,28,2605576878,-10442657
1643918800,197625,true,2616281136,28,2604014079,-12267057
1643919049,197623,true,2616804419,28,2601931804,-14872615
1643919173,197623,true,2616804419,28,2601151381,-15653038
1643919233,197625,true,2616281136,28,2600891292,-15389844
1643919312,197625,true,2616281136,28,2600891292,-15389844
1643919829,197622,true,2617066099,28,2601151381,-15914718
1643920362,197622,true,2617066099,28,2601671637,-15394462
1643920381,197624,true,2616542765,28,2601671637,-14871128
1643920674,197624,true,2616542765,28,2601411496,-15131269
1643920735,197622,true,2617066099,28,2601151381,-15914718
1643920971,197623,true,2616804419,28,2600891292,-15913127
1643921375,197625,true,2616281136,28,2599851195,-16429941
1643921469,197625,true,2616281136,28,2599331303,-16949833
1643921503,197625,true,2616281136,28,2599331303,-16949833
1643921641,197626,true,2616019535,28,2598291831,-17727704
1643922032,197629,true,2615234886,28,2594656949,-20577937
1643922066,197629,true,2615234886,28,2594397509,-20837377
1643922073,197629,true,2615234886,28,2594397509,-20837377
1643922084,197629,true,2615234886,28,2594397509,-20837377
1643922130,197629,true,2615234886,28,2594656949,-20577937
1643922185,197628,true,2615496409,28,2594916414,-20579995
1643922204,197627,true,2615757959,28,2595175906,-20582053
1643923033,197626,true,2616019535,28,2605316346,-10703189
1643923072,197625,true,2616281136,28,2606098019,-10183117
1643923112,197624,true,2616542765,28,2606879927,-9662838
1643923131,197623,true,2616804419,28,2607140615,-9663804
1643923384,197621,true,2617327806,28,2612882351,-4445455
1643923928,197620,true,2617589539,28,2625978821,8389282
1643924019,197620,true,2617589539,28,2627029371,9439832
1643924111,197620,true,2617589539,28,2627554803,9965264
1643924139,197618,true,2618113083,28,2628080340,9967257
1643924166,197617,true,2618374894,28,2628343148,9968254
1643924276,197616,true,2618636732,28,2629657582,11020850
1643924301,197615,true,2618898595,28,2629920548,11021953
1643924871,197613,true,2619422401,28,2638877048,19454647
1643924974,197612,true,2619684343,28,2639932757,20248414
1643925235,197612,true,2619684343,28,2643102419,23418076
1643925330,197611,true,2619946312,28,2644424235,24477923
1643925802,197608,true,2620732374,28,2652899522,32167148
1643926244,197606,true,2621256547,28,2658210364,36953817
1643926413,197604,true,2621780825,28,2659539735,37758910
1643926503,197604,true,2621780825,28,2660337677,38556852
1643927144,197600,true,2622829694,28,2663798192,40968498
1643927220,197598,true,2623354286,28,2663798192,40443906
1643927713,197597,true,2623616622,28,2661934279,38317657
1643927824,197597,true,2623616622,28,2661668112,38051490
1643928588,197594,true,2624403785,28,2658742033,34338248
1643929016,197592,true,2624928692,28,2656084753,31156061
1643929130,197592,true,2624928692,28,2655553615,30624923
1643929452,197591,true,2625191185,28,2655288086,30096901
1643929633,197588,true,2625978821,28,2655022584,29043763
1643930005,197586,true,2626504043,28,2655022584,28518541
1643930174,197585,true,2626766694,28,2655288086,28521392
1643930202,197585,true,2626766694,28,2655288086,28521392
1643930344,197582,true,2627554803,28,2655553615,27998812
1643931943,197580,true,2628080340,28,2660869771,32789431
1643932114,197580,true,2628080340,28,2661401972,33321632
1643932484,197580,true,2628080340,28,2662466692,34386352
1643932617,197576,true,2629131730,28,2663265512,34133782
1643932684,197574,true,2629657582,28,2663798192,34140610
1643933511,197571,true,2630446559,28,2677149866,46703307
1643933550,197570,true,2630709603,28,2677953092,47243489
1643934796,197566,true,2631762045,28,2692183208,60421163
1643934909,197564,true,2632288424,28,2692183208,59894784
1643935131,197561,true,2633078189,28,2692452426,59374237
1643935927,197561,true,2633078189,28,2691914017,58835828
1643936079,197558,true,2633868192,28,2691644852,57776660
1643937752,197555,true,2634658431,28,2689223583,54565152
1643938569,197554,true,2634921897,28,2689223583,54301686
1643938669,197554,true,2634921897,28,2689223583,54301686
1643938733,197551,true,2635712453,28,2688954687,53242234
1643938872,197549,true,2636239621,28,2688685819,52446198
1643941393,197548,true,2636503245,28,2680900313,44397068
1643942417,197548,true,2636503245,28,2683582421,47079176
1643942483,197544,true,2637558005,28,2683850779,46292774
1643942504,197542,true,2638085543,28,2683850779,45765236
1643942562,197541,true,2638349351,28,2684119164,45769813
1643944792,197540,true,2638613186,28,2692183208,53570022
1643947353,197538,true,2639140935,28,2692183208,53042273
1643947669,197536,true,2639668790,28,2691914017,52245227
1643947699,197535,true,2639932757,28,2691914017,51981260
1643947921,197534,true,2640196750,28,2691375715,51178965
1643948415,197531,true,2640988888,28,2690568463,49579575
1643949972,197530,true,2641252987,28,2685730038,44477051
1643951465,197529,true,2641517112,28,2685192973,43675861
1643951475,197528,true,2641781264,28,2685461492,43680228
1643951534,197524,true,2642838135,28,2685730038,42891903
1643951571,197522,true,2643366729,28,2685998611,42631882
1643951681,197519,true,2644159819,28,2687073172,42913353
1643951850,197517,true,2644688677,28,2688954687,44266010
1643951884,197513,true,2645746711,28,2689492505,43745794
1643951936,197510,true,2646540515,28,2690568463,44027948
1643951972,197506,true,2647599290,28,2691375715,43776425
1643951998,197502,true,2648658488,28,2692183208,43524720
1643952010,197498,true,2649718110,28,2692452426,42734316
1643952053,197494,true,2650778157,28,2693798922,43020765
1643952118,197490,true,2651838627,28,2695685147,43846520
1643952120,197487,true,2652634258,28,2695685147,43050889
1643952143,197482,true,2653960841,28,2696493933,42533092
1643952255,197477,true,2655288086,28,2700541507,45253421
1643952340,197472,true,2656615996,28,2704054318,47438322
1643952653,197469,true,2657413061,28,2716792648,59379587
1643952888,197465,true,2658476185,28,2726590237,68114052
1643953328,197460,true,2659805689,28,2744369906,84564217
1643953516,197454,true,2661401972,28,2750963973,89562001
1643953618,197450,true,2662466692,28,2754266946,91800254
1643953882,197446,true,2663531839,28,2760332700,96800861
1643954429,197440,true,2665130357,28,2763646922,98516565
1643954458,197434,true,2666729835,28,2763923287,97193452
1643954542,197429,true,2668063467,28,2764476099,96412632
1643954646,197424,true,2669397765,28,2765582055,96184290
1643954723,197417,true,2671266905,28,2766411813,95144908
1643954763,197411,true,2672870065,28,2766688454,93818389
1643954845,197405,true,2674474188,28,2767518544,93044356
1643954885,197400,true,2675811693,28,2768072075,92260382
1643954932,197393,true,2677685323,28,2768902580,91217257
1643955631,197385,true,2679828221,28,2780277815,100449594
1643955657,197380,true,2681168404,28,2780833898,99665494
1643957047,197374,true,2682777507,28,2799247178,116469671
1643958403,197367,true,2684656015,28,2800087036,115431021
1643958910,197359,true,2686804491,28,2798967282,112162791
1643959755,197354,true,2688148162,28,2797568218,109420056
1643960330,197348,true,2689761454,28,2796729115,106967661
1643960869,197341,true,2691644852,28,2796729115,105084263
1643961239,197332,true,2694068302,28,2796729115,102660813
1643961626,197327,true,2695415605,28,2797008788,101593183
1643961828,197320,true,2697302962,28,2799527103,102224141
1643961891,197312,true,2699461560,28,2800367045,100905485
1643961940,197303,true,2701892048,28,2801207239,99315191
1643961984,197296,true,2703783940,28,2801767509,97983569
1643962016,197289,true,2705677156,28,2802608123,96930967
1643962085,197283,true,2707300968,28,2803729334,96428366
1643962097,197274,true,2709738514,28,2804009707,94271193
1643962213,197267,true,2711635900,28,2806534326,94898426
1643963575,197260,true,2713534615,28,2839278033,125743418
1643963790,197253,true,2715434659,28,2841550251,126115592
1643963831,197245,true,2717607767,28,2841834406,124226639
1643963894,197238,true,2719510664,28,2842118589,122607925
1643964893,197233,true,2720870691,28,2841266124,120395433
1643965241,197226,true,2722775872,28,2840697956,117922084
1643965306,197218,true,2724954855,28,2840413915,115459060
1643965754,197211,true,2726862896,28,2840129902,113267006
1643965763,197206,true,2728226600,28,2839845917,111619317
1643965943,197200,true,2729863945,28,2838994134,109130189
1643966807,197193,true,2731775423,28,2834172185,102396762
1643967189,197186,true,2733688240,28,2832189057,98500817
1643967203,197182,true,2734781879,28,2831905867,97123988
1643968156,197176,true,2736423159,28,2832472276,96049117
1643968393,197169,true,2738339230,28,2833605435,95266205
1643968427,197162,true,2740256642,28,2833888796,93632154
1643969185,197158,true,2741352909,28,2841550251,100197342
1643969194,197152,true,2742998132,28,2841550251,98552119
1643969273,197145,true,2744918807,28,2842402801,97483994
1643969662,197138,true,2746840827,28,2847523477,100682650
1643969714,197133,true,2748214522,28,2848093010,99878488
1643969787,197127,true,2749863863,28,2848662658,98798795
1643969874,197120,true,2751789345,28,2849232419,97443074
1643969908,197114,true,2753440832,28,2849517342,96076510
1643970115,197109,true,2754817827,28,2849802294,94984467
1643970156,197103,true,2756471131,28,2850087274,93616143
1643970240,197096,true,2758401240,28,2849802294,91401054
1643970661,197089,true,2760332700,28,2847808230,87475530
1643970696,197085,true,2761436999,28,2847808230,86371231
1643971256,197079,true,2763094276,28,2841834406,78740130
1643971345,197072,true,2765029022,28,2840697956,75668934
1643972812,197066,true,2766688454,28,2834455602,67767148
1643973004,197062,true,2767795296,28,2834172185,66376889
1643973380,197057,true,2769179470,28,2833038799,63859329
1643973492,197050,true,2771118477,28,2832755524,61637047
1643973762,197044,true,2772781564,28,2832755524,59973960
1643974523,197040,true,2773890843,28,2832189057,58298214
1643974655,197035,true,2775278066,28,2832189057,56910991
1643974741,197030,true,2776665982,28,2832472276,55806294
1643974977,197025,true,2778054593,28,2833322103,55267510
1643975724,197021,true,2779165982,28,2835306024,56140042
1643977615,197017,true,2780277815,28,2835589554,55311739
1643977710,197012,true,2781668232,28,2835873113,54204881
1643978062,197007,true,2783059344,28,2836156700,53097356
1643978737,197002,true,2784451152,28,2836723960,52272808
1643980618,196997,true,2785843656,28,2840697956,54854300
1643980805,196992,true,2787236857,28,2841550251,54313394
1643980968,196987,true,2788630754,28,2841834406,53203652
1643981006,196982,true,2790025348,28,2841834406,51809058
1643981033,196977,true,2791420640,28,2841834406,50413766
1643981416,196972,true,2792816629,28,2841266124,48449495
1643981430,196967,true,2794213317,28,2841266124,47052807
1643981448,196962,true,2795610703,28,2841266124,45655421
1643981462,196957,true,2797008788,28,2840982026,43973238
1643981476,196953,true,2798127759,28,2840982026,42854267
1643981537,196950,true,2798967282,28,2840129902,41162620
1643981546,196946,true,2800087036,28,2840129902,40042866
1643981600,196941,true,2801487360,28,2838994134,37506774
1643981651,196938,true,2802327890,28,2838142606,35814716
1643982294,196936,true,2802888384,28,2824835298,21946914
1643982324,196931,true,2804290108,28,2823988016,19697908
1643982363,196926,true,2805692534,28,2823140989,17448455
1643983015,196923,true,2806534326,28,2804290108,-2244218
1643983088,196922,true,2806814979,28,2802047685,-4767294
1643983213,196917,true,2808218667,28,2798127759,-10090908
1643983280,196912,true,2809623058,28,2796449470,-13173588
1643983283,196913,true,2809342123,28,2796449470,-12892653
1643983379,196912,true,2809623058,28,2794213317,-15409741
1643983489,196908,true,2810747075,28,2791978952,-18768123
1643983878,196904,true,2811871543,28,2785565100,-26306443
1643984143,196904,true,2811871543,28,2781946399,-29925144
1643984149,196905,true,2811590384,28,2781946399,-29643985
1643984177,196902,true,2812433945,28,2781946399,-30487546
1643984195,196898,true,2813559088,28,2781946399,-31612689
1643984275,196897,true,2813840444,28,2782224593,-31615851
1643984809,196897,true,2813840444,28,2785565100,-28275344
1643985000,196894,true,2814684680,28,2787794332,-26890348
1643985013,196891,true,2815529170,28,2787794332,-27734838
1643985140,196890,true,2815810723,28,2791141526,-24669197
1643985165,196890,true,2815810723,28,2791699782,-24110941
1643985190,196886,true,2816937216,28,2792258150,-24679066
1643985281,196884,true,2817500632,28,2793933923,-23566709
1643985369,196884,true,2817500632,28,2795610703,-21889929
1643985665,196885,true,2817218910,28,2800647082,-16571828
1643985675,196881,true,2818345966,28,2800647082,-17698884
1643985696,196879,true,2818909664,28,2801207239,-17702425
1643985934,196879,true,2818909664,28,2805973103,-12936561
1643985987,196878,true,2819191555,28,2807095661,-12095894
1643986051,196875,true,2820037397,28,2807657108,-12380289
1643986754,196873,true,2820601433,28,2816373913,-4227520
1643986878,196873,true,2820601433,28,2817218910,-3382523
1643987049,196872,true,2820883493,28,2818909664,-1973829
1643987069,196869,true,2821729842,28,2819191555,-2538287
1643987104,196867,true,2822294217,28,2819755421,-2538796
1643987123,196867,true,2822294217,28,2820037397,-2256820
1643987187,196866,true,2822576446,28,2821729842,-846604
1643987207,196863,true,2823423304,28,2822012015,-1411289
1643987653,196860,true,2824270415,28,2834172185,9901770
1643987791,196860,true,2824270415,28,2838142606,13872191
1643987895,196858,true,2824835298,28,2840982026,16146728
1643987915,196855,true,2825682833,28,2841550251,15867418
1643987936,196850,true,2827095957,28,2842402801,15306844
1643988110,196849,true,2827378667,28,2848662658,21283991
1643988130,196847,true,2827944171,28,2849517342,21573171
1643988417,196843,true,2829075518,28,2860651600,31576082
1643988454,196839,true,2830207318,28,2862082212,31874894
1643988592,196838,true,2830490339,28,2867811818,37321479
1643988614,196837,true,2830773388,28,2868672248,37898860
1643988630,196834,true,2831622705,28,2869246011,37623306
1643988789,196831,true,2832472276,28,2874702487,42230211
1643988811,196830,true,2832755524,28,2875277457,42521933
1643988836,196830,true,2832755524,28,2876427740,43672216
1643988885,196827,true,2833605435,28,2878154028,44548593
1643988949,196823,true,2834739047,28,2881033478,46294431
1643989051,196822,true,2835022521,28,2884204200,49181679
1643989101,196822,true,2835022521,28,2885646590,50624069
1643989377,196819,true,2835873113,28,2893158657,57285544
1643989389,196814,true,2837291333,28,2893447973,56156640
1643989409,196814,true,2837291333,28,2893737318,56445985
1643989439,196814,true,2837291333,28,2894316094,57024761
1643989473,196813,true,2837575062,28,2894605526,57030464
1643989516,196808,true,2838994134,28,2895184476,56190342
1643989544,196807,true,2839278033,28,2895184476,55906443
1643990172,196808,true,2838994134,28,2891712512,52718378
1643990187,196807,true,2839278033,28,2891423369,52145336
1643990475,196803,true,2840413915,28,2887667149,47253234
1643990527,196802,true,2840697956,28,2887378411,46680455
1643990601,196803,true,2840413915,28,2886801022,46387107
1643990662,196802,true,2840697956,28,2886223748,45525792
1643990682,196799,true,2841550251,28,2885935155,44384904
1643990839,196798,true,2841834406,28,2884204200,42369794
1643990924,196798,true,2841834406,28,2883339111,41504705
1643991010,196798,true,2841834406,28,2882762530,40928124
1643991211,196794,true,2842971310,28,2881033478,38062168
1643991258,196793,true,2843255607,28,2881033478,37777871
1643991273,196793,true,2843255607,28,2881321581,38065974
1643991597,196792,true,2843539933,28,2884492620,40952687
1643991622,196788,true,2844677519,28,2884781069,40103550
1643992011,196787,true,2844961987,28,2888533536,43571549
1643992052,196786,true,2845246483,28,2889111271,43864788
1643992086,196785,true,2845531008,28,2889978091,44447083
1643992107,196780,true,2846954058,28,2890556116,43602058
1643992137,196777,true,2847808230,28,2891423369,43615139
1643992164,196775,true,2848377820,28,2892290883,43913063
1643992281,196773,true,2848947524,28,2896342723,47395199
1643992494,196767,true,2850657320,28,2903301946,52644626
1643992518,196764,true,2851512602,28,2904173023,52660421
1643992550,196762,true,2852082933,28,2905044362,52961429
1643992626,196759,true,2852938644,28,2907078504,54139860
1643992692,196753,true,2854650835,28,2909695921,55045086
1643992777,196750,true,2855507316,28,2912315695,56808379
1643992879,196748,true,2856078446,28,2915520845,59442399
1643993229,196746,true,2856649690,28,2926035108,69385418
1643993302,196740,true,2858364109,28,2928083947,69719838
1643993520,196736,true,2859507626,28,2935119436,75611810
1643993524,196734,true,2860079556,28,2935119436,75039880
1643993628,196732,true,2860651600,28,2938349683,77698083
1643993851,196726,true,2862368421,28,2945115326,82746905
1643993991,196723,true,2863227217,28,2946588178,83360961
1643994357,196721,true,2863799891,28,2945998949,82199058
1643994397,196719,true,2864372680,28,2945704379,81331699
1643994846,196714,true,2865805152,28,2943348875,77543723
1643994851,196711,true,2866664980,28,2943348875,76683895
1643994854,196709,true,2867238342,28,2943348875,76110533
1643996408,196706,true,2868098599,28,2944231968,76133369
1643996819,196701,true,2869532935,28,2945115326,75582391
1643997321,196696,true,2870967989,28,2945704379,74736390
1643997338,196693,true,2871829365,28,2945704379,73875014
1643997428,196690,true,2872691000,28,2945998949,73307949
1643997459,196685,true,2874127633,28,2945998949,71871316
1643997643,196679,true,2875852541,28,2946882837,71030296
1643997998,196675,true,2877003054,28,2949831046,72827992
1643998388,196672,true,2877866242,28,2951896548,74030306
1643998827,196666,true,2879593393,28,2953963495,74370102
1644000165,196659,true,2881609713,28,2954258892,72649179
1644000358,196654,true,2883050806,28,2954258892,71208086
1644000433,196651,true,2883915808,28,2954258892,70343084
1644000679,196645,true,2885646590,28,2953963495,68316905
1644001046,196638,true,2887667149,28,2953372791,65705642
1644001483,196633,true,2889111271,28,2952782205,63670934
1644001940,196629,true,2890267089,28,2951306257,61039168
1644001985,196623,true,2892001683,28,2951306257,59304574
1644002019,196616,true,2894026692,28,2951011156,56984464
1644002076,196611,true,2895473994,28,2950716084,55242090
1644002213,196608,true,2896342723,28,2950126030,53783307
1644002764,196603,true,2897791184,28,2946293549,48502365
1644002931,196598,true,2899240370,28,2945115326,45874956
1644003157,196594,true,2900400240,28,2943643210,43242970
1644003174,196591,true,2901270447,28,2943643210,42372763
1644003196,196586,true,2902721372,28,2943348875,40627503
1644003221,196581,true,2904173023,28,2943348875,39175852
1644003822,196577,true,2905334867,28,2942171830,36836963
1644004557,196575,true,2905915963,28,2943643210,37727247
1644004573,196570,true,2907369212,28,2943643210,36273998
1644004842,196564,true,2909114069,28,2945998949,36884880
1644004887,196560,true,2910277889,28,2946293549,36015660
1644004976,196557,true,2911151060,28,2947177525,36026465
1644005013,196551,true,2912898187,28,2947766990,34868803
1644005087,196546,true,2914354928,28,2948356573,34001645
1644005153,196542,true,2915520845,28,2948946274,33425429
1644005188,196539,true,2916395588,28,2949241169,32845581
1644005392,196533,true,2918145863,28,2951896548,33750685
1644005401,196528,true,2919605228,28,2951896548,32291320
1644005418,196524,true,2920773245,28,2952191737,31418492
1644005456,196521,true,2921649565,28,2952782205,31132640
1644005489,196516,true,2923110682,28,2953077483,29966801
1644005518,196511,true,2924572530,28,2953668128,29095598
1644005989,196509,true,2925157473,28,2960173026,35015553
1644006209,196506,true,2926035108,28,2962838248,36803140
1644006334,196502,true,2927205698,28,2964616395,37410697
1644006357,196498,true,2928376756,28,2964912857,36536101
1644006640,196496,true,2928962461,28,2966395610,37433149
1644007512,196494,true,2929548282,28,2965209348,35661066
1644008628,196491,true,2930427235,28,2960469043,30041808
1644008668,196488,true,2931306451,28,2960469043,29162592
1644008836,196487,true,2931599581,28,2958397544,26797963
1644008854,196486,true,2931892741,28,2958397544,26504803
1644009117,196485,true,2932185931,28,2955440772,23254841
1644009841,196482,true,2933065674,28,2948946274,15880600
1644010825,196481,true,2933358981,28,2943937574,10578593
1644010837,196480,true,2933652317,28,2943937574,10285257
1644011918,196479,true,2933945682,28,2945115326,11169644
1644012466,196476,true,2934825954,28,2948061767,13235813
1644012804,196475,true,2935119436,28,2948946274,13826838
1644013095,196474,true,2935412948,28,2949536093,14123145
1644013293,196474,true,2935412948,28,2950421042,15008094
1644013348,196471,true,2936293660,28,2950421042,14127382
1644013364,196470,true,2936587290,28,2950421042,13833752
1644014920,196469,true,2936880948,28,2943643210,6762262
1644015210,196469,true,2936880948,28,2942171830,5290882
1644015267,196466,true,2937762101,28,2942466047,4703946
1644015359,196465,true,2938055877,28,2942466047,4410170
1644018377,196462,true,2938937382,28,2952782205,13844823
1644018423,196461,true,2939231276,28,2953077483,13846207
1644018462,196458,true,2940113133,28,2953077483,12964350
1644018498,196456,true,2940701185,28,2953372791,12671606
1644018549,196451,true,2942171830,28,2953668128,11496298
1644018561,196450,true,2942466047,28,2953963495,11497448
1644018595,196447,true,2943348875,28,2954258892,10910017
1644018602,196444,true,2944231968,28,2954258892,10026924
1644018648,196439,true,2945704379,28,2954849773,9145394
1644018830,196439,true,2945704379,28,2957510202,11805823
1644018880,196436,true,2946588178,28,2958101733,11513555
1644018894,196433,true,2947472243,28,2958397544,10925301
1644018908,196429,true,2948651409,28,2958693383,10041974
1644018947,196428,true,2948946274,28,2959285152,10338878
1644019161,196424,true,2950126030,28,2962838248,12712218
1644019464,196422,true,2950716084,28,2968769557,18053473
1644019501,196418,true,2951896548,28,2969363340,17466792
1644019665,196417,true,2952191737,28,2971145404,18953667
1644019677,196414,true,2953077483,28,2971145404,18067921
1644019746,196412,true,2953668128,28,2972036837,18368709
1644019791,196408,true,2954849773,28,2972631274,17781501
1644019955,196407,true,2955145258,28,2974712740,19567482
1644020205,196405,true,2955736317,28,2979773799,24037482
1644020218,196405,true,2955736317,28,2980071777,24335460
1644020244,196402,true,2956623126,28,2980667821,24044695
1644020603,196401,true,2956918788,28,2984246590,27327802
1644020625,196399,true,2957510202,28,2984246590,26736388
1644021673,196399,true,2957510202,28,2988726095,31215893
1644021747,196396,true,2958397544,28,2989323870,30926326
1644021969,196396,true,2958397544,28,2991117913,32720369
1644021997,196394,true,2958989253,28,2991417024,32427771
1644022026,196393,true,2959285152,28,2991417024,32131872
1644022236,196390,true,2960173026,28,2991716166,31543140
1644022248,196390,true,2960173026,28,2991716166,31543140
1644022266,196388,true,2960765090,28,2991716166,30951076
1644022415,196388,true,2960765090,28,2991417024,30651934
1644022476,196386,true,2961357273,28,2991117913,29760640
1644022870,196386,true,2961357273,28,2990220757,28863484
1644023322,196384,true,2961949574,28,2989323870,27374296
1644023664,196383,true,2962245769,28,2986933487,24687718
1644025164,196381,true,2962838248,28,2979177934,16339686
1644025190,196381,true,2962838248,28,2979177934,16339686
1644026707,196379,true,2963430845,28,2972334040,8903195
1644027001,196378,true,2963727188,28,2972334040,8606852
1644027051,196377,true,2964023561,28,2972631274,8607713
1644027168,196377,true,2964023561,28,2973225830,9202269
1644027396,196375,true,2964616395,28,2975010211,10393816
1644028418,196373,true,2965209348,28,2986634823,21425475
1644028437,196372,true,2965505869,28,2986933487,21427618
1644028439,196372,true,2965505869,28,2986933487,21427618
1644028447,196370,true,2966099000,28,2986933487,20834487
1644028739,196368,true,2966692249,28,2991117913,24425664
1644030063,196367,true,2966988918,28,3000704341,33715423
1644030944,196367,true,2966988918,28,3001604642,34615724
1644031426,196365,true,2967582346,28,3001604642,34022296
1644031449,196362,true,2968472710,28,3001604642,33131932
1644031531,196361,true,2968769557,28,3001304512,32534955
1644034116,196362,true,2968472710,28,2995308201,26835491
1644034202,196360,true,2969066434,28,2995607732,26541298
1644034238,196357,true,2969957243,28,2995607732,25650489
1644034273,196356,true,2970254238,28,2995607732,25353494
1644034319,196356,true,2970254238,28,2995607732,25353494
1644034696,196353,true,2971145404,28,2998005057,26859653
1644034763,196350,true,2972036837,28,2998304857,26268020
1644034790,196349,true,2972334040,28,2998604688,26270648
1644034828,196348,true,2972631274,28,2998904548,26273274
1644034835,196345,true,2973523152,28,2998904548,25381396
1644034837,196341,true,2974712740,28,2998904548,24191808
1644034989,196339,true,2975307712,28,3001304512,25996800
1644036020,196338,true,2975605243,28,3019063658,43458415
1644036376,196335,true,2976498014,28,3022990797,46492783
1644036565,196331,true,2977688792,28,3024502595,46813803
1644036648,196329,true,2978284359,28,3024502595,46218236
1644036903,196329,true,2978284359,28,3023293096,45008737
1644037901,196326,true,2979177934,28,3017856335,38678401
1644038724,196323,true,2980071777,28,3016046254,35974477
1644038784,196322,true,2980369784,28,3016347859,35978075
1644038843,196322,true,2980369784,28,3016649494,36279710
1644040123,196319,true,2981263984,28,3021479755,40215771
1644040150,196316,true,2982158453,28,3021479755,39321302
1644040730,196314,true,2982754914,28,3024502595,41747681
1644040951,196314,true,2982754914,28,3024805045,42050131
1644041302,196311,true,2983649830,28,3026015148,42365318
1644042733,196308,true,2984545015,28,3029951329,45406314
1644043270,196307,true,2984843469,28,3028739652,43896183
1644043352,196307,true,2984843469,28,3028436808,43593339
1644043895,196304,true,2985739012,28,3026317750,40578738
1644044211,196302,true,2986336189,28,3025107525,38771336
1644044357,196301,true,2986634823,28,3024502595,37867772
1644044597,196301,true,2986634823,28,3022990797,36355974
1644044703,196298,true,2987530903,28,3022386289,34855386
1644044755,196296,true,2988128439,28,3022084081,33955642
1644044785,196294,true,2988726095,28,3021781903,33055808
1644045394,196295,true,2988427252,28,3016347859,27920607
1644046502,196292,true,2989323870,28,3008515932,19192062
1644046951,196290,true,2989921765,28,3008215111,18293346
1644047127,196288,true,2990519779,28,3008215111,17695332
1644047590,196288,true,2990519779,28,3008215111,17695332
1644048128,196285,true,2991417024,28,3008215111,16798087
1644048492,196282,true,2992314539,28,3008215111,15900572
1644050105,196280,true,2992913032,28,3008215111,15302079
1644050237,196280,true,2992913032,28,3008515932,15602900
1644050337,196277,true,2993810996,28,3008515932,14704936
1644051136,196275,true,2994409788,28,3004908059,10498271
1644051723,196274,true,2994709229,28,3003406055,8696826
1644051793,196274,true,2994709229,28,3003406055,8696826
1644051963,196271,true,2995607732,28,3003105745,7498013
1644051965,196269,true,2996206883,28,3003105745,6898862
1644051991,196266,true,2997105835,28,3003105745,5999910
1644052118,196266,true,2997105835,28,3003706396,6600561
1644053946,196262,true,2998304857,28,3016951159,18646302
1644054135,196260,true,2998904548,28,3017554579,18650031
1644054225,196259,true,2999204439,28,3017554579,18350140
1644054314,196258,true,2999504359,28,3017856335,18351976
1644054564,196254,true,3000704341,28,3018459936,17755595
1644054612,196252,true,3001304512,28,3018459936,17155424
1644054622,196251,true,3001604642,28,3018459936,16855294
1644054985,196252,true,3001304512,28,3017856335,16551823
1644055101,196248,true,3002505214,28,3018158120,15652906
1644055524,196245,true,3003406055,28,3019969468,16563413
1644056202,196246,true,3003105745,28,3022084081,18978336
1644056216,196246,true,3003105745,28,3022084081,18978336
1644056757,196243,true,3004006766,28,3022990797,18984031
1644058326,196240,true,3004908059,28,3019365565,14457506
1644058690,196241,true,3004607598,28,3019365565,14757967
1644059750,196241,true,3004607598,28,3019365565,14757967
1644059761,196238,true,3005509070,28,3019667501,14158431
1644060054,196236,true,3006110202,28,3019969468,13859266
1644060100,196237,true,3005809621,28,3019969468,14159847
1644060360,196237,true,3005809621,28,3019365565,13555944
1644060808,196234,true,3006711454,28,3018761782,12050328
1644061360,196231,true,3007613558,28,3016951159,9337601
1644061389,196232,true,3007312827,28,3016951159,9638332
1644062993,196232,true,3007312827,28,3013935866,6623039
1644063110,196230,true,3007914319,28,3013634503,5720184
1644063298,196228,true,3008515932,28,3013333170,4817238
1644063597,196228,true,3008515932,28,3012730593,4214661
1644063794,196230,true,3007914319,28,3012730593,4816274
1644064505,196228,true,3008515932,28,3012730593,4214661
1644067261,196225,true,3009418577,28,3013333170,3914593
1644068240,196225,true,3009418577,28,3013333170,3914593
1644068242,196227,true,3008816784,28,3013333170,4516386
1644068308,196225,true,3009418577,28,3013634503,4215926
1644068777,196223,true,3010020491,28,3014840137,4819646
1644068872,196223,true,3010020491,28,3014840137,4819646
1644068917,196225,true,3009418577,28,3015141622,5723045
1644068965,196222,true,3010321493,28,3015443136,5121643
1644069026,196220,true,3010923587,28,3015443136,4519549
1644070825,196219,true,3011224680,28,3022386289,11161609
1644072892,196220,true,3010923587,28,3019969468,9045881
1644072915,196218,true,3011525802,28,3020271465,8745663
1644072920,196215,true,3012429350,28,3020271465,7842115
1644072980,196214,true,3012730593,28,3020271465,7540872
1644073026,196215,true,3012429350,28,3020573492,8144142
1644073110,196211,true,3013634503,28,3021479755,7845252
1644073144,196209,true,3014237260,28,3021479755,7242495
1644073181,196207,true,3014840137,28,3021781903,6941766
1644073281,196208,true,3014538684,28,3022386289,7847605
1644073321,196205,true,3015443136,28,3022386289,6943153
1644073748,196205,true,3015443136,28,3022386289,6943153
1644073797,196203,true,3016046254,28,3022386289,6340035
1644074163,196204,true,3015744680,28,3024502595,8757915
1644074199,196201,true,3016649494,28,3024805045,8155551
1644074214,196201,true,3016649494,28,3025107525,8458031
1644074289,196200,true,3016951159,28,3025712577,8761418
1644074317,196199,true,3017252854,28,3026015148,8762294
1644074372,196197,true,3017856335,28,3026923044,9066709
1644075341,196196,true,3018158120,28,3039054376,20896256
1644075379,196194,true,3018761782,28,3039662217,20900435
1644075473,196193,true,3019063658,28,3041182352,22118694
1644077221,196190,true,3019969468,28,3051234328,31264860
1644077447,196190,true,3019969468,28,3050929235,30959767
1644077760,196188,true,3020573492,28,3049709168,29135676
1644079048,196187,true,3020875549,28,3043616150,22740601
1644079420,196186,true,3021177637,28,3042703247,21525610
1644079462,196185,true,3021479755,28,3042399008,20919253
1644079495,196183,true,3022084081,28,3042399008,20314927
1644079530,196183,true,3022084081,28,3042094798,20010717
1644079555,196183,true,3022084081,28,3042094798,20010717
1644079713,196183,true,3022084081,28,3040878264,18794183
1644079739,196182,true,3022386289,28,3040574207,18187918
1644079767,196183,true,3022084081,28,3040270180,18186099
1644079787,196182,true,3022386289,28,3039966183,17579894
1644079800,196183,true,3022084081,28,3039966183,17882102
1644079876,196183,true,3022084081,28,3039054376,16970295
1644079973,196183,true,3022084081,28,3037839058,15754977
1644080246,196182,true,3022386289,28,3033892630,11506341
1644080252,196183,true,3022084081,28,3033892630,11808549
1644080374,196183,true,3022084081,28,3031769754,9685673
1644080436,196183,true,3022084081,28,3030557350,8473269
1644080605,196183,true,3022084081,28,3027528458,5444377
1644080629,196184,true,3021781903,28,3026923044,5141141
1644080664,196184,true,3021781903,28,3026317750,4535847
1644080767,196186,true,3021177637,28,3023293096,2115459
1644080792,196187,true,3020875549,28,3022688528,1812979
1644080939,196188,true,3020573492,28,3018459936,-2113556
1644081049,196189,true,3020271465,28,3015141622,-5129843
1644081070,196191,true,3019667501,28,3014237260,-5430241
1644081331,196192,true,3019365565,28,3005509070,-13856495
1644081370,196194,true,3018761782,28,3004307167,-14454615
1644081445,196194,true,3018761782,28,3001904803,-16856979
1644081450,196196,true,3018158120,28,3001904803,-16253317
1644081483,196198,true,3017554579,28,3000704341,-16850238
1644081505,196199,true,3017252854,28,3000104290,-17148564
1644081661,196199,true,3017252854,28,2995907292,-21345562
1644081721,196200,true,3016951159,28,2994409788,-22541371
1644081775,196202,true,3016347859,28,2993212323,-23135536
1644081830,196203,true,3016046254,28,2992314539,-23731715
1644081849,196203,true,3016046254,28,2992015338,-24030916
1644081885,196203,true,3016046254,28,2991417024,-24629230
1644082021,196204,true,3015744680,28,2989323870,-26420810
1644082340,196205,true,3015443136,28,2985141954,-30301182
1644082407,196205,true,3015443136,28,2984545015,-30898121
1644082639,196205,true,3015443136,28,2984843469,-30599667
1644082872,196206,true,3015141622,28,2986336189,-28805433
1644083117,196206,true,3015141622,28,2989024967,-26116655
1644083196,196206,true,3015141622,28,2990220757,-24920865
1644083206,196205,true,3015443136,28,2990220757,-25222379
1644083212,196206,true,3015141622,28,2990519779,-24621843
1644083235,196207,true,3014840137,28,2990818831,-24021306
1644083287,196205,true,3015443136,28,2992015338,-23427798
1644083456,196205,true,3015443136,28,2995308201,-20134935
1644083464,196207,true,3014840137,28,2995607732,-19232405
1644084638,196207,true,3014840137,28,3009719519,-5120618
1644085380,196206,true,3015141622,28,3013333170,-1808452
1644085397,196206,true,3015141622,28,3013333170,-1808452
1644086195,196208,true,3014538684,28,3015141622,602938
1644089176,196208,true,3014538684,28,3016347859,1809175
1644089653,196207,true,3014840137,28,3016347859,1507722
1644091506,196206,true,3015141622,28,3016347859,1206237
1644091537,196208,true,3014538684,28,3016347859,1809175
1644091572,196208,true,3014538684,28,3016347859,1809175
1644091600,196207,true,3014840137,28,3016046254,1206117
1644093718,196208,true,3014538684,28,3004307167,-10231517
1644093924,196210,true,3013935866,28,3004607598,-9328268
1644094768,196210,true,3013935866,28,3007012125,-6923741
1644095383,196209,true,3014237260,28,3009418577,-4818683
1644095622,196209,true,3014237260,28,3010622525,-3614735
1644098169,196210,true,3013935866,28,3020271465,6335599
1644098737,196210,true,3013935866,28,3020875549,6939683
1644098903,196209,true,3014237260,28,3021177637,6940377
1644099169,196209,true,3014237260,28,3022386289,8149029
1644099839,196210,true,3013935866,28,3024805045,10869179
1644099981,196208,true,3014538684,28,3026317750,11779066
1644100098,196207,true,3014840137,28,3027528458,12688321
1644100291,196207,true,3014840137,28,3029042526,14202389
1644100536,196207,true,3014840137,28,3031466608,16626471
1644100618,196206,true,3015141622,28,3031769754,16628132
1644100673,196204,true,3015744680,28,3032376139,16631459
1644100825,196204,true,3015744680,28,3032982644,17237964
1644100921,196204,true,3015744680,28,3033589271,17844591
1644100972,196203,true,3016046254,28,3033892630,17846376
1644101108,196201,true,3016649494,28,3034499439,17849945
1644101142,196201,true,3016649494,28,3034499439,17849945
1644101184,196201,true,3016649494,28,3034499439,17849945
1644101203,196201,true,3016649494,28,3034802889,18153395
1644101282,196200,true,3016951159,28,3034802889,17851730
1644101530,196200,true,3016951159,28,3035713421,18762262
1644101791,196200,true,3016951159,28,3034802889,17851730
1644102386,196199,true,3017252854,28,3031769754,14516900
1644103923,196199,true,3017252854,28,3026015148,8762294
1644104418,196199,true,3017252854,28,3024805045,7552191
1644106404,196200,true,3016951159,28,3019969468,3018309
1644107210,196199,true,3017252854,28,3020271465,3018611
1644109264,196199,true,3017252854,28,3020875549,3622695
1644109267,196200,true,3016951159,28,3021177637,4226478
1644109295,196201,true,3016649494,28,3021177637,4528143
1644110183,196200,true,3016951159,28,3022990797,6039638
1644110207,196200,true,3016951159,28,3022990797,6039638
1644110252,196201,true,3016649494,28,3023293096,6643602
1644110272,196201,true,3016649494,28,3023293096,6643602
1644112659,196200,true,3016951159,28,3024805045,7853886
1644112840,196200,true,3016951159,28,3025107525,8156366
1644114871,196201,true,3016649494,28,3025410036,8760542
1644117852,196201,true,3016649494,28,3025410036,8760542
1644119908,196201,true,3016649494,28,3025410036,8760542
1644120304,196201,true,3016649494,28,3024200174,7550680
1644120358,196202,true,3016347859,28,3023897785,7549926
1644120447,196203,true,3016046254,28,3023293096,7246842
1644120518,196204,true,3015744680,28,3022688528,6943848
1644120828,196205,true,3015443136,28,3019365565,3922429
1644120992,196207,true,3014840137,28,3017554579,2714442
1644121804,196209,true,3014237260,28,3007012125,-7225135
1644122179,196210,true,3013935866,28,3003706396,-10229470
1644122330,196211,true,3013634503,28,3003105745,-10528758
1644122403,196212,true,3013333170,28,3003105745,-10227425
1644122752,196213,true,3013031866,28,3003406055,-9625811
1644122913,196214,true,3012730593,28,3003706396,-9024197
1644123124,196215,true,3012429350,28,3004607598,-7821752
1644123155,196216,true,3012128138,28,3004908059,-7220079
1644123531,196217,true,3011826955,28,3006410813,-5416142
1644124202,196217,true,3011826955,28,3008816784,-3010171
1644124901,196217,true,3011826955,28,3010020491,-1806464
1644124932,196218,true,3011525802,28,3010020491,-1505311
1644124946,196219,true,3011224680,28,3010020491,-1204189
1644124978,196218,true,3011525802,28,3010020491,-1505311
1644125653,196218,true,3011525802,28,3012128138,602336
1644126175,196219,true,3011224680,28,3013935866,2711186
1644126725,196219,true,3011224680,28,3015443136,4218456
1644127178,196219,true,3011224680,28,3015443136,4218456
1644127813,196218,true,3011525802,28,3015443136,3917334
1644128450,196219,true,3011224680,28,3015443136,4218456
1644128741,196219,true,3011224680,28,3015443136,4218456
1644129029,196218,true,3011525802,28,3015443136,3917334
1644129148,196217,true,3011826955,28,3015443136,3616181
1644129200,196218,true,3011525802,28,3015443136,3917334
1644129738,196216,true,3012128138,28,3015141622,3013484
1644130144,196216,true,3012128138,28,3014840137,2711999
1644130221,196214,true,3012730593,28,3014840137,2109544
1644130280,196214,true,3012730593,28,3014840137,2109544
1644130287,196213,true,3013031866,28,3014840137,1808271
1644130339,196212,true,3013333170,28,3014840137,1506967
1644130353,196210,true,3013935866,28,3014538684,602818
1644130388,196210,true,3013935866,28,3014538684,602818
1644130511,196208,true,3014538684,28,3014237260,-301424
1644130624,196207,true,3014840137,28,3013935866,-904271
1644131561,196206,true,3015141622,28,3010923587,-4218035
1644131607,196206,true,3015141622,28,3010923587,-4218035
1644131945,196204,true,3015744680,28,3010020491,-5724189
1644132227,196203,true,3016046254,28,3008515932,-7530322
1644133595,196203,true,3016046254,28,3004607598,-11438656
1644133689,196204,true,3015744680,28,3004607598,-11137082
1644133933,196202,true,3016347859,28,3005208549,-11139310
1644133948,196201,true,3016649494,28,3005208549,-11440945
1644134120,196201,true,3016649494,28,3005809621,-10839873
1644135543,196201,true,3016649494,28,3011224680,-5424814
1644135673,196200,true,3016951159,28,3011224680,-5726479
1644135960,196200,true,3016951159,28,3011224680,-5726479
1644136397,196199,true,3017252854,28,3011224680,-6028174
1644136655,196200,true,3016951159,28,3010923587,-6027572
1644138408,196199,true,3017252854,28,3010321493,-6931361
1644139537,196199,true,3017252854,28,3010321493,-6931361
1644140162,196199,true,3017252854,28,3010321493,-6931361
1644141672,196200,true,3016951159,28,3010321493,-6629666
1644142361,196199,true,3017252854,28,3011224680,-6028174
1644144756,196199,true,3017252854,28,3013634503,-3618351
1644145723,196199,true,3017252854,28,3013634503,-3618351
1644146870,196200,true,3016951159,28,3012730593,-4220566
1644147939,196199,true,3017252854,28,3011826955,-5425899
1644147994,196199,true,3017252854,28,3011826955,-5425899
1644148006,196199,true,3017252854,28,3011826955,-5425899
1644148085,196200,true,3016951159,28,3011826955,-5124204
1644148275,196200,true,3016951159,28,3011826955,-5124204
1644148452,196200,true,3016951159,28,3011525802,-5425357
1644148743,196200,true,3016951159,28,3011525802,-5425357
1644149459,196200,true,3016951159,28,3010923587,-6027572
1644149526,196199,true,3017252854,28,3010622525,-6630329
1644151459,196199,true,3017252854,28,3010321493,-6931361
1644151704,196200,true,3016951159,28,3010321493,-6629666
1644151964,196200,true,3016951159,28,3010321493,-6629666
1644152875,196200,true,3016951159,28,3008816784,-8134375
1644153080,196201,true,3016649494,28,3008816784,-7832710
1644153510,196201,true,3016649494,28,3009418577,-7230917
1644155694,196201,true,3016649494,28,3010923587,-5725907
1644155879,196201,true,3016649494,28,3010923587,-5725907
1644155952,196203,true,3016046254,28,3011224680,-4821574
1644156721,196203,true,3016046254,28,3011224680,-4821574
1644157884,196203,true,3016046254,28,3011826955,-4219299
1644158023,196204,true,3015744680,28,3013634503,-2110177
1644158034,196205,true,3015443136,28,3013935866,-1507270
1644158151,196206,true,3015141622,28,3014840137,-301485
1644158235,196205,true,3015443136,28,3015141622,-301514
1644158510,196207,true,3014840137,28,3015141622,301485
1644158579,196208,true,3014538684,28,3014538684,0
1644158651,196209,true,3014237260,28,3014237260,0
1644158729,196208,true,3014538684,28,3013634503,-904181
1644158927,196211,true,3013634503,28,3011826955,-1807548
1644158956,196212,true,3013333170,28,3011525802,-1807368
1644159627,196214,true,3012730593,28,3001304512,-11426081
1644159657,196213,true,3013031866,28,3001004411,-12027455
1644159701,196217,true,3011826955,28,2999804309,-12022646
1644159719,196218,true,3011525802,28,2999204439,-12321363
1644159726,196220,true,3010923587,28,2998904548,-12019039
1644160041,196220,true,3010923587,28,2988726095,-22197492
1644160099,196223,true,3010020491,28,2987530903,-22489588
1644161368,196224,true,3009719519,28,2972928537,-36790982
1644161397,196226,true,3009117665,28,2972928537,-36189128
1644161476,196226,true,3009117665,28,2972631274,-36486391
1644161574,196229,true,3008215111,28,2973820505,-34394606
1644162276,196228,true,3008515932,28,2980667821,-27848111
1644162499,196230,true,3007914319,28,2981860267,-26054052
1644162538,196230,true,3007914319,28,2982158453,-25755866
1644162689,196233,true,3007012125,28,2983351495,-23660630
1644163097,196232,true,3007312827,28,2986634823,-20678004
1644164786,196235,true,3006410813,28,2987530903,-18879910
1644164806,196235,true,3006410813,28,2987530903,-18879910
1644165180,196238,true,3005509070,28,2987530903,-17978167
1644165321,196237,true,3005809621,28,2987829656,-17979965
1644165350,196239,true,3005208549,28,2987829656,-17378893
1644165377,196239,true,3005208549,28,2987829656,-17378893
1644166929,196241,true,3004607598,28,2995308201,-9299397
1644167342,196239,true,3005208549,28,2996206883,-9001666
1644167368,196241,true,3004607598,28,2996206883,-8400715
1644168943,196240,true,3004908059,28,3000704341,-4203718
1644169175,196241,true,3004607598,28,3001304512,-3303086
1644169524,196240,true,3004908059,28,3001604642,-3303417
1644171919,196241,true,3004607598,28,3003105745,-1501853
1644171940,196240,true,3004908059,28,3003105745,-1802314
1644172682,196242,true,3004307167,28,3000404300,-3902867
1644173431,196240,true,3004908059,28,2997705286,-7202773
1644173663,196242,true,3004307167,28,2996806154,-7501013
1644173893,196241,true,3004607598,28,2995907292,-8700306
1644174239,196243,true,3004006766,28,2994709229,-9297537
1644175851,196242,true,3004307167,28,2990220757,-14086410
1644175982,196244,true,3003706396,28,2990519779,-13186617
1644176447,196244,true,3003706396,28,2991117913,-12588483
1644176834,196246,true,3003105745,28,2991417024,-11688721
1644176909,196245,true,3003406055,28,2991716166,-11689889
1644177293,196247,true,3002805464,28,2992314539,-10490925
1644177335,196246,true,3003105745,28,2992314539,-10791206
1644179123,196248,true,3002505214,28,2993810996,-8694218
1644180606,196247,true,3002805464,28,2993810996,-8994468
1644180713,196250,true,3001904803,28,2993810996,-8093807
1644180796,196249,true,3002204993,28,2993810996,-8393997
1644182518,196251,true,3001604642,28,2987829656,-13774986
1644182638,196250,true,3001904803,28,2987530903,-14373900
1644182841,196253,true,3001004411,28,2987829656,-13174755
1644183253,196252,true,3001304512,28,2988427252,-12877260
1644183363,196254,true,3000704341,28,2988726095,-11978246
1644189003,196253,true,3001004411,28,2995308201,-5696210
1644189016,196255,true,3000404300,28,2995607732,-4796568
1644189155,196254,true,3000704341,28,2997105835,-3598506
1644189223,196256,true,3000104290,28,2997705286,-2399004
1644189228,196253,true,3001004411,28,2997705286,-3299125
1644189480,196255,true,3000404300,28,2999804309,-599991
1644189483,196254,true,3000704341,28,2999804309,-900032
1644189521,196256,true,3000104290,28,3000404300,300010
1644189561,196252,true,3001304512,28,3000704341,-600171
1644189621,196254,true,3000704341,28,3001604642,900301
1644189666,196253,true,3001004411,28,3002505214,1500803
1644189864,196254,true,3000704341,28,3006711454,6007113
1644190398,196250,true,3001904803,28,3018158120,16253317
1644190545,196251,true,3001604642,28,3021479755,19875113
1644190565,196249,true,3002204993,28,3022084081,19879088
1644190693,196250,true,3001904803,28,3025107525,23202722
1644190736,196246,true,3003105745,28,3026317750,23212005
1644190925,196247,true,3002805464,28,3029951329,27145865
1644190955,196246,true,3003105745,28,3030254324,27148579
1644190970,196247,true,3002805464,28,3030557350,27751886
1644190988,196242,true,3004307167,28,3030860405,26553238
1644191094,196242,true,3004307167,28,3033589271,29282104
1644191138,196240,true,3004908059,28,3035106369,30198310
1644191322,196241,true,3004607598,28,3040574207,35966609
1644191610,196236,true,3006110202,28,3046051895,39941693
1644191743,196236,true,3006110202,28,3048489590,42379388
1644192131,196234,true,3006711454,28,3054897824,48186370
1644192192,196234,true,3006711454,28,3055814385,49102931
1644192582,196230,true,3007914319,28,3059789328,51875009
1644192603,196230,true,3007914319,28,3059789328,51875009
1644192653,196229,true,3008215111,28,3060095307,51880196
1644192702,196230,true,3007914319,28,3060095307,52180988
1644192725,196226,true,3009117665,28,3060401316,51283651
1644192865,196226,true,3009117665,28,3059789328,50671663
1644192888,196225,true,3009418577,28,3059483379,50064802
1644192905,196225,true,3009418577,28,3059483379,50064802
1644193089,196222,true,3010321493,28,3057036894,46715401
1644193132,196222,true,3010321493,28,3056425578,46104085
1644193195,196222,true,3010321493,28,3055508834,45187341
1644193540,196223,true,3010020491,28,3048794439,38773948
1644193551,196219,true,3011224680,28,3048489590,37264910
1644193581,196220,true,3010923587,28,3047879983,36956396
1644193621,196219,true,3011224680,28,3046965802,35741122
1644194108,196222,true,3010321493,28,3034802889,24481396
1644194389,196218,true,3011525802,28,3028739652,17213850
1644194400,196219,true,3011224680,28,3028436808,17212128
1644194766,196219,true,3011224680,28,3021479755,10255075
1644194933,196221,true,3010622525,28,3018761782,8139257
1644194954,196218,true,3011525802,28,3018459936,6934134
1644195080,196219,true,3011224680,28,3016951159,5726479
1644195804,196219,true,3011224680,28,3010321493,-903187
1644197192,196222,true,3010321493,28,3006110202,-4211291
1644197296,196219,true,3011224680,28,3006110202,-5114478
1644197342,196220,true,3010923587,28,3006110202,-4813385
1644197540,196222,true,3010321493,28,3006711454,-3610039
1644197751,196223,true,3010020491,28,3007312827,-2707664
1644197823,196219,true,3011224680,28,3007613558,-3611122
1644197853,196220,true,3010923587,28,3007613558,-3310029
1644197869,196221,true,3010622525,28,3007914319,-2708206
1644198001,196221,true,3010622525,28,3008816784,-1805741
1644198534,196217,true,3011826955,28,3013634503,1807548
1644198689,196216,true,3012128138,28,3015141622,3013484
1644199081,196217,true,3011826955,28,3019365565,7538610
1644201029,196216,true,3012128138,28,3025712577,13584439
1644201424,196212,true,3013333170,28,3026620382,13287212
1644201458,196210,true,3013935866,28,3026923044,12987178
1644201460,196210,true,3013935866,28,3026923044,12987178
1644201752,196208,true,3014538684,28,3028133994,13595310
1644201798,196204,true,3015744680,28,3028133994,12389314
1644201874,196203,true,3016046254,28,3028739652,12693398
1644201916,196203,true,3016046254,28,3029345430,13299176
1644201961,196200,true,3016951159,28,3029648364,12697205
1644202163,196197,true,3017856335,28,3032679376,14823041
1644202513,196195,true,3018459936,28,3037535304,19075368
1644203729,196196,true,3018158120,28,3048794439,30636319
1644204455,196193,true,3019063658,28,3047575226,28511568
1644204556,196190,true,3019969468,28,3047879983,27910515
1644205012,196188,true,3020573492,28,3049709168,29135676
1644205070,196188,true,3020573492,28,3050014139,29440647
1644205119,196185,true,3021479755,28,3050624173,29144418
1644205545,196181,true,3022688528,28,3054592364,31903836
1644206107,196179,true,3023293096,28,3060095307,36802211
1644206214,196179,true,3023293096,28,3061013427,37720331
1644206267,196177,true,3023897785,28,3061625660,37727875
1644207495,196173,true,3025107525,28,3065914723,40807198
1644207720,196171,true,3025712577,28,3066221315,40508738
1644207796,196171,true,3025712577,28,3066834590,41122013
1644208279,196169,true,3026317750,28,3070209795,43892045
1644208366,196164,true,3027831211,28,3070823868,42992657
1644208707,196162,true,3028436808,28,3074203464,45766656
1644208884,196162,true,3028436808,28,3076048447,47611639
1644209116,196159,true,3029345430,28,3078202327,48856897
1644210724,196155,true,3030557350,28,3083131146,52573796
1644210779,196152,true,3031466608,28,3083439459,51972851
1644211673,196151,true,3031769754,28,3085907074,54137320
1644211698,196149,true,3032376139,28,3086215665,53839526
1644211737,196143,true,3034196019,28,3086215665,52019646
1644211879,196140,true,3035106369,28,3087759081,52652712
1644212434,196138,true,3035713421,28,3094249864,58536443
1644212482,196135,true,3036624226,28,3094868745,58244519
1644212756,196130,true,3038142842,28,3097035803,58892961
1644212771,196127,true,3039054376,28,3097035803,57981427
1644213130,196126,true,3039358281,28,3098894489,59536208
1644213251,196123,true,3040270180,28,3099514299,59244119
1644213864,196118,true,3041790619,28,3100134233,58343614
1644214081,196115,true,3042703247,28,3100134233,57430986
1644214788,196113,true,3043311818,28,3101064366,57752548
1644214865,196110,true,3044224903,28,3101374473,57149570
1644215139,196105,true,3045747320,28,3102304978,56557658
1644215625,196101,true,3046965802,28,3103235763,56269961
1644215666,196100,true,3047270499,28,3103235763,55965264
1644215681,196097,true,3048184771,28,3103235763,55050992
1644215846,196092,true,3049709168,28,3102615208,52906040
1644216003,196089,true,3050624173,28,3101684610,51060437
1644216164,196088,true,3050929235,28,3100754291,49825056
1644216559,196085,true,3051844605,28,3097965007,46120402
1644217078,196083,true,3052455005,28,3094868745,42413740
1644217366,196080,true,3053370833,28,3093631107,40260274
1644220013,196079,true,3053676170,28,3092393964,38717794
1644220096,196076,true,3054592364,28,3092393964,37801600
1644220120,196074,true,3055203313,28,3092393964,37190651
1644221977,196072,true,3055814385,28,3082514612,26700227
1644222208,196071,true,3056119966,28,3082206392,26086426
1644222242,196070,true,3056425578,28,3082206392,25780814
1644225724,196068,true,3057036894,28,3078510147,21473253
1644225906,196066,true,3057648332,28,3078510147,20861815
1644225967,196066,true,3057648332,28,3078510147,20861815
1644226134,196065,true,3057954096,28,3077894537,19940441
1644226428,196064,true,3058259892,28,3077279051,19019159
1644226476,196062,true,3058871574,28,3077279051,18407477
1644226477,196062,true,3058871574,28,3077279051,18407477
1644226484,196061,true,3059177462,28,3077279051,18101589
1644226517,196061,true,3059177462,28,3076971354,17793892
1644226574,196061,true,3059177462,28,3076663687,17486225
1644226610,196061,true,3059177462,28,3076356052,17178590
1644226647,196061,true,3059177462,28,3076048447,16870985
1644226768,196061,true,3059177462,28,3074818335,15640873
1644227240,196061,true,3059177462,28,3070516816,11339354
1644227880,196062,true,3058871574,28,3064995133,6123559
1644228105,196061,true,3059177462,28,3063463095,4285633
1644228116,196060,true,3059483379,28,3063463095,3979716
1644230156,196061,true,3059177462,28,3065914723,6737261
1644230238,196060,true,3059483379,28,3066221315,6737936
1644230398,196059,true,3059789328,28,3066221315,6431987
1644230472,196058,true,3060095307,28,3066221315,6126008
1644230540,196058,true,3060095307,28,3066221315,6126008
1644232452,196057,true,3060401316,28,3072052382,11651066
1644233887,196056,true,3060707356,28,3072052382,11345026
1644234633,196055,true,3061013427,28,3072052382,11038955
1644234952,196055,true,3061013427,28,3072052382,11038955
1644235983,196054,true,3061319528,28,3071130950,9811422
1644236433,196052,true,3061931823,28,3070823868,8892045
1644236527,196050,true,3062544240,28,3070516816,7972576
1644237142,196050,true,3062544240,28,3069288916,6744676
1644237504,196049,true,3062850494,28,3068368314,5517820
1644237656,196046,true,3063769441,28,3068061508,4292067
1644237993,196045,true,3064075818,28,3067447987,3372169
1644238022,196044,true,3064382226,28,3067447987,3065761
1644238028,196043,true,3064688664,28,3067447987,2759323
1644238182,196040,true,3065608163,28,3068061508,2453345
1644239864,196037,true,3066527937,28,3078202327,11674390
1644239877,196036,true,3066834590,28,3078202327,11367737
1644240019,196035,true,3067141273,28,3078817998,11676725
1644240348,196031,true,3068368314,28,3080357715,11989401
1644241373,196027,true,3069595845,28,3085907074,16311229
1644242979,196027,true,3069595845,28,3087759081,18163236
1644244323,196025,true,3070209795,28,3089612200,19402405
1644244333,196022,true,3071130950,28,3089921161,18790211
1644244758,196018,true,3072359587,28,3092084755,19725168
1644244771,196017,true,3072666823,28,3092393964,19727141
1644244920,196015,true,3073281387,28,3093321775,20040388
1644244977,196012,true,3074203464,28,3093940470,19737006
1644245000,196008,true,3075433329,28,3094249864,18816535
1644245491,196007,true,3075740873,28,3100754291,25013418
1644245695,196004,true,3076663687,28,3104166826,27503139
1644245952,196001,true,3077586779,28,3108204665,30617886
1644246022,195998,true,3078510147,28,3109448134,30937987
1644246072,195996,true,3079125880,28,3110070054,30944174
1644246124,195993,true,3080049710,28,3111003169,30953459
1644246285,195991,true,3080665751,28,3113181524,32515773
1644246708,195988,true,3081590043,28,3117854567,36264524
1644247091,195986,true,3082206392,28,3119101896,36895504
1644247110,195984,true,3082822864,28,3119101896,36279032
1644247208,195982,true,3083439459,28,3118790017,35350558
1644247629,195980,true,3084056178,28,3115672942,31616764
1644247729,195979,true,3084364584,28,3115049900,30685316
1644248208,195977,true,3084981487,28,3111936563,26955076
1644248303,195975,true,3085598514,28,3111625401,26026887
1644248420,195973,true,3086215665,28,3111625401,25409736
1644248539,195972,true,3086524287,28,3111625401,25101114
1644249138,195969,true,3087450336,28,3112870237,25419901
1644249510,195968,true,3087759081,28,3115361405,27602324
1644249518,195966,true,3088376664,28,3115361405,26984741
1644249603,195966,true,3088376664,28,3115984509,27607845
1644249626,195963,true,3089303270,28,3115984509,26681239
1644249757,195961,true,3089921161,28,3117542813,27621652
1644249870,195959,true,3090539177,28,3118790017,28250840
1644250008,195959,true,3090539177,28,3119725747,29186570
1644250193,195956,true,3091466431,28,3120973825,29507394
1644251128,195954,true,3092084755,28,3127534428,35449673
1644251452,195953,true,3092393964,28,3129411418,37017454
1644251717,195953,true,3092393964,28,3130037332,37643368
1644251794,195950,true,3093321775,28,3130663370,37341595
1644252044,195948,true,3093940470,28,3132542238,38601768
1644252160,195947,true,3094249864,28,3132855492,38605628
1644252214,195947,true,3094249864,28,3132855492,38605628
1644252267,195944,true,3095178232,28,3132855492,37677260
1644253082,195944,true,3095178232,28,3127847182,32668950
1644253101,195943,true,3095487750,28,3127534428,32046678
1644253135,195944,true,3095178232,28,3127534428,32356196
1644253165,195942,true,3095797298,28,3127534428,31737130
1644253752,195941,true,3096106878,28,3126283727,30176849
1644254139,195940,true,3096416489,28,3125658564,29242075
1644254478,195940,true,3096416489,28,3127847182,31430693
1644254865,195939,true,3096726130,28,3130350335,33624205
1644255002,195937,true,3097345507,28,3130663370,33317863
1644256142,195936,true,3097655241,28,3130037332,32382091
1644256165,195937,true,3097345507,28,3130350335,33004828
1644256180,195935,true,3097965007,28,3130350335,32385328
1644256231,195934,true,3098274803,28,3130350335,32075532
1644256392,195933,true,3098584631,28,3130976437,32391806
1644256540,195933,true,3098584631,28,3131602663,33018032
1644256692,195931,true,3099204379,28,3132542238,33337859
1644256965,195930,true,3099514299,28,3134422233,34907934
1644257006,195928,true,3100134233,28,3134735676,34601443
1644257017,195928,true,3100134233,28,3135049149,34914916
1644257452,195925,true,3101064366,28,3141953504,40889138
1644257508,195922,true,3101994778,28,3142896184,40901406
1644257972,195920,true,3102615208,28,3152653791,50038583
1644258360,195919,true,3102925470,28,3159280989,56355519
1644258576,195916,true,3103856441,28,3161809298,57952857
1644259730,195914,true,3104477243,28,3160544891,56067648
1644259768,195912,true,3105098170,28,3160228868,55130698
1644259803,195911,true,3105408679,28,3159912877,54504198
1644259895,195908,true,3106340395,28,3158333394,51992999
1644260086,195907,true,3106651029,28,3155492315,48841286
1644260119,195905,true,3107272390,28,3155176797,47904407
1644260176,195904,true,3107583118,28,3154545856,46962738
1644260354,195900,true,3108826337,28,3153284353,44458016
1644260812,195899,true,3109137220,28,3153284353,44147133
1644261464,195895,true,3110381061,28,3156439057,46057996
1644261488,195894,true,3110692100,28,3156754701,46062601
1644261575,195890,true,3111936563,28,3157386084,45449521
1644261712,195888,true,3112558982,28,3159596917,47037935
1644262025,195883,true,3114115572,28,3165605557,51489985
1644262163,195882,true,3114426984,28,3167505395,53078411
1644262249,195877,true,3115984509,28,3168455742,52471233
1644263977,195875,true,3116607737,28,3181154310,64546573
1644264150,195870,true,3118166352,28,3180836227,62669875
1644266297,195868,true,3118790017,28,3177657139,58867122
1644266332,195864,true,3120037720,28,3177657139,57619419
1644266401,195862,true,3120661759,28,3177657139,56995380
1644266409,195857,true,3122222402,28,3177657139,55434737
1644266951,195857,true,3122222402,28,3174481229,52258827
1644267155,195852,true,3123783825,28,3173211754,49427929
1644267180,195850,true,3124408613,28,3172894464,48485851
1644267218,195845,true,3125971130,28,3172577207,46606077
1644267269,195846,true,3125658564,28,3171625624,45967060
1644267988,195843,true,3126596355,28,3159280989,32684634
1644268011,195841,true,3127221706,28,3158965092,31743386
1644268539,195837,true,3128472782,28,3153284353,24811571
1644268594,195837,true,3128472782,28,3152969057,24496275
1644268632,195834,true,3129411418,28,3152969057,23557639
1644268771,195832,true,3130037332,28,3152338557,22301225
1644268815,195826,true,3131915824,28,3152338557,20422733
1644268961,195827,true,3131602663,28,3151077937,19475274
1644268994,195824,true,3132542238,28,3150762861,18220623
1644269309,195822,true,3133168778,28,3150447816,17279038
1644270158,195818,true,3134422233,28,3142896184,8473951
1644270455,195819,true,3134108822,28,3139441072,5332250
1644270635,195816,true,3135049149,28,3136930649,1881500
1644270695,195815,true,3135362654,28,3136616987,1254333
1644270812,195812,true,3136303357,28,3135989758,-313599
1644270910,195812,true,3136303357,28,3135676190,-627167
1644270928,195809,true,3137244342,28,3135676190,-1568152
1644271154,195808,true,3137558066,28,3135676190,-1881876
1644271170,195805,true,3138499428,28,3135676190,-2823238
1644271254,195806,true,3138185609,28,3136303357,-1882252
1644271258,195803,true,3139127159,28,3136303357,-2823802
1644272892,195802,true,3139441072,28,3145411382,5970310
1644273041,195799,true,3140382998,28,3145725923,5342925
1644274431,195800,true,3140068992,28,3148243384,8174392
1644274496,195797,true,3141011107,28,3148243384,7232277
1644275093,195796,true,3141325208,28,3148873065,7547857
1644275660,195794,true,3141953504,28,3150132803,8179299
1644275762,195795,true,3141639340,28,3150132803,8493463
1644276781,195793,true,3142267699,28,3151393045,9125346
1644276826,195792,true,3142581926,28,3151393045,8811119
1644276861,195790,true,3143210474,28,3151393045,8182571
1644277067,195792,true,3142581926,28,3151077937,8496011
1644278456,195790,true,3143210474,28,3149187952,5977478
1644278574,195789,true,3143524795,28,3148873065,5348270
1644279015,195787,true,3144153531,28,3148558209,4404678
1644279034,195788,true,3143839148,28,3148558209,4719061
1644279067,195787,true,3144153531,28,3148243384,4089853
1644279179,195786,true,3144467947,28,3147299100,2831153
1644279299,195784,true,3145096872,28,3146040495,943623
1644279397,195785,true,3144782394,28,3145096872,314478
1644280125,195785,true,3144782394,28,3135676190,-9106204
1644280253,195784,true,3145096872,28,3134108822,-10988050
1644281193,195782,true,3145725923,28,3128472782,-17253141
1644281269,195784,true,3145096872,28,3128785630,-16311242
1644282872,195783,true,3145411382,28,3130976437,-14434945
1644283261,195782,true,3145725923,28,3131602663,-14123260
1644283271,195781,true,3146040495,28,3131915824,-14124671
1644283572,195782,true,3145725923,28,3132855492,-12870431
1644284422,195781,true,3146040495,28,3136930649,-9109846
1644284757,195781,true,3146040495,28,3138499428,-7541067
1644284809,195779,true,3146669735,28,3138813278,-7856457
1644284871,195780,true,3146355099,28,3139127159,-7227940
1644285016,195779,true,3146669735,28,3140068992,-6600743
1644286041,195779,true,3146669735,28,3144153531,-2516204
1644286803,195777,true,3147299100,28,3146355099,-944001
1644287573,195778,true,3146984402,28,3146355099,-629303
1644288608,195777,true,3147299100,28,3146355099,-944001
1644289400,195777,true,3147299100,28,3146669735,-629365
1644290008,195776,true,3147613830,28,3146669735,-944095
1644290350,195778,true,3146984402,28,3146040495,-943907
1644290415,195776,true,3147613830,28,3145725923,-1887907
1644292588,195775,true,3147928592,28,3142267699,-5660893
1644294286,195773,true,3148558209,28,3142267699,-6290510
1644295020,195775,true,3147928592,28,3142267699,-5660893
1644295061,195774,true,3148243384,28,3142267699,-5975685
1644295161,195773,true,3148558209,28,3142581926,-5976283
1644295252,195772,true,3148873065,28,3142896184,-5976881
1644295741,195773,true,3148558209,28,3144467947,-4090262
1644296071,195772,true,3148873065,28,3145725923,-3147142
1644296189,195771,true,3149187952,28,3146040495,-3147457
1644296224,195770,true,3149502871,28,3146355099,-3147772
1644296227,195771,true,3149187952,28,3146355099,-2832853
1644296377,195769,true,3149817821,28,3147613830,-2203991
1644296691,195768,true,3150132803,28,3150447816,315013
1644296907,195767,true,3150447816,28,3152338557,1890741
1644296927,195769,true,3149817821,28,3152338557,2520736
1644297315,195767,true,3150447816,28,3155492315,5044499
1644297423,195766,true,3150762861,28,3156439057,5676196
1644298087,195765,true,3151077937,28,3161177031,10099094
1644298431,195766,true,3150762861,28,3162441692,11678831
1644299016,195765,true,3151077937,28,3164023229,12945292
1644299132,195765,true,3151077937,28,3164339631,13261694
1644299182,195765,true,3151077937,28,3164656065,13578128
1644299204,195766,true,3150762861,28,3164656065,13893204
1644299403,195765,true,3151077937,28,3166238710,15160773
1644299493,195764,true,3151393045,28,3167188676,15795631
1644299532,195763,true,3151708184,28,3167505395,15797211
1644299555,195764,true,3151393045,28,3167822146,16429101
1644299567,195762,true,3152023355,28,3167822146,15798791
1644300504,195758,true,3153284353,28,3181154310,27869957
1644300610,195757,true,3153599682,28,3182426963,28827281
1644300643,195758,true,3153284353,28,3183381786,30097433
1644300678,195757,true,3153599682,28,3184336896,30737214
1644301143,195752,true,3155176797,28,3195181525,40004728
1644301213,195751,true,3155492315,28,3196779435,41287120
1644301355,195752,true,3155176797,28,3199337754,44160957
1644301975,195751,true,3155492315,28,3209270593,53778278
1644302130,195747,true,3156754701,28,3210554493,53799792
1644302150,195747,true,3156754701,28,3210554493,53799792
1644302236,195748,true,3156439057,28,3211196636,54757579
1644302439,195748,true,3156439057,28,3211838908,55399851
1644302471,195745,true,3157386084,28,3211517756,54131672
1644302495,195745,true,3157386084,28,3211196636,53810552
1644302497,195746,true,3157070377,28,3211196636,54126259
1644302825,195747,true,3156754701,28,3207025002,50270301
1644302846,195743,true,3158017592,28,3206704331,48686739
1644303007,195744,true,3157701822,28,3204140122,46438300
1644303060,195744,true,3157701822,28,3203179072,45477250
1644303930,195745,true,3157386084,28,3188160203,30774119
1644303971,195742,true,3158333394,28,3187841419,29508025
1644304002,195742,true,3158333394,28,3187522667,29189273
1644304063,195741,true,3158649227,28,3186885258,28236031
1644304235,195741,true,3158649227,28,3184973796,26324569
1644306446,195738,true,3159596917,28,3177974905,18377988
1644306704,195739,true,3159280989,28,3177974905,18693916
1644306826,195738,true,3159596917,28,3177974905,18377988
1644307055,195739,true,3159280989,28,3177974905,18693916
1644307529,195735,true,3160544891,28,3177974905,17430014
1644307572,195737,true,3159912877,28,3177974905,18062028
1644307644,195736,true,3160228868,28,3177339405,17110537
1644307664,195736,true,3160228868,28,3177339405,17110537
1644307682,195733,true,3161177031,28,3177339405,16162374
1644307700,195733,true,3161177031,28,3177021703,15844672
1644307960,195733,true,3161177031,28,3173846428,12669397
1644307981,195734,true,3160860945,28,3173529075,12668130
1644308004,195731,true,3161809298,28,3173211754,11402456
1644308127,195731,true,3161809298,28,3170674326,8865028
1644308331,195733,true,3161177031,28,3165922118,4745087
1644308352,195734,true,3160860945,28,3165289028,4428083
1644308816,195731,true,3161809298,28,3153915042,-7894256
1644309092,195733,true,3161177031,28,3146669735,-14507296
1644309098,195734,true,3160860945,28,3146355099,-14505846
1644309162,195735,true,3160544891,28,3144467947,-16076944
1644309283,195733,true,3161177031,28,3140697037,-20479994
1644310489,195736,true,3160228868,28,3121285922,-38942946
1644310620,195738,true,3159596917,28,3119413806,-40183111
1644311405,195739,true,3159280989,28,3113804192,-45476797
1644311419,195737,true,3159912877,28,3113804192,-46108685
1644311435,195740,true,3158965092,28,3113804192,-45160900
1644311565,195742,true,3158333394,28,3111936563,-46396831
1644311662,195745,true,3157386084,28,3110692100,-46693984
1644311700,195744,true,3157701822,28,3110381061,-47320761
1644311948,195747,true,3156754701,28,3106029792,-50724909
1644311957,195750,true,3155807864,28,3105719220,-50088644
1644312085,195752,true,3155176797,28,3103856441,-51320356
1644312585,195751,true,3155492315,28,3097655241,-57837074
1644312928,195754,true,3154545856,28,3094249864,-60295992
1644312933,195756,true,3153915042,28,3094249864,-59665178
1644313033,195759,true,3152969057,28,3093321775,-59647282
1644313224,195756,true,3153915042,28,3091775578,-62139464
1644313298,195758,true,3153284353,28,3091775578,-61508775
1644313330,195760,true,3152653791,28,3092084755,-60569036
1644313360,195762,true,3152023355,28,3092084755,-59938600
1644313387,195760,true,3152653791,28,3092084755,-60569036
1644314841,195761,true,3152338557,28,3100754291,-51584266
1644314989,195763,true,3151708184,28,3100754291,-50953893
1644315005,195766,true,3150762861,28,3100754291,-50008570
1644315134,195763,true,3151708184,28,3100444246,-51263938
1644315593,195765,true,3151077937,28,3098274803,-52803134
1644315911,195768,true,3150132803,28,3096726130,-53406673
1644316100,195771,true,3149187952,28,3096106878,-53081074
1644316120,195768,true,3150132803,28,3096106878,-54025925
1644316204,195771,true,3149187952,28,3095797298,-53390654
1644316353,195773,true,3148558209,28,3095487750,-53070459
1644316380,195776,true,3147613830,28,3095487750,-52126080
1644316621,195774,true,3148243384,28,3095178232,-53065152
1644316826,195776,true,3147613830,28,3095487750,-52126080
1644317271,195778,true,3146984402,28,3097655241,-49329161
1644317656,195781,true,3146040495,28,3100134233,-45906262
1644317716,195779,true,3146669735,28,3100444246,-46225489
1644318081,195781,true,3146040495,28,3103235763,-42804732
1644318099,195783,true,3145411382,28,3103235763,-42175619
1644318121,195785,true,3144782394,28,3103546086,-41236308
1644318414,195783,true,3145411382,28,3106029792,-39381590
1644319518,195784,true,3145096872,28,3113804192,-31292680
1644319563,195786,true,3144467947,28,3113804192,-30663755
1644319601,195788,true,3143839148,28,3113804192,-30034956
1644320737,195786,true,3144467947,28,3110692100,-33775847
1644321782,195788,true,3143839148,28,3106340395,-37498753
1644322173,195790,true,3143210474,28,3105408679,-37801795
1644322214,195793,true,3142267699,28,3105408679,-36859020
1644322223,195791,true,3142896184,28,3105408679,-37487505
1644322361,195793,true,3142267699,28,3104787691,-37480008
1644322591,195796,true,3141325208,28,3103856441,-37468767
1644322722,195799,true,3140382998,28,3103235763,-37147235
1644322832,195798,true,3140697037,28,3102615208,-38081829
1644322993,195800,true,3140068992,28,3101374473,-38694519
1644323017,195804,true,3138813278,28,3101064366,-37748912
1644323130,195807,true,3137871822,28,3099204379,-38667443
1644323136,195807,true,3137871822,28,3099204379,-38667443
1644323152,195810,true,3136930649,28,3098894489,-38036160
1644323176,195814,true,3135676190,28,3098584631,-37091559
1644323527,195818,true,3134422233,28,3091775578,-42646655
1644323627,195817,true,3134735676,28,3089612200,-45123476
1644323922,195821,true,3133482095,28,3083439459,-50042636
1644324544,195825,true,3132229015,28,3071438063,-60790952
1644325337,195831,true,3130350335,28,3065914723,-64435612
1644325462,195830,true,3130663370,28,3065608163,-65055207
1644325479,195834,true,3129411418,28,3065914723,-63496695
1644325609,195838,true,3128159966,28,3065914723,-62245243
1644325710,195843,true,3126596355,28,3066221315,-60375040
1644326356,195844,true,3126283727,28,3068675151,-57608576
1644326405,195847,true,3125346030,28,3068982018,-56364012
1644326941,195851,true,3124096204,28,3071130950,-52965254
1644327387,195857,true,3122222402,28,3072359587,-49862815
1644327401,195859,true,3121598051,28,3072359587,-49238464
1644328118,195863,true,3120349724,28,3074818335,-45531389
1644328230,195867,true,3119101896,28,3075125817,-43976079
1644328245,195872,true,3117542813,28,3075125817,-42416996
1644328303,195874,true,3116919398,28,3075740873,-41178525
1644328504,195878,true,3115672942,28,3076663687,-39009255
1644328836,195882,true,3114426984,28,3078817998,-35608986
1644328869,195886,true,3113181524,28,3079125880,-34055644
1644328899,195888,true,3112558982,28,3079125880,-33433102
1644328973,195891,true,3111625401,28,3079741736,-31883665
1644329279,195895,true,3110381061,28,3081281915,-29099146
1644329535,195898,true,3109448134,28,3082514612,-26933522
1644329758,195900,true,3108826337,28,3083131146,-25695191
1644329899,195903,true,3107893876,28,3083747803,-24146073
1644330679,195906,true,3106961694,28,3087141622,-19820072
1644330960,195909,true,3106029792,28,3088376664,-17653128
1644331218,195910,true,3105719220,28,3089612200,-16107020
1644331790,195913,true,3104787691,28,3094559289,-10228402
1644331934,195916,true,3103856441,28,3094868745,-8987696
1644331957,195918,true,3103235763,28,3094868745,-8367018
1644332160,195920,true,3102615208,28,3094559289,-8055919
1644332228,195923,true,3101684610,28,3094559289,-7125321
1644332302,195926,true,3100754291,28,3094249864,-6504427
1644332399,195928,true,3100134233,28,3093940470,-6193763
1644332418,195930,true,3099514299,28,3093940470,-5573829
1644332471,195934,true,3098274803,28,3093631107,-4643696
1644332500,195937,true,3097345507,28,3093321775,-4023732
1644332593,195940,true,3096416489,28,3092084755,-4331734
1644332925,195941,true,3096106878,28,3087450336,-8656542
1644332948,195945,true,3094868745,28,3086832939,-8035806
1644333353,195948,true,3093940470,28,3076356052,-17584418
1644333411,195951,true,3093012473,28,3074510884,-18501589
1644333457,195953,true,3092393964,28,3072974090,-19419874
1644333541,195957,true,3091157315,28,3070823868,-20333447
1644333984,195958,true,3090848230,28,3061625660,-29222570
1644334024,195961,true,3089921161,28,3061013427,-28907734
1644334558,195962,true,3089612200,28,3056119966,-33492234
1644335092,195966,true,3088376664,28,3055508834,-32867830
1644335116,195967,true,3088067857,28,3055814385,-32253472
1644335132,195970,true,3087141622,28,3055814385,-31327237
1644335174,195971,true,3086832939,28,3056425578,-30407361
1644335719,195971,true,3086832939,28,3062238016,-24594923
1644335750,195972,true,3086524287,28,3062544240,-23980047
1644336030,195974,true,3085907074,28,3064688664,-21218410
1644337451,195975,true,3085598514,28,3076663687,-8934827
1644337556,195975,true,3085598514,28,3076971354,-8627160
1644338446,195976,true,3085289985,28,3077586779,-7703206
1644338932,195977,true,3084981487,28,3077586779,-7394708
1644338939,195977,true,3084981487,28,3077586779,-7394708
1644338954,195976,true,3085289985,28,3077586779,-7703206
1644338970,195977,true,3084981487,28,3077586779,-7394708
1644339194,195980,true,3084056178,28,3075433329,-8622849
1644339206,195980,true,3084056178,28,3075433329,-8622849
1644339271,195980,true,3084056178,28,3074818335,-9237843
1644339293,195981,true,3083747803,28,3074510884,-9236919
1644339912,195984,true,3082822864,28,3065914723,-16908141
1644340747,195985,true,3082514612,28,3052455005,-30059607
1644341669,195985,true,3082514612,28,3050624173,-31890439
1644342167,195986,true,3082206392,28,3050624173,-31582219
1644342231,195989,true,3081281915,28,3050319141,-30962774
1644342605,195991,true,3080665751,28,3047879983,-32785768
1644342684,195992,true,3080357715,28,3047270499,-33087216
1644342725,195993,true,3080049710,28,3046965802,-33083908
1644342730,195997,true,3078817998,28,3046965802,-31852196
1644343049,195998,true,3078510147,28,3046051895,-32458252
1644343541,195997,true,3078817998,28,3045138262,-33679736
1644343633,195998,true,3078510147,28,3045138262,-33371885
1644343942,196002,true,3077279051,28,3045138262,-32140789
1644344312,196003,true,3076971354,28,3048794439,-28176915
1644344804,196002,true,3077279051,28,3052455005,-24824046
1644345043,196003,true,3076971354,28,3053981538,-22989816
1644345291,196007,true,3075740873,28,3055814385,-19926488
1644346491,196007,true,3075740873,28,3063463095,-12277778
1644346528,196006,true,3076048447,28,3063463095,-12585352
1644346602,196007,true,3075740873,28,3063769441,-11971432
1644346624,196011,true,3074510884,28,3063769441,-10741443
1644348171,196011,true,3074510884,28,3061931823,-12579061
1644348264,196011,true,3074510884,28,3061625660,-12885224
1644348333,196013,true,3073896074,28,3061319528,-12576546
1644348342,196016,true,3072974090,28,3061319528,-11654562
1644348426,196018,true,3072359587,28,3060401316,-11958271
1644348539,196019,true,3072052382,28,3059789328,-12263054
1644349551,196020,true,3071745207,28,3051539451,-20205756
1644349614,196024,true,3070516816,28,3050929235,-19587581
1644349965,196026,true,3069902805,28,3047879983,-22022822
1644350619,196026,true,3069902805,28,3045747320,-24155485
1644350641,196028,true,3069288916,28,3045747320,-23541596
1644350905,196031,true,3068368314,28,3046356500,-22011814
1644350983,196032,true,3068061508,28,3046661136,-21400372
1644351209,196031,true,3068368314,28,3048184771,-20183543
1644351269,196033,true,3067754732,28,3048489590,-19265142
1644351316,196036,true,3066834590,28,3048794439,-18040151
1644351773,196037,true,3066527937,28,3053676170,-12851767
1644351998,196035,true,3067141273,28,3056425578,-10715695
1644352062,196036,true,3066834590,28,3057342597,-9491993
1644352135,196039,true,3065914723,28,3058259892,-7654831
1644352184,196038,true,3066221315,28,3058871574,-7349741
1644352204,196036,true,3066834590,28,3059177462,-7657128
1644352244,196037,true,3066527937,28,3060095307,-6432630
1644352278,196038,true,3066221315,28,3060707356,-5513959
1644352312,196038,true,3066221315,28,3061319528,-4901787
1644352326,196035,true,3067141273,28,3061625660,-5515613
1644352333,196035,true,3067141273,28,3061931823,-5209450
1644352354,196036,true,3066834590,28,3062238016,-4596574
1644352470,196035,true,3067141273,28,3064995133,-2146140
1644352515,196032,true,3068061508,28,3065914723,-2146785
1644352541,196032,true,3068061508,28,3066527937,-1533571
1644352684,196034,true,3067447987,28,3069902805,2454818
1644352794,196032,true,3068061508,28,3072666823,4605315
1644352826,196029,true,3068982018,28,3073281387,4299369
1644352890,196029,true,3068982018,28,3075125817,6143799
1644353438,196030,true,3068675151,28,3089303270,20628119
1644353514,196028,true,3069288916,28,3091157315,21868399
1644353731,196025,true,3070209795,28,3096416489,26206694
1644354157,196026,true,3069902805,28,3105408679,35505874
1644354176,196026,true,3069902805,28,3105719220,35816415
1644354647,196024,true,3070516816,28,3113181524,42664708
1644354786,196021,true,3071438063,28,3114115572,42677509
1644356096,196022,true,3071130950,28,3117854567,46723617
1644359127,196022,true,3071130950,28,3116296107,45165157
1644359436,196020,true,3071745207,28,3116296107,44550900
1644359447,196017,true,3072666823,28,3116296107,43629284
1644359644,196018,true,3072359587,28,3116296107,43936520
1644359668,196018,true,3072359587,28,3116296107,43936520
1644359682,196017,true,3072666823,28,3116296107,43629284
1644359695,196014,true,3073588715,28,3116296107,42707392
1644360965,196015,true,3073281387,28,3112247757,38966370
1644361043,196016,true,3072974090,28,3111936563,38962473
1644361333,196014,true,3073588715,28,3111003169,37414454
1644362106,196012,true,3074203464,28,3111003169,36799705
1644362158,196014,true,3073588715,28,3111003169,37414454
1644362216,196014,true,3073588715,28,3111314269,37725554
1644362257,196012,true,3074203464,28,3111625401,37421937
1644362522,196008,true,3075433329,28,3113492843,38059514
1644362566,196010,true,3074818335,28,3113804192,38985857
1644362637,196010,true,3074818335,28,3114426984,39608649
1644362991,196008,true,3075433329,28,3117231090,41797761
1644364262,196003,true,3076971354,28,3128159966,51188612
1644364723,196004,true,3076663687,28,3129411418,52747731
1644365746,196004,true,3076663687,28,3128472782,51809095
1644366408,196001,true,3077586779,28,3128472782,50886003
1644366441,195996,true,3079125880,28,3128472782,49346902
1644366832,195996,true,3079125880,28,3126596355,47470475
1644367797,195996,true,3079125880,28,3121598051,42472171
1644367899,195993,true,3080049710,28,3120973825,40924115
1644368151,195988,true,3081590043,28,3120349724,38759681
1644368368,195988,true,3081590043,28,3120349724,38759681
1644368653,195988,true,3081590043,28,3121285922,39695879
1644370598,195985,true,3082514612,28,3124096204,41581592
1644370734,195981,true,3083747803,28,3124096204,40348401
1644371360,195981,true,3083747803,28,3121598051,37850248
1644371622,195981,true,3083747803,28,3120661759,36913956
1644371655,195978,true,3084673020,28,3120349724,35676704
1644371679,195975,true,3085598514,28,3120349724,34751210
1644371794,195976,true,3085289985,28,3119725747,34435762
1644372232,195976,true,3085289985,28,3116919398,31629413
1644372282,195974,true,3085907074,28,3116607737,30700663
1644372366,195971,true,3086832939,28,3115984509,29151570
1644372389,195972,true,3086524287,28,3115672942,29148655
1644372497,195973,true,3086215665,28,3114115572,27899907
1644372529,195971,true,3086832939,28,3113804192,26971253
1644372579,195969,true,3087450336,28,3113181524,25731188
1644372619,195969,true,3087450336,28,3112558982,25108646
1644372663,195969,true,3087450336,28,3111936563,24486227
1644372724,195968,true,3087759081,28,3111003169,23244088
1644372862,195966,true,3088376664,28,3108204665,19828001
1644372875,195967,true,3088067857,28,3108204665,20136808
1644372910,195966,true,3088376664,28,3107272390,18895726
1644373615,195964,true,3088994370,28,3093012473,4018103
1644373827,195962,true,3089612200,28,3089303270,-308930
1644373881,195963,true,3089303270,28,3088067857,-1235413
1644373984,195962,true,3089612200,28,3086215665,-3396535
1644374005,195961,true,3089921161,28,3085598514,-4322647
1644375812,195959,true,3090539177,28,3072974090,-17565087
1644378057,195959,true,3090539177,28,3076663687,-13875490
1644378332,195958,true,3090848230,28,3076663687,-14184543
1644378978,195957,true,3091157315,28,3076971354,-14185961
1644379557,195955,true,3091775578,28,3076971354,-14804224
1644379627,195956,true,3091466431,28,3076971354,-14495077
1644379779,195955,true,3091775578,28,3077279051,-14496527
1644379792,195954,true,3092084755,28,3077279051,-14805704
1644380124,195952,true,3092703203,28,3078202327,-14500876
1644382031,195952,true,3092703203,28,3083131146,-9572057
1644382165,195952,true,3092703203,28,3083439459,-9263744
1644382410,195952,true,3092703203,28,3083747803,-8955400
1644382990,195950,true,3093321775,28,3084673020,-8648755
1644383053,195950,true,3093321775,28,3084673020,-8648755
1644383057,195949,true,3093631107,28,3084673020,-8958087
1644383442,195949,true,3093631107,28,3083439459,-10191648
1644383467,195948,true,3093940470,28,3083439459,-10501011
1644383474,195948,true,3093940470,28,3083439459,-10501011
1644383961,195948,true,3093940470,28,3080357715,-13582755
1644383967,195947,true,3094249864,28,3080357715,-13892149
1644384033,195945,true,3094868745,28,3079741736,-15127009
1644384169,195945,true,3094868745,28,3078202327,-16666418
1644384775,195945,true,3094868745,28,3072359587,-22509158
1644384850,195945,true,3094868745,28,3071745207,-23123538
1644385043,195943,true,3095487750,28,3071130950,-24356800
1644385114,195942,true,3095797298,28,3071130950,-24666348
1644385278,195942,true,3095797298,28,3070823868,-24973430
1644385378,195941,true,3096106878,28,3071130950,-24975928
1644385431,195940,true,3096416489,28,3071438063,-24978426
1644385454,195940,true,3096416489,28,3071438063,-24978426
1644385494,195939,true,3096726130,28,3072052382,-24673748
1644385619,195938,true,3097035803,28,3073896074,-23139729
1644387367,195936,true,3097655241,28,3097965007,309766
1644389202,195936,true,3097655241,28,3097965007,309766
1644389323,195935,true,3097965007,28,3098274803,309796
1644389435,195934,true,3098274803,28,3098274803,0
1644391875,195933,true,3098584631,28,3098894489,309858
1644392150,195933,true,3098584631,28,3098274803,-309828
1644392194,195933,true,3098584631,28,3098274803,-309828
1644392222,195932,true,3098894489,28,3097965007,-929482
1644392265,195931,true,3099204379,28,3097965007,-1239372
1644392924,195931,true,3099204379,28,3095797298,-3407081
1644393396,195932,true,3098894489,28,3094249864,-4644625
1644393475,195931,true,3099204379,28,3093940470,-5263909
1644393569,195931,true,3099204379,28,3093940470,-5263909
1644393846,195930,true,3099514299,28,3095487750,-4026549
1644394226,195930,true,3099514299,28,3097655241,-1859058
1644394631,195930,true,3099514299,28,3100444246,929947
1644394676,195930,true,3099514299,28,3100754291,1239992
1644394719,195930,true,3099514299,28,3100754291,1239992
1644394849,195931,true,3099204379,28,3101064366,1859987
1644394923,195932,true,3098894489,28,3101064366,2169877
1644394971,195931,true,3099204379,28,3101064366,1859987
1644394992,195931,true,3099204379,28,3100754291,1549912
1644395089,195933,true,3098584631,28,3100444246,1859615
1644395158,195935,true,3097965007,28,3100134233,2169226
1644395269,195935,true,3097965007,28,3099514299,1549292
1644395474,195935,true,3097965007,28,3097655241,-309766
1644396493,195937,true,3097345507,28,3084981487,-12364020
1644396568,195939,true,3096726130,28,3084364584,-12361546
1644396585,195939,true,3096726130,28,3084364584,-12361546
1644396595,195939,true,3096726130,28,3084364584,-12361546
1644396695,195940,true,3096416489,28,3084056178,-12360311
1644396710,195942,true,3095797298,28,3084056178,-11741120
1644396795,195942,true,3095797298,28,3084056178,-11741120
1644397218,195942,true,3095797298,28,3085598514,-10198784
1644397277,195943,true,3095487750,28,3085907074,-9580676
1644397388,195944,true,3095178232,28,3086524287,-8653945
1644397410,195944,true,3095178232,28,3086832939,-8345293
1644397554,195943,true,3095487750,28,3088067857,-7419893
1644397594,195944,true,3095178232,28,3088376664,-6801568
1644397696,195946,true,3094559289,28,3089612200,-4947089
1644397774,195946,true,3094559289,28,3090539177,-4020112
1644397827,195946,true,3094559289,28,3091157315,-3401974
1644397963,195947,true,3094249864,28,3093012473,-1237391
1644398705,195948,true,3093940470,28,3101994778,8054308
1644399504,195949,true,3093631107,28,3107583118,13952011
1644400934,195948,true,3093940470,28,3105408679,11468209
1644401362,195949,true,3093631107,28,3104477243,10846136
1644401405,195950,true,3093321775,28,3104787691,11465916
1644401406,195951,true,3093012473,28,3104787691,11775218
1644401632,195950,true,3093321775,28,3106029792,12708017
1644402017,195950,true,3093321775,28,3109448134,16126359
1644402051,195950,true,3093321775,28,3109448134,16126359
1644402111,195952,true,3092703203,28,3110381061,17677858
1644402340,195950,true,3093321775,28,3113181524,19859749
1644404979,195948,true,3093940470,28,3135362654,41422184
1644405224,195949,true,3093631107,28,3135049149,41418042
1644406424,195951,true,3093012473,28,3132855492,39843019
1644406641,195949,true,3093631107,28,3132229015,38597908
1644406688,195947,true,3094249864,28,3132229015,37979151
1644407149,195947,true,3094249864,28,3133482095,39232231
1644407352,195948,true,3093940470,28,3134735676,40795206
1644407622,195946,true,3094559289,28,3136616987,42057698
1644407712,195944,true,3095178232,28,3137244342,42066110
1644407921,195944,true,3095178232,28,3138499428,43321196
1644409150,195944,true,3095178232,28,3148243384,53065152
1644409640,195942,true,3095797298,28,3150132803,54335505
1644409673,195939,true,3096726130,28,3150132803,53406673
1644409853,195938,true,3097035803,28,3150447816,53412013
1644410114,195938,true,3097035803,28,3150762861,53727058
1644410221,195935,true,3097965007,28,3151077937,53112930
1644410370,195932,true,3098894489,28,3151708184,52813695
1644410414,195931,true,3099204379,28,3152023355,52818976
1644410457,195930,true,3099514299,28,3152338557,52824258
1644410485,195927,true,3100444246,28,3152969057,52524811
1644410526,195922,true,3101994778,28,3153599682,51604904
1644410620,195920,true,3102615208,28,3155176797,52561589
1644410729,195918,true,3103235763,28,3157070377,53834614
1644412245,195915,true,3104166826,28,3183381786,79214960
1644412279,195910,true,3105719220,28,3183700125,77980905
1644412402,195908,true,3106340395,28,3184655330,78314935
1644415029,195905,true,3107272390,28,3199657688,92385298
1644415108,195901,true,3108515486,28,3199657688,91142202
1644415284,195896,true,3110070054,28,3199017852,88947798
1644415354,195894,true,3110692100,28,3198697983,88005883
1644415366,195891,true,3111625401,28,3198697983,87072582
1644415397,195888,true,3112558982,28,3198378145,85819163
1644415408,195884,true,3113804192,28,3198378145,84573953
1644415590,195882,true,3114426984,28,3196459789,82032805
1644416008,195880,true,3115049900,28,3191030695,75980795
1644416103,195877,true,3115984509,28,3189754602,73770093
1644416107,195873,true,3117231090,28,3189754602,72523512
1644416130,195871,true,3117854567,28,3189435658,71581091
1644416271,195870,true,3118166352,28,3187522667,69356315
1644416755,195866,true,3119413806,28,3181790573,62376767
1644417063,195862,true,3120661759,28,3179246286,58584527
1644417196,195860,true,3121285922,28,3179246286,57960364
1644417251,195858,true,3121910211,28,3179564210,57653999
1644417301,195854,true,3123159162,28,3179882167,56723005
1644417523,195849,true,3124721054,28,3181790573,57069519
1644417759,195846,true,3125658564,28,3184655330,58996766
1644417765,195844,true,3126283727,28,3184655330,58371603
1644418120,195839,true,3127847182,28,3191030695,63183513
1644418394,195833,true,3129724359,28,3196140175,66415816
1644418640,195830,true,3130663370,28,3199977654,69314284
1644418664,195828,true,3131289534,28,3199977654,68688120
1644419537,195824,true,3132542238,28,3205101460,72559222
1644419619,195818,true,3134422233,28,3204780982,70358749
1644419683,195816,true,3135049149,28,3204460536,69411387
1644419701,195814,true,3135676190,28,3204140122,68463932
1644419718,195810,true,3136930649,28,3204140122,67209473
1644419815,195806,true,3138185609,28,3202858786,64673177
1644419816,195805,true,3138499428,28,3202858786,64359358
1644419982,195804,true,3138813278,28,3200297652,61484374
1644422643,195801,true,3139755016,28,3179564210,39809194
1644422868,195797,true,3141011107,28,3179882167,38871060
1644423458,195795,true,3141639340,28,3181472426,39833086
1644424456,195794,true,3141953504,28,3184018495,42064991
1644424508,195791,true,3142896184,28,3184018495,41122311
1644424819,195787,true,3144153531,28,3184973796,40820265
1644425179,195785,true,3144782394,28,3185610822,40828428
1644425205,195784,true,3145096872,28,3185610822,40513950
1644425287,195780,true,3146355099,28,3186247976,39892877
1644425296,195776,true,3147613830,28,3186247976,38634146
1644425486,195774,true,3148243384,28,3188160203,39916819
1644425489,195772,true,3148873065,28,3188160203,39287138
1644425532,195769,true,3149817821,28,3188479019,38661198
1644427136,195764,true,3151393045,28,3203499390,52106345
1644428777,195762,true,3152023355,28,3207345704,55322349
1644428879,195760,true,3152653791,28,3207666439,55012648
1644429450,195757,true,3153599682,28,3207666439,54066757
1644430407,195753,true,3154861311,28,3207666439,52805128
1644430421,195749,true,3156123445,28,3207666439,51542994
1644430452,195747,true,3156754701,28,3207666439,50911738
1644431084,195744,true,3157701822,28,3207025002,49323180
1644431159,195739,true,3159280989,28,3207025002,47744013
1644431169,195736,true,3160228868,28,3206704331,46475463
1644431649,195734,true,3160860945,28,3203819740,42958795
1644432238,195731,true,3161809298,28,3199977654,38168356
1644432381,195726,true,3163390519,28,3199337754,35947235
1644432509,195723,true,3164339631,28,3198378145,34038514
1644432937,195721,true,3164972531,28,3196459789,31487258
1644433035,195718,true,3165922118,28,3196459789,30537671
1644433055,195714,true,3167188676,28,3196779435,29590759
1644433204,195711,true,3168138928,28,3197099113,28960185
1644433388,195708,true,3169089465,28,3198058339,28968874
1644433407,195706,true,3169723314,28,3198058339,28335025
1644433434,195701,true,3171308493,28,3198378145,27069652
1644433455,195698,true,3172259981,28,3198378145,26118164
1644433579,195695,true,3173211754,28,3199657688,26445934
1644433584,195692,true,3174163813,28,3199657688,25493875
1644433645,195688,true,3175433669,28,3200617681,25184012
1644433682,195685,true,3176386394,28,3200937743,24551349
1644433765,195681,true,3177657139,28,3202538532,24881393
1644433934,195678,true,3178610532,28,3205742512,27131980
1644434713,195674,true,3179882167,28,3220522156,40639989
1644434763,195671,true,3180836227,28,3221488409,40652182
1644434794,195667,true,3182108752,28,3222132739,40023987
1644434903,195664,true,3183063480,28,3224066502,41003022
1644434950,195659,true,3184655330,28,3225356322,40700992
1644434962,195656,true,3185610822,28,3225356322,39745500
1644435455,195651,true,3187203946,28,3235369939,48165993
1644437360,195648,true,3188160203,28,3249961180,61800977
1644438575,195644,true,3189435658,28,3252887315,63451657
1644438618,195641,true,3190392585,28,3253212604,62820019
1644440169,195636,true,3191988100,28,3260703229,68715129
1644441741,195633,true,3192945792,28,3261355403,68409611
1644443269,195630,true,3193903772,28,3261355403,67451631
1644443294,195627,true,3194862039,28,3261355403,66493364
1644443582,195622,true,3196459789,28,3261029300,64569511
1644443756,195619,true,3197418823,28,3260377192,62958369
1644444987,195616,true,3198378145,28,3253212604,54834459
1644445424,195613,true,3199337754,28,3250936266,51598512
1644446532,195609,true,3200617681,28,3246713006,46095325
1644447239,195607,true,3201257837,28,3244116804,42858967
1644447559,195605,true,3201898120,28,3244765659,42867539
1644449819,195602,true,3202858786,28,3246388367,43529581
1644450754,195598,true,3204140122,28,3246388367,42248245
1644452117,195596,true,3204780982,28,3246388367,41607385
1644452176,195594,true,3205421970,28,3246388367,40966397
1644452200,195591,true,3206383693,28,3246388367,40004674
1644452221,195588,true,3207345704,28,3246388367,39042663
1644452252,195586,true,3207987205,28,3246388367,38401162
1644452274,195584,true,3208628835,28,3246063760,37434925
1644452281,195582,true,3209270593,28,3246063760,36793167
1644452562,195580,true,3209912479,28,3243792424,33879945
1644452563,195578,true,3210554493,28,3243792424,33237931
1644452689,195577,true,3210875549,28,3242819481,31943932
1644453034,195576,true,3211196636,28,3239254519,28057883
1644453134,195574,true,3211838908,28,3237959141,26120233
1644454090,195573,true,3212160092,28,3228260304,16100212
1644455104,195572,true,3212481308,28,3226969323,14488015
1644455355,195571,true,3212802556,28,3226324026,13521470
1644459976,195571,true,3212802556,28,3221488409,8685853
1644460233,195571,true,3212802556,28,3221488409,8685853
1644460478,195570,true,3213123836,28,3221488409,8364573
1644460501,195569,true,3213445149,28,3221488409,8043260
1644461334,195568,true,3213766493,28,3221488409,7721916
1644461402,195567,true,3214087870,28,3221488409,7400539
1644461477,195566,true,3214409278,28,3220844208,6434930
1644461819,195565,true,3214730719,28,3218912378,4181659
1644461860,195564,true,3215052192,28,3218268692,3216500
1644461911,195564,true,3215052192,28,3217946897,2894705
1644462001,195563,true,3215373698,28,3216981706,1608008
1644462167,195562,true,3215695235,28,3214730719,-964516
1644462187,195562,true,3215695235,28,3214409278,-1285957
1644462255,195562,true,3215695235,28,3213123836,-2571399
1644462393,195561,true,3216016805,28,3210875549,-5141256
1644462435,195561,true,3216016805,28,3209912479,-6104326
1644462736,195561,true,3216016805,28,3203499390,-12517415
1644462970,195562,true,3215695235,28,3198697983,-16997252
1644465347,195562,true,3215695235,28,3183700125,-31995110
1644465661,195562,true,3215695235,28,3183700125,-31995110
1644466159,195563,true,3215373698,28,3183700125,-31673573
1644467751,195564,true,3215052192,28,3183700125,-31352067
1644467767,195565,true,3214730719,28,3183700125,-31030594
1644467782,195565,true,3214730719,28,3183700125,-31030594
1644467794,195565,true,3214730719,28,3183381786,-31348933
1644468519,195567,true,3214087870,28,3180836227,-33251643
1644468611,195567,true,3214087870,28,3180518175,-33569695
1644469709,195568,true,3213766493,28,3173846428,-39920065
1644472902,195569,true,3213445149,28,3168138928,-45306221
1644473005,195570,true,3213123836,28,3168138928,-44984908
1644473138,195570,true,3213123836,28,3168455742,-44668094
1644475001,195570,true,3213123836,28,3172259981,-40863855
1644475012,195570,true,3213123836,28,3172577207,-40546629
1644475117,195571,true,3212802556,28,3172577207,-40225349
1644475202,195571,true,3212802556,28,3172894464,-39908092
1644475474,195571,true,3212802556,28,3173846428,-38956128
1644477215,195570,true,3213123836,28,3181154310,-31969526
1644478257,195571,true,3212802556,28,3182108752,-30693804
1644479637,195571,true,3212802556,28,3182426963,-30375593
1644479778,195571,true,3212802556,28,3182745206,-30057350
1644480428,195571,true,3212802556,28,3184655330,-28147226
1644480611,195572,true,3212481308,28,3185292293,-27189015
1644480712,195571,true,3212802556,28,3185610822,-27191734
1644480739,195572,true,3212481308,28,3185929383,-26551925
1644480795,195572,true,3212481308,28,3186247976,-26233332
1644481589,195572,true,3212481308,28,3193584414,-18896894
1644483072,195572,true,3212481308,28,3199017852,-13463456
1644483309,195573,true,3212160092,28,3199017852,-13142240
1644484210,195573,true,3212160092,28,3199017852,-13142240
1644484367,195573,true,3212160092,28,3199017852,-13142240
1644484468,195573,true,3212160092,28,3199017852,-13142240
1644484874,195574,true,3211838908,28,3198378145,-13460763
1644484879,195574,true,3211838908,28,3198378145,-13460763
1644484893,195574,true,3211838908,28,3198378145,-13460763
1644486940,195573,true,3212160092,28,3202218310,-9941782
1644487192,195574,true,3211838908,28,3203179072,-8659836
1644487313,195574,true,3211838908,28,3203819740,-8019168
1644487425,195573,true,3212160092,28,3204460536,-7699556
1644487447,195572,true,3212481308,28,3204780982,-7700326
1644487518,195572,true,3212481308,28,3205421970,-7059338
1644487622,195571,true,3212802556,28,3207025002,-5777554
1644487797,195570,true,3213123836,28,3209912479,-3211357
1644487938,195568,true,3213766493,28,3212481308,-1285185
1644488032,195568,true,3213766493,28,3214409278,642785
1644488253,195567,true,3214087870,28,3219234269,5146399
1644488337,195566,true,3214409278,28,3220844208,6434930
1644488348,195564,true,3215052192,28,3221166292,6114100
1644488735,195564,true,3215052192,28,3230197745,15145553
1644488756,195563,true,3215373698,28,3230843817,15470119
1644488773,195562,true,3215695235,28,3231166901,15471666
1644488865,195560,true,3216338406,28,3233106086,16767680
1644488888,195560,true,3216338406,28,3233752739,17414333
1644488922,195560,true,3216338406,28,3234722962,18384556
1644489001,195559,true,3216660040,28,3236664281,20004241
1644489758,195558,true,3216981706,28,3248986387,32004681
1644490883,195558,true,3216981706,28,3254514084,37532378
1644490997,195558,true,3216981706,28,3254514084,37532378
1644491032,195557,true,3217303404,28,3254514084,37210680
1644492617,195556,true,3217625135,28,3249311285,31686150
1644492725,195557,true,3217303404,28,3248986387,31682983
1644492771,195557,true,3217303404,28,3248986387,31682983
1644492801,195557,true,3217303404,28,3249311285,32007881
1644492846,195556,true,3217625135,28,3249636216,32011081
1644492897,195556,true,3217625135,28,3249961180,32336045
1644492937,195556,true,3217625135,28,3250286176,32661041
1644492941,195556,true,3217625135,28,3250611205,32986070
1644492962,195555,true,3217946897,28,3250611205,32664308
1644493679,195554,true,3218268692,28,3260051187,41782495
1644493727,195555,true,3217946897,28,3260377192,42430295
1644493741,195555,true,3217946897,28,3260703229,42756332
1644493778,195553,true,3218590519,28,3260703229,42112710
1644493790,195553,true,3218590519,28,3261029300,42438781
1644493814,195554,true,3218268692,28,3261029300,42760608
1644495809,195554,true,3218268692,28,3251586486,33317794
1644495821,195552,true,3218912378,28,3251586486,32674108
1644496549,195552,true,3218912378,28,3249636216,30723838
1644498550,195553,true,3218590519,28,3245414645,26824126
1644498576,195554,true,3218268692,28,3245739186,27470494
1644499045,195552,true,3218912378,28,3247687117,28774739
1644499093,195552,true,3218912378,28,3247687117,28774739
1644499346,195553,true,3218590519,28,3248986387,30395868
1644499812,195553,true,3218590519,28,3251261359,32670840
1644499824,195551,true,3219234269,28,3251586486,32352217
1644499835,195551,true,3219234269,28,3251261359,32027090
1644499856,195551,true,3219234269,28,3250936266,31701997
1644499863,195553,true,3218590519,28,3250936266,32345747
1644499902,195553,true,3218590519,28,3250286176,31695657
1644499927,195553,true,3218590519,28,3249636216,31045697
1644499931,195553,true,3218590519,28,3249636216,31045697
1644500033,195557,true,3217303404,28,3246063760,28760356
1644500156,195558,true,3216981706,28,3240874470,23892764
1644500200,195558,true,3216981706,28,3238930626,21948920
1644500456,195559,true,3216660040,28,3226646658,9986618
1644500467,195564,true,3215052192,28,3226001426,10949234
1644500578,195565,true,3214730719,28,3220200136,5469417
1644500605,195565,true,3214730719,28,3218912378,4181659
1644500613,195566,true,3214409278,28,3218268692,3859414
1644500640,195571,true,3212802556,28,3216660040,3857484
1644501012,195573,true,3212160092,28,3194223162,-17936930
1644501308,195573,true,3212160092,28,3176068787,-36091305
1644501562,195573,true,3212160092,28,3160228868,-51931224
1644501583,195578,true,3210554493,28,3158649227,-51905266
1644501607,195580,true,3209912479,28,3157070377,-52842102
1644501620,195580,true,3209912479,28,3156439057,-53473422
1644501695,195581,true,3209591520,28,3152653791,-56937729
1644501711,195586,true,3207987205,28,3152023355,-55963850
1644501742,195588,true,3207345704,28,3150762861,-56582843
1644501764,195587,true,3207666439,28,3149817821,-57848618
1644501874,195589,true,3207025002,28,3145725923,-61299079
1644502680,195594,true,3205421970,28,3122846877,-82575093
1644503139,195597,true,3204460536,28,3111936563,-92523973
1644503264,195596,true,3204780982,28,3109759079,-95021903
1644503287,195598,true,3204140122,28,3109137220,-95002902
1644503412,195603,true,3202538532,28,3107272390,-95266142
1644503451,195605,true,3201898120,28,3106961694,-94936426
1644503466,195605,true,3201898120,28,3106651029,-95247091
1644503510,195606,true,3201577963,28,3106651029,-94926934
1644503589,195609,true,3200617681,28,3107272390,-93345291
1644503853,195611,true,3199977654,28,3110692100,-89285554
1644504517,195609,true,3200617681,28,3122222402,-78395279
1644504671,195610,true,3200297652,28,3125033526,-75264126
1644504698,195613,true,3199337754,28,3125346030,-73991724
1644504764,195614,true,3199017852,28,3126909015,-72108837
1644504786,195613,true,3199337754,28,3127221706,-72116048
1644505023,195613,true,3199337754,28,3132229015,-67108739
1644505149,195617,true,3198058339,28,3134422233,-63636106
1644505162,195618,true,3197738565,28,3134735676,-63002889
1644505182,195617,true,3198058339,28,3135362654,-62695685
1644505199,195617,true,3198058339,28,3135676190,-62382149
1644505299,195619,true,3197418823,28,3138185609,-59233214
1644505358,195620,true,3197099113,28,3139441072,-57658041
1644505387,195619,true,3197418823,28,3140382998,-57035825
1644505405,195619,true,3197418823,28,3140697037,-56721786
1644505410,195620,true,3197099113,28,3141011107,-56088006
1644505420,195621,true,3196779435,28,3141325208,-55454227
1644505428,195619,true,3197418823,28,3141639340,-55779483
1644505436,195619,true,3197418823,28,3141639340,-55779483
1644505438,195621,true,3196779435,28,3141953504,-54825931
1644505454,195621,true,3196779435,28,3142581926,-54197509
1644505762,195617,true,3198058339,28,3157701822,-40356517
1644505772,195617,true,3198058339,28,3158017592,-40040747
1644505784,195619,true,3197418823,28,3158649227,-38769596
1644505847,195618,true,3197738565,28,3161809298,-35929267
1644505859,195613,true,3199337754,28,3162441692,-36896062
1644505971,195613,true,3199337754,28,3168455742,-30882012
1644506193,195615,true,3198697983,28,3179564210,-19133773
1644506287,195615,true,3198697983,28,3184018495,-14679488
1644506490,195611,true,3199977654,28,3194223162,-5754492
1644506822,195611,true,3199977654,28,3208949698,8972044
1644507031,195613,true,3199337754,28,3217946897,18609143
1644507135,195614,true,3199017852,28,3221810558,22792706
1644507285,195610,true,3200297652,28,3225356322,25058670
1644507519,195610,true,3200297652,28,3226324026,26026374
1644507616,195613,true,3199337754,28,3227292020,27954266
1644507704,195614,true,3199017852,28,3227614749,28596897
1644507734,195609,true,3200617681,28,3227937510,27319829
1644507921,195609,true,3200617681,28,3231166901,30549220
1644508320,195611,true,3199977654,28,3237635378,37657724
1644508341,195612,true,3199657688,28,3237959141,38301453
1644508369,195608,true,3200937743,28,3238282937,37345194
1644508394,195608,true,3200937743,28,3238606765,37669022
1644508451,195612,true,3199657688,28,3238930626,39272938
1644508486,195614,true,3199017852,28,3238930626,39912774
1644508523,195611,true,3199977654,28,3238930626,38952972
1644508739,195612,true,3199657688,28,3236987948,37330260
1644508981,195616,true,3198378145,28,3234399522,36021377
1644509688,195618,true,3197738565,28,3223099476,25360911
1644509719,195616,true,3198378145,28,3222132739,23754594
1644509928,195617,true,3198058339,28,3215695235,17636896
1644509996,195622,true,3196459789,28,3213445149,16985360
1644510309,195624,true,3195820593,28,3206704331,10883738
1644510492,195621,true,3196779435,28,3206063086,9283651
1644510666,195622,true,3196459789,28,3205742512,9282723
1644511118,195627,true,3194862039,28,3204460536,9598497
1644511588,195630,true,3193903772,28,3202538532,8634760
1644511605,195627,true,3194862039,28,3202538532,7676493
1644511674,195629,true,3194223162,28,3202858786,8635624
1644511774,195634,true,3192626530,28,3203499390,10872860
1644511935,195637,true,3191668933,28,3203819740,12150807
1644511977,195635,true,3192307299,28,3204140122,11832823
1644512038,195636,true,3191988100,28,3204460536,12472436
1644512103,195641,true,3190392585,28,3204780982,14388397
1644512170,195643,true,3189754602,28,3205101460,15346858
1644512277,195641,true,3190392585,28,3205742512,15349927
1644512346,195641,true,3190392585,28,3206063086,15670501
1644512430,195645,true,3189116747,28,3206704331,17587584
1644512822,195647,true,3188479019,28,3209591520,21112501
1644513014,195644,true,3189435658,28,3211838908,22403250
1644513742,195643,true,3189754602,28,3226001426,36246824
1644513928,195646,true,3188797867,28,3229228879,40431012
1644514359,195648,true,3188160203,28,3234076115,45915912
1644515103,195645,true,3189116747,28,3236340647,47223900
1644515280,195645,true,3189116747,28,3235046434,45929687
1644515345,195649,true,3187841419,28,3234076115,46234696
1644515387,195651,true,3187203946,28,3233752739,46548793
1644515436,195649,true,3187841419,28,3233106086,45264667
1644515525,195650,true,3187522667,28,3231490018,43967351
1644515572,195651,true,3187203946,28,3230843817,43639871
1644515774,195652,true,3186885258,28,3227614749,40729491
1644516780,195649,true,3187841419,28,3212802556,24961137
1644517104,195650,true,3187522667,28,3208628835,21106168
1644517140,195649,true,3187841419,28,3208308004,20466585
1644517567,195649,true,3187841419,28,3205421970,17580551
1644517727,195647,true,3188479019,28,3204140122,15661103
1644517916,195647,true,3188479019,28,3201898120,13419101
1644518021,195646,true,3188797867,28,3200617681,11819814
1644518097,195646,true,3188797867,28,3199337754,10539887
1644518116,195644,true,3189435658,28,3199337754,9902096
1644519604,195645,true,3189116747,28,3178292702,-10824045
1644519908,195644,true,3189435658,28,3177339405,-12096253
1644520033,195642,true,3190073578,28,3176704033,-13369545
1644520082,195640,true,3190711624,28,3176704033,-14007591
1644520103,195641,true,3190392585,28,3176704033,-13688552
1644520316,195641,true,3190392585,28,3175433669,-14958916
1644520342,195639,true,3191030695,28,3175433669,-15597026
1644520427,195637,true,3191668933,28,3174481229,-17187704
1644520441,195638,true,3191349798,28,3174481229,-16868569
1644520531,195637,true,3191668933,28,3173529075,-18139858
1644520772,195636,true,3191988100,28,3170357291,-21630809
1644520803,195634,true,3192626530,28,3169723314,-22903216
1644520865,195633,true,3192945792,28,3168772588,-24173204
1644520901,195633,true,3192945792,28,3168138928,-24806864
1644520932,195632,true,3193265087,28,3167505395,-25759692
1644522648,195629,true,3194223162,28,3144153531,-50069631
1644522796,195629,true,3194223162,28,3143524795,-50698367
1644522833,195628,true,3194542585,28,3143524795,-51017790
1644523012,195628,true,3194542585,28,3141953504,-52589081
1644523218,195627,true,3194862039,28,3140382998,-54479041
1644523246,195627,true,3194862039,28,3140382998,-54479041
1644523261,195628,true,3194542585,28,3140068992,-54473593
1644523302,195628,true,3194542585,28,3139755016,-54787569
1644523746,195629,true,3194223162,28,3132855492,-61367670
1644523887,195629,true,3194223162,28,3131289534,-62933628
1644524116,195629,true,3194223162,28,3129411418,-64811744
1644524137,195630,true,3193903772,28,3129098508,-64805264
1644524543,195629,true,3194223162,28,3126909015,-67314147
1644524549,195630,true,3193903772,28,3126909015,-66994757
1644525232,195630,true,3193903772,28,3126909015,-66994757
1644525257,195631,true,3193584414,28,3126909015,-66675399
1644525339,195631,true,3193584414,28,3127221706,-66362708
1644525347,195632,true,3193265087,28,3127221706,-66043381
1644525385,195635,true,3192307299,28,3127221706,-65085593
1644525399,195636,true,3191988100,28,3127221706,-64766394
1644525554,195638,true,3191349798,28,3126283727,-65066071
1644525587,195639,true,3191030695,28,3125971130,-65059565
1644525706,195642,true,3190073578,28,3124721054,-65352524
1644525744,195644,true,3189435658,28,3124408613,-65027045
1644526523,195647,true,3188479019,28,3111003169,-77475850
1644526652,195648,true,3188160203,28,3109448134,-78712069
1644526702,195652,true,3186885258,28,3108826337,-78058921
1644526746,195655,true,3185929383,28,3108204665,-77724718
1644527054,195660,true,3184336896,28,3105098170,-79238726
1644527812,195661,true,3184018495,28,3106651029,-77367466
1644527836,195665,true,3182745206,28,3106651029,-76094177
1644527886,195668,true,3181790573,28,3106961694,-74828879
1644528133,195673,true,3180200155,28,3107893876,-72306279
1644528151,195675,true,3179564210,28,3107893876,-71670334
1644528359,195679,true,3178292702,28,3109448134,-68844568
1644528372,195681,true,3177657139,28,3109448134,-68209005
1644528909,195685,true,3176386394,28,3113492843,-62893551
1644528929,195687,true,3175751212,28,3113492843,-62258369
1644529558,195690,true,3174798677,28,3118166352,-56632325
1644530077,195693,true,3173846428,28,3122534624,-51311804
1644530299,195697,true,3172577207,28,3122846877,-49730330
1644530598,195699,true,3171942786,28,3122222402,-49720384
1644530794,195702,true,3170991394,28,3121598051,-49393343
1644532104,195706,true,3169723314,28,3115672942,-54050372
1644532285,195710,true,3168455742,28,3115672942,-52782800
1644532643,195714,true,3167188676,28,3116607737,-50580939
1644534206,195718,true,3165922118,28,3119101896,-46820222
1644534337,195721,true,3164972531,28,3119101896,-45870635
1644534639,195725,true,3163706858,28,3118790017,-44916841
1644534787,195728,true,3162757936,28,3118478169,-44279767
1644534851,195731,true,3161809298,28,3118166352,-43642946
1644535159,195734,true,3160860945,28,3116607737,-44253208
1644535183,195738,true,3159596917,28,3116607737,-42989180
1644535312,195740,true,3158965092,28,3115672942,-43292150
1644535742,195743,true,3158017592,28,3112247757,-45769835
1644535769,195746,true,3157070377,28,3111936563,-45133814
1644535776,195750,true,3155807864,28,3111936563,-43871301
1644535843,195752,true,3155176797,28,3111003169,-44173628
1644535876,195756,true,3153915042,28,3110381061,-43533981
1644536097,195759,true,3152969057,28,3106340395,-46628662
1644536137,195763,true,3151708184,28,3105408679,-46299505
1644536163,195766,true,3150762861,28,3104787691,-45975170
1644536249,195770,true,3149502871,28,3103235763,-46267108
1644536721,195773,true,3148558209,28,3094868745,-53689464
1644536745,195777,true,3147299100,28,3094559289,-52739811
1644536758,195779,true,3146669735,28,3094249864,-52419871
1644536833,195783,true,3145411382,28,3093012473,-52398909
1644536904,195787,true,3144153531,28,3091466431,-52687100
1644537599,195792,true,3142581926,28,3078817998,-63763928
1644537738,195794,true,3141953504,28,3077894537,-64058967
1644537808,195799,true,3140382998,28,3077279051,-63103947
1644537811,195803,true,3139127159,28,3077279051,-61848108
1644537882,195808,true,3137558066,28,3076356052,-61202014
1644537899,195811,true,3136616987,28,3076048447,-60568540
1644537925,195816,true,3135049149,28,3075740873,-59308276
1644538253,195821,true,3133482095,28,3070823868,-62658227
1644538544,195826,true,3131915824,28,3067447987,-64467837
1644538604,195831,true,3130350335,28,3066834590,-63515745
1644538663,195836,true,3128785630,28,3066221315,-62564315
1644538729,195841,true,3127221706,28,3065608163,-61613543
1644538763,195847,true,3125346030,28,3064995133,-60350897
1644538949,195851,true,3124096204,28,3062544240,-61551964
1644539001,195857,true,3122222402,28,3061931823,-60290579
1644539029,195862,true,3120661759,28,3061319528,-59342231
1644539044,195867,true,3119101896,28,3061319528,-57782368
1644539056,195871,true,3117854567,28,3061013427,-56841140
1644539083,195876,true,3116296107,28,3060401316,-55894791
1644539134,195882,true,3114426984,28,3059177462,-55249522
1644539155,195887,true,3112870237,28,3058565718,-54304519
1644539220,195892,true,3111314269,28,3056731221,-54583048
1644539358,195897,true,3109759079,28,3052760250,-56998829
1644539472,195903,true,3107893876,28,3049404228,-58489648
1644539949,195908,true,3106340395,28,3037839058,-68501337
1644540268,195912,true,3105098170,28,3030557350,-74540820
1644540343,195918,true,3103235763,28,3028739652,-74496111
1644540375,195923,true,3101684610,28,3028133994,-73550616
1644540415,195927,true,3100444246,28,3027225736,-73218510
1644540990,195930,true,3099514299,28,3021177637,-78336662
1644541010,195935,true,3097965007,28,3021177637,-76787370
1644541028,195940,true,3096416489,28,3021177637,-75238852
1644541358,195944,true,3095178232,28,3024200174,-70978058
1644541417,195946,true,3094559289,28,3024805045,-69754244
1644541422,195951,true,3093012473,28,3024805045,-68207428
1644541495,195955,true,3091775578,28,3026620382,-65155196
1644541503,195957,true,3091157315,28,3026923044,-64234271
1644541515,195957,true,3091157315,28,3027225736,-63931579
1644541798,195961,true,3089921161,28,3036016992,-53904169
1644541848,195965,true,3088685502,28,3037231581,-51453921
1644542062,195966,true,3088376664,28,3043616150,-44760514
1644542124,195967,true,3088067857,28,3045442776,-42625081
1644542164,195970,true,3087141622,28,3046965802,-40175820
1644542228,195973,true,3086215665,28,3048794439,-37421226
1644542657,195974,true,3085907074,28,3061625660,-24281414
1644543118,195974,true,3085907074,28,3073896074,-12011000
1644543212,195977,true,3084981487,28,3076048447,-8933040
1644543758,195980,true,3084056178,28,3077894537,-6161641
1644543795,195980,true,3084056178,28,3077894537,-6161641
1644543830,195980,true,3084056178,28,3077894537,-6161641
1644544070,195984,true,3082822864,28,3076048447,-6774417
1644544636,195988,true,3081590043,28,3070823868,-10766175
1644545109,195987,true,3081898202,28,3066527937,-15370265
1644545156,195987,true,3081898202,28,3065914723,-15983479
1644545441,195991,true,3080665751,28,3062544240,-18121511
1644545470,195995,true,3079433792,28,3062238016,-17195776
1644546764,195996,true,3079125880,28,3050624173,-28501707
1644546858,195996,true,3079125880,28,3050014139,-29111741
1644546898,196000,true,3077894537,28,3049709168,-28185369
1644547435,196004,true,3076663687,28,3049709168,-26954519
1644548656,196004,true,3076663687,28,3053065526,-23598161
1644548691,196005,true,3076356052,28,3053370833,-22985219
1644549529,196008,true,3075433329,28,3054592364,-20840965
1644549547,196012,true,3074203464,28,3054592364,-19611100
1644549624,196011,true,3074510884,28,3054592364,-19918520
1644549873,196011,true,3074510884,28,3055203313,-19307571
1644550018,196013,true,3073896074,28,3055814385,-18081689
1644550211,196017,true,3072666823,28,3056119966,-16546857
1644550853,196016,true,3072974090,28,3057342597,-15631493
1644550998,196016,true,3072974090,28,3057954096,-15019994
1644551075,196018,true,3072359587,28,3058259892,-14099695
1644551083,196022,true,3071130950,28,3058259892,-12871058
1644551506,196020,true,3071745207,28,3061931823,-9813384
1644551608,196020,true,3071745207,28,3062850494,-8894713
1644551751,196022,true,3071130950,28,3064382226,-6748724
1644551867,196026,true,3069902805,28,3065608163,-4294642
1644553362,196024,true,3070516816,28,3076971354,6454538
1644553700,196024,true,3070516816,28,3076971354,6454538
1644553801,196026,true,3069902805,28,3076971354,7068549
1644554592,196030,true,3068675151,28,3075740873,7065722
1644554626,196029,true,3068982018,28,3075740873,6758855
1644554770,196029,true,3068982018,28,3075433329,6451311
1644555121,196032,true,3068061508,28,3073896074,5834566
1644556181,196036,true,3066834590,28,3069902805,3068215
1644556323,196035,true,3067141273,28,3069288916,2147643
1644556352,196035,true,3067141273,28,3068982018,1840745
1644557587,196039,true,3065914723,28,3056425578,-9489145
1644557677,196044,true,3064382226,28,3055814385,-8567841
1644558675,196042,true,3064995133,28,3053676170,-11318963
1644558798,196042,true,3064995133,28,3053981538,-11013595
1644558906,196046,true,3063769441,28,3053981538,-9787903
1644559740,196051,true,3062238016,28,3055203313,-7034703
1644559869,196050,true,3062544240,28,3055203313,-7340927
1644559914,196050,true,3062544240,28,3055203313,-7340927
1644559918,196053,true,3061625660,28,3055203313,-6422347
1644560050,196058,true,3060095307,28,3055508834,-4586473
1644560182,196056,true,3060707356,28,3056119966,-4587390
1644560656,196055,true,3061013427,28,3057954096,-3059331
1644561654,196058,true,3060095307,28,3062850494,2755187
1644561900,196062,true,3058871574,28,3063463095,4591521
1644562058,196060,true,3059483379,28,3063769441,4286062
1644562105,196060,true,3059483379,28,3063769441,4286062
1644562290,196062,true,3058871574,28,3064382226,5510652
1644562435,196065,true,3057954096,28,3064688664,6734568
1644562684,196063,true,3058565718,28,3065301632,6735914
1644562747,196062,true,3058871574,28,3065608163,6736589
1644563208,196063,true,3058565718,28,3067754732,9189014
1644563231,196066,true,3057648332,28,3067754732,10106400
1644563291,196064,true,3058259892,28,3068061508,9801616
1644563333,196063,true,3058565718,28,3068368314,9802596
1644563351,196064,true,3058259892,28,3068675151,10415259
1644563402,196066,true,3057648332,28,3068982018,11333686
1644564178,196063,true,3058565718,28,3074510884,15945166
1644564436,196062,true,3058871574,28,3076048447,17176873
1644564683,196063,true,3058565718,28,3077279051,18713333
1644564687,196065,true,3057954096,28,3077279051,19324955
1644565207,196062,true,3058871574,28,3080049710,21178136
1644565755,196060,true,3059483379,28,3082206392,22723013
1644566097,196061,true,3059177462,28,3084364584,25187122
1644566765,196062,true,3058871574,28,3090539177,31667603
1644566925,196058,true,3060095307,28,3092393964,32298657
1644568644,196055,true,3061013427,28,3103856441,42843014
1644568784,196056,true,3060707356,28,3103856441,43149085
1644568823,196057,true,3060401316,28,3103856441,43455125
1644569415,196053,true,3061625660,28,3103235763,41610103
1644569749,196050,true,3062544240,28,3101994778,39450538
1644569841,196050,true,3062544240,28,3101684610,39140370
1644569852,196051,true,3062238016,28,3101684610,39446594
1644569904,196047,true,3063463095,28,3101374473,37911378
1644569921,196044,true,3064382226,28,3101374473,36992247
1644569960,196044,true,3064382226,28,3100754291,36372065
1644570085,196045,true,3064075818,28,3099514299,35438481
1644570107,196041,true,3065301632,28,3099204379,33902747
1644570348,196038,true,3066221315,28,3095487750,29266435
1644570866,196037,true,3066527937,28,3088685502,22157565
1644570896,196038,true,3066221315,28,3088685502,22464187
1644570969,196034,true,3067447987,28,3088067857,20619870
1644571012,196030,true,3068675151,28,3087759081,19083930
1644571031,196029,true,3068982018,28,3087450336,18468318
1644571034,196030,true,3068675151,28,3087450336,18775185
1644571061,196025,true,3070209795,28,3087450336,17240541
1644571599,196022,true,3071130950,28,3086832939,15701989
1644572300,196021,true,3071438063,28,3093012473,21574410
1644572307,196021,true,3071438063,28,3093012473,21574410
1644572415,196017,true,3072666823,28,3094249864,21583041
1644572769,196014,true,3073588715,28,3097965007,24376292
1644574367,196013,true,3073896074,28,3101684610,27788536
1644574404,196014,true,3073588715,28,3101684610,28095895
1644574487,196011,true,3074510884,28,3101684610,27173726
1644574612,196010,true,3074818335,28,3101684610,26866275
1644574910,196010,true,3074818335,28,3101374473,26556138
1644574926,196011,true,3074510884,28,3101374473,26863589
1644574945,196008,true,3075433329,28,3101374473,25941144
1644575154,196007,true,3075740873,28,3100754291,25013418
1644575445,196007,true,3075740873,28,3100134233,24393360
1644575480,196008,true,3075433329,28,3100134233,24700904
1644575492,196006,true,3076048447,28,3099824250,23775803
1644575728,196005,true,3076356052,28,3097965007,21608955
1644575776,196006,true,3076048447,28,3097655241,21606794
1644575807,196007,true,3075740873,28,3097655241,21914368
1644575970,196005,true,3076356052,28,3096726130,20370078
1644576079,196003,true,3076971354,28,3096106878,19135524
1644576158,196003,true,3076971354,28,3095797298,18825944
1644576190,196003,true,3076971354,28,3095797298,18825944
1644576941,196001,true,3077586779,28,3096416489,18829710
1644577008,195999,true,3078202327,28,3096416489,18214162
1644577768,195998,true,3078510147,28,3102615208,24105061
1644577979,195998,true,3078510147,28,3103856441,25346294
1644578949,195994,true,3079741736,28,3105719220,25977484
1644580360,195993,true,3080049710,28,3105098170,25048460
1644580497,195992,true,3080357715,28,3104477243,24119528
1644580527,195992,true,3080357715,28,3104477243,24119528
1644580845,195988,true,3081590043,28,3102925470,21335427
1644580908,195987,true,3081898202,28,3102615208,20717006
1644581608,195987,true,3081898202,28,3097965007,16066805
1644581671,195987,true,3081898202,28,3097655241,15757039
1644581725,195984,true,3082822864,28,3097655241,14832377
1644582214,195983,true,3083131146,28,3096416489,13285343
1644582242,195982,true,3083439459,28,3096416489,12977030
1644582254,195982,true,3083439459,28,3096416489,12977030
1644582265,195979,true,3084364584,28,3096726130,12361546
1644582289,195977,true,3084981487,28,3096726130,11744643
1644582319,195976,true,3085289985,28,3097035803,11745818
1644582609,195976,true,3085289985,28,3099204379,13914394
1644583147,195974,true,3085907074,28,3104787691,18880617
1644583486,195973,true,3086215665,28,3107893876,21678211
1644583633,195972,true,3086524287,28,3108826337,22302050
1644583645,195972,true,3086524287,28,3108826337,22302050
1644583662,195970,true,3087141622,28,3108826337,21684715
1644583738,195969,true,3087450336,28,3109137220,21686884
1644583932,195969,true,3087450336,28,3109759079,22308743
1644584056,195969,true,3087450336,28,3109759079,22308743
1644584863,195967,true,3088067857,28,3106961694,18893837
1644585753,195965,true,3088685502,28,3104787691,16102189
1644585885,195965,true,3088685502,28,3105098170,16412668
1644586089,195965,true,3088685502,28,3105408679,16723177
1644586271,195962,true,3089612200,28,3105408679,15796479
1644586811,195961,true,3089921161,28,3106340395,16419234
1644586924,195960,true,3090230154,28,3106651029,16420875
1644586939,195958,true,3090848230,28,3106651029,15802799
1644587199,195956,true,3091466431,28,3108204665,16738234
1644587695,195954,true,3092084755,28,3110692100,18607345
1644587936,195952,true,3092703203,28,3112247757,19544554
1644588166,195951,true,3093012473,28,3113804192,20791719
1644589867,195949,true,3093631107,28,3119413806,25782699
1644590061,195946,true,3094559289,28,3120661759,26102470
1644590093,195945,true,3094868745,28,3120661759,25793014
1644590118,195944,true,3095178232,28,3120661759,25483527
1644590181,195941,true,3096106878,28,3120349724,24242846
1644590609,195941,true,3096106878,28,3118166352,22059474
1644590772,195939,true,3096726130,28,3117231090,20504960
1644590775,195939,true,3096726130,28,3117231090,20504960
1644590809,195936,true,3097655241,28,3117231090,19575849
1644590818,195935,true,3097965007,28,3117231090,19266083
1644590872,195933,true,3098584631,28,3117542813,18958182
1644591065,195931,true,3099204379,28,3118478169,19273790
1644591087,195929,true,3099824250,28,3118790017,18965767
1644591117,195928,true,3100134233,28,3118790017,18655784
1644591379,195926,true,3100754291,28,3119413806,18659515
1644591394,195925,true,3101064366,28,3119725747,18661381
1644591401,195923,true,3101684610,28,3119725747,18041137
1644591418,195922,true,3101994778,28,3119413806,17419028
1644591447,195922,true,3101994778,28,3119413806,17419028
1644591483,195921,true,3102304978,28,3119413806,17108828
1644591490,195918,true,3103235763,28,3119413806,16178043
1644591515,195918,true,3103235763,28,3119101896,15866133
1644591825,195919,true,3102925470,28,3114738427,11812957
1644591932,195918,true,3103235763,28,3113181524,9945761
1644591966,195916,true,3103856441,28,3113181524,9325083
1644592337,195916,true,3103856441,28,3113181524,9325083
1644592687,195916,true,3103856441,28,3111625401,7768960
1644592735,195916,true,3103856441,28,3111003169,7146728
1644593594,195915,true,3104166826,28,3104166826,0
1644594031,195916,true,3103856441,28,3103235763,-620678
1644594380,195916,true,3103856441,28,3102925470,-930971
1644595258,195916,true,3103856441,28,3106340395,2483954
1644595625,195914,true,3104477243,28,3107583118,3105875
1644596213,195915,true,3104166826,28,3108826337,4659511
1644596367,195915,true,3104166826,28,3108826337,4659511
1644596827,195915,true,3104166826,28,3107272390,3105564
1644596909,195913,true,3104787691,28,3106961694,2174003
1644597169,195914,true,3104477243,28,3105408679,931436
1644597287,195914,true,3104477243,28,3104477243,0
1644597425,195914,true,3104477243,28,3102925470,-1551773
1644597716,195912,true,3105098170,28,3099824250,-5273920
1644597740,195913,true,3104787691,28,3099514299,-5273392
1644598691,195913,true,3104787691,28,3090539177,-14248514
1644598966,195913,true,3104787691,28,3089303270,-15484421
1644599560,195911,true,3105408679,28,3090230154,-15178525
1644599578,195912,true,3105098170,28,3090539177,-14558993
1644599588,195913,true,3104787691,28,3090539177,-14248514
1644600068,195912,true,3105098170,28,3093012473,-12085697
1644600163,195911,true,3105408679,28,3093321775,-12086904
1644600192,195912,true,3105098170,28,3093321775,-11776395
1644600244,195913,true,3104787691,28,3093631107,-11156584
1644600258,195912,true,3105098170,28,3093631107,-11467063
1644600267,195911,true,3105408679,28,3093631107,-11777572
1644601915,195913,true,3104787691,28,3089612200,-15175491
1644601940,195914,true,3104477243,28,3089303270,-15173973
1644602017,195914,true,3104477243,28,3088994370,-15482873
1644602632,195913,true,3104787691,28,3087141622,-17646069
1644602754,195915,true,3104166826,28,3086832939,-17333887
1644603471,195916,true,3103856441,28,3084981487,-18874954
1644603849,195916,true,3103856441,28,3084056178,-19800263
1644604093,195915,true,3104166826,28,3083747803,-20419023
1644604171,195917,true,3103546086,28,3083747803,-19798283
1644604223,195918,true,3103235763,28,3083439459,-19796304
1644604230,195918,true,3103235763,28,3083439459,-19796304
1644604246,195917,true,3103546086,28,3083439459,-20106627
1644604264,195918,true,3103235763,28,3083131146,-20104617
1644604320,195920,true,3102615208,28,3082514612,-20100596
1644604382,195921,true,3102304978,28,3081590043,-20714935
1644604454,195920,true,3102615208,28,3080665751,-21949457
1644604646,195923,true,3101684610,28,3077279051,-24405559
1644604786,195925,true,3101064366,28,3074510884,-26553482
1644604804,195925,true,3101064366,28,3074203464,-26860902
1644604998,195926,true,3100754291,28,3069595845,-31158446
1644605007,195929,true,3099824250,28,3069595845,-30228405
1644605074,195932,true,3098894489,28,3067754732,-31139757
1644605087,195933,true,3098584631,28,3067447987,-31136644
1644605093,195934,true,3098274803,28,3067141273,-31133530
1644605111,195937,true,3097345507,28,3066527937,-30817570
1644605114,195940,true,3096416489,28,3066527937,-29888552
1644605132,195941,true,3096106878,28,3065914723,-30192155
1644605537,195943,true,3095487750,28,3052149790,-43337960
1644605561,195946,true,3094559289,28,3051539451,-43019838
1644605588,195949,true,3093631107,28,3050624173,-43006934
1644605846,195950,true,3093321775,28,3041486470,-51835305
1644605877,195952,true,3092703203,28,3040574207,-52128996
1644605897,195955,true,3091775578,28,3039662217,-52113361
1644605932,195958,true,3090848230,28,3038446656,-52401574
1644605969,195959,true,3090539177,28,3037231581,-53307596
1644606034,195962,true,3089612200,28,3034802889,-54809311
1644606108,195966,true,3088376664,28,3032679376,-55697288
1644606175,195970,true,3087141622,28,3030557350,-56584272
1644606254,195972,true,3086524287,28,3027831211,-58693076
1644606324,195974,true,3085907074,28,3025712577,-60194497
1644606343,195979,true,3084364584,28,3025107525,-59257059
1644606405,195984,true,3082822864,28,3022688528,-60134336
1644606663,195987,true,3081898202,28,3012730593,-69167609
1644606744,195990,true,3080973817,28,3010020491,-70953326
1644606899,195993,true,3080049710,28,3005809621,-74240089
1644606943,195998,true,3078510147,28,3004908059,-73602088
1644606963,196000,true,3077894537,28,3004607598,-73286939
1644607231,196003,true,3076971354,28,3001004411,-75966943
1644607461,196006,true,3076048447,28,2998304857,-77743590
1644607487,196010,true,3074818335,28,2998005057,-76813278
1644607507,196013,true,3073896074,28,2997705286,-76190788
1644607533,196015,true,3073281387,28,2997105835,-76175552
1644607997,196020,true,3071745207,28,2990519779,-81225428
1644608020,196024,true,3070516816,28,2990519779,-79997037
1644608022,196027,true,3069595845,28,2990519779,-79076066
1644608171,196029,true,3068982018,28,2991716166,-77265852
1644608202,196032,true,3068061508,28,2992314539,-75746969
1644608664,196036,true,3066834590,28,3000704341,-66130249
1644608746,196039,true,3065914723,28,3001904803,-64009920
1644608756,196041,true,3065301632,28,3001904803,-63396829
1644608778,196045,true,3064075818,28,3001904803,-62171015
1644609126,196049,true,3062850494,28,3003105745,-59744749
1644609158,196052,true,3061931823,28,3003105745,-58826078
1644609797,196056,true,3060707356,28,3004607598,-56099758
1644609863,196058,true,3060095307,28,3004307167,-55788140
1644609883,196063,true,3058565718,28,3004006766,-54558952
1644609901,196066,true,3057648332,28,3004006766,-53641566
1644609922,196070,true,3056425578,28,3003706396,-52719182
1644609960,196073,true,3055508834,28,3002805464,-52703370
1644610115,196081,true,3053065526,28,2998304857,-54760669
1644610168,196085,true,3051844605,28,2996806154,-55038451
1644610642,196091,true,3050014139,28,2980071777,-69942362
1644610875,196094,true,3049099318,28,2972928537,-76170781
1644610890,196102,true,3046661136,28,2972334040,-74327096
1644610908,196106,true,3045442776,28,2971739663,-73703113
1644610947,196111,true,3043920511,28,2970551264,-73369247
1644610998,196115,true,3042703247,28,2968769557,-73933690
1644611149,196124,true,3039966183,28,2963134531,-76831652
1644611300,196127,true,3039054376,28,2957510202,-81544174
1644611428,196133,true,3037231581,28,2952782205,-84449376
1644611604,196137,true,3036016992,28,2945998949,-90018043
1644612049,196144,true,3033892630,28,2936587290,-97305340
1644612088,196148,true,3032679376,28,2936293660,-96385716
1644612095,196154,true,3030860405,28,2936000060,-94860345
1644612219,196158,true,3029648364,28,2933945682,-95702682
1644612266,196166,true,3027225736,28,2933065674,-94160062
1644612305,196170,true,3026015148,28,2932479149,-93535999
1644612365,196175,true,3024502595,28,2931599581,-92903014
1644612418,196180,true,3022990797,28,2931013349,-91977448
1644612446,196187,true,3020875549,28,2930720277,-90155272
1644612464,196191,true,3019667501,28,2930427235,-89240266
1644612492,196197,true,3017856335,28,2930134221,-87722114
1644612739,196200,true,3016951159,28,2928669594,-88281565
1644612743,196208,true,3014538684,28,2928669594,-85869090
1644612821,196211,true,3013634503,28,2928669594,-84964909
1644612874,196217,true,3011826955,28,2928962461,-82864494
1644612882,196220,true,3010923587,28,2928962461,-81961126
1644613101,196228,true,3008515932,28,2929255357,-79260575
1644613136,196231,true,3007613558,28,2929255357,-78358201
1644613260,196236,true,3006110202,28,2929255357,-76854845
1644613286,196239,true,3005208549,28,2929255357,-75953192
1644613332,196247,true,3002805464,28,2929255357,-73550107
1644613455,196250,true,3001904803,28,2929548282,-72356521
1644613505,196255,true,3000404300,28,2929548282,-70856018
1644613963,196258,true,2999504359,28,2929548282,-69956077
1644614274,196266,true,2997105835,28,2930720277,-66385558
1644614337,196270,true,2995907292,28,2930427235,-65480057
1644614377,196275,true,2994409788,28,2930427235,-63982553
1644615434,196278,true,2993511645,28,2932479149,-61032496
1644615531,196285,true,2991417024,28,2932772397,-58644627
1644615961,196289,true,2990220757,28,2933652317,-56568440
1644616516,196294,true,2988726095,28,2933358981,-55367114
1644616867,196296,true,2988128439,28,2932772397,-55356042
1644616909,196304,true,2985739012,28,2932772397,-52966615
1644617207,196307,true,2984843469,28,2931892741,-52950728
1644617239,196313,true,2983053190,28,2931892741,-51160449
1644617296,196314,true,2982754914,28,2931599581,-51155333
1644617773,196323,true,2980071777,28,2929548282,-50523495
1644617797,196326,true,2979177934,28,2929255357,-49922577
1644617890,196332,true,2977391053,28,2928376756,-49014297
1644618053,196334,true,2976795664,28,2926913007,-49882657
1644618374,196342,true,2974415298,28,2924572530,-49842768
1644618385,196346,true,2973225830,28,2924572530,-48653300
1644618499,196351,true,2971739663,28,2922526147,-49213516
1644618711,196354,true,2970848319,28,2918729522,-52118797
1644618822,196362,true,2968472710,28,2916978897,-51493813
1644618829,196365,true,2967582346,28,2916687228,-50895118
1644618856,196371,true,2965802419,28,2916395588,-49406831
1644618882,196372,true,2965505869,28,2916103978,-49401891
1644619579,196379,true,2963430845,28,2910277889,-53152956
1644619632,196382,true,2962541993,28,2909986891,-52555102
1644619769,196387,true,2961061167,28,2908823187,-52237980
1644619793,196388,true,2960765090,28,2908823187,-51941903
1644619821,196396,true,2958397544,28,2908532334,-49865210
1644619841,196399,true,2957510202,28,2908241509,-49268693
1644619886,196404,true,2956031890,28,2907659948,-48371942
1644619981,196405,true,2955736317,28,2906497175,-49239142
1644620077,196412,true,2953668128,28,2905334867,-48333261
1644620096,196416,true,2952486957,28,2905044362,-47442595
1644620115,196419,true,2951601388,28,2904753887,-46847501
1644620138,196421,true,2951011156,28,2904463441,-46547715
1644620174,196428,true,2948946274,28,2903882635,-45063639
1644620460,196431,true,2948061767,28,2902431129,-45630638
1644620499,196435,true,2946882837,28,2902431129,-44451708
1644620545,196436,true,2946588178,28,2902140915,-44447263
1644620930,196443,true,2944526391,28,2900110229,-44416162
1644620968,196446,true,2943643210,28,2899820247,-43822963
1644620972,196449,true,2942760294,28,2899820247,-42940047
1644620983,196450,true,2942466047,28,2899530294,-42935753
1644621113,196457,true,2940407145,28,2898370772,-42036373
1644621219,196460,true,2939525199,28,2897501434,-42023765
1644621305,196462,true,2938937382,28,2896632358,-42305024
1644621334,196463,true,2938643518,28,2896342723,-42300795
1644621678,196468,true,2937174636,28,2897501434,-39673202
1644621722,196469,true,2936880948,28,2897791184,-39089764
1644621735,196471,true,2936293660,28,2897791184,-38502476
1644621826,196472,true,2936000060,28,2898950475,-37049585
1644622154,196476,true,2934825954,28,2903592276,-31233678
1644622282,196477,true,2934532501,28,2905915963,-28616538
1644623202,196479,true,2933945682,28,2923110682,-10835000
1644624178,196480,true,2933652317,28,2929841237,-3811080
1644624188,196485,true,2932185931,28,2929841237,-2344694
1644624491,196486,true,2931892741,28,2928962461,-2930280
1644624665,196488,true,2931306451,28,2928669594,-2636857
1644624689,196488,true,2931306451,28,2928376756,-2929695
1644624743,196492,true,2930134221,28,2928376756,-1757465
1644625022,196494,true,2929548282,28,2927205698,-2342584
1644625041,196496,true,2928962461,28,2927205698,-1756763
1644625849,196498,true,2928376756,28,2925449989,-2926767
1644626889,196503,true,2926913007,28,2923402993,-3510014
1644626925,196504,true,2926620345,28,2923402993,-3217352
1644626983,196507,true,2925742534,28,2923402993,-2339541
1644627077,196509,true,2925157473,28,2923402993,-1754480
1644627163,196513,true,2923987703,28,2923402993,-584710
1644627875,196514,true,2923695333,28,2923987703,292370
1644628034,196516,true,2923110682,28,2924280102,1169420
1644628296,196517,true,2922818400,28,2925157473,2339073
1644628363,196521,true,2921649565,28,2925449989,3800424
1644628465,196522,true,2921357429,28,2926327712,4970283
1644630803,196522,true,2921357429,28,2939819151,18461722
1644630837,196522,true,2921357429,28,2940113133,18755704
1644631035,196525,true,2920481197,28,2940113133,19631936
1644631097,196525,true,2920481197,28,2940113133,19631936
1644631117,196523,true,2921065323,28,2940113133,19047810
1644631139,196523,true,2921065323,28,2940113133,19047810
1644631668,196525,true,2920481197,28,2942466047,21984850
1644632025,196525,true,2920481197,28,2944526391,24045194
1644635629,196523,true,2921065323,28,2951306257,30240934
1644635926,196523,true,2921065323,28,2950421042,29355719
1644636188,196523,true,2921065323,28,2949536093,28470770
1644636482,196522,true,2921357429,28,2948061767,26704338
1644636536,196521,true,2921649565,28,2947766990,26117425
1644638587,196522,true,2921357429,28,2933358981,12001552
1644638702,196522,true,2921357429,28,2933358981,12001552
1644638812,196522,true,2921357429,28,2933358981,12001552
1644638840,196521,true,2921649565,28,2933358981,11709416
1644638927,196521,true,2921649565,28,2933652317,12002752
1644640576,196520,true,2921941730,28,2939525199,17583469
1644640867,196519,true,2922233924,28,2940113133,17879209
1644642838,196518,true,2922526147,28,2941877642,19351495
1644642940,196519,true,2922233924,28,2941877642,19643718
1644643894,196518,true,2922526147,28,2938937382,16411235
1644643926,196518,true,2922526147,28,2938643518,16117371
1644644830,196517,true,2922818400,28,2933358981,10540581
1644645788,196519,true,2922233924,28,2930427235,8193311
1644646009,196519,true,2922233924,28,2930427235,8193311
1644646031,196518,true,2922526147,28,2930427235,7901088
1644646082,196518,true,2922526147,28,2930427235,7901088
1644646318,196520,true,2921941730,28,2929841237,7899507
1644646361,196519,true,2922233924,28,2929841237,7607313
1644646480,196519,true,2922233924,28,2928669594,6435670
1644646635,196519,true,2922233924,28,2926913007,4679083
1644646964,196522,true,2921357429,28,2922818400,1460971
1644648107,196522,true,2921357429,28,2910568917,-10788512
1644648154,196522,true,2921357429,28,2909986891,-11370538
1644648169,196522,true,2921357429,28,2909695921,-11661508
1644648370,196525,true,2920481197,28,2908241509,-12239688
1644648391,196525,true,2920481197,28,2907950714,-12530483
1644648432,196526,true,2920189178,28,2907659948,-12529230
1644648680,196526,true,2920189178,28,2905334867,-14854311
1644648772,196529,true,2919313297,28,2904753887,-14559410
1644648831,196530,true,2919021395,28,2904463441,-14557954
1644648906,196530,true,2919021395,28,2903882635,-15138760
1644648948,196530,true,2919021395,28,2903882635,-15138760
1644649031,196533,true,2918145863,28,2903882635,-14263228
1644649083,196533,true,2918145863,28,2903592276,-14553587
1644649296,196533,true,2918145863,28,2903301946,-14843917
1644649365,196533,true,2918145863,28,2903301946,-14843917
1644650826,196535,true,2917562322,28,2911442175,-6120147
1644651576,196535,true,2917562322,28,2914063521,-3498801
1644651858,196535,true,2917562322,28,2914354928,-3207394
1644651878,196534,true,2917854078,28,2914354928,-3499150
1644652237,196536,true,2917270595,28,2913772144,-3498451
1644652409,196536,true,2917270595,28,2913480796,-3789799
1644652940,196535,true,2917562322,28,2914063521,-3498801
1644652971,196534,true,2917854078,28,2914354928,-3499150
1644652988,196535,true,2917562322,28,2914354928,-3207394
1644653099,196534,true,2917854078,28,2914646363,-3207715
1644653171,196532,true,2918437678,28,2914937828,-3499850
1644653206,196532,true,2918437678,28,2914937828,-3499850
1644653299,196533,true,2918145863,28,2915520845,-2625018
1644653624,196532,true,2918437678,28,2918145863,-291815
1644655918,196530,true,2919021395,28,2932185931,13164536
1644656150,196529,true,2919313297,28,2932479149,13165852
1644657448,196530,true,2919021395,28,2933945682,14924287
1644657908,196528,true,2919605228,28,2934239077,14633849
1644660063,196526,true,2920189178,28,2934239077,14049899
1644660308,196525,true,2920481197,28,2934239077,13757880
1644660349,196525,true,2920481197,28,2934239077,13757880
1644660622,196523,true,2921065323,28,2934239077,13173754
1644661869,196522,true,2921357429,28,2931013349,9655920
1644661929,196520,true,2921941730,28,2930720277,8778547
1644661983,196521,true,2921649565,28,2930134221,8484656
1644662214,196519,true,2922233924,28,2928083947,5850023
1644662311,196518,true,2922526147,28,2926913007,4386860
1644662704,196517,true,2922818400,28,2923110682,292282
1644662848,196518,true,2922526147,28,2921649565,-876582
1644662863,196517,true,2922818400,28,2921357429,-1460971
1644662889,196516,true,2923110682,28,2921065323,-2045359
1644662904,196516,true,2923110682,28,2921065323,-2045359
1644662944,196518,true,2922526147,28,2920189178,-2336969
1644663207,196517,true,2922818400,28,2914937828,-7880572
1644663497,196516,true,2923110682,28,2909695921,-13414761
1644663514,196516,true,2923110682,28,2909404981,-13705701
1644663535,196518,true,2922526147,28,2909114069,-13412078
1644663609,196517,true,2922818400,28,2907950714,-14867686
1644664722,196516,true,2923110682,28,2901270447,-21840235
1644664743,196516,true,2923110682,28,2901270447,-21840235
1644664762,196518,true,2922526147,28,2901270447,-21255700
1644664802,196519,true,2922233924,28,2901270447,-20963477
1644664812,196519,true,2922233924,28,2901270447,-20963477
1644665047,196521,true,2921649565,28,2900110229,-21539336
1644665148,196523,true,2921065323,28,2899530294,-21535029
1644665155,196524,true,2920773245,28,2899530294,-21242951
1644665215,196524,true,2920773245,28,2899530294,-21242951
1644665231,196525,true,2920481197,28,2899530294,-20950903
1644665307,196526,true,2920189178,28,2899820247,-20368931
1644665368,196527,true,2919897189,28,2900110229,-19786960
1644665433,196527,true,2919897189,28,2900110229,-19786960
1644665488,196527,true,2919897189,28,2900690280,-19206909
1644666585,196527,true,2919897189,28,2909695921,-10201268
1644666699,196528,true,2919605228,28,2911733319,-7871909
1644667072,196527,true,2919897189,28,2918437678,-1459511
1644667204,196528,true,2919605228,28,2919605228,0
1644667264,196527,true,2919897189,28,2920189178,291989
1644667424,196528,true,2919605228,28,2921065323,1460095
1644668268,196527,true,2919897189,28,2926035108,6137919
1644668327,196527,true,2919897189,28,2926327712,6430523
1644668351,196527,true,2919897189,28,2926327712,6430523
1644668472,196527,true,2919897189,28,2926620345,6723156
1644669153,196528,true,2919605228,28,2927205698,7600470
1644669288,196529,true,2919313297,28,2926913007,7599710
1644669592,196529,true,2919313297,28,2925449989,6136692
1644669894,196530,true,2919021395,28,2923402993,4381598
1644670130,196530,true,2919021395,28,2921357429,2336034
1644670944,196532,true,2918437678,28,2916687228,-1750450
1644673097,196532,true,2918437678,28,2910859974,-7577704
1644674273,196534,true,2917854078,28,2909695921,-8158157
1644674352,196535,true,2917562322,28,2909404981,-8157341
1644674398,196537,true,2916978897,28,2909114069,-7864828
1644674640,196538,true,2916687228,28,2907950714,-8736514
1644674759,196540,true,2916103978,28,2907659948,-8444030
1644675015,196540,true,2916103978,28,2907369212,-8734766
1644675028,196542,true,2915520845,28,2907369212,-8151633
1644675133,196541,true,2915812397,28,2907369212,-8443185
1644675533,196543,true,2915229322,28,2906206555,-9022767
1644676145,196544,true,2914937828,28,2905044362,-9893466
1644676158,196545,true,2914646363,28,2905044362,-9602001
1644676207,196545,true,2914646363,28,2905044362,-9602001
1644676276,196547,true,2914063521,28,2904753887,-9309634
1644676655,196549,true,2913480796,28,2902721372,-10759424
1644676674,196551,true,2912898187,28,2902431129,-10467058
1644676774,196551,true,2912898187,28,2900690280,-12207907
1644676798,196554,true,2912024493,28,2900110229,-11914264
1644676838,196557,true,2911151060,28,2899530294,-11620766
1644676910,196558,true,2910859974,28,2898080964,-12779010
1644677150,196558,true,2910859974,28,2893737318,-17122656
1644677650,196561,true,2909986891,28,2884492620,-25494271
1644677727,196564,true,2909114069,28,2883339111,-25774958
1644677941,196565,true,2908823187,28,2881033478,-27789709
1644677956,196565,true,2908823187,28,2881033478,-27789709
1644678047,196566,true,2908532334,28,2880457357,-28074977
1644678265,196568,true,2907950714,28,2880169341,-27781373
1644678399,196568,true,2907950714,28,2880169341,-27781373
1644678560,196567,true,2908241509,28,2880745403,-27496106
1644678566,196568,true,2907950714,28,2880745403,-27205311
1644678600,196570,true,2907369212,28,2881033478,-26335734
1644678694,196571,true,2907078504,28,2881609713,-25468791
1644678972,196570,true,2907369212,28,2883050806,-24318406
1644679022,196570,true,2907369212,28,2883339111,-24030101
1644679044,196572,true,2906787825,28,2883339111,-23448714
1644679469,196573,true,2906497175,28,2882474283,-24022892
1644679504,196573,true,2906497175,28,2882474283,-24022892
1644679613,196573,true,2906497175,28,2881609713,-24887462
1644679626,196575,true,2905915963,28,2881897874,-24018089
1644679902,196576,true,2905625400,28,2880745403,-24879997
1644680351,196576,true,2905625400,28,2876715383,-28910017
1644680361,196577,true,2905334867,28,2876715383,-28619484
1644680506,196579,true,2904753887,28,2876140126,-28613761
1644680579,196580,true,2904463441,28,2875852541,-28610900
1644681850,196580,true,2904463441,28,2881321581,-23141860
1644681900,196580,true,2904463441,28,2881321581,-23141860
1644682018,196583,true,2903592276,28,2881609713,-21982563
1644682030,196583,true,2903592276,28,2881609713,-21982563
1644682162,196583,true,2903592276,28,2882762530,-20829746
1644682257,196583,true,2903592276,28,2883915808,-19676468
1644682308,196585,true,2903011645,28,2884781069,-18230576
1644682920,196584,true,2903301946,28,2896632358,-6669588
1644683072,196584,true,2903301946,28,2899530294,-3771652
1644683953,196583,true,2903592276,28,2914937828,11345552
1644683961,196586,true,2902721372,28,2914937828,12216456
1644683991,196585,true,2903011645,28,2915229322,12217677
1644684032,196585,true,2903011645,28,2915520845,12509200
1644684037,196584,true,2903301946,28,2915812397,12510451
1644684051,196587,true,2902431129,28,2915812397,13381268
1644684065,196585,true,2903011645,28,2916103978,13092333
1644684344,196584,true,2903301946,28,2919313297,16011351
1644684381,196584,true,2903301946,28,2919605228,16303282
1644684399,196587,true,2902431129,28,2919897189,17466060
1644684444,196585,true,2903011645,28,2920189178,17177533
1644684656,196585,true,2903011645,28,2921649565,18637920
1644685352,196584,true,2903301946,28,2927498419,24196473
1644685418,196587,true,2902431129,28,2928083947,25652818
1644685442,196585,true,2903011645,28,2928376756,25365111
1644685466,196585,true,2903011645,28,2928669594,25657949
1644685469,196584,true,2903301946,28,2928669594,25367648
1644687189,196584,true,2903301946,28,2936587290,33285344
1644687487,196583,true,2903592276,28,2936587290,32995014
1644688806,196582,true,2903882635,28,2935119436,31236801
1644688974,196581,true,2904173023,28,2935119436,30946413
1644688999,196582,true,2903882635,28,2935119436,31236801
1644689027,196580,true,2904463441,28,2935412948,30949507
1644689207,196577,true,2905334867,28,2936000060,30665193
1644689244,196575,true,2905915963,28,2936000060,30084097
1644689262,196576,true,2905625400,28,2936000060,30374660
1644689340,196574,true,2906206555,28,2936587290,30380735
1644689467,196571,true,2907078504,28,2937468354,30389850
1644689481,196569,true,2907659948,28,2937762101,30102153
1644689526,196570,true,2907369212,28,2938055877,30686665
1644689587,196568,true,2907950714,28,2938937382,30986668
1644689598,196565,true,2908823187,28,2938937382,30114195
1644689713,196562,true,2909695921,28,2940701185,31005264
1644689736,196562,true,2909695921,28,2940995255,31299334
1644689865,196559,true,2910568917,28,2943348875,32779958
1644690385,196555,true,2911733319,28,2952782205,41048886
1644691511,196552,true,2912606927,28,2968175892,55568965
1644694173,196552,true,2912606927,28,2968769557,56162630
1644694498,196549,true,2913480796,28,2968769557,55288761
1644694883,196547,true,2914063521,28,2968175892,54112371
1644694899,196544,true,2914937828,28,2968175892,53238064
1644695287,196545,true,2914646363,28,2966395610,51749247
1644695602,196543,true,2915229322,28,2964912857,49683535
1644696264,196542,true,2915520845,28,2961653408,46132563
1644696956,196539,true,2916395588,28,2959581080,43185492
1644696983,196540,true,2916103978,28,2959877038,43773060
1644697024,196538,true,2916687228,28,2960173026,43485798
1644697049,196537,true,2916978897,28,2960173026,43194129
1644697170,196534,true,2917854078,28,2961061167,43207089
1644697341,196535,true,2917562322,28,2961949574,44387252
1644697546,196532,true,2918437678,28,2964023561,45585883
1644697928,196531,true,2918729522,28,2967582346,48852824
1644697961,196528,true,2919605228,28,2967879104,48273876
1644698135,196529,true,2919313297,28,2969363340,50050043
1644698297,196526,true,2920189178,28,2971145404,50956226
1644699426,196525,true,2920481197,28,2976795664,56314467
1644699907,196521,true,2921649565,28,2976498014,54848449
1644699929,196522,true,2921357429,28,2976498014,55140585
1644700014,196519,true,2922233924,28,2976498014,54264090
1644700252,196518,true,2922526147,28,2975605243,53079096
1644700701,196514,true,2923695333,28,2973820505,50125172
1644700937,196515,true,2923402993,28,2972036837,48633844
1644700963,196512,true,2924280102,28,2971739663,47459561
1644700990,196510,true,2924864987,28,2971442518,46577531
1644701026,196507,true,2925742534,28,2970848319,45105785
1644701430,196509,true,2925157473,28,2964616395,39458922
1644701452,196507,true,2925742534,28,2964319963,38577429
1644701538,196506,true,2926035108,28,2962541993,36506885
1644701565,196502,true,2927205698,28,2961949574,34743876
1644701659,196506,true,2926035108,28,2959581080,33545972
1644701664,196503,true,2926913007,28,2959285152,32372145
1644701669,196503,true,2926913007,28,2959285152,32372145
1644701678,196499,true,2928083947,28,2958989253,30905306
1644701692,196502,true,2927205698,28,2958397544,31191846
1644701748,196499,true,2928083947,28,2956918788,28834841
1644701771,196499,true,2928083947,28,2956031890,27947943
1644701774,196496,true,2928962461,28,2956031890,27069429
1644702010,196498,true,2928376756,28,2947766990,19390234
1644702159,196496,true,2928962461,28,2941583484,12621023
1644702193,196495,true,2929255357,28,2940113133,10857776
1644702284,196492,true,2930134221,28,2935706490,5572269
1644702413,196496,true,2928962461,28,2929841237,878776
1644702565,196495,true,2929255357,28,2922818400,-6436957
1644703531,196495,true,2929255357,28,2885646590,-43608767
1644703549,196493,true,2929841237,28,2885358054,-44483183
1644703742,196497,true,2928669594,28,2882186064,-46483530
1644704375,196496,true,2928962461,28,2881609713,-47352748
1644704394,196495,true,2929255357,28,2881897874,-47357483
1644705155,196493,true,2929841237,28,2887089702,-42751535
1644705208,196497,true,2928669594,28,2887667149,-41002445
1644705249,196496,true,2928962461,28,2887955916,-41006545
1644705403,196494,true,2929548282,28,2889689122,-39859160
1644705431,196492,true,2930134221,28,2889978091,-40156130
1644705449,196495,true,2929255357,28,2890267089,-38988268
1644705788,196492,true,2930134221,28,2894894986,-35239235
1644706251,196490,true,2930720277,28,2899530294,-31189983
1644706318,196487,true,2931599581,28,2900110229,-31489352
1644706338,196490,true,2930720277,28,2900400240,-30320037
1644707756,196488,true,2931306451,28,2909986891,-21319560
1644707775,196486,true,2931892741,28,2909986891,-21905850
1644707814,196483,true,2932772397,28,2909986891,-22785506
1644709020,196486,true,2931892741,28,2912024493,-19868248
1644709281,196484,true,2932479149,28,2911733319,-20745830
1644710117,196482,true,2933065674,28,2910277889,-22787785
1644710397,196479,true,2933945682,28,2910277889,-23667793
1644710991,196483,true,2932772397,28,2910568917,-22203480
1644711303,196480,true,2933652317,28,2910568917,-23083400
1644711448,196479,true,2933945682,28,2910568917,-23376765
1644712153,196477,true,2934532501,28,2909114069,-25418432
1644712242,196481,true,2933358981,28,2908823187,-24535794
1644712364,196481,true,2933358981,28,2909114069,-24244912
1644712403,196480,true,2933652317,28,2909114069,-24538248
1644712505,196477,true,2934532501,28,2909404981,-25127520
1644712537,196481,true,2933358981,28,2909695921,-23663060
1644712581,196480,true,2933652317,28,2909986891,-23665426
1644712771,196479,true,2933945682,28,2911151060,-22794622
1644713006,196476,true,2934825954,28,2914646363,-20179591
1644715701,196479,true,2933945682,28,2938349683,4404001
1644716686,196479,true,2933945682,28,2937468354,3522672
1644717238,196479,true,2933945682,28,2935412948,1467266
1644717352,196476,true,2934825954,28,2934825954,0
1644717762,196480,true,2933652317,28,2932772397,-879920
1644717799,196479,true,2933945682,28,2932479149,-1466533
1644719193,196479,true,2933945682,28,2925742534,-8203148
1644719501,196476,true,2934825954,28,2924864987,-9960967
1644719650,196481,true,2933358981,28,2924280102,-9078879
1644721136,196480,true,2933652317,28,2920481197,-13171120
1644723800,196481,true,2933358981,28,2920481197,-12877784
1644727307,196478,true,2934239077,28,2922233924,-12005153
1644727405,196482,true,2933065674,28,2922233924,-10831750
1644727562,196482,true,2933065674,28,2922233924,-10831750
1644728852,196482,true,2933065674,28,2916395588,-16670086
1644729368,196480,true,2933652317,28,2914063521,-19588796
1644731216,196485,true,2932185931,28,2911151060,-21034871
1644734294,196485,true,2932185931,28,2911442175,-20743756
1644734326,196486,true,2931892741,28,2911733319,-20159422
1644734880,196484,true,2932479149,28,2913480796,-18998353
1644735044,196489,true,2931013349,28,2914354928,-16658421
1644737974,196488,true,2931306451,28,2919313297,-11993154
1644738400,196489,true,2931013349,28,2919313297,-11700052
1644739526,196487,true,2931599581,28,2919313297,-12286284
1644740150,196492,true,2930134221,28,2919313297,-10820924
1644740365,196492,true,2930134221,28,2919605228,-10528993
1644740834,196493,true,2929841237,28,2920189178,-9652059
1644742069,196492,true,2930134221,28,2921357429,-8776792
1644745574,196497,true,2928669594,28,2921357429,-7312165
1644746462,196497,true,2928669594,28,2921357429,-7312165
1644748235,196499,true,2928083947,28,2919313297,-8770650
1644748513,196498,true,2928376756,28,2919021395,-9355361
1644748574,196503,true,2926913007,28,2919313297,-7599710
1644748720,196503,true,2926913007,28,2919897189,-7015818
1644749763,196504,true,2926620345,28,2924864987,-1755358
1644750276,196502,true,2927205698,28,2927205698,0
1644750785,196507,true,2925742534,28,2927498419,1755885
1644751515,196507,true,2925742534,28,2927498419,1755885
1644751528,196508,true,2925449989,28,2927791168,2341179
1644751660,196506,true,2926035108,28,2927791168,1756060
1644751731,196511,true,2924572530,28,2928083947,3511417
1644754818,196510,true,2924864987,28,2936000060,11135073
1644755427,196511,true,2924572530,28,2936000060,11427530
1644756371,196511,true,2924572530,28,2936000060,11427530
1644756491,196515,true,2923402993,28,2936293660,12890667
1644756507,196514,true,2923695333,28,2936293660,12598327
1644756521,196516,true,2923110682,28,2936293660,13182978
1644756597,196515,true,2923402993,28,2936587290,13184297
1644757374,196520,true,2921941730,28,2938937382,16995652
1644758806,196519,true,2922233924,28,2940407145,18173221
1644759713,196520,true,2921941730,28,2941289355,19347625
1644761777,196519,true,2922233924,28,2942171830,19937906
1644761787,196524,true,2920773245,28,2942466047,21692802
1644762670,196523,true,2921065323,28,2943937574,22872251
1644762689,196524,true,2920773245,28,2943937574,23164329
1644762714,196522,true,2921357429,28,2943937574,22580145
1644762747,196527,true,2919897189,28,2943937574,24040385
1644762879,196527,true,2919897189,28,2943054570,23157381
1644762942,196528,true,2919605228,28,2942760294,23155066
1644762954,196526,true,2920189178,28,2942466047,22276869
1644762988,196529,true,2919313297,28,2942171830,22858533
1644763892,196530,true,2919021395,28,2931306451,12285056
1644764071,196531,true,2918729522,28,2928669594,9940072
1644764173,196529,true,2919313297,28,2927498419,8185122
1644764182,196531,true,2918729522,28,2927205698,8476176
1644764226,196532,true,2918437678,28,2926620345,8182667
1644764490,196531,true,2918729522,28,2923987703,5258181
1644764568,196529,true,2919313297,28,2923695333,4382036
1644764597,196531,true,2918729522,28,2923695333,4965811
1644765521,196531,true,2918729522,28,2928376756,9647234
1644766019,196530,true,2919021395,28,2931306451,12285056
1644766307,196527,true,2919897189,28,2932185931,12288742
1644766457,196528,true,2919605228,28,2932479149,12873921
1644767536,196527,true,2919897189,28,2935706490,15809301
1644767711,196526,true,2920189178,28,2936000060,15810882
1644767834,196523,true,2921065323,28,2936293660,15228337
1644767915,196522,true,2921357429,28,2936000060,14642631
1644768152,196521,true,2921649565,28,2935706490,14056925
1644768180,196520,true,2921941730,28,2935706490,13764760
1644768223,196517,true,2922818400,28,2935412948,12594548
1644768230,196516,true,2923110682,28,2935412948,12302266
1644768260,196516,true,2923110682,28,2935119436,12008754
1644768287,196515,true,2923402993,28,2934825954,11422961
1644768294,196513,true,2923987703,28,2934825954,10838251
1644768664,196513,true,2923987703,28,2929548282,5560579
1644768686,196513,true,2923987703,28,2928962461,4974758
1644768724,196513,true,2923987703,28,2928376756,4389053
1644768987,196512,true,2924280102,28,2923402993,-877109
1644769082,196513,true,2923987703,28,2921649565,-2338138
1644769575,196514,true,2923695333,28,2912898187,-10797146
1644769627,196514,true,2923695333,28,2911733319,-11962014
1644770345,196513,true,2923987703,28,2901850730,-22136973
1644770452,196514,true,2923695333,28,2900690280,-23005053
1644770455,196515,true,2923402993,28,2900690280,-22712713
1644771751,196516,true,2923110682,28,2891712512,-31398170
1644772108,196515,true,2923402993,28,2889111271,-34291722
1644772120,196516,true,2923110682,28,2889111271,-33999411
1644772195,196518,true,2922526147,28,2888533536,-33992611
1644772594,196519,true,2922233924,28,2887089702,-35144222
1644773382,196519,true,2922233924,28,2881897874,-40336050
1644773449,196520,true,2921941730,28,2881321581,-40620149
1644774077,196522,true,2921357429,28,2879881352,-41476077
1644774083,196523,true,2921065323,28,2879881352,-41183971
1644774403,196523,true,2921065323,28,2879593393,-41471930
1644774444,196523,true,2921065323,28,2879881352,-41183971
1644774480,196525,true,2920481197,28,2879881352,-40599845
1644775281,196526,true,2920189178,28,2883915808,-36273370
1644775670,196526,true,2920189178,28,2885069547,-35119631
1644775703,196527,true,2919897189,28,2885358054,-34539135
1644775724,196529,true,2919313297,28,2885358054,-33955243
1644777465,196529,true,2919313297,28,2894316094,-24997203
1644777489,196530,true,2919021395,28,2894316094,-24705301
1644777514,196532,true,2918437678,28,2894316094,-24121584
1644777531,196534,true,2917854078,28,2894316094,-23537984
1644777536,196536,true,2917270595,28,2894026692,-23243903
1644778294,196540,true,2916103978,28,2878729688,-37374290
1644778306,196542,true,2915520845,28,2878441844,-37079001
1644778325,196543,true,2915229322,28,2878154028,-37075294
1644778888,196544,true,2914937828,28,2864372680,-50565148
1644778896,196549,true,2913480796,28,2864086271,-49394525
1644779871,196550,true,2913189477,28,2854936300,-58253177
1644780035,196551,true,2912898187,28,2854936300,-57961887
1644780239,196552,true,2912606927,28,2855792867,-56814060
1644780821,196557,true,2911151060,28,2858649945,-52501115
1644780876,196558,true,2910859974,28,2858649945,-52210029
1644781264,196559,true,2910568917,28,2858935810,-51633107
1644781304,196560,true,2910277889,28,2858935810,-51342079
1644781402,196564,true,2909114069,28,2858649945,-50464124
1644781479,196565,true,2908823187,28,2858364109,-50459078
1644781514,196567,true,2908241509,28,2858078301,-50163208
1644781614,196567,true,2908241509,28,2857792522,-50448987
1644781886,196572,true,2906787825,28,2856078446,-50709379
1644782188,196573,true,2906497175,28,2854365399,-52131776
1644782370,196575,true,2905915963,28,2853223938,-52692025
1644782707,196576,true,2905625400,28,2851797754,-53827646
1644782767,196581,true,2904173023,28,2851512602,-52660421
1644782795,196581,true,2904173023,28,2851512602,-52660421
1644783403,196583,true,2903592276,28,2854936300,-48655976
1644783476,196583,true,2903592276,28,2855792867,-47799409
1644783490,196588,true,2902140915,28,2856078446,-46062469
1644783496,196588,true,2902140915,28,2856078446,-46062469
1644783648,196589,true,2901850730,28,2858649945,-43200785
1644783655,196589,true,2901850730,28,2858649945,-43200785
1644783699,196593,true,2900690280,28,2859507626,-41182654
1644783868,196593,true,2900690280,28,2862368421,-38321859
1644783975,196593,true,2900690280,28,2864372680,-36317600
1644784026,196594,true,2900400240,28,2865518601,-34881639
1644784043,196598,true,2899240370,28,2865805152,-33435218
1644785991,196598,true,2899240370,28,2889400182,-9840188
1644786114,196598,true,2899240370,28,2889978091,-9262279
1644787041,196598,true,2899240370,28,2894316094,-4924276
1644787052,196603,true,2897791184,28,2894316094,-3475090
1644787208,196602,true,2898080964,28,2894894986,-3185978
1644787443,196603,true,2897791184,28,2895184476,-2606708
1644787461,196603,true,2897791184,28,2895184476,-2606708
1644787662,196608,true,2896342723,28,2895763542,-579181
1644787776,196607,true,2896632358,28,2895763542,-868816
1644787848,196608,true,2896342723,28,2895473994,-868729
1644788070,196609,true,2896053118,28,2894316094,-1737024
1644788308,196614,true,2894605526,28,2893158657,-1446869
1644789538,196614,true,2894605526,28,2885935155,-8670371
1644792549,196615,true,2894316094,28,2884204200,-10111894
1644792714,196616,true,2894026692,28,2884492620,-9534072
1644792778,196621,true,2892580112,28,2884781069,-7799043
1644792787,196621,true,2892580112,28,2884781069,-7799043
1644793087,196621,true,2892580112,28,2886801022,-5779090
1644793113,196622,true,2892290883,28,2887089702,-5201181
1644793359,196627,true,2890845171,28,2889111271,-1733900
1644793454,196627,true,2890845171,28,2889978091,-867080
1644793465,196626,true,2891134256,28,2889978091,-1156165
1644793470,196626,true,2891134256,28,2889978091,-1156165
1644793526,196631,true,2889689122,28,2890267089,577967
1644793531,196631,true,2889689122,28,2890267089,577967
1644793598,196630,true,2889978091,28,2890267089,288998
1644793619,196630,true,2889978091,28,2890267089,288998
1644794260,196636,true,2888244711,28,2888244711,0
1644794270,196637,true,2887955916,28,2888244711,288795
1644794333,196635,true,2888533536,28,2888244711,-288825
1644794671,196635,true,2888533536,28,2887378411,-1155125
1644795270,196642,true,2886512371,28,2882474283,-4038088
1644795961,196642,true,2886512371,28,2882474283,-4038088
1644795973,196641,true,2886801022,28,2882474283,-4326739
1644796698,196642,true,2886512371,28,2882762530,-3749841
1644796742,196648,true,2884781069,28,2882762530,-2018539
1644797010,196648,true,2884781069,28,2881897874,-2883195
1644797012,196647,true,2885069547,28,2881897874,-3171673
1644797206,196649,true,2884492620,28,2881321581,-3171039
1644797256,196655,true,2882762530,28,2881321581,-1440949
1644797379,196656,true,2882474283,28,2880745403,-1728880
1644797575,196655,true,2882762530,28,2879881352,-2881178
1644797645,196656,true,2882474283,28,2879881352,-2592931
1644797870,196662,true,2880745403,28,2879593393,-1152010
1644798243,196662,true,2880745403,28,2879881352,-864051
1644798272,196659,true,2881609713,28,2879881352,-1728361
1644798325,196660,true,2881321581,28,2879593393,-1728188
1644798618,196666,true,2879593393,28,2879017561,-575832
1644798619,196666,true,2879593393,28,2879017561,-575832
1644798672,196664,true,2880169341,28,2879017561,-1151780
1644798739,196665,true,2879881352,28,2878729688,-1151664
1644798765,196671,true,2878154028,28,2878441844,287816
1644799013,196670,true,2878441844,28,2877003054,-1438790
1644799027,196668,true,2879017561,28,2877003054,-2014507
1644801585,196669,true,2878729688,28,2869532935,-9196753
1644801833,196675,true,2877003054,28,2869532935,-7470119
1644801864,196674,true,2877290755,28,2869532935,-7757820
1644802070,196672,true,2877866242,28,2868959115,-8907127
1644802084,196672,true,2877866242,28,2868959115,-8907127
1644802093,196678,true,2876140126,28,2868959115,-7181011
1644802128,196677,true,2876427740,28,2868672248,-7755492
1644802262,196676,true,2876715383,28,2867525065,-9190318
1644802282,196676,true,2876715383,28,2867238342,-9477041
1644802338,196681,true,2875277457,28,2866378342,-8899115
1644802581,196681,true,2875277457,28,2862654657,-12622800
1644804611,196680,true,2875564984,28,2845815561,-29749423
1644805040,196680,true,2875564984,28,2846669391,-28895593
1644805790,196685,true,2874127633,28,2849517342,-24610291
1644806403,196685,true,2874127633,28,2852653379,-21474254
1644807135,196684,true,2874415046,28,2854365399,-20049647
1644807192,196684,true,2874415046,28,2854365399,-20049647
1644807331,196689,true,2872978269,28,2854365399,-18612870
1644807651,196690,true,2872691000,28,2854365399,-18325601
1644807729,196688,true,2873265567,28,2854079991,-19185576
1644807893,196689,true,2872978269,28,2853223938,-19754331
1644808433,196695,true,2871255086,28,2851797754,-19457332
1644808605,196695,true,2871255086,28,2851227480,-20027606
1644808856,196694,true,2871542211,28,2850942385,-20599826
1644809143,196693,true,2871829365,28,2850942385,-20886980
1644809683,196695,true,2871255086,28,2852368142,-18886944
1644809736,196696,true,2870967989,28,2852368142,-18599847
1644809750,196694,true,2871542211,28,2852368142,-19174069
1644812625,196693,true,2871829365,28,2860651600,-11177765
1644813631,196694,true,2871542211,28,2860651600,-10890611
1644814055,196695,true,2871255086,28,2860651600,-10603486
1644814298,196693,true,2871829365,28,2860651600,-11177765
1644814901,196692,true,2872116548,28,2860651600,-11464948
1644815341,196694,true,2871542211,28,2861223759,-10318452
1644816136,196695,true,2871255086,28,2862654657,-8600429
1644817612,196693,true,2871829365,28,2863799891,-8029474
1644817618,196692,true,2872116548,28,2863799891,-8316657
1644817623,196693,true,2871829365,28,2863799891,-8029474
1644818011,196694,true,2871542211,28,2863227217,-8314994
1644818049,196692,true,2872116548,28,2863227217,-8889331
1644818097,196690,true,2872691000,28,2862940923,-9750077
1644818442,196692,true,2872116548,28,2861509882,-10606666
1644818659,196693,true,2871829365,28,2860651600,-11177765
1644818999,196691,true,2872403760,28,2859221704,-13182056
1644819215,196690,true,2872691000,28,2858364109,-14326891
1644819883,196691,true,2872403760,28,2856078446,-16325314
1644820363,196692,true,2872116548,28,2855507316,-16609232
1644820750,196691,true,2872403760,28,2855221794,-17181966
1644820781,196691,true,2872403760,28,2855221794,-17181966
1644821340,196692,true,2872116548,28,2854936300,-17180248
1644821432,196693,true,2871829365,28,2855221794,-16607571
1644821438,196694,true,2871542211,28,2855221794,-16320417
1644821479,196693,true,2871829365,28,2855221794,-16607571
1644821511,196694,true,2871542211,28,2855507316,-16034895
1644821586,196695,true,2871255086,28,2856078446,-15176640
1644821920,196696,true,2870967989,28,2858078301,-12889688
1644821933,196695,true,2871255086,28,2858364109,-12890977
1644822905,196696,true,2870967989,28,2864945583,-6022406
1644824706,196698,true,2870393881,28,2869246011,-1147870
1644825130,196698,true,2870393881,28,2869246011,-1147870
1644825162,196698,true,2870393881,28,2869532935,-860946
1644825163,196699,true,2870106871,28,2869532935,-573936
1644825702,196701,true,2869532935,28,2871255086,1722151
1644825801,196701,true,2869532935,28,2871829365,2296430
1644826584,196700,true,2869819889,28,2877290755,7470866
1644827252,196701,true,2869532935,28,2880745403,11212468
1644827385,196702,true,2869246011,28,2881033478,11787467
1644827593,196702,true,2869246011,28,2881321581,12075570
1644827608,196701,true,2869532935,28,2881321581,11788646
1644827739,196702,true,2869246011,28,2881321581,12075570
1644827775,196703,true,2868959115,28,2881033478,12074363
1644827911,196703,true,2868959115,28,2880745403,11786288
1644828248,196702,true,2869246011,28,2879017561,9771550
1644828388,196703,true,2868959115,28,2878441844,9482729
1644828997,196704,true,2868672248,28,2874989958,6317710
1644829123,196705,true,2868385409,28,2874127633,5742224
1644829142,196705,true,2868385409,28,2873840249,5454840
1644829285,196707,true,2867811818,28,2872978269,5166451
1644829294,196708,true,2867525065,28,2872691000,5165935
1644829302,196710,true,2866951646,28,2872691000,5739354
1644829562,196710,true,2866951646,28,2870680921,3729275
1644829678,196711,true,2866664980,28,2869819889,3154909
1644832512,196712,true,2866378342,28,2863513540,-2864802
1644832590,196713,true,2866091733,28,2863513540,-2578193
1644832917,196712,true,2866378342,28,2863513540,-2864802
1644833104,196713,true,2866091733,28,2862940923,-3150810
1644833162,196714,true,2865805152,28,2862940923,-2864229
1644833724,196715,true,2865518601,28,2861796033,-3722568
1644834067,196715,true,2865518601,28,2861223759,-4294842
1644835730,196716,true,2865232077,28,2860079556,-5152521
1644835739,196717,true,2864945583,28,2860365564,-4580019
1644835984,196718,true,2864659117,28,2860651600,-4007517
1644836174,196718,true,2864659117,28,2861509882,-3149235
1644836409,196718,true,2864659117,28,2862368421,-2290696
1644837182,196719,true,2864372680,28,2865232077,859397
1644837306,196720,true,2864086271,28,2865805152,1718881
1644837978,196719,true,2864372680,28,2866951646,2578966
1644838142,196719,true,2864372680,28,2867238342,2865662
1644839715,196720,true,2864086271,28,2869246011,5159740
1644841273,196720,true,2864086271,28,2869246011,5159740
1644841290,196720,true,2864086271,28,2869246011,5159740
1644841489,196720,true,2864086271,28,2869246011,5159740
1644842328,196721,true,2863799891,28,2868672248,4872357
1644842356,196722,true,2863513540,28,2868672248,5158708
1644842387,196722,true,2863513540,28,2868672248,5158708
1644842399,196722,true,2863513540,28,2868672248,5158708
1644842439,196721,true,2863799891,28,2869246011,5446120
1644842517,196721,true,2863799891,28,2870106871,6306980
1644842547,196720,true,2864086271,28,2870680921,6594650
1644842740,196718,true,2864659117,28,2874127633,9468516
1644843301,196717,true,2864945583,28,2886512371,21566788
1644843318,196716,true,2865232077,28,2886801022,21568945
1644843338,196715,true,2865518601,28,2887378411,21859810
1644843351,196714,true,2865805152,28,2887667149,21861997
1644843410,196711,true,2866664980,28,2889400182,22735202
1644843459,196710,true,2866951646,28,2890845171,23893525
1644843598,196709,true,2867238342,28,2894605526,27367184
1644843643,196707,true,2867811818,28,2896053118,28241300
1644843741,196704,true,2868672248,28,2898950475,30278227
1644843826,196702,true,2869246011,28,2901850730,32604719
1644843873,196700,true,2869819889,28,2903301946,33482057
1644843930,196698,true,2870393881,28,2905044362,34650481
1644844561,196694,true,2871542211,28,2919313297,47771086
1644844830,196692,true,2872116548,28,2921941730,49825182
1644845399,196690,true,2872691000,28,2927791168,55100168
1644845857,196687,true,2873552894,28,2930720277,57167383
1644846294,196683,true,2874702487,28,2933652317,58949830
1644846843,196682,true,2874989958,28,2935706490,60716532
1644847571,196680,true,2875564984,28,2936293660,60728676
1644847931,196677,true,2876427740,28,2936880948,60453208
1644848039,196673,true,2877578484,28,2937468354,59889870
1644848606,196671,true,2878154028,28,2941289355,63135327
1644848627,196668,true,2879017561,28,2941583484,62565923
1644848707,196665,true,2879881352,28,2942171830,62290478
1644848783,196661,true,2881033478,28,2943054570,62021092
1644849192,196658,true,2881897874,28,2948356573,66458699
1644849312,196655,true,2882762530,28,2949536093,66773563
1644849865,196653,true,2883339111,28,2952782205,69443094
1644850863,196649,true,2884492620,28,2949241169,64748549
1644850927,196646,true,2885358054,28,2948946274,63588220
1644852622,196645,true,2885646590,28,2939819151,54172561
1644852674,196643,true,2886223748,28,2939819151,53595403
1644853009,196639,true,2887378411,28,2938643518,51265107
1644853167,196637,true,2887955916,28,2938055877,50099961
1644853590,196636,true,2888244711,28,2935412948,47168237
1644853629,196634,true,2888822389,28,2935119436,46297047
1644854337,196631,true,2889689122,28,2931306451,41617329
1644854631,196628,true,2890556116,28,2930720277,40164161
1644855369,196628,true,2890556116,28,2932772397,42216281
1644855827,196625,true,2891423369,28,2935119436,43696067
1644855862,196622,true,2892290883,28,2935412948,43122065
1644856050,196619,true,2893158657,28,2936587290,43428633
1644856069,196618,true,2893447973,28,2936587290,43139317
1644856231,196615,true,2894316094,28,2938055877,43739783
1644856292,196611,true,2895473994,28,2938349683,42875689
1644856302,196608,true,2896342723,28,2938349683,42006960
1644856500,196607,true,2896632358,28,2940113133,43480775
1644856511,196604,true,2897501434,28,2940113133,42611699
1644856625,196600,true,2898660609,28,2941289355,42628746
1644856647,196596,true,2899820247,28,2941583484,41763237
1644856823,196594,true,2900400240,28,2943348875,42948635
1644856877,196591,true,2901270447,28,2943937574,42667127
1644856885,196587,true,2902431129,28,2944231968,41800839
1644857000,196583,true,2903592276,28,2945998949,42406673
1644857510,196581,true,2904173023,28,2952782205,48609182
1644857709,196579,true,2904753887,28,2954849773,50095886
1644857926,196575,true,2905915963,28,2956918788,51002825
1644858390,196572,true,2906787825,28,2958989253,52201428
1644860075,196570,true,2907369212,28,2954849773,47480561
1644860113,196568,true,2907950714,28,2954849773,46899059
1644860218,196565,true,2908823187,28,2954554318,45731131
1644860287,196562,true,2909695921,28,2954554318,44858397
1644860399,196560,true,2910277889,28,2954258892,43981003
1644860620,196558,true,2910859974,28,2953372791,42512817
1644863049,196555,true,2911733319,28,2948356573,36623254
1644863610,196553,true,2912315695,28,2945704379,33388684
1644864571,196552,true,2912606927,28,2940407145,27800218
1644864654,196550,true,2913189477,28,2939819151,26629674
1644864693,196548,true,2913772144,28,2939525199,25753055
1644864754,196546,true,2914354928,28,2938643518,24288590
1644864887,196547,true,2914063521,28,2936587290,22523769
1644865368,196545,true,2914646363,28,2931013349,16366986
1644865390,196544,true,2914937828,28,2930720277,15782449
1644865440,196541,true,2915812397,28,2929841237,14028840
1644865453,196542,true,2915520845,28,2929548282,14027437
1644865478,196541,true,2915812397,28,2929255357,13442960
1644865493,196539,true,2916395588,28,2928962461,12566873
1644865594,196537,true,2916978897,28,2926620345,9641448
1644865794,196539,true,2916395588,28,2921357429,4961841
1644866192,196539,true,2916395588,28,2909114069,-7281519
1644866294,196537,true,2916978897,28,2905915963,-11062934
1644866628,196535,true,2917562322,28,2896922021,-20640301
1644866726,196536,true,2917270595,28,2894605526,-22665069
1644866728,196537,true,2916978897,28,2894605526,-22373371
1644866953,196535,true,2917562322,28,2888822389,-28739933
1644867065,196534,true,2917854078,28,2886223748,-31630330
1644867092,196535,true,2917562322,28,2885358054,-32204268
1644867107,196535,true,2917562322,28,2885069547,-32492775
1644867114,196533,true,2918145863,28,2885069547,-33076316
1644867169,196532,true,2918437678,28,2883627445,-34810233
1644867200,196534,true,2917854078,28,2882762530,-35091548
1644867331,196534,true,2917854078,28,2879881352,-37972726
1644867377,196532,true,2918437678,28,2879305463,-39132215
1644867523,196531,true,2918729522,28,2877866242,-40863280
1644867734,196532,true,2918437678,28,2877003054,-41434624
1644868252,196533,true,2918145863,28,2875852541,-42293322
1644869243,196531,true,2918729522,28,2880457357,-38272165
1644869266,196529,true,2919313297,28,2880745403,-38567894
1644870737,196531,true,2918729522,28,2879593393,-39136129
1644870766,196531,true,2918729522,28,2879305463,-39424059
1644870802,196529,true,2919313297,28,2879305463,-40007834
1644870821,196528,true,2919605228,28,2879593393,-40011835
1644870852,196529,true,2919313297,28,2879593393,-39719904
1644870884,196529,true,2919313297,28,2879593393,-39719904
1644870939,196527,true,2919897189,28,2879881352,-40015837
1644871649,196525,true,2920481197,28,2885358054,-35123143
1644871818,196526,true,2920189178,28,2886801022,-33388156
1644875428,196526,true,2920189178,28,2895184476,-25004702
1644875453,196525,true,2920481197,28,2895473994,-25007203
1644875456,196524,true,2920773245,28,2895473994,-25299251
1644875535,196525,true,2920481197,28,2895763542,-24717655
1644875556,196525,true,2920481197,28,2896053118,-24428079
1644875592,196524,true,2920773245,28,2896342723,-24430522
1644875638,196524,true,2920773245,28,2896632358,-24140887
1644875654,196525,true,2920481197,28,2896922021,-23559176
1644876287,196525,true,2920481197,28,2902721372,-17759825
1644876421,196525,true,2920481197,28,2904173023,-16308174
1644876468,196524,true,2920773245,28,2904753887,-16019358
1644876549,196526,true,2920189178,28,2905625400,-14563778
1644876601,196525,true,2920481197,28,2906206555,-14274642
1644876653,196525,true,2920481197,28,2906787825,-13693372
1644876659,196525,true,2920481197,28,2907078504,-13402693
1644876693,196526,true,2920189178,28,2907659948,-12529230
1644876827,196525,true,2920481197,28,2909986891,-10494306
1644876917,196525,true,2920481197,28,2911733319,-8747878
1644877111,196524,true,2920773245,28,2915812397,-4960848
1644877133,196526,true,2920189178,28,2916103978,-4085200
1644877267,196525,true,2920481197,28,2919021395,-1459802
1644879842,196525,true,2920481197,28,2935412948,14931751
1644882641,196524,true,2920773245,28,2940407145,19633900
1644882706,196526,true,2920189178,28,2940407145,20217967
1644882754,196525,true,2920481197,28,2940407145,19925948
1644882767,196525,true,2920481197,28,2940407145,19925948
1644883887,196525,true,2920481197,28,2938349683,17868486
1644884618,196527,true,2919897189,28,2937174636,17277447
1644884792,196526,true,2920189178,28,2937174636,16985458
1644884878,196526,true,2920189178,28,2936880948,16691770
1644885197,196527,true,2919897189,28,2935706490,15809301
1644885236,196530,true,2919021395,28,2935412948,16391553
1644885443,196529,true,2919313297,28,2934239077,14925780
1644886274,196529,true,2919313297,28,2928083947,8770650
1644886436,196530,true,2919021395,28,2926620345,7598950
1644887263,196532,true,2918437678,28,2923402993,4965315
1644887745,196532,true,2918437678,28,2923402993,4965315
1644888331,196531,true,2918729522,28,2923110682,4381160
1644888355,196532,true,2918437678,28,2923402993,4965315
1644888374,196533,true,2918145863,28,2923402993,5257130
1644888467,196532,true,2918437678,28,2923695333,5257655
1644888534,196531,true,2918729522,28,2923987703,5258181
1644888689,196532,true,2918437678,28,2925157473,6719795
1644888740,196533,true,2918145863,28,2925449989,7304126
1644888749,196532,true,2918437678,28,2925742534,7304856
1644888771,196531,true,2918729522,28,2925742534,7013012
1644888847,196531,true,2918729522,28,2926620345,7890823
1644888860,196532,true,2918437678,28,2926913007,8475329
1644888873,196532,true,2918437678,28,2927205698,8768020
1644888874,196531,true,2918729522,28,2927205698,8476176
1644888906,196530,true,2919021395,28,2927791168,8769773
1644888974,196530,true,2919021395,28,2929548282,10526887
1644888993,196530,true,2919021395,28,2930134221,11112826
1644889029,196528,true,2919605228,28,2931306451,11701223
1644889088,196526,true,2920189178,28,2933652317,13463139
1644889120,196526,true,2920189178,28,2935119436,14930258
1644889301,196524,true,2920773245,28,2943348875,22575630
1644889775,196522,true,2921357429,28,2964616395,43258966
1644889864,196520,true,2921941730,28,2968769557,46827827
1644890142,196520,true,2921941730,28,2981562111,59620381
1644890158,196519,true,2922233924,28,2982158453,59924529
1644890186,196517,true,2922818400,28,2983351495,60533095
1644890236,196515,true,2923402993,28,2985739012,62336019
1644890308,196514,true,2923695333,28,2989024967,65329634
1644890332,196512,true,2924280102,28,2989921765,65641663
1644890349,196510,true,2924864987,28,2990818831,65953844
1644890392,196508,true,2925449989,28,2992613771,67163782
1644890420,196506,true,2926035108,28,2993810996,67775888
1644890602,196504,true,2926620345,28,3001904803,75284458
1644890605,196502,true,2927205698,28,3001904803,74699105
1644890629,196499,true,2928083947,28,3003105745,75021798
1644890795,196497,true,2928669594,28,3008515932,79846338
1644891001,196495,true,2929255357,28,3011525802,82270445
1644892984,196492,true,2930134221,28,3024805045,94670824
1644893042,196489,true,2931013349,28,3025107525,94094176
1644893330,196486,true,2931892741,28,3025107525,93214784
1644893419,196482,true,2933065674,28,3025410036,92344362
1644893466,196479,true,2933945682,28,3025410036,91464354
1644894149,196476,true,2934825954,28,3026923044,92097090
1644895943,196472,true,2936000060,28,3029951329,93951269
1644898943,196468,true,2937174636,28,3029951329,92776693
1644899765,196464,true,2938349683,28,3029648364,91298681
1644899804,196460,true,2939525199,28,3029345430,89820231
1644899837,196456,true,2940701185,28,3029345430,88644245
1644899852,196451,true,2942171830,28,3029345430,87173600
1644900150,196448,true,2943054570,28,3028133994,85079424
1644900176,196443,true,2944526391,28,3028133994,83607603
1644900269,196439,true,2945704379,28,3027831211,82126832
1644900830,196434,true,2947177525,28,3024805045,77627520
1644901609,196430,true,2948356573,28,3021479755,73123182
1644904109,196426,true,2949536093,28,3018158120,68622027
1644904900,196421,true,2951011156,28,3018158120,67146964
1644905102,196416,true,2952486957,28,3018158120,65671163
1644905684,196413,true,2953372791,28,3018158120,64785329
1644906315,196408,true,2954849773,28,3018158120,63308347
1644906368,196403,true,2956327493,28,3018158120,61830627
1644906920,196398,true,2957805953,28,3018158120,60352167
1644906948,196395,true,2958693383,28,3018459936,59766553
1644907102,196390,true,2960173026,28,3018761782,58588756
1644907125,196385,true,2961653408,28,3018761782,57108374
1644907865,196380,true,2963134531,28,3020875549,57741018
1644908687,196377,true,2964023561,28,3028133994,64110433
1644908913,196372,true,2965505869,28,3029648364,64142495
1644910213,196367,true,2966988918,28,3033892630,66903712
1644910657,196362,true,2968472710,28,3034802889,66330179
1644910690,196358,true,2969660277,28,3034802889,65142612
1644911065,196353,true,2971145404,28,3036016992,64871588
1644911340,196348,true,2972631274,28,3037231581,64600307
1644911375,196343,true,2974117887,28,3037231581,63113694
1644911419,196340,true,2975010211,28,3037535304,62525093
1644912118,196334,true,2976795664,28,3045138262,68342598
1644912212,196329,true,2978284359,28,3046051895,67767536
1644912655,196324,true,2979773799,28,3050014139,70240340
1644913018,196320,true,2980965888,28,3054286936,73321048
1644913689,196315,true,2982456669,28,3057954096,75497427
1644913832,196309,true,2984246590,28,3058565718,74319128
1644913923,196305,true,2985440468,28,3058871574,73431106
1644914046,196302,true,2986336189,28,3059483379,73147190
1644914062,196296,true,2988128439,28,3059789328,71660889
1644914147,196291,true,2989622802,28,3060401316,70778514
1644914174,196287,true,2990818831,28,3060707356,69888525
1644914243,196283,true,2992015338,28,3061319528,69304190
1644914281,196277,true,2993810996,28,3061625660,67814664
1644914294,196272,true,2995308201,28,3061625660,66317459
1644914376,196268,true,2996506504,28,3062544240,66037736
1644915740,196264,true,2997705286,28,3078202327,80497041
1644917866,196258,true,2999504359,28,3080973817,81469458
1644918417,196253,true,3001004411,28,3082206392,81201981
1644918420,196249,true,3002204993,28,3082206392,80001399
1644918442,196245,true,3003406055,28,3082206392,78800337
1644918498,196240,true,3004908059,28,3082206392,77298333
1644918573,196235,true,3006410813,28,3082514612,76103799
1644918592,196231,true,3007613558,28,3082514612,74901054
1644918609,196227,true,3008816784,28,3082822864,74006080
1644919201,196222,true,3010321493,28,3085598514,75277021
1644920321,196216,true,3012128138,28,3090848230,78720092
1644920478,196213,true,3013031866,28,3091157315,78125449
1644920493,196209,true,3014237260,28,3091157315,76920055
1644920608,196203,true,3016046254,28,3091157315,75111061
1644921204,196198,true,3017554579,28,3092393964,74839385
1644921280,196194,true,3018761782,28,3092393964,73632182
1644921291,196191,true,3019667501,28,3092393964,72726463
1644921301,196184,true,3021781903,28,3092393964,70612061
1644921613,196178,true,3023595425,28,3093940470,70345045
1644921719,196174,true,3024805045,28,3094249864,69444819
1644921787,196170,true,3026015148,28,3094868745,68853597
1644922528,196163,true,3028133994,28,3100754291,72620297
1644922790,196157,true,3029951329,28,3102615208,72663879
1644923443,196152,true,3031466608,28,3106029792,74563184
1644923655,196149,true,3032376139,28,3105719220,73343081
1644924600,196142,true,3034499439,28,3103856441,69357002
1644925758,196135,true,3036624226,28,3102304978,65680752
1644926578,196131,true,3037839058,28,3103546086,65707028
1644926615,196128,true,3038750501,28,3103546086,64795585
1644927987,196122,true,3040574207,28,3102304978,61730771
1644928086,196115,true,3042703247,28,3101994778,59291531
1644929411,196112,true,3043616150,28,3101374473,57758323
1644929543,196109,true,3044529326,28,3101684610,57155284
1644929800,196103,true,3046356500,28,3101994778,55638278
1644930040,196097,true,3048184771,28,3102615208,54430437
1644930255,196093,true,3049404228,28,3103235763,53831535
1644930284,196090,true,3050319141,28,3103235763,52916622
1644930453,196085,true,3051844605,28,3103856441,52011836
1644930660,196080,true,3053370833,28,3104787691,51416858
1644930684,196076,true,3054592364,28,3104787691,50195327
1644930808,196074,true,3055203313,28,3105408679,50205366
1644931027,196070,true,3056425578,28,3106651029,50225451
1644931164,196066,true,3057648332,28,3107272390,49624058
1644931185,196063,true,3058565718,28,3107583118,49017400
1644931492,196061,true,3059177462,28,3109137220,49959758
1644931706,196058,true,3060095307,28,3110070054,49974747
1644931904,196054,true,3061319528,28,3110381061,49061533
1644932377,196051,true,3062238016,28,3111003169,48765153
1644932521,196049,true,3062850494,28,3111003169,48152675
1644932626,196045,true,3064075818,28,3110692100,46616282
1644932853,196042,true,3064995133,28,3110381061,45385928
1644934017,196040,true,3065608163,28,3108204665,42596502
1644934128,196038,true,3066221315,28,3108826337,42605022
1644934590,196034,true,3067447987,28,3112247757,44799770
1644934667,196030,true,3068675151,28,3112870237,44195086
1644934766,196027,true,3069595845,28,3113804192,44208347
1644934916,196025,true,3070209795,28,3115361405,45151610
1644934958,196021,true,3071438063,28,3115984509,44546446
1644934981,196018,true,3072359587,28,3116296107,43936520
1644935034,196015,true,3073281387,28,3116919398,43638011
1644935250,196013,true,3073896074,28,3119725747,45829673
1644935368,196009,true,3075125817,28,3121285922,46160105
1644935518,196006,true,3076048447,28,3122534624,46486177
1644935869,196003,true,3076971354,28,3125033526,48062172
1644935988,196001,true,3077586779,28,3125346030,47759251
1644936071,195998,true,3078510147,28,3125658564,47148417
1644936583,195994,true,3079741736,28,3130350335,50608599
1644936613,195991,true,3080665751,28,3130663370,49997619
1644936624,195989,true,3081281915,28,3130663370,49381455
1644936653,195985,true,3082514612,28,3130663370,48148758
1644937177,195983,true,3083131146,28,3130037332,46906186
1644937424,195980,true,3084056178,28,3130663370,46607192
1644937929,195977,true,3084981487,28,3131289534,46308047
1644938205,195973,true,3086215665,28,3129098508,42882843
1644938239,195971,true,3086832939,28,3128785630,41952691
1644938297,195967,true,3088067857,28,3128159966,40092109
1644938575,195965,true,3088685502,28,3125971130,37285628
1644938659,195962,true,3089612200,28,3125346030,35733830
1644939950,195959,true,3090539177,28,3118166352,27627175
1644941572,195956,true,3091466431,28,3120973825,29507394
1644941608,195953,true,3092393964,28,3121285922,28891958
1644941620,195950,true,3093321775,28,3121285922,27964147
1644941666,195947,true,3094249864,28,3121598051,27348187
1644941765,195943,true,3095487750,28,3122534624,27046874
1644941907,195940,true,3096416489,28,3123471478,27054989
1644942178,195936,true,3097655241,28,3125658564,28003323
1644942220,195934,true,3098274803,28,3125971130,27696327
1644942230,195930,true,3099514299,28,3125971130,26456831
1644942249,195927,true,3100444246,28,3126283727,25839481
1644942297,195925,true,3101064366,28,3126283727,25219361
1644942354,195922,true,3101994778,28,3126596355,24601577
1644942983,195919,true,3102925470,28,3126596355,23670885
1644943735,195917,true,3103546086,28,3123159162,19613076
1644945429,195915,true,3104166826,28,3118166352,13999526
1644945453,195913,true,3104787691,28,3117854567,13066876
1644945519,195910,true,3105719220,28,3117542813,11823593
1644945527,195908,true,3106340395,28,3117542813,11202418
1644945568,195908,true,3106340395,28,3117231090,10890695
1644945656,195907,true,3106651029,28,3116607737,9956708
1644945692,195905,true,3107272390,28,3116296107,9023717
1644945982,195903,true,3107893876,28,3113492843,5598967
1644946535,195903,true,3107893876,28,3107893876,0
1644946655,195902,true,3108204665,28,3106651029,-1553636
1644947516,195900,true,3108826337,28,3098584631,-10241706
1644949270,195899,true,3109137220,28,3097035803,-12101417
1644949291,195899,true,3109137220,28,3097345507,-11791713
1644949401,195899,true,3109137220,28,3097345507,-11791713
1644949448,195897,true,3109759079,28,3097655241,-12103838
1644949476,195895,true,3110381061,28,3097655241,-12725820
1644949486,195895,true,3110381061,28,3097655241,-12725820
1644949729,195894,true,3110692100,28,3099204379,-11487721
1644949800,195893,true,3111003169,28,3099824250,-11178919
1644949852,195892,true,3111314269,28,3100134233,-11180036
1644949985,195892,true,3111314269,28,3101374473,-9939796
1644951656,195891,true,3111625401,28,3113181524,1556123
1644955284,195889,true,3112247757,28,3113492843,1245086
1644956336,195888,true,3112558982,28,3113492843,933861
1644957627,195889,true,3112247757,28,3111936563,-311194
1644959362,195888,true,3112558982,28,3111003169,-1555813
1644960622,195886,true,3113181524,28,3111003169,-2178355
1644960724,195885,true,3113492843,28,3111003169,-2489674
1644960750,195886,true,3113181524,28,3111003169,-2178355
1644960773,195885,true,3113492843,28,3111003169,-2489674
1644960875,195884,true,3113804192,28,3110692100,-3112092
1644961898,195884,true,3113804192,28,3105719220,-8084972
1644963253,195885,true,3113492843,28,3102304978,-11187865
1644963324,195884,true,3113804192,28,3102615208,-11188984
1644963912,195883,true,3114115572,28,3105098170,-9017402
1644963989,195883,true,3114115572,28,3105719220,-8396352
1644964075,195883,true,3114115572,28,3106340395,-7775177
1644964153,195883,true,3114115572,28,3106961694,-7153878
1644964188,195881,true,3114738427,28,3107272390,-7466037
1644964231,195881,true,3114738427,28,3107583118,-7155309
1644964266,195881,true,3114738427,28,3108204665,-6533762
1644964302,195881,true,3114738427,28,3108515486,-6222941
1644964307,195879,true,3115361405,28,3108826337,-6535068
1644964340,195878,true,3115672942,28,3109137220,-6535722
1644964360,195878,true,3115672942,28,3109448134,-6224808
1644964386,195878,true,3115672942,28,3110070054,-5602888
1644964704,195875,true,3116607737,28,3115984509,-623228
1644964726,195874,true,3116919398,28,3116296107,-623291
1644965570,195874,true,3116919398,28,3131289534,14370136
1644965972,195873,true,3117231090,28,3136616987,19385897
1644967213,195871,true,3117854567,28,3135362654,17508087
1644967254,195870,true,3118166352,28,3135362654,17196302
1644967280,195871,true,3117854567,28,3135362654,17508087
1644967476,195870,true,3118166352,28,3135362654,17196302
1644967507,195867,true,3119101896,28,3135362654,16260758
1644967537,195867,true,3119101896,28,3135362654,16260758
1644967561,195867,true,3119101896,28,3135362654,16260758
1644967586,195866,true,3119413806,28,3135362654,15948848
1644967596,195864,true,3120037720,28,3135676190,15638470
1644967615,195863,true,3120349724,28,3135676190,15326466
1644967933,195862,true,3120661759,28,3139755016,19093257
1644968313,195860,true,3121285922,28,3146040495,24754573
1644968367,195858,true,3121910211,28,3146984402,25074191
1644968603,195856,true,3122534624,28,3153284353,30749729
1644968672,195855,true,3122846877,28,3155176797,32329920
1644970649,195852,true,3123783825,28,3185610822,61826997
1644970745,195849,true,3124721054,28,3185610822,60889768
1644970788,195848,true,3125033526,28,3185292293,60258767
1644971009,195846,true,3125658564,28,3184336896,58678332
1644971257,195845,true,3125971130,28,3181790573,55819443
1644971457,195842,true,3126909015,28,3179564210,52655195
1644971598,195841,true,3127221706,28,3177974905,50753199
1644972938,195840,true,3127534428,28,3165922118,38387690
1644973370,195839,true,3127847182,28,3165289028,37441846
1644974040,195837,true,3128472782,28,3165289028,36816246
1644974065,195836,true,3128785630,28,3165289028,36503398
1644974222,195836,true,3128785630,28,3164656065,35870435
1644974423,195835,true,3129098508,28,3163706858,34608350
1644974729,195834,true,3129411418,28,3162125479,32714061
1644975759,195833,true,3129724359,28,3157386084,27661725
1644975916,195833,true,3129724359,28,3156439057,26714698
1644976258,195832,true,3130037332,28,3155176797,25139465
1644976354,195831,true,3130350335,28,3154861311,24510976
1644977098,195831,true,3130350335,28,3149502871,19152536
1644979112,195830,true,3130663370,28,3143839148,13175778
1644979361,195830,true,3130663370,28,3143839148,13175778
1644979389,195830,true,3130663370,28,3143839148,13175778
1644980155,195830,true,3130663370,28,3143839148,13175778
1644980163,195830,true,3130663370,28,3143839148,13175778
1644980304,195829,true,3130976437,28,3144153531,13177094
1644980642,195828,true,3131289534,28,3144782394,13492860
1644980679,195828,true,3131289534,28,3145096872,13807338
1644980782,195827,true,3131602663,28,3145411382,13808719
1644980813,195826,true,3131915824,28,3145725923,13810099
1644980816,195825,true,3132229015,28,3145725923,13496908
1644980946,195824,true,3132542238,28,3146669735,14127497
1644980981,195823,true,3132855492,28,3146984402,14128910
1644980993,195822,true,3133168778,28,3146984402,13815624
1644981003,195821,true,3133482095,28,3146984402,13502307
1644981103,195819,true,3134108822,28,3147928592,13819770
1644981159,195818,true,3134422233,28,3148558209,14135976
1644981177,195817,true,3134735676,28,3148873065,14137389
1644981191,195817,true,3134735676,28,3148873065,14137389
1644981420,195816,true,3135049149,28,3151708184,16659035
1644981566,195815,true,3135362654,28,3153284353,17921699
1644981898,195814,true,3135676190,28,3157070377,21394187
1644982299,195814,true,3135676190,28,3161177031,25500841
1644982330,195813,true,3135989758,28,3161493149,25503391
1644982403,195811,true,3136616987,28,3161809298,25192311
1644982527,195810,true,3136930649,28,3162125479,25194830
1644982719,195810,true,3136930649,28,3161809298,24878649
1644983168,195809,true,3137244342,28,3158965092,21720750
1644984741,195808,true,3137558066,28,3146040495,8482429
1644985075,195807,true,3137871822,28,3143839148,5967326
1644985099,195807,true,3137871822,28,3143839148,5967326
1644985174,195806,true,3138185609,28,3142896184,4710575
1644985538,195806,true,3138185609,28,3139127159,941550
1644985602,195804,true,3138813278,28,3138185609,-627669
1644987947,195806,true,3138185609,28,3116607737,-21577872
1644987971,195804,true,3138813278,28,3116919398,-21893880
1644987979,195804,true,3138813278,28,3116919398,-21893880
1644988406,195802,true,3139441072,28,3118790017,-20651055
1644988477,195803,true,3139127159,28,3119101896,-20025263
1644992269,195801,true,3139755016,28,3127221706,-12533310
1644992296,195800,true,3140068992,28,3127534428,-12534564
1644992362,195799,true,3140382998,28,3127534428,-12848570
1644992406,195799,true,3140382998,28,3127847182,-12535816
1644993768,195797,true,3141011107,28,3136616987,-4394120
1644994235,195796,true,3141325208,28,3138813278,-2511930
1644997874,195795,true,3141639340,28,3138813278,-2826062
1644998053,195796,true,3141325208,28,3138813278,-2511930
1644998296,195793,true,3142267699,28,3138813278,-3454421
1644998433,195793,true,3142267699,28,3139127159,-3140540
1644998445,195792,true,3142581926,28,3139127159,-3454767
1644998578,195792,true,3142581926,28,3139755016,-2826910
1644999435,195790,true,3143210474,28,3143210474,0
1644999588,195789,true,3143524795,28,3144153531,628736
1644999824,195788,true,3143839148,28,3145411382,1572234
1645000952,195788,true,3143839148,28,3150762861,6923713
1645001789,195785,true,3144782394,28,3152338557,7556163
1645001802,195784,true,3145096872,28,3152338557,7241685
1645002615,195784,true,3145096872,28,3151077937,5981065
1645002784,195783,true,3145411382,28,3150447816,5036434
1645004592,195780,true,3146355099,28,3145725923,-629176
1645005223,195779,true,3146669735,28,3145725923,-943812
1645005246,195779,true,3146669735,28,3145725923,-943812
1645005555,195778,true,3146984402,28,3145096872,-1887530
1645005648,195775,true,3147928592,28,3144782394,-3146198
1645005876,195776,true,3147613830,28,3143839148,-3774682
1645006970,195776,true,3147613830,28,3139127159,-8486671
1645007001,195776,true,3147613830,28,3139127159,-8486671
1645007014,195773,true,3148558209,28,3139127159,-9431050
1645007027,195774,true,3148243384,28,3138813278,-9430106
1645007068,195775,true,3147928592,28,3138499428,-9429164
1645008857,195776,true,3147613830,28,3125658564,-21955266
1645008959,195773,true,3148558209,28,3125658564,-22899645
1645009040,195774,true,3148243384,28,3125658564,-22584820
1645009383,195775,true,3147928592,28,3125658564,-22270028
1645009432,195777,true,3147299100,28,3125658564,-21640536
1645010357,195774,true,3148243384,28,3129411418,-18831966
1645011700,195775,true,3147928592,28,3132229015,-15699577
1645013225,195776,true,3147613830,28,3132542238,-15071592
1645013704,195777,true,3147299100,28,3133482095,-13817005
1645014163,195774,true,3148243384,28,3133795443,-14447941
1645014484,195775,true,3147928592,28,3133795443,-14133149
1645014901,195776,true,3147613830,28,3133795443,-13818387
1645015469,195778,true,3146984402,28,3132542238,-14442164
1645015474,195775,true,3147928592,28,3132542238,-15386354
1645016137,195776,true,3147613830,28,3129724359,-17889471
1645016255,195777,true,3147299100,28,3129411418,-17887682
1645016758,195780,true,3146355099,28,3126596355,-19758744
1645016786,195777,true,3147299100,28,3126596355,-20702745
1645018205,195780,true,3146355099,28,3120661759,-25693340
1645018406,195782,true,3145725923,28,3120037720,-25688203
1645018519,195785,true,3144782394,28,3119413806,-25368588
1645019274,195783,true,3145411382,28,3112247757,-33163625
1645019301,195788,true,3143839148,28,3111936563,-31902585
1645019322,195791,true,3142896184,28,3111625401,-31270783
1645019372,195794,true,3141953504,28,3110692100,-31261404
1645019382,195794,true,3141953504,28,3110381061,-31572443
1645019411,195799,true,3140382998,28,3109759079,-30623919
1645019415,195801,true,3139755016,28,3109759079,-29995937
1645019422,195804,true,3138813278,28,3109759079,-29054199
1645019525,195804,true,3138813278,28,3107583118,-31230160
1645019589,195808,true,3137558066,28,3106029792,-31528274
1645019598,195811,true,3136616987,28,3106029792,-30587195
1645019612,195813,true,3135989758,28,3105719220,-30270538
1645019776,195814,true,3135676190,28,3101994778,-33681412
1645019839,195818,true,3134422233,28,3100444246,-33977987
1645020137,195820,true,3133795443,28,3093631107,-40164336
1645021358,195822,true,3133168778,28,3077586779,-55581999
1645021465,195823,true,3132855492,28,3077279051,-55576441
1645021593,195827,true,3131602663,28,3076356052,-55246611
1645022195,195830,true,3130663370,28,3073281387,-57381983
1645023059,195832,true,3130037332,28,3069288916,-60748416
1645023850,195832,true,3130037332,28,3066221315,-63816017
1645023864,195836,true,3128785630,28,3066221315,-62564315
1645024004,195839,true,3127847182,28,3065914723,-61932459
1645026333,195841,true,3127221706,28,3067447987,-59773719
1645028129,195841,true,3127221706,28,3067447987,-59773719
1645028300,195845,true,3125971130,28,3067141273,-58829857
1645028341,195847,true,3125346030,28,3067141273,-58204757
1645028346,195850,true,3124408613,28,3067141273,-57267340
1645028415,195851,true,3124096204,28,3066527937,-57568267
1645028877,195855,true,3122846877,28,3063463095,-59383782
1645028931,195858,true,3121910211,28,3063463095,-58447116
1645029094,195861,true,3120973825,28,3062544240,-58429585
1645029172,195862,true,3120661759,28,3062544240,-58117519
1645029367,195866,true,3119413806,28,3062238016,-57175790
1645030189,195869,true,3118478169,28,3061625660,-56852509
1645030262,195872,true,3117542813,28,3062238016,-55304797
1645031093,195872,true,3117542813,28,3071438063,-46104750
1645033990,195876,true,3116296107,28,3078817998,-37478109
1645036245,195878,true,3115672942,28,3078817998,-36854944
1645036317,195881,true,3114738427,28,3079125880,-35612547
1645036622,195882,true,3114426984,28,3079125880,-35301104
1645036648,195886,true,3113181524,28,3079125880,-34055644
1645037439,195887,true,3112870237,28,3083747803,-29122434
1645037843,195890,true,3111936563,28,3086215665,-25720898
1645038020,195890,true,3111936563,28,3087141622,-24794941
1645038041,195894,true,3110692100,28,3087450336,-23241764
1645038230,195895,true,3110381061,28,3089303270,-21077791
1645038412,195897,true,3109759079,28,3092084755,-17674324
1645038442,195896,true,3110070054,28,3092703203,-17366851
1645038494,195899,true,3109137220,28,3093631107,-15506113
1645038950,195898,true,3109448134,28,3102925470,-6522664
1645038961,195899,true,3109137220,28,3102925470,-6211750
1645039004,195898,true,3109448134,28,3103856441,-5591693
1645039051,195900,true,3108826337,28,3105098170,-3728167
1645039288,195897,true,3109759079,28,3111936563,2177484
1645039314,195896,true,3110070054,28,3112870237,2800183
1645039353,195895,true,3110381061,28,3114115572,3734511
1645039381,195896,true,3110070054,28,3115049900,4979846
1645039411,195893,true,3111003169,28,3116296107,5292938
1645039452,195893,true,3111003169,28,3117854567,6851398
1645039468,195892,true,3111314269,28,3118166352,6852083
1645039538,195893,true,3111003169,28,3120973825,9970656
1645039549,195890,true,3111936563,28,3121285922,9349359
1645039579,195890,true,3111936563,28,3122534624,10598061
1645039586,195890,true,3111936563,28,3122846877,10910314
1645039701,195890,true,3111936563,28,3127534428,15597865
1645039779,195887,true,3112870237,28,3130976437,18106200
1645039816,195886,true,3113181524,28,3132542238,19360714
1645039818,195887,true,3112870237,28,3132855492,19985255
1645040352,195886,true,3113181524,28,3153284353,40102829
1645040694,195883,true,3114115572,28,3162757936,48642364
1645040900,195883,true,3114115572,28,3167505395,53389823
1645041876,195884,true,3113804192,28,3169723314,55919122
1645044808,195884,true,3113804192,28,3170040287,56236095
1645044889,195880,true,3115049900,28,3170040287,54990387
1645044926,195880,true,3115049900,28,3170040287,54990387
1645045021,195882,true,3114426984,28,3169723314,55296330
1645045160,195882,true,3114426984,28,3169089465,54662481
1645047309,195879,true,3115361405,28,3158965092,43603687
1645047482,195879,true,3115361405,28,3158965092,43603687
1645047563,195881,true,3114738427,28,3158649227,43910800
1645047864,195881,true,3114738427,28,3157386084,42647657
1645048015,195879,true,3115361405,28,3156754701,41393296
1645048135,195879,true,3115361405,28,3155807864,40446459
1645048259,195880,true,3115049900,28,3154861311,39811411
1645048315,195880,true,3115049900,28,3154230433,39180533
1645049331,195878,true,3115672942,28,3142896184,27223242
1645050484,195879,true,3115361405,28,3138185609,22824204
1645050766,195880,true,3115049900,28,3138185609,23135709
1645050795,195880,true,3115049900,28,3138185609,23135709
1645051150,195878,true,3115672942,28,3139127159,23454217
1645053128,195877,true,3115984509,28,3142896184,26911675
1645054894,195878,true,3115672942,28,3148243384,32570442
1645055275,195878,true,3115672942,28,3148243384,32570442
1645055434,195875,true,3116607737,28,3148243384,31635647
1645055505,195874,true,3116919398,28,3148243384,31323986
1645055522,195876,true,3116296107,28,3148243384,31947277
1645055552,195876,true,3116296107,28,3147928592,31632485
1645055571,195874,true,3116919398,28,3147928592,31009194
1645055577,195873,true,3117231090,28,3147928592,30697502
1645055621,195875,true,3116607737,28,3147613830,31006093
1645055747,195876,true,3116296107,28,3146669735,30373628
1645055799,195874,true,3116919398,28,3146355099,29435701
1645056152,195873,true,3117231090,28,3142581926,25350836
1645056221,195875,true,3116607737,28,3141953504,25345767
1645057049,195876,true,3116296107,28,3133482095,17185988
1645057174,195874,true,3116919398,28,3132542238,15622840
1645057383,195873,true,3117231090,28,3131602663,14371573
1645057573,195874,true,3116919398,28,3131602663,14683265
1645058745,195874,true,3116919398,28,3135989758,19070360
1645059020,195872,true,3117542813,28,3136616987,19074174
1645059157,195871,true,3117854567,28,3136930649,19076082
1645059232,195871,true,3117854567,28,3136930649,19076082
1645059259,195871,true,3117854567,28,3136930649,19076082
1645059321,195868,true,3118790017,28,3136930649,18140632
1645059348,195866,true,3119413806,28,3136930649,17516843
1645059414,195866,true,3119413806,28,3137244342,17830536
1645059588,195864,true,3120037720,28,3137871822,17834102
1645059751,195861,true,3120973825,28,3138813278,17839453
1645060075,195859,true,3121598051,28,3140382998,18784947
1645060117,195859,true,3121598051,28,3140697037,19098986
1645060278,195857,true,3122222402,28,3141639340,19416938
1645060318,195854,true,3123159162,28,3141953504,18794342
1645061830,195852,true,3123783825,28,3151077937,27294112
1645061923,195851,true,3124096204,28,3151393045,27296841
1645062011,195849,true,3124721054,28,3151708184,26987130
1645062243,195845,true,3125971130,28,3151708184,25737054
1645062723,195843,true,3126596355,28,3150762861,24166506
1645064330,195842,true,3126909015,28,3148243384,21334369
1645064422,195841,true,3127221706,28,3148243384,21021678
1645064527,195837,true,3128472782,28,3147928592,19455810
1645064566,195834,true,3129411418,28,3147928592,18517174
1645064660,195834,true,3129411418,28,3147299100,17887682
1645065920,195833,true,3129724359,28,3134735676,5011317
1645066464,195830,true,3130663370,28,3130037332,-626038
1645067713,195827,true,3131602663,28,3130350335,-1252328
1645067758,195826,true,3131915824,28,3130350335,-1565489
1645068724,195826,true,3131915824,28,3128472782,-3443042
1645068740,195822,true,3133168778,28,3128472782,-4695996
1645068964,195820,true,3133795443,28,3127221706,-6573737
1645069143,195819,true,3134108822,28,3125971130,-8137692
1645069294,195819,true,3134108822,28,3124096204,-10012618
1645069341,195816,true,3135049149,28,3123783825,-11265324
1645070131,195814,true,3135676190,28,3114426984,-21249206
1645070147,195813,true,3135989758,28,3114115572,-21874186
1645070235,195814,true,3135676190,28,3112870237,-22805953
1645070274,195811,true,3136616987,28,3112247757,-24369230
1645070441,195810,true,3136930649,28,3109137220,-27793429
1645070475,195810,true,3136930649,28,3108515486,-28415163
1645070500,195812,true,3136303357,28,3108204665,-28098692
1645070520,195809,true,3137244342,28,3107583118,-29661224
1645070571,195809,true,3137244342,28,3106651029,-30593313
1645070629,195810,true,3136930649,28,3105408679,-31521970
1645070635,195811,true,3136616987,28,3105098170,-31518817
1645070666,195810,true,3136930649,28,3104477243,-32453406
1645070702,195810,true,3136930649,28,3103546086,-33384563
1645070767,195811,true,3136616987,28,3101994778,-34622209
1645070774,195813,true,3135989758,28,3101684610,-34305148
1645070776,195812,true,3136303357,28,3101684610,-34618747
1645071207,195814,true,3135676190,28,3090539177,-45137013
1645071306,195816,true,3135049149,28,3088376664,-46672485
1645071407,195818,true,3134422233,28,3086215665,-48206568
1645071484,195818,true,3134422233,28,3084364584,-50057649
1645072398,195820,true,3133795443,28,3068368314,-65427129
1645074116,195822,true,3133168778,28,3068368314,-64800464
1645075035,195824,true,3132542238,28,3066527937,-66014301
1645075055,195826,true,3131915824,28,3066527937,-65387887
1645075088,195829,true,3130976437,28,3066527937,-64448500
1645075173,195831,true,3130350335,28,3066527937,-63822398
1645077793,195833,true,3129724359,28,3067141273,-62583086
1645078859,195835,true,3129098508,28,3068061508,-61037000
1645079220,195838,true,3128159966,28,3068982018,-59177948
1645079268,195841,true,3127221706,28,3069288916,-57932790
1645079326,195843,true,3126596355,28,3069288916,-57307439
1645079333,195845,true,3125971130,28,3069288916,-56682214
1645079362,195848,true,3125033526,28,3069595845,-55437681
1645079847,195850,true,3124408613,28,3072666823,-51741790
1645079900,195853,true,3123471478,28,3073281387,-50190091
1645079977,195855,true,3122846877,28,3073896074,-48950803
1645080034,195858,true,3121910211,28,3074203464,-47706747
1645080041,195860,true,3121285922,28,3074510884,-46775038
1645080049,195863,true,3120349724,28,3074510884,-45838840
1645080075,195865,true,3119725747,28,3074818335,-44907412
1645080098,195868,true,3118790017,28,3075125817,-43664200
1645083013,195868,true,3118790017,28,3093940470,-24849547
1645083891,195872,true,3117542813,28,3092703203,-24839610
1645083922,195874,true,3116919398,28,3092703203,-24216195
1645084043,195876,true,3116296107,28,3092703203,-23592904
1645084098,195877,true,3115984509,28,3092703203,-23281306
1645084820,195879,true,3115361405,28,3096106878,-19254527
1645084927,195880,true,3115049900,28,3097035803,-18014097
1645085019,195883,true,3114115572,28,3097655241,-16460331
1645085092,195884,true,3113804192,28,3098274803,-15529389
1645085187,195885,true,3113492843,28,3099204379,-14288464
1645085249,195885,true,3113492843,28,3099824250,-13668593
1645085358,195887,true,3112870237,28,3101374473,-11495764
1645085448,195887,true,3112870237,28,3103235763,-9634474
1645086413,195887,true,3112870237,28,3118166352,5296115
1645086429,195887,true,3112870237,28,3118166352,5296115
1645086463,195889,true,3112247757,28,3118790017,6542260
1645086547,195889,true,3112247757,28,3119413806,7166049
1645086569,195890,true,3111936563,28,3119413806,7477243
1645086580,195890,true,3111936563,28,3119413806,7477243
1645086594,195892,true,3111314269,28,3119413806,8099537
1645086610,195894,true,3110692100,28,3119413806,8721706
1645086788,195897,true,3109759079,28,3116607737,6848658
1645086821,195898,true,3109448134,28,3115984509,6536375
1645086914,195901,true,3108515486,28,3113804192,5288706
1645087041,195903,true,3107893876,28,3109137220,1243344
1645087303,195908,true,3106340395,28,3098274803,-8065592
1645087343,195908,true,3106340395,28,3096726130,-9614265
1645087470,195911,true,3105408679,28,3092084755,-13323924
1645087650,195913,true,3104787691,28,3085598514,-19189177
1645087926,195917,true,3103546086,28,3075433329,-28112757
1645088249,195917,true,3103546086,28,3063769441,-39776645
1645088440,195920,true,3102615208,28,3058871574,-43743634
1645088457,195921,true,3102304978,28,3058871574,-43433404
1645089575,195925,true,3101064366,28,3062544240,-38520126
1645089604,195925,true,3101064366,28,3062544240,-38520126
1645089628,195928,true,3100134233,28,3062544240,-37589993
1645090148,195930,true,3099514299,28,3059177462,-40336837
1645090282,195935,true,3097965007,28,3058565718,-39399289
1645090914,195934,true,3098274803,28,3055508834,-42765969
1645091750,195937,true,3097345507,28,3054897824,-42447683
1645092207,195939,true,3096726130,28,3055814385,-40911745
1645092256,195944,true,3095178232,28,3055814385,-39363847
1645092275,195944,true,3095178232,28,3055814385,-39363847
1645092305,195947,true,3094249864,28,3056119966,-38129898
1645092370,195949,true,3093631107,28,3056119966,-37511141
1645092692,195953,true,3092393964,28,3057648332,-34745632
1645092778,195953,true,3092393964,28,3058259892,-34134072
1645092836,195956,true,3091466431,28,3058565718,-32900713
1645093252,195958,true,3090848230,28,3061013427,-29834803
1645094337,195962,true,3089612200,28,3067447987,-22164213
1645094828,195962,true,3089612200,28,3068061508,-21550692
1645094865,195966,true,3088376664,28,3068061508,-20315156
1645094957,195967,true,3088067857,28,3067754732,-20313125
1645095416,195972,true,3086524287,28,3066221315,-20302972
1645095493,195972,true,3086524287,28,3065914723,-20609564
1645095503,195976,true,3085289985,28,3065914723,-19375262
1645096407,195978,true,3084673020,28,3057954096,-26718924
1645096660,195983,true,3083131146,28,3055814385,-27316761
1645096765,195984,true,3082822864,28,3055203313,-27619551
1645096796,195987,true,3081898202,28,3054897824,-27000378
1645097009,195988,true,3081590043,28,3053981538,-27608505
1645098091,195992,true,3080357715,28,3053981538,-26376177
1645098570,195992,true,3080357715,28,3054592364,-25765351
1645098599,195995,true,3079433792,28,3054592364,-24841428
1645099095,195997,true,3078817998,28,3055814385,-23003613
1645099278,196001,true,3077586779,28,3056119966,-21466813
1645099288,196000,true,3077894537,28,3056119966,-21774571
1645099341,196003,true,3076971354,28,3056731221,-20240133
1645099372,196004,true,3076663687,28,3056731221,-19932466
1645099533,196006,true,3076048447,28,3058565718,-17482729
1645099595,196006,true,3076048447,28,3059177462,-16870985
1645099648,196007,true,3075740873,28,3059789328,-15951545
1645099672,196008,true,3075433329,28,3059789328,-15644001
1645099726,196010,true,3074818335,28,3060401316,-14417019
1645099759,196009,true,3075125817,28,3061013427,-14112390
1645099895,196010,true,3074818335,28,3062544240,-12274095
1645099953,196011,true,3074510884,28,3063156779,-11354105
1645100900,196012,true,3074203464,28,3074203464,0
1645102412,196011,true,3074510884,28,3076971354,2460470
1645102432,196011,true,3074510884,28,3076971354,2460470
1645103165,196012,true,3074203464,28,3073896074,-307390
1645103279,196013,true,3073896074,28,3072974090,-921984
1645103301,196013,true,3073896074,28,3072974090,-921984
1645103387,196012,true,3074203464,28,3072359587,-1843877
1645103971,196013,true,3073896074,28,3067141273,-6754801
1645103996,196014,true,3073588715,28,3066834590,-6754125
1645104013,196014,true,3073588715,28,3066834590,-6754125
1645104064,196013,true,3073896074,28,3065914723,-7981351
1645104083,196015,true,3073281387,28,3065608163,-7673224
1645104101,196016,true,3072974090,28,3065301632,-7672458
1645104191,196017,true,3072666823,28,3063463095,-9203728
1645105485,196018,true,3072359587,28,3034802889,-37556698
1645105615,196020,true,3071745207,28,3032072931,-39672276
1645105631,196021,true,3071438063,28,3031769754,-39668309
1645106006,196022,true,3071130950,28,3024502595,-46628355
1645106052,196023,true,3070823868,28,3024502595,-46321273
1645106240,196026,true,3069902805,28,3022386289,-47516516
1645106246,196027,true,3069595845,28,3022386289,-47209556
1645106264,196029,true,3068982018,28,3022084081,-46897937
1645106585,196031,true,3068368314,28,3017554579,-50813735
1645106737,196033,true,3067754732,28,3015744680,-52010052
1645106811,196035,true,3067141273,28,3015141622,-51999651
1645107249,196036,true,3066834590,28,3010923587,-55911003
1645107874,196039,true,3065914723,28,3007914319,-58000404
1645107911,196041,true,3065301632,28,3007914319,-57387313
1645107933,196043,true,3064688664,28,3007914319,-56774345
1645107946,196045,true,3064075818,28,3007914319,-56161499
1645108002,196047,true,3063463095,28,3007914319,-55548776
1645108053,196050,true,3062544240,28,3007914319,-54629921
1645108397,196053,true,3061625660,28,3007914319,-53711341
1645108508,196054,true,3061319528,28,3007613558,-53705970
1645108884,196057,true,3060401316,28,3006711454,-53689862
1645109285,196061,true,3059177462,28,3005809621,-53367841
1645109326,196063,true,3058565718,28,3005809621,-52756097
1645109342,196065,true,3057954096,28,3005809621,-52144475
1645109362,196067,true,3057342597,28,3005809621,-51532976
1645109383,196071,true,3056119966,28,3005509070,-50610896
1645109392,196074,true,3055203313,28,3005509070,-49694243
1645109490,196077,true,3054286936,28,3004607598,-49679338
1645109533,196080,true,3053370833,28,3004307167,-49063666
1645109632,196084,true,3052149790,28,3002805464,-49344326
1645109644,196088,true,3050929235,28,3002505214,-48424021
1645109847,196092,true,3049709168,28,2999204439,-50504729
1645110213,196096,true,3048489590,28,2993810996,-54678594
1645110382,196101,true,3046965802,28,2991716166,-55249636
1645110444,196105,true,3045747320,28,2991117913,-54629407
1645110483,196109,true,3044529326,28,2990818831,-53710495
1645111316,196112,true,3043616150,28,2982456669,-61159481
1645111548,196117,true,3042094798,28,2983053190,-59041608
1645112234,196121,true,3040878264,28,2984246590,-56631674
1645112238,196124,true,3039966183,28,2984246590,-55719593
1645112336,196128,true,3038750501,28,2983948195,-54802306
1645112359,196131,true,3037839058,28,2983948195,-53890863
1645113094,196132,true,3037535304,28,2983053190,-54482114
1645113694,196135,true,3036624226,28,2983053190,-53571036
1645113908,196138,true,3035713421,28,2983351495,-52361926
1645114239,196141,true,3034802889,28,2983351495,-51451394
1645114318,196140,true,3035106369,28,2983649830,-51456539
1645114327,196143,true,3034196019,28,2983649830,-50546189
1645114418,196146,true,3033285943,28,2983948195,-49337748
1645115679,196148,true,3032679376,28,2989323870,-43355506
1645115755,196148,true,3032679376,28,2989622802,-43056574
1645116954,196151,true,3031769754,28,2994409788,-37359966
1645117068,196154,true,3030860405,28,2994709229,-36151176
1645117548,196156,true,3030254324,28,2991716166,-38538158
1645117674,196157,true,3029951329,28,2990818831,-39132498
1645117700,196161,true,3028739652,28,2990519779,-38219873
1645117877,196164,true,3027831211,28,2987829656,-40001555
1645118205,196167,true,3026923044,28,2981860267,-45062777
1645118289,196167,true,3026923044,28,2980071777,-46851267
1645118377,196171,true,3025712577,28,2978880046,-46832531
1645118436,196175,true,3024502595,28,2977688792,-46813803
1645118903,196177,true,3023897785,28,2972928537,-50969248
1645118915,196177,true,3023897785,28,2972928537,-50969248
1645119677,196181,true,3022688528,28,2972334040,-50354488
1645119684,196184,true,3021781903,28,2972631274,-49150629
1645119745,196187,true,3020875549,28,2972928537,-47947012
1645119955,196187,true,3020875549,28,2973523152,-47352397
1645120039,196192,true,3019365565,28,2973820505,-45545060
1645120053,196195,true,3018459936,28,2973820505,-44639431
1645120061,196198,true,3017554579,28,2973820505,-43734074
1645120308,196200,true,3016951159,28,2971739663,-45211496
1645121448,196206,true,3015141622,28,2956327493,-58814129
1645121473,196209,true,3014237260,28,2955736317,-58500943
1645121644,196212,true,3013333170,28,2952782205,-60550965
1645121670,196214,true,3012730593,28,2952191737,-60538856
1645121784,196221,true,3010622525,28,2949831046,-60791479
1645121802,196224,true,3009719519,28,2949241169,-60478350
1645121811,196227,true,3008816784,28,2949241169,-59575615
1645122014,196230,true,3007914319,28,2944526391,-63387928
1645122394,196237,true,3005809621,28,2936000060,-69809561
1645122407,196241,true,3004607598,28,2935706490,-68901108
1645122414,196244,true,3003706396,28,2935706490,-67999906
1645122430,196247,true,3002805464,28,2935119436,-67686028
1645122433,196255,true,3000404300,28,2935119436,-65284864
1645122689,196260,true,2998904548,28,2926913007,-71991541
1645122696,196263,true,2998005057,28,2926913007,-71092050
1645123074,196266,true,2997105835,28,2915229322,-81876513
1645123177,196274,true,2994709229,28,2912024493,-82684736
1645123449,196279,true,2993212323,28,2905044362,-88167961
1645123462,196283,true,2992015338,28,2904753887,-87261451
1645123622,196287,true,2990818831,28,2902140915,-88677916
1645123636,196295,true,2988427252,28,2901850730,-86576522
1645123724,196300,true,2986933487,28,2901560574,-85372913
1645123924,196303,true,2986037586,28,2900690280,-85347306
1645124082,196307,true,2984843469,28,2900690280,-84153189
1645124384,196315,true,2982456669,28,2902431129,-80025540
1645124506,196320,true,2980965888,28,2903592276,-77373612
1645125280,196322,true,2980369784,28,2911733319,-68636465
1645125342,196326,true,2979177934,28,2912024493,-67153441
1645125796,196334,true,2976795664,28,2913772144,-63023520
1645125819,196339,true,2975307712,28,2913772144,-61535568
1645126661,196343,true,2974117887,28,2907950714,-66167173
1645127128,196346,true,2973225830,28,2904753887,-68471943
1645127321,196354,true,2970848319,28,2903592276,-67256043
1645127684,196359,true,2969363340,28,2902431129,-66932211
1645127711,196362,true,2968472710,28,2902721372,-65751338
1645128439,196365,true,2967582346,28,2905334867,-62247479
1645128481,196373,true,2965209348,28,2905334867,-59874481
1645128620,196377,true,2964023561,28,2905334867,-58688694
1645128902,196380,true,2963134531,28,2904463441,-58671090
1645129990,196383,true,2962245769,28,2899530294,-62715475
1645130029,196390,true,2960173026,28,2899240370,-60932656
1645130042,196393,true,2959285152,28,2899240370,-60044782
1645130320,196395,true,2958693383,28,2897211713,-61481670
1645130354,196399,true,2957510202,28,2896922021,-60588181
1645130365,196406,true,2955440772,28,2896922021,-58518751
1645130582,196408,true,2954849773,28,2897211713,-57638060
1645130648,196409,true,2954554318,28,2897501434,-57052884
1645130658,196413,true,2953372791,28,2897501434,-55871357
1645130809,196419,true,2951601388,28,2898080964,-53520424
1645131194,196420,true,2951306257,28,2900110229,-51196028
1645132177,196421,true,2951011156,28,2903882635,-47128521
1645132205,196425,true,2949831046,28,2903882635,-45948411
1645132309,196432,true,2947766990,28,2903592276,-44174714
1645132327,196433,true,2947472243,28,2903592276,-43879967
1645133024,196436,true,2946588178,28,2894316094,-52272084
1645133057,196441,true,2945115326,28,2894026692,-51088634
1645133061,196447,true,2943348875,28,2894026692,-49322183
1645133100,196448,true,2943054570,28,2893158657,-49895913
1645133213,196453,true,2941583484,28,2890845171,-50738313
1645133257,196457,true,2940407145,28,2889689122,-50718023
1645133486,196464,true,2938349683,28,2883915808,-54433875
1645133507,196465,true,2938055877,28,2883627445,-54428432
1645133527,196471,true,2936293660,28,2883339111,-52954549
1645133550,196475,true,2935119436,28,2882762530,-52356906
1645133588,196481,true,2933358981,28,2882186064,-51172917
1645133597,196482,true,2933065674,28,2881897874,-51167800
1645133629,196487,true,2931599581,28,2881609713,-49989868
1645133651,196491,true,2930427235,28,2881033478,-49393757
1645133774,196495,true,2929255357,28,2879593393,-49661964
1645133818,196496,true,2928962461,28,2879017561,-49944900
1645133888,196500,true,2927791168,28,2878441844,-49349324
1645134523,196503,true,2926913007,28,2878729688,-48183319
1645134856,196506,true,2926035108,28,2879881352,-46153756
1645134906,196506,true,2926035108,28,2880457357,-45577751
1645135267,196511,true,2924572530,28,2886223748,-38348782
1645136242,196514,true,2923695333,28,2891134256,-32561077
1645136366,196517,true,2922818400,28,2891423369,-31395031
1645136487,196518,true,2922526147,28,2891423369,-31102778
1645136590,196522,true,2921357429,28,2891712512,-29644917
1645136687,196525,true,2920481197,28,2891423369,-29057828
1645136693,196529,true,2919313297,28,2891423369,-27889928
1645137427,196530,true,2919021395,28,2888244711,-30776684
1645137474,196534,true,2917854078,28,2888244711,-29609367
1645137526,196537,true,2916978897,28,2887955916,-29022981
1645138174,196540,true,2916103978,28,2886801022,-29302956
1645138727,196541,true,2915812397,28,2887667149,-28145248
1645138780,196545,true,2914646363,28,2887955916,-26690447
1645141242,196548,true,2913772144,28,2891423369,-22348775
1645141777,196552,true,2912606927,28,2891134256,-21472671
1645142000,196553,true,2912315695,28,2891134256,-21181439
1645142205,196557,true,2911151060,28,2890556116,-20594944
1645142317,196561,true,2909986891,28,2890267089,-19719802
1645142596,196564,true,2909114069,28,2889689122,-19424947
1645142696,196565,true,2908823187,28,2889400182,-19423005
1645142712,196570,true,2907369212,28,2889400182,-17969030
1645143232,196573,true,2906497175,28,2887955916,-18541259
1645143279,196576,true,2905625400,28,2887667149,-17958251
1645143324,196577,true,2905334867,28,2887667149,-17667718
1645143340,196580,true,2904463441,28,2887378411,-17085030
1645143596,196584,true,2903301946,28,2885069547,-18232399
1645143966,196587,true,2902431129,28,2882186064,-20245065
1645144210,196588,true,2902140915,28,2880745403,-21395512
1645144219,196592,true,2900980349,28,2880457357,-20522992
1645144549,196596,true,2899820247,28,2878729688,-21090559
1645144564,196599,true,2898950475,28,2878729688,-20220787
1645144770,196599,true,2898950475,28,2878441844,-20508631
1645145367,196604,true,2897501434,28,2879305463,-18195971
1645145389,196607,true,2896632358,28,2879593393,-17038965
1645145866,196610,true,2895763542,28,2881321581,-14441961
1645146060,196610,true,2895763542,28,2882474283,-13289259
1645146769,196614,true,2894605526,28,2883915808,-10689718
1645147347,196616,true,2894026692,28,2884492620,-9534072
1645147498,196618,true,2893447973,28,2884492620,-8955353
1645147543,196618,true,2893447973,28,2884492620,-8955353
1645147566,196622,true,2892290883,28,2884492620,-7798263
1645147934,196625,true,2891423369,28,2883915808,-7507561
1645148035,196625,true,2891423369,28,2883627445,-7795924
1645148047,196625,true,2891423369,28,2883627445,-7795924
1645148088,196628,true,2890556116,28,2883627445,-6928671
1645148117,196629,true,2890267089,28,2883627445,-6639644
1645148156,196629,true,2890267089,28,2883627445,-6639644
1645148166,196628,true,2890556116,28,2883627445,-6928671
1645148198,196632,true,2889400182,28,2883627445,-5772737
1645148208,196633,true,2889111271,28,2883627445,-5483826
1645148268,196630,true,2889978091,28,2884204200,-5773891
1645148411,196628,true,2890556116,28,2885069547,-5486569
1645148420,196632,true,2889400182,28,2885069547,-4330635
1645148477,196632,true,2889400182,28,2885646590,-3753592
1645148518,196630,true,2889978091,28,2886223748,-3754343
1645148627,196627,true,2890845171,28,2887667149,-3178022
1645148677,196630,true,2889978091,28,2888244711,-1733380
1645148784,196631,true,2889689122,28,2889689122,0
1645150089,196628,true,2890556116,28,2909114069,18557953
1645150650,196626,true,2891134256,28,2910568917,19434661
1645152025,196629,true,2890267089,28,2910568917,20301828
1645154122,196631,true,2889689122,28,2907369212,17680090
1645154778,196628,true,2890556116,28,2907369212,16813096
1645155453,196626,true,2891134256,28,2907369212,16234956
1645157865,196630,true,2889978091,28,2907369212,17391121
1645157910,196632,true,2889400182,28,2907369212,17969030
1645157967,196629,true,2890267089,28,2907369212,17102123
1645159846,196627,true,2890845171,28,2903301946,12456775
1645159916,196631,true,2889689122,28,2903301946,13612824
1645159940,196632,true,2889400182,28,2903011645,13611463
1645160053,196629,true,2890267089,28,2902431129,12164040
1645160335,196629,true,2890267089,28,2900690280,10423191
1645160486,196632,true,2889400182,28,2899530294,10130112
1645161786,196634,true,2888822389,28,2889689122,866733
1645162713,196631,true,2889689122,28,2888822389,-866733
1645162736,196631,true,2889689122,28,2889111271,-577851
1645162758,196634,true,2888822389,28,2889111271,288882
1645163576,196635,true,2888533536,28,2891712512,3178976
1645164725,196632,true,2889400182,28,2894605526,5205344
1645164833,196631,true,2889689122,28,2894894986,5205864
1645166475,196634,true,2888822389,28,2899240370,10417981
1645166479,196634,true,2888822389,28,2899530294,10707905
1645168028,196631,true,2889689122,28,2905044362,15355240
1645168319,196630,true,2889978091,28,2905915963,15937872
1645168672,196633,true,2889111271,28,2905915963,16804692
1645168704,196633,true,2889111271,28,2906206555,17095284
1645168725,196630,true,2889978091,28,2906206555,16228464
1645168840,196630,true,2889978091,28,2906206555,16228464
1645168855,196633,true,2889111271,28,2906206555,17095284
1645169434,196633,true,2889111271,28,2907369212,18257941
1645169803,196629,true,2890267089,28,2907950714,17683625
1645169861,196629,true,2890267089,28,2907950714,17683625
1645170136,196630,true,2889978091,28,2908241509,18263418
1645170269,196630,true,2889978091,28,2908241509,18263418
1645171862,196626,true,2891134256,28,2907078504,15944248
1645172259,196626,true,2891134256,28,2907369212,16234956
1645172278,196625,true,2891423369,28,2907369212,15945843
1645173078,196624,true,2891712512,28,2909986891,18274379
1645173357,196620,true,2892869370,28,2910859974,17990604
1645173815,196620,true,2892869370,28,2912315695,19446325
1645173856,196618,true,2893447973,28,2912606927,19158954
1645173967,196618,true,2893447973,28,2913189477,19741504
1645174136,196615,true,2894316094,28,2914937828,20621734
1645174549,196613,true,2894894986,28,2918145863,23250877
1645174600,196612,true,2895184476,28,2918729522,23545046
1645175848,196611,true,2895473994,28,2931013349,35539355
1645178740,196608,true,2896342723,28,2932479149,36136426
1645178795,196606,true,2896922021,28,2932479149,35557128
1645179078,196605,true,2897211713,28,2932185931,34974218
1645179096,196605,true,2897211713,28,2932185931,34974218
1645179490,196603,true,2897791184,28,2930427235,32636051
1645179886,196602,true,2898080964,28,2928962461,30881497
1645180421,196601,true,2898370772,28,2924572530,26201758
1645181774,196602,true,2898080964,28,2917854078,19773114
1645181939,196600,true,2898660609,28,2917854078,19193469
1645182272,196599,true,2898950475,28,2917854078,18903603
1645182322,196598,true,2899240370,28,2917854078,18613708
1645182477,196598,true,2899240370,28,2917270595,18030225
1645182491,196596,true,2899820247,28,2916978897,17158650
1645182601,196596,true,2899820247,28,2916103978,16283731
1645182642,196595,true,2900110229,28,2915812397,15702168
1645182676,196596,true,2899820247,28,2915520845,15700598
1645182711,196594,true,2900400240,28,2915229322,14829082
1645182970,196594,true,2900400240,28,2912315695,11915455
1645183154,196594,true,2900400240,28,2910277889,9877649
1645184293,196595,true,2900110229,28,2898660609,-1449620
1645184350,196593,true,2900690280,28,2898660609,-2029671
1645184439,196594,true,2900400240,28,2898080964,-2319276
1645184461,196593,true,2900690280,28,2898080964,-2609316
1645185414,196595,true,2900110229,28,2893737318,-6372911
1645185449,196593,true,2900690280,28,2893447973,-7242307
1645185471,196593,true,2900690280,28,2893158657,-7531623
1645185659,196593,true,2900690280,28,2891712512,-8977768
1645185724,196595,true,2900110229,28,2891134256,-8975973
1645186156,196594,true,2900400240,28,2887378411,-13021829
1645186183,196594,true,2900400240,28,2887089702,-13310538
1645186247,196594,true,2900400240,28,2886801022,-13599218
1645186328,196594,true,2900400240,28,2886512371,-13887869
1645186408,196592,true,2900980349,28,2886512371,-14467978
1645186469,196592,true,2900980349,28,2886512371,-14467978
1645187095,196591,true,2901270447,28,2889400182,-11870265
1645189360,196592,true,2900980349,28,2897501434,-3478915
1645190834,196590,true,2901560574,28,2897501434,-4059140
1645191148,196590,true,2901560574,28,2897211713,-4348861
1645191195,196589,true,2901850730,28,2896922021,-4928709
1645191578,196590,true,2901560574,28,2894605526,-6955048
1645191634,196589,true,2901850730,28,2894316094,-7534636
1645191742,196589,true,2901850730,28,2893737318,-8113412
1645191763,196589,true,2901850730,28,2893737318,-8113412
1645192135,196590,true,2901560574,28,2892580112,-8980462
1645192490,196588,true,2902140915,28,2891423369,-10717546
1645192529,196588,true,2902140915,28,2891423369,-10717546
1645193253,196588,true,2902140915,28,2892580112,-9560803
1645193269,196588,true,2902140915,28,2892580112,-9560803
1645193870,196586,true,2902721372,28,2895763542,-6957830
1645193972,196586,true,2902721372,28,2895763542,-6957830
1645194005,196585,true,2903011645,28,2895763542,-7248103
1645194105,196586,true,2902721372,28,2895473994,-7247378
1645194474,196585,true,2903011645,28,2894026692,-8984953
1645194859,196586,true,2902721372,28,2891712512,-11008860
1645194900,196585,true,2903011645,28,2891423369,-11588276
1645194933,196586,true,2902721372,28,2891134256,-11587116
1645194990,196587,true,2902431129,28,2889978091,-12453038
1645195211,196591,true,2901270447,28,2884781069,-16489378
1645195231,196590,true,2901560574,28,2883915808,-17644766
1645195366,196593,true,2900690280,28,2878441844,-22248436
1645195400,196594,true,2900400240,28,2877003054,-23397186
1645195579,196601,true,2898370772,28,2868959115,-29411657
1645195627,196601,true,2898370772,28,2866664980,-31705792
1645195659,196604,true,2897501434,28,2864945583,-32555851
1645195985,196606,true,2896922021,28,2851512602,-45409419
1645196001,196613,true,2894894986,28,2850942385,-43952601
1645196038,196613,true,2894894986,28,2849517342,-45377644
1645196059,196616,true,2894026692,28,2848947524,-45079168
1645196075,196616,true,2894026692,28,2848662658,-45364034
1645196198,196622,true,2892290883,28,2845531008,-46759875
1645196293,196621,true,2892580112,28,2843255607,-49324505
1645196304,196624,true,2891712512,28,2843255607,-48456905
1645196419,196624,true,2891712512,28,2840697956,-51014556
1645196496,196629,true,2890267089,28,2839561961,-50705128
1645196772,196627,true,2890845171,28,2836440316,-54404855
1645197041,196630,true,2889978091,28,2836156700,-53821391
1645197548,196630,true,2889978091,28,2844961987,-45016104
1645197750,196634,true,2888822389,28,2848947524,-39874865
1645197822,196632,true,2889400182,28,2850087274,-39312908
1645197866,196635,true,2888533536,28,2850657320,-37876216
1645197868,196635,true,2888533536,28,2850657320,-37876216
1645197902,196639,true,2887378411,28,2850657320,-36721091
1645198092,196638,true,2887667149,28,2850657320,-37009829
1645198227,196641,true,2886801022,28,2850087274,-36713748
1645198235,196641,true,2886801022,28,2850087274,-36713748
1645198381,196646,true,2885358054,28,2847808230,-37549824
1645198407,196646,true,2885358054,28,2847238753,-38119301
1645198437,196650,true,2884204200,28,2846669391,-37534809
1645198541,196651,true,2883915808,28,2844393080,-39522728
1645199232,196657,true,2882186064,28,2830773388,-51412676
1645199329,196657,true,2882186064,28,2828792639,-53393425
1645199364,196661,true,2881033478,28,2827944171,-53089307
1645199381,196663,true,2880457357,28,2827661404,-52795953
1645199445,196669,true,2878729688,28,2825965401,-52764287
1645199725,196670,true,2878441844,28,2818345966,-60095878
1645200101,196675,true,2877003054,28,2810466029,-66537025
1645200223,196676,true,2876715383,28,2808218667,-68496716
1645200267,196683,true,2874702487,28,2807657108,-67045379
1645200327,196684,true,2874415046,28,2806814979,-67600067
1645200336,196689,true,2872978269,28,2806534326,-66443943
1645200383,196692,true,2872116548,28,2805411993,-66704555
1645200564,196699,true,2870106871,28,2801767509,-68339362
1645200678,196701,true,2869532935,28,2798967282,-70565653
1645200835,196706,true,2868098599,28,2795890264,-72208335
1645200852,196708,true,2867525065,28,2795610703,-71914362
1645200858,196716,true,2865232077,28,2795610703,-69621374
1645200877,196717,true,2864945583,28,2795051665,-69893918
1645200908,196722,true,2863513540,28,2794772187,-68741353
1645201015,196724,true,2862940923,28,2793654558,-69286365
1645201226,196732,true,2860651600,28,2792537375,-68114225
1645201368,196733,true,2860365564,28,2793095911,-67269653
1645201401,196738,true,2858935810,28,2793375220,-65560590
1645201559,196739,true,2858649945,28,2794772187,-63877758
1645201798,196747,true,2856364054,28,2796729115,-59634939
1645201835,196747,true,2856364054,28,2797008788,-59355266
1645202514,196752,true,2854936300,28,2807937874,-46998426
1645202673,196753,true,2854650835,28,2810747075,-43903760
1645203006,196761,true,2852368142,28,2813559088,-38809054
1645203107,196761,true,2852368142,28,2814121828,-38246314
1645203138,196766,true,2850942385,28,2814121828,-36820557
1645203437,196767,true,2850657320,28,2813277760,-37379560
1645203478,196774,true,2848662658,28,2812996460,-35666198
1645203493,196774,true,2848662658,28,2812996460,-35666198
1645203522,196779,true,2847238753,28,2812715189,-34523564
1645203760,196781,true,2846669391,28,2810185010,-36484381
1645203811,196788,true,2844677519,28,2809904020,-34773499
1645203925,196788,true,2844677519,28,2808499489,-36178030
1645203941,196792,true,2843539933,28,2808499489,-35040444
1645204536,196794,true,2842971310,28,2805131479,-37839831
1645204642,196800,true,2841266124,28,2804290108,-36976016
1645205234,196800,true,2841266124,28,2801207239,-40058885
1645205387,196805,true,2839845917,28,2800927147,-38918770
1645205421,196806,true,2839561961,28,2800927147,-38634814
1645205896,196813,true,2837575062,28,2798127759,-39447303
1645206117,196814,true,2837291333,28,2795890264,-41401069
1645207362,196818,true,2836156700,28,2785008070,-51148630
1645207568,196819,true,2835873113,28,2784172735,-51700378
1645207650,196826,true,2833888796,28,2783337650,-50551146
1645207821,196827,true,2833605435,28,2781390093,-52215342
1645208609,196833,true,2831905867,28,2770841393,-61064474
1645208645,196835,true,2831339571,28,2770287308,-61052263
1645208647,196842,true,2829358425,28,2770287308,-59071117
1645208659,196843,true,2829075518,28,2770287308,-58788210
1645209317,196847,true,2827944171,28,2765305525,-62638646
1645209396,196849,true,2827378667,28,2765029022,-62349645
1645209403,196857,true,2825117781,28,2765029022,-60088759
1645209476,196859,true,2824552842,28,2765305525,-59247317
1645209550,196863,true,2823423304,28,2765582055,-57841249
1645209575,196865,true,2822858704,28,2765858614,-57000090
1645209594,196872,true,2820883493,28,2766135199,-54748294
1645210087,196874,true,2820319401,28,2771395589,-48923812
1645210104,196877,true,2819473474,28,2771672729,-47800745
1645210192,196879,true,2818909664,28,2772781564,-46128100
1645210250,196886,true,2816937216,28,2773336148,-43601068
1645210272,196887,true,2816655551,28,2773613482,-43042069
1645210373,196891,true,2815529170,28,2775278066,-40251104
1645210887,196892,true,2815247645,28,2781111982,-34135663
1645210906,196899,true,2813277760,28,2781390093,-31887667
1645211712,196900,true,2812996460,28,2788909617,-24086843
1645211720,196904,true,2811871543,28,2789188508,-22683035
1645212146,196905,true,2811590384,28,2791141526,-20448858
1645212271,196912,true,2809623058,28,2791141526,-18481532
1645212651,196913,true,2809342123,28,2792537375,-16804748
1645212752,196917,true,2808218667,28,2792816629,-15402038
1645212801,196916,true,2808499489,28,2793095911,-15403578
1645213228,196922,true,2806814979,28,2795890264,-10924715
1645213267,196923,true,2806534326,28,2796169853,-10364473
1645213760,196927,true,2805411993,28,2798687413,-6724580
1645213916,196926,true,2805692534,28,2798967282,-6725252
1645213994,196930,true,2804570537,28,2799247178,-5323359
1645214402,196931,true,2804290108,28,2799247178,-5042930
1645214523,196934,true,2803448990,28,2799247178,-4201812
1645215291,196932,true,2804009707,28,2797568218,-6441489
1645215359,196933,true,2803729334,28,2797568218,-6161116
1645215408,196934,true,2803448990,28,2797288489,-6160501
1645215484,196936,true,2802888384,28,2797288489,-5599895
1645215507,196935,true,2803168673,28,2797008788,-6159885
1645215587,196936,true,2802888384,28,2796729115,-6159269
1645216198,196937,true,2802608123,28,2794492738,-8115385
1645216239,196939,true,2802047685,28,2794492738,-7554947
1645216569,196940,true,2801767509,28,2791978952,-9788557
1645216635,196942,true,2801207239,28,2791420640,-9786599
1645216707,196944,true,2800647082,28,2790583381,-10063701
1645216923,196947,true,2799807056,28,2788351919,-11455137
1645218051,196947,true,2799807056,28,2785565100,-14241956
1645218067,196950,true,2798967282,28,2785565100,-13402182
1645218113,196953,true,2798127759,28,2785843656,-12284103
1645218199,196955,true,2797568218,28,2786400853,-11167365
1645218542,196954,true,2797847974,28,2789188508,-8659466
1645218560,196957,true,2797008788,28,2789467427,-7541361
1645219008,196960,true,2796169853,28,2791141526,-5028327
1645219723,196962,true,2795610703,28,2793095911,-2514792
1645219739,196961,true,2795890264,28,2793095911,-2794353
1645219833,196964,true,2795051665,28,2793654558,-1397107
1645220171,196966,true,2794492738,28,2793654558,-838180
1645220526,196968,true,2793933923,28,2793654558,-279365
1645221112,196967,true,2794213317,28,2794772187,558870
1645221185,196970,true,2793375220,28,2795051665,1676445
1645221599,196971,true,2793095911,28,2794772187,1676276
1645221616,196973,true,2792537375,28,2794772187,2234812
1645221640,196971,true,2793095911,28,2794772187,1676276
1645221683,196973,true,2792537375,28,2794492738,1955363
1645221927,196975,true,2791978952,28,2793095911,1116959
1645221956,196976,true,2791699782,28,2792816629,1116847
1645222107,196975,true,2791978952,28,2791699782,-279170
1645222497,196977,true,2791420640,28,2787236857,-4183783
1645222609,196978,true,2791141526,28,2785843656,-5297870
1645222626,196980,true,2790583381,28,2785565100,-5018281
1645222981,196979,true,2790862439,28,2779443898,-11418541
1645223026,196981,true,2790304351,28,2778610232,-11694119
1645223054,196983,true,2789746373,28,2778332399,-11413974
1645223241,196983,true,2789746373,28,2775833149,-13913224
1645223257,196981,true,2790304351,28,2775555594,-14748757
1645223902,196982,true,2790025348,28,2770010307,-20015041
1645224894,196983,true,2789746373,28,2770564337,-19182036
1645225753,196984,true,2789467427,28,2771118477,-18348950
1645225962,196982,true,2790025348,28,2771672729,-18352619
1645226115,196983,true,2789746373,28,2771949896,-17796477
1645226538,196984,true,2789467427,28,2773058842,-16408585
1645226586,196985,true,2789188508,28,2773336148,-15852360
1645228128,196984,true,2789467427,28,2780277815,-9189612
1645228158,196985,true,2789188508,28,2780277815,-8910693
1645228188,196987,true,2788630754,28,2780555843,-8074911
1645228676,196988,true,2788351919,28,2781946399,-6405520
1645229123,196987,true,2788630754,28,2783059344,-5571410
1645229263,196989,true,2788073111,28,2783059344,-5013767
1645229320,196991,true,2787515580,28,2783337650,-4177930
1645229961,196992,true,2787236857,28,2782502816,-4734041
1645230466,196991,true,2787515580,28,2782224593,-5290987
1645230513,196993,true,2786958161,28,2782224593,-4733568
1645230922,196995,true,2786400853,28,2783615984,-2784869
1645230967,196996,true,2786122241,28,2783615984,-2506257
1645231039,196994,true,2786679493,28,2784172735,-2506758
1645232274,196995,true,2786400853,28,2795331170,8930317
1645232363,196997,true,2785843656,28,2795890264,10046608
1645232706,196997,true,2785843656,28,2798687413,12843757
1645232866,196994,true,2786679493,28,2799527103,12847610
1645233125,196994,true,2786679493,28,2802047685,15368192
1645233230,196995,true,2786400853,28,2803168673,16767820
1645239207,196994,true,2786679493,28,2822012015,35332522
1645240621,196991,true,2787515580,28,2822012015,34496435
1645240967,196991,true,2787515580,28,2822012015,34496435
1645241556,196992,true,2787236857,28,2820883493,33646636
1645241662,196991,true,2787515580,28,2820601433,33085853
1645241897,196989,true,2788073111,28,2819473474,31400363
1645241996,196989,true,2788073111,28,2819191555,31118444
1645242063,196989,true,2788073111,28,2818627801,30554690
1645243208,196988,true,2788351919,28,2811871543,23519624
1645243343,196986,true,2788909617,28,2811028150,22118533
1645244019,196985,true,2789188508,28,2809061217,19872709
1645244413,196986,true,2788909617,28,2808218667,19309050
1645244667,196983,true,2789746373,28,2807376370,17629997
1645245248,196980,true,2790583381,28,2806814979,16231598
1645245258,196980,true,2790583381,28,2806814979,16231598
1645245995,196979,true,2790862439,28,2808780339,17917900
1645246190,196977,true,2791420640,28,2809623058,18202418
1645247416,196975,true,2791978952,28,2812152730,20173778
1645248216,196974,true,2792258150,28,2812152730,19894580
1645248820,196974,true,2792258150,28,2812152730,19894580
1645249746,196972,true,2792816629,28,2812433945,19617316
1645250585,196970,true,2793375220,28,2812433945,19058725
1645250754,196969,true,2793654558,28,2812433945,18779387
1645251278,196970,true,2793375220,28,2812433945,19058725
1645251479,196968,true,2793933923,28,2812433945,18500022
1645252084,196966,true,2794492738,28,2812433945,17941207
1645252104,196965,true,2794772187,28,2812433945,17661758
1645252517,196966,true,2794492738,28,2812433945,17941207
1645252964,196965,true,2794772187,28,2812433945,17661758
1645253014,196963,true,2795331170,28,2812715189,17384019
1645253620,196962,true,2795610703,28,2812715189,17104486
1645253632,196963,true,2795331170,28,2812715189,17384019
1645253748,196962,true,2795610703,28,2812996460,17385757
1645259667,196959,true,2796449470,28,2818909664,22460194
1645260475,196959,true,2796449470,28,2817500632,21051162
1645260507,196960,true,2796169853,28,2817218910,21049057
1645260559,196959,true,2796449470,28,2816937216,20487746
1645260709,196957,true,2797008788,28,2815529170,18520382
1645260728,196958,true,2796729115,28,2815529170,18800055
1645260736,196960,true,2796169853,28,2815247645,19077792
1645260806,196959,true,2796449470,28,2814403240,17953770
1645261174,196958,true,2796729115,28,2808780339,12051224
1645261213,196959,true,2796449470,28,2808218667,11769197
1645261225,196960,true,2796169853,28,2807937874,11768021
1645261354,196959,true,2796449470,28,2805973103,9523633
1645261951,196959,true,2796449470,28,2796729115,279645
1645262120,196960,true,2796169853,28,2793933923,-2235930
1645262965,196962,true,2795610703,28,2787236857,-8373846
1645263478,196961,true,2795890264,28,2786400853,-9489411
1645264665,196960,true,2796169853,28,2785843656,-10326197
1645266117,196961,true,2795890264,28,2785843656,-10046608
1645266231,196962,true,2795610703,28,2785843656,-9767047
1645266258,196961,true,2795890264,28,2785843656,-10046608
1645266265,196961,true,2795890264,28,2785565100,-10325164
1645266366,196962,true,2795610703,28,2785286571,-10324132
1645266477,196963,true,2795331170,28,2784729597,-10601573
1645266624,196962,true,2795610703,28,2783894345,-11716358
1645267037,196962,true,2795610703,28,2780833898,-14776805
1645267469,196964,true,2795051665,28,2777499066,-17552599
1645268475,196965,true,2794772187,28,2772504314,-22267873
1645268520,196964,true,2795051665,28,2772781564,-22270101
1645269976,196965,true,2794772187,28,2775278066,-19494121
1645269990,196967,true,2794213317,28,2775278066,-18935251
1645270024,196967,true,2794213317,28,2775278066,-18935251
1645270270,196966,true,2794492738,28,2774723093,-19769645
1645270343,196968,true,2793933923,28,2774168232,-19765691
1645270365,196970,true,2793375220,28,2773890843,-19484377
1645270424,196971,true,2793095911,28,2773058842,-20037069
1645270481,196972,true,2792816629,28,2771949896,-20866733
1645270502,196975,true,2791978952,28,2771395589,-20583363
1645270526,196977,true,2791420640,28,2770564337,-20856303
1645270552,196979,true,2790862439,28,2769733334,-21129105
1645270584,196981,true,2790304351,28,2768902580,-21401771
1645270818,196984,true,2789467427,28,2762265513,-27201914
1645270900,196986,true,2788909617,28,2759780717,-29128900
1645271328,196988,true,2788351919,28,2745742365,-42609554
1645272193,196990,true,2787794332,28,2720326598,-67467734
1645272413,196992,true,2787236857,28,2718966843,-68270014
1645272540,196994,true,2786679493,28,2717879528,-68799965
1645272558,196996,true,2786122241,28,2717879528,-68242713
1645272659,196998,true,2785565100,28,2717064327,-68500773
1645272700,197000,true,2785008070,28,2717064327,-67943743
1645273028,197000,true,2785008070,28,2718423131,-66584939
1645273805,197001,true,2784729597,28,2721687034,-63042563
1645274321,197003,true,2784172735,28,2723320454,-60852281
1645275121,197006,true,2783337650,28,2721959202,-61378448
1645275464,197006,true,2783337650,28,2720598631,-62739019
1645275686,197007,true,2783059344,28,2719782615,-63276729
1645275742,197010,true,2782224593,28,2719510664,-62713929
1645275855,197013,true,2781390093,28,2718966843,-62423250
1645275856,197014,true,2781111982,28,2718966843,-62145139
1645275965,197015,true,2780833898,28,2718151316,-62682582
1645276312,197019,true,2779721843,28,2715163143,-64558700
1645276323,197022,true,2778888093,28,2715163143,-63724950
1645276404,197023,true,2778610232,28,2715163143,-63447089
1645276412,197025,true,2778054593,28,2715163143,-62891450
1645276449,197027,true,2777499066,28,2714891654,-62607412
1645276475,197031,true,2776388344,28,2714891654,-61496690
1645276537,197031,true,2776388344,28,2715163143,-61225201
1645276783,197033,true,2775833149,28,2715706203,-60126946
1645277403,197035,true,2775278066,28,2717336034,-57942032
1645277691,197039,true,2774168232,28,2718694974,-55473258
1645277717,197039,true,2774168232,28,2718694974,-55473258
1645277726,197041,true,2773613482,28,2718966843,-54646639
1645278403,197043,true,2773058842,28,2726590237,-46468605
1645278601,197046,true,2772227091,28,2727953805,-44273286
1645278670,197047,true,2771949896,28,2728499423,-43450473
1645278753,197049,true,2771395589,28,2729045150,-42350439
1645278866,197051,true,2770841393,28,2729863945,-40977448
1645278912,197054,true,2770010307,28,2730409945,-39600362
1645279113,197056,true,2769456388,28,2732048601,-37407787
1645280327,197058,true,2768902580,28,2737791644,-31110936
1645280572,197061,true,2768072075,28,2738065423,-30006652
1645281135,197065,true,2766965123,28,2737791644,-29173479
1645281241,197067,true,2766411813,28,2737517892,-28893921
1645281350,197069,true,2765858614,28,2737244168,-28614446
1645283182,197073,true,2764752547,28,2732048601,-32703946
1645283872,197076,true,2763923287,28,2731229150,-32694137
1645284134,197078,true,2763370585,28,2731502273,-31868312
1645284206,197080,true,2762817994,28,2731502273,-31315721
1645284470,197083,true,2761989314,28,2732595038,-29394276
1645284759,197085,true,2761436999,28,2733961609,-27475390
1645285388,197087,true,2760884795,28,2736970471,-23914324
1645285447,197089,true,2760332700,28,2737244168,-23088532
1645286721,197091,true,2759780717,28,2743821114,-15959603
1645286778,197094,true,2758952948,28,2744095496,-14857452
1645286888,197094,true,2758952948,28,2744644343,-14308605
1645286929,197097,true,2758125428,28,2744918807,-13206621
1645286985,197099,true,2757573885,28,2745467818,-12106067
1645286992,197101,true,2757022453,28,2745467818,-11554635
1645287030,197102,true,2756746778,28,2745742365,-11004413
1645287193,197104,true,2756195512,28,2747664961,-8530551
1645287273,197105,true,2755919920,28,2748764192,-7155728
1645287305,197108,true,2755093309,28,2749039069,-6054240
1645287318,197108,true,2755093309,28,2749313973,-5779336
1645287393,197109,true,2754817827,28,2750413863,-4403964
1645287474,197110,true,2754542373,28,2752064524,-2477849
1645287633,197112,true,2753991547,28,2755644355,1652808
1645288701,197112,true,2753991547,28,2779999815,26008268
1645288723,197113,true,2753716176,28,2780277815,26561639
1645288932,197113,true,2753716176,28,2783615984,29899808
1645288998,197115,true,2753165515,28,2784451152,31285637
1645289102,197115,true,2753165515,28,2785565100,32399585
1645289166,197116,true,2752890226,28,2785565100,32674874
1645289247,197117,true,2752614965,28,2785286571,32671606
1645289547,197121,true,2751514194,28,2782781066,31266872
1645289764,197121,true,2751514194,28,2780277815,28763621
1645289772,197123,true,2750963973,28,2780277815,29313842
1645289797,197124,true,2750688905,28,2779999815,29310910
1645289911,197127,true,2749863863,28,2778054593,28190730
1645289924,197127,true,2749863863,28,2778054593,28190730
1645290029,197129,true,2749313973,28,2776110733,26796760
1645291022,197130,true,2749039069,28,2757849643,8810574
1645292341,197132,true,2748489343,28,2751789345,3300002
1645292634,197132,true,2748489343,28,2752339731,3850388
1645292751,197134,true,2747939728,28,2752339731,4400003
1645293112,197135,true,2747664961,28,2752890226,5225265
1645294183,197137,true,2747115511,28,2756195512,9080001
1645294722,197136,true,2747390222,28,2757022453,9632231
1645296546,197138,true,2746840827,28,2757022453,10181626
1645297351,197139,true,2746566170,28,2757022453,10456283
1645297412,197140,true,2746291541,28,2757022453,10730912
1645297551,197140,true,2746291541,28,2757022453,10730912
1645297607,197141,true,2746016939,28,2757022453,11005514
1645299403,197143,true,2745467818,28,2750413863,4946045
1645302889,197145,true,2744918807,28,2750138849,5220042
1645305362,197144,true,2745193299,28,2754266946,9073647
1645305397,197145,true,2744918807,28,2754266946,9348139
1645305503,197146,true,2744644343,28,2754266946,9622603
1645307901,197148,true,2744095496,28,2746016939,1921443
1645309208,197148,true,2744095496,28,2746016939,1921443
1645309337,197148,true,2744095496,28,2745467818,1372322
1645310680,197150,true,2743546759,28,2738886925,-4659834
1645311586,197152,true,2742998132,28,2738613064,-4385068
1645311962,197152,true,2742998132,28,2739434730,-3563402
1645312600,197153,true,2742723860,28,2740530668,-2193192
1645312779,197155,true,2742175397,28,2740530668,-1644729
1645312927,197156,true,2741901207,28,2740804721,-1096486
1645313582,197155,true,2742175397,28,2742175397,0
1645313596,197156,true,2741901207,28,2742175397,274190
1645314374,197155,true,2742175397,28,2746840827,4665430
1645314400,197155,true,2742175397,28,2747115511,4940114
1645314760,197154,true,2742449615,28,2750138849,7689234
1645316438,197152,true,2742998132,28,2759228843,16230711
1645316737,197150,true,2743546759,28,2759228843,15682084
1645316800,197151,true,2743272432,28,2758952948,15680516
1645316936,197149,true,2743821114,28,2758677080,14855966
1645316988,197148,true,2744095496,28,2758401240,14305744
1645317268,197146,true,2744644343,28,2757298155,12653812
1645317314,197146,true,2744644343,28,2756746778,12102435
1645317384,197145,true,2744918807,28,2756471131,11552324
1645317592,197144,true,2745193299,28,2754542373,9349074
1645317653,197142,true,2745742365,28,2753991547,8249182
1645318666,197143,true,2745467818,28,2744095496,-1372322
1645318717,197142,true,2745742365,28,2743821114,-1921251
1645318768,197141,true,2746016939,28,2743272432,-2744507
1645319316,197140,true,2746291541,28,2739708673,-6582868
1645319333,197141,true,2746016939,28,2739708673,-6308266
1645319395,197140,true,2746291541,28,2739160814,-7130727
1645319445,197139,true,2746566170,28,2738613064,-7953106
1645320387,197140,true,2746291541,28,2727135582,-19155959
1645320882,197140,true,2746291541,28,2721687034,-24604507
1645320924,197140,true,2746291541,28,2721142778,-25148763
1645320941,197139,true,2746566170,28,2720870691,-25695479
1645321352,197139,true,2746566170,28,2718694974,-27871196
1645321388,197139,true,2746566170,28,2718966843,-27599327
1645321449,197138,true,2746840827,28,2718966843,-27873984
1645321568,197137,true,2747115511,28,2720054593,-27060918
1645324520,197136,true,2747390222,28,2737244168,-10146054
1645324739,197136,true,2747390222,28,2737244168,-10146054
1645324776,197136,true,2747390222,28,2737244168,-10146054
1645324823,197135,true,2747664961,28,2737244168,-10420793
1645325719,197134,true,2747939728,28,2734508428,-13431300
1645325769,197135,true,2747664961,28,2733961609,-13703352
1645325856,197135,true,2747664961,28,2733688240,-13976721
1645325943,197134,true,2747939728,28,2732868297,-15071431
1645326682,197136,true,2747390222,28,2724954855,-22435367
1645327531,197137,true,2747115511,28,2718151316,-28964195
1645327646,197137,true,2747115511,28,2717336034,-29779477
1645327665,197136,true,2747390222,28,2717336034,-30054188
1645329480,197139,true,2746566170,28,2708925755,-37640415
1645331520,197141,true,2746016939,28,2708925755,-37091184
1645331568,197141,true,2746016939,28,2708925755,-37091184
1645331577,197140,true,2746291541,28,2708925755,-37365786
1645331638,197143,true,2745467818,28,2708654890,-36812928
1645331765,197146,true,2744644343,28,2707571699,-37072644
1645331817,197146,true,2744644343,28,2707300968,-37343375
1645331881,197145,true,2744918807,28,2706759589,-38159218
1645334710,197148,true,2744095496,28,2692183208,-51912288
1645334734,197151,true,2743272432,28,2692183208,-51089224
1645334883,197151,true,2743272432,28,2692183208,-51089224
1645335034,197151,true,2743272432,28,2691914017,-51358415
1645335318,197154,true,2742449615,28,2690837520,-51612095
1645335506,197157,true,2741627045,28,2689761454,-51865591
1645336112,197158,true,2741352909,28,2686804491,-54548418
1645336257,197158,true,2741352909,28,2685730038,-55622871
1645336290,197162,true,2740256642,28,2685192973,-55063669
1645336320,197166,true,2739160814,28,2684924480,-54236334
1645336331,197168,true,2738613064,28,2684924480,-53688584
1645336353,197167,true,2738886925,28,2684656015,-54230910
1645336456,197172,true,2737517892,28,2683582421,-53935471
1645336467,197176,true,2736423159,28,2683314089,-53109070
1645336504,197178,true,2735875956,28,2682777507,-53098449
1645336548,197179,true,2735602396,28,2682241032,-53361364
1645336625,197185,true,2733961609,28,2681436520,-52525089
1645336741,197189,true,2732868297,28,2679828221,-53040076
1645337351,197191,true,2732321806,28,2673672007,-58649799
1645337364,197192,true,2732048601,28,2673672007,-58376594
1645337411,197199,true,2730136932,28,2673137352,-56999580
1645337443,197204,true,2728772273,28,2672602805,-56169468
1645337469,197207,true,2727953805,28,2672335572,-55618233
1645337483,197209,true,2727408296,28,2672068365,-55339931
1645337524,197216,true,2725499873,28,2671534031,-53965842
1645337531,197221,true,2724137532,28,2671266905,-52870627
1645337553,197225,true,2723048149,28,2670732731,-52315418
1645337586,197226,true,2722775872,28,2670198665,-52577207
1645338835,197234,true,2720598631,28,2646805169,-73793462
1645338891,197239,true,2719238740,28,2646011286,-73227454
1645338967,197242,true,2718423131,28,2644953146,-73469985
1645339096,197244,true,2717879528,28,2642838135,-75041393
1645339151,197252,true,2715706203,28,2641781264,-73924939
1645340215,197256,true,2714620192,28,2636766896,-77853296
1645340652,197258,true,2714077349,28,2635448908,-78628441
1645340668,197260,true,2713534615,28,2635448908,-78085707
1645340727,197267,true,2711635900,28,2635448908,-76186992
1645340765,197271,true,2710551517,28,2635448908,-75102609
1645341017,197273,true,2710009488,28,2636503245,-73506243
1645341131,197274,true,2709738514,28,2636766896,-72971618
1645341285,197282,true,2707571699,28,2637294275,-70277424
1645341980,197286,true,2706488941,28,2639932757,-66556184
1645342013,197288,true,2705947724,28,2639932757,-66014967
1645342314,197290,true,2705406616,28,2641517112,-63889504
1645342499,197297,true,2703513588,28,2642573878,-60939710
1645342857,197301,true,2702432453,28,2643631066,-58801387
1645343130,197303,true,2701892048,28,2644688677,-57203371
1645343203,197304,true,2701621886,28,2644953146,-56668740
1645343422,197311,true,2699731506,28,2645482163,-54249343
1645343472,197314,true,2698921749,28,2645482163,-53439586
1645343825,197317,true,2698112234,28,2647069849,-51042385
1645345293,197318,true,2697842450,28,2648658488,-49183962
1645345363,197324,true,2696224311,28,2648658488,-47565823
1645345389,197328,true,2695146091,28,2648658488,-46487603
1645345425,197329,true,2694876603,28,2648658488,-46218115
1645345550,197331,true,2694337709,28,2648128836,-46208873
1645345644,197338,true,2692452426,28,2647334556,-45117870
1645345883,197342,true,2691375715,28,2645482163,-45893552
1645346280,197343,true,2691106604,28,2641517112,-49589492
1645346322,197345,true,2690568463,28,2640988888,-49579575
1645346422,197353,true,2688416977,28,2639668790,-48748187
1645346465,197357,true,2687341879,28,2638877048,-48464831
1645346475,197359,true,2686804491,28,2638877048,-47927443
1645346560,197362,true,2685998611,28,2637558005,-48440606
1645346754,197370,true,2683850779,28,2634394992,-49455787
1645346772,197374,true,2682777507,28,2633868192,-48909315
1645346818,197377,true,2681972834,28,2633078189,-48894645
1645347905,197381,true,2680900313,28,2616542765,-64357548
1645347967,197389,true,2678756558,28,2615757959,-62998599
1645347988,197393,true,2677685323,28,2615496409,-62188914
1645348017,197397,true,2676614517,28,2615234886,-61379631
1645348098,197400,true,2675811693,28,2614711917,-61099776
1645348125,197408,true,2673672007,28,2614450472,-59221535
1645348200,197411,true,2672870065,28,2614189053,-58681012
1645348231,197414,true,2672068365,28,2614189053,-57879312
1645348266,197417,true,2671266905,28,2614189053,-57077852
1645348290,197424,true,2669397765,28,2614450472,-54947293
1645348754,197427,true,2668597106,28,2616281136,-52315970
1645348778,197430,true,2667796687,28,2616281136,-51515551
1645348793,197432,true,2667263208,28,2616542765,-50720443
1645348809,197439,true,2665396870,28,2616542765,-48854105
1645348885,197443,true,2664330978,28,2616804419,-47526559
1645348964,197445,true,2663798192,28,2617066099,-46732093
1645349258,197448,true,2662999212,28,2618374894,-44624318
1645349599,197453,true,2661668112,28,2619422401,-42245711
1645349645,197456,true,2660869771,28,2619684343,-41185428
1645350032,197458,true,2660337677,28,2621518673,-38819004
1645351073,197461,true,2659539735,28,2623091977,-36447758
1645351400,197466,true,2658210364,28,2624403785,-33806579
1645351691,197469,true,2657413061,28,2624666226,-32746835
1645351785,197471,true,2656881658,28,2624666226,-32215432
1645352107,197474,true,2656084753,28,2624666226,-31418527
1645352286,197480,true,2654491659,28,2624666226,-29825433
1645352334,197484,true,2653430128,28,2624928692,-28501436
1645352534,197486,true,2652899522,28,2625453704,-27445818
1645352612,197488,true,2652369021,28,2625978821,-26390200
1645352770,197494,true,2650778157,28,2626766694,-24011463
1645354066,197497,true,2649983082,28,2633868192,-16114890
1645354095,197499,true,2649453165,28,2633868192,-15584973
1645354251,197501,true,2648923354,28,2633868192,-15055162
1645354479,197505,true,2647864049,28,2632814908,-15049141
1645354980,197509,true,2646805169,28,2629657582,-17147587
1645355012,197511,true,2646275887,28,2629394643,-16881244
1645355636,197514,true,2645482163,28,2624403785,-21078378
1645356026,197518,true,2644424235,28,2621780825,-22643410
1645356107,197521,true,2643631066,28,2621518673,-22112393
1645356218,197523,true,2643102419,28,2621256547,-21845872
1645357545,197525,true,2642573878,28,2620994448,-21579430
1645357657,197529,true,2641517112,28,2620994448,-20522664
1645357690,197531,true,2640988888,28,2621256547,-19732341
1645357702,197533,true,2640460770,28,2621256547,-19204223
1645357731,197535,true,2639932757,28,2621256547,-18676210
1645357873,197538,true,2639140935,28,2622305207,-16835728
1645358232,197539,true,2638877048,28,2624666226,-14210822
1645358255,197541,true,2638349351,28,2624928692,-13420659
1645359165,197542,true,2638085543,28,2634131578,-3953965
1645359175,197544,true,2637558005,28,2634131578,-3426427
1645359330,197546,true,2637030572,28,2636239621,-790951
1645359470,197547,true,2636766896,28,2637821761,1054865
1645359553,197547,true,2636766896,28,2638877048,2110152
1645359557,197549,true,2636239621,28,2638877048,2637427
1645359602,197550,true,2635976024,28,2639404849,3428825
1645360022,197550,true,2635976024,28,2644424235,8448211
1645360115,197550,true,2635976024,28,2644953146,8977122
1645360199,197552,true,2635448908,28,2645482163,10033255
1645360454,197553,true,2635185389,28,2646540515,11355126
1645360493,197553,true,2635185389,28,2646805169,11619780
1645361322,197554,true,2634921897,28,2647069849,12147952
1645361443,197555,true,2634658431,28,2646275887,11617456
1645361746,197557,true,2634131578,28,2642838135,8706557
1645361798,197557,true,2634131578,28,2642309647,8178069
1645361845,197558,true,2633868192,28,2641781264,7913072
1645361926,197559,true,2633604831,28,2641252987,7648156
1645362162,197561,true,2633078189,28,2639140935,6062746
1645362514,197561,true,2633078189,28,2636503245,3425056
1645364486,197562,true,2632814908,28,2629920548,-2894360
1645365481,197563,true,2632551652,28,2630709603,-1842049
1645366489,197564,true,2632288424,28,2631762045,-526379
1645366554,197564,true,2632288424,28,2631498895,-789529
1645366613,197564,true,2632288424,28,2631498895,-789529
1645366661,197564,true,2632288424,28,2631235771,-1052653
1645366700,197566,true,2631762045,28,2630972674,-789371
1645366747,197566,true,2631762045,28,2630709603,-1052442
1645367026,197568,true,2631235771,28,2627817558,-3418213
1645367044,197567,true,2631498895,28,2627554803,-3944092
1645367050,197569,true,2630972674,28,2627554803,-3417871
1645367140,197569,true,2630972674,28,2627292073,-3680601
1645367286,197569,true,2630972674,28,2626766694,-4205980
1645367521,197569,true,2630972674,28,2625978821,-4993853
1645367807,197571,true,2630446559,28,2624666226,-5780333
1645368682,197572,true,2630183540,28,2622829694,-7353846
1645368978,197572,true,2630183540,28,2623091977,-7091563
1645369524,197572,true,2630183540,28,2621780825,-8402715
1645369633,197573,true,2629920548,28,2621780825,-8139723
1645369663,197574,true,2629657582,28,2621780825,-7876757
1645369670,197575,true,2629394643,28,2621780825,-7613818
1645370413,197573,true,2629920548,28,2625191185,-4729363
1645371235,197576,true,2629131730,28,2629920548,788818
1645371466,197576,true,2629131730,28,2631762045,2630315
1645371559,197577,true,2628868843,28,2632288424,3419581
1645371685,197575,true,2629394643,28,2632814908,3420265
1645371871,197577,true,2628868843,28,2633604831,4735988
1645372291,197577,true,2628868843,28,2635712453,6843610
1645372339,197578,true,2628605982,28,2636503245,7897263
1645372355,197576,true,2629131730,28,2636766896,7635166
1645372598,197577,true,2628868843,28,2639932757,11063914
1645373264,197576,true,2629131730,28,2649453165,20321435
1645373667,197576,true,2629131730,28,2654757108,25625378
1645373681,197574,true,2629657582,28,2655022584,25365002
1645373919,197574,true,2629657582,28,2658476185,28818603
1645374464,197572,true,2630183540,28,2664064572,33881032
1645374638,197571,true,2630446559,28,2664597411,34150852
1645374732,197569,true,2630972674,28,2664863871,33891197
1645374769,197568,true,2631235771,28,2665130357,33894586
1645374857,197566,true,2631762045,28,2665130357,33368312
1645375147,197566,true,2631762045,28,2664064572,32302527
1645375293,197564,true,2632288424,28,2662999212,30710788
1645376305,197565,true,2632025221,28,2649188246,17163025
1645376773,197563,true,2632551652,28,2644953146,12401494
1645377107,197562,true,2632814908,28,2644424235,11609327
1645377166,197560,true,2633341497,28,2644424235,11082738
1645377229,197560,true,2633341497,28,2644688677,11347180
1645377289,197558,true,2633868192,28,2644953146,11084954
1645377448,197557,true,2634131578,28,2645746711,11615133
1645378260,197555,true,2634658431,28,2650248081,15589650
1645378776,197555,true,2634658431,28,2651838627,17180196
1645378808,197553,true,2635185389,28,2651838627,16653238
1645380883,197552,true,2635448908,28,2648923354,13474446
1645380886,197551,true,2635712453,28,2649188246,13475793
1645381837,197552,true,2635448908,28,2650778157,15329249
1645381888,197550,true,2635976024,28,2651043235,15067211
1645381995,197549,true,2636239621,28,2651573470,15333849
1645382003,197547,true,2636766896,28,2651573470,14806574
1645383461,197546,true,2637030572,28,2659805689,22775117
1645384013,197544,true,2637558005,28,2660337677,22779672
1645384030,197543,true,2637821761,28,2660337677,22515916
1645385883,197541,true,2638349351,28,2655819171,17469820
1645386629,197541,true,2638349351,28,2654757108,16407757
1645387330,197539,true,2638877048,28,2653695471,14818423
1645387384,197539,true,2638877048,28,2653430128,14553080
1645387481,197538,true,2639140935,28,2652899522,13758587
1645387732,197538,true,2639140935,28,2651308339,12167404
1645387870,197537,true,2639404849,28,2650513105,11108256
1645387906,197536,true,2639668790,28,2650248081,10579291
1645388622,197536,true,2639668790,28,2643631066,3962276
1645388962,197536,true,2639668790,28,2640460770,791980
1645388980,197535,true,2639932757,28,2640460770,528013
1645390878,197535,true,2639932757,28,2632814908,-7117849
1645391107,197535,true,2639932757,28,2632814908,-7117849
1645391174,197536,true,2639668790,28,2632551652,-7117138
1645391209,197536,true,2639668790,28,2632025221,-7643569
1645391546,197537,true,2639404849,28,2628605982,-10798867
1645392130,197538,true,2639140935,28,2620732374,-18408561
1645392156,197538,true,2639140935,28,2620470327,-18670608
1645392573,197538,true,2639140935,28,2611837459,-27303476
1645392592,197540,true,2638613186,28,2611576301,-27036885
1645392710,197542,true,2638085543,28,2608966161,-29119382
1645392731,197542,true,2638085543,28,2608444446,-29641097
1645393412,197543,true,2637821761,28,2596214132,-41607629
1645393593,197544,true,2637558005,28,2593619345,-43938660
1645393684,197546,true,2637030572,28,2592582157,-44448415
1645394278,197546,true,2637030572,28,2588178731,-48851841
1645394398,197547,true,2636766896,28,2587919939,-48846957
1645394483,197549,true,2636239621,28,2588178731,-48060890
1645394677,197552,true,2635448908,28,2589473080,-45975828
1645394743,197551,true,2635712453,28,2589991000,-45721453
1645394943,197551,true,2635712453,28,2592063718,-43648735
1645394959,197554,true,2634921897,28,2592322925,-42598972
1645395051,197556,true,2634394992,28,2593619345,-40775647
1645395073,197556,true,2634394992,28,2593878707,-40516285
1645395732,197555,true,2634658431,28,2602972733,-31685698
1645396110,197558,true,2633868192,28,2608705290,-25162902
1645397367,197560,true,2633341497,28,2615757959,-17583538
1645397452,197560,true,2633341497,28,2616281136,-17060361
1645397477,197560,true,2633341497,28,2616542765,-16798732
1645397480,197563,true,2632551652,28,2616542765,-16008887
1645397560,197564,true,2632288424,28,2617327806,-14960618
1645397590,197562,true,2632814908,28,2617851298,-14963610
1645397861,197562,true,2632814908,28,2621256547,-11558361
1645397915,197564,true,2632288424,28,2621780825,-10507599
1645397927,197564,true,2632288424,28,2622043003,-10245421
1645398008,197562,true,2632814908,28,2623354286,-9460622
1645398113,197561,true,2633078189,28,2625453704,-7624485
1645398481,197562,true,2632814908,28,2632551652,-263256
1645398637,197562,true,2632814908,28,2635976024,3161116
1645398919,197560,true,2633341497,28,2641781264,8439767
1645398975,197558,true,2633868192,28,2642838135,8969943
1645398993,197559,true,2633604831,28,2643102419,9497588
1645399022,197559,true,2633604831,28,2643631066,10026235
1645399363,197558,true,2633868192,28,2647334556,13466364
1645400052,197557,true,2634131578,28,2645746711,11615133
1645400069,197558,true,2633868192,28,2645746711,11878519
1645400688,197558,true,2633868192,28,2642045442,8177250
1645400959,197556,true,2634394992,28,2641252987,6857995
1645400973,197554,true,2634921897,28,2641252987,6331090
1645401202,197554,true,2634921897,28,2640724816,5802919
1645401257,197554,true,2634921897,28,2640724816,5802919
1645401290,197553,true,2635185389,28,2640724816,5539427
1645401542,197551,true,2635712453,28,2639404849,3692396
1645401709,197553,true,2635185389,28,2638349351,3163962
1645401756,197554,true,2634921897,28,2638085543,3163646
1645401768,197552,true,2635448908,28,2637821761,2372853
1645401883,197551,true,2635712453,28,2636503245,790792
1645402196,197554,true,2634921897,28,2632288424,-2633473
1645402319,197554,true,2634921897,28,2630709603,-4212294
1645402347,197552,true,2635448908,28,2630446559,-5002349
1645402503,197551,true,2635712453,28,2628868843,-6843610
1645402630,197553,true,2635185389,28,2627817558,-7367831
1645402854,197555,true,2634658431,28,2625978821,-8679610
1645404114,197553,true,2635185389,28,2626241419,-8943970
1645404623,197552,true,2635448908,28,2627292073,-8156835
1645404681,197554,true,2634921897,28,2627292073,-7629824
1645404799,197555,true,2634658431,28,2627817558,-6840873
1645404864,197554,true,2634921897,28,2628343148,-6578749
1645404918,197552,true,2635448908,28,2628868843,-6580065
1645404946,197554,true,2634921897,28,2629131730,-5790167
1645405046,197555,true,2634658431,28,2630446559,-4211872
1645405059,197554,true,2634921897,28,2630446559,-4475338
1645405144,197553,true,2635185389,28,2631762045,-3423344
1645405199,197555,true,2634658431,28,2632814908,-1843523
1645405267,197555,true,2634658431,28,2634131578,-526853
1645405527,197554,true,2634921897,28,2638877048,3955151
1645405541,197554,true,2634921897,28,2639140935,4219038
1645405542,197556,true,2634394992,28,2639140935,4745943
1645405552,197556,true,2634394992,28,2639404849,5009857
1645405661,197553,true,2635185389,28,2642573878,7388489
1645405692,197552,true,2635448908,28,2643631066,8182158
1645405756,197553,true,2635185389,28,2646011286,10825897
1645405924,197551,true,2635712453,28,2652103811,16391358
1645405992,197547,true,2636766896,28,2654757108,17990212
1645406334,197545,true,2637294275,28,2669397765,32103490
1645406351,197545,true,2637294275,28,2670198665,32904390
1645407116,197543,true,2637821761,28,2698112234,60290473
1645407133,197538,true,2639140935,28,2698382046,59241111
1645407155,197536,true,2639668790,28,2699191641,59522851
1645407556,197537,true,2639404849,28,2709467567,70062718
1645407585,197534,true,2640196750,28,2710009488,69812738
1645408745,197529,true,2641517112,28,2722231398,80714286
1645408795,197527,true,2642045442,28,2722775872,80730430
1645409028,197527,true,2642045442,28,2723865146,81819704
1645409364,197524,true,2642838135,28,2724954855,82116720
1645409534,197519,true,2644159819,28,2724682387,80522568
1645411730,197517,true,2644688677,28,2722503621,77814944
1645411905,197518,true,2644424235,28,2722775872,78351637
1645412321,197515,true,2645217641,28,2723048149,77830508
1645412330,197511,true,2646275887,28,2723048149,76772262
1645413014,197509,true,2646805169,28,2723865146,77059977
1645413778,197509,true,2646805169,28,2724682387,77877218
1645413791,197506,true,2647599290,28,2724682387,77083097
1645414291,197501,true,2648923354,28,2726590237,77666883
1645414386,197499,true,2649453165,28,2726862896,77409731
1645414422,197499,true,2649453165,28,2726862896,77409731
1645414461,197496,true,2650248081,28,2726862896,76614815
1645414505,197491,true,2651573470,28,2726862896,75289426
1645414934,197489,true,2652103811,28,2726045001,73941190
1645414965,197489,true,2652103811,28,2726045001,73941190
1645415431,197485,true,2653164812,28,2724137532,70972720
1645415477,197480,true,2654491659,28,2724137532,69645873
1645416277,197478,true,2655022584,28,2717064327,62041743
1645418032,197478,true,2655022584,28,2716792648,61770064
1645418078,197474,true,2656084753,28,2717064327,60979574
1645418200,197469,true,2657413061,28,2717336034,59922973
1645418577,197467,true,2657944570,28,2718423131,60478561
1645418994,197464,true,2658742033,28,2720870691,62128658
1645419256,197458,true,2660337677,28,2723592786,63255109
1645419297,197453,true,2661668112,28,2724137532,62469420
1645419379,197450,true,2662466692,28,2724954855,62488163
1645419427,197446,true,2663531839,28,2725772423,62240584
1645419597,197439,true,2665396870,28,2727953805,62556935
1645420476,197434,true,2666729835,28,2738065423,71335588
1645421191,197429,true,2668063467,28,2742449615,74386148
1645422416,197425,true,2669130852,28,2746291541,77160689
1645422426,197418,true,2670999805,28,2746291541,75291736
1645423131,197413,true,2672335572,28,2746566170,74230598
1645423438,197408,true,2673672007,28,2746016939,72344932
1645423498,197404,true,2674741636,28,2745742365,71000729
1645423503,197398,true,2676346882,28,2745742365,69395483
1645425085,197393,true,2677685323,28,2740256642,62571319
1645425797,197390,true,2678488709,28,2739434730,60946021
1645426316,197386,true,2679560265,28,2739434730,59874465
1645427032,197380,true,2681168404,28,2739434730,58266326
1645427699,197376,true,2682241032,28,2739434730,57193698
1645427888,197373,true,2683045785,28,2739434730,56388945
1645428193,197369,true,2684119164,28,2739434730,55315566
1645428535,197363,true,2685730038,28,2739708673,53978635
1645428545,197359,true,2686804491,28,2739982644,53178153
1645428995,197356,true,2687610613,28,2741901207,54290594
1645429721,197352,true,2688685819,28,2745193299,56507480
1645430000,197347,true,2690030430,28,2746291541,56261111
1645430134,197344,true,2690837520,28,2746840827,56003307
1645430680,197341,true,2691644852,28,2747664961,56020109
1645430808,197337,true,2692721672,28,2747664961,54943289
1645431563,197332,true,2694068302,28,2749039069,54970767
1645431928,197329,true,2694876603,28,2749039069,54162466
1645432083,197328,true,2695146091,28,2749039069,53892978
1645432497,197324,true,2696224311,28,2748214522,51990211
1645432610,197320,true,2697302962,28,2747664961,50361999
1645433011,197318,true,2697842450,28,2745193299,47350849
1645433094,197316,true,2698382046,28,2744369906,45987860
1645433342,197313,true,2699191641,28,2742175397,42983756
1645433442,197309,true,2700271480,28,2740804721,40533241
1645434745,197307,true,2700811561,28,2725499873,24688312
1645434760,197305,true,2701351750,28,2725499873,24148123
1645435684,197302,true,2702162237,28,2722503621,20341384
1645437356,197298,true,2703243264,28,2724682387,21439123
1645437396,197296,true,2703783940,28,2724682387,20898447
1645437411,197294,true,2704324723,28,2724682387,20357664
1645438538,197291,true,2705136102,28,2720598631,15462529
1645438559,197287,true,2706218319,28,2720598631,14380312
1645438586,197285,true,2706759589,28,2720326598,13567009
1645438607,197283,true,2707300968,28,2720326598,13025630
1645438682,197281,true,2707842456,28,2719510664,11668208
1645438993,197277,true,2708925755,28,2716792648,7866893
1645439072,197275,true,2709467567,28,2715706203,6238636
1645439079,197272,true,2710280489,28,2715706203,5425714
1645439103,197269,true,2711093654,28,2715434659,4341005
1645439135,197266,true,2711907064,28,2714891654,2984590
1645439243,197264,true,2712449472,28,2713263289,813817
1645439620,197261,true,2713263289,28,2708384051,-4879238
1645439640,197259,true,2713805968,28,2708113240,-5692728
1645439841,197257,true,2714348757,28,2705406616,-8942141
1645439858,197255,true,2714891654,28,2705136102,-9755552
1645439866,197253,true,2715434659,28,2704865615,-10569044
1645439872,197250,true,2716249371,28,2704865615,-11383756
1645439906,197248,true,2716792648,28,2704324723,-12467925
1645439914,197247,true,2717064327,28,2704054318,-13010009
1645439927,197246,true,2717336034,28,2703783940,-13552094
1645439945,197244,true,2717879528,28,2703513588,-14365940
1645439998,197243,true,2718151316,28,2702432453,-15718863
1645440026,197243,true,2718151316,28,2701892048,-16259268
1645440826,197242,true,2718423131,28,2687341879,-31081252
1645441296,197241,true,2718694974,28,2683045785,-35649189
1645441314,197240,true,2718966843,28,2682777507,-36189336
1645442907,197240,true,2718966843,28,2684387576,-34579267
1645443020,197239,true,2719238740,28,2684656015,-34582725
1645443073,197237,true,2719782615,28,2684656015,-35126600
1645443250,197237,true,2719782615,28,2684656015,-35126600
1645443378,197239,true,2719238740,28,2684387576,-34851164
1645443448,197238,true,2719510664,28,2684119164,-35391500
1645443470,197238,true,2719510664,28,2683850779,-35659885
1645443484,197238,true,2719510664,28,2683850779,-35659885
1645443521,197242,true,2718423131,28,2683582421,-34840710
1645443555,197243,true,2718151316,28,2683045785,-35105531
1645443658,197243,true,2718151316,28,2681436520,-36714796
1645443672,197245,true,2717607767,28,2681168404,-36439363
1645443759,197249,true,2716520996,28,2679024434,-37496562
1645443768,197251,true,2715977773,28,2678756558,-37221215
1645443798,197252,true,2715706203,28,2678220887,-37485316
1645443860,197255,true,2714891654,28,2676346882,-38544772
1645443874,197261,true,2713263289,28,2676079274,-37184015
1645444067,197263,true,2712720717,28,2670465685,-42255032
1645444094,197265,true,2712178255,28,2669664705,-42513550
1645444190,197268,true,2711364764,28,2666196569,-45168195
1645444623,197274,true,2709738514,28,2650513105,-59225409
1645444673,197276,true,2709196648,28,2648658488,-60538160
1645444815,197278,true,2708654890,28,2643895429,-64759461
1645445130,197281,true,2707842456,28,2633604831,-74237625
1645445366,197287,true,2706218319,28,2627817558,-78400761
1645445399,197290,true,2705406616,28,2627292073,-78114543
1645445883,197291,true,2705136102,28,2623616622,-81519480
1645445903,197295,true,2704054318,28,2623616622,-80437696
1645445973,197301,true,2702432453,28,2623616622,-78815831
1645445987,197303,true,2701892048,28,2623616622,-78275426
1645446034,197306,true,2701081642,28,2623354286,-77727356
1645446327,197310,true,2700001480,28,2622305207,-77696273
1645446432,197316,true,2698382046,28,2622305207,-76076839
1645446600,197318,true,2697842450,28,2622043003,-75799447
1645446657,197320,true,2697302962,28,2621780825,-75522137
1645447039,197323,true,2696493933,28,2621518673,-74975260
1645447440,197329,true,2694876603,28,2620208306,-74668297
1645447573,197330,true,2694607142,28,2619684343,-74922799
1645447592,197333,true,2693798922,28,2619684343,-74114579
1645447626,197336,true,2692990944,28,2619422401,-73568543
1645447836,197342,true,2691375715,28,2618374894,-73000821
1645447871,197344,true,2690837520,28,2618374894,-72462626
1645448033,197349,true,2689492505,28,2617589539,-71902966
1645448203,197352,true,2688685819,28,2616542765,-72143054
1645448404,197359,true,2686804491,28,2614450472,-72354019
1645448659,197362,true,2685998611,28,2612098643,-73899968
1645448681,197366,true,2684924480,28,2611837459,-73087021
1645448911,197370,true,2683850779,28,2609748929,-74101850
1645448924,197377,true,2681972834,28,2609487980,-72484854
1645448991,197380,true,2681168404,28,2608705290,-72463114
1645448993,197385,true,2679828221,28,2608705290,-71122931
1645449093,197390,true,2678488709,28,2607401329,-71087380
1645449166,197397,true,2676614517,28,2606098019,-70516498
1645449196,197400,true,2675811693,28,2605837435,-69974258
1645449264,197405,true,2674474188,28,2605055841,-69418347
1645449313,197409,true,2673404666,28,2604795361,-68609305
1645449478,197415,true,2671801185,28,2604795361,-67005824
1645449574,197418,true,2670999805,28,2604795361,-66204444
1645449648,197422,true,2669931672,28,2604795361,-65136311
1645449954,197427,true,2668597106,28,2604795361,-63801745
1645450238,197433,true,2666996508,28,2604534907,-62461601
1645450548,197436,true,2666196569,28,2603493354,-62703215
1645450631,197440,true,2665130357,28,2603233031,-61897326
1645450851,197446,true,2663531839,28,2602972733,-60559106
1645451838,197451,true,2662200472,28,2600631229,-61569243
1645451846,197455,true,2661135858,28,2600631229,-60504629
1645451899,197460,true,2659805689,28,2600891292,-58914397
1645451908,197465,true,2658476185,28,2600891292,-57584893
1645452252,197471,true,2656881658,28,2601671637,-55210021
1645452271,197474,true,2656084753,28,2601671637,-54413116
1645452288,197479,true,2654757108,28,2601671637,-53085471
1645452289,197484,true,2653430128,28,2601671637,-51758491
1645452494,197489,true,2652103811,28,2603233031,-48870780
1645452500,197492,true,2651308339,28,2603233031,-48075308
1645452570,197497,true,2649983082,28,2604014079,-45969003
1645452637,197502,true,2648658488,28,2605055841,-43602647
1645452655,197505,true,2647864049,28,2605316346,-42547703
1645452664,197508,true,2647069849,28,2605316346,-41753503
1645452670,197512,true,2646011286,28,2605576878,-40434408
1645452981,197515,true,2645217641,28,2611054064,-34163577
1645453011,197517,true,2644688677,28,2611837459,-32851218
1645453038,197520,true,2643895429,28,2612359853,-31535576
1645453077,197523,true,2643102419,28,2613143639,-29958780
1645453119,197526,true,2642309647,28,2614450472,-27859175
1645453156,197527,true,2642045442,28,2615496409,-26549033
1645453183,197529,true,2641517112,28,2616542765,-24974347
1645453196,197532,true,2640724816,28,2617066099,-23658717
1645453222,197531,true,2640988888,28,2618636732,-22352156
1645453453,197529,true,2641517112,28,2631762045,-9755067
1645453488,197531,true,2640988888,28,2633604831,-7384057
1645453548,197532,true,2640724816,28,2637294275,-3430541
1645453881,197531,true,2640988888,28,2657413061,16424173
1645453931,197529,true,2641517112,28,2660071670,18554558
1645455767,197532,true,2640724816,28,2700811561,60086745
1645455814,197533,true,2640460770,28,2701081642,60620872
1645455844,197531,true,2640988888,28,2701081642,60092754
1645455854,197528,true,2641781264,28,2701351750,59570486
1645455863,197530,true,2641252987,28,2701351750,60098763
1645456094,197530,true,2641252987,28,2703243264,61990277
1645456201,197528,true,2641781264,28,2704865615,63084351
1645456245,197525,true,2642573878,28,2705947724,63373846
1645456355,197526,true,2642309647,28,2708113240,65803593
1645456524,197525,true,2642573878,28,2711635900,69062022
1645456636,197522,true,2643366729,28,2714077349,70710620
1645456683,197518,true,2644424235,28,2715163143,70738908
1645456869,197519,true,2644159819,28,2719782615,75622796
1645456889,197517,true,2644688677,28,2720326598,75637921
1645456988,197513,true,2645746711,28,2722775872,77029161
1645457024,197510,true,2646540515,28,2723320454,76779939
1645457106,197511,true,2646275887,28,2724954855,78678968
1645457121,197509,true,2646805169,28,2725227351,78422182
1645457146,197506,true,2647599290,28,2725499873,77900583
1645457169,197503,true,2648393649,28,2726045001,77651352
1645457176,197505,true,2647864049,28,2726045001,78180952
1645457971,197504,true,2648128836,28,2733688240,85559404
1645457978,197501,true,2648923354,28,2733688240,84764886
1645458001,197497,true,2649983082,28,2733688240,83705158
1645458506,197498,true,2649718110,28,2731775423,82057313
1645458539,197497,true,2649983082,28,2731502273,81519191
1645458743,197494,true,2650778157,28,2729318054,78539897
1645459442,197490,true,2651838627,28,2727408296,75569669
1645459559,197491,true,2651573470,28,2727408296,75834826
1645460469,197488,true,2652369021,28,2727135582,74766561
1645460488,197485,true,2653164812,28,2727135582,73970770
1645460491,197480,true,2654491659,28,2727135582,72643923
1645460711,197480,true,2654491659,28,2728499423,74007764
1645460730,197476,true,2655553615,28,2728499423,72945808
1645460803,197473,true,2656350361,28,2728772273,72421912
1645460902,197468,true,2657678802,28,2728772273,71093471
1645460947,197468,true,2657678802,28,2728772273,71093471
1645461003,197464,true,2658742033,28,2728499423,69757390
1645462016,197461,true,2659539735,28,2723592786,64053051
1645462711,197455,true,2661135858,28,2718966843,57830985
1645463562,197455,true,2661135858,28,2716249371,55113513
1645463611,197451,true,2662200472,28,2715977773,53777301
1645464005,197448,true,2662999212,28,2715706203,52706991
1645464457,197443,true,2664330978,28,2716520996,52190018
1645465085,197442,true,2664597411,28,2720054593,55457182
1645465177,197438,true,2665663410,28,2720598631,54935221
1645465183,197435,true,2666463189,28,2720598631,54135442
1645465318,197429,true,2668063467,28,2721142778,53079311
1645465459,197429,true,2668063467,28,2721687034,53623567
1645465503,197425,true,2669130852,28,2721687034,52556182
1645465524,197421,true,2670198665,28,2721414892,51216227
1645465570,197416,true,2671534031,28,2721414892,49880861
1645465706,197417,true,2671266905,28,2720598631,49331726
1645466562,197413,true,2672335572,28,2711364764,39029192
1645466643,197410,true,2673137352,28,2710551517,37414165
1645466684,197405,true,2674474188,28,2709738514,35264326
1645466704,197406,true,2674206768,28,2709467567,35260799
1645466712,197403,true,2675009110,28,2709196648,34187538
1645466736,197401,true,2675544139,28,2708384051,32839912
1645466996,197398,true,2676346882,28,2699461560,23114678
1645467042,197399,true,2676079274,28,2698112234,22032960
1645467168,197396,true,2676882178,28,2693529569,16647391
1645467231,197394,true,2677417581,28,2691375715,13958134
1645467291,197390,true,2678488709,28,2689492505,11003796
1645467406,197392,true,2677953092,28,2685192973,7239881
1645467505,197390,true,2678488709,28,2681436520,2947811
1645467522,197389,true,2678756558,28,2680632250,1875692
1645467568,197386,true,2679560265,28,2678756558,-803707
1645467896,197388,true,2679024434,28,2665396870,-13627564
1645467929,197386,true,2679560265,28,2664064572,-15495693
1645467934,197384,true,2680096204,28,2663798192,-16298012
1645468099,197382,true,2680632250,28,2656350361,-24281889
1645468106,197384,true,2680096204,28,2656084753,-24011451
1645468151,197383,true,2680364214,28,2653960841,-26403373
1645468614,197382,true,2680632250,28,2634658431,-45973819
1645469164,197381,true,2680900313,28,2622043003,-58857310
1645469165,197384,true,2680096204,28,2622043003,-58053201
1645469204,197382,true,2680632250,28,2621780825,-58851425
1645469212,197381,true,2680900313,28,2621780825,-59119488
1645469238,197377,true,2681972834,28,2621780825,-60192009
1645469253,197380,true,2681168404,28,2621780825,-59387579
1645469278,197376,true,2682241032,28,2622043003,-60198029
1645469281,197374,true,2682777507,28,2622043003,-60734504
1645469288,197370,true,2683850779,28,2622305207,-61545572
1645469303,197371,true,2683582421,28,2622567437,-61014984
1645469384,197365,true,2685192973,28,2624928692,-60264281
1645469403,197363,true,2685730038,28,2625453704,-60276334
1645469473,197359,true,2686804491,28,2627292073,-59512418
1645469482,197360,true,2686535838,28,2627554803,-58981035
1645469483,197355,true,2687879374,28,2627554803,-60324571
1645469500,197354,true,2688148162,28,2628080340,-60067822
1645469521,197351,true,2688954687,28,2628343148,-60611539
1645469536,197353,true,2688416977,28,2628605982,-59810995
1645469549,197349,true,2689492505,28,2628868843,-60623662
1645469553,197348,true,2689761454,28,2628868843,-60892611
1645469686,197348,true,2689761454,28,2629920548,-59840906
1645469721,197350,true,2689223583,28,2630183540,-59040043
1645469875,197346,true,2690299433,28,2632288424,-58011009
1645470166,197347,true,2690030430,28,2635976024,-54054406
1645470230,197347,true,2690030430,28,2637030572,-52999858
1645470245,197349,true,2689492505,28,2637294275,-52198230
1645470255,197345,true,2690568463,28,2637558005,-53010458
1645470259,197346,true,2690299433,28,2637558005,-52741428
1645470422,197349,true,2689492505,28,2638877048,-50615457
1645470488,197352,true,2688685819,28,2639404849,-49280970
1645470582,197349,true,2689492505,28,2640196750,-49295755
1645470953,197352,true,2688685819,28,2644159819,-44526000
1645470983,197358,true,2687073172,28,2644424235,-42648937
1645471017,197361,true,2686267211,28,2644424235,-41842976
1645471041,197358,true,2687073172,28,2644424235,-42648937
1645471422,197363,true,2685730038,28,2635976024,-49754014
1645471807,197369,true,2684119164,28,2633604831,-50514333
1645472137,197370,true,2683850779,28,2634658431,-49192348
1645472154,197368,true,2684387576,28,2634658431,-49729145
1645472161,197371,true,2683582421,28,2634658431,-48923990
1645472195,197376,true,2682241032,28,2634658431,-47582601
1645472204,197380,true,2681168404,28,2634658431,-46509973
1645472217,197378,true,2681704664,28,2634658431,-47046233
1645472225,197382,true,2680632250,28,2634921897,-45710353
1645472285,197387,true,2679292336,28,2635185389,-44106947
1645472347,197391,true,2678220887,28,2635712453,-42508434
1645472782,197391,true,2678220887,28,2636766896,-41453991
1645472922,197395,true,2677149866,28,2637558005,-39591861
1645473165,197400,true,2675811693,28,2640196750,-35614943
1645473387,197405,true,2674474188,28,2642309647,-32164541
1645473619,197404,true,2674741636,28,2644159819,-30581817
1645473934,197408,true,2673672007,28,2644953146,-28718861
1645474129,197413,true,2672335572,28,2646011286,-26324286
1645474881,197416,true,2671534031,28,2648923354,-22610677
1645474940,197416,true,2671534031,28,2648923354,-22610677
1645476051,197420,true,2670465685,28,2644688677,-25777008
1645476074,197424,true,2669397765,28,2644688677,-24709088
1645476200,197428,true,2668330273,28,2644688677,-23641596
1645477027,197426,true,2668863966,28,2650513105,-18350861
1645477035,197429,true,2668063467,28,2650513105,-17550362
1645477331,197433,true,2666996508,28,2652634258,-14362250
1645477686,197438,true,2665663410,28,2654757108,-10906302
1645477752,197436,true,2666196569,28,2655022584,-11173985
1645478311,197440,true,2665130357,28,2654226237,-10904120
1645478341,197444,true,2664064572,28,2653960841,-10103731
1645478353,197447,true,2663265512,28,2653960841,-9304671
1645478619,197446,true,2663531839,28,2653164812,-10367027
1645478651,197449,true,2662732939,28,2652899522,-9833417
1645478685,197454,true,2661401972,28,2652899522,-8502450
1645478694,197458,true,2660337677,28,2652899522,-7438155
1645478901,197456,true,2660869771,28,2653960841,-6908930
1645478970,197459,true,2660071670,28,2654226237,-5845433
1645479000,197462,true,2659273808,28,2654226237,-5047571
1645479057,197466,true,2658210364,28,2654491659,-3718705
1645479085,197464,true,2658742033,28,2654491659,-4250374
1645479222,197467,true,2657944570,28,2654757108,-3187462
1645479248,197471,true,2656881658,28,2654757108,-2124550
1645479289,197474,true,2656084753,28,2654491659,-1593094
1645479772,197474,true,2656084753,28,2652103811,-3980942
1645480265,197478,true,2655022584,28,2645482163,-9540421
1645480289,197482,true,2653960841,28,2645217641,-8743200
1645480301,197486,true,2652899522,28,2644953146,-7946376
1645480397,197487,true,2652634258,28,2643102419,-9531839
1645480449,197492,true,2651308339,28,2642045442,-9262897
1645480541,197496,true,2650248081,28,2639140935,-11107146
1645480613,197501,true,2648923354,28,2636766896,-12156458
1645480763,197503,true,2648393649,28,2630709603,-17684046
1645480789,197508,true,2647069849,28,2629657582,-17412267
1645480808,197513,true,2645746711,28,2628868843,-16877868
1645480824,197517,true,2644688677,28,2628080340,-16608337
1645480886,197519,true,2644159819,28,2625453704,-18706115
1645481023,197524,true,2642838135,28,2619684343,-23153792
1645481035,197529,true,2641517112,28,2619160485,-22356627
1645481221,197533,true,2640460770,28,2612098643,-28362127
1645481268,197535,true,2639932757,28,2610531932,-29400825
1645481275,197539,true,2638877048,28,2610270905,-28606143
1645481309,197541,true,2638349351,28,2609227057,-29122294
1645481405,197544,true,2637558005,28,2606358629,-31199376
1645481449,197544,true,2637558005,28,2605316346,-32241659
1645481464,197548,true,2636503245,28,2605055841,-31447404
1645481471,197550,true,2635976024,28,2605055841,-30920183
1645481572,197550,true,2635976024,28,2603493354,-32482670
1645481773,197549,true,2636239621,28,2601931804,-34307817
1645481871,197552,true,2635448908,28,2600891292,-34557616
1645481888,197553,true,2635185389,28,2600631229,-34554160
1645481912,197552,true,2635448908,28,2600631229,-34817679
1645482214,197551,true,2635712453,28,2599591236,-36121217
1645482251,197554,true,2634921897,28,2599591236,-35330661
1645482386,197555,true,2634658431,28,2599331303,-35327128
1645482408,197554,true,2634921897,28,2599331303,-35590594
1645482448,197553,true,2635185389,28,2599591236,-35594153
1645482790,197557,true,2634131578,28,2601671637,-32459941
1645482886,197558,true,2633868192,28,2602972733,-30895459
1645482964,197556,true,2634394992,28,2604274480,-30120512
1645482974,197556,true,2634394992,28,2604274480,-30120512
1645483100,197558,true,2633868192,28,2606358629,-27509563
1645483165,197561,true,2633078189,28,2606879927,-26198262
1645483571,197560,true,2633341497,28,2606098019,-27243478
1645483891,197561,true,2633078189,28,2605837435,-27240754
1645483906,197563,true,2632551652,28,2605837435,-26714217
1645483985,197567,true,2631498895,28,2605837435,-25661460
1645484398,197566,true,2631762045,28,2611315170,-20446875
1645485072,197569,true,2630972674,28,2618636732,-12335942
1645485181,197572,true,2630183540,28,2619422401,-10761139
1645485204,197575,true,2629394643,28,2619684343,-9710300
1645485261,197574,true,2629657582,28,2619684343,-9973239
1645485437,197578,true,2628605982,28,2619684343,-8921639
1645485447,197581,true,2627817558,28,2619684343,-8133215
1645485461,197583,true,2627292073,28,2619684343,-7607730
1645485479,197582,true,2627554803,28,2619684343,-7870460
1645485651,197586,true,2626504043,28,2618374894,-8129149
1645485704,197589,true,2625716250,28,2617851298,-7864952
1645485794,197590,true,2625453704,28,2616019535,-9434169
1645486013,197589,true,2625716250,28,2610531932,-15184318
1645486026,197594,true,2624403785,28,2610009904,-14393881
1645486419,197597,true,2623616622,28,2601151381,-22465241
1645486436,197598,true,2623354286,28,2600891292,-22462994
1645486509,197597,true,2623616622,28,2599591236,-24025386
1645486582,197602,true,2622305207,28,2598291831,-24013376
1645486590,197605,true,2621518673,28,2598032027,-23486646
1645486626,197605,true,2621518673,28,2597252774,-24265899
1645487222,197605,true,2621518673,28,2583524433,-37994240
1645487334,197610,true,2620208306,28,2581716689,-38491617
1645487366,197613,true,2619422401,28,2581200423,-38221978
1645487494,197613,true,2619422401,28,2579910210,-39512191
1645487512,197613,true,2619422401,28,2579652244,-39770157
1645487514,197618,true,2618113083,28,2579652244,-38460839
1645487522,197620,true,2617589539,28,2579652244,-37937295
1645487825,197621,true,2617327806,28,2577331718,-39996088
1645487865,197622,true,2617066099,28,2577074010,-39992089
1645487890,197627,true,2615757959,28,2577074010,-38683949
1645487960,197629,true,2615234886,28,2576558673,-38676213
1645488071,197631,true,2614711917,28,2576043438,-38668479
1645488424,197630,true,2614973388,28,2574240929,-40732459
1645488469,197635,true,2613666294,28,2573983531,-39682763
1645488542,197637,true,2613143639,28,2573726158,-39417481
1645488601,197640,true,2612359853,28,2573211490,-39148363
1645488698,197641,true,2612098643,28,2572439681,-39658962
1645488717,197645,true,2611054064,28,2572439681,-38614383
1645488880,197648,true,2610270905,28,2571925270,-38345635
1645488907,197650,true,2609748929,28,2571925270,-37823659
1645488911,197651,true,2609487980,28,2571925270,-37562710
1645489304,197655,true,2608444446,28,2571668103,-36776343
1645489344,197658,true,2607662069,28,2571668103,-35993966
1645489459,197661,true,2606879927,28,2571925270,-34954657
1645489546,197661,true,2606879927,28,2572182463,-34697464
1645489849,197666,true,2605576878,28,2572696925,-32879953
1645489920,197667,true,2605316346,28,2572954195,-32362151
1645489991,197670,true,2604534907,28,2572954195,-31580712
1645490088,197670,true,2604534907,28,2573211490,-31323417
1645490129,197675,true,2603233031,28,2573468811,-29764220
1645490231,197678,true,2602452217,28,2573983531,-28468686
1645490262,197680,true,2601931804,28,2574498353,-27433451
1645490542,197679,true,2602191998,28,2578620641,-23571357
1645490545,197684,true,2600891292,28,2578620641,-22270651
1645490559,197686,true,2600371192,28,2578878503,-21492689
1645490681,197688,true,2599851195,28,2580684260,-19166935
1645490792,197686,true,2600371192,28,2582233058,-18138134
1645491085,197691,true,2599071396,28,2586109120,-12962276
1645491862,197693,true,2598551660,28,2596473754,-2077906
1645492031,197695,true,2598032027,28,2597772250,-259777
1645492040,197694,true,2598291831,28,2597772250,-519581
1645492073,197700,true,2596733401,28,2598032027,1298626
1645492341,197703,true,2595954537,28,2598032027,2077490
1645492370,197705,true,2595435424,28,2598032027,2596603
1645492621,197704,true,2595694967,28,2596214132,519165
1645492972,197710,true,2594138095,28,2593619345,-518750
1645493029,197712,true,2593619345,28,2593100699,-518646
1645493034,197715,true,2592841415,28,2593100699,259284
1645493077,197713,true,2593360009,28,2592582157,-777852
1645493814,197719,true,2591804538,28,2583524433,-8280105
1645493866,197720,true,2591545383,28,2583007805,-8537578
1645493874,197723,true,2590768075,28,2583007805,-7760270
1645493887,197721,true,2591286255,28,2583007805,-8278450
1645493923,197725,true,2590249999,28,2582749530,-7500469
1645493937,197725,true,2590249999,28,2582749530,-7500469
1645493973,197726,true,2589991000,28,2582749530,-7241470
1645493976,197724,true,2590509024,28,2582749530,-7759494
1645494047,197726,true,2589991000,28,2583007805,-6983195
1645494119,197725,true,2590249999,28,2583524433,-6725566
1645494172,197725,true,2590249999,28,2584041163,-6208836
1645494371,197722,true,2591027152,28,2586885030,-4142122
1645494428,197722,true,2591027152,28,2587661173,-3365979
1645494688,197721,true,2591286255,28,2590509024,-777231
1645494921,197721,true,2591286255,28,2593360009,2073754
1645495310,197718,true,2592063718,28,2598811515,6747797
1645495352,197718,true,2592063718,28,2599331303,7267585
1645495387,197717,true,2592322925,28,2599591236,7268311
1645495916,197719,true,2591804538,28,2600891292,9086754
1645495951,197717,true,2592322925,28,2600371192,8048267
1645496766,197719,true,2591804538,28,2590768075,-1036463
1645496849,197718,true,2592063718,28,2589732027,-2331691
1645496889,197720,true,2591545383,28,2589473080,-2072303
1645496915,197721,true,2591286255,28,2589214158,-2072097
1645496957,197723,true,2590768075,28,2588437549,-2330526
1645497021,197723,true,2590768075,28,2587402433,-3365642
1645497849,197725,true,2590249999,28,2579652244,-10597755
1645498052,197726,true,2589991000,28,2578362805,-11628195
1645498235,197729,true,2589214158,28,2577331718,-11882440
1645498745,197729,true,2589214158,28,2574755803,-14458355
1645499049,197731,true,2588696393,28,2574498353,-14198040
1645499074,197731,true,2588696393,28,2574498353,-14198040
1645499105,197733,true,2588178731,28,2574498353,-13680378
1645499111,197732,true,2588437549,28,2574498353,-13939196
1645499141,197735,true,2587661173,28,2574240929,-13420244
1645499149,197736,true,2587402433,28,2574240929,-13161504
1645499158,197738,true,2586885030,28,2574240929,-12644101
1645499171,197738,true,2586885030,28,2573983531,-12901499
1645499249,197742,true,2585850535,28,2572954195,-12896340
1645499310,197744,true,2585333442,28,2571925270,-13408172
1645499314,197746,true,2584816453,28,2571925270,-12891183
1645499333,197746,true,2584816453,28,2571668103,-13148350
1645499505,197751,true,2583524433,28,2568584107,-14940326
1645499667,197755,true,2582491281,28,2565503808,-16987473
1645499683,197758,true,2581716689,28,2565247284,-16469405
1645499819,197758,true,2581716689,28,2562170987,-19545702
1645500483,197764,true,2580168201,28,2545062673,-35105528
1645501174,197767,true,2579394305,28,2531610194,-47784111
1645501325,197769,true,2578878503,28,2530344769,-48533734
1645501357,197769,true,2578878503,28,2530091760,-48786743
1645501390,197775,true,2577331718,28,2529585817,-47745901
1645501496,197779,true,2576301043,28,2528574236,-47726807
1645501664,197780,true,2576043438,28,2527815815,-48227623
1645501999,197780,true,2576043438,28,2525794472,-50248966
1645502739,197786,true,2574498353,28,2521504484,-52993869
1645502752,197789,true,2573726158,28,2521504484,-52221674
1645502933,197789,true,2573726158,28,2521000259,-52725899
1645503184,197789,true,2573726158,28,2520496134,-53230024
1645503279,197794,true,2572439681,28,2520496134,-51943547
1645503577,197797,true,2571668103,28,2521504484,-50163619
1645503630,197797,true,2571668103,28,2521756634,-49911469
1645503655,197798,true,2571410962,28,2521756634,-49654328
1645504806,197803,true,2570125642,28,2524531954,-45593688
1645505090,197804,true,2569868656,28,2524531954,-45336702
1645505175,197804,true,2569868656,28,2524531954,-45336702
1645505240,197805,true,2569611694,28,2524784407,-44827287
1645505654,197809,true,2568584107,28,2526047052,-42537055
1645505680,197811,true,2568070467,28,2526047052,-42023415
1645505838,197811,true,2568070467,28,2526047052,-42023415
1645505956,197812,true,2567813685,28,2525794472,-42019213
1645507773,197816,true,2566786817,28,2518228821,-48557996
1645507796,197818,true,2566273536,28,2518480644,-47792892
1645508849,197818,true,2566273536,28,2521504484,-44769052
1645508915,197819,true,2566016935,28,2522008810,-44008125
1645508934,197823,true,2564990784,28,2522008810,-42981974
1645508950,197825,true,2564477863,28,2522261011,-42216852
1645509062,197824,true,2564734311,28,2523522394,-41211917
1645509224,197824,true,2564734311,28,2525541918,-39192393
1645509247,197828,true,2563708674,28,2525794472,-37914202
1645509304,197829,true,2563452328,28,2526299657,-37152671
1645509310,197827,true,2563965045,28,2526299657,-37665388
1645509371,197829,true,2563452328,28,2526552286,-36900042
1645509466,197834,true,2562170987,28,2526552286,-35618701
1645509492,197835,true,2561914795,28,2526552286,-35362509
1645509523,197835,true,2561914795,28,2526552286,-35362509
1645509545,197837,true,2561402489,28,2526552286,-34850203
1645510168,197843,true,2559866185,28,2522765488,-37100697
1645511381,197844,true,2559610224,28,2512695084,-46915140
1645511518,197843,true,2559866185,28,2512695084,-47171101
1645511752,197846,true,2559098379,28,2512695084,-46403295
1645511756,197851,true,2557819214,28,2512695084,-45124130
1645511979,197853,true,2557307727,28,2513197648,-44110079
1645512007,197853,true,2557307727,28,2513197648,-44110079
1645513063,197854,true,2557052021,28,2518732492,-38319529
1645513548,197860,true,2555518327,28,2522765488,-32752839
1645514140,197862,true,2555007300,28,2525289389,-29717911
1645514178,197862,true,2555007300,28,2525289389,-29717911
1645514260,197863,true,2554751825,28,2525541918,-29209907
1645514295,197869,true,2553219510,28,2525541918,-27677592
1645514342,197872,true,2552453697,28,2525541918,-26911779
1645514385,197872,true,2552453697,28,2525289389,-27164308
1645514414,197874,true,2551943283,28,2525289389,-26653894
1645514440,197881,true,2550157637,28,2525289389,-24868248
1645514516,197884,true,2549392743,28,2525036886,-24355857
1645514537,197884,true,2549392743,28,2525036886,-24355857
1645514837,197885,true,2549137829,28,2524027123,-25110706
1645515949,197891,true,2547608882,28,2517473504,-30135378
1645515972,197894,true,2546844752,28,2517473504,-29371248
1645515978,197894,true,2546844752,28,2517473504,-29371248
1645516379,197895,true,2546590093,28,2517473504,-29116589
1645516486,197900,true,2545317180,28,2517725251,-27591929
1645516836,197903,true,2544553737,28,2518732492,-25821245
1645517231,197902,true,2544808193,28,2519740136,-25068057
1645517286,197903,true,2544553737,28,2519992110,-24561627
1645517402,197908,true,2543281842,28,2520496134,-22785708
1645517545,197911,true,2542519010,28,2521252359,-21266651
1645518283,197909,true,2543027539,28,2526299657,-16727882
1645518458,197910,true,2542773262,28,2527563059,-15210203
1645518536,197916,true,2541248132,28,2528068597,-13179535
1645518548,197918,true,2540739958,28,2528068597,-12671361
1645518562,197918,true,2540739958,28,2528321404,-12418554
1645519822,197919,true,2540485910,28,2536678228,-3807682
1645519973,197925,true,2538962152,28,2537185589,-1776563
1645520028,197928,true,2538200615,28,2537439307,-761308
1645520226,197928,true,2538200615,28,2538200615,0
1645520516,197928,true,2538200615,28,2540994032,2793417
1645520764,197933,true,2536931896,28,2543027539,6095643
1645520874,197936,true,2536170968,28,2543790524,7619556
1645521837,197935,true,2536424585,28,2550412653,13988068
1645521881,197935,true,2536424585,28,2550667694,14243109
1645521987,197940,true,2535156753,28,2551177853,16021100
1645522126,197941,true,2534903263,28,2550922761,16019498
1645522498,197941,true,2534903263,28,2549392743,14489480
1645522513,197940,true,2535156753,28,2549392743,14235990
1645523139,197945,true,2533889555,28,2549392743,15503188
1645523574,197946,true,2533636192,28,2549647682,16011490
1645524119,197945,true,2533889555,28,2550667694,16778139
1645524196,197944,true,2534142944,28,2550922761,16779817
1645524211,197948,true,2533129540,28,2550922761,17793221
1645524814,197950,true,2532622990,28,2549902647,17279657
1645524909,197949,true,2532876253,28,2549902647,17026394
1645524921,197948,true,2533129540,28,2549902647,16773107
1645525289,197951,true,2532369753,28,2550667694,18297941
1645525321,197953,true,2531863355,28,2550667694,18804339
1645525353,197951,true,2532369753,28,2550922761,18553008
1645525361,197950,true,2532622990,28,2550922761,18299771
1645525401,197953,true,2531863355,28,2551177853,19314498
1645525427,197953,true,2531863355,28,2551177853,19314498
1645525480,197951,true,2532369753,28,2551688114,19318361
1645525543,197950,true,2532622990,28,2552198478,19575488
1645525573,197951,true,2532369753,28,2552708943,20339190
1645525599,197951,true,2532369753,28,2552964214,20594461
1645526301,197947,true,2533382853,28,2564734311,31351458
1645526413,197945,true,2533889555,28,2567043495,33153940
1645526420,197946,true,2533636192,28,2567300200,33664008
1645526454,197945,true,2533889555,28,2568070467,34180912
1645526471,197941,true,2534903263,28,2568327274,33424011
1645526595,197938,true,2535663810,28,2571668103,36004293
1645526623,197937,true,2535917376,28,2572182463,36265087
1645527019,197937,true,2535917376,28,2580168201,44250825
1645527076,197932,true,2537185589,28,2581200423,44014834
1645527107,197930,true,2537693051,28,2581974860,44281809
1645527210,197929,true,2537946821,28,2583782785,45835964
1645527236,197927,true,2538454435,28,2584299567,45845132
1645527779,197922,true,2539723916,28,2589991000,50267084
1645528232,197919,true,2540485910,28,2593878707,53392797
1645528611,197918,true,2540739958,28,2594656949,53916991
1645529181,197917,true,2540994032,28,2595175906,54181874
1645529342,197912,true,2542264783,28,2594916414,52651631
1645529437,197909,true,2543027539,28,2594656949,51629410
1645529853,197908,true,2543281842,28,2592841415,49559573
1645530250,197908,true,2543281842,28,2591027152,47745310
1645530470,197903,true,2544553737,28,2590249999,45696262
1645530475,197900,true,2545317180,28,2590249999,44932819
1645530482,197900,true,2545317180,28,2590249999,44932819
1645530497,197899,true,2545571711,28,2590249999,44678288
1645530616,197894,true,2546844752,28,2589991000,43146248
1645531278,197891,true,2547608882,28,2589214158,41605276
1645531342,197891,true,2547608882,28,2589214158,41605276
1645531367,197890,true,2547863643,28,2589214158,41350515
1645531421,197885,true,2549137829,28,2588955263,39817434
1645531961,197884,true,2549392743,28,2586109120,36716377
1645531965,197882,true,2549902647,28,2586109120,36206473
1645532009,197882,true,2549902647,28,2585850535,35947888
1645532035,197877,true,2551177853,28,2585850535,34672682
1645532069,197875,true,2551688114,28,2585850535,34162421
1645532084,197874,true,2551943283,28,2585850535,33907252
1645532105,197873,true,2552198478,28,2585850535,33652057
1645532194,197869,true,2553219510,28,2586109120,32889610
1645532212,197867,true,2553730180,28,2586109120,32378940
1645532238,197866,true,2553985553,28,2586367731,32382178
1645532346,197865,true,2554240951,28,2587402433,33161482
1645532377,197860,true,2555518327,28,2587661173,32142846
1645532394,197857,true,2556285059,28,2587661173,31376114
1645532519,197855,true,2556796342,28,2589214158,32417816
1645532762,197852,true,2557563457,28,2592582157,35018700
1645533089,197847,true,2558842495,28,2596993074,38150579
1645533126,197844,true,2559610224,28,2597512499,37902275
1645533372,197841,true,2560378184,28,2601671637,41293453
1645533419,197838,true,2561146375,28,2602452217,41305842
1645533469,197833,true,2562427204,28,2603233031,40805827
1645534892,197831,true,2562939715,28,2604014079,41074364
1645535268,197828,true,2563708674,28,2602972733,39264059
1645535374,197826,true,2564221441,28,2602712462,38491021
1645535408,197821,true,2565503808,28,2602452217,36948409
1645535523,197820,true,2565760359,28,2602191998,36431639
1645535669,197818,true,2566273536,28,2601411496,35137960
1645535890,197816,true,2566786817,28,2600111181,33324364
1645536412,197812,true,2567813685,28,2594916414,27102729
1645537023,197811,true,2568070467,28,2588955263,20884796
1645537591,197810,true,2568327274,28,2586109120,17781846
1645537639,197807,true,2569097849,28,2586109120,17011271
1645537911,197803,true,2570125642,28,2586626368,16500726
1645538180,197802,true,2570382655,28,2587919939,17537284
1645538194,197799,true,2571153847,28,2587919939,16766092
1645538208,197797,true,2571668103,28,2588178731,16510628
1645538242,197792,true,2572954195,28,2588437549,15483354
1645538244,197790,true,2573468811,28,2588437549,14968738
1645538268,197787,true,2574240929,28,2588696393,14455464
1645538329,197785,true,2574755803,28,2589473080,14717277
1645538337,197780,true,2576043438,28,2589732027,13688589
1645538415,197777,true,2576816329,28,2590768075,13951746
1645538582,197775,true,2577331718,28,2593360009,16028291
1645538717,197772,true,2578104995,28,2595435424,17330429
1645539259,197767,true,2579394305,28,2601671637,22277332
1645539286,197765,true,2579910210,28,2601931804,22021594
1645539322,197763,true,2580426217,28,2602191998,21765781
1645539330,197760,true,2581200423,28,2602191998,20991575
1645539406,197758,true,2581716689,28,2602712462,20995773
1645540365,197756,true,2582233058,28,2599591236,17358178
1645540401,197754,true,2582749530,28,2599071396,16321866
1645540622,197752,true,2583266106,28,2595694967,12428861
1645540631,197750,true,2583782785,28,2595435424,11652639
1645540640,197750,true,2583782785,28,2595435424,11652639
1645540939,197747,true,2584557997,28,2593878707,9320710
1645540963,197744,true,2585333442,28,2593878707,8545265
1645540999,197741,true,2586109120,28,2593619345,7510225
1645541019,197742,true,2585850535,28,2593619345,7768810
1645541232,197739,true,2586626368,28,2594656949,8030581
1645541264,197736,true,2587402433,28,2594916414,7513981
1645541288,197734,true,2587919939,28,2595175906,7255967
1645541295,197735,true,2587661173,28,2595175906,7514733
1645541494,197729,true,2589214158,28,2598811515,9597357
1645541578,197725,true,2590249999,28,2600371192,10121193
1645541584,197723,true,2590768075,28,2600371192,9603117
1645541615,197724,true,2590509024,28,2601151381,10642357
1645541721,197717,true,2592322925,28,2604274480,11951555
1645541744,197713,true,2593360009,28,2605055841,11695832
1645542024,197709,true,2594397509,28,2613666294,19268785
1645542062,197710,true,2594138095,28,2614973388,20835293
1645542077,197703,true,2595954537,28,2615234886,19280349
1645542163,197699,true,2596993074,28,2617589539,20596465
1645542319,197696,true,2597772250,28,2622567437,24795187
1645542853,197698,true,2597252774,28,2634921897,37669123
1645542985,197691,true,2599071396,28,2637294275,38222879
1645543030,197688,true,2599851195,28,2638085543,38234348
1645543216,197685,true,2600631229,28,2639932757,39301528
1645543253,197686,true,2600371192,28,2640460770,40089578
1645543261,197680,true,2601931804,28,2640460770,38528966
1645543328,197676,true,2602972733,28,2641252987,38280254
1645543470,197673,true,2603753703,28,2642838135,39084432
1645543995,197674,true,2603493354,28,2644159819,40666465
1645544089,197668,true,2605055841,28,2644688677,39632836
1645544226,197665,true,2605837435,28,2645482163,39644728
1645544365,197663,true,2606358629,28,2646275887,39917258
1645544430,197665,true,2605837435,28,2646540515,40703080
1645544535,197659,true,2607401329,28,2646540515,39139186
1645545308,197657,true,2607922835,28,2642573878,34651043
1645545321,197656,true,2608183627,28,2642309647,34126020
1645545359,197659,true,2607401329,28,2641781264,34379935
1645546057,197654,true,2608705290,28,2632814908,24109618
1645546084,197652,true,2609227057,28,2632288424,23061367
1645546091,197651,true,2609487980,28,2632288424,22800444
1645546547,197655,true,2608444446,28,2623616622,15172176
1645546571,197652,true,2609227057,28,2623354286,14127229
1645546581,197651,true,2609487980,28,2623091977,13603997
1645546615,197650,true,2609748929,28,2622305207,12556278
1645546670,197655,true,2608444446,28,2621256547,12812101
1645547208,197652,true,2609227057,28,2610270905,1043848
1645548022,197650,true,2609748929,28,2599851195,-9897734
1645548630,197650,true,2609748929,28,2599331303,-10417626
1645548635,197654,true,2608705290,28,2599331303,-9373987
1645548640,197651,true,2609487980,28,2599331303,-10156677
1645548900,197648,true,2610270905,28,2600371192,-9899713
1645549351,197648,true,2610270905,28,2600631229,-9639676
1645549543,197652,true,2609227057,28,2600891292,-8335765
1645549607,197649,true,2610009904,28,2601151381,-8858523
1645550052,197646,true,2610792985,28,2602191998,-8600987
1645550190,197646,true,2610792985,28,2602191998,-8600987
1645550222,197650,true,2609748929,28,2601931804,-7817125
1645550527,197648,true,2610270905,28,2600891292,-9379613
1645550563,197646,true,2610792985,28,2600631229,-10161756
1645551405,197646,true,2610792985,28,2596214132,-14578853
1645552955,197648,true,2610270905,28,2596733401,-13537504
1645552963,197645,true,2611054064,28,2596733401,-14320663
1645553016,197644,true,2611315170,28,2596733401,-14581769
1645553277,197643,true,2611576301,28,2596733401,-14842900
1645555211,197647,true,2610531932,28,2592841415,-17690517
1645555243,197644,true,2611315170,28,2593100699,-18214471
1645555932,197642,true,2611837459,28,2598551660,-13285799
1645555940,197642,true,2611837459,28,2598551660,-13285799
1645555981,197645,true,2611054064,28,2598811515,-12242549
1645556041,197642,true,2611837459,28,2599071396,-12766063
1645556052,197641,true,2612098643,28,2599071396,-13027247
1645556321,197643,true,2611576301,28,2600371192,-11205109
1645556404,197645,true,2611054064,28,2600891292,-10162772
1645556575,197643,true,2611576301,28,2601151381,-10424920
1645556647,197643,true,2611576301,28,2601411496,-10164805
1645557343,197645,true,2611054064,28,2599071396,-11982668
1645557518,197648,true,2610270905,28,2598032027,-12238878
1645557568,197646,true,2610792985,28,2597512499,-13280486
1645557612,197646,true,2610792985,28,2597512499,-13280486
1645557639,197647,true,2610531932,28,2597252774,-13279158
1645557869,197649,true,2610009904,28,2596993074,-13016830
1645557886,197646,true,2610792985,28,2596993074,-13799911
1645557895,197646,true,2610792985,28,2596993074,-13799911
1645558315,197647,true,2610531932,28,2598291831,-12240101
1645558325,197648,true,2610270905,28,2598551660,-11719245
1645558427,197645,true,2611054064,28,2599331303,-11722761
1645558620,197644,true,2611315170,28,2601411496,-9903674
1645558640,197644,true,2611315170,28,2601411496,-9903674
1645558907,197644,true,2611315170,28,2605576878,-5738292
1645559099,197641,true,2612098643,28,2608183627,-3915016
1645559203,197640,true,2612359853,28,2609227057,-3132796
1645559333,197639,true,2612621088,28,2610270905,-2350183
1645559404,197640,true,2612359853,28,2611054064,-1305789
1645559592,197637,true,2613143639,28,2612882351,-261288
1645559622,197636,true,2613404953,28,2613143639,-261314
1645559854,197636,true,2613404953,28,2616019535,2614582
1645560065,197637,true,2613143639,28,2619160485,6016846
1645560093,197634,true,2613927660,28,2619422401,5494741
1645560254,197633,true,2614189053,28,2621780825,7591772
1645560332,197632,true,2614450472,28,2622829694,8379222
1645561192,197633,true,2614189053,28,2632551652,18362599
1645561226,197631,true,2614711917,28,2632814908,18102991
1645561327,197630,true,2614973388,28,2633604831,18631443
1645561355,197629,true,2615234886,28,2633604831,18369945
1645561399,197630,true,2614973388,28,2633868192,18894804
1645561728,197628,true,2615496409,28,2632814908,17318499
1645561827,197628,true,2615496409,28,2632288424,16792015
1645562302,197626,true,2616019535,28,2627029371,11009836
1645562540,197627,true,2615757959,28,2623878983,8121024
1645562583,197625,true,2616281136,28,2623354286,7073150
1645562611,197624,true,2616542765,28,2622829694,6286929
1645563001,197623,true,2616804419,28,2616281136,-523283
1645563706,197624,true,2616542765,28,2608183627,-8359138
1645564082,197623,true,2616804419,28,2606358629,-10445790
1645564224,197623,true,2616804419,28,2606098019,-10706400
1645564512,197622,true,2617066099,28,2606619265,-10446834
1645565410,197622,true,2617066099,28,2611054064,-6012035
1645566757,197622,true,2617066099,28,2614189053,-2877046
1645567060,197622,true,2617066099,28,2614450472,-2615627
1645567357,197621,true,2617327806,28,2614189053,-3138753
1645567494,197622,true,2617066099,28,2614189053,-2877046
1645567565,197623,true,2616804419,28,2613927660,-2876759
1645567747,197624,true,2616542765,28,2613666294,-2876471
1645568283,197623,true,2616804419,28,2613143639,-3660780
1645568298,197623,true,2616804419,28,2612882351,-3922068
1645568546,197627,true,2615757959,28,2612098643,-3659316
1645568592,197629,true,2615234886,28,2611837459,-3397427
1645568620,197629,true,2615234886,28,2611837459,-3397427
1645569402,197630,true,2614973388,28,2606619265,-8354123
1645570013,197633,true,2614189053,28,2602972733,-11216320
1645571145,197635,true,2613666294,28,2601151381,-12514913
1645571153,197634,true,2613927660,28,2601151381,-12776279
1645571172,197635,true,2613666294,28,2601151381,-12514913
1645571321,197638,true,2612882351,28,2601671637,-11210714
1645571385,197639,true,2612621088,28,2601671637,-10949451
1645571423,197639,true,2612621088,28,2601931804,-10689284
1645571578,197639,true,2612621088,28,2602972733,-9648355
1645571690,197642,true,2611837459,28,2603493354,-8344105
1645571787,197643,true,2611576301,28,2604274480,-7301821
1645571851,197644,true,2611315170,28,2604795361,-6519809
1645572002,197644,true,2611315170,28,2605837435,-5477735
1645572255,197647,true,2610531932,28,2608183627,-2348305
1645572547,197648,true,2610270905,28,2611054064,783159
1645572626,197648,true,2610270905,28,2612098643,1827738
1645572669,197648,true,2610270905,28,2612882351,2611446
1645573302,197650,true,2609748929,28,2622829694,13080765
1645573401,197649,true,2610009904,28,2624141371,14131467
1645573481,197648,true,2610270905,28,2625453704,15182799
1645574272,197647,true,2610531932,28,2638877048,28345116
1645574289,197648,true,2610270905,28,2639140935,28870030
1645574531,197646,true,2610792985,28,2641517112,30724127
1645574768,197646,true,2610792985,28,2642045442,31252457
1645574814,197644,true,2611315170,28,2642045442,30730272
1645574832,197643,true,2611576301,28,2642309647,30733346
1645574861,197642,true,2611837459,28,2642309647,30472188
1645574923,197641,true,2612098643,28,2642573878,30475235
1645575730,197638,true,2612882351,28,2644424235,31541884
1645576315,197636,true,2613404953,28,2643631066,30226113
1645576392,197635,true,2613666294,28,2643631066,29964772
1645576436,197635,true,2613666294,28,2643366729,29700435
1645577993,197633,true,2614189053,28,2631762045,17572992
1645578084,197632,true,2614450472,28,2631235771,16785299
1645578154,197631,true,2614711917,28,2630709603,15997686
1645578184,197631,true,2614711917,28,2630446559,15734642
1645580423,197630,true,2614973388,28,2623616622,8643234
1645580838,197629,true,2615234886,28,2623354286,8119400
1645582089,197629,true,2615234886,28,2619946312,4711426
1645582101,197628,true,2615496409,28,2619946312,4449903
1645582164,197628,true,2615496409,28,2619946312,4449903
1645582180,197626,true,2616019535,28,2619946312,3926777
1645582193,197625,true,2616281136,28,2619946312,3665176
1645582211,197624,true,2616542765,28,2619946312,3403547
1645582271,197623,true,2616804419,28,2620208306,3403887
1645582401,197622,true,2617066099,28,2620732374,3666275
1645582418,197620,true,2617589539,28,2620994448,3404909
1645582447,197619,true,2617851298,28,2620994448,3143150
1645582466,197618,true,2618113083,28,2621256547,3143464
1645582491,197616,true,2618636732,28,2621518673,2881941
1645582558,197614,true,2619160485,28,2622305207,3144722
1645582968,197613,true,2619422401,28,2628605982,9183581
1645583017,197613,true,2619422401,28,2629394643,9972242
1645583030,197610,true,2620208306,28,2629394643,9186337
1645583081,197608,true,2620732374,28,2629920548,9188174
1645583340,197608,true,2620732374,28,2631762045,11029671
1645583352,197608,true,2620732374,28,2631762045,11029671
1645583418,197606,true,2621256547,28,2632288424,11031877
1645583496,197604,true,2621780825,28,2632551652,10770827
1645584196,197605,true,2621518673,28,2631762045,10243372
1645584225,197605,true,2621518673,28,2631498895,9980222
1645584300,197602,true,2622305207,28,2630446559,8141352
1645584547,197601,true,2622567437,28,2625716250,3148813
1645585539,197603,true,2622043003,28,2613666294,-8376709
1645587386,197603,true,2622043003,28,2611054064,-10988939
1645588327,197601,true,2622567437,28,2612882351,-9685086
1645588571,197600,true,2622829694,28,2613404953,-9424741
1645588759,197601,true,2622567437,28,2614189053,-8378384
1645589099,197602,true,2622305207,28,2615757959,-6547248
1645589243,197599,true,2623091977,28,2616804419,-6287558
1645589281,197598,true,2623354286,28,2616804419,-6549867
1645589568,197600,true,2622829694,28,2618898595,-3931099
1645589604,197600,true,2622829694,28,2619160485,-3669209
1645589863,197598,true,2623354286,28,2621518673,-1835613
1645589910,197596,true,2623878983,28,2622043003,-1835980
1645590080,197598,true,2623354286,28,2623616622,262336
1645590111,197598,true,2623354286,28,2624141371,787085
1645591066,197595,true,2624141371,28,2632551652,8410281
1645591227,197594,true,2624403785,28,2633341497,8937712
1645591244,197596,true,2623878983,28,2633604831,9725848
1645591290,197597,true,2623616622,28,2633868192,10251570
1645591329,197594,true,2624403785,28,2634131578,9727793
1645591348,197593,true,2624666226,28,2634394992,9728766
1645591487,197595,true,2624141371,28,2635712453,11571082
1645591492,197596,true,2623878983,28,2635712453,11833470
1645591645,197592,true,2624928692,28,2637558005,12629313
1645592584,197591,true,2625191185,28,2646275887,21084702
1645592661,197593,true,2624666226,28,2647069849,22403623
1645593633,197593,true,2624666226,28,2653695471,29029245
1645594111,197589,true,2625716250,28,2654491659,28775409
1645595912,197586,true,2626504043,28,2653430128,26926085
1645596101,197588,true,2625978821,28,2653960841,27982020
1645596221,197588,true,2625978821,28,2654491659,28512838
1645597049,197583,true,2627292073,28,2661668112,34376039
1645598749,197579,true,2628343148,28,2669130852,40787704
1645600463,197580,true,2628080340,28,2666196569,38116229
1645600585,197579,true,2628343148,28,2666196569,37853421
1645600650,197574,true,2629657582,28,2666196569,36538987
1645601824,197571,true,2630446559,28,2669931672,39485113
1645601918,197571,true,2630446559,28,2670465685,40019126
1645602622,197570,true,2630709603,28,2679828221,49118618
1645603085,197565,true,2632025221,28,2685461492,53436271
1645603126,197560,true,2633341497,28,2685998611,52657114
1645603181,197561,true,2633078189,28,2686535838,53457649
1645604514,197559,true,2633604831,28,2692452426,58847595
1645604603,197554,true,2634921897,28,2692452426,57530529
1645604717,197549,true,2636239621,28,2692721672,56482051
1645604757,197550,true,2635976024,28,2692990944,57014920
1645604867,197548,true,2636503245,28,2693798922,57295677
1645604920,197542,true,2638085543,28,2694337709,56252166
1645606117,197536,true,2639668790,28,2707571699,67902909
1645606142,197536,true,2639668790,28,2707842456,68173666
1645607412,197533,true,2640460770,28,2708384051,67923281
1645607479,197528,true,2641781264,28,2708113240,66331976
1645607497,197522,true,2643366729,28,2708113240,64746511
1645607506,197521,true,2643631066,28,2708113240,64482174
1645607527,197519,true,2644159819,28,2708113240,63953421
1645607580,197513,true,2645746711,28,2708113240,62366529
1645607621,197507,true,2647334556,28,2708384051,61049495
1645609497,197506,true,2647599290,28,2722231398,74632108
1645609507,197503,true,2648393649,28,2722231398,73837749
1645609658,197498,true,2649718110,28,2722231398,72513288
1645610494,197492,true,2651308339,28,2721142778,69834439
1645610610,197492,true,2651308339,28,2720870691,69562352
1645610615,197489,true,2652103811,28,2720870691,68766880
1645610676,197484,true,2653430128,28,2720598631,67168503
1645610853,197479,true,2654757108,28,2720054593,65297485
1645610980,197478,true,2655022584,28,2719782615,64760031
1645611004,197476,true,2655553615,28,2719510664,63957049
1645612016,197473,true,2656350361,28,2713534615,57184254
1645612459,197468,true,2657678802,28,2711364764,53685962
1645612618,197468,true,2657678802,28,2711093654,53414852
1645612622,197467,true,2657944570,28,2711093654,53149084
1645612670,197464,true,2658742033,28,2711093654,52351621
1645612731,197459,true,2660071670,28,2711093654,51021984
1645613802,197459,true,2660071670,28,2714348757,54277087
1645615565,197457,true,2660603711,28,2716249371,55645660
1645615604,197454,true,2661401972,28,2716520996,55119024
1645615737,197449,true,2662732939,28,2716792648,54059709
1645615825,197449,true,2662732939,28,2717064327,54331388
1645615838,197447,true,2663265512,28,2717336034,54070522
1645616472,197443,true,2664330978,28,2719782615,55451637
1645616556,197438,true,2665663410,28,2720326598,54663188
1645616579,197438,true,2665663410,28,2720326598,54663188
1645616604,197435,true,2666463189,28,2720598631,54135442
1645616859,197430,true,2667796687,28,2722231398,54434711
1645616950,197425,true,2669130852,28,2723048149,53917297
1645617319,197425,true,2669130852,28,2725772423,56641571
1645617398,197421,true,2670198665,28,2726317605,56118940
1645617422,197416,true,2671534031,28,2726590237,55056206
1645618332,197411,true,2672870065,28,2727681036,54810971
1645619212,197411,true,2672870065,28,2726590237,53720172
1645619607,197407,true,2673939374,28,2726590237,52650863
1645619703,197402,true,2675276611,28,2726590237,51313626
1645619777,197397,true,2676614517,28,2726862896,50248379
1645620166,197396,true,2676882178,28,2728499423,51617245
1645620235,197392,true,2677953092,28,2729045150,51092058
1645620336,197388,true,2679024434,28,2729590986,50566552
1645620340,197383,true,2680364214,28,2729590986,49226772
1645621803,197382,true,2680632250,28,2740530668,59898418
1645622479,197378,true,2681704664,28,2742723860,61019196
1645622675,197374,true,2682777507,28,2743272432,60494925
1645622879,197370,true,2683850779,28,2743546759,59695980
1645623303,197369,true,2684119164,28,2743821114,59701950
1645623934,197365,true,2685192973,28,2742998132,57805159
1645624286,197361,true,2686267211,28,2742175397,55908186
1645625324,197357,true,2687341879,28,2739160814,51818935
1645625471,197355,true,2687879374,28,2738613064,50733690
1645625646,197351,true,2688954687,28,2737517892,48563205
1645625699,197347,true,2690030430,28,2737244168,47213738
1645625704,197344,true,2690837520,28,2737244168,46406648
1645625727,197341,true,2691644852,28,2736970471,45325619
1645625731,197337,true,2692721672,28,2736970471,44248799
1645627177,197333,true,2693798922,28,2727408296,33609374
1645627964,197329,true,2694876603,28,2727408296,32531693
1645628050,197325,true,2695954716,28,2727408296,31453580
1645628088,197321,true,2697033259,28,2727135582,30102323
1645628550,197318,true,2697842450,28,2723865146,26022696
1645628562,197315,true,2698651884,28,2723865146,25213262
1645628934,197312,true,2699461560,28,2719782615,20321055
1645628947,197309,true,2700271480,28,2719782615,19511135
1645629094,197306,true,2701081642,28,2717607767,16526125
1645629882,197304,true,2701621886,28,2707030265,5408379
1645629941,197301,true,2702432453,28,2706488941,4056488
1645631801,197299,true,2702972967,28,2696763583,-6209384
1645632399,197297,true,2703513588,28,2696493933,-7019655
1645632463,197295,true,2704054318,28,2696224311,-7830007
1645632470,197292,true,2704865615,28,2696224311,-8641304
1645632567,197290,true,2705406616,28,2695954716,-9451900
1645632616,197289,true,2705677156,28,2695954716,-9722440
1645632627,197287,true,2706218319,28,2695954716,-10263603
1645632769,197285,true,2706759589,28,2695415605,-11343984
1645633105,197283,true,2707300968,28,2693798922,-13502046
1645633644,197282,true,2707571699,28,2691375715,-16195984
1645633889,197281,true,2707842456,28,2690568463,-17273993
1645633902,197279,true,2708384051,28,2690568463,-17815588
1645633956,197277,true,2708925755,28,2690568463,-18357292
1645634202,197276,true,2709196648,28,2691106604,-18090044
1645634242,197274,true,2709738514,28,2691106604,-18631910
1645634409,197272,true,2710280489,28,2692183208,-18097281
1645634429,197271,true,2710551517,28,2692452426,-18099091
1645634441,197269,true,2711093654,28,2692452426,-18641228
1645635434,197267,true,2711635900,28,2702972967,-8662933
1645636487,197265,true,2712178255,28,2707571699,-4606556
1645636539,197264,true,2712449472,28,2707842456,-4607016
1645636580,197263,true,2712720717,28,2707842456,-4878261
1645636886,197262,true,2712991989,28,2710009488,-2982501
1645637521,197258,true,2714077349,28,2715163143,1085794
1645637552,197257,true,2714348757,28,2715434659,1085902
1645637658,197256,true,2714620192,28,2715977773,1357581
1645637680,197255,true,2714891654,28,2715977773,1086119
1645637683,197252,true,2715706203,28,2715977773,271570
1645637737,197252,true,2715706203,28,2715977773,271570
1645637741,197252,true,2715706203,28,2715977773,271570
1645637939,197253,true,2715434659,28,2715977773,543114
1645638022,197250,true,2716249371,28,2715977773,-271598
1645638046,197250,true,2716249371,28,2715706203,-543168
1645638056,197250,true,2716249371,28,2715706203,-543168
1645638333,197251,true,2715977773,28,2714891654,-1086119
1645638615,197249,true,2716520996,28,2711635900,-4885096
1645638633,197250,true,2716249371,28,2711364764,-4884607
1645638643,197250,true,2716249371,28,2711364764,-4884607
1645638662,197253,true,2715434659,28,2711093654,-4341005
1645638683,197252,true,2715706203,28,2710551517,-5154686
1645638705,197252,true,2715706203,28,2710280489,-5425714
1645638745,197253,true,2715434659,28,2709467567,-5967092
1645638751,197256,true,2714620192,28,2709196648,-5423544
1645638792,197255,true,2714891654,28,2708384051,-6507603
1645638939,197257,true,2714348757,28,2704595156,-9753601
1645638973,197258,true,2714077349,28,2703783940,-10293409
1645638994,197261,true,2713263289,28,2703243264,-10020025
1645639035,197261,true,2713263289,28,2702162237,-11101052
1645639046,197263,true,2712720717,28,2701892048,-10828669
1645639492,197265,true,2712178255,28,2690030430,-22147825
1645639537,197267,true,2711635900,28,2689223583,-22412317
1645639596,197267,true,2711635900,28,2687879374,-23756526
1645639732,197269,true,2711093654,28,2684924480,-26169174
1645639903,197272,true,2710280489,28,2681168404,-29112085
1645639948,197274,true,2709738514,28,2680096204,-29642310
1645639985,197274,true,2709738514,28,2679024434,-30714080
1645639991,197276,true,2709196648,28,2679024434,-30172214
1645640012,197279,true,2708384051,28,2678220887,-30163164
1645640111,197282,true,2707571699,28,2675544139,-32027560
1645640860,197282,true,2707571699,28,2660603711,-46967988
1645641290,197284,true,2707030265,28,2655288086,-51742179
1645641936,197287,true,2706218319,28,2650248081,-55970238
1645642295,197290,true,2705406616,28,2650248081,-55158535
1645642580,197291,true,2705136102,28,2649983082,-55153020
1645643057,197293,true,2704595156,28,2650513105,-54082051
1645643281,197296,true,2703783940,28,2650778157,-53005783
1645643526,197299,true,2702972967,28,2651308339,-51664628
1645643808,197299,true,2702972967,28,2652103811,-50869156
1645643900,197302,true,2702162237,28,2652103811,-50058426
1645643922,197305,true,2701351750,28,2652103811,-49247939
1645643977,197308,true,2700541507,28,2652369021,-48172486
1645644260,197308,true,2700541507,28,2653164812,-47376695
1645644337,197311,true,2699731506,28,2653430128,-46301378
1645644705,197315,true,2698651884,28,2653695471,-44956413
1645644749,197318,true,2697842450,28,2653960841,-43881609
1645644867,197318,true,2697842450,28,2653960841,-43881609
1645644916,197321,true,2697033259,28,2653960841,-43072418
1645645234,197325,true,2695954716,28,2653430128,-42524588
1645645259,197328,true,2695146091,28,2653164812,-41981279
1645645324,197329,true,2694876603,28,2652899522,-41977081
1645645343,197332,true,2694068302,28,2652899522,-41168780
1645645395,197337,true,2692721672,28,2652369021,-40352651
1645645450,197340,true,2691914017,28,2651573470,-40340547
1645645451,197341,true,2691644852,28,2651573470,-40071382
1645645500,197345,true,2690568463,28,2651043235,-39525228
1645646587,197350,true,2689223583,28,2636766896,-52456687
1645646623,197354,true,2688148162,28,2636239621,-51908541
1645646667,197356,true,2687610613,28,2635448908,-52161705
1645646804,197360,true,2686535838,28,2633078189,-53457649
1645647317,197367,true,2684656015,28,2624666226,-59989789
1645647923,197371,true,2683582421,28,2620208306,-63374115
1645647954,197373,true,2683045785,28,2619946312,-63099473
1645648007,197377,true,2681972834,28,2619684343,-62288491
1645648027,197384,true,2680096204,28,2619684343,-60411861
1645648262,197386,true,2679560265,28,2619422401,-60137864
1645648273,197388,true,2679024434,28,2619422401,-59602033
1645649269,197391,true,2678220887,28,2627029371,-51191516
1645649401,197398,true,2676346882,28,2628080340,-48266542
1645650184,197399,true,2676079274,28,2630709603,-45369671
1645650228,197401,true,2675544139,28,2630709603,-44834536
1645651214,197404,true,2674741636,28,2628080340,-46661296
1645651395,197411,true,2672870065,28,2627817558,-45052507
1645652509,197412,true,2672602805,28,2630446559,-42156246
1645652527,197414,true,2672068365,28,2630446559,-41621806
1645652599,197417,true,2671266905,28,2630183540,-41083365
1645653333,197424,true,2669397765,28,2626766694,-42631071
1645653391,197425,true,2669130852,28,2626504043,-42626809
1645654435,197426,true,2668863966,28,2619684343,-49179623
1645654479,197429,true,2668063467,28,2619684343,-48379124
1645654531,197435,true,2666463189,28,2619422401,-47040788
1645654562,197437,true,2665929976,28,2619422401,-46507575
1645654624,197438,true,2665663410,28,2619160485,-46502925
1645655043,197441,true,2664863871,28,2616804419,-48059452
1645655191,197447,true,2663265512,28,2616019535,-47245977
1645655299,197448,true,2662999212,28,2615496409,-47502803
1645655320,197450,true,2662466692,28,2615496409,-46970283
1645655519,197452,true,2661934279,28,2614973388,-46960891
1645655582,197458,true,2660337677,28,2614973388,-45364289
1645655804,197458,true,2660337677,28,2614973388,-45364289
1645655848,197460,true,2659805689,28,2614973388,-44832301
1645655934,197461,true,2659539735,28,2615496409,-44043326
1645657758,197466,true,2658210364,28,2630183540,-28026824
1645657873,197466,true,2658210364,28,2630183540,-28026824
1645657898,197468,true,2657678802,28,2629920548,-27758254
1645657911,197469,true,2657413061,28,2629920548,-27492513
1645657948,197475,true,2655819171,28,2629657582,-26161589
1645658020,197477,true,2655288086,28,2628868843,-26419243
1645658028,197480,true,2654491659,28,2628868843,-25622816
1645658035,197481,true,2654226237,28,2628605982,-25620255
1645658076,197488,true,2652369021,28,2628080340,-24288681
1645658260,197492,true,2651308339,28,2624403785,-26904554
1645658281,197494,true,2650778157,28,2624141371,-26636786
1645658348,197497,true,2649983082,28,2622567437,-27415645
1645658357,197504,true,2648128836,28,2622305207,-25823629
1645658415,197508,true,2647069849,28,2620994448,-26075401
1645658839,197512,true,2646011286,28,2611315170,-34696116
1645659761,197514,true,2645482163,28,2591804538,-53677625
1645660164,197521,true,2643631066,28,2590509024,-53122042
1645660706,197526,true,2642309647,28,2591286255,-51023392
1645660787,197529,true,2641517112,28,2591286255,-50230857
1645660809,197531,true,2640988888,28,2591286255,-49702633
1645660831,197537,true,2639404849,28,2591286255,-48118594
1645660839,197542,true,2638085543,28,2591027152,-47058391
1645660887,197546,true,2637030572,28,2591027152,-46003420
1645660911,197547,true,2636766896,28,2590768075,-45998821
1645660927,197554,true,2634921897,28,2590768075,-44153822
1645660982,197558,true,2633868192,28,2590249999,-43618193
1645661161,197563,true,2632551652,28,2588696393,-43855259
1645661447,197564,true,2632288424,28,2586367731,-45920693
1645661562,197571,true,2630446559,28,2585591976,-44854583
1645662156,197575,true,2629394643,28,2582749530,-46645113
1645662318,197578,true,2628605982,28,2581716689,-46889293
1645662357,197579,true,2628343148,28,2581458543,-46884605
1645662436,197585,true,2626766694,28,2580942328,-45824366
1645662539,197589,true,2625716250,28,2580684260,-45031990
1645662635,197591,true,2625191185,28,2580426217,-44764968
1645662767,197592,true,2624928692,28,2580684260,-44244432
1645662804,197598,true,2623354286,28,2580684260,-42670026
1645662994,197602,true,2622305207,28,2581200423,-41104784
1645663123,197605,true,2621518673,28,2580942328,-40576345
1645663519,197606,true,2621256547,28,2579394305,-41862242
1645663923,197611,true,2619946312,28,2577074010,-42872302
1645663988,197615,true,2618898595,28,2576558673,-42339922
1645664034,197618,true,2618113083,28,2576301043,-41812040
1645664314,197619,true,2617851298,28,2574240929,-43610369
1645665631,197625,true,2616281136,28,2569097849,-47183287
1645665637,197628,true,2615496409,28,2569097849,-46398560
1645665658,197631,true,2614711917,28,2569097849,-45614068
1645665733,197632,true,2614450472,28,2568840965,-45609507
1645665765,197637,true,2613143639,28,2568840965,-44302674
1645665781,197640,true,2612359853,28,2568840965,-43518888
1645666038,197643,true,2611576301,28,2568070467,-43505834
1645666061,197644,true,2611315170,28,2568070467,-43244703
1645666128,197649,true,2610009904,28,2567556930,-42452974
1645666133,197652,true,2609227057,28,2567556930,-41670127
1645666968,197656,true,2608183627,28,2562170987,-46012640
1645666984,197657,true,2607922835,28,2562170987,-45751848
1645667054,197662,true,2606619265,28,2561658629,-44960636
1645667155,197665,true,2605837435,28,2561146375,-44691060
1645667215,197669,true,2604795361,28,2560890286,-43905075
1645667442,197669,true,2604795361,28,2559866185,-44929176
1645667449,197674,true,2603493354,28,2559866185,-43627169
1645667456,197678,true,2602452217,28,2559866185,-42586032
1645668376,197681,true,2601671637,28,2562939715,-38731922
1645668915,197682,true,2601411496,28,2565760359,-35651137
1645669478,197687,true,2600111181,28,2567043495,-33067686
1645669607,197690,true,2599331303,28,2567043495,-32287808
1645670810,197693,true,2598551660,28,2567300200,-31251460
1645671102,197693,true,2598551660,28,2567556930,-30994730
1645671116,197698,true,2597252774,28,2567556930,-29695844
1645671159,197701,true,2596473754,28,2567300200,-29173554
1645671192,197704,true,2595694967,28,2567043495,-28651472
1645671237,197705,true,2595435424,28,2566786817,-28648607
1645671266,197709,true,2594397509,28,2566530164,-27867345
1645671281,197713,true,2593360009,28,2566530164,-26829845
1645671297,197715,true,2592841415,28,2566273536,-26567879
1645671347,197717,true,2592322925,28,2566016935,-26305990
1645671356,197720,true,2591545383,28,2565760359,-25785024
1645671365,197724,true,2590509024,28,2565760359,-24748665
1645671381,197727,true,2589732027,28,2565503808,-24228219
1645671402,197729,true,2589214158,28,2564990784,-24223374
1645671424,197732,true,2588437549,28,2564477863,-23959686
1645671428,197736,true,2587402433,28,2564221441,-23180992
1645671502,197740,true,2586367731,28,2562170987,-24196744
1645671541,197744,true,2585333442,28,2560890286,-24443156
1645671599,197747,true,2584557997,28,2558842495,-25715502
1645671620,197752,true,2583266106,28,2558074996,-25191110
1645671650,197757,true,2581974860,28,2557052021,-24922839
1645671737,197762,true,2580684260,28,2553219510,-27464750
1645671842,197766,true,2579652244,28,2548628078,-31024166
1645671847,197772,true,2578104995,28,2548373241,-29731754
1645671871,197777,true,2576816329,28,2547354146,-29462183
1645671925,197782,true,2575528307,28,2544808193,-30720114
1645671963,197787,true,2574240929,28,2543027539,-31213390
1645671966,197792,true,2572954195,28,2542773262,-30180933
1645671973,197797,true,2571668103,28,2542519010,-29149093
1645672096,197803,true,2570125642,28,2536170968,-33954674
1645672104,197808,true,2568840965,28,2535917376,-32923589
1645672118,197812,true,2567813685,28,2534903263,-32910422
1645672120,197818,true,2566273536,28,2534903263,-31370273
1645672127,197825,true,2564477863,28,2534396358,-30081505
1645672208,197829,true,2563452328,28,2529838776,-33613552
1645672255,197834,true,2562170987,28,2527310328,-34860659
1645672481,197839,true,2560890286,28,2514203078,-46687208
1645672659,197845,true,2559354289,28,2504417270,-54937019
1645672842,197850,true,2558074996,28,2494170691,-63904305
1645672872,197854,true,2557052021,28,2492425470,-64626551
1645672909,197859,true,2555773879,28,2490432427,-65341452
1645672934,197866,true,2553985553,28,2488938690,-65046863
1645673074,197871,true,2552708943,28,2481483435,-71225508
1645673092,197876,true,2551432971,28,2480491090,-70941881
1645673337,197882,true,2549902647,28,2470342403,-79560244
1645673379,197889,true,2548118429,28,2468860716,-79257713
1645673382,197896,true,2546335459,28,2468860716,-77474743
1645673462,197902,true,2544808193,28,2466393213,-78414980
1645673493,197908,true,2543281842,28,2465653443,-77628399
1645673519,197916,true,2541248132,28,2464913895,-76334237
1645673571,197922,true,2539723916,28,2463435464,-76288452
1645673631,197926,true,2538708281,28,2461711748,-76996533
1645673681,197933,true,2536931896,28,2460235238,-76696658
1645673797,197940,true,2535156753,28,2457284874,-77871879
1645673989,197947,true,2533382853,28,2452865960,-80516893
1645674017,197950,true,2532622990,28,2452130248,-80492742
1645674074,197957,true,2530850863,28,2450904550,-79946313
1645674087,197964,true,2529079976,28,2450414443,-78665533
1645674127,197971,true,2527310328,28,2449434522,-77875806
1645674150,197975,true,2526299657,28,2448699839,-77599818
1645674164,197982,true,2524531954,28,2448210172,-76321782
1645674176,197990,true,2522513237,28,2447720604,-74792633
1645674310,197999,true,2520244110,28,2442586040,-77658070
1645674333,198002,true,2519488188,28,2441853411,-77634777
1645674379,198009,true,2517725251,28,2440388812,-77336439
1645674423,198017,true,2515711977,28,2439168983,-76542994
1645674438,198024,true,2513951683,28,2438681223,-75270460
1645674489,198026,true,2513448968,28,2437705994,-75742974
1645674648,198032,true,2511941426,28,2434052358,-77889068
1645674694,198039,true,2510183770,28,2433078981,-77104789
1645674712,198047,true,2508176527,28,2432592438,-75584089
1645674730,198049,true,2507674967,28,2432105993,-75568974
1645674747,198054,true,2506421505,28,2431619644,-74801861
1645674785,198062,true,2504417270,28,2430647240,-73770030
1645674824,198070,true,2502414637,28,2429675224,-72739413
1645675026,198073,true,2501664063,28,2424578514,-77085549
1645675090,198079,true,2500163590,28,2423124276,-77039314
1645675097,198087,true,2498164359,28,2422881988,-75282371
1645675169,198095,true,2496166726,28,2421186649,-74980077
1645675179,198098,true,2495418026,28,2420944554,-74473472
1645675216,198104,true,2493921299,28,2419976418,-73944881
1645675237,198113,true,2491677892,28,2419492496,-72185396
1645675244,198121,true,2489685446,28,2419492496,-70192950
1645675314,198124,true,2488938690,28,2417557772,-71380918
1645675323,198130,true,2487445849,28,2417316041,-70129808
1645675366,198138,true,2485456788,28,2416349356,-69107432
1645675421,198147,true,2483220995,28,2414658588,-68562407
1645675460,198151,true,2482227955,28,2413210300,-69017655
1645675468,198157,true,2480739139,28,2412969003,-67770136
1645675486,198165,true,2478755440,28,2412486481,-66268959
1645675531,198173,true,2476773328,28,2411521728,-65251600
1645675540,198176,true,2476030445,28,2411521728,-64508717
1645675551,198182,true,2474545346,28,2411280600,-63264746
1645675648,198191,true,2472319369,28,2409111532,-63207837
1645675662,198198,true,2470589437,28,2408870645,-61718792
1645675698,198201,true,2469848409,28,2408148128,-61700281
1645675709,198207,true,2468367018,28,2407907337,-60459681
1645675717,198216,true,2466146598,28,2407666571,-58480027
1645675809,198223,true,2464420986,28,2405741304,-58679682
1645675858,198226,true,2463681807,28,2404779248,-58902559
1645675862,198231,true,2462450336,28,2404538794,-57911542
1645675888,198240,true,2460235238,28,2404057959,-56177279
1645675908,198249,true,2458022133,28,2403817577,-54204556
1645675910,198252,true,2457284874,28,2403577219,-53707655
1645675920,198257,true,2456056600,28,2403577219,-52479381
1645675979,198266,true,2453847254,28,2402375791,-51471463
1645675997,198275,true,2451639895,28,2402135577,-49504318
1645676000,198278,true,2450904550,28,2402135577,-48768973
1645676003,198285,true,2449189603,28,2402135577,-47054026
1645676160,198296,true,2446497110,28,2399014986,-47482124
1645676197,198305,true,2444296364,28,2397815838,-46480526
1645676217,198308,true,2443563221,28,2397096637,-46466584
1645676287,198314,true,2442097596,28,2394940329,-47157267
1645676509,198324,true,2439656841,28,2389199650,-50457191
1645676678,198332,true,2437705994,28,2386334474,-51371520
1645676695,198335,true,2436974828,28,2385857278,-51117550
1645676730,198341,true,2435513155,28,2385380178,-50132977
1645676799,198350,true,2433322289,28,2384426265,-48896024
1645676827,198358,true,2431376507,28,2383949451,-47427056
1645676870,198361,true,2430647240,28,2383234409,-47412831
1645677094,198366,true,2429432280,28,2380138372,-49293908
1645677198,198375,true,2427246884,28,2379424473,-47822411
1645677204,198383,true,2425305960,28,2379424473,-45881487
1645677371,198385,true,2424820972,28,2379424473,-45396499
1645677417,198390,true,2423608925,28,2379186555,-44422370
1645677448,198396,true,2422155268,28,2379186555,-42968713
1645677507,198403,true,2420460438,28,2379424473,-41035965
1645677537,198405,true,2419976418,28,2379662416,-40314002
1645677665,198407,true,2419492496,28,2380614424,-38878072
1645677681,198413,true,2418041308,28,2380852485,-37188823
1645677893,198420,true,2416349356,28,2383234409,-33114947
1645678799,198422,true,2415866159,28,2391829085,-24037074
1645678806,198424,true,2415383058,28,2392068267,-23314791
1645678924,198428,true,2414417146,28,2393503867,-20913279
1645678977,198434,true,2412969003,28,2393982592,-18986411
1645679072,198435,true,2412727730,28,2394461412,-18266318
1645679086,198437,true,2412245257,28,2394461412,-17783845
1645679116,198442,true,2411039496,28,2394700859,-16338637
1645679130,198447,true,2409834338,28,2394700859,-15133479
1645679163,198448,true,2409593378,28,2394940329,-14653049
1645679183,198450,true,2409111532,28,2394940329,-14171203
1645679330,198454,true,2408148128,28,2394461412,-13686716
1645679359,198460,true,2406703745,28,2393982592,-12721153
1645679409,198461,true,2406463099,28,2393503867,-12959232
1645679537,198463,true,2405981878,28,2392785960,-13195918
1645679602,198467,true,2405019726,28,2392307474,-12712252
1645679623,198472,true,2403817577,28,2392068267,-11749310
1645679628,198473,true,2403577219,28,2392068267,-11508952
1645679637,198476,true,2402856290,28,2391829085,-11027205
1645680299,198480,true,2401895388,28,2384903174,-16992214
1645680314,198486,true,2400454755,28,2384664707,-15790048
1645680333,198487,true,2400214733,28,2384426265,-15788468
1645680376,198490,true,2399494813,28,2383711080,-15783733
1645680567,198496,true,2398055620,28,2380138372,-17917248
1645680602,198501,true,2396856952,28,2379424473,-17432479
1645680646,198502,true,2396617290,28,2378235118,-18382172
1645680696,198504,true,2396138038,28,2377046357,-19091681
1645680724,198511,true,2394461412,28,2376095776,-18365636
1645680725,198515,true,2393503867,28,2376095776,-17408091
1645680886,198517,true,2393025238,28,2371585706,-21439532
1645680898,198519,true,2392546705,28,2371111460,-21435245
1645680913,198526,true,2390872592,28,2370637308,-20235284
1645681032,198530,true,2389916482,28,2366847511,-23068971
1645681051,198533,true,2389199650,28,2366374212,-22825438
1645681062,198535,true,2388721882,28,2365901009,-22820873
1645681101,198541,true,2387289151,28,2364481965,-22807186
1645681161,198547,true,2385857278,28,2362118783,-23738495
1645681390,198550,true,2385141664,28,2353630867,-31510797
1645681601,198553,true,2384426265,28,2345407968,-39018297
1645681636,198559,true,2382996110,28,2344001216,-38994894
1645681854,198564,true,2381804969,28,2336279147,-45525822
1645681885,198567,true,2381090570,28,2335111357,-45979213
1645682027,198568,true,2380852485,28,2330679079,-50173406
1645682053,198574,true,2379424473,28,2329980015,-49444458
1645682098,198576,true,2378948660,28,2328582517,-50366143
1645682143,198579,true,2378235118,28,2327418575,-50816543
1645682152,198580,true,2377997318,28,2327185856,-50811462
1645682174,198586,true,2376571019,28,2326953161,-49617858
1645682536,198588,true,2376095776,28,2322304137,-53791639
1645682594,198592,true,2375145575,28,2321839746,-53305829
1645682687,198593,true,2374908085,28,2321839746,-53068339
1645682885,198599,true,2373483638,28,2323000898,-50482740
1645682910,198601,true,2373009013,28,2323465522,-49543491
1645682940,198604,true,2372297253,28,2323697868,-48599385
1645682980,198605,true,2372060047,28,2324162631,-47897416
1645683068,198610,true,2370874372,28,2325324945,-45549427
1645683524,198611,true,2370637308,28,2335111357,-35525951
1645683744,198614,true,2369926260,28,2339318132,-30608128
1645683764,198614,true,2369926260,28,2339786019,-30140241
1645683786,198619,true,2368741652,28,2340019998,-28721654
1645683876,198620,true,2368504801,28,2341424361,-27080440
1645683963,198623,true,2367794392,28,2342361071,-25433321
1645684219,198623,true,2367794392,28,2344235616,-23558776
1645684260,198628,true,2366610850,28,2344470040,-22140810
1645684307,198629,true,2366374212,28,2344704487,-21669725
1645684327,198631,true,2365901009,28,2344938957,-20962052
1645684524,198632,true,2365664442,28,2345173451,-20490991
1645684693,198637,true,2364481965,28,2344938957,-19543008
1645684719,198637,true,2364481965,28,2344938957,-19543008
1645684722,198638,true,2364245540,28,2344938957,-19306583
1645684740,198638,true,2364245540,28,2344938957,-19306583
1645684869,198643,true,2363063772,28,2344704487,-18359285
1645684998,198644,true,2362827489,28,2343766839,-19060650
1645685012,198646,true,2362354995,28,2343766839,-18588156
1645685147,198647,true,2362118783,28,2343532486,-18586297
1645685220,198651,true,2361174171,28,2343298156,-17876015
1645685541,198651,true,2361174171,28,2343532486,-17641685
1645685917,198653,true,2360702007,28,2344001216,-16700791
1645685959,198654,true,2360465961,28,2344001216,-16464745
1645685998,198658,true,2359522010,28,2344001216,-15520794
1645686276,198658,true,2359522010,28,2344001216,-15520794
1645686286,198660,true,2359050177,28,2344001216,-15048961
1645686310,198660,true,2359050177,28,2344001216,-15048961
1645686333,198665,true,2357871005,28,2344001216,-13869789
1645686469,198665,true,2357871005,28,2343298156,-14572849
1645686521,198667,true,2357399502,28,2343298156,-14101346
1645686525,198667,true,2357399502,28,2343298156,-14101346
1645686603,198671,true,2356456778,28,2343063850,-13392928
1645686607,198671,true,2356456778,28,2343063850,-13392928
1645686774,198674,true,2355749982,28,2342361071,-13388911
1645686927,198674,true,2355749982,28,2341424361,-14325621
1645686952,198677,true,2355043398,28,2341190242,-13853156
1645686955,198677,true,2355043398,28,2341190242,-13853156
1645687138,198679,true,2354572460,28,2338850339,-15722121
1645687889,198680,true,2354337027,28,2328582517,-25754510
1645687924,198684,true,2353395527,28,2328116870,-25278657
1645687956,198685,true,2353160211,28,2327651316,-25508895
1645687978,198688,true,2352454404,28,2327418575,-25035829
1645688024,198690,true,2351983984,28,2326720489,-25263495
1645688046,198694,true,2351043426,28,2326255214,-24788212
1645688051,198695,true,2350808345,28,2326255214,-24553131
1645688089,198698,true,2350103243,28,2325557477,-24545766
1645688284,198700,true,2349633293,28,2323000898,-26632395
1645688319,198704,true,2348693675,28,2322768621,-25925054
1645688411,198704,true,2348693675,28,2322304137,-26389538
1645688459,198708,true,2347754432,28,2322071930,-25682502
1645688523,198709,true,2347519680,28,2322304137,-25215543
1645688607,198713,true,2346580907,28,2322304137,-24276770
1645688666,198713,true,2346580907,28,2322536368,-24044539
1645688678,198717,true,2345642509,28,2322536368,-23106141
1645688718,198718,true,2345407968,28,2323000898,-22407070
1645688739,198722,true,2344470040,28,2323000898,-21469142
1645688746,198721,true,2344704487,28,2323233198,-21471289
1645688760,198724,true,2344001216,28,2323465522,-20535694
1645688786,198725,true,2343766839,28,2323697868,-20068971
1645688831,198728,true,2343063850,28,2324627487,-18436363
1645688894,198726,true,2343532486,28,2326255214,-17277272
1645688906,198729,true,2342829567,28,2326487840,-16341727
1645688917,198730,true,2342595307,28,2326720489,-15874818
1645689049,198731,true,2342361071,28,2330679079,-11681992
1645689057,198729,true,2342829567,28,2330912147,-11917420
1645689062,198732,true,2342126859,28,2330912147,-11214712
1645689083,198732,true,2342126859,28,2331378353,-10748506
1645689746,198735,true,2341424361,28,2347284952,5860591
1645689782,198733,true,2341892669,28,2348224006,6331337
1645689793,198736,true,2341190242,28,2348458829,7268587
1645689870,198736,true,2341190242,28,2351043426,9853184
1645689961,198737,true,2340956146,28,2354101617,13145471
1645689966,198734,true,2341658503,28,2354337027,12678524
1645689997,198737,true,2340956146,28,2355514431,14558285
1645690023,198736,true,2341190242,28,2356456778,15266536
1645690087,198736,true,2341190242,28,2359050177,17859935
1645690099,198733,true,2341892669,28,2359286082,17393413
1645690154,198735,true,2341424361,28,2361410289,19985928
1645690183,198734,true,2341658503,28,2362354995,20696492
1645690199,198732,true,2342126859,28,2362827489,20700630
1645690216,198729,true,2342829567,28,2363536408,20706841
1645690246,198731,true,2342361071,28,2364718413,22357342
1645690426,198728,true,2343063850,28,2371348571,28284721
1645690589,198725,true,2343766839,28,2376808676,33041837
1645690627,198722,true,2344470040,28,2377521790,33051750
1645690640,198723,true,2344235616,28,2377759542,33523926
1645690688,198720,true,2344938957,28,2378472942,33533985
1645690699,198718,true,2345407968,28,2378472942,33064974
1645690851,198715,true,2346111661,28,2379662416,33550755
1645690954,198715,true,2346111661,28,2380852485,34740824
1645691058,198712,true,2346815565,28,2382043149,35227584
1645691301,198709,true,2347519680,28,2384426265,36906585
1645691648,198705,true,2348458829,28,2387766632,39307803
1645691667,198704,true,2348693675,28,2388005409,39311734
1645691739,198701,true,2349398353,28,2388244209,38845856
1645691840,198698,true,2350103243,28,2388721882,38618639
1645691861,198694,true,2351043426,28,2388721882,37678456
1645691912,198693,true,2351278530,28,2388721882,37443352
1645692085,198691,true,2351748809,28,2387289151,35540342
1645692105,198689,true,2352219182,28,2386811764,34592582
1645692208,198685,true,2353160211,28,2385380178,32219967
1645692344,198685,true,2353160211,28,2383234409,30074198
1645692658,198683,true,2353630867,28,2379662416,26031549
1645692673,198681,true,2354101617,28,2379662416,25560799
1645692704,198679,true,2354572460,28,2379424473,24852013
1645692722,198679,true,2354572460,28,2379186555,24614095
1645692728,198677,true,2355043398,28,2379186555,24143157
1645692737,198676,true,2355278903,28,2379186555,23907652
1645693255,198673,true,2355985557,28,2379424473,23438916
1645693274,198672,true,2356221156,28,2379424473,23203317
1645693363,198671,true,2356456778,28,2379424473,22967695
1645693387,198669,true,2356928093,28,2379424473,22496380
1645693416,198667,true,2357399502,28,2379186555,21787053
1645693606,198667,true,2357399502,28,2378710789,21311287
1645693671,198665,true,2357871005,28,2378710789,20839784
1645693715,198664,true,2358106792,28,2379186555,21079763
1645694299,198661,true,2358814295,28,2384903174,26088879
1645694633,198660,true,2359050177,28,2387766632,28716455
1645694674,198658,true,2359522010,28,2388005409,28483399
1645694819,198656,true,2359993938,28,2388960754,28966816
1645695539,198653,true,2360702007,28,2396377652,35675645
1645695684,198652,true,2360938077,28,2396856952,35918875
1645695734,198650,true,2361410289,28,2397096637,35686348
1645695796,198648,true,2361882594,28,2397096637,35214043
1645695847,198645,true,2362591230,28,2397096637,34505407
1645695869,198644,true,2362827489,28,2396856952,34029463
1645695876,198643,true,2363063772,28,2396856952,33793180
1645696312,198641,true,2363536408,28,2393743218,30206810
1645696651,198638,true,2364245540,28,2390633529,26387989
1645696655,198638,true,2364245540,28,2390633529,26387989
1645696712,198636,true,2364718413,28,2389677514,24959101
1645696785,198636,true,2364718413,28,2388483034,23764621
1645696879,198634,true,2365191380,28,2387050445,21859065
1645697551,198634,true,2365191380,28,2377284062,12092682
1645697577,198632,true,2365664442,28,2376808676,11144234
1645697611,198632,true,2365664442,28,2376333386,10668944
1645697648,198630,true,2366137599,28,2375858190,9720591
1645697658,198631,true,2365901009,28,2375858190,9957181
1645697768,198630,true,2366137599,28,2374433174,8295575
1645697774,198629,true,2366374212,28,2374433174,8058962
1645697801,198627,true,2366847511,28,2373958359,7110848
1645697861,198628,true,2366610850,28,2373009013,6398163
1645698262,198627,true,2366847511,28,2367084196,236685
1645698302,198627,true,2366847511,28,2366137599,-709912
1645698631,198625,true,2367320904,28,2359757963,-7562941
1645698699,198625,true,2367320904,28,2358578437,-8742467
1645698720,198626,true,2367084196,28,2358342603,-8741593
1645699015,198624,true,2367557636,28,2355749982,-11807654
1645699058,198621,true,2368267975,28,2355278903,-12989072
1645699358,198621,true,2368267975,28,2352219182,-16048793
1645699371,198620,true,2368504801,28,2352219182,-16285619
1645700640,198618,true,2368978526,28,2358106792,-10871734
1645700664,198615,true,2369689291,28,2358106792,-11582499
1645700848,198615,true,2369689291,28,2357871005,-11818286
1645700928,198614,true,2369926260,28,2357871005,-12055255
1645701143,198612,true,2370400268,28,2357871005,-12529263
1645701171,198609,true,2371111460,28,2357871005,-13240455
1645701214,198609,true,2371111460,28,2357871005,-13240455
1645701267,198608,true,2371348571,28,2357635242,-13713329
1645701978,198606,true,2371822864,28,2356456778,-15366086
1645701984,198603,true,2372534482,28,2356456778,-16077704
1645702086,198603,true,2372534482,28,2356221156,-16313326
1645702164,198603,true,2372534482,28,2355749982,-16784500
1645702345,198603,true,2372534482,28,2354807918,-17726564
1645702388,198601,true,2373009013,28,2354337027,-18671986
1645702679,198601,true,2373009013,28,2352219182,-20789831
1645702689,198602,true,2372771736,28,2351983984,-20787752
1645702716,198602,true,2372771736,28,2351983984,-20787752
1645702835,198600,true,2373246314,28,2351513658,-21732656
1645702861,198601,true,2373009013,28,2351513658,-21495355
1645702882,198602,true,2372771736,28,2351513658,-21258078
1645702997,198603,true,2372534482,28,2351513658,-21020824
1645703012,198601,true,2373009013,28,2351513658,-21495355
1645703014,198602,true,2372771736,28,2351513658,-21258078
1645703044,198603,true,2372534482,28,2351983984,-20550498
1645703046,198603,true,2372534482,28,2351983984,-20550498
1645703052,198601,true,2373009013,28,2351983984,-21025029
1645703284,198601,true,2373009013,28,2355278903,-17730110
1645703416,198602,true,2372771736,28,2357163786,-15607950
1645703878,198601,true,2373009013,28,2363063772,-9945241
1645703957,198599,true,2373483638,28,2364481965,-9001673
1645703987,198599,true,2373483638,28,2365191380,-8292258
1645704126,198599,true,2373483638,28,2368267975,-5215663
1645704188,198599,true,2373483638,28,2369452345,-4031293
1645704264,198597,true,2373958359,28,2371111460,-2846899
1645704271,198597,true,2373958359,28,2371111460,-2846899
1645704315,198599,true,2373483638,28,2372060047,-1423591
1645704336,198599,true,2373483638,28,2372534482,-949156
1645704346,198597,true,2373958359,28,2372771736,-1186623
1645704359,198598,true,2373720987,28,2373009013,-711974
1645704910,198600,true,2373246314,28,2378948660,5702346
1645705031,198600,true,2373246314,28,2378710789,5464475
1645705147,198599,true,2373483638,28,2378472942,4989304
1645705190,198600,true,2373246314,28,2378235118,4988804
1645705579,198604,true,2372297253,28,2377284062,4986809
1645705708,198604,true,2372297253,28,2376808676,4511423
1645705891,198603,true,2372534482,28,2375383090,2848608
1645705907,198604,true,2372297253,28,2375145575,2848322
1645706035,198608,true,2371348571,28,2373958359,2609788
1645706328,198608,true,2371348571,28,2372060047,711476
1645706462,198607,true,2371585706,28,2371348571,-237135
1645706826,198607,true,2371585706,28,2369926260,-1659446
1645706829,198611,true,2370637308,28,2369926260,-711048
1645707681,198611,true,2370637308,28,2369215424,-1421884
1645707726,198609,true,2371111460,28,2369215424,-1896036
1645707751,198609,true,2371111460,28,2369215424,-1896036
1645707844,198613,true,2370163252,28,2369215424,-947828
1645707858,198614,true,2369926260,28,2369215424,-710836
1645708030,198612,true,2370400268,28,2368741652,-1658616
1645708041,198612,true,2370400268,28,2368741652,-1658616
1645708392,198616,true,2369452345,28,2366847511,-2604834
1645708745,198616,true,2369452345,28,2364954885,-4497460
1645708801,198615,true,2369689291,28,2364718413,-4970878
1645708881,198615,true,2369689291,28,2364481965,-5207326
1645708895,198618,true,2368978526,28,2364245540,-4732986
1645708982,198617,true,2369215424,28,2364245540,-4969884
1645709479,198614,true,2369926260,28,2365191380,-4734880
1645709825,198614,true,2369926260,28,2368978526,-947734
1645709880,198617,true,2369215424,28,2369926260,710836
1645710231,198616,true,2369452345,28,2375383090,5930745
1645710271,198614,true,2369926260,28,2376095776,6169516
1645710281,198614,true,2369926260,28,2376333386,6407126
1645710612,198616,true,2369452345,28,2382757834,13305489
1645710709,198615,true,2369689291,28,2384187846,14498555
1645710832,198612,true,2370400268,28,2385857278,15457010
1645710854,198611,true,2370637308,28,2386334474,15697166
1645711061,198613,true,2370163252,28,2389677514,19514262
1645711184,198612,true,2370400268,28,2391589926,21189658
1645711277,198610,true,2370874372,28,2392785960,21911588
1645711445,198610,true,2370874372,28,2394221990,23347618
1645711458,198612,true,2370400268,28,2394461412,24061144
1645711590,198611,true,2370637308,28,2395179823,24542515
1645711620,198611,true,2370637308,28,2395419341,24782033
1645711648,198611,true,2370637308,28,2395658883,25021575
1645712122,198613,true,2370163252,28,2399014986,28851734
1645712190,198611,true,2370637308,28,2399014986,28377678
1645712331,198610,true,2370874372,28,2399014986,28140614
1645712366,198610,true,2370874372,28,2399014986,28140614
1645712391,198611,true,2370637308,28,2399014986,28377678
1645712450,198609,true,2371111460,28,2399014986,27903526
1645712564,198608,true,2371348571,28,2398775108,27426537
1645712584,198608,true,2371348571,28,2398775108,27426537
1645712693,198609,true,2371111460,28,2398055620,26944160
1645712848,198607,true,2371585706,28,2396617290,25031584
1645712900,198606,true,2371822864,28,2396138038,24315174
1645712928,198605,true,2372060047,28,2395898448,23838401
1645712968,198607,true,2371585706,28,2395419341,23833635
1645713072,198605,true,2372060047,28,2394461412,22401365
1645713103,198604,true,2372297253,28,2394221990,21924737
1645713123,198602,true,2372771736,28,2394221990,21450254
1645713145,198603,true,2372534482,28,2394221990,21687508
1645713171,198599,true,2373483638,28,2394700859,21217221
1645713224,198595,true,2374433174,28,2395419341,20986167
1645713246,198593,true,2374908085,28,2395658883,20750798
1645713309,198593,true,2374908085,28,2396617290,21709205
1645713420,198589,true,2375858190,28,2397576081,21717891
1645713596,198585,true,2376808676,28,2399254887,22446211
1645713632,198583,true,2377284062,28,2399734762,22450700
1645713776,198582,true,2377521790,28,2401174963,23653173
1645713811,198579,true,2378235118,28,2401415081,23179963
1645713825,198576,true,2378948660,28,2401655222,22706562
1645713898,198574,true,2379424473,28,2401655222,22230749
1645713934,198575,true,2379186555,28,2401655222,22468667
1645713941,198572,true,2379900382,28,2401655222,21754840
1645714015,198569,true,2380614424,28,2401655222,21040798
1645714036,198568,true,2380852485,28,2401655222,20802737
1645714052,198568,true,2380852485,28,2401895388,21042903
1645714074,198566,true,2381328679,28,2401895388,20566709
1645714098,198562,true,2382281354,28,2401895388,19614034
1645714124,198561,true,2382519582,28,2402135577,19615995
1645714136,198561,true,2382519582,28,2402135577,19615995
1645714165,198558,true,2383234409,28,2402375791,19141382
1645714198,198554,true,2384187846,28,2402856290,18668444
1645714374,198550,true,2385141664,28,2406222476,21080812
1645714518,198550,true,2385141664,28,2409593378,24451714
1645714539,198546,true,2386095864,28,2410075321,23979457
1645714553,198542,true,2387050445,28,2410316329,23265884
1645714566,198538,true,2388005409,28,2410798416,22793007
1645714882,198537,true,2388244209,28,2419734445,31490236
1645714899,198532,true,2389438570,28,2420218416,30779846
1645714971,198528,true,2390394489,28,2421186649,30792160
1645714999,198525,true,2391111679,28,2421428767,30317088
1645715036,198525,true,2391111679,28,2421428767,30317088
1645715095,198521,true,2392068267,28,2421670910,29602643
1645715173,198518,true,2392785960,28,2422155268,29369308
1645715281,198514,true,2393743218,28,2423124276,29381058
1645715326,198515,true,2393503867,28,2423366588,29862721
1645715402,198512,true,2394221990,28,2424093671,29871681
1645715435,198509,true,2394940329,28,2424578514,29638185
1645715494,198506,true,2395658883,28,2425305960,29647077
1645715515,198506,true,2395658883,28,2425791046,30132163
1645715541,198503,true,2396377652,28,2426276228,29898576
1645715631,198499,true,2397336347,28,2428217929,30881582
1645715806,198495,true,2398295425,28,2433565621,35270196
1645715855,198495,true,2398295425,28,2435026125,36730700
1645715922,198492,true,2399014986,28,2436731155,37716169
1645715926,198489,true,2399734762,28,2436974828,37240066
1645716046,198484,true,2400934870,28,2439656841,38721971
1645716051,198484,true,2400934870,28,2439656841,38721971
1645716064,198480,true,2401895388,28,2439900807,38005419
1645716130,198476,true,2402856290,28,2441609250,38752960
1645716185,198471,true,2404057959,28,2442586040,38528081
1645716193,198470,true,2404298364,28,2442586040,38287676
1645716307,198468,true,2404779248,28,2444296364,39517116
1645716405,198465,true,2405500754,28,2445029726,39528972
1645716528,198460,true,2406703745,28,2445518756,38815011
1645716862,198459,true,2406944415,28,2447720604,40776189
1645716915,198457,true,2407425828,28,2448454993,41029165
1645716952,198454,true,2408148128,28,2448944709,40796581
1645717000,198450,true,2409111532,28,2449189603,40078071
1645717023,198448,true,2409593378,28,2449434522,39841144
1645717233,198446,true,2410075321,28,2449679466,39604145
1645717584,198443,true,2410798416,28,2446007884,35209468
1645717676,198439,true,2411762880,28,2445274229,33511349
1645717714,198438,true,2412004056,28,2445029726,33025670
1645717765,198437,true,2412245257,28,2444540793,32295536
1645717839,198433,true,2413210300,28,2444051958,30841658
1645717869,198428,true,2414417146,28,2443807578,29390432
1645717984,198427,true,2414658588,28,2443074582,28415994
1645718029,198424,true,2415383058,28,2442830299,27447241
1645718036,198419,true,2416590991,28,2442830299,26239308
1645718672,198414,true,2417799528,28,2447475856,29676328
1645718945,198412,true,2418283112,28,2450414443,32131331
1645718998,198409,true,2419008670,28,2451149641,32140971
1645719069,198404,true,2420218416,28,2452375461,32157045
1645719196,198399,true,2421428767,28,2454583482,33154715
1645719368,198396,true,2422155268,28,2458267935,36112667
1645719475,198394,true,2422639724,28,2460481262,37841538
1645719486,198390,true,2423608925,28,2460727310,37118385
1645719511,198385,true,2424820972,28,2461219480,36398508
1645719616,198381,true,2425791046,28,2463435464,37644418
1645719634,198379,true,2426276228,28,2463928175,37651947
1645719650,198375,true,2427246884,28,2464174568,36927684
1645719892,198370,true,2428460750,28,2468367018,39906268
1645719902,198367,true,2429189362,28,2468613855,39424493
1645719944,198365,true,2429675224,28,2469107602,39432378
1645720298,198363,true,2430161183,28,2473061139,42899956
1645720358,198358,true,2431376507,28,2473803131,42426624
1645720369,198355,true,2432105993,28,2473803131,41697138
1645721023,198355,true,2432105993,28,2476525676,44419683
1645721043,198353,true,2432592438,28,2476525676,43933238
1645721157,198348,true,2433808978,28,2476030445,42221467
1645721190,198345,true,2434539193,28,2475782866,41243673
1645721205,198345,true,2434539193,28,2475782866,41243673
1645721345,198343,true,2435026125,28,2474545346,39519221
1645721510,198338,true,2436243882,28,2472072161,35828279
1645721694,198336,true,2436731155,28,2469354513,32623358
1645721786,198336,true,2436731155,28,2468613855,31882700
1645721815,198334,true,2437218526,28,2468367018,31148492
1645722035,198328,true,2438681223,28,2467133205,28451982
1645722246,198326,true,2439168983,28,2466639852,27470869
1645722321,198325,true,2439412900,28,2466639852,27226952
1645722445,198323,true,2439900807,28,2466639852,26739045
1645722457,198317,true,2441365114,28,2466639852,25274738
1645722512,198314,true,2442097596,28,2466393213,24295617
1645722613,198314,true,2442097596,28,2466146598,24049002
1645722634,198312,true,2442586040,28,2466146598,23560558
1645722749,198306,true,2444051958,28,2465160386,21108428
1645722756,198303,true,2444785247,28,2465160386,20375139
1645722784,198303,true,2444785247,28,2464913895,20128648
1645723226,198301,true,2445274229,28,2461957920,16683691
1645723263,198296,true,2446497110,28,2461711748,15214638
1645723290,198294,true,2446986434,28,2461465602,14479168
1645723306,198296,true,2446497110,28,2461465602,14968492
1645723341,198297,true,2446252485,28,2460973383,14720898
1645723945,198293,true,2447231133,28,2453111247,5880114
1645723985,198291,true,2447720604,28,2452375461,4654857
1645724265,198292,true,2447475856,28,2447965376,489520
1645724351,198293,true,2447231133,28,2446986434,-244699
1645724440,198289,true,2448210172,28,2446252485,-1957687
1645724483,198287,true,2448699839,28,2446007884,-2691955
1645724652,198288,true,2448454993,28,2445274229,-3180764
1645724660,198289,true,2448210172,28,2445274229,-2935943
1645724669,198284,true,2449434522,28,2445274229,-4160293
1645724795,198281,true,2450169426,28,2444540793,-5628633
1645725735,198282,true,2449924434,28,2442097596,-7826838
1645726184,198283,true,2449679466,28,2441609250,-8070216
1645726236,198278,true,2450904550,28,2441609250,-9295300
1645726288,198275,true,2451639895,28,2441365114,-10274781
1645726352,198276,true,2451394756,28,2441365114,-10029642
1645726445,198276,true,2451394756,28,2441365114,-10029642
1645726504,198271,true,2452620698,28,2441609250,-11011448
1645726520,198269,true,2453111247,28,2441609250,-11501997
1645727246,198270,true,2452865960,28,2445518756,-7347204
1645727320,198271,true,2452620698,28,2446007884,-6612814
1645727669,198268,true,2453356558,28,2446986434,-6370124
1645727914,198265,true,2454092639,28,2447231133,-6861506
1645727918,198267,true,2453601894,28,2447231133,-6370761
1645728005,198268,true,2453356558,28,2447720604,-5635954
1645728022,198266,true,2453847254,28,2447720604,-6126650
1645728031,198264,true,2454338048,28,2447720604,-6617444
1645728045,198265,true,2454092639,28,2447965376,-6127263
1645728057,198265,true,2454092639,28,2447965376,-6127263
1645728066,198262,true,2454828940,28,2448210172,-6618768
1645728102,198259,true,2455565462,28,2448454993,-7110469
1645728140,198260,true,2455319930,28,2448944709,-6375221
1645728141,198260,true,2455319930,28,2448944709,-6375221
1645728172,198257,true,2456056600,28,2449434522,-6622078
1645728222,198253,true,2457039170,28,2449924434,-7114736
1645728506,198254,true,2456793491,28,2453111247,-3682244
1645728524,198254,true,2456793491,28,2453356558,-3436933
1645728525,198252,true,2457284874,28,2453356558,-3928316
1645728574,198248,true,2458267935,28,2454338048,-3929887
1645728604,198249,true,2458022133,28,2454828940,-3193193
1645728663,198249,true,2458022133,28,2456302206,-1719927
1645728733,198246,true,2458759614,28,2458513762,-245852
1645728742,198242,true,2459743265,28,2459005490,-737775
1645728782,198241,true,2459989239,28,2460481262,492023
1645728831,198240,true,2460235238,28,2462450336,2215098
1645728844,198236,true,2461219480,28,2462942851,1723371
1645728861,198232,true,2462204115,28,2463928175,1724060
1645729018,198230,true,2462696581,28,2471824979,9128398
1645729019,198229,true,2462942851,28,2471824979,8882128
1645729785,198227,true,2463435464,28,2507424224,43988760
1645730186,198223,true,2464420986,28,2520244110,55823124
1645730369,198221,true,2464913895,28,2525794472,60880577
1645730395,198218,true,2465653443,28,2526552286,60898843
1645731028,198215,true,2466393213,28,2530850863,64457650
1645731190,198210,true,2467626656,28,2531863355,64236699
1645731268,198208,true,2468120206,28,2532369753,64249547
1645731270,198205,true,2468860716,28,2532369753,63509037
1645731297,198202,true,2469601448,28,2532622990,63021542
1645731316,198196,true,2471083580,28,2532622990,61539410
1645731385,198192,true,2472072161,28,2533382853,61310692
1645731428,198189,true,2472813857,28,2534142944,61329087
1645731505,198185,true,2473803131,28,2535156753,61353622
1645731520,198179,true,2475287784,28,2535410269,60122485
1645731583,198175,true,2476278048,28,2536424585,60146537
1645731605,198172,true,2477021006,28,2536931896,59910890
1645731622,198168,true,2478011963,28,2537185589,59173626
1645732198,198162,true,2479499141,28,2551177853,71678712
1645732238,198158,true,2480491090,28,2551943283,71452193
1645732355,198156,true,2480987213,28,2553985553,72998340
1645732470,198153,true,2481731584,28,2556285059,74553475
1645732528,198146,true,2483469317,28,2557563457,74094140
1645732538,198142,true,2484462854,28,2557563457,73100603
1645732553,198140,true,2484959771,28,2558074996,73115225
1645732608,198136,true,2485953904,28,2559354289,73400385
1645732682,198130,true,2487445849,28,2561146375,73700526
1645732756,198126,true,2488440977,28,2563196009,74755032
1645732803,198123,true,2489187584,28,2564477863,75290279
1645732818,198120,true,2489934415,28,2564990784,75056369
1645732866,198114,true,2491428749,28,2566786817,75358068
1645732923,198109,true,2492674713,28,2569354759,76680046
1645732955,198105,true,2493671932,28,2570639693,76967761
1645732983,198102,true,2494420108,28,2571925270,77505162
1645733019,198096,true,2495917135,28,2573468811,77551676
1645733025,198090,true,2497415059,28,2573726158,76311099
1645733037,198086,true,2498414175,28,2574240929,75826754
1645733045,198082,true,2499413691,28,2574755803,75342112
1645733051,198074,true,2501413922,28,2575270780,73856858
1645733066,198067,true,2503165437,28,2576043438,72878001
1645733106,198061,true,2504667712,28,2578362805,73695093
1645733156,198056,true,2505920296,28,2581458543,75538247
1645733164,198048,true,2507925734,28,2581974860,74049126
1645733190,198040,true,2509932777,28,2583782785,73850008
1645733200,198032,true,2511941426,28,2584557997,72616571
1645733233,198025,true,2513700313,28,2587143719,73443406
1645733240,198017,true,2515711977,28,2587661173,71949196
1645733310,198008,true,2517977024,28,2592322925,74345901
1645733441,198002,true,2519488188,28,2600891292,81403104
1645733568,197996,true,2521000259,28,2607662069,86661810
1645733605,197988,true,2523017765,28,2610009904,86992139
1645733633,197980,true,2525036886,28,2611576301,86539415
1645733842,197973,true,2526804942,28,2624403785,97598843
1645733848,197967,true,2528321404,28,2624928692,96607288
1645733862,197959,true,2530344769,28,2625716250,95371481
1645733986,197950,true,2532622990,28,2634658431,102035441
1645734012,197942,true,2534649798,28,2636239621,101589823
1645734020,197934,true,2536678228,28,2636766896,100088668
1645734072,197927,true,2538454435,28,2640196750,101742315
1645734144,197918,true,2540739958,28,2644688677,103948719
1645734195,197910,true,2542773262,28,2647599290,104826028
1645734294,197903,true,2544553737,28,2653430128,108876391
1645734304,197895,true,2546590093,28,2653960841,107370748
1645734357,197887,true,2548628078,28,2656615996,107987918
1645734375,197878,true,2550922761,28,2657413061,106490300
1645734466,197872,true,2552453697,28,2661401972,108948275
1645734489,197864,true,2554496375,28,2662200472,107704097
1645734553,197857,true,2556285059,28,2664597411,108312352
1645734754,197849,true,2558330803,28,2668863966,110533163
1645734851,197843,true,2559866185,28,2669664705,109798520
1645734886,197836,true,2561658629,28,2669664705,108006076
1645735054,197829,true,2563452328,28,2667263208,103810880
1645735301,197821,true,2565503808,28,2663798192,98294384
1645735368,197815,true,2567043495,28,2662999212,95955717
1645735377,197807,true,2569097849,28,2662999212,93901363
1645735385,197800,true,2570896757,28,2662732939,91836182
1645735423,197792,true,2572954195,28,2662200472,89246277
1645735437,197786,true,2574498353,28,2661668112,87169759
1645735794,197779,true,2576301043,28,2652634258,76333215
1645736012,197771,true,2578362805,28,2647864049,69501244
1645736056,197764,true,2580168201,28,2647069849,66901648
1645736563,197759,true,2581458543,28,2645217641,63759098
1645736735,197752,true,2583266106,28,2644688677,61422571
1645737137,197744,true,2585333442,28,2642573878,57240436
1645737279,197737,true,2587143719,28,2641781264,54637545
1645738209,197732,true,2588437549,28,2640196750,51759201
1645738268,197725,true,2590249999,28,2639932757,49682758
1645738300,197717,true,2592322925,28,2639932757,47609832
1645738342,197710,true,2594138095,28,2639404849,45266754
1645739566,197706,true,2595175906,28,2632025221,36849315
1645739615,197700,true,2596733401,28,2632025221,35291820
1645739634,197692,true,2598811515,28,2632025221,33213706
1645740075,197685,true,2600631229,28,2631235771,30604542
1645740186,197682,true,2601411496,28,2630972674,29561178
1645740308,197676,true,2602972733,28,2630446559,27473826
1645740528,197669,true,2604795361,28,2629131730,24336369
1645740747,197663,true,2606358629,28,2628080340,21721711
1645740782,197660,true,2607140615,28,2627817558,20676943
1645740795,197654,true,2608705290,28,2627817558,19112268
1645740880,197648,true,2610270905,28,2627554803,17283898
1645741606,197642,true,2611837459,28,2624141371,12303912
1645741662,197639,true,2612621088,28,2623354286,10733198
1645741753,197633,true,2614189053,28,2622567437,8378384
1645741808,197628,true,2615496409,28,2621780825,6284416
1645741975,197625,true,2616281136,28,2619422401,3141265
1645741993,197623,true,2616804419,28,2619160485,2356066
1645742050,197619,true,2617851298,28,2618374894,523596
1645742076,197615,true,2618898595,28,2618113083,-785512
1645742479,197614,true,2619160485,28,2611837459,-7323026
1645742552,197613,true,2619422401,28,2610792985,-8629416
1645742566,197610,true,2620208306,28,2610531932,-9676374
1645742588,197607,true,2620994448,28,2610270905,-10723543
1645742602,197607,true,2620994448,28,2610009904,-10984544
1645742770,197606,true,2621256547,28,2605576878,-15679669
1645743024,197603,true,2622043003,28,2599331303,-22711700
1645743144,197600,true,2622829694,28,2596214132,-26615562
1645743148,197600,true,2622829694,28,2596214132,-26615562
1645743243,197600,true,2622829694,28,2593360009,-29469685
1645743277,197598,true,2623354286,28,2592322925,-31031361
1645743297,197596,true,2623878983,28,2591545383,-32333600
1645743394,197597,true,2623616622,28,2588178731,-35437891
1645743575,197597,true,2623616622,28,2581974860,-41641762
1645743621,197595,true,2624141371,28,2580684260,-43457111
1645743633,197594,true,2624403785,28,2580426217,-43977568
1645743861,197595,true,2624141371,28,2575785860,-48355511
1645743895,197595,true,2624141371,28,2575270780,-48870591
1645743995,197593,true,2624666226,28,2574240929,-50425297
1645744268,197592,true,2624928692,28,2571925270,-53003422
1645744353,197592,true,2624928692,28,2571153847,-53774845
1645744430,197593,true,2624666226,28,2570896757,-53769469
1645744464,197592,true,2624928692,28,2571153847,-53774845
1645744498,197591,true,2625191185,28,2571153847,-54037338
1645744824,197590,true,2625453704,28,2573468811,-51984893
1645746116,197591,true,2625191185,28,2589214158,-35977027
1645746290,197590,true,2625453704,28,2590249999,-35203705
1645746352,197588,true,2625978821,28,2590249999,-35728822
1645746427,197588,true,2625978821,28,2590509024,-35469797
1645746867,197588,true,2625978821,28,2591804538,-34174283
1645747680,197588,true,2625978821,28,2594397509,-31581312
1645747696,197587,true,2626241419,28,2594397509,-31843910
1645747716,197586,true,2626504043,28,2594397509,-32106534
1645747804,197587,true,2626241419,28,2595175906,-31065513
1645747836,197586,true,2626504043,28,2595435424,-31068619
1645748718,197586,true,2626504043,28,2603493354,-23010689
1645748720,197586,true,2626504043,28,2603493354,-23010689
1645748839,197587,true,2626241419,28,2605055841,-21185578
1645748881,197587,true,2626241419,28,2605837435,-20403984
1645749468,197586,true,2626504043,28,2614711917,-11792126
1645749528,197586,true,2626504043,28,2615496409,-11007634
1645749574,197588,true,2625978821,28,2615757959,-10220862
1645749761,197589,true,2625716250,28,2616281136,-9435114
1645749775,197589,true,2625716250,28,2616542765,-9173485
1645749870,197591,true,2625191185,28,2616542765,-8648420
1645750274,197594,true,2624403785,28,2616542765,-7861020
1645750317,197595,true,2624141371,28,2616542765,-7598606
1645750341,197596,true,2623878983,28,2616542765,-7336218
1645750353,197599,true,2623091977,28,2616542765,-6549212
1645750386,197605,true,2621518673,28,2616281136,-5237537
1645750399,197607,true,2620994448,28,2616281136,-4713312
1645750405,197607,true,2620994448,28,2616281136,-4713312
1645750837,197611,true,2619946312,28,2610009904,-9936408
1645751098,197616,true,2618636732,28,2605837435,-12799297
1645751355,197618,true,2618113083,28,2602191998,-15921085
1645751413,197618,true,2618113083,28,2601671637,-16441446
1645751672,197621,true,2617327806,28,2599851195,-17476611
1645751711,197626,true,2616019535,28,2599591236,-16428299
1645751761,197628,true,2615496409,28,2599591236,-15905173
1645751875,197629,true,2615234886,28,2599331303,-15903583
1645751963,197633,true,2614189053,28,2599331303,-14857750
1645752003,197638,true,2612882351,28,2599331303,-13551048
1645752038,197639,true,2612621088,28,2599331303,-13289785
1645752073,197639,true,2612621088,28,2599591236,-13029852
1645752108,197641,true,2612098643,28,2600111181,-11987462
1645752173,197645,true,2611054064,28,2601151381,-9902683
1645752210,197645,true,2611054064,28,2601931804,-9122260
1645752363,197644,true,2611315170,28,2605837435,-5477735
1645752827,197646,true,2610792985,28,2616804419,6011434
1645752895,197649,true,2610009904,28,2618374894,8364990
1645753274,197649,true,2610009904,28,2625453704,15443800
1645753302,197647,true,2610531932,28,2625716250,15184318
1645753347,197649,true,2610009904,28,2626504043,16494139
1645753377,197651,true,2609487980,28,2627029371,17541391
1645753410,197651,true,2609487980,28,2627292073,17804093
1645753698,197649,true,2610009904,28,2630972674,20962770
1645753926,197651,true,2609487980,28,2632288424,22800444
1645753948,197653,true,2608966161,28,2632288424,23322263
1645754478,197654,true,2608705290,28,2629394643,20689353
1645754772,197652,true,2609227057,28,2628605982,19378925
1645754800,197654,true,2608705290,28,2628605982,19900692
1645755196,197655,true,2608444446,28,2629920548,21476102
1645755618,197655,true,2608444446,28,2631762045,23317599
1645755877,197653,true,2608966161,28,2632814908,23848747
1645756076,197655,true,2608444446,28,2633604831,25160385
1645756106,197656,true,2608183627,28,2633868192,25684565
1645756200,197656,true,2608183627,28,2634394992,26211365
1645756235,197654,true,2608705290,28,2634658431,25953141
1645757944,197655,true,2608444446,28,2642573878,34129432
1645758180,197656,true,2608183627,28,2642573878,34390251
1645758199,197656,true,2608183627,28,2642573878,34390251
1645758350,197653,true,2608966161,28,2642573878,33607717
1645758925,197655,true,2608444446,28,2640988888,32544442
1645758972,197655,true,2608444446,28,2640460770,32016324
1645759320,197655,true,2608444446,28,2637558005,29113559
1645759387,197653,true,2608966161,28,2636766896,27800735
1645760126,197656,true,2608183627,28,2628343148,20159521
1645760152,197657,true,2607922835,28,2628080340,20157505
1645760199,197657,true,2607922835,28,2627554803,19631968
1645760314,197654,true,2608705290,28,2626241419,17536129
1645760532,197656,true,2608183627,28,2623616622,15432995
1645760537,197657,true,2607922835,28,2623354286,15431451
1645760545,197657,true,2607922835,28,2623354286,15431451
1645760568,197654,true,2608705290,28,2623091977,14386687
1645760992,197656,true,2608183627,28,2621780825,13597198
1645761007,197657,true,2607922835,28,2621780825,13857990
1645761018,197657,true,2607922835,28,2621780825,13857990
1645761930,197653,true,2608966161,28,2627292073,18325912
1645762127,197653,true,2608966161,28,2629131730,20165569
1645762735,197653,true,2608966161,28,2632814908,23848747
1645762782,197653,true,2608966161,28,2633078189,24112028
1645763723,197649,true,2610009904,28,2630446559,20436655
1645763730,197648,true,2610270905,28,2630446559,20175654
1645763751,197649,true,2610009904,28,2630446559,20436655
1645764144,197648,true,2610270905,28,2628080340,17809435
1645764231,197645,true,2611054064,28,2627554803,16500739
1645764475,197644,true,2611315170,28,2625978821,14663651
1645765487,197643,true,2611576301,28,2621780825,10204524
1645765497,197642,true,2611837459,28,2621780825,9943366
1645765513,197639,true,2612621088,28,2621518673,8897585
1645765551,197638,true,2612882351,28,2621256547,8374196
1645765567,197637,true,2613143639,28,2621256547,8112908
1645765582,197636,true,2613404953,28,2621256547,7851594
1645765717,197633,true,2614189053,28,2619946312,5757259
1645765765,197632,true,2614450472,28,2619422401,4971929
1645766065,197632,true,2614450472,28,2615234886,784414
1645766281,197631,true,2614711917,28,2612098643,-2613274
1645766307,197628,true,2615496409,28,2611576301,-3920108
1645766394,197627,true,2615757959,28,2610531932,-5226027
1645766440,197627,true,2615757959,28,2610009904,-5748055
1645766468,197627,true,2615757959,28,2609487980,-6269979
1645766543,197624,true,2616542765,28,2608705290,-7837475
1645766763,197623,true,2616804419,28,2606358629,-10445790
1645767061,197624,true,2616542765,28,2603753703,-12789062
1645767109,197623,true,2616804419,28,2603233031,-13571388
1645767203,197621,true,2617327806,28,2602452217,-14875589
1645767535,197621,true,2617327806,28,2601671637,-15656169
1645767842,197621,true,2617327806,28,2603753703,-13574103
1645767960,197620,true,2617589539,28,2604795361,-12794178
1645768209,197618,true,2618113083,28,2607140615,-10972468
1645768920,197618,true,2618113083,28,2610792985,-7320098
1645769155,197619,true,2617851298,28,2611315170,-6536128
1645769471,197618,true,2618113083,28,2611054064,-7059019
1645769686,197616,true,2618636732,28,2610792985,-7843747
1645769895,197616,true,2618636732,28,2611054064,-7582668
1645769916,197617,true,2618374894,28,2611054064,-7320830
1645769987,197617,true,2618374894,28,2611054064,-7320830
1645770026,197616,true,2618636732,28,2611315170,-7321562
1645770136,197615,true,2618898595,28,2611837459,-7061136
1645770631,197615,true,2618898595,28,2615234886,-3663709
1645771280,197615,true,2618898595,28,2620732374,1833779
1645772111,197615,true,2618898595,28,2624928692,6030097
1645772310,197614,true,2619160485,28,2625453704,6293219
1645772533,197615,true,2618898595,28,2625978821,7080226
1645772546,197615,true,2618898595,28,2625978821,7080226
1645772560,197614,true,2619160485,28,2625978821,6818336
1645772878,197612,true,2619684343,28,2628343148,8658805
1645772884,197611,true,2619946312,28,2628605982,8659670
1645772944,197611,true,2619946312,28,2628868843,8922531
1645773074,197610,true,2620208306,28,2629131730,8923424
1645773204,197609,true,2620470327,28,2629657582,9187255
1645773243,197608,true,2620732374,28,2629657582,8925208
1645774101,197608,true,2620732374,28,2628868843,8136469
1645774768,197607,true,2620994448,28,2625453704,4459256
1645775684,197605,true,2621518673,28,2623878983,2360310
1645775776,197604,true,2621780825,28,2623616622,1835797
1645775786,197604,true,2621780825,28,2623616622,1835797
1645776102,197603,true,2622043003,28,2622567437,524434
1645776119,197602,true,2622305207,28,2622567437,262230
1645776136,197601,true,2622567437,28,2622305207,-262230
1645776215,197602,true,2622305207,28,2622043003,-262204
1645776676,197602,true,2622305207,28,2619422401,-2882806
1645776747,197601,true,2622567437,28,2619160485,-3406952
1645776804,197600,true,2622829694,28,2618636732,-4192962
1645776831,197601,true,2622567437,28,2618374894,-4192543
1645777552,197603,true,2622043003,28,2611315170,-10727833
1645777700,197603,true,2622043003,28,2609748929,-12294074
1645777929,197604,true,2621780825,28,2607662069,-14118756
1645778303,197605,true,2621518673,28,2604795361,-16723312
1645778328,197608,true,2620732374,28,2604795361,-15937013
1645778765,197607,true,2620994448,28,2603233031,-17761417
1645778793,197608,true,2620732374,28,2603493354,-17239020
1645779921,197609,true,2620470327,28,2606879927,-13590400
1645779987,197611,true,2619946312,28,2607140615,-12805697
1645780109,197610,true,2620208306,28,2607401329,-12806977
1645780149,197611,true,2619946312,28,2607140615,-12805697
1645780493,197613,true,2619422401,28,2604795361,-14627040
1645780672,197616,true,2618636732,28,2602712462,-15924270
1645780819,197616,true,2618636732,28,2600891292,-17745440
1645780856,197616,true,2618636732,28,2600371192,-18265540
1645781104,197619,true,2617851298,28,2597512499,-20338799
1645781120,197621,true,2617327806,28,2597512499,-19815307
1645781369,197621,true,2617327806,28,2593878707,-23449099
1645781403,197623,true,2616804419,28,2593360009,-23444410
1645781956,197626,true,2616019535,28,2585591976,-30427559
1645781987,197629,true,2615234886,28,2585333442,-29901444
1645782034,197629,true,2615234886,28,2585333442,-29901444
1645782074,197630,true,2614973388,28,2585074935,-29898453
1645782366,197633,true,2614189053,28,2584557997,-29631056
1645782407,197636,true,2613404953,28,2584557997,-28846956
1645782962,197636,true,2613404953,28,2585850535,-27554418
1645782997,197637,true,2613143639,28,2586109120,-27034519
1645783042,197640,true,2612359853,28,2586626368,-25733485
1645783046,197643,true,2611576301,28,2586626368,-24949933
1645783079,197642,true,2611837459,28,2586885030,-24952429
1645783102,197642,true,2611837459,28,2587143719,-24693740
1645783136,197644,true,2611315170,28,2587661173,-23653997
1645783146,197646,true,2610792985,28,2587919939,-22873046
1645783149,197644,true,2611315170,28,2587919939,-23395231
1645783187,197644,true,2611315170,28,2588696393,-22618777
1645783234,197644,true,2611315170,28,2589473080,-21842090
1645783257,197647,true,2610531932,28,2589991000,-20540932
1645783295,197644,true,2611315170,28,2590768075,-20547095
1645783668,197643,true,2611576301,28,2599071396,-12504905
1645783732,197644,true,2611315170,28,2600631229,-10683941
1645783808,197646,true,2610792985,28,2601931804,-8861181
1645784014,197644,true,2611315170,28,2605576878,-5738292
1645784921,197644,true,2611315170,28,2618113083,6797913
1645785055,197645,true,2611054064,28,2618374894,7320830
1645785406,197648,true,2610270905,28,2617589539,7318634
1645787111,197647,true,2610531932,28,2617066099,6534167
1645787176,197646,true,2610792985,28,2616804419,6011434
1645787587,197647,true,2610531932,28,2614450472,3918540
1645788286,197650,true,2609748929,28,2610792985,1044056
1645788295,197650,true,2609748929,28,2610792985,1044056
1645788315,197649,true,2610009904,28,2610792985,783081
1645788325,197650,true,2609748929,28,2610792985,1044056
1645788329,197652,true,2609227057,28,2610792985,1565928
1645788781,197650,true,2609748929,28,2611054064,1305135
1645788857,197649,true,2610009904,28,2611315170,1305266
1645788864,197650,true,2609748929,28,2611315170,1566241
1645788897,197652,true,2609227057,28,2611576301,2349244
1645789183,197650,true,2609748929,28,2613927660,4178731
1645789187,197648,true,2610270905,28,2613927660,3656755
1645789319,197648,true,2610270905,28,2616019535,5748630
1645789364,197650,true,2609748929,28,2616281136,6532207
1645789631,197646,true,2610792985,28,2619422401,8629416
1645790416,197644,true,2611315170,28,2628605982,17290812
1645790487,197644,true,2611315170,28,2629131730,17816560
1645790504,197645,true,2611054064,28,2629131730,18077666
1645790596,197641,true,2612098643,28,2630183540,18084897
1645790612,197639,true,2612621088,28,2630446559,17825471
1645790629,197638,true,2612882351,28,2630709603,17827252
1645790714,197638,true,2612882351,28,2632551652,19669301
1645790826,197633,true,2614189053,28,2635185389,20996336
1645790879,197630,true,2614973388,28,2636239621,21266233
1645790908,197630,true,2614973388,28,2637030572,22057184
1645790947,197629,true,2615234886,28,2638349351,23114465
1645791245,197623,true,2616804419,28,2647069849,30265430
1645791306,197620,true,2617589539,28,2648923354,31333815
1645791534,197620,true,2617589539,28,2655288086,37698547
1645791562,197619,true,2617851298,28,2656084753,38233455
1645791688,197614,true,2619160485,28,2659273808,40113323
1645791729,197611,true,2619946312,28,2660337677,40391365
1645791747,197611,true,2619946312,28,2660869771,40923459
1645791756,197610,true,2620208306,28,2661135858,40927552
1645791938,197605,true,2621518673,28,2665130357,43611684
1645792366,197602,true,2622305207,28,2675009110,52703903
1645792406,197602,true,2622305207,28,2675811693,53506486
1645792414,197602,true,2622305207,28,2675811693,53506486
1645793140,197598,true,2623354286,28,2676079274,52724988
1645793165,197595,true,2624141371,28,2676079274,51937903
1645793432,197595,true,2624141371,28,2675811693,51670322
1645793437,197595,true,2624141371,28,2675811693,51670322
1645793457,197591,true,2625191185,28,2675811693,50620508
1645793645,197587,true,2626241419,28,2678220887,51979468
1645793691,197586,true,2626504043,28,2679024434,52520391
1645793748,197586,true,2626504043,28,2679828221,53324178
1645794476,197581,true,2627817558,28,2693798922,65981364
1645794495,197578,true,2628605982,28,2694337709,65731727
1645795350,197576,true,2629131730,28,2708925755,79794025
1645795558,197576,true,2629131730,28,2710280489,81148759
1645796003,197570,true,2630709603,28,2711364764,80655161
1645796015,197567,true,2631498895,28,2711364764,79865869
1645796071,197564,true,2632288424,28,2711635900,79347476
1645796181,197564,true,2632288424,28,2712449472,80161048
1645797007,197557,true,2634131578,28,2718423131,84291553
1645797028,197553,true,2635185389,28,2718694974,83509585
1645797119,197551,true,2635712453,28,2719238740,83526287
1645797194,197550,true,2635976024,28,2719510664,83534640
1645797238,197543,true,2637821761,28,2719782615,81960854
1645797289,197540,true,2638613186,28,2719782615,81169429
1645797630,197538,true,2639140935,28,2719238740,80097805
1645797665,197537,true,2639404849,28,2718966843,79561994
1645798632,197531,true,2640988888,28,2709467567,68478679
1645798821,197528,true,2641781264,28,2707030265,65249001
1645799467,197526,true,2642309647,28,2701081642,58771995
1645799522,197525,true,2642573878,28,2700271480,57697602
1645799541,197519,true,2644159819,28,2700001480,55841661
1645799613,197515,true,2645217641,28,2699461560,54243919
1645799687,197515,true,2645217641,28,2698921749,53704108
1645799693,197513,true,2645746711,28,2698921749,53175038
1645799728,197507,true,2647334556,28,2698651884,51317328
1645799899,197502,true,2648658488,28,2699191641,50533153
1645800200,197502,true,2648658488,28,2699191641,50533153
1645800259,197500,true,2649188246,28,2699191641,50003395
1645801068,197494,true,2650778157,28,2698382046,47603889
1645801117,197490,true,2651838627,28,2698382046,46543419
1645801200,197488,true,2652369021,28,2698382046,46013025
1645801208,197486,true,2652899522,28,2698112234,45212712
1645801219,197480,true,2654491659,28,2698112234,43620575
1645801231,197476,true,2655553615,28,2698112234,42558619
1645801250,197475,true,2655819171,28,2697842450,42023279
1645801284,197473,true,2656350361,28,2697842450,41492089
1645801345,197468,true,2657678802,28,2697302962,39624160
1645801352,197464,true,2658742033,28,2697302962,38560929
1645801484,197463,true,2659007907,28,2695954716,36946809
1645801693,197461,true,2659539735,28,2691375715,31835980
1645801714,197456,true,2660869771,28,2690837520,29967749
1645801823,197452,true,2661934279,28,2688954687,27020408
1645801871,197452,true,2661934279,28,2688148162,26213883
1645802168,197449,true,2662732939,28,2684656015,21923076
1645802268,197444,true,2664064572,28,2683582421,19517849
1645802362,197440,true,2665130357,28,2683045785,17915428
1645802419,197440,true,2665130357,28,2682777507,17647150
1645802431,197436,true,2666196569,28,2682777507,16580938
1645802481,197432,true,2667263208,28,2682509256,15246048
1645802624,197427,true,2668597106,28,2682241032,13643926
1645802931,197427,true,2668597106,28,2682241032,13643926
1645802956,197424,true,2669397765,28,2682509256,13111491
1645802982,197420,true,2670465685,28,2682509256,12043571
1645803502,197415,true,2671801185,28,2693260243,21459058
1645804066,197415,true,2671801185,28,2702162237,30361052
1645804092,197412,true,2672602805,28,2702432453,29829648
1645804141,197408,true,2673672007,28,2703243264,29571257
1645804225,197403,true,2675009110,28,2704595156,29586046
1645804430,197402,true,2675276611,28,2707030265,31753654
1645804471,197399,true,2676079274,28,2707571699,31492425
1645804535,197395,true,2677149866,28,2708654890,31505024
1645804551,197390,true,2678488709,28,2708925755,30437046
1645804628,197388,true,2679024434,28,2710280489,31256055
1645804667,197384,true,2680096204,28,2710822572,30726368
1645804733,197380,true,2681168404,28,2712178255,31009851
1645805122,197374,true,2682777507,28,2718151316,35373809
1645805252,197372,true,2683314089,28,2720326598,37012509
1645805319,197368,true,2684387576,28,2721142778,36755202
1645805880,197363,true,2685730038,28,2729318054,43588016
1645805960,197357,true,2687341879,28,2729863945,42522066
1645806343,197356,true,2687610613,28,2731775423,44164810
1645806386,197352,true,2688685819,28,2731775423,43089604
1645806537,197349,true,2689492505,28,2730682986,41190481
1645806703,197343,true,2691106604,28,2729045150,37938546
1645806729,197342,true,2691375715,28,2728772273,37396558
1645808085,197340,true,2691914017,28,2715434659,23520642
1645808145,197336,true,2692990944,28,2715163143,22172199
1645808568,197331,true,2694337709,28,2714891654,20553945
1645808795,197330,true,2694607142,28,2716249371,21642229
1645808915,197327,true,2695415605,28,2716520996,21105391
1645809133,197324,true,2696224311,28,2716792648,20568337
1645809163,197320,true,2697302962,28,2716792648,19489686
1645809210,197319,true,2697572693,28,2716792648,19219955
1645809253,197316,true,2698382046,28,2716520996,18138950
1645809264,197314,true,2698921749,28,2716520996,17599247
1645809305,197310,true,2700001480,28,2716249371,16247891
1645809316,197311,true,2699731506,28,2715977773,16246267
1645809325,197310,true,2700001480,28,2715977773,15976293
1645809471,197310,true,2700001480,28,2714348757,14347277
1645809542,197306,true,2701081642,28,2713534615,12452973
1645809562,197307,true,2700811561,28,2713534615,12723054
1645809940,197305,true,2701351750,28,2711093654,9741904
1645809980,197307,true,2700811561,28,2710822572,10011011
1645810110,197303,true,2701892048,28,2709738514,7846466
1645810177,197304,true,2701621886,28,2709467567,7845681
1645810207,197302,true,2702162237,28,2709196648,7034411
1645810224,197303,true,2701892048,28,2709196648,7304600
1645810267,197299,true,2702972967,28,2709196648,6223681
1645810911,197299,true,2702972967,28,2708113240,5140273
1645811015,197297,true,2703513588,28,2708113240,4599652
1645811343,197298,true,2703243264,28,2711093654,7850390
1645811393,197294,true,2704324723,28,2711093654,6768931
1645811402,197294,true,2704324723,28,2711364764,7040041
1645811690,197293,true,2704595156,28,2711093654,6498498
1645812143,197295,true,2704054318,28,2708925755,4871437
1645812167,197291,true,2705136102,28,2708925755,3789653
1645812208,197290,true,2705406616,28,2708384051,2977435
1645812212,197290,true,2705406616,28,2708384051,2977435
1645812228,197293,true,2704595156,28,2707842456,3247300
1645812249,197290,true,2705406616,28,2707571699,2165083
1645812466,197292,true,2704865615,28,2704054318,-811297
1645812488,197291,true,2705136102,28,2703783940,-1352162
1645812503,197295,true,2704054318,28,2703243264,-811054
1645813139,197294,true,2704324723,28,2690837520,-13487203
1645813231,197296,true,2703783940,28,2689492505,-14291435
1645813278,197295,true,2704054318,28,2688954687,-15099631
1645813718,197299,true,2702972967,28,2683850779,-19122188
1645813806,197298,true,2703243264,28,2683045785,-20197479
1645813858,197300,true,2702702696,28,2682509256,-20193440
1645813921,197300,true,2702702696,28,2681704664,-20998032
1645813971,197305,true,2701351750,28,2681436520,-19915230
1645815309,197303,true,2701892048,28,2684119164,-17772884
1645815468,197305,true,2701351750,28,2684387576,-16964174
1645815589,197305,true,2701351750,28,2684387576,-16964174
1645816089,197310,true,2700001480,28,2682777507,-17223973
1645816610,197309,true,2700271480,28,2680364214,-19907266
1645816770,197310,true,2700001480,28,2679828221,-20173259
1645816827,197309,true,2700271480,28,2679828221,-20443259
1645816830,197314,true,2698921749,28,2679828221,-19093528
1645816851,197312,true,2699461560,28,2679828221,-19633339
1645816984,197312,true,2699461560,28,2680096204,-19365356
1645817028,197311,true,2699731506,28,2680096204,-19635302
1645817126,197314,true,2698921749,28,2680632250,-18289499
1645817155,197312,true,2699461560,28,2680900313,-18561247
1645817661,197311,true,2699731506,28,2685461492,-14270014
1645818160,197310,true,2700001480,28,2689761454,-10240026
1645818587,197314,true,2698921749,28,2692721672,-6200077
1645818698,197313,true,2699191641,28,2692990944,-6200697
1645818714,197313,true,2699191641,28,2692990944,-6200697
1645818764,197312,true,2699461560,28,2692990944,-6470616
1645819536,197316,true,2698382046,28,2687879374,-10502672
1645819549,197316,true,2698382046,28,2687879374,-10502672
1645819633,197314,true,2698921749,28,2687341879,-11579870
1645819682,197314,true,2698921749,28,2687073172,-11848577
1645819689,197318,true,2697842450,28,2687073172,-10769278
1645819709,197317,true,2698112234,28,2686804491,-11307743
1645820154,197315,true,2698651884,28,2683850779,-14801105
1645820158,197314,true,2698921749,28,2683850779,-15070970
1645820177,197317,true,2698112234,28,2683850779,-14261455
1645821593,197315,true,2698651884,28,2687879374,-10772510
1645821962,197312,true,2699461560,28,2690568463,-8893097
1645822199,197311,true,2699731506,28,2691375715,-8355791
1645822284,197314,true,2698921749,28,2691914017,-7007732
1645822820,197311,true,2699731506,28,2698382046,-1349460
1645823320,197307,true,2700811561,28,2704324723,3513162
1645823408,197307,true,2700811561,28,2705406616,4595055
1645823427,197309,true,2700271480,28,2705677156,5405676
1645823442,197306,true,2701081642,28,2705947724,4866082
1645823452,197303,true,2701892048,28,2705947724,4055676
1645824518,197302,true,2702162237,28,2717607767,15445530
1645824872,197305,true,2701351750,28,2719510664,18158914
1645824909,197303,true,2701892048,28,2719510664,17618616
1645825080,197300,true,2702702696,28,2720326598,17623902
1645825848,197299,true,2702972967,28,2718423131,15450164
1645826501,197303,true,2701892048,28,2715163143,13271095
1645826515,197301,true,2702432453,28,2714891654,12459201
1645826552,197299,true,2702972967,28,2714620192,11647225
1645828435,197299,true,2702972967,28,2704324723,1351756
1645828462,197303,true,2701892048,28,2704595156,2703108
1645828486,197302,true,2702162237,28,2704595156,2432919
1645828539,197300,true,2702702696,28,2704865615,2162919
1645828562,197300,true,2702702696,28,2704865615,2162919
1645828889,197304,true,2701621886,28,2707030265,5408379
1645829106,197302,true,2702162237,28,2708925755,6763518
1645829173,197301,true,2702432453,28,2710009488,7577035
1645829263,197301,true,2702432453,28,2711907064,9474611
1645829267,197304,true,2701621886,28,2711907064,10285178
1645829274,197301,true,2702432453,28,2712178255,9745802
1645829282,197300,true,2702702696,28,2712449472,9746776
1645829357,197296,true,2703783940,28,2715163143,11379203
1645829402,197299,true,2702972967,28,2717064327,14091360
1645829513,197296,true,2703783940,28,2721142778,17358838
1645829846,197294,true,2704324723,28,2733961609,29636886
1645829882,197290,true,2705406616,28,2735602396,30195780
1645829910,197292,true,2704865615,28,2736970471,32104856
1645829930,197289,true,2705677156,28,2737791644,32114488
1645830063,197285,true,2706759589,28,2744095496,37335907
1645830170,197280,true,2708113240,28,2749313973,41200733
1645830344,197282,true,2707571699,28,2758125428,50553729
1645830372,197279,true,2708384051,28,2759504766,51120715
1645830393,197274,true,2709738514,28,2760332700,50594186
1645831172,197273,true,2710009488,28,2779999815,69990327
1645831189,197275,true,2709467567,28,2779999815,70532248
1645831225,197272,true,2710280489,28,2780277815,69997326
1645831295,197267,true,2711635900,28,2780833898,69197998
1645831305,197263,true,2712720717,28,2780833898,68113181
1645831326,197264,true,2712449472,28,2781390093,68940621
1645831351,197259,true,2713805968,28,2781946399,68140431
1645831590,197253,true,2715434659,28,2786958161,71523502
1645831643,197249,true,2716520996,28,2788073111,71552115
1645831673,197249,true,2716520996,28,2788630754,72109758
1645831840,197244,true,2717879528,28,2790583381,72703853
1645831849,197237,true,2719782615,28,2790862439,71079824
1645832065,197234,true,2720598631,28,2793933923,73335292
1645832150,197234,true,2720598631,28,2795051665,74453034
1645832282,197229,true,2721959202,28,2798407572,76448370
1645832339,197222,true,2723865146,28,2799807056,75941910
1645832438,197219,true,2724682387,28,2802327890,77645503
1645832500,197219,true,2724682387,28,2803729334,79046947
1645832608,197215,true,2725772423,28,2806534326,80761903
1645832648,197209,true,2727408296,28,2807376370,79968074
1645832692,197206,true,2728226600,28,2807937874,79711274
1645832699,197206,true,2728226600,28,2807937874,79711274
1645832700,197203,true,2729045150,28,2807937874,78892724
1645832767,197199,true,2730136932,28,2808499489,78362557
1645832814,197196,true,2730956055,28,2808780339,77824284
1645832877,197196,true,2730956055,28,2808780339,77824284
1645832909,197192,true,2732048601,28,2808780339,76731738
1645832929,197189,true,2732868297,28,2808780339,75912042
1645833069,197187,true,2733414898,28,2807657108,74242210
1645833181,197186,true,2733688240,28,2805131479,71443239
1645833628,197183,true,2734508428,28,2792816629,58308201
1645833700,197179,true,2735602396,28,2790583381,54980985
1645833819,197176,true,2736423159,28,2786679493,50256334
1645833852,197176,true,2736423159,28,2785565100,49141941
1645833871,197172,true,2737517892,28,2785008070,47490178
1645833969,197167,true,2738886925,28,2782224593,43337668
1645834007,197165,true,2739434730,28,2781111982,41677252
1645834066,197164,true,2739708673,28,2779443898,39735225
1645834074,197160,true,2740804721,28,2779165982,38361261
1645834107,197155,true,2742175397,28,2778332399,36157002
1645834110,197152,true,2742998132,28,2778332399,35334267
1645834659,197151,true,2743272432,28,2771118477,27846045
1645835006,197147,true,2744369906,28,2773890843,29520937
1645835203,197142,true,2745742365,28,2776110733,30368368
1645835831,197140,true,2746291541,28,2781668232,35376691
1645835846,197138,true,2746840827,28,2781946399,35105572
1645835850,197134,true,2747939728,28,2781946399,34006671
1645835874,197128,true,2749588904,28,2781946399,32357495
1645835906,197124,true,2750688905,28,2782502816,31813911
1645835952,197122,true,2751239070,28,2783059344,31820274
1645835990,197116,true,2752890226,28,2784451152,31560926
1645836011,197111,true,2754266946,28,2785008070,30741124
1645836023,197106,true,2755644355,28,2785286571,29642216
1645836120,197103,true,2756471131,28,2788073111,31601980
1645836131,197098,true,2757849643,28,2788351919,30502276
1645836151,197093,true,2759228843,28,2788909617,29680774
1645836192,197088,true,2760608734,28,2790304351,29695617
1645836250,197084,true,2761713143,28,2792537375,30824232
1645836273,197078,true,2763370585,28,2793375220,30004635
1645836315,197073,true,2764752547,28,2795051665,30299118
1645836354,197068,true,2766135199,28,2796169853,30034654
1645836376,197063,true,2767518544,28,2797008788,29490244
1645836382,197058,true,2768902580,28,2797008788,28106208
1645836404,197053,true,2770287308,28,2797568218,27280910
1645836456,197048,true,2771672729,28,2798967282,27294553
1645837357,197044,true,2772781564,28,2821729842,48948278
1645837371,197039,true,2774168232,28,2822294217,48125985
1645837375,197034,true,2775555594,28,2822294217,46738623
1645837523,197029,true,2776943649,28,2826530623,49586974
1645837555,197024,true,2778332399,28,2827661404,49329005
1645837568,197020,true,2779443898,28,2827944171,48500273
1645837860,197015,true,2780833898,28,2832472276,51638378
1645837887,197010,true,2782224593,28,2832472276,50247683
1645837921,197006,true,2783337650,28,2832472276,49134626
1645837931,197002,true,2784451152,28,2832472276,48021124
1645837992,196999,true,2785286571,28,2832189057,46902486
1645838181,196995,true,2786400853,28,2830773388,44372535
1645838518,196990,true,2787794332,28,2831056465,43262133
1645838628,196987,true,2788630754,28,2831056465,42425711
1645838956,196984,true,2789467427,28,2831905867,42438440
1645838997,196981,true,2790304351,28,2832189057,41884706
1645839316,196976,true,2791699782,28,2831905867,40206085
1645839370,196973,true,2792537375,28,2831622705,39085330
1645839420,196970,true,2793375220,28,2831339571,37964351
1645840216,196967,true,2794213317,28,2825117781,30904464
1645840407,196963,true,2795331170,28,2823988016,28656846
1645840647,196960,true,2796169853,28,2822294217,26124364
1645840894,196956,true,2797288489,28,2820601433,23312944
1645840900,196953,true,2798127759,28,2820601433,22473674
1645842304,196948,true,2799527103,28,2816373913,16846810
1645842771,196945,true,2800367045,28,2815529170,15162125
1645844683,196942,true,2801207239,28,2811309253,10102014
1645844718,196939,true,2802047685,28,2811309253,9261568
1645845195,196936,true,2802888384,28,2809623058,6734674
1645845275,196933,true,2803729334,28,2809342123,5612789
1645845397,196931,true,2804290108,28,2808780339,4490231
1645845795,196929,true,2804850994,28,2805973103,1122109
1645845838,196927,true,2805411993,28,2805692534,280541
1645847143,196926,true,2805692534,28,2794772187,-10920347
1645848106,196925,true,2805973103,28,2792816629,-13156474
1645848205,196926,true,2805692534,28,2793095911,-12596623
1645848626,196924,true,2806253700,28,2793375220,-12878480
1645848629,196923,true,2806534326,28,2793375220,-13159106
1645848645,196922,true,2806814979,28,2793375220,-13439759
1645848693,196923,true,2806534326,28,2793375220,-13159106
1645849314,196921,true,2807095661,28,2796169853,-10925808
1645849339,196920,true,2807376370,28,2796169853,-11206517
1645849383,196921,true,2807095661,28,2796449470,-10646191
1645849467,196922,true,2806814979,28,2797008788,-9806191
1645849471,196919,true,2807657108,28,2797008788,-10648320
1645850921,196919,true,2807657108,28,2807095661,-561447
1645850955,196919,true,2807657108,28,2807095661,-561447
1645851293,196918,true,2807937874,28,2809342123,1404249
1645851849,196915,true,2808780339,28,2811309253,2528914
1645852288,196914,true,2809061217,28,2812433945,3372728
1645852669,196915,true,2808780339,28,2813559088,4778749
1645852705,196915,true,2808780339,28,2813559088,4778749
1645852742,196912,true,2809623058,28,2813559088,3936030
1645853001,196912,true,2809623058,28,2812433945,2810887
1645853109,196915,true,2808780339,28,2811590384,2810045
1645853745,196916,true,2808499489,28,2805692534,-2806955
1645853816,196914,true,2809061217,28,2804850994,-4210223
1645854128,196914,true,2809061217,28,2801207239,-7853978
1645854174,196918,true,2807937874,28,2800367045,-7570829
1645854253,196920,true,2807376370,28,2798687413,-8688957
1645855288,196918,true,2807937874,28,2784172735,-23765139
1645855495,196920,true,2807376370,28,2781946399,-25429971
1645855609,196923,true,2806534326,28,2781111982,-25422344
1645856789,196925,true,2805973103,28,2778610232,-27362871
1645856918,196924,true,2806253700,28,2778888093,-27365607
1645857131,196925,true,2805973103,28,2779165982,-26807121
1645857601,196928,true,2805131479,28,2779999815,-25131664
1645857742,196930,true,2804570537,28,2780277815,-24292722
1645859381,196928,true,2805131479,28,2783059344,-22072135
1645859466,196928,true,2805131479,28,2783059344,-22072135
1645859486,196929,true,2804850994,28,2783059344,-21791650
1645859513,196930,true,2804570537,28,2782781066,-21789471
1645859545,196928,true,2805131479,28,2782781066,-22350413
1645859649,196929,true,2804850994,28,2781946399,-22904595
1645859803,196930,true,2804570537,28,2780833898,-23736639
1645860224,196930,true,2804570537,28,2777221343,-27349194
1645860278,196928,true,2805131479,28,2776943649,-28187830
1645860416,196928,true,2805131479,28,2776110733,-29020746
1645860790,196929,true,2804850994,28,2773890843,-30960151
1645861136,196929,true,2804850994,28,2772227091,-32623903
1645861170,196927,true,2805411993,28,2771949896,-33462097
1645861179,196927,true,2805411993,28,2771949896,-33462097
1645861566,196928,true,2805131479,28,2773058842,-32072637
1645861697,196928,true,2805131479,28,2773890843,-31240636
1645861720,196926,true,2805692534,28,2773890843,-31801691
1645861797,196926,true,2805692534,28,2774445649,-31246885
1645861894,196927,true,2805411993,28,2775000566,-30411427
1645861927,196927,true,2805411993,28,2775278066,-30133927
1645862061,196926,true,2805692534,28,2776388344,-29304190
1645862384,196926,true,2805692534,28,2778332399,-27360135
1645862596,196927,true,2805411993,28,2779999815,-25412178
1645863352,196927,true,2805411993,28,2784451152,-20960841
1645863602,196925,true,2805973103,28,2785565100,-20408003
1645863606,196926,true,2805692534,28,2785565100,-20127434
1645863615,196926,true,2805692534,28,2785565100,-20127434
1645863665,196927,true,2805411993,28,2786400853,-19011140
1645863956,196925,true,2805973103,28,2790304351,-15668752
1645864005,196926,true,2805692534,28,2791141526,-14551008
1645864041,196928,true,2805131479,28,2791420640,-13710839
1645864064,196930,true,2804570537,28,2791699782,-12870755
1645864698,196929,true,2804850994,28,2797847974,-7003020
1645864738,196930,true,2804570537,28,2798407572,-6162965
1645864768,196932,true,2804009707,28,2798407572,-5602135
1645864803,196934,true,2803448990,28,2798687413,-4761577
1645864868,196935,true,2803168673,28,2798687413,-4481260
1645864900,196937,true,2802608123,28,2798687413,-3920710
1645865124,196940,true,2801767509,28,2798407572,-3359937
1645865153,196942,true,2801207239,28,2798407572,-2799667
1645865176,196943,true,2800927147,28,2798127759,-2799388
1645865205,196945,true,2800367045,28,2797847974,-2519071
1645865223,196948,true,2799527103,28,2797847974,-1679129
1645865313,196950,true,2798967282,28,2796729115,-2238167
1645865472,196950,true,2798967282,28,2794213317,-4753965
1645865492,196953,true,2798127759,28,2793933923,-4193836
1645866252,196957,true,2797008788,28,2771949896,-25058892
1645866794,196959,true,2796449470,28,2760056695,-36392775
1645866822,196961,true,2795890264,28,2759504766,-36385498
1645866830,196963,true,2795331170,28,2759504766,-35826404
1645866916,196967,true,2794213317,28,2757573885,-36639432
1645866968,196970,true,2793375220,28,2756746778,-36628442
1645867170,196972,true,2792816629,28,2753716176,-39100453
1645867184,196974,true,2792258150,28,2753440832,-38817318
1645867334,196978,true,2791141526,28,2752339731,-38801795
1645867427,196981,true,2790304351,28,2752339731,-37964620
1645867513,196983,true,2789746373,28,2752064524,-37681849
1645871782,196984,true,2789467427,28,2753440832,-36026595
1645872043,196988,true,2788351919,28,2753716176,-34635743
1645872651,196991,true,2787515580,28,2753991547,-33524033
1645872677,196992,true,2787236857,28,2753991547,-33245310
1645872725,196994,true,2786679493,28,2754266946,-32412547
1645873421,196997,true,2785843656,28,2759504766,-26338890
1645873639,196998,true,2785565100,28,2761436999,-24128101
1645873684,196999,true,2785286571,28,2761713143,-23573428
1645873708,197001,true,2784729597,28,2761713143,-23016454
1645873877,197004,true,2783894345,28,2762541740,-21352605
1645873997,197006,true,2783337650,28,2762817994,-20519656
1645874346,197007,true,2783059344,28,2761989314,-21070030
1645874384,197008,true,2782781066,28,2761713143,-21067923
1645874401,197012,true,2781668232,28,2761713143,-19955089
1645875976,197013,true,2781390093,28,2753991547,-27398546
1645875979,197014,true,2781111982,28,2753991547,-27120435
1645875991,197016,true,2780555843,28,2754266946,-26288897
1645876266,197018,true,2779999815,28,2756195512,-23804303
1645876533,197018,true,2779999815,28,2757573885,-22425930
1645876665,197019,true,2779721843,28,2757849643,-21872200
1645876962,197020,true,2779443898,28,2758952948,-20490950
1645877023,197022,true,2778888093,28,2758952948,-19935145
1645877097,197022,true,2778888093,28,2758952948,-19935145
1645877198,197023,true,2778610232,28,2758952948,-19657284
1645877256,197025,true,2778054593,28,2758952948,-19101645
1645877636,197027,true,2777499066,28,2758677080,-18821986
1645877714,197028,true,2777221343,28,2758677080,-18544263
1645877854,197029,true,2776943649,28,2758401240,-18542409
1645877993,197030,true,2776665982,28,2758125428,-18540554
1645878115,197033,true,2775833149,28,2757573885,-18259264
1645878412,197033,true,2775833149,28,2756746778,-19086371
1645878514,197035,true,2775278066,28,2756471131,-18806935
1645880207,197037,true,2774723093,28,2753440832,-21282261
1645880410,197040,true,2773890843,28,2753716176,-20174667
1645880437,197040,true,2773890843,28,2753716176,-20174667
1645880443,197043,true,2773058842,28,2753716176,-19342666
1645880452,197045,true,2772504314,28,2753716176,-18788138
1645880904,197046,true,2772227091,28,2755919920,-16307171
1645880921,197047,true,2771949896,28,2755919920,-16029976
1645881090,197049,true,2771395589,28,2757022453,-14373136
1645881150,197051,true,2770841393,28,2757573885,-13267508
1645881277,197051,true,2770841393,28,2759228843,-11612550
1645882553,197050,true,2771118477,28,2775833149,4714672
1645883465,197052,true,2770564337,28,2778054593,7490256
1645883521,197053,true,2770287308,28,2777776815,7489507
1645884956,197053,true,2770287308,28,2774168232,3880924
1645885447,197052,true,2770564337,28,2772227091,1662754
1645885653,197053,true,2770287308,28,2771949896,1662588
1645886051,197054,true,2770010307,28,2771395589,1385282
1645886061,197054,true,2770010307,28,2771395589,1385282
1645886108,197053,true,2770287308,28,2771672729,1385421
1645886260,197053,true,2770287308,28,2772504314,2217006
1645886697,197053,true,2770287308,28,2775000566,4713258
1645888003,197054,true,2770010307,28,2781111982,11101675
1645888229,197053,true,2770287308,28,2780555843,10268535
1645888258,197054,true,2770010307,28,2780555843,10545536
1645888496,197053,true,2770287308,28,2780833898,10546590
1645889162,197054,true,2770010307,28,2783059344,13049037
1645889847,197052,true,2770564337,28,2786679493,16115156
1645889861,197052,true,2770564337,28,2786958161,16393824
1645890266,197051,true,2770841393,28,2791141526,20300133
1645890941,197051,true,2770841393,28,2796169853,25328460
1645891021,197048,true,2771672729,28,2796729115,25056386
1645891094,197048,true,2771672729,28,2797008788,25336059
1645891341,197047,true,2771949896,28,2797288489,25338593
1645899404,197048,true,2771672729,28,2790304351,18631622
1645899445,197046,true,2772227091,28,2790304351,18077260
1645899573,197046,true,2772227091,28,2790025348,17798257
1645899615,197045,true,2772504314,28,2789746373,17242059
1645899639,197047,true,2771949896,28,2789467427,17517531
1645899853,197046,true,2772227091,28,2787794332,15567241
1645899959,197046,true,2772227091,28,2786958161,14731070
1645901353,197046,true,2772227091,28,2775833149,3606058
1645901565,197048,true,2771672729,28,2775833149,4160420
1645901606,197046,true,2772227091,28,2775833149,3606058
1645901985,197047,true,2771949896,28,2777776815,5826919
1645902050,197046,true,2772227091,28,2778332399,6105308
1645902074,197048,true,2771672729,28,2778332399,6659670
1645902178,197046,true,2772227091,28,2779443898,7216807
1645902218,197046,true,2772227091,28,2779999815,7772724
1645902233,197045,true,2772504314,28,2780277815,7773501
1645902256,197046,true,2772227091,28,2780555843,8328752
1645902273,197045,true,2772504314,28,2780833898,8329584
1645902520,197046,true,2772227091,28,2785286571,13059480
1645902783,197044,true,2772781564,28,2790304351,17522787
1645902791,197046,true,2772227091,28,2790304351,18077260
1645902804,197045,true,2772504314,28,2790583381,18079067
1645902923,197045,true,2772504314,28,2793375220,20870906
1645902936,197043,true,2773058842,28,2793654558,20595716
1645903235,197044,true,2772781564,28,2801207239,28425675
1645904115,197042,true,2773336148,28,2818345966,45009818
1645904171,197042,true,2773336148,28,2818909664,45573516
1645905210,197039,true,2774168232,28,2823988016,49819784
1645905400,197039,true,2774168232,28,2824270415,50102183
1645905409,197037,true,2774723093,28,2824270415,49547322
1645905486,197036,true,2775000566,28,2824270415,49269849
1645905756,197034,true,2775555594,28,2823705646,48150052
1645906310,197034,true,2775555594,28,2821729842,46174248
1645907870,197031,true,2776388344,28,2817782382,41394038
1645908397,197030,true,2776665982,28,2817782382,41116400
1645908728,197027,true,2777499066,28,2818345966,40846900
1645908756,197026,true,2777776815,28,2818345966,40569151
1645908796,197023,true,2778610232,28,2818627801,40017569
1645909801,197021,true,2779165982,28,2822294217,43128235
1645909884,197018,true,2779999815,28,2823140989,43141174
1645909949,197017,true,2780277815,28,2823423304,43145489
1645909970,197013,true,2781390093,28,2823705646,42315553
1645910040,197010,true,2782224593,28,2824552842,42328249
1645910211,197006,true,2783337650,28,2826813276,43475626
1645911016,197004,true,2783894345,28,2836723960,52829615
1645911153,197001,true,2784729597,28,2838426420,53696823
1645911340,196998,true,2785565100,28,2840129902,54564802
1645911434,196995,true,2786400853,28,2841266124,54865271
1645912058,196993,true,2786958161,28,2842402801,55444640
1645912069,196990,true,2787794332,28,2842402801,54608469
1645912360,196987,true,2788630754,28,2840413915,51783161
1645912458,196984,true,2789467427,28,2839561961,50094534
1645912520,196984,true,2789467427,28,2838994134,49526707
1645912896,196982,true,2790025348,28,2834739047,44713699
1645913870,196980,true,2790583381,28,2825682833,35099452
1645913891,196977,true,2791420640,28,2825400293,33979653
1645913907,196977,true,2791420640,28,2825400293,33979653
1645913967,196974,true,2792258150,28,2824552842,32294692
1645913983,196972,true,2792816629,28,2824270415,31453786
1645914532,196970,true,2793375220,28,2817500632,24125412
1645915197,196970,true,2793375220,28,2811309253,17934033
1645916243,196967,true,2794213317,28,2806534326,12321009
1645916261,196966,true,2794492738,28,2806534326,12041588
1645916280,196964,true,2795051665,28,2806534326,11482661
1645916517,196963,true,2795331170,28,2805692534,10361364
1645916597,196963,true,2795331170,28,2805131479,9800309
1645916607,196961,true,2795890264,28,2805131479,9241215
1645916650,196959,true,2796449470,28,2804850994,8401524
1645916757,196959,true,2796449470,28,2803729334,7279864
1645917168,196959,true,2796449470,28,2798967282,2517812
1645918219,196958,true,2796729115,28,2787236857,-9492258
1645918266,196955,true,2797568218,28,2786679493,-10888725
1645918287,196955,true,2797568218,28,2786679493,-10888725
1645918324,196955,true,2797568218,28,2786122241,-11445977
1645918852,196954,true,2797847974,28,2783337650,-14510324
1645919834,196952,true,2798407572,28,2777499066,-20908506
1645920533,196953,true,2798127759,28,2775555594,-22572165
1645920869,196953,true,2798127759,28,2775833149,-22294610
1645921232,196952,true,2798407572,28,2777221343,-21186229
1645921654,196949,true,2799247178,28,2778888093,-20359085
1645921667,196950,true,2798967282,28,2778888093,-20079189
1645921701,196949,true,2799247178,28,2778888093,-20359085
1645921773,196948,true,2799527103,28,2778888093,-20639010
1645921804,196947,true,2799807056,28,2778888093,-20918963
1645921814,196948,true,2799527103,28,2778610232,-20916871
1645921832,196948,true,2799527103,28,2778610232,-20916871
1645921843,196948,true,2799527103,28,2778610232,-20916871
1645921885,196947,true,2799807056,28,2778054593,-21752463
1645921909,196949,true,2799247178,28,2777776815,-21470363
1645922339,196951,true,2798687413,28,2773058842,-25628571
1645922864,196951,true,2798687413,28,2764752547,-33934866
1645923292,196951,true,2798687413,28,2757298155,-41389258
1645923859,196953,true,2798127759,28,2751789345,-46338414
1645923938,196954,true,2797847974,28,2751514194,-46333780
1645923981,196954,true,2797847974,28,2751239070,-46608904
1645923998,196954,true,2797847974,28,2750963973,-46884001
1645924209,196957,true,2797008788,28,2747939728,-49069060
1645924221,196959,true,2796449470,28,2747664961,-48784509
1645924237,196960,true,2796169853,28,2747390222,-48779631
1645924456,196962,true,2795610703,28,2743546759,-52063944
1645925367,196965,true,2794772187,28,2726862896,-67909291
1645925388,196967,true,2794213317,28,2726590237,-67623080
1645925729,196969,true,2793654558,28,2719238740,-74415818
1645925909,196970,true,2793375220,28,2717336034,-76039186
1645927127,196975,true,2791978952,28,2708654890,-83324062
1645927175,196978,true,2791141526,28,2708113240,-83028286
1645927183,196979,true,2790862439,28,2708113240,-82749199
1645927200,196981,true,2790304351,28,2707842456,-82461895
1645927509,196989,true,2788073111,28,2704054318,-84018793
1645927834,196992,true,2787236857,28,2701621886,-85614971
1645927851,196993,true,2786958161,28,2701621886,-85336275
1645927983,196994,true,2786679493,28,2700811561,-85867932
1645928255,197001,true,2784729597,28,2699731506,-84998091
1645928302,197004,true,2783894345,28,2699731506,-84162839
1645928510,197005,true,2783615984,28,2699731506,-83884478
1645928546,197006,true,2783337650,28,2699461560,-83876090
1645928559,197011,true,2781946399,28,2699461560,-82484839
1645929273,197014,true,2781111982,28,2699191641,-81920341
1645930495,197015,true,2780833898,28,2700811561,-80022337
1645930575,197016,true,2780555843,28,2700811561,-79744282
1645930624,197021,true,2779165982,28,2700811561,-78354421
1645930642,197023,true,2778610232,28,2701081642,-77528590
1645930910,197024,true,2778332399,28,2701892048,-76440351
1645930947,197026,true,2777776815,28,2701892048,-75884767
1645931042,197031,true,2776388344,28,2702432453,-73955891
1645931101,197034,true,2775555594,28,2702702696,-72852898
1645931163,197035,true,2775278066,28,2702972967,-72305099
1645931506,197037,true,2774723093,28,2704865615,-69857478
1645931764,197042,true,2773336148,28,2706488941,-66847207
1645932354,197045,true,2772504314,28,2710822572,-61681742
1645932454,197047,true,2771949896,28,2711635900,-60313996
1645932494,197049,true,2771395589,28,2711907064,-59488525
1645934464,197054,true,2770010307,28,2719782615,-50227692
1645934549,197057,true,2769179470,28,2719782615,-49396855
1645935036,197059,true,2768625717,28,2719510664,-49115053
1645936338,197061,true,2768072075,28,2717607767,-50464308
1645937004,197067,true,2766411813,28,2717336034,-49075779
1645937457,197070,true,2765582055,28,2717336034,-48246021
1645937559,197073,true,2764752547,28,2717336034,-47416513
1645937613,197075,true,2764199679,28,2717064327,-47135352
1645938119,197081,true,2762541740,28,2715163143,-47378597
1645938280,197085,true,2761436999,28,2714348757,-47088242
1645938793,197088,true,2760608734,28,2711907064,-48701670
1645940063,197090,true,2760056695,28,2709738514,-50318181
1645940327,197096,true,2758401240,28,2710009488,-48391752
1645940512,197099,true,2757573885,28,2710551517,-47022368
1645940599,197101,true,2757022453,28,2710551517,-46470936
1645940633,197103,true,2756471131,28,2710822572,-45648559
1645941474,197109,true,2754817827,28,2713263289,-41554538
1645942050,197112,true,2753991547,28,2714891654,-39099893
1645942370,197115,true,2753165515,28,2715706203,-37459312
1645942960,197117,true,2752614965,28,2715706203,-36908762
1645943009,197123,true,2750963973,28,2715706203,-35257770
1645943052,197127,true,2749863863,28,2715977773,-33886090
1645943133,197130,true,2749039069,28,2715977773,-33061296
1645943185,197133,true,2748214522,28,2715977773,-32236749
1645943205,197139,true,2746566170,28,2716249371,-30316799
1645943520,197142,true,2745742365,28,2718151316,-27591049
1645943939,197146,true,2744644343,28,2720870691,-23773652
1645944863,197148,true,2744095496,28,2726590237,-17505259
1645944986,197154,true,2742449615,28,2727135582,-15314033
1645945056,197156,true,2741901207,28,2727408296,-14492911
1645945346,197160,true,2740804721,28,2727953805,-12850916
1645945439,197162,true,2740256642,28,2728226600,-12030042
1645945910,197166,true,2739160814,28,2732048601,-7112213
1645946024,197168,true,2738613064,28,2733414898,-5198166
1645946150,197170,true,2738065423,28,2734508428,-3556995
1645946162,197172,true,2737517892,28,2734781879,-2736013
1645946946,197176,true,2736423159,28,2742998132,6574973
1645947961,197178,true,2735875956,28,2747390222,11514266
1645948445,197179,true,2735602396,28,2747115511,11513115
1645948455,197180,true,2735328863,28,2747115511,11786648
1645948817,197183,true,2734508428,28,2747115511,12607083
1645949158,197185,true,2733961609,28,2746840827,12879218
1645949180,197186,true,2733688240,28,2746840827,13152587
1645949256,197188,true,2733141584,28,2746566170,13424586
1645949332,197191,true,2732321806,28,2746291541,13969735
1645949837,197193,true,2731775423,28,2743821114,12045691
1645949893,197194,true,2731502273,28,2743546759,12044486
1645950575,197196,true,2730956055,28,2738065423,7109368
1645950813,197198,true,2730409945,28,2736696801,6286856
1645951041,197200,true,2729863945,28,2736149544,6285599
1645951382,197201,true,2729590986,28,2736423159,6832173
1645951392,197202,true,2729318054,28,2736423159,7105105
1645951396,197204,true,2728772273,28,2736423159,7650886
1645951403,197206,true,2728226600,28,2736423159,8196559
1645951775,197206,true,2728226600,28,2736149544,7922944
1645952429,197207,true,2727953805,28,2738613064,10659259
1645953218,197209,true,2727408296,28,2738613064,11204768
1645953221,197210,true,2727135582,28,2738613064,11477482
1645953231,197211,true,2726862896,28,2738886925,12024029
1645953245,197212,true,2726590237,28,2738886925,12296688
1645953256,197214,true,2726045001,28,2738886925,12841924
1645953397,197215,true,2725772423,28,2739982644,14210221
1645953481,197215,true,2725772423,28,2740804721,15032298
1645953552,197215,true,2725772423,28,2741352909,15580486
1645953654,197216,true,2725499873,28,2742449615,16949742
1645954490,197216,true,2725499873,28,2750688905,25189032
1645954956,197216,true,2725499873,28,2755368819,29868946
1645955476,197215,true,2725772423,28,2757022453,31250030
1645955483,197217,true,2725227351,28,2757298155,32070804
1645955829,197216,true,2725499873,28,2757573885,32074012
1645955890,197215,true,2725772423,28,2757573885,31801462
1645955948,197214,true,2726045001,28,2757849643,31804642
1645955974,197216,true,2725499873,28,2757849643,32349770
1645957714,197215,true,2725772423,28,2763094276,37321853
1645957756,197214,true,2726045001,28,2763370585,37325584
1645957775,197212,true,2726590237,28,2763370585,36780348
1645957802,197212,true,2726590237,28,2763370585,36780348
1645957940,197209,true,2727408296,28,2764199679,36791383
1645958475,197208,true,2727681036,28,2766411813,38730777
1645958543,197206,true,2728226600,28,2766965123,38738523
1645958587,197205,true,2728499423,28,2767241819,38742396
1645958611,197203,true,2729045150,28,2767518544,38473394
1645958631,197200,true,2729863945,28,2767795296,37931351
1645958648,197198,true,2730409945,28,2768072075,37662130
1645958797,197194,true,2731502273,28,2770287308,38785035
1645958898,197192,true,2732048601,28,2772227091,40178490
1645959096,197188,true,2733141584,28,2776388344,43246760
1645959107,197186,true,2733688240,28,2776665982,42977742
1645959131,197180,true,2735328863,28,2776943649,41614786
1645959135,197177,true,2736149544,28,2777221343,41071799
1645959169,197174,true,2736970471,28,2778054593,41084122
1645959183,197171,true,2737791644,28,2778332399,40540755
1645959613,197166,true,2739160814,28,2788630754,49469940
1645960524,197163,true,2739982644,28,2807095661,67113017
1645960567,197160,true,2740804721,28,2807657108,66852387
1645960603,197157,true,2741627045,28,2807937874,66310829
1645960623,197152,true,2742998132,28,2807937874,64939742
1645960630,197149,true,2743821114,28,2807937874,64116760
1645960677,197147,true,2744369906,28,2808218667,63848761
1645961155,197144,true,2745193299,28,2807095661,61902362
1645961175,197139,true,2746566170,28,2807095661,60529491
1645961197,197136,true,2747390222,28,2807095661,59705439
1645961205,197134,true,2747939728,28,2807095661,59155933
1645961323,197131,true,2748764192,28,2807657108,58892916
1645961334,197125,true,2750413863,28,2807657108,57243245
1645961478,197122,true,2751239070,28,2808780339,57541269
1645963532,197119,true,2752064524,28,2823705646,71641122
1645963798,197116,true,2752890226,28,2823705646,70815420
1645963990,197111,true,2754266946,28,2823705646,69438700
1645964036,197107,true,2755368819,28,2823705646,68336827
1645964054,197105,true,2755919920,28,2823705646,67785726
1645964187,197102,true,2756746778,28,2823423304,66676526
1645964220,197098,true,2757849643,28,2823423304,65573661
1645964293,197095,true,2758677080,28,2822858704,64181624
1645964333,197092,true,2759504766,28,2822576446,63071680
1645964807,197090,true,2760056695,28,2819755421,59698726
1645964897,197086,true,2761160883,28,2818909664,57748781
1645965372,197083,true,2761989314,28,2815529170,53539856
1645965534,197080,true,2762817994,28,2814684680,51866686
1645966102,197077,true,2763646922,28,2812715189,49068267
1645966245,197073,true,2764752547,28,2813559088,48806541
1645966452,197069,true,2765858614,28,2815247645,49389031
1645966628,197066,true,2766688454,28,2816655551,49967097
1645967013,197062,true,2767795296,28,2820319401,52524105
1645967267,197058,true,2768902580,28,2822576446,53673866
1645967409,197054,true,2770010307,28,2823423304,53412997
1645967724,197051,true,2770841393,28,2825682833,54841440
1645967976,197048,true,2771672729,28,2826813276,55140547
1645968005,197043,true,2773058842,28,2826813276,53754434
1645968559,197040,true,2773890843,28,2824835298,50944455
1645968567,197037,true,2774723093,28,2824835298,50112205
1645968578,197034,true,2775555594,28,2824835298,49279704
1645968783,197030,true,2776665982,28,2823140989,46475007
1645968816,197027,true,2777499066,28,2822576446,45077380
1645968822,197024,true,2778332399,28,2822576446,44244047
1645968837,197022,true,2778888093,28,2822576446,43688353
1645968842,197018,true,2779999815,28,2822294217,42294402
1645968867,197017,true,2780277815,28,2822012015,41734200
1645968879,197015,true,2780833898,28,2821729842,40895944
1645968964,197014,true,2781111982,28,2819755421,38643439
1645969036,197011,true,2781946399,28,2817782382,35835983
1645969053,197010,true,2782224593,28,2817218910,34994317
1645969064,197008,true,2782781066,28,2816937216,34156150
1645969476,197009,true,2782502816,28,2803168673,20665857
1645969493,197007,true,2783059344,28,2802608123,19548779
1645969595,197007,true,2783059344,28,2798127759,15068415
1645969657,197006,true,2783337650,28,2795051665,11714015
1645969673,197009,true,2782502816,28,2794213317,11710501
1645969703,197007,true,2783059344,28,2793095911,10036567
1645969715,197007,true,2783059344,28,2792537375,9478031
1645969790,197005,true,2783615984,28,2789746373,6130389
1645969887,197008,true,2782781066,28,2786122241,3341175
1645970020,197006,true,2783337650,28,2781390093,-1947557
1645970044,197006,true,2783337650,28,2780833898,-2503752
1645970057,197004,true,2783894345,28,2780277815,-3616530
1645970345,197005,true,2783615984,28,2772227091,-11388893
1645970697,197002,true,2784451152,28,2766135199,-18315953
1645970748,197001,true,2784729597,28,2766135199,-18594398
1645970771,196999,true,2785286571,28,2766135199,-19151372
1645970811,197000,true,2785008070,28,2765858614,-19149456
1645970837,196997,true,2785843656,28,2765858614,-19985042
1645970861,196997,true,2785843656,28,2765582055,-20261601
1645970884,196995,true,2786400853,28,2765582055,-20818798
1645970895,196997,true,2785843656,28,2765582055,-20261601
1645971402,196994,true,2786679493,28,2766135199,-20544294
1645971537,196994,true,2786679493,28,2767518544,-19160949
1645971800,196991,true,2787515580,28,2769456388,-18059192
1645972397,196993,true,2786958161,28,2769733334,-17224827
1645972407,196990,true,2787794332,28,2769456388,-18337944
1645972461,196989,true,2788073111,28,2769179470,-18893641
1645973563,196987,true,2788630754,28,2768072075,-20558679
1645973635,196989,true,2788073111,28,2767795296,-20277815
1645974973,196988,true,2788351919,28,2761160883,-27191036
1645975001,196988,true,2788351919,28,2760884795,-27467124
1645975113,196986,true,2788909617,28,2760884795,-28024822
1645975134,196988,true,2788351919,28,2760884795,-27467124
1645975291,196986,true,2788909617,28,2761160883,-27748734
1645975335,196986,true,2788909617,28,2761436999,-27472618
1645975396,196984,true,2789467427,28,2761713143,-27754284
1645975400,196986,true,2788909617,28,2761713143,-27196474
1645975420,196984,true,2789467427,28,2761989314,-27478113
1645975445,196983,true,2789746373,28,2762265513,-27480860
1645975499,196980,true,2790583381,28,2763370585,-27212796
1645975535,196982,true,2790025348,28,2764199679,-25825669
1645975557,196979,true,2790862439,28,2764752547,-26109892
1645975562,196979,true,2790862439,28,2764752547,-26109892
1645975622,196975,true,2791978952,28,2766411813,-25567139
1645975636,196977,true,2791420640,28,2766688454,-24732186
1645976025,196973,true,2792537375,28,2777776815,-14760560
1645976316,196974,true,2792258150,28,2785843656,-6414494
1645976326,196970,true,2793375220,28,2786122241,-7252979
1645976336,196972,true,2792816629,28,2786400853,-6415776
1645977340,196970,true,2793375220,28,2802327890,8952670
1645977397,196971,true,2793095911,28,2802047685,8951774
1645977427,196968,true,2793933923,28,2801767509,7833586
1645977588,196970,true,2793375220,28,2800927147,7551927
1645977824,196968,true,2793933923,28,2799527103,5593180
1645978007,196970,true,2793375220,28,2798687413,5312193
1645978341,196967,true,2794213317,28,2798407572,4194255
1645978386,196969,true,2793654558,28,2798407572,4753014
1645978521,196969,true,2793654558,28,2798127759,4473201
1645978531,196970,true,2793375220,28,2798127759,4752539
1645978649,196969,true,2793654558,28,2797847974,4193416
1645978688,196971,true,2793095911,28,2797568218,4472307
1645978697,196971,true,2793095911,28,2797568218,4472307
1645979283,196973,true,2792537375,28,2793654558,1117183
1645979299,196972,true,2792816629,28,2793375220,558591
1645980299,196975,true,2791978952,28,2782224593,-9754359
1645980354,196974,true,2792258150,28,2781946399,-10311751
1645982119,196977,true,2791420640,28,2775833149,-15587491
1645982668,196976,true,2791699782,28,2775555594,-16144188
1645984782,196978,true,2791141526,28,2774168232,-16973294
1645984869,196978,true,2791141526,28,2774168232,-16973294
1645984891,196980,true,2790583381,28,2774168232,-16415149
1645984906,196979,true,2790862439,28,2774168232,-16694207
1645984913,196983,true,2789746373,28,2774168232,-15578141
1645984937,196983,true,2789746373,28,2774168232,-15578141
1645985043,196987,true,2788630754,28,2773613482,-15017272
1645985141,196986,true,2788909617,28,2773058842,-15850775
1645985219,196991,true,2787515580,28,2772227091,-15288489
1645985259,196991,true,2787515580,28,2771672729,-15842851
1645985983,196997,true,2785843656,28,2761160883,-24682773
1645986035,196996,true,2786122241,28,2760332700,-25789541
1645986067,197000,true,2785008070,28,2760056695,-24951375
1645986098,197001,true,2784729597,28,2759504766,-25224831
1645986108,197005,true,2783615984,28,2759504766,-24111218
1645986123,197004,true,2783894345,28,2759228843,-24665502
1645986175,197008,true,2782781066,28,2758677080,-24103986
1645986317,197007,true,2783059344,28,2757573885,-25485459
1645987805,197012,true,2781668232,28,2759228843,-22439389
1645987815,197011,true,2781946399,28,2759228843,-22717556
1645987852,197014,true,2781111982,28,2759504766,-21607216
1645987979,197014,true,2781111982,28,2759228843,-21883139
1645988034,197021,true,2779165982,28,2758952948,-20213034
1645988220,197020,true,2779443898,28,2757573885,-21870013
1645989315,197025,true,2778054593,28,2747115511,-30939082
1645989363,197025,true,2778054593,28,2746566170,-31488423
1645989378,197031,true,2776388344,28,2746566170,-29822174
1645989422,197031,true,2776388344,28,2745467818,-30920526
1645989477,197038,true,2774445649,28,2744369906,-30075743
1645989731,197039,true,2774168232,28,2739160814,-35007418
1645989809,197045,true,2772504314,28,2737517892,-34986422
1645989851,197045,true,2772504314,28,2736696801,-35807513
1645989870,197051,true,2770841393,28,2736423159,-34418234
1645989895,197052,true,2770564337,28,2735875956,-34688381
1645990147,197059,true,2768625717,28,2729590986,-39034731
1645990190,197059,true,2768625717,28,2728499423,-40126294
1645990220,197065,true,2766965123,28,2727681036,-39284087
1645990257,197066,true,2766688454,28,2726862896,-39825558
1645990267,197073,true,2764752547,28,2726590237,-38162310
1645990287,197073,true,2764752547,28,2726045001,-38707546
1645990312,197078,true,2763370585,28,2724954855,-38415730
1645990389,197079,true,2763094276,28,2722503621,-40590655
1645990404,197085,true,2761436999,28,2721959202,-39477797
1645990450,197086,true,2761160883,28,2720054593,-41106290
1645990491,197090,true,2760056695,28,2718694974,-41361721
1645990505,197091,true,2759780717,28,2718151316,-41629401
1645990513,197097,true,2758125428,28,2717607767,-40517661
1645990993,197099,true,2757573885,28,2695146091,-62427794
1645991186,197101,true,2757022453,28,2685730038,-71292415
1645991195,197103,true,2756471131,28,2685461492,-71009639
1645991218,197109,true,2754817827,28,2684387576,-70430251
1645991263,197113,true,2753716176,28,2682509256,-71206920
1645991287,197116,true,2752890226,28,2681168404,-71721822
1645991505,197119,true,2752064524,28,2670465685,-81598839
1645991564,197125,true,2750413863,28,2667796687,-82617176
1645991841,197129,true,2749313973,28,2656084753,-93229220
1645991902,197134,true,2747939728,28,2653430128,-94509600
1645991912,197139,true,2746566170,28,2652899522,-93666648
1645992011,197145,true,2744918807,28,2647864049,-97054758
1645992079,197151,true,2743272432,28,2644424235,-98848197
1645992105,197157,true,2741627045,28,2643366729,-98260316
1645992139,197161,true,2740530668,28,2642045442,-98485226
1645992142,197167,true,2738886925,28,2642045442,-96841483
1645992290,197171,true,2737791644,28,2637558005,-100233639
1645992313,197176,true,2736423159,28,2637030572,-99392587
1645992333,197179,true,2735602396,28,2636503245,-99099151
1645992357,197186,true,2733688240,28,2635976024,-97712216
1645992361,197190,true,2732595038,28,2635712453,-96882585
1645992479,197198,true,2730409945,28,2632025221,-98384724
1645992493,197202,true,2729318054,28,2631762045,-97556009
1645992558,197208,true,2727681036,28,2629920548,-97760488
1645992631,197212,true,2726590237,28,2627817558,-98772679
1645992851,197218,true,2724954855,28,2622567437,-102387418
1645992855,197222,true,2723865146,28,2622567437,-101297709
1645992861,197228,true,2722231398,28,2622305207,-99926191
1645992917,197232,true,2721142778,28,2620732374,-100410404
1645992966,197239,true,2719238740,28,2619422401,-99816339
1645993073,197243,true,2718151316,28,2616804419,-101346897
1645993379,197250,true,2716249371,28,2612359853,-103889518
1645993590,197254,true,2715163143,28,2609227057,-105936086
1645993801,197261,true,2713263289,28,2607401329,-105861960
1645993912,197266,true,2711907064,28,2607401329,-104505735
1645993932,197273,true,2710009488,28,2607401329,-102608159
1645993966,197279,true,2708384051,28,2607140615,-101243436
1645993979,197286,true,2706488941,28,2606879927,-99609014
1645994135,197291,true,2705136102,28,2605837435,-99298667
1645994172,197298,true,2703243264,28,2605837435,-97405829
1645994285,197304,true,2701621886,28,2606358629,-95263257
1645994325,197312,true,2699461560,28,2606358629,-93102931
1645994333,197317,true,2698112234,28,2606619265,-91492969
1645994734,197324,true,2696224311,28,2608444446,-87779865
1645994808,197329,true,2694876603,28,2609487980,-85388623
1645994859,197337,true,2692721672,28,2610270905,-82450767
1645994884,197341,true,2691644852,28,2610531932,-81112920
1645994986,197345,true,2690568463,28,2612359853,-78208610
1645994997,197351,true,2688954687,28,2612621088,-76333599
1645995024,197358,true,2687073172,28,2613143639,-73929533
1645995120,197361,true,2686267211,28,2615757959,-70509252
1645995133,197366,true,2684924480,28,2616019535,-68904945
1645995469,197371,true,2683582421,28,2623354286,-60228135
1645995757,197378,true,2681704664,28,2629394643,-52310021
1645995785,197382,true,2680632250,28,2629657582,-50974668
1645995801,197386,true,2679560265,28,2629920548,-49639717
1645995881,197391,true,2678220887,28,2630709603,-47511284
1645995888,197400,true,2675811693,28,2630709603,-45102090
1645995909,197403,true,2675009110,28,2630709603,-44299507
1645996021,197408,true,2673672007,28,2630972674,-42699333
1645996058,197414,true,2672068365,28,2630709603,-41358762
1645996219,197423,true,2669664705,28,2629920548,-39744157
1645996309,197427,true,2668597106,28,2628605982,-39991124
1645996544,197432,true,2667263208,28,2625191185,-42072023
1645996620,197438,true,2665663410,28,2623616622,-42046788
1645996690,197447,true,2663265512,28,2622043003,-41222509
1645996769,197451,true,2662200472,28,2619684343,-42516129
1645996804,197457,true,2660603711,28,2618374894,-42228817
1645996832,197464,true,2658742033,28,2617066099,-41675934
1645996878,197473,true,2656350361,28,2615234886,-41115475
1645996967,197477,true,2655288086,28,2612098643,-43189443
1645997095,197482,true,2653960841,28,2607662069,-46298772
1645997121,197488,true,2652369021,28,2606879927,-45489094
1645997131,197497,true,2649983082,28,2606619265,-43363817
1645997466,197499,true,2649453165,28,2599071396,-50381769
1645997556,197502,true,2648658488,28,2597252774,-51405714
1645997584,197508,true,2647069849,28,2596473754,-50596095
1645997754,197517,true,2644688677,28,2595175906,-49512771
1645998249,197519,true,2644159819,28,2595175906,-48983913
1645998774,197522,true,2643366729,28,2600631229,-42735500
1645998828,197528,true,2641781264,28,2601151381,-40629883
1645998862,197537,true,2639404849,28,2601671637,-37733212
1645998870,197539,true,2638877048,28,2601931804,-36945244
1645999039,197542,true,2638085543,28,2603493354,-34592189
1645999189,197548,true,2636503245,28,2604274480,-32228765
1646000012,197557,true,2634131578,28,2606098019,-28033559
1646000114,197560,true,2633341497,28,2606619265,-26722232
1646000144,197561,true,2633078189,28,2606619265,-26458924
1646001129,197566,true,2631762045,28,2611315170,-20446875
1646001208,197575,true,2629394643,28,2611837459,-17557184
1646001247,197577,true,2628868843,28,2612098643,-16770200
1646001280,197578,true,2628605982,28,2612359853,-16246129
1646001293,197583,true,2627292073,28,2612359853,-14932220
1646001359,197588,true,2625978821,28,2613143639,-12835182
1646001413,197589,true,2625716250,28,2613927660,-11788590
1646001876,197590,true,2625453704,28,2619422401,-6031303
1646002029,197595,true,2624141371,28,2620732374,-3408997
1646002051,197600,true,2622829694,28,2620732374,-2097320
1646002153,197601,true,2622567437,28,2620994448,-1572989
1646002382,197601,true,2622567437,28,2621256547,-1310890
1646002747,197606,true,2621256547,28,2621256547,0
1646002771,197612,true,2619684343,28,2621518673,1834330
1646002860,197612,true,2619684343,28,2621780825,2096482
1646002865,197612,true,2619684343,28,2621780825,2096482
1646002873,197616,true,2618636732,28,2621780825,3144093
1646002956,197621,true,2617327806,28,2621780825,4453019
1646003009,197622,true,2617066099,28,2621518673,4452574
1646003040,197622,true,2617066099,28,2621256547,4190448
1646003054,197625,true,2616281136,28,2620994448,4713312
1646003068,197632,true,2614450472,28,2620732374,6281902
1646003435,197633,true,2614189053,28,2613404953,-784100
1646003489,197633,true,2614189053,28,2612621088,-1567965
1646003791,197634,true,2613927660,28,2607922835,-6004825
1646003822,197640,true,2612359853,28,2607401329,-4958524
1646003832,197641,true,2612098643,28,2607401329,-4697314
1646003843,197640,true,2612359853,28,2607140615,-5219238
1646004127,197640,true,2612359853,28,2605837435,-6522418
1646004133,197645,true,2611054064,28,2605837435,-5216629
1646004146,197644,true,2611315170,28,2605837435,-5477735
1646004252,197644,true,2611315170,28,2605055841,-6259329
1646004293,197644,true,2611315170,28,2604795361,-6519809
1646004326,197648,true,2610270905,28,2604274480,-5996425
1646004396,197648,true,2610270905,28,2603753703,-6517202
1646004442,197647,true,2610531932,28,2603233031,-7298901
1646004689,197646,true,2610792985,28,2599851195,-10941790
1646004754,197650,true,2609748929,28,2599331303,-10417626
1646004858,197649,true,2610009904,28,2598811515,-11198389
1646004872,197649,true,2610009904,28,2598811515,-11198389
1646004904,197649,true,2610009904,28,2599071396,-10938508
1646004965,197653,true,2608966161,28,2599331303,-9634858
1646004993,197652,true,2609227057,28,2599591236,-9635821
1646005019,197651,true,2609487980,28,2599851195,-9636785
1646005064,197650,true,2609748929,28,2600371192,-9377737
1646005084,197653,true,2608966161,28,2600371192,-8594969
1646005150,197651,true,2609487980,28,2601151381,-8336599
1646005215,197650,true,2609748929,28,2601671637,-8077292
1646005443,197650,true,2609748929,28,2602972733,-6776196
1646005448,197653,true,2608966161,28,2602972733,-5993428
1646005588,197651,true,2609487980,28,2604534907,-4953073
1646006362,197649,true,2610009904,28,2614189053,4179149
1646006563,197648,true,2610270905,28,2617327806,7056901
1646006589,197650,true,2609748929,28,2617589539,7840610
1646006600,197648,true,2610270905,28,2617589539,7318634
1646006730,197647,true,2610531932,28,2618374894,7842962
1646006829,197647,true,2610531932,28,2618636732,8104800
1646006832,197649,true,2610009904,28,2618636732,8626828
1646007057,197647,true,2610531932,28,2619684343,9152411
1646007627,197646,true,2610792985,28,2618898595,8105610
1646007675,197645,true,2611054064,28,2618374894,7320830
1646007839,197648,true,2610270905,28,2617066099,6795194
1646008042,197646,true,2610792985,28,2615496409,4703424
1646008145,197646,true,2610792985,28,2614450472,3657487
1646008474,197646,true,2610792985,28,2611576301,783316
1646008996,197649,true,2610009904,28,2607140615,-2869289
1646009081,197648,true,2610270905,28,2606619265,-3651640
1646009094,197648,true,2610270905,28,2606358629,-3912276
1646009111,197648,true,2610270905,28,2606358629,-3912276
1646009836,197650,true,2609748929,28,2604795361,-4953568
1646010512,197649,true,2610009904,28,2606619265,-3390639
1646010528,197651,true,2609487980,28,2606879927,-2608053
1646010534,197652,true,2609227057,28,2606879927,-2347130
1646010539,197654,true,2608705290,28,2606879927,-1825363
1646010678,197653,true,2608966161,28,2608183627,-782534
1646010758,197655,true,2608444446,28,2608966161,521715
1646010840,197655,true,2608444446,28,2610009904,1565458
1646011193,197657,true,2607922835,28,2614189053,6266218
1646011216,197655,true,2608444446,28,2614711917,6267471
1646011267,197656,true,2608183627,28,2615496409,7312782
1646011309,197656,true,2608183627,28,2616281136,8097509
1646011571,197654,true,2608705290,28,2622829694,14124404
1646011698,197652,true,2609227057,28,2625716250,16489193
1646011789,197652,true,2609227057,28,2627817558,18590501
1646011834,197651,true,2609487980,28,2629131730,19643750
1646011857,197648,true,2610270905,28,2629657582,19386677
1646011877,197645,true,2611054064,28,2630183540,19129476
1646011902,197644,true,2611315170,28,2630972674,19657504
1646011960,197642,true,2611837459,28,2632814908,20977449
1646012004,197639,true,2612621088,28,2634131578,21510490
1646012175,197635,true,2613666294,28,2639404849,25738555
1646012273,197633,true,2614189053,28,2642573878,28384825
1646012342,197630,true,2614973388,28,2644953146,29979758
1646012432,197627,true,2615757959,28,2647334556,31576597
1646012857,197623,true,2616804419,28,2657147346,40342927
1646013246,197621,true,2617327806,28,2663798192,46470386
1646013366,197619,true,2617851298,28,2664863871,47012573
1646013420,197615,true,2618898595,28,2665396870,46498275
1646013437,197613,true,2619422401,28,2665396870,45974469
1646013454,197612,true,2619684343,28,2665663410,45979067
1646013515,197610,true,2620208306,28,2665929976,45721670
1646013565,197607,true,2620994448,28,2665929976,44935528
1646014254,197606,true,2621256547,28,2661934279,40677732
1646014287,197605,true,2621518673,28,2661401972,39883299
1646014333,197603,true,2622043003,28,2660869771,38826768
1646014354,197601,true,2622567437,28,2660869771,38302334
1646014570,197600,true,2622829694,28,2658210364,35380670
1646014814,197600,true,2622829694,28,2654757108,31927414
1646014886,197599,true,2623091977,28,2653695471,30603494
1646015498,197596,true,2623878983,28,2647069849,23190866
1646016285,197595,true,2624141371,28,2642838135,18696764
1646016292,197596,true,2623878983,28,2642838135,18959152
1646016366,197595,true,2624141371,28,2642573878,18432507
1646016382,197592,true,2624928692,28,2642309647,17380955
1646016469,197593,true,2624666226,28,2641517112,16850886
1646016470,197593,true,2624666226,28,2641517112,16850886
1646016493,197594,true,2624403785,28,2641252987,16849202
1646016524,197592,true,2624928692,28,2640724816,15796124
1646017449,197596,true,2623878983,28,2621256547,-2622436
1646017774,197596,true,2623878983,28,2615234886,-8644097
1646018793,197596,true,2623878983,28,2607662069,-16216914
1646019091,197595,true,2624141371,28,2608705290,-15436081
1646019927,197598,true,2623354286,28,2611576301,-11777985
1646021359,197597,true,2623616622,28,2613927660,-9688962
1646021428,197597,true,2623616622,28,2614189053,-9427569
1646021444,197595,true,2624141371,28,2614189053,-9952318
1646022069,197598,true,2623354286,28,2618374894,-4979392
1646022656,197596,true,2623878983,28,2621518673,-2360310
1646022726,197597,true,2623616622,28,2621780825,-1835797
1646022761,197594,true,2624403785,28,2622043003,-2360782
1646022858,197596,true,2623878983,28,2622305207,-1573776
1646022924,197595,true,2624141371,28,2622305207,-1836164
1646023013,197595,true,2624141371,28,2622305207,-1836164
1646023148,197592,true,2624928692,28,2622567437,-2361255
1646023834,197593,true,2624666226,28,2617851298,-6814928
1646024463,197592,true,2624928692,28,2614450472,-10478220
1646024703,197593,true,2624666226,28,2613404953,-11261273
1646025219,197590,true,2625453704,28,2612882351,-12571353
1646026497,197591,true,2625191185,28,2614973388,-10217797
1646027095,197590,true,2625453704,28,2615757959,-9695745
1646028372,197592,true,2624928692,28,2614450472,-10478220
1646028541,197589,true,2625716250,28,2614450472,-11265778
1646028544,197591,true,2625191185,28,2614450472,-10740713
1646028587,197589,true,2625716250,28,2614189053,-11527197
1646028607,197591,true,2625191185,28,2613927660,-11263525
1646028659,197590,true,2625453704,28,2613404953,-12048751
1646028698,197591,true,2625191185,28,2612882351,-12308834
1646028867,197591,true,2625191185,28,2609748929,-15442256
1646028890,197592,true,2624928692,28,2609487980,-15440712
1646028908,197591,true,2625191185,28,2609227057,-15964128
1646028912,197593,true,2624666226,28,2609227057,-15439169
1646028952,197590,true,2625453704,28,2609227057,-16226647
1646028982,197590,true,2625453704,28,2609227057,-16226647
1646029139,197589,true,2625716250,28,2610009904,-15706346
1646029168,197591,true,2625191185,28,2609748929,-15442256
1646029186,197588,true,2625978821,28,2609748929,-16229892
1646029200,197589,true,2625716250,28,2609487980,-16228270
1646029307,197590,true,2625453704,28,2608183627,-17270077
1646029331,197593,true,2624666226,28,2608183627,-16482599
1646029500,197589,true,2625716250,28,2607140615,-18575635
1646029615,197590,true,2625453704,28,2606619265,-18834439
1646029634,197591,true,2625191185,28,2606358629,-18832556
1646030191,197594,true,2624403785,28,2601931804,-22471981
1646030505,197592,true,2624928692,28,2601411496,-23517196
1646031161,197593,true,2624666226,28,2601931804,-22734422
1646031181,197594,true,2624403785,28,2601931804,-22471981
1646031931,197597,true,2623616622,28,2603753703,-19862919
1646032758,197593,true,2624666226,28,2607922835,-16743391
1646032843,197593,true,2624666226,28,2608183627,-16482599
1646032969,197594,true,2624403785,28,2608966161,-15437624
1646032984,197597,true,2623616622,28,2609227057,-14389565
1646033008,197594,true,2624403785,28,2609227057,-15176728
1646033091,197593,true,2624666226,28,2610009904,-14656322
1646033157,197594,true,2624403785,28,2610531932,-13871853
1646033166,197597,true,2623616622,28,2610531932,-13084690
1646033171,197592,true,2624928692,28,2610531932,-14396760
1646033179,197592,true,2624928692,28,2610531932,-14396760
1646033357,197591,true,2625191185,28,2612621088,-12570097
1646033589,197593,true,2624666226,28,2615757959,-8908267
1646033639,197589,true,2625716250,28,2616542765,-9173485
1646033680,197588,true,2625978821,28,2617327806,-8651015
1646033727,197587,true,2626241419,28,2618374894,-7866525
1646034370,197588,true,2625978821,28,2629657582,3678761
1646034664,197584,true,2627029371,28,2634921897,7892526
1646034793,197583,true,2627292073,28,2637030572,9738499
1646034862,197582,true,2627554803,28,2637821761,10266958
1646034972,197585,true,2626766694,28,2638877048,12110354
1646035652,197581,true,2627817558,28,2640460770,12643212
1646035668,197580,true,2628080340,28,2640460770,12380430
1646035709,197581,true,2627817558,28,2640460770,12643212
1646036331,197583,true,2627292073,28,2642045442,14753369
1646036429,197579,true,2628343148,28,2642045442,13702294
1646036483,197578,true,2628605982,28,2642045442,13439460
1646036500,197581,true,2627817558,28,2642045442,14227884
1646037520,197584,true,2627029371,28,2643895429,16866058
1646037644,197580,true,2628080340,28,2643366729,15286389
1646037651,197580,true,2628080340,28,2643366729,15286389
1646037725,197582,true,2627554803,28,2642838135,15283332
1646037727,197586,true,2626504043,28,2642838135,16334092
1646037772,197583,true,2627292073,28,2642309647,15017574
1646037807,197583,true,2627292073,28,2642045442,14753369
1646038978,197587,true,2626241419,28,2630709603,4468184
1646039043,197591,true,2625191185,28,2630183540,4992355
1646039085,197588,true,2625978821,28,2629920548,3941727
1646039159,197589,true,2625716250,28,2629657582,3941332
1646039173,197592,true,2624928692,28,2629657582,4728890
1646039387,197595,true,2624141371,28,2628868843,4727472
1646039935,197593,true,2624666226,28,2630709603,6043377
1646040302,197593,true,2624666226,28,2632814908,8148682
1646040369,197596,true,2623878983,28,2633078189,9199206
1646040638,197600,true,2622829694,28,2634658431,11828737
1646040664,197597,true,2623616622,28,2634658431,11041809
1646040716,197597,true,2623616622,28,2634921897,11305275
1646041356,197600,true,2622829694,28,2634394992,11565298
1646042383,197603,true,2622043003,28,2631762045,9719042
1646042415,197600,true,2622829694,28,2631762045,8932351
1646042494,197600,true,2622829694,28,2631498895,8669201
1646043260,197603,true,2622043003,28,2628605982,6562979
1646043556,197606,true,2621256547,28,2627292073,6035526
1646043560,197603,true,2622043003,28,2627292073,5249070
1646043664,197602,true,2622305207,28,2627029371,4724164
1646043759,197606,true,2621256547,28,2627029371,5772824
1646044406,197608,true,2620732374,28,2627292073,6559699
1646044649,197604,true,2621780825,28,2628605982,6825157
1646044657,197604,true,2621780825,28,2628605982,6825157
1646045211,197606,true,2621256547,28,2632551652,11295105
1646047195,197607,true,2620994448,28,2638877048,17882600
1646047214,197604,true,2621780825,28,2638877048,17096223
1646047256,197602,true,2622305207,28,2638877048,16571841
1646047887,197605,true,2621518673,28,2636239621,14720948
1646048007,197603,true,2622043003,28,2635712453,13669450
1646048510,197600,true,2622829694,28,2633868192,11038498
1646049027,197599,true,2623091977,28,2632814908,9722931
1646049966,197601,true,2622567437,28,2636503245,13935808
1646050063,197600,true,2622829694,28,2636766896,13937202
1646050086,197597,true,2623616622,28,2636766896,13150274
1646050164,197595,true,2624141371,28,2637294275,13152904
1646050228,197597,true,2623616622,28,2637821761,14205139
1646050266,197596,true,2623878983,28,2637821761,13942778
1646050312,197594,true,2624403785,28,2638085543,13681758
1646050337,197593,true,2624666226,28,2638085543,13419317
1646050646,197596,true,2623878983,28,2638085543,14206560
1646050707,197595,true,2624141371,28,2638085543,13944172
1646050753,197592,true,2624928692,28,2638085543,13156851
1646050772,197591,true,2625191185,28,2638085543,12894358
1646050778,197593,true,2624666226,28,2638085543,13419317
1646050786,197592,true,2624928692,28,2638085543,13156851
1646050791,197589,true,2625716250,28,2638085543,12369293
1646050807,197587,true,2626241419,28,2638085543,11844124
1646050907,197588,true,2625978821,28,2638613186,12634365
1646050919,197587,true,2626241419,28,2638613186,12371767
1646051460,197584,true,2627029371,28,2643102419,16073048
1646052061,197582,true,2627554803,28,2647069849,19515046
1646052071,197583,true,2627292073,28,2647334556,20042483
1646052244,197582,true,2627554803,28,2649188246,21633443
1646052283,197578,true,2628605982,28,2649718110,21112128
1646053103,197576,true,2629131730,28,2653960841,24829111
1646053140,197576,true,2629131730,28,2653695471,24563741
1646053148,197574,true,2629657582,28,2653695471,24037889
1646053167,197569,true,2630972674,28,2653695471,22722797
1646053221,197568,true,2631235771,28,2653430128,22194357
1646053223,197568,true,2631235771,28,2653430128,22194357
1646053231,197566,true,2631762045,28,2653164812,21402767
1646053254,197564,true,2632288424,28,2653164812,20876388
1646054554,197564,true,2632288424,28,2640196750,7908326
1646054587,197566,true,2631762045,28,2639668790,7906745
1646054596,197564,true,2632288424,28,2639668790,7380366
1646054650,197562,true,2632814908,28,2638877048,6062140
1646054665,197563,true,2632551652,28,2638613186,6061534
1646054736,197562,true,2632814908,28,2637294275,4479367
1646055338,197560,true,2633341497,28,2630183540,-3157957
1646057524,197559,true,2633604831,28,2619684343,-13920488
1646057542,197560,true,2633341497,28,2619946312,-13395185
1646057664,197559,true,2633604831,28,2620208306,-13396525
1646057747,197557,true,2634131578,28,2620994448,-13137130
1646057782,197555,true,2634658431,28,2621518673,-13139758
1646057836,197555,true,2634658431,28,2622829694,-11828737
1646057850,197553,true,2635185389,28,2623091977,-12093412
1646057951,197550,true,2635976024,28,2625716250,-10259774
1646058023,197547,true,2636766896,28,2627817558,-8949338
1646058066,197547,true,2636766896,28,2628868843,-7898053
1646058481,197545,true,2637294275,28,2640988888,3694613
1646058498,197541,true,2638349351,28,2641517112,3167761
1646058506,197539,true,2638877048,28,2641781264,2904216
1646058584,197539,true,2638877048,28,2644688677,5811629
1646058620,197536,true,2639668790,28,2646011286,6342496
1646058668,197532,true,2640724816,28,2647864049,7139233
1646058696,197529,true,2641517112,28,2648923354,7406242
1646058729,197529,true,2641517112,28,2650513105,8995993
1646058780,197526,true,2642309647,28,2652634258,10324611
1646058856,197523,true,2643102419,28,2656084753,12982334
1646058912,197519,true,2644159819,28,2659007907,14848088
1646059825,197518,true,2644424235,28,2698651884,54227649
1646059868,197516,true,2644953146,28,2699731506,54778360
1646059997,197513,true,2645746711,28,2703243264,57496553
1646060016,197510,true,2646540515,28,2703783940,57243425
1646060248,197507,true,2647334556,28,2711635900,64301344
1646060264,197504,true,2648128836,28,2712178255,64049419
1646060297,197501,true,2648923354,28,2713263289,64339935
1646060314,197497,true,2649983082,28,2713805968,63822886
1646060326,197493,true,2651043235,28,2714348757,63305522
1646060335,197490,true,2651838627,28,2714620192,62781565
1646060355,197487,true,2652634258,28,2715434659,62800401
1646060415,197483,true,2653695471,28,2717607767,63912296
1646060505,197479,true,2654757108,28,2720870691,66113583
1646060633,197476,true,2655553615,28,2724409946,68856331
1646060645,197472,true,2656615996,28,2724682387,68066391
1646061013,197469,true,2657413061,28,2732321806,74908745
1646061249,197465,true,2658476185,28,2736970471,78494286
1646061380,197462,true,2659273808,28,2739708673,80434865
1646061381,197457,true,2660603711,28,2739982644,79378933
1646061388,197453,true,2661668112,28,2739982644,78314532
1646061401,197449,true,2662732939,28,2740530668,77797729
1646061406,197444,true,2664064572,28,2740530668,76466096
1646061435,197439,true,2665396870,28,2741352909,75956039
1646061457,197434,true,2666729835,28,2742175397,75445562
1646061478,197429,true,2668063467,28,2742998132,74934665
1646061517,197424,true,2669397765,28,2744644343,75246578
1646061601,197419,true,2670732731,28,2748214522,77481791
1646061651,197414,true,2672068365,28,2750413863,78345498
1646061654,197409,true,2673404666,28,2750413863,77009197
1646061697,197403,true,2675009110,28,2752339731,77330621
1646061791,197397,true,2676614517,28,2756746778,80132261
1646061866,197392,true,2677953092,28,2759780717,81827625
1646061963,197387,true,2679292336,28,2763923287,84630951
1646061980,197381,true,2680900313,28,2764476099,83575786
1646062166,197375,true,2682509256,28,2770010307,87501051
1646062205,197370,true,2683850779,28,2770841393,86990614
1646062438,197365,true,2685192973,28,2776110733,90917760
1646062561,197359,true,2686804491,28,2779721843,92917352
1646062573,197352,true,2688685819,28,2779999815,91313996
1646062599,197347,true,2690030430,28,2780833898,90803468
1646062843,197341,true,2691644852,28,2788630754,96985902
1646062874,197335,true,2693260243,28,2789746373,96486130
1646063117,197329,true,2694876603,28,2798127759,103251156
1646063192,197324,true,2696224311,28,2800647082,104422771
1646063748,197318,true,2697842450,28,2804290108,106447658
1646063776,197312,true,2699461560,28,2804570537,105108977
1646063809,197306,true,2701081642,28,2804850994,103769352
1646064447,197301,true,2702432453,28,2814121828,111689375
1646064621,197294,true,2704324723,28,2814966149,110641426
1646064686,197288,true,2705947724,28,2814966149,109018425
1646064786,197282,true,2707571699,28,2814684680,107112981
1646064808,197277,true,2708925755,28,2814684680,105758925
1646064816,197271,true,2710551517,28,2814684680,104133163
1646065418,197265,true,2712178255,28,2814966149,102787894
1646065432,197259,true,2713805968,28,2814966149,101160181
1646065479,197254,true,2715163143,28,2815247645,100084502
1646065486,197249,true,2716520996,28,2815247645,98726649
1646065642,197242,true,2718423131,28,2815810723,97387592
1646065660,197236,true,2720054593,28,2815810723,95756130
1646065983,197231,true,2721414892,28,2815810723,94395831
1646066113,197225,true,2723048149,28,2815810723,92762574
1646066504,197218,true,2724954855,28,2815810723,90855868
1646066861,197212,true,2726590237,28,2818345966,91755729
1646066873,197206,true,2728226600,28,2818345966,90119366
1646066900,197201,true,2729590986,28,2818627801,89036815
1646067980,197194,true,2731502273,28,2816937216,85434943
1646068108,197189,true,2732868297,28,2816373913,83505616
1646068146,197183,true,2734508428,28,2816373913,81865485
1646068260,197178,true,2735875956,28,2815529170,79653214
1646068316,197172,true,2737517892,28,2815247645,77729753
1646068355,197167,true,2738886925,28,2814966149,76079224
1646068454,197163,true,2739982644,28,2814121828,74139184
1646068526,197158,true,2741352909,28,2813559088,72206179
1646068594,197152,true,2742998132,28,2812996460,69998328
1646069458,197148,true,2744095496,28,2805131479,61035983
1646070122,197143,true,2745467818,28,2802327890,56860072
1646070420,197139,true,2746566170,28,2802047685,55481515
1646070501,197133,true,2748214522,28,2802327890,54113368
1646071063,197128,true,2749588904,28,2802888384,53299480
1646071114,197124,true,2750688905,28,2803168673,52479768
1646071124,197118,true,2752339731,28,2803168673,50828942
1646071265,197112,true,2753991547,28,2804009707,50018160
1646071374,197106,true,2755644355,28,2804850994,49206639
1646071506,197101,true,2757022453,28,2805692534,48670081
1646071960,197094,true,2758952948,28,2808780339,49827391
1646072423,197088,true,2760608734,28,2812433945,51825211
1646072606,197082,true,2762265513,28,2813840444,51574931
1646073737,197078,true,2763370585,28,2811309253,47938668
1646075196,197071,true,2765305525,28,2806253700,40948175
1646075290,197064,true,2767241819,28,2806253700,39011881
1646078505,197058,true,2768902580,28,2801487360,32584780
1646078626,197054,true,2770010307,28,2801767509,31757202
1646078789,197047,true,2771949896,28,2802327890,30377994
1646079320,197040,true,2773890843,28,2803448990,29558147
1646079519,197034,true,2775555594,28,2804570537,29014943
1646079617,197031,true,2776388344,28,2805131479,28743135
1646079686,197025,true,2778054593,28,2805692534,27637941
1646079706,197019,true,2779721843,28,2805973103,26251260
1646081171,197012,true,2781668232,28,2824552842,42884610
1646081354,197010,true,2782224593,28,2826247998,44023405
1646081562,197004,true,2783894345,28,2827661404,43767059
1646081567,196998,true,2785565100,28,2827661404,42096304
1646081688,196992,true,2787236857,28,2827095957,39859100
1646081702,196990,true,2787794332,28,2827095957,39301625
1646084531,196984,true,2789467427,28,2826247998,36780571
1646084717,196980,true,2790583381,28,2826247998,35664617
1646085841,196975,true,2791978952,28,2822294217,30315265
1646086046,196972,true,2792816629,28,2821729842,28913213
1646086068,196968,true,2793933923,28,2821729842,27795919
1646086093,196964,true,2795051665,28,2822012015,26960350
1646086376,196958,true,2796729115,28,2823988016,27258901
1646087010,196955,true,2797568218,28,2830490339,32922121
1646087393,196951,true,2798687413,28,2835022521,36335108
1646087413,196948,true,2799527103,28,2835306024,35778921
1646087434,196941,true,2801487360,28,2835589554,34102194
1646087544,196938,true,2802327890,28,2837858820,35530930
1646087576,196935,true,2803168673,28,2838710263,35541590
1646087605,196930,true,2804570537,28,2839845917,35275380
1646087625,196924,true,2806253700,28,2840697956,34444256
1646087730,196917,true,2808218667,28,2845531008,37312341
1646087902,196914,true,2809061217,28,2853509260,44448043
1646087920,196910,true,2810185010,28,2854079991,43894981
1646087989,196904,true,2811871543,28,2856935355,45063812
1646088039,196898,true,2813559088,28,2859221704,45662616
1646088338,196893,true,2814966149,28,2872978269,58012120
1646088423,196889,true,2816092304,28,2876427740,60335436
1646088691,196883,true,2817782382,28,2888244711,70462329
1646088761,196876,true,2819755421,28,2891134256,71378835
1646088786,196872,true,2820883493,28,2892001683,71118190
1646088822,196868,true,2822012015,28,2893447973,71435958
1646088842,196863,true,2823423304,28,2894026692,70603388
1646089229,196857,true,2825117781,28,2907369212,82251431
1646089694,196853,true,2826247998,28,2910277889,84029891
1646089730,196850,true,2827095957,28,2910568917,83472960
1646089808,196845,true,2828509788,28,2910568917,82059129
1646090270,196839,true,2830207318,28,2908823187,78615869
1646090379,196835,true,2831339571,28,2908241509,76901938
1646090388,196833,true,2831905867,28,2908241509,76335642
1646090987,196830,true,2832755524,28,2905915963,73160439
1646091025,196825,true,2834172185,28,2905915963,71743778
1646091219,196822,true,2835022521,28,2905915963,70893442
1646091396,196820,true,2835589554,28,2906206555,70617001
1646091457,196817,true,2836440316,28,2906206555,69766239
1646091571,196813,true,2837575062,28,2905625400,68050338
1646091587,196809,true,2838710263,28,2905625400,66915137
1646091862,196807,true,2839278033,28,2905044362,65766329
1646092050,196804,true,2840129902,28,2904753887,64623985
1646092166,196799,true,2841550251,28,2905044362,63494111
1646092252,196795,true,2842687041,28,2905625400,62938359
1646092503,196792,true,2843539933,28,2907659948,64120015
1646092690,196789,true,2844393080,28,2909114069,64720989
1646092711,196784,true,2845815561,28,2909114069,63298508
1646092778,196781,true,2846669391,28,2909695921,63026530
1646092893,196779,true,2847238753,28,2910859974,63621221
1646092912,196776,true,2848093010,28,2910859974,62766964
1646092942,196770,true,2849802294,28,2911442175,61639881
1646092969,196767,true,2850657320,28,2912024493,61367173
1646092985,196764,true,2851512602,28,2912315695,60803093
1646093122,196759,true,2852938644,28,2915229322,62290678
1646093160,196755,true,2854079991,28,2916103978,62023987
1646093407,196752,true,2854936300,28,2921357429,66421129
1646093533,196748,true,2856078446,28,2923987703,67909257
1646093564,196744,true,2857221049,28,2924864987,67643938
1646093742,196738,true,2858935810,28,2930427235,71491425
1646093765,196733,true,2860365564,28,2931013349,70647785
1646093812,196729,true,2861509882,28,2932185931,70676049
1646093834,196724,true,2862940923,28,2932772397,69831474
1646093906,196720,true,2864086271,28,2934239077,70152806
1646093924,196715,true,2865518601,28,2934532501,69013900
1646094452,196713,true,2866091733,28,2943348875,77257142
1646094531,196709,true,2867238342,28,2944526391,77288049
1646094879,196704,true,2868672248,28,2947766990,79094742
1646094908,196700,true,2869819889,28,2947766990,77947101
1646094953,196698,true,2870393881,28,2947766990,77373109
1646095560,196693,true,2871829365,28,2947177525,75348160
1646095720,196688,true,2873265567,28,2946882837,73617270
1646095747,196684,true,2874415046,28,2946882837,72467791
1646096206,196682,true,2874989958,28,2947472243,72482285
1646096547,196677,true,2876427740,28,2948356573,71928833
1646097034,196672,true,2877866242,28,2947766990,69900748
1646097079,196668,true,2879017561,28,2947766990,68749429
1646097142,196665,true,2879881352,28,2947472243,67590891
1646097240,196660,true,2881321581,28,2946882837,65561256
1646097248,196655,true,2882762530,28,2946882837,64120307
1646097265,196651,true,2883915808,28,2946882837,62967029
1646097282,196648,true,2884781069,28,2946588178,61807109
1646097513,196643,true,2886223748,28,2944526391,58302643
1646097519,196639,true,2887378411,28,2944231968,56853557
1646097852,196635,true,2888533536,28,2940701185,52167649
1646099811,196632,true,2889400182,28,2927205698,37805516
1646099861,196628,true,2890556116,28,2927205698,36649582
1646099910,196623,true,2892001683,28,2927205698,35204015
1646100374,196620,true,2892869370,28,2926620345,33750975
1646100606,196617,true,2893737318,28,2925742534,32005216
1646100901,196614,true,2894605526,28,2924280102,29674576
1646100954,196610,true,2895763542,28,2923987703,28224161
1646101597,196607,true,2896632358,28,2919897189,23264831
1646101928,196605,true,2897211713,28,2918145863,20934150
1646102070,196602,true,2898080964,28,2917562322,19481358
1646102243,196597,true,2899530294,28,2916687228,17156934
1646102470,196594,true,2900400240,28,2916103978,15703738
1646102946,196592,true,2900980349,28,2915229322,14248973
1646104477,196588,true,2902140915,28,2913772144,11631229
1646104496,196583,true,2903592276,28,2913772144,10179868
1646104649,196580,true,2904463441,28,2913772144,9308703
1646104699,196578,true,2905044362,28,2913480796,8436434
1646105227,196575,true,2905915963,28,2911151060,5235097
1646107127,196571,true,2907078504,28,2901850730,-5227774
1646107153,196568,true,2907950714,28,2902140915,-5809799
1646107262,196566,true,2908532334,28,2902721372,-5810962
1646107499,196566,true,2908532334,28,2904173023,-4359311
1646107986,196561,true,2909986891,28,2907078504,-2908387
1646108526,196557,true,2911151060,28,2910568917,-582143
1646109113,196556,true,2911442175,28,2913189477,1747302
1646110320,196555,true,2911733319,28,2913189477,1456158
1646110469,196550,true,2913189477,28,2913480796,291319
1646110829,196546,true,2914354928,28,2915520845,1165917
1646112309,196544,true,2914937828,28,2926035108,11097280
1646112647,196542,true,2915520845,28,2926327712,10806867
1646112946,196537,true,2916978897,28,2926035108,9056211
1646113035,196533,true,2918145863,28,2926035108,7889245
1646113057,196531,true,2918729522,28,2926035108,7305586
1646113337,196531,true,2918729522,28,2925449989,6720467
1646113390,196527,true,2919897189,28,2925157473,5260284
1646113463,196523,true,2921065323,28,2924864987,3799664
1646113534,196521,true,2921649565,28,2924572530,2922965
1646114752,196522,true,2921357429,28,2917854078,-3503351
1646114865,196518,true,2922526147,28,2917270595,-5255552
1646114930,196516,true,2923110682,28,2916687228,-6423454
1646115060,196515,true,2923402993,28,2914937828,-8465165
1646115462,196518,true,2922526147,28,2909695921,-12830226
1646115736,196518,true,2922526147,28,2906497175,-16028972
1646115790,196517,true,2922818400,28,2905915963,-16902437
1646115827,196516,true,2923110682,28,2905625400,-17485282
1646116284,196519,true,2922233924,28,2901850730,-20383194
1646116376,196519,true,2922233924,28,2901270447,-20963477
1646117040,196519,true,2922233924,28,2901850730,-20383194
1646117432,196518,true,2922526147,28,2904173023,-18353124
1646117485,196520,true,2921941730,28,2904463441,-17478289
1646117582,196521,true,2921649565,28,2905334867,-16314698
1646118168,196519,true,2922233924,28,2909404981,-12828943
1646118383,196518,true,2922526147,28,2909986891,-12539256
1646118428,196520,true,2921941730,28,2910277889,-11663841
1646118482,196519,true,2922233924,28,2910568917,-11665007
1646118570,196518,true,2922526147,28,2911151060,-11375087
1646118792,196516,true,2923110682,28,2913189477,-9921205
1646118884,196518,true,2922526147,28,2914354928,-8171219
1646119438,196518,true,2922526147,28,2919021395,-3504752
1646119861,196517,true,2922818400,28,2921357429,-1460971
1646120847,196515,true,2923402993,28,2923987703,584710
1646120944,196516,true,2923110682,28,2923987703,877021
1646121042,196515,true,2923402993,28,2923987703,584710
1646122880,196514,true,2923695333,28,2921357429,-2337904
1646123109,196512,true,2924280102,28,2921357429,-2922673
1646123891,196514,true,2923695333,28,2919605228,-4090105
1646124309,196513,true,2923987703,28,2919313297,-4674406
1646124325,196512,true,2924280102,28,2919313297,-4966805
1646125130,196511,true,2924572530,28,2921065323,-3507207
1646125512,196512,true,2924280102,28,2922526147,-1753955
1646125605,196511,true,2924572530,28,2923110682,-1461848
1646125980,196511,true,2924572530,28,2923695333,-877197
1646126354,196509,true,2925157473,28,2923110682,-2046791
1646126617,196511,true,2924572530,28,2922526147,-2046383
1646126724,196510,true,2924864987,28,2921941730,-2923257
1646126881,196510,true,2924864987,28,2920773245,-4091742
1646127064,196509,true,2925157473,28,2919605228,-5552245
1646127155,196512,true,2924280102,28,2918729522,-5550580
1646127574,196512,true,2924280102,28,2913772144,-10507958
1646127583,196512,true,2924280102,28,2913772144,-10507958
1646128776,196513,true,2923987703,28,2900400240,-23587463
1646129318,196517,true,2922818400,28,2898370772,-24447628
1646129351,196517,true,2922818400,28,2898370772,-24447628
1646129353,196518,true,2922526147,28,2898080964,-24445183
1646129370,196519,true,2922233924,28,2898080964,-24152960
1646129393,196524,true,2920773245,28,2897791184,-22982061
1646129458,196527,true,2919897189,28,2896632358,-23264831
1646129464,196528,true,2919605228,28,2896632358,-22972870
1646129655,196531,true,2918729522,28,2893447973,-25281549
1646129727,196536,true,2917270595,28,2892290883,-24979712
1646129754,196538,true,2916687228,28,2892001683,-24685545
1646129924,196538,true,2916687228,28,2889978091,-26709137
1646130172,196539,true,2916395588,28,2887089702,-29305886
1646130840,196544,true,2914937828,28,2879593393,-35344435
1646130864,196546,true,2914354928,28,2879305463,-35049465
1646131128,196546,true,2914354928,28,2876715383,-37639545
1646131147,196547,true,2914063521,28,2876715383,-37348138
1646131168,196552,true,2912606927,28,2876715383,-35891544
1646131196,196554,true,2912024493,28,2876715383,-35309110
1646131320,196554,true,2912024493,28,2878154028,-33870465
1646131428,196555,true,2911733319,28,2879305463,-32427856
1646131458,196559,true,2910568917,28,2879593393,-30975524
1646131473,196561,true,2909986891,28,2879881352,-30105539
1646131698,196561,true,2909986891,28,2882186064,-27800827
1646131731,196561,true,2909986891,28,2882474283,-27512608
1646131994,196565,true,2908823187,28,2885358054,-23465133
1646132017,196567,true,2908241509,28,2885646590,-22594919
1646132084,196566,true,2908532334,28,2886512371,-22019963
1646132144,196566,true,2908532334,28,2887378411,-21153923
1646132286,196569,true,2907659948,28,2889978091,-17681857
1646132306,196570,true,2907369212,28,2890556116,-16813096
1646133642,196568,true,2907950714,28,2910568917,2618203
1646133661,196568,true,2907950714,28,2910568917,2618203
1646134105,196570,true,2907369212,28,2914646363,7277151
1646134139,196572,true,2906787825,28,2914646363,7858538
1646134522,196569,true,2907659948,28,2914646363,6986415
1646134904,196569,true,2907659948,28,2914354928,6694980
1646135052,196571,true,2907078504,28,2914063521,6985017
1646135178,196573,true,2906497175,28,2913480796,6983621
1646135340,196571,true,2907078504,28,2912606927,5528423
1646135369,196570,true,2907369212,28,2912315695,4946483
1646136020,196573,true,2906497175,28,2905044362,-1452813
1646136650,196575,true,2905915963,28,2900980349,-4935614
1646136685,196573,true,2906497175,28,2900690280,-5806895
1646136736,196572,true,2906787825,28,2900690280,-6097545
1646136795,196575,true,2905915963,28,2900400240,-5515723
1646137068,196576,true,2905625400,28,2901270447,-4354953
1646137165,196573,true,2906497175,28,2902140915,-4356260
1646137255,196573,true,2906497175,28,2903011645,-3485530
1646137281,196574,true,2906206555,28,2903301946,-2904609
1646137359,196574,true,2906206555,28,2904463441,-1743114
1646137368,196571,true,2907078504,28,2904463441,-2615063
1646137428,196570,true,2907369212,28,2905915963,-1453249
1646137473,196571,true,2907078504,28,2906787825,-290679
1646137529,196571,true,2907078504,28,2908241509,1163005
1646137734,196567,true,2908241509,28,2913480796,5239287
1646137938,196566,true,2908532334,28,2918729522,10197188
1646137980,196567,true,2908241509,28,2919605228,11363719
1646137999,196567,true,2908241509,28,2919897189,11655680
1646138144,196564,true,2909114069,28,2922526147,13412078
1646138371,196564,true,2909114069,28,2926620345,17506276
1646138731,196567,true,2908241509,28,2931013349,22771840
1646138858,196566,true,2908532334,28,2932479149,23946815
1646138884,196564,true,2909114069,28,2932772397,23658328
1646139240,196564,true,2909114069,28,2935412948,26298879
1646139459,196565,true,2908823187,28,2934825954,26002767
1646139498,196565,true,2908823187,28,2934825954,26002767
1646139528,196562,true,2909695921,28,2934825954,25130033
1646139742,196561,true,2909986891,28,2934532501,24545610
1646139860,196562,true,2909695921,28,2935119436,25423515
1646139909,196561,true,2909986891,28,2935706490,25719599
1646139916,196558,true,2910859974,28,2935706490,24846516
1646139963,196557,true,2911151060,28,2936293660,25142600
1646139992,196555,true,2911733319,28,2936880948,25147629
1646140027,196553,true,2912315695,28,2937762101,25446406
1646140135,196550,true,2913189477,28,2940113133,26923656
1646140152,196548,true,2913772144,28,2940701185,26929041
1646140227,196546,true,2914354928,28,2942466047,28111119
1646140243,196544,true,2914937828,28,2942760294,27822466
1646140493,196541,true,2915812397,28,2949536093,33723696
1646140712,196539,true,2916395588,28,2955440772,39045184
1646140899,196538,true,2916687228,28,2959581080,42893852
1646140958,196536,true,2917270595,28,2960765090,43494495
1646141548,196533,true,2918145863,28,2970848319,52702456
1646141560,196532,true,2918437678,28,2970848319,52410641
1646141580,196531,true,2918729522,28,2971145404,52415882
1646141588,196529,true,2919313297,28,2971442518,52129221
1646141657,196525,true,2920481197,28,2973225830,52744633
1646141763,196524,true,2920773245,28,2975307712,54534467
1646141849,196522,true,2921357429,28,2976795664,55438235
1646141853,196521,true,2921649565,28,2976795664,55146099
1646141968,196516,true,2923110682,28,2978284359,55173677
1646142282,196515,true,2923402993,28,2981263984,57860991
1646142454,196513,true,2923987703,28,2983649830,59662127
1646142526,196512,true,2924280102,28,2984545015,60264913
1646142628,196507,true,2925742534,28,2986634823,60892289
1646142661,196505,true,2926327712,28,2987232180,60904468
1646142701,196503,true,2926913007,28,2987829656,60916649
1646142842,196501,true,2927498419,28,2991417024,63918605
1646142872,196496,true,2928962461,28,2992015338,63052877
1646142892,196494,true,2929548282,28,2992613771,63065489
1646142921,196491,true,2930427235,28,2993511645,63084410
1646143346,196488,true,2931306451,28,3006711454,75405003
1646143362,196483,true,2932772397,28,3007312827,74540430
1646143404,196481,true,2933358981,28,3008215111,74856130
1646143464,196479,true,2933945682,28,3009719519,75773837
1646144552,196475,true,2935119436,28,3028133994,93014558
1646144721,196470,true,2936587290,28,3029042526,92455236
1646144790,196467,true,2937468354,28,3029042526,91574172
1646145013,196465,true,2938055877,28,3028436808,90380931
1646145136,196461,true,2939231276,28,3028133994,88902718
1646145148,196456,true,2940701185,28,3028133994,87432809
1646145160,196453,true,2941583484,28,3028133994,86550510
1646145182,196450,true,2942466047,28,3027528458,85062411
1646145208,196448,true,2943054570,28,3027225736,84171166
1646145221,196443,true,2944526391,28,3026923044,82396653
1646145226,196440,true,2945409838,28,3026923044,81513206
1646145257,196437,true,2946293549,28,3026015148,79721599
1646145260,196434,true,2947177525,28,3026015148,78837623
1646145451,196430,true,2948356573,28,3021177637,72821064
1646145505,196426,true,2949536093,28,3019969468,70433375
1646145520,196423,true,2950421042,28,3019667501,69246459
1646145546,196420,true,2951306257,28,3019365565,68059308
1646145584,196415,true,2952782205,28,3018761782,65979577
1646145685,196411,true,2953963495,28,3016951159,62987664
1646145847,196408,true,2954849773,28,3014538684,59688911
1646145878,196404,true,2956031890,28,3013935866,57903976
1646146001,196400,true,2957214480,28,3011826955,54612475
1646146236,196396,true,2958397544,28,3007312827,48915283
1646146301,196394,true,2958989253,28,3005809621,46820368
1646146341,196391,true,2959877038,28,3004908059,45031021
1646146348,196387,true,2961061167,28,3004607598,43546431
1646146410,196384,true,2961949574,28,3003105745,41156171
1646146413,196382,true,2962541993,28,3003105745,40563752
1646146415,196379,true,2963430845,28,3003105745,39674900
1646146923,196376,true,2964319963,28,2991716166,27396203
1646146955,196373,true,2965209348,28,2990818831,25609483
1646146979,196371,true,2965802419,28,2990519779,24717360
1646147022,196369,true,2966395610,28,2989622802,23227192
1646147089,196367,true,2966988918,28,2988726095,21737177
1646147630,196365,true,2967582346,28,2981860267,14277921
1646147675,196363,true,2968175892,28,2980965888,12789996
1646147799,196361,true,2968769557,28,2978880046,10110489
1646147819,196360,true,2969066434,28,2978582188,9515754
1646147834,196358,true,2969660277,28,2978284359,8624082
1646147895,196357,true,2969957243,28,2977391053,7433810
1646148556,196354,true,2970848319,28,2974117887,3269568
1646148886,196353,true,2971145404,28,2974117887,2972483
1646148934,196351,true,2971739663,28,2974117887,2378224
1646149001,196349,true,2972334040,28,2973820505,1486465
1646149221,196346,true,2973225830,28,2973523152,297322
1646149268,196345,true,2973523152,28,2973225830,-297322
1646149280,196343,true,2974117887,28,2973225830,-892057
1646149281,196341,true,2974712740,28,2973225830,-1486910
1646149372,196339,true,2975307712,28,2972334040,-2973672
1646149441,196339,true,2975307712,28,2971442518,-3865194
1646149494,196336,true,2976200394,28,2971145404,-5054990
1646149515,196335,true,2976498014,28,2970848319,-5649695
1646149524,196334,true,2976795664,28,2970848319,-5947345
1646149539,196334,true,2976795664,28,2970551264,-6244400
1646149572,196333,true,2977093343,28,2970254238,-6839105
1646149585,196331,true,2977688792,28,2969957243,-7731549
1646150050,196331,true,2977688792,28,2960469043,-17219749
1646150096,196332,true,2977391053,28,2959581080,-17809973
1646150113,196331,true,2977688792,28,2959285152,-18403640
1646150260,196330,true,2977986561,28,2956623126,-21363435
1646150797,196330,true,2977986561,28,2947766990,-30219571
1646150813,196331,true,2977688792,28,2947472243,-30216549
1646150858,196331,true,2977688792,28,2946882837,-30805955
1646150987,196330,true,2977986561,28,2945115326,-32871235
1646151010,196330,true,2977986561,28,2944820844,-33165717
1646151325,196331,true,2977688792,28,2942466047,-35222745
1646151343,196330,true,2977986561,28,2942466047,-35520514
1646151509,196328,true,2978582188,28,2943348875,-35233313
1646151516,196329,true,2978284359,28,2943348875,-34935484
1646152180,196328,true,2978582188,28,2948946274,-29635914
1646152188,196327,true,2978880046,28,2948946274,-29933772
1646152220,196326,true,2979177934,28,2949241169,-29936765
1646152255,196326,true,2979177934,28,2949241169,-29936765
1646152301,196327,true,2978880046,28,2949241169,-29638877
1646152355,196327,true,2978880046,28,2948946274,-29933772
1646152372,196326,true,2979177934,28,2948946274,-30231660
1646152378,196327,true,2978880046,28,2948946274,-29933772
1646152432,196328,true,2978582188,28,2948356573,-30225615
1646152450,196329,true,2978284359,28,2948061767,-30222592
1646152469,196329,true,2978284359,28,2948061767,-30222592
1646152502,196331,true,2977688792,28,2947472243,-30216549
1646152978,196333,true,2977093343,28,2942171830,-34921513
1646152986,196335,true,2976498014,28,2942171830,-34326184
1646153300,196335,true,2976498014,28,2938349683,-38148331
1646153424,196337,true,2975902804,28,2935706490,-40196314
1646153462,196340,true,2975010211,28,2934825954,-40184257
1646153487,196341,true,2974712740,28,2934239077,-40473663
1646153696,196343,true,2974117887,28,2929255357,-44862530
1646153956,196345,true,2973523152,28,2922526147,-50997005
1646154863,196348,true,2972631274,28,2912024493,-60606781
1646154884,196349,true,2972334040,28,2912024493,-60309547
1646155004,196350,true,2972036837,28,2911151060,-60885777
1646155010,196353,true,2971145404,28,2911151060,-59994344
1646155037,196356,true,2970254238,28,2911151060,-59103178
1646155443,196357,true,2969957243,28,2912315695,-57641548
1646156875,196359,true,2969363340,28,2922233924,-47129416
1646156924,196361,true,2968769557,28,2922526147,-46243410
1646157018,196365,true,2967582346,28,2923110682,-44471664
1646157032,196366,true,2967285617,28,2923402993,-43882624
1646157078,196366,true,2967285617,28,2923987703,-43297914
1646157251,196368,true,2966692249,28,2926620345,-40071904
1646157341,196371,true,2965802419,28,2927791168,-38011251
1646157363,196373,true,2965209348,28,2928083947,-37125401
1646157445,196373,true,2965209348,28,2928962461,-36246887
1646158028,196376,true,2964319963,28,2934239077,-30080886
1646158140,196380,true,2963134531,28,2934825954,-28308577
1646158247,196382,true,2962541993,28,2935119436,-27422557
1646159545,196384,true,2961949574,28,2928669594,-33279980
1646159556,196388,true,2960765090,28,2928669594,-32095496
1646159605,196392,true,2959581080,28,2928376756,-31204324
1646159639,196394,true,2958989253,28,2928083947,-30905306
1646159787,196395,true,2958693383,28,2927791168,-30902215
1646159936,196399,true,2957510202,28,2928376756,-29133446
1646160073,196403,true,2956327493,28,2929255357,-27072136
1646160151,196405,true,2955736317,28,2930134221,-25602096
1646160317,196405,true,2955736317,28,2931599581,-24136736
1646160327,196409,true,2954554318,28,2931599581,-22954737
1646160407,196413,true,2953372791,28,2932772397,-20600394
1646162285,196414,true,2953077483,28,2949831046,-3246437
1646162407,196414,true,2953077483,28,2950126030,-2951453
1646162526,196416,true,2952486957,28,2950421042,-2065915
1646162638,196419,true,2951601388,28,2951011156,-590232
1646162750,196419,true,2951601388,28,2951601388,0
1646162902,196418,true,2951896548,28,2953077483,1180935
1646163806,196418,true,2951896548,28,2963430845,11534297
1646163938,196421,true,2951011156,28,2964912857,13901701
1646163997,196421,true,2951011156,28,2965505869,14494713
1646164019,196420,true,2951306257,28,2965802419,14496162
1646164028,196420,true,2951306257,28,2965802419,14496162
1646164108,196424,true,2950126030,28,2966692249,16566219
1646164182,196425,true,2949831046,28,2966988918,17157872
1646164291,196424,true,2950126030,28,2967582346,17456316
1646164306,196425,true,2949831046,28,2967582346,17751300
1646164322,196429,true,2948651409,28,2967582346,18930937
1646164389,196430,true,2948356573,28,2967582346,19225773
1646164530,196429,true,2948651409,28,2967285617,18634208
1646165276,196430,true,2948356573,28,2961061167,12704594
1646165718,196433,true,2947472243,28,2957214480,9742237
1646165738,196434,true,2947177525,28,2957214480,10036955
1646165750,196433,true,2947472243,28,2956918788,9446545
1646167053,196433,true,2947472243,28,2959285152,11812909
1646167170,196436,true,2946588178,28,2959581080,12992902
1646167220,196436,true,2946588178,28,2959877038,13288860
1646167308,196435,true,2946882837,28,2960173026,13290189
1646168426,196435,true,2946882837,28,2965209348,18326511
1646168691,196436,true,2946588178,28,2966395610,19807432
1646169278,196436,true,2946588178,28,2969066434,22478256
1646169350,196435,true,2946882837,28,2969066434,22183597
1646169384,196435,true,2946882837,28,2969066434,22183597
1646169400,196436,true,2946588178,28,2968769557,22181379
1646169431,196437,true,2946293549,28,2968769557,22476008
1646169439,196436,true,2946588178,28,2968769557,22181379
1646169731,196437,true,2946293549,28,2966395610,20102061
1646170920,196438,true,2945998949,28,2958693383,12694434
1646171005,196439,true,2945704379,28,2957805953,12101574
1646171083,196438,true,2945998949,28,2956918788,10919839
1646171869,196439,true,2945704379,28,2953372791,7668412
1646174178,196441,true,2945115326,28,2950421042,5305716
1646174235,196441,true,2945115326,28,2950716084,5600758
1646174521,196440,true,2945409838,28,2951601388,6191550
1646174641,196440,true,2945409838,28,2951896548,6486710
1646174689,196440,true,2945409838,28,2952191737,6781899
1646174869,196441,true,2945115326,28,2953372791,8257465
1646175404,196440,true,2945409838,28,2956327493,10917655
1646175485,196439,true,2945704379,28,2956918788,11214409
1646175680,196439,true,2945704379,28,2958397544,12693165
1646175724,196438,true,2945998949,28,2958989253,12990304
1646176283,196437,true,2946293549,28,2963430845,17137296
1646176680,196436,true,2946588178,28,2965209348,18621170
1646176778,196435,true,2946882837,28,2965505869,18623032
1646177397,196435,true,2946882837,28,2966395610,19512773
1646177874,196434,true,2947177525,28,2965505869,18328344
1646177904,196433,true,2947472243,28,2965505869,18033626
1646178620,196433,true,2947472243,28,2965802419,18330176
1646178640,196432,true,2947766990,28,2965802419,18035429
1646180639,196430,true,2948356573,28,2972334040,23977467
1646180663,196430,true,2948356573,28,2972334040,23977467
1646180686,196429,true,2948651409,28,2972334040,23682631
1646180704,196429,true,2948651409,28,2972334040,23682631
1646180714,196428,true,2948946274,28,2972036837,23090563
1646180766,196428,true,2948946274,28,2971739663,22793389
1646181100,196430,true,2948356573,28,2966988918,18632345
1646181124,196430,true,2948356573,28,2966692249,18335676
1646181151,196429,true,2948651409,28,2966099000,17447591
1646181228,196430,true,2948356573,28,2964912857,16556284
1646181242,196431,true,2948061767,28,2964616395,16554628
1646181252,196430,true,2948356573,28,2964616395,16259822
1646181346,196429,true,2948651409,28,2962838248,14186839
1646181996,196430,true,2948356573,28,2948651409,294836
1646182834,196430,true,2948356573,28,2936587290,-11769283
1646182915,196429,true,2948651409,28,2936000060,-12651349
1646182985,196428,true,2948946274,28,2935706490,-13239784
1646182994,196429,true,2948651409,28,2935706490,-12944919
1646183003,196428,true,2948946274,28,2935706490,-13239784
1646183026,196427,true,2949241169,28,2935706490,-13534679
1646183179,196426,true,2949536093,28,2936587290,-12948803
1646183271,196426,true,2949536093,28,2937174636,-12361457
1646183959,196425,true,2949831046,28,2943348875,-6482171
1646184000,196424,true,2950126030,28,2943643210,-6482820
1646184006,196421,true,2951011156,28,2943643210,-7367946
1646184044,196422,true,2950716084,28,2943643210,-7072874
1646184057,196421,true,2951011156,28,2943643210,-7367946
1646184080,196420,true,2951306257,28,2943643210,-7663047
1646184084,196418,true,2951896548,28,2943643210,-8253338
1646184129,196418,true,2951896548,28,2943643210,-8253338
1646184144,196418,true,2951896548,28,2943643210,-8253338
1646184368,196419,true,2951601388,28,2942760294,-8841094
1646184443,196417,true,2952191737,28,2942466047,-9725690
1646184547,196417,true,2952191737,28,2941877642,-10314095
1646186749,196418,true,2951896548,28,2924572530,-27324018
1646186764,196418,true,2951896548,28,2924864987,-27031561
1646187454,196418,true,2951896548,28,2926620345,-25276203
1646187634,196420,true,2951306257,28,2926913007,-24393250
1646189187,196421,true,2951011156,28,2925449989,-25561167
1646189779,196421,true,2951011156,28,2925449989,-25561167
1646189806,196421,true,2951011156,28,2925449989,-25561167
1646189826,196421,true,2951011156,28,2925449989,-25561167
1646189977,196422,true,2950716084,28,2926620345,-24095739
1646190063,196421,true,2951011156,28,2927205698,-23805458
1646190139,196420,true,2951306257,28,2928083947,-23222310
1646190477,196420,true,2951306257,28,2931306451,-19999806
1646190869,196420,true,2951306257,28,2936000060,-15306197
1646191612,196418,true,2951896548,28,2946293549,-5602999
1646191756,196418,true,2951896548,28,2947472243,-4424305
1646192044,196418,true,2951896548,28,2948651409,-3245139
1646192101,196418,true,2951896548,28,2948651409,-3245139
1646192102,196417,true,2952191737,28,2948651409,-3540328
1646192168,196417,true,2952191737,28,2949536093,-2655644
1646192179,196416,true,2952486957,28,2949536093,-2950864
1646192198,196416,true,2952486957,28,2949831046,-2655911
1646192208,196416,true,2952486957,28,2950126030,-2360927
1646192269,196414,true,2953077483,28,2951011156,-2066327
1646192314,196414,true,2953077483,28,2951896548,-1180935
1646192322,196413,true,2953372791,28,2951896548,-1476243
1646192395,196413,true,2953372791,28,2953372791,0
1646192543,196411,true,2953963495,28,2956918788,2955293
1646192832,196411,true,2953963495,28,2963134531,9171036
1646192864,196411,true,2953963495,28,2964023561,10060066
1646192890,196411,true,2953963495,28,2964616395,10652900
1646192910,196409,true,2954554318,28,2965209348,10655030
1646192933,196408,true,2954849773,28,2965802419,10952646
1646192957,196406,true,2955440772,28,2966692249,11251477
1646192981,196406,true,2955440772,28,2967285617,11844845
1646192987,196403,true,2956327493,28,2967582346,11254853
1646193004,196402,true,2956623126,28,2968175892,11552766
1646193085,196400,true,2957214480,28,2971442518,14228038
1646193633,196398,true,2957805953,28,2994409788,36603835
1646193678,196395,true,2958693383,28,2996206883,37513500
1646193754,196394,true,2958989253,28,2999204439,40215186
1646193932,196392,true,2959581080,28,3005509070,45927990
1646193935,196391,true,2959877038,28,3005509070,45632032
1646193969,196388,true,2960765090,28,3006711454,45946364
1646193976,196387,true,2961061167,28,3007012125,45950958
1646194367,196383,true,2962245769,28,3017554579,55308810
1646194535,196382,true,2962541993,28,3021479755,58937762
1646194657,196380,true,2963134531,28,3023897785,60763254
1646196190,196380,true,2963134531,28,3024200174,61065643
1646196443,196377,true,2964023561,28,3023595425,59571864
1646196478,196376,true,2964319963,28,3023293096,58973133
1646196558,196373,true,2965209348,28,3022990797,57781449
1646196828,196374,true,2964912857,28,3021781903,56869046
1646196898,196371,true,2965802419,28,3020875549,55073130
1646198841,196371,true,2965802419,28,3000704341,34901922
1646198844,196368,true,2966692249,28,3000704341,34012092
1646198854,196369,true,2966395610,28,3000704341,34308731
1646199922,196367,true,2966988918,28,2995008700,28019782
1646199954,196367,true,2966988918,28,2994709229,27720311
1646200936,196364,true,2967879104,28,2997405546,29526442
1646200956,196364,true,2967879104,28,2997405546,29526442
1646201207,196360,true,2969066434,28,2998904548,29838114
1646201693,196361,true,2968769557,28,3001904803,33135246
1646201705,196357,true,2969957243,28,3001904803,31947560
1646202123,196358,true,2969660277,28,3001004411,31344134
1646202151,196355,true,2970551264,28,3000704341,30153077
1646202200,196356,true,2970254238,28,3000404300,30150062
1646202250,196353,true,2971145404,28,3000104290,28958886
1646202273,196354,true,2970848319,28,2999804309,28955990
1646203094,196352,true,2971442518,28,2993212323,21769805
1646203696,196353,true,2971145404,28,2988128439,16983035
1646203759,196351,true,2971739663,28,2987530903,15791240
1646203966,196352,true,2971442518,28,2985440468,13997950
1646204139,196350,true,2972036837,28,2984545015,12508178
1646204547,196352,true,2971442518,28,2982158453,10715935
1646204661,196349,true,2972334040,28,2981263984,8929944
1646204710,196351,true,2971739663,28,2980667821,8928158
1646204735,196349,true,2972334040,28,2980667821,8333781
1646204893,196351,true,2971739663,28,2979475852,7736189
1646204907,196349,true,2972334040,28,2979177934,6843894
1646205038,196351,true,2971739663,28,2977986561,6246898
1646205997,196350,true,2972036837,28,2969957243,-2079594
1646206170,196352,true,2971442518,28,2969066434,-2376084
1646206199,196349,true,2972334040,28,2969066434,-3267606
1646207415,196349,true,2972334040,28,2970551264,-1782776
1646208175,196347,true,2972928537,28,2972036837,-891700
1646208345,196349,true,2972334040,28,2972036837,-297203
1646208380,196346,true,2973225830,28,2972036837,-1188993
1646208442,196346,true,2973225830,28,2972036837,-1188993
1646208449,196344,true,2973820505,28,2971739663,-2080842
1646208509,196346,true,2973225830,28,2971442518,-1783312
1646208901,196344,true,2973820505,28,2969066434,-4754071
1646208946,196343,true,2974117887,28,2968769557,-5348330
1646208972,196341,true,2974712740,28,2968769557,-5943183
1646208977,196343,true,2974117887,28,2968769557,-5348330
1646209012,196340,true,2975010211,28,2968769557,-6240654
1646209039,196339,true,2975307712,28,2968769557,-6538155
1646209040,196336,true,2976200394,28,2968769557,-7430837
1646209094,196338,true,2975605243,28,2969066434,-6538809
1646209106,196335,true,2976498014,28,2969363340,-7134674
1646209114,196334,true,2976795664,28,2969363340,-7432324
1646209152,196332,true,2977391053,28,2969660277,-7730776
1646209422,196333,true,2977093343,28,2973225830,-3867513
1646210289,196330,true,2977986561,28,2984843469,6856908
1646210902,196328,true,2978582188,28,2996206883,17624695
1646211039,196325,true,2979475852,28,2996206883,16731031
1646211110,196326,true,2979177934,28,2996206883,17028949
1646211224,196323,true,2980071777,28,2995607732,15535955
1646211322,196322,true,2980369784,28,2995308201,14938417
1646211341,196319,true,2981263984,28,2995308201,14044217
1646211661,196320,true,2980965888,28,2993212323,12246435
1646212023,196316,true,2982158453,28,2990818831,8660378
1646212600,196315,true,2982456669,28,2986037586,3580917
1646212655,196312,true,2983351495,28,2985739012,2387517
1646212724,196313,true,2983053190,28,2985141954,2088764
1646212738,196309,true,2984246590,28,2985141954,895364
1646213355,196308,true,2984545015,28,2985739012,1193997
1646213402,196304,true,2985739012,28,2985739012,0
1646213440,196305,true,2985440468,28,2985739012,298544
1646213443,196302,true,2986336189,28,2985739012,-597177
1646213450,196301,true,2986634823,28,2985739012,-895811
1646213468,196298,true,2987530903,28,2985739012,-1791891
1646213536,196298,true,2987530903,28,2986037586,-1493317
1646213543,196295,true,2988427252,28,2986336189,-2091063
1646213704,196295,true,2988427252,28,2986634823,-1792429
1646214538,196292,true,2989323870,28,2989024967,-298903
1646214543,196293,true,2989024967,28,2989024967,0
1646214618,196290,true,2989921765,28,2989024967,-896798
1646214652,196290,true,2989921765,28,2989024967,-896798
1646214696,196287,true,2990818831,28,2989323870,-1494961
1646214857,196288,true,2990519779,28,2989622802,-896977
1646215714,196285,true,2991417024,28,2992913032,1496008
1646216886,196286,true,2991117913,28,2995308201,4190288
1646217154,196283,true,2992015338,28,2995607732,3592394
1646217204,196284,true,2991716166,28,2996806154,5089988
1646217341,196282,true,2992314539,28,2998005057,5690518
1646217393,196282,true,2992314539,28,2998604688,6290149
1646217420,196278,true,2993511645,28,2998904548,5392903
1646217423,196280,true,2992913032,28,2998904548,5991516
1646217452,196278,true,2993511645,28,2999204439,5692794
1646217839,196278,true,2993511645,28,3004307167,10795522
1646218124,196275,true,2994409788,28,3007012125,12602337
1646218605,196277,true,2993810996,28,3012128138,18317142
1646218715,196275,true,2994409788,28,3013333170,18923382
1646218911,196276,true,2994110377,28,3015141622,21031245
1646218930,196273,true,2995008700,28,3015141622,20132922
1646218948,196276,true,2994110377,28,3015443136,21332759
1646219027,196275,true,2994409788,28,3014538684,20128896
1646219069,196277,true,2993810996,28,3014237260,20426264
1646219080,196275,true,2994409788,28,3014237260,19827472
1646219153,196278,true,2993511645,28,3013935866,20424221
1646219210,196277,true,2993810996,28,3013634503,19823507
1646219701,196279,true,2993212323,28,3008816784,15604461
1646221552,196277,true,2993810996,28,3000404300,6593304
1646222829,196280,true,2992913032,28,3000404300,7491268
1646222918,196279,true,2993212323,28,3000704341,7492018
1646222941,196281,true,2992613771,28,3000704341,8090570
1646223047,196281,true,2992613771,28,3000704341,8090570
1646223049,196283,true,2992015338,28,3000704341,8689003
1646223065,196283,true,2992015338,28,3000704341,8689003
1646223159,196284,true,2991716166,28,3001004411,9288245
1646223167,196283,true,2992015338,28,3001004411,8989073
1646223297,196285,true,2991417024,28,3001604642,10187618
1646223308,196284,true,2991716166,28,3001904803,10188637
1646223325,196285,true,2991417024,28,3001904803,10487779
1646223507,196283,true,2992015338,28,3003706396,11691058
1646223532,196284,true,2991716166,28,3004006766,12290600
1646223575,196283,true,2992015338,28,3004307167,12291829
1646223607,196283,true,2992015338,28,3004307167,12291829
1646223625,196282,true,2992314539,28,3004307167,11992628
1646223712,196282,true,2992314539,28,3004006766,11692227
1646223806,196283,true,2992015338,28,3003706396,11691058
1646224056,196284,true,2991716166,28,3001904803,10188637
1646224237,196283,true,2992015338,28,3000704341,8689003
1646224278,196284,true,2991716166,28,3000404300,8688134
1646224576,196285,true,2991417024,28,2994409788,2992764
1646224582,196287,true,2990818831,28,2994409788,3590957
1646224632,196287,true,2990818831,28,2993511645,2692814
1646224636,196288,true,2990519779,28,2993212323,2692544
1646224693,196288,true,2990519779,28,2992314539,1794760
1646224770,196289,true,2990220757,28,2991117913,897156
1646224833,196289,true,2990220757,28,2990220757,0
1646224842,196289,true,2990220757,28,2989921765,-298992
1646224868,196290,true,2989921765,28,2989622802,-298963
1646225407,196290,true,2989921765,28,2979177934,-10743831
1646225414,196289,true,2990220757,28,2978880046,-11340711
1646225432,196289,true,2990220757,28,2978880046,-11340711
1646225539,196290,true,2989921765,28,2978284359,-11637406
1646226098,196289,true,2990220757,28,2978582188,-11638569
1646226548,196288,true,2990519779,28,2983948195,-6571584
1646226658,196288,true,2990519779,28,2984843469,-5676310
1646226693,196288,true,2990519779,28,2984843469,-5676310
1646226711,196287,true,2990818831,28,2984843469,-5975362
1646226783,196285,true,2991417024,28,2985440468,-5976556
1646226797,196285,true,2991417024,28,2985440468,-5976556
1646226938,196286,true,2991117913,28,2985440468,-5677445
1646226967,196285,true,2991417024,28,2985440468,-5976556
1646226984,196285,true,2991417024,28,2985141954,-6275070
1646227041,196285,true,2991417024,28,2985141954,-6275070
1646227051,196287,true,2990818831,28,2984843469,-5975362
1646227412,196287,true,2990818831,28,2979177934,-11640897
1646227559,196287,true,2990818831,28,2975902804,-14916027
1646227679,196287,true,2990818831,28,2972928537,-17890294
1646227804,196288,true,2990519779,28,2969957243,-20562536
1646227952,196289,true,2990220757,28,2966988918,-23231839
1646227968,196289,true,2990220757,28,2966395610,-23825147
1646228149,196288,true,2990519779,28,2962245769,-28274010
1646228152,196290,true,2989921765,28,2962245769,-27675996
1646228261,196292,true,2989323870,28,2959285152,-30038718
1646228558,196293,true,2989024967,28,2951601388,-37423579
1646228578,196293,true,2989024967,28,2951011156,-38013811
1646228619,196295,true,2988427252,28,2950126030,-38301222
1646228625,196298,true,2987530903,28,2949831046,-37699857
1646228838,196299,true,2987232180,28,2945409838,-41822342
1646228848,196300,true,2986933487,28,2945409838,-41523649
1646229697,196302,true,2986336189,28,2942466047,-43870142
1646229833,196304,true,2985739012,28,2942466047,-43272965
1646230193,196304,true,2985739012,28,2945115326,-40623686
1646230574,196306,true,2985141954,28,2947766990,-37374964
1646230733,196307,true,2984843469,28,2948356573,-36486896
1646230939,196309,true,2984246590,28,2949241169,-35005421
1646231319,196309,true,2984246590,28,2951011156,-33235434
1646231333,196310,true,2983948195,28,2951011156,-32937039
1646231475,196311,true,2983649830,28,2952486957,-31162873
1646231667,196312,true,2983351495,28,2953668128,-29683367
1646232001,196312,true,2983351495,28,2955145258,-28206237
1646232066,196313,true,2983053190,28,2955736317,-27316873
1646232092,196313,true,2983053190,28,2956031890,-27021300
1646232094,196315,true,2982456669,28,2956031890,-26424779
1646232113,196314,true,2982754914,28,2956327493,-26427421
1646232145,196314,true,2982754914,28,2956918788,-25836126
1646232176,196314,true,2982754914,28,2957510202,-25244712
1646232181,196315,true,2982456669,28,2957805953,-24650716
1646232187,196314,true,2982754914,28,2957805953,-24948961
1646232193,196314,true,2982754914,28,2958101733,-24653181
1646232245,196313,true,2983053190,28,2959581080,-23472110
1646232252,196314,true,2982754914,28,2959581080,-23173834
1646232274,196312,true,2983351495,28,2960469043,-22882452
1646232292,196313,true,2983053190,28,2960765090,-22288100
1646232295,196311,true,2983649830,28,2961061167,-22588663
1646232492,196311,true,2983649830,28,2967582346,-16067484
1646232697,196310,true,2983948195,28,2974415298,-9532897
1646233234,196311,true,2983649830,28,2990818831,7169001
1646233257,196309,true,2984246590,28,2991417024,7170434
1646233277,196310,true,2983948195,28,2992015338,8067143
1646233282,196308,true,2984545015,28,2992314539,7769524
1646233312,196308,true,2984545015,28,2993511645,8966630
1646233478,196306,true,2985141954,28,2999804309,14662355
1646233567,196307,true,2984843469,28,3002805464,17961995
1646233592,196307,true,2984843469,28,3003406055,18562586
1646233627,196306,true,2985141954,28,3004307167,19165213
1646233629,196305,true,2985440468,28,3004307167,18866699
1646233663,196309,true,2984246590,28,3004908059,20661469
1646233704,196311,true,2983649830,28,3005208549,21558719
1646233823,196312,true,2983351495,28,3004908059,21556564
1646234486,196312,true,2983351495,28,2990519779,7168284
1646234787,196315,true,2982456669,28,2983948195,1491526
1646234852,196316,true,2982158453,28,2982456669,298216
1646234868,196318,true,2981562111,28,2982158453,596342
1646234952,196317,true,2981860267,28,2979773799,-2086468
1646234968,196320,true,2980965888,28,2979475852,-1490036
1646235007,196322,true,2980369784,28,2978582188,-1787596
1646235017,196323,true,2980071777,28,2978582188,-1489589
1646235018,196321,true,2980667821,28,2978582188,-2085633
1646235087,196322,true,2980369784,28,2977391053,-2978731
1646235253,196324,true,2979773799,28,2972928537,-6845262
1646235278,196325,true,2979475852,28,2972036837,-7439015
1646235294,196323,true,2980071777,28,2971739663,-8332114
1646235475,196326,true,2979177934,28,2967285617,-11892317
1646235517,196328,true,2978582188,28,2967285617,-11296571
1646235608,196329,true,2978284359,28,2967285617,-10998742
1646235640,196328,true,2978582188,28,2967582346,-10999842
1646235959,196331,true,2977688792,28,2967879104,-9809688
1646236782,196333,true,2977093343,28,2966988918,-10104425
1646236813,196334,true,2976795664,28,2966692249,-10103415
1646236893,196333,true,2977093343,28,2965802419,-11290924
1646236917,196336,true,2976200394,28,2965209348,-10991046
1646237036,196340,true,2975010211,28,2963430845,-11579366
1646237052,196342,true,2974415298,28,2963430845,-10984453
1646237492,196340,true,2975010211,28,2962541993,-12468218
1646237679,196343,true,2974117887,28,2961949574,-12168313
1646237799,196345,true,2973523152,28,2961949574,-11573578
1646238045,196346,true,2973225830,28,2961949574,-11276256
1646238053,196344,true,2973820505,28,2961949574,-11870931
1646238817,196345,true,2973523152,28,2965505869,-8017283
1646238821,196348,true,2972631274,28,2965505869,-7125405
1646239237,196348,true,2972631274,28,2968472710,-4158564
1646240402,196345,true,2973523152,28,2973225830,-297322
1646240454,196346,true,2973225830,28,2973225830,0
1646240459,196347,true,2972928537,28,2973225830,297293
1646240906,196348,true,2972631274,28,2971145404,-1485870
1646240994,196345,true,2973523152,28,2970848319,-2674833
1646241079,196346,true,2973225830,28,2970551264,-2674566
1646242127,196348,true,2972631274,28,2968472710,-4158564
1646242262,196348,true,2972631274,28,2968472710,-4158564
1646242350,196346,true,2973225830,28,2968769557,-4456273
1646243344,196347,true,2972928537,28,2969066434,-3862103
1646243426,196349,true,2972334040,28,2968769557,-3564483
1646243636,196350,true,2972036837,28,2967879104,-4157733
1646245451,196348,true,2972631274,28,2956623126,-16008148
1646245984,196351,true,2971739663,28,2956327493,-15412170
1646246319,196353,true,2971145404,28,2956031890,-15113514
1646246446,196353,true,2971145404,28,2955440772,-15704632
1646246470,196352,true,2971442518,28,2955145258,-16297260
1646246713,196356,true,2970254238,28,2953372791,-16881447
1646246757,196358,true,2969660277,28,2953077483,-16582794
1646246850,196359,true,2969363340,28,2951896548,-17466792
1646246938,196357,true,2969957243,28,2950716084,-19241159
1646247323,196361,true,2968769557,28,2945115326,-23654231
1646248979,196363,true,2968175892,28,2930427235,-37748657
1646249110,196364,true,2967879104,28,2930134221,-37744883
1646249486,196362,true,2968472710,28,2929548282,-38924428
1646249971,196365,true,2967582346,28,2928083947,-39498399
1646250049,196367,true,2966988918,28,2928083947,-38904971
1646250161,196367,true,2966988918,28,2928083947,-38904971
1646251354,196364,true,2967879104,28,2931013349,-36865755
1646251404,196366,true,2967285617,28,2931306451,-35979166
1646252074,196368,true,2966692249,28,2934532501,-32159748
1646252153,196369,true,2966395610,28,2934825954,-31569656
1646253532,196365,true,2967582346,28,2937174636,-30407710
1646253593,196367,true,2966988918,28,2937174636,-29814282
1646253885,196369,true,2966395610,28,2937174636,-29220974
1646254151,196369,true,2966395610,28,2937174636,-29220974
1646254172,196366,true,2967285617,28,2937468354,-29817263
1646254180,196367,true,2966988918,28,2937468354,-29520564
1646254702,196368,true,2966692249,28,2938643518,-28048731
1646254936,196368,true,2966692249,28,2939231276,-27460973
1646257904,196366,true,2967285617,28,2942171830,-25113787
1646258148,196368,true,2966692249,28,2942760294,-23931955
1646258327,196369,true,2966395610,28,2943348875,-23046735
1646258376,196369,true,2966395610,28,2943937574,-22458036
1646258406,196366,true,2967285617,28,2944231968,-23053649
1646258430,196367,true,2966988918,28,2944526391,-22462527
1646258460,196368,true,2966692249,28,2944820844,-21871405
1646258549,196367,true,2966988918,28,2946293549,-20695369
1646258613,196364,true,2967879104,28,2947472243,-20406861
1646258682,196366,true,2967285617,28,2948651409,-18634208
1646258741,196366,true,2967285617,28,2949536093,-17749524
1646258894,196365,true,2967582346,28,2952486957,-15095389
1646258940,196363,true,2968175892,28,2953372791,-14803101
1646258966,196364,true,2967879104,28,2953668128,-14210976
1646262036,196367,true,2966988918,28,2967285617,296699
1646263469,196367,true,2966988918,28,2966988918,0
1646263891,196364,true,2967879104,28,2966692249,-1186855
1646264551,196366,true,2967285617,28,2965505869,-1779748
1646264725,196369,true,2966395610,28,2964912857,-1482753
1646264931,196370,true,2966099000,28,2964023561,-2075439
1646265624,196369,true,2966395610,28,2959877038,-6518572
1646265850,196371,true,2965802419,28,2958397544,-7404875
1646266121,196375,true,2964616395,28,2956031890,-8584505
1646266267,196376,true,2964319963,28,2954554318,-9765645
1646267365,196376,true,2964319963,28,2945704379,-18615584
1646267419,196379,true,2963430845,28,2945409838,-18021007
1646267432,196383,true,2962245769,28,2945115326,-17130443
1646267458,196384,true,2961949574,28,2945115326,-16834248
1646267541,196384,true,2961949574,28,2944820844,-17128730
1646267603,196387,true,2961061167,28,2944820844,-16240323
1646268276,196390,true,2960173026,28,2947472243,-12700783
1646268935,196392,true,2959581080,28,2953077483,-6503597
1646268962,196393,true,2959285152,28,2953077483,-6207669
1646269820,196395,true,2958693383,28,2959285152,591769
1646269862,196397,true,2958101733,28,2959581080,1479347
1646269948,196399,true,2957510202,28,2959877038,2366836
1646269964,196399,true,2957510202,28,2959877038,2366836
1646270011,196400,true,2957214480,28,2959877038,2662558
1646271987,196401,true,2956918788,28,2955145258,-1773530
1646271998,196401,true,2956918788,28,2955145258,-1773530
1646272078,196400,true,2957214480,28,2955145258,-2069222
1646272266,196401,true,2956918788,28,2954258892,-2659896
1646273276,196404,true,2956031890,28,2948356573,-7675317
1646273299,196403,true,2956327493,28,2948061767,-8265726
1646273812,196403,true,2956327493,28,2942171830,-14155663
1646274803,196404,true,2956031890,28,2936293660,-19738230
1646274838,196407,true,2955145258,28,2936000060,-19145198
1646274889,196407,true,2955145258,28,2935706490,-19438768
1646274968,196408,true,2954849773,28,2935119436,-19730337
1646277502,196411,true,2953963495,28,2928083947,-25879548
1646278371,196414,true,2953077483,28,2928083947,-24993536
1646278642,196413,true,2953372791,28,2927791168,-25581623
1646278671,196414,true,2953077483,28,2927498419,-25579064
1646278685,196416,true,2952486957,28,2927498419,-24988538
1646278707,196419,true,2951601388,28,2927205698,-24395690
1646278716,196420,true,2951306257,28,2927205698,-24100559
1646278752,196421,true,2951011156,28,2926620345,-24390811
1646279277,196424,true,2950126030,28,2918145863,-31980167
1646281047,196427,true,2949241169,28,2898950475,-50290694
1646281292,196428,true,2948946274,28,2898660609,-50285665
1646282416,196429,true,2948651409,28,2901270447,-47380962
1646282457,196432,true,2947766990,28,2901560574,-46206416
1646283675,196434,true,2947177525,28,2899240370,-47937155
1646283883,196435,true,2946882837,28,2898660609,-48222228
1646284124,196437,true,2946293549,28,2898080964,-48212585
1646284190,196439,true,2945704379,28,2898080964,-47623415
1646284220,196442,true,2944820844,28,2898080964,-46739880
1646284659,196442,true,2944820844,28,2900110229,-44710615
1646285041,196443,true,2944526391,28,2902140915,-42385476
1646286487,196447,true,2943348875,28,2906206555,-37142320
1646286664,196449,true,2942760294,28,2906206555,-36553739
1646286701,196450,true,2942466047,28,2906206555,-36259492
1646287675,196452,true,2941877642,28,2905625400,-36252242
1646287765,196455,true,2940995255,28,2905625400,-35369855
1646287827,196458,true,2940113133,28,2905334867,-34778266
1646287859,196458,true,2940113133,28,2905334867,-34778266
1646287939,196459,true,2939819151,28,2904753887,-35065264
1646287992,196463,true,2938643518,28,2904463441,-34180077
1646288020,196466,true,2937762101,28,2904463441,-33298660
1646288028,196467,true,2937468354,28,2904463441,-33004913
1646288064,196469,true,2936880948,28,2903882635,-32998313
1646289058,196474,true,2935412948,28,2892580112,-42832836
1646289143,196476,true,2934825954,28,2892001683,-42824271
1646289193,196476,true,2934825954,28,2891423369,-43402585
1646289200,196478,true,2934239077,28,2891423369,-42815708
1646289241,196481,true,2933358981,28,2891423369,-41935612
1646289244,196484,true,2932479149,28,2891423369,-41055780
1646289329,196483,true,2932772397,28,2891134256,-41638141
1646289539,196484,true,2932479149,28,2890845171,-41633978
1646289744,196487,true,2931599581,28,2891134256,-40465325
1646289966,196489,true,2931013349,28,2892869370,-38143979
1646290264,196488,true,2931306451,28,2896342723,-34963728
1646290439,196488,true,2931306451,28,2898370772,-32935679
1646290717,196491,true,2930427235,28,2901560574,-28866661
1646290897,196492,true,2930134221,28,2903592276,-26541945
1646291053,196491,true,2930427235,28,2905044362,-25382873
1646291161,196491,true,2930427235,28,2905334867,-25092368
1646291171,196493,true,2929841237,28,2905625400,-24215837
1646291508,196494,true,2929548282,28,2907078504,-22469778
1646291971,196493,true,2929841237,28,2908532334,-21308903
1646292694,196494,true,2929548282,28,2910568917,-18979365
1646292801,196496,true,2928962461,28,2910568917,-18393544
1646294222,196497,true,2928669594,28,2909986891,-18682703
1646294409,196496,true,2928962461,28,2909695921,-19266540
1646295040,196497,true,2928669594,28,2909114069,-19555525
1646295426,196499,true,2928083947,28,2908823187,-19260760
1646295536,196500,true,2927791168,28,2908823187,-18967981
1646297478,196499,true,2928083947,28,2909695921,-18388026
1646298924,196501,true,2927498419,28,2906497175,-21001244
1646299058,196503,true,2926913007,28,2906206555,-20706452
1646299223,196504,true,2926620345,28,2905334867,-21285478
1646299308,196504,true,2926620345,28,2905044362,-21575983
1646299332,196505,true,2926327712,28,2905044362,-21283350
1646299660,196508,true,2925449989,28,2903592276,-21857713
1646299807,196510,true,2924864987,28,2903011645,-21853342
1646299903,196509,true,2925157473,28,2902431129,-22726344
1646300110,196512,true,2924280102,28,2900690280,-23589822
1646301893,196515,true,2923402993,28,2891712512,-31690481
1646302009,196518,true,2922526147,28,2891712512,-30813635
1646302256,196519,true,2922233924,28,2891423369,-30810555
1646302283,196522,true,2921357429,28,2891423369,-29934060
1646302356,196525,true,2920481197,28,2891134256,-29346941
1646303411,196529,true,2919313297,28,2888533536,-30779761
1646304060,196529,true,2919313297,28,2887667149,-31646148
1646304365,196532,true,2918437678,28,2887378411,-31059267
1646304382,196536,true,2917270595,28,2887667149,-29603446
1646305090,196538,true,2916687228,28,2894026692,-22660536
1646305123,196538,true,2916687228,28,2894605526,-22081702
1646305715,196540,true,2916103978,28,2900110229,-15993749
1646305736,196544,true,2914937828,28,2900400240,-14537588
1646306130,196545,true,2914646363,28,2904753887,-9892476
1646306235,196545,true,2914646363,28,2905334867,-9311496
1646306258,196546,true,2914354928,28,2905334867,-9020061
1646306266,196550,true,2913189477,28,2905334867,-7854610
1646306844,196550,true,2913189477,28,2908532334,-4657143
1646306873,196549,true,2913480796,28,2908823187,-4657609
1646306960,196550,true,2913189477,28,2909695921,-3493556
1646307575,196553,true,2912315695,28,2916395588,4079893
1646307989,196552,true,2912606927,28,2920481197,7874270
1646308198,196551,true,2912898187,28,2921941730,9043543
1646308365,196553,true,2912315695,28,2922818400,10502705
1646308388,196555,true,2911733319,28,2922818400,11085081
1646308546,196556,true,2911442175,28,2923695333,12253158
1646308695,196555,true,2911733319,28,2923987703,12254384
1646309233,196557,true,2911151060,28,2923110682,11959622
1646309267,196560,true,2910277889,28,2922818400,12540511
1646309317,196561,true,2909986891,28,2922526147,12539256
1646309990,196561,true,2909986891,28,2918437678,8450787
1646310031,196563,true,2909404981,28,2918145863,8740882
1646310371,196565,true,2908823187,28,2916687228,7864041
1646310428,196566,true,2908532334,28,2916395588,7863254
1646310457,196566,true,2908532334,28,2916395588,7863254
1646310541,196568,true,2907950714,28,2916395588,8444874
1646310574,196570,true,2907369212,28,2916395588,9026376
1646311102,196569,true,2907659948,28,2916978897,9318949
1646311708,196569,true,2907659948,28,2919313297,11653349
1646311715,196570,true,2907369212,28,2919313297,11944085
1646312500,196572,true,2906787825,28,2919897189,13109364
1646312652,196570,true,2907369212,28,2919313297,11944085
1646314787,196571,true,2907078504,28,2917562322,10483818
1646315788,196572,true,2906787825,28,2919605228,12817403
1646316032,196573,true,2906497175,28,2920189178,13692003
1646316092,196572,true,2906787825,28,2920481197,13693372
1646316365,196571,true,2907078504,28,2921941730,14863226
1646317567,196572,true,2906787825,28,2926327712,19539887
1646317882,196573,true,2906497175,28,2926913007,20415832
1646317993,196571,true,2907078504,28,2926620345,19541841
1646318047,196570,true,2907369212,28,2926620345,19251133
1646318076,196570,true,2907369212,28,2926327712,18958500
1646318264,196571,true,2907078504,28,2925449989,18371485
1646318457,196569,true,2907659948,28,2923695333,16035385
1646318622,196568,true,2907950714,28,2922526147,14575433
1646318663,196568,true,2907950714,28,2921941730,13991016
1646318682,196570,true,2907369212,28,2921649565,14280353
1646318925,196569,true,2907659948,28,2917562322,9902374
1646318946,196568,true,2907950714,28,2916978897,9028183
1646318962,196569,true,2907659948,28,2916687228,9027280
1646320001,196571,true,2907078504,28,2894605526,-12472978
1646320200,196570,true,2907369212,28,2891134256,-16234956
1646320226,196570,true,2907369212,28,2890556116,-16813096
1646320347,196571,true,2907078504,28,2888244711,-18833793
1646320378,196574,true,2906206555,28,2887667149,-18539406
1646320401,196574,true,2906206555,28,2887089702,-19116853
1646320432,196574,true,2906206555,28,2886512371,-19694184
1646320435,196575,true,2905915963,28,2886512371,-19403592
1646320505,196578,true,2905044362,28,2885358054,-19686308
1646320510,196578,true,2905044362,28,2885069547,-19974815
1646320528,196579,true,2904753887,28,2884781069,-19972818
1646320689,196580,true,2904463441,28,2881321581,-23141860
1646320983,196583,true,2903592276,28,2876140126,-27452150
1646321051,196583,true,2903592276,28,2874989958,-28602318
1646321086,196584,true,2903301946,28,2874127633,-29174313
1646321102,196585,true,2903011645,28,2873840249,-29171396
1646321763,196588,true,2902140915,28,2860079556,-42061359
1646321897,196588,true,2902140915,28,2857221049,-44919866
1646321961,196589,true,2901850730,28,2855507316,-46343414
1646322144,196590,true,2901560574,28,2851227480,-50333094
1646322418,196595,true,2900110229,28,2845246483,-54863746
1646322442,196596,true,2899820247,28,2844961987,-54858260
1646322548,196597,true,2899530294,28,2843255607,-56274687
1646322626,196599,true,2898950475,28,2842118589,-56831886
1646322663,196604,true,2897501434,28,2841550251,-55951183
1646322692,196605,true,2897211713,28,2841266124,-55945589
1646322726,196606,true,2896922021,28,2840697956,-56224065
1646323385,196608,true,2896342723,28,2833038799,-63303924
1646323447,196614,true,2894605526,28,2832189057,-62416469
1646323553,196615,true,2894316094,28,2830773388,-63542706
1646324515,196617,true,2893737318,28,2825117781,-68619537
1646324519,196619,true,2893158657,28,2825117781,-68040876
1646324538,196624,true,2891712512,28,2825117781,-66594731
1646325498,196625,true,2891423369,28,2826530623,-64892746
1646327202,196627,true,2890845171,28,2825682833,-65162338
1646327695,196629,true,2890267089,28,2825117781,-65149308
1646328109,196635,true,2888533536,28,2824835298,-63698238
1646328213,196636,true,2888244711,28,2824835298,-63409413
1646328243,196638,true,2887667149,28,2824552842,-63114307
1646328514,196641,true,2886801022,28,2822294217,-64506805
1646328524,196647,true,2885069547,28,2822294217,-62775330
1646328542,196648,true,2884781069,28,2822294217,-62486852
1646328578,196650,true,2884204200,28,2821729842,-62474358
1646328666,196654,true,2883050806,28,2820319401,-62731405
1646328725,196661,true,2881033478,28,2819191555,-61841923
1646328766,196662,true,2880745403,28,2818627801,-62117602
1646328810,196664,true,2880169341,28,2818064160,-62105181
1646328927,196667,true,2879305463,28,2816937216,-62368247
1646329003,196672,true,2877866242,28,2816373913,-61492329
1646329012,196673,true,2877578484,28,2816373913,-61204571
1646329036,196675,true,2877003054,28,2816092304,-60910750
1646329052,196677,true,2876427740,28,2816092304,-60335436
1646329065,196682,true,2874989958,28,2816092304,-58897654
1646330488,196682,true,2874989958,28,2818627801,-56362157
1646330717,196683,true,2874702487,28,2820883493,-53818994
1646330844,196686,true,2873840249,28,2821729842,-52110407
1646331297,196690,true,2872691000,28,2822012015,-50678985
1646331588,196690,true,2872691000,28,2822576446,-50114554
1646332422,196691,true,2872403760,28,2825117781,-47285979
1646332670,196693,true,2871829365,28,2825965401,-45863964
1646332804,196698,true,2870393881,28,2825965401,-44428480
1646333096,196699,true,2870106871,28,2825965401,-44141470
1646333160,196700,true,2869819889,28,2825965401,-43854488
1646333334,196704,true,2868672248,28,2825682833,-42989415
1646334759,196708,true,2867525065,28,2821165581,-46359484
1646335552,196709,true,2867238342,28,2820601433,-46636909
1646335595,196711,true,2866664980,28,2820601433,-46063547
1646335904,196714,true,2865805152,28,2820601433,-45203719
1646335965,196719,true,2864372680,28,2820601433,-43771247
1646336855,196721,true,2863799891,28,2820601433,-43198458
1646336968,196723,true,2863227217,28,2820319401,-42907816
1646337073,196726,true,2862368421,28,2820037397,-42331024
1646339295,196732,true,2860651600,28,2811309253,-49342347
1646340189,196735,true,2859793577,28,2812715189,-47078388
1646340423,196737,true,2859221704,28,2812996460,-46225244
1646340581,196740,true,2858364109,28,2812433945,-45930164
1646340663,196746,true,2856649690,28,2812152730,-44496960
1646341429,196749,true,2855792867,28,2809061217,-46731650
1646342133,196751,true,2855221794,28,2804850994,-50370800
1646342322,196755,true,2854079991,28,2804009707,-50070284
1646342979,196761,true,2852368142,28,2804290108,-48078034
1646344238,196764,true,2851512602,28,2806253700,-45258902
1646344319,196765,true,2851227480,28,2806253700,-44973780
1646344802,196769,true,2850087274,28,2804570537,-45516737
1646344884,196774,true,2848662658,28,2804290108,-44372550
1646344918,196778,true,2847523477,28,2804290108,-43233369
1646344932,196780,true,2846954058,28,2804290108,-42663950
1646344994,196781,true,2846669391,28,2805131479,-41537912
1646344998,196787,true,2844961987,28,2805131479,-39830508
1646345103,196789,true,2844393080,28,2806814979,-37578101
1646346422,196791,true,2843824287,28,2826247998,-17576289
1646346497,196793,true,2843255607,28,2827661404,-15594203
1646346528,196798,true,2841834406,28,2828226965,-13607441
1646348269,196800,true,2841266124,28,2834455602,-6810522
1646348603,196801,true,2840982026,28,2834455602,-6526424
1646349202,196803,true,2840413915,28,2834455602,-5958313
1646349531,196808,true,2838994134,28,2834455602,-4538532
1646349623,196810,true,2838426420,28,2834739047,-3687373
1646349743,196812,true,2837858820,28,2835022521,-2836299
1646349913,196814,true,2837291333,28,2835589554,-1701779
1646352075,196819,true,2835873113,28,2840129902,4256789
1646352376,196821,true,2835306024,28,2839845917,4539893
1646352419,196823,true,2834739047,28,2839845917,5106870
1646352517,196825,true,2834172185,28,2839561961,5389776
1646352557,196829,true,2833038799,28,2839278033,6239234
1646352589,196831,true,2832472276,28,2839278033,6805757
1646352927,196833,true,2831905867,28,2836723960,4818093
1646352945,196835,true,2831339571,28,2836723960,5384389
1646353085,196840,true,2829924325,28,2835306024,5381699
1646353227,196841,true,2829641361,28,2833605435,3964074
1646353283,196843,true,2829075518,28,2833038799,3963281
1646353353,196844,true,2828792639,28,2832472276,3679637
1646353364,196848,true,2827661404,28,2832189057,4527653
1646353709,196849,true,2827378667,28,2828226965,848298
1646353860,196851,true,2826813276,28,2826247998,-565278
1646354012,196853,true,2826247998,28,2824552842,-1695156
1646354656,196856,true,2825400293,28,2818345966,-7054327
1646354680,196857,true,2825117781,28,2818345966,-6771815
1646354687,196859,true,2824552842,28,2818064160,-6488682
1646354708,196860,true,2824270415,28,2818064160,-6206255
1646354731,196864,true,2823140989,28,2817782382,-5358607
1646354755,196865,true,2822858704,28,2817500632,-5358072
1646354773,196866,true,2822576446,28,2817218910,-5357536
1646354790,196868,true,2822012015,28,2816937216,-5074799
1646355029,196874,true,2820319401,28,2809623058,-10696343
1646355053,196876,true,2819755421,28,2809061217,-10694204
1646355060,196877,true,2819473474,28,2808780339,-10693135
1646355065,196879,true,2818909664,28,2808499489,-10410175
1646355069,196885,true,2817218910,28,2808499489,-8719421
1646355084,196887,true,2816655551,28,2807937874,-8717677
1646355107,196888,true,2816373913,28,2807095661,-9278252
1646355124,196890,true,2815810723,28,2806534326,-9276397
1646355164,196895,true,2814403240,28,2804850994,-9552246
1646355257,196898,true,2813559088,28,2800367045,-13192043
1646355796,196901,true,2812715189,28,2774723093,-37992096
1646356095,196902,true,2812433945,28,2760884795,-51549150
1646356139,196908,true,2810747075,28,2758952948,-51794127
1646356156,196911,true,2809904020,28,2758125428,-51778592
1646356241,196914,true,2809061217,28,2753165515,-55895702
1646356281,196917,true,2808218667,28,2750688905,-57529762
1646356296,196923,true,2806534326,28,2749588904,-56945422
1646356316,196926,true,2805692534,28,2748489343,-57203191
1646356435,196930,true,2804570537,28,2740804721,-63765816
1646356653,196933,true,2803729334,28,2730136932,-73592402
1646356976,196938,true,2802327890,28,2720598631,-81729259
1646357031,196942,true,2801207239,28,2719782615,-81424624
1646357114,196945,true,2800367045,28,2718966843,-81400202
1646357436,196947,true,2799807056,28,2715977773,-83829283
1646358581,196952,true,2798407572,28,2715706203,-82701369
1646358869,196956,true,2797288489,28,2716792648,-80495841
1646358903,196959,true,2796449470,28,2717064327,-79385143
1646359234,196960,true,2796169853,28,2718966843,-77203010
1646359301,196964,true,2795051665,28,2719510664,-75541001
1646359632,196966,true,2794492738,28,2721414892,-73077846
1646361790,196970,true,2793375220,28,2727953805,-65421415
1646363171,196970,true,2793375220,28,2728772273,-64602947
1646363785,196973,true,2792537375,28,2728772273,-63765102
1646363795,196975,true,2791978952,28,2728772273,-63206679
1646363859,196978,true,2791141526,28,2728772273,-62369253
1646363867,196979,true,2790862439,28,2728772273,-62090166
1646363886,196984,true,2789467427,28,2728772273,-60695154
1646363932,196986,true,2788909617,28,2728499423,-60410194
1646364017,196990,true,2787794332,28,2728226600,-59567732
1646364337,196991,true,2787515580,28,2726862896,-60652684
1646364480,196996,true,2786122241,28,2726045001,-60077240
1646364545,196999,true,2785286571,28,2725772423,-59514148
1646367582,197003,true,2784172735,28,2720870691,-63302044
1646367742,197004,true,2783894345,28,2720870691,-63023654
1646367863,197009,true,2782502816,28,2720870691,-61632125
1646367883,197012,true,2781668232,28,2720870691,-60797541
1646367962,197016,true,2780555843,28,2720870691,-59685152
1646368592,197018,true,2779999815,28,2720598631,-59401184
1646368604,197023,true,2778610232,28,2720598631,-58011601
1646368655,197026,true,2777776815,28,2720598631,-57178184
1646368720,197030,true,2776665982,28,2720598631,-56067351
1646369013,197031,true,2776388344,28,2720326598,-56061746
1646369501,197036,true,2775000566,28,2719782615,-55217951
1646369518,197039,true,2774168232,28,2719782615,-54385617
1646369524,197043,true,2773058842,28,2719782615,-53276227
1646369817,197044,true,2772781564,28,2720054593,-52726971
1646370664,197049,true,2771395589,28,2720598631,-50796958
1646370743,197052,true,2770564337,28,2720870691,-49693646
1646370753,197055,true,2769733334,28,2720870691,-48862643
1646370952,197057,true,2769179470,28,2721414892,-47764578
1646372027,197060,true,2768348882,28,2723592786,-44756096
1646372550,197063,true,2767518544,28,2724409946,-43108598
1646372801,197067,true,2766411813,28,2724409946,-42001867
1646374147,197068,true,2766135199,28,2724409946,-41725253
1646377318,197072,true,2765029022,28,2724409946,-40619076
1646377535,197074,true,2764476099,28,2724409946,-40066153
1646377834,197077,true,2763646922,28,2724409946,-39236976
1646379364,197078,true,2763370585,28,2724954855,-38415730
1646379979,197082,true,2762265513,28,2724954855,-37310658
1646380359,197084,true,2761713143,28,2724954855,-36758288
1646380419,197087,true,2760884795,28,2724954855,-35929940
1646380675,197088,true,2760608734,28,2724954855,-35653879
1646380810,197092,true,2759504766,28,2724954855,-34549911
1646380848,197094,true,2758952948,28,2725227351,-33725597
1646381223,197097,true,2758125428,28,2726045001,-32080427
1646381268,197099,true,2757573885,28,2726317605,-31256280
1646381382,197103,true,2756471131,28,2727135582,-29335549
1646381434,197106,true,2755644355,28,2727408296,-28236059
1646381480,197109,true,2754817827,28,2727953805,-26864022
1646381810,197111,true,2754266946,28,2731229150,-23037796
1646382366,197115,true,2753165515,28,2736970471,-16195044
1646382403,197118,true,2752339731,28,2737244168,-15095563
1646382420,197121,true,2751514194,28,2737244168,-14270026
1646382445,197122,true,2751239070,28,2737517892,-13721178
1646382576,197127,true,2749863863,28,2738613064,-11250799
1646382606,197130,true,2749039069,28,2738886925,-10152144
1646382627,197133,true,2748214522,28,2738886925,-9327597
1646382695,197135,true,2747664961,28,2738886925,-8778036
1646382751,197142,true,2745742365,28,2738339230,-7403135
1646383079,197146,true,2744644343,28,2735602396,-9041947
1646383111,197149,true,2743821114,28,2735328863,-8492251
1646383431,197150,true,2743546759,28,2733688240,-9858519
1646384177,197155,true,2742175397,28,2729318054,-12857343
1646384178,197159,true,2741078801,28,2729318054,-11760747
1646384304,197161,true,2740530668,28,2729045150,-11485518
1646384446,197163,true,2739982644,28,2729045150,-10937494
1646385015,197167,true,2738886925,28,2735055357,-3831568
1646385230,197170,true,2738065423,28,2735875956,-2189467
1646385383,197172,true,2737517892,28,2736423159,-1094733
1646385436,197173,true,2737244168,28,2736696801,-547367
1646385449,197177,true,2736149544,28,2736696801,547257
1646385832,197181,true,2735055357,28,2735055357,0
1646385840,197184,true,2734235005,28,2735055357,820352
1646385856,197185,true,2733961609,28,2735055357,1093748
1646385875,197189,true,2732868297,28,2735055357,2187060
1646385897,197193,true,2731775423,28,2735055357,3279934
1646386207,197194,true,2731502273,28,2734508428,3006155
1646386372,197196,true,2730956055,28,2734235005,3278950
1646386441,197199,true,2730136932,28,2733961609,3824677
1646386779,197202,true,2729318054,28,2732595038,3276984
1646389216,197204,true,2728772273,28,2732868297,4096024
1646390001,197204,true,2728772273,28,2732868297,4096024
1646390075,197204,true,2728772273,28,2733141584,4369311
1646390229,197207,true,2727953805,28,2734235005,6281200
1646390820,197208,true,2727681036,28,2739982644,12301608
1646391485,197207,true,2727953805,28,2746566170,18612365
1646391636,197206,true,2728226600,28,2748214522,19987922
1646391765,197209,true,2727408296,28,2749313973,21905677
1646392041,197209,true,2727408296,28,2750138849,22730553
1646394796,197208,true,2727681036,28,2746291541,18610505
1646395379,197207,true,2727953805,28,2747664961,19711156
1646395733,197208,true,2727681036,28,2748489343,20808307
1646395770,197207,true,2727953805,28,2748489343,20535538
1646395783,197206,true,2728226600,28,2748489343,20262743
1646395942,197205,true,2728499423,28,2748214522,19715099
1646395985,197207,true,2727953805,28,2748214522,20260717
1646396773,197205,true,2728499423,28,2744918807,16419384
1646396824,197203,true,2729045150,28,2744644343,15599193
1646396847,197201,true,2729590986,28,2744644343,15053357
1646397093,197202,true,2729318054,28,2742175397,12857343
1646397602,197201,true,2729590986,28,2736970471,7379485
1646397638,197199,true,2730136932,28,2736696801,6559869
1646397969,197197,true,2730682986,28,2735875956,5192970
1646398242,197199,true,2730136932,28,2735328863,5191931
1646398309,197198,true,2730409945,28,2734781879,4371934
1646398902,197196,true,2730956055,28,2732321806,1365751
1646398915,197196,true,2730956055,28,2732321806,1365751
1646399159,197197,true,2730682986,28,2731775423,1092437
1646400552,197197,true,2730682986,28,2726317605,-4365381
1646400615,197195,true,2731229150,28,2726317605,-4911545
1646400655,197195,true,2731229150,28,2726590237,-4638913
1646400715,197197,true,2730682986,28,2726862896,-3820090
1646400733,197196,true,2730956055,28,2727135582,-3820473
1646400907,197194,true,2731502273,28,2728499423,-3002850
1646400942,197194,true,2731502273,28,2728499423,-3002850
1646402041,197197,true,2730682986,28,2729318054,-1364932
1646402202,197196,true,2730956055,28,2729318054,-1638001
1646402219,197194,true,2731502273,28,2729318054,-2184219
1646402883,197194,true,2731502273,28,2725499873,-6002400
1646402899,197197,true,2730682986,28,2725499873,-5183113
1646402941,197196,true,2730956055,28,2725227351,-5728704
1646403018,197194,true,2731502273,28,2724954855,-6547418
1646403337,197194,true,2731502273,28,2723048149,-8454124
1646403355,197198,true,2730409945,28,2723048149,-7361796
1646403374,197196,true,2730956055,28,2722775872,-8180183
1646403413,197195,true,2731229150,28,2721687034,-9542116
1646403435,197198,true,2730409945,28,2721414892,-8995053
1646403469,197202,true,2729318054,28,2720598631,-8719423
1646403574,197200,true,2729863945,28,2718966843,-10897102
1646403681,197198,true,2730409945,28,2717336034,-13073911
1646403711,197201,true,2729590986,28,2716792648,-12798338
1646403764,197205,true,2728499423,28,2715977773,-12521650
1646404225,197202,true,2729318054,28,2710822572,-18495482
1646404321,197200,true,2729863945,28,2710009488,-19854457
1646404336,197203,true,2729045150,28,2710009488,-19035662
1646404379,197207,true,2727953805,28,2709467567,-18486238
1646404414,197204,true,2728772273,28,2709196648,-19575625
1646404512,197202,true,2729318054,28,2707842456,-21475598
1646404838,197205,true,2728499423,28,2703783940,-24715483
1646404895,197210,true,2727135582,28,2703243264,-23892318
1646405016,197207,true,2727953805,28,2701892048,-26061757
1646405146,197206,true,2728226600,28,2700271480,-27955120
1646405153,197209,true,2727408296,28,2700271480,-27136816
1646405155,197213,true,2726317605,28,2700271480,-26046125
1646405167,197211,true,2726862896,28,2700001480,-26861416
1646405179,197210,true,2727135582,28,2700001480,-27134102
1646405261,197214,true,2726045001,28,2700271480,-25773521
1646405305,197218,true,2724954855,28,2699731506,-25223349
1646405319,197216,true,2725499873,28,2699731506,-25768367
1646405323,197215,true,2725772423,28,2699731506,-26040917
1646405584,197220,true,2724409946,28,2697033259,-27376687
1646405874,197224,true,2723320454,28,2693260243,-30060211
1646405928,197221,true,2724137532,28,2692990944,-31146588
1646405972,197220,true,2724409946,28,2692721672,-31688274
1646406015,197225,true,2723048149,28,2692721672,-30326477
1646406049,197228,true,2722231398,28,2692721672,-29509726
1646406196,197224,true,2723320454,28,2692721672,-30598782
1646406226,197223,true,2723592786,28,2692721672,-30871114
1646406383,197228,true,2722231398,28,2693260243,-28971155
1646406397,197231,true,2721414892,28,2693260243,-28154649
1646406409,197229,true,2721959202,28,2693260243,-28698959
1646406411,197229,true,2721959202,28,2693260243,-28698959
1646406448,197234,true,2720598631,28,2693260243,-27338388
1646406628,197238,true,2719510664,28,2692721672,-26788992
1646406681,197235,true,2720326598,28,2692452426,-27874172
1646406685,197235,true,2720326598,28,2692452426,-27874172
1646406722,197240,true,2718966843,28,2692452426,-26514417
1646407008,197244,true,2717879528,28,2691644852,-26234676
1646407270,197242,true,2718423131,28,2690837520,-27585611
1646407450,197242,true,2718423131,28,2690299433,-28123698
1646407631,197246,true,2717336034,28,2689761454,-27574580
1646408279,197249,true,2716520996,28,2682241032,-34279964
1646409127,197247,true,2717064327,28,2679024434,-38039893
1646409550,197248,true,2716792648,28,2679560265,-37232383
1646409571,197252,true,2715706203,28,2679560265,-36145938
1646409605,197256,true,2714620192,28,2679560265,-35059927
1646409646,197254,true,2715163143,28,2679560265,-35602878
1646409747,197255,true,2714891654,28,2679560265,-35331389
1646409757,197261,true,2713263289,28,2679560265,-33703024
1646409778,197264,true,2712449472,28,2679292336,-33157136
1646409996,197264,true,2712449472,28,2677685323,-34764149
1646409999,197265,true,2712178255,28,2677685323,-34492932
1646410291,197270,true,2710822572,28,2675544139,-35278433
1646410302,197273,true,2710009488,28,2675276611,-34732877
1646410343,197272,true,2710280489,28,2675009110,-35271379
1646410475,197273,true,2710009488,28,2673404666,-36604822
1646410577,197279,true,2708384051,28,2672335572,-36048479
1646410604,197282,true,2707571699,28,2672068365,-35503334
1646410685,197281,true,2707842456,28,2671266905,-36575551
1646410715,197283,true,2707300968,28,2670999805,-36301163
1646411008,197288,true,2705947724,28,2668330273,-37617451
1646411271,197291,true,2705136102,28,2665663410,-39472692
1646411886,197291,true,2705136102,28,2662200472,-42935630
1646411931,197292,true,2704865615,28,2662200472,-42665143
1646412006,197297,true,2703513588,28,2662200472,-41313116
1646412395,197300,true,2702702696,28,2664064572,-38638124
1646412453,197300,true,2702702696,28,2664330978,-38371718
1646413805,197302,true,2702162237,28,2675009110,-27153127
1646413850,197307,true,2700811561,28,2675276611,-25534950
1646413965,197310,true,2700001480,28,2676079274,-23922206
1646413976,197310,true,2700001480,28,2676079274,-23922206
1646414027,197310,true,2700001480,28,2676614517,-23386963
1646414149,197316,true,2698382046,28,2677685323,-20696723
1646415842,197318,true,2697842450,28,2690030430,-7812020
1646415903,197317,true,2698112234,28,2690030430,-8081804
1646416925,197318,true,2697842450,28,2688148162,-9694288
1646417217,197323,true,2696493933,28,2687879374,-8614559
1646418153,197325,true,2695954716,28,2688416977,-7537739
1646419256,197324,true,2696224311,28,2689492505,-6731806
1646419328,197325,true,2695954716,28,2689223583,-6731133
1646419387,197330,true,2694607142,28,2688954687,-5652455
1646420496,197332,true,2694068302,28,2683045785,-11022517
1646420577,197331,true,2694337709,28,2682509256,-11828453
1646420631,197332,true,2694068302,28,2681972834,-12095468
1646420659,197337,true,2692721672,28,2681704664,-11017008
1646420919,197340,true,2691914017,28,2678756558,-13157459
1646420943,197340,true,2691914017,28,2678220887,-13693130
1646420955,197341,true,2691644852,28,2678220887,-13423965
1646420972,197346,true,2690299433,28,2677953092,-12346341
1646421004,197350,true,2689223583,28,2677149866,-12073717
1646421073,197350,true,2689223583,28,2675544139,-13679444
1646421153,197351,true,2688954687,28,2673672007,-15282680
1646421177,197357,true,2687341879,28,2673137352,-14204527
1646421186,197361,true,2686267211,28,2672870065,-13397146
1646421234,197363,true,2685730038,28,2671801185,-13928853
1646421473,197365,true,2685192973,28,2666196569,-18996404
1646421934,197370,true,2683850779,28,2655288086,-28562693
1646423001,197373,true,2683045785,28,2636766896,-46278889
1646423017,197375,true,2682509256,28,2636766896,-45742360
1646423332,197377,true,2681972834,28,2636239621,-45733213
1646423906,197382,true,2680632250,28,2633078189,-47554061
1646424120,197386,true,2679560265,28,2631235771,-48324494
1646424202,197388,true,2679024434,28,2630446559,-48577875
1646424412,197390,true,2678488709,28,2628605982,-49882727
1646424857,197395,true,2677149866,28,2624928692,-52221174
1646424872,197399,true,2676079274,28,2624928692,-51150582
1646424980,197400,true,2675811693,28,2623616622,-52195071
1646425024,197402,true,2675276611,28,2623091977,-52184634
1646425438,197406,true,2674206768,28,2619160485,-55046283
1646425466,197409,true,2673404666,28,2618898595,-54506071
1646426550,197412,true,2672602805,28,2611054064,-61548741
1646426988,197414,true,2672068365,28,2610531932,-61536433
1646427270,197418,true,2670999805,28,2610792985,-60206820
1646427977,197421,true,2670198665,28,2611837459,-58361206
1646429859,197424,true,2669397765,28,2612359853,-57037912
1646429931,197426,true,2668863966,28,2612359853,-56504113
1646430052,197430,true,2667796687,28,2612359853,-55436834
1646430117,197433,true,2666996508,28,2612359853,-54636655
1646430155,197437,true,2665929976,28,2612359853,-53570123
1646430208,197438,true,2665663410,28,2612621088,-53042322
1646430683,197441,true,2664863871,28,2614450472,-50413399
1646430856,197444,true,2664064572,28,2615234886,-48829686
1646430969,197447,true,2663265512,28,2615496409,-47769103
1646431982,197449,true,2662732939,28,2617851298,-44881641
1646432174,197452,true,2661934279,28,2617589539,-44344740
1646432213,197455,true,2661135858,28,2617327806,-43808052
1646432332,197458,true,2660337677,28,2616804419,-43533258
1646432592,197460,true,2659805689,28,2615234886,-44570803
1646432627,197463,true,2659007907,28,2614973388,-44034519
1646432791,197466,true,2658210364,28,2613404953,-44805411
1646432862,197469,true,2657413061,28,2612882351,-44530710
1646432879,197471,true,2656881658,28,2612621088,-44260570
1646432956,197474,true,2656084753,28,2611576301,-44508452
1646433013,197477,true,2655288086,28,2610792985,-44495101
1646433357,197482,true,2653960841,28,2604014079,-49946762
1646433412,197485,true,2653164812,28,2603233031,-49931781
1646433683,197488,true,2652369021,28,2599071396,-53297625
1646433768,197493,true,2651043235,28,2597772250,-53270985
1646433889,197498,true,2649718110,28,2596473754,-53244356
1646434235,197500,true,2649188246,28,2593619345,-55568901
1646434327,197502,true,2648658488,28,2593100699,-55557789
1646434363,197507,true,2647334556,28,2592841415,-54493141
1646434462,197512,true,2646011286,28,2592841415,-53169871
1646435826,197512,true,2646011286,28,2607662069,-38349217
1646436397,197514,true,2645482163,28,2611054064,-34428099
1646436807,197518,true,2644424235,28,2611576301,-32847934
1646436853,197523,true,2643102419,28,2611576301,-31526118
1646437317,197523,true,2643102419,28,2612621088,-30481331
1646437410,197525,true,2642573878,28,2612882351,-29691527
1646437460,197529,true,2641517112,28,2612882351,-28634761
1646440405,197532,true,2640724816,28,2617066099,-23658717
1646440424,197532,true,2640724816,28,2617066099,-23658717
1646441043,197534,true,2640196750,28,2614450472,-25746278
1646441057,197537,true,2639404849,28,2614450472,-24954377
1646441959,197542,true,2638085543,28,2608966161,-29119382
1646442121,197542,true,2638085543,28,2607662069,-30423474
1646442173,197544,true,2637558005,28,2607401329,-30156676
1646442249,197547,true,2636766896,28,2606879927,-29886969
1646442330,197552,true,2635448908,28,2606358629,-29090279
1646442344,197552,true,2635448908,28,2606358629,-29090279
1646442681,197553,true,2635185389,28,2605576878,-29608511
1646442839,197557,true,2634131578,28,2605055841,-29075737
1646442865,197561,true,2633078189,28,2605055841,-28022348
1646442898,197560,true,2633341497,28,2605316346,-28025151
1646442962,197561,true,2633078189,28,2605316346,-27761843
1646443244,197564,true,2632288424,28,2605837435,-26450989
1646443640,197568,true,2631235771,28,2606619265,-24616506
1646443731,197568,true,2631235771,28,2606879927,-24355844
1646444259,197568,true,2631235771,28,2608705290,-22530481
1646444550,197571,true,2630446559,28,2609227057,-21219502
1646446249,197575,true,2629394643,28,2609227057,-20167586
1646446310,197575,true,2629394643,28,2609487980,-19906663
1646446523,197576,true,2629131730,28,2609748929,-19382801
1646446542,197578,true,2628605982,28,2609748929,-18857053
1646446558,197582,true,2627554803,28,2609748929,-17805874
1646447772,197581,true,2627817558,28,2612882351,-14935207
1646449158,197582,true,2627554803,28,2610009904,-17544899
1646449426,197586,true,2626504043,28,2609227057,-17276986
1646449599,197590,true,2625453704,28,2608966161,-16487543
1646449618,197590,true,2625453704,28,2608966161,-16487543
1646450729,197591,true,2625191185,28,2610531932,-14659253
1646450741,197595,true,2624141371,28,2610531932,-13609439
1646450773,197599,true,2623091977,28,2610531932,-12560045
1646450789,197600,true,2622829694,28,2610792985,-12036709
1646450912,197600,true,2622829694,28,2611315170,-11514524
1646450953,197604,true,2621780825,28,2611576301,-10204524
1646451205,197609,true,2620470327,28,2612882351,-7587976
1646451254,197609,true,2620470327,28,2613143639,-7326688
1646451274,197610,true,2620208306,28,2613143639,-7064667
1646451792,197613,true,2619422401,28,2616542765,-2879636
1646451867,197617,true,2618374894,28,2617066099,-1308795
1646454091,197618,true,2618113083,28,2624666226,6553143
1646454878,197619,true,2617851298,28,2624666226,6814928
1646454952,197621,true,2617327806,28,2624666226,7338420
1646455156,197625,true,2616281136,28,2624141371,7860235
1646455323,197626,true,2616019535,28,2623354286,7334751
1646455504,197627,true,2615757959,28,2623091977,7334018
1646456112,197628,true,2615496409,28,2621518673,6022264
1646456422,197632,true,2614450472,28,2620732374,6281902
1646456441,197632,true,2614450472,28,2620732374,6281902
1646456826,197633,true,2614189053,28,2620208306,6019253
1646459628,197634,true,2613927660,28,2620208306,6280646
1646460766,197635,true,2613666294,28,2620208306,6542012
1646460898,197635,true,2613666294,28,2620470327,6804033
1646461580,197636,true,2613404953,28,2622043003,8638050
1646462510,197636,true,2613404953,28,2624666226,11261273
1646463037,197638,true,2612882351,28,2624928692,12046341
1646463741,197637,true,2613143639,28,2624928692,11785053
1646464546,197638,true,2612882351,28,2624928692,12046341
1646464700,197638,true,2612882351,28,2624928692,12046341
1646464723,197639,true,2612621088,28,2624928692,12307604
1646464829,197639,true,2612621088,28,2624928692,12307604
1646465144,197638,true,2612882351,28,2625978821,13096470
1646465268,197638,true,2612882351,28,2626504043,13621692
1646465280,197639,true,2612621088,28,2626504043,13882955
1646465339,197638,true,2612882351,28,2626766694,13884343
1646466201,197637,true,2613143639,28,2630446559,17302920
1646466357,197636,true,2613404953,28,2630972674,17567721
1646466453,197637,true,2613143639,28,2631762045,18618406
1646466589,197636,true,2613404953,28,2632288424,18883471
1646467342,197634,true,2613927660,28,2634394992,20467332
1646469771,197633,true,2614189053,28,2635976024,21786971
1646469780,197634,true,2613927660,28,2636239621,22311961
1646469792,197632,true,2614450472,28,2636239621,21789149
1646469807,197630,true,2614973388,28,2636239621,21266233
1646469882,197629,true,2615234886,28,2636503245,21268359
1646469946,197629,true,2615234886,28,2637030572,21795686
1646470066,197628,true,2615496409,28,2637821761,22325352
1646470571,197625,true,2616281136,28,2640988888,24707752
1646471950,197624,true,2616542765,28,2648128836,31586071
1646472365,197624,true,2616542765,28,2648128836,31586071
1646474078,197623,true,2616804419,28,2649983082,33178663
1646474827,197621,true,2617327806,28,2649983082,32655276
1646474830,197620,true,2617589539,28,2649983082,32393543
1646474857,197620,true,2617589539,28,2649983082,32393543
1646474901,197619,true,2617851298,28,2649983082,32131784
1646474918,197617,true,2618374894,28,2649983082,31608188
1646475133,197616,true,2618636732,28,2649188246,30551514
1646475150,197616,true,2618636732,28,2649188246,30551514
1646475223,197614,true,2619160485,28,2648923354,29762869
1646476101,197612,true,2619684343,28,2647069849,27385506
1646476214,197611,true,2619946312,28,2646805169,26858857
1646476326,197611,true,2619946312,28,2646275887,26329575
1646478493,197609,true,2620470327,28,2642045442,21575115
1646478545,197606,true,2621256547,28,2642309647,21053100
1646478622,197604,true,2621780825,28,2642309647,20528822
1646478735,197603,true,2622043003,28,2642309647,20266644
1646479137,197600,true,2622829694,28,2643102419,20272725
1646479207,197598,true,2623354286,28,2643102419,19748133
1646479225,197596,true,2623878983,28,2643102419,19223436
1646479231,197596,true,2623878983,28,2643102419,19223436
1646479484,197593,true,2624666226,28,2643895429,19229203
1646481516,197591,true,2625191185,28,2648393649,23202464
1646481959,197589,true,2625716250,28,2648393649,22677399
1646481989,197589,true,2625716250,28,2648658488,22942238
1646482035,197588,true,2625978821,28,2648658488,22679667
1646483495,197585,true,2626766694,28,2657147346,30380652
1646483610,197583,true,2627292073,28,2657678802,30386729
1646483825,197582,true,2627554803,28,2659007907,31453104
1646483883,197582,true,2627554803,28,2659007907,31453104
1646483947,197579,true,2628343148,28,2659007907,30664759
1646484013,197577,true,2628868843,28,2659007907,30139064
1646484022,197577,true,2628868843,28,2659007907,30139064
1646485172,197575,true,2629394643,28,2661668112,32273469
1646485187,197573,true,2629920548,28,2661668112,31747564
1646485319,197570,true,2630709603,28,2661934279,31224676
1646485344,197569,true,2630972674,28,2661934279,30961605
1646485372,197568,true,2631235771,28,2661934279,30698508
1646485444,197565,true,2632025221,28,2661934279,29909058
1646486149,197564,true,2632288424,28,2658210364,25921940
1646487298,197563,true,2632551652,28,2650778157,18226505
1646487340,197561,true,2633078189,28,2650778157,17699968
1646487357,197559,true,2633604831,28,2650778157,17173326
1646487366,197558,true,2633868192,28,2650778157,16909965
1646488183,197558,true,2633868192,28,2646275887,12407695
1646488964,197556,true,2634394992,28,2641781264,7386272
1646489148,197554,true,2634921897,28,2640988888,6066991
1646489265,197553,true,2635185389,28,2640988888,5803499
1646489596,197553,true,2635185389,28,2640196750,5011361
1646489866,197552,true,2635448908,28,2639668790,4219882
1646489890,197550,true,2635976024,28,2639668790,3692766
1646489950,197549,true,2636239621,28,2639404849,3165228
1646489987,197550,true,2635976024,28,2639404849,3428825
1646490035,197548,true,2636503245,28,2639668790,3165545
1646490063,197546,true,2637030572,28,2639668790,2638218
1646490224,197545,true,2637294275,28,2639932757,2638482
1646490991,197545,true,2637294275,28,2642045442,4751167
1646495103,197544,true,2637558005,28,2645482163,7924158
1646495245,197541,true,2638349351,28,2645482163,7132812
1646495368,197540,true,2638613186,28,2645482163,6868977
1646497680,197540,true,2638613186,28,2645217641,6604455
1646498225,197539,true,2638877048,28,2645217641,6340593
1646498231,197537,true,2639404849,28,2645482163,6077314
1646498438,197535,true,2639932757,28,2645746711,5813954
1646498455,197536,true,2639668790,28,2645746711,6077921
1646498545,197534,true,2640196750,28,2646011286,5814536
1646498653,197532,true,2640724816,28,2646805169,6080353
1646498675,197530,true,2641252987,28,2647069849,5816862
1646498766,197530,true,2641252987,28,2648128836,6875849
1646498788,197528,true,2641781264,28,2648393649,6612385
1646498820,197525,true,2642573878,28,2648923354,6349476
1646498850,197524,true,2642838135,28,2649453165,6615030
1646499031,197523,true,2643102419,28,2652369021,9266602
1646499061,197521,true,2643631066,28,2652899522,9268456
1646499082,197518,true,2644424235,28,2653430128,9005893
1646499145,197517,true,2644688677,28,2654226237,9537560
1646499356,197516,true,2644953146,28,2657413061,12459915
1646499411,197514,true,2645482163,28,2658210364,12728201
1646499474,197511,true,2646275887,28,2659007907,12732020
1646499477,197510,true,2646540515,28,2659007907,12467392
1646499482,197510,true,2646540515,28,2659007907,12467392
1646499487,197508,true,2647069849,28,2659273808,12203959
1646499493,197505,true,2647864049,28,2659273808,11409759
1646499625,197504,true,2648128836,28,2660603711,12474875
1646500564,197504,true,2648128836,28,2666729835,18600999
1646501174,197502,true,2648658488,28,2663265512,14607024
1646504809,197499,true,2649453165,28,2667529934,18076769
1646504875,197498,true,2649718110,28,2667529934,17811824
1646505138,197498,true,2649718110,28,2667263208,17545098
1646505278,197496,true,2650248081,28,2667263208,17015127
1646505408,197493,true,2651043235,28,2666996508,15953273
1646507850,197493,true,2651043235,28,2665396870,14353635
1646508380,197493,true,2651043235,28,2665929976,14886741
1646508436,197491,true,2651573470,28,2665929976,14356506
1646509393,197488,true,2652369021,28,2666729835,14360814
1646511004,197488,true,2652369021,28,2666996508,14627487
1646511104,197488,true,2652369021,28,2667263208,14894187
1646511397,197486,true,2652899522,28,2667796687,14897165
1646511423,197484,true,2653430128,28,2667796687,14366559
1646511481,197483,true,2653695471,28,2668063467,14367996
1646511967,197482,true,2653960841,28,2669664705,15703864
1646512950,197480,true,2654491659,28,2672870065,18378406
1646512976,197479,true,2654757108,28,2673137352,18380244
1646513245,197478,true,2655022584,28,2673939374,18916790
1646513936,197477,true,2655288086,28,2675276611,19988525
1646514046,197475,true,2655819171,28,2675544139,19724968
1646514071,197473,true,2656350361,28,2675544139,19193778
1646514264,197473,true,2656350361,28,2675811693,19461332
1646515022,197473,true,2656350361,28,2674206768,17856407
1646515034,197472,true,2656615996,28,2674206768,17590772
1646517116,197470,true,2657147346,28,2670732731,13585385
1646517129,197470,true,2657147346,28,2670732731,13585385
1646517157,197470,true,2657147346,28,2670732731,13585385
1646517187,197469,true,2657413061,28,2670732731,13319670
1646517223,197467,true,2657944570,28,2670732731,12788161
1646517432,197467,true,2657944570,28,2670465685,12521115
1646517492,197468,true,2657678802,28,2670198665,12519863
1646517500,197466,true,2658210364,28,2670198665,11988301
1646517576,197464,true,2658742033,28,2669931672,11189639
1646517898,197465,true,2658476185,28,2668330273,9854088
1646520666,197466,true,2658210364,28,2660337677,2127313
1646520710,197464,true,2658742033,28,2660603711,1861678
1646521639,197462,true,2659273808,28,2661934279,2660471
1646522097,197463,true,2659007907,28,2662732939,3725032
1646525808,197463,true,2659007907,28,2663265512,4257605
1646526120,197461,true,2659539735,28,2663265512,3725777
1646527496,197459,true,2660071670,28,2664863871,4792201
1646527564,197460,true,2659805689,28,2664863871,5058182
1646527737,197460,true,2659805689,28,2665130357,5324668
1646528387,197458,true,2660337677,28,2665396870,5059193
1646528692,197457,true,2660603711,28,2665929976,5326265
1646529736,197457,true,2660603711,28,2667263208,6659497
1646532119,197457,true,2660603711,28,2667796687,7192976
1646532140,197456,true,2660869771,28,2667796687,6926916
1646532159,197454,true,2661401972,28,2667796687,6394715
1646532163,197454,true,2661401972,28,2667796687,6394715
1646532300,197455,true,2661135858,28,2667529934,6394076
1646532388,197454,true,2661401972,28,2667263208,5861236
1646535607,197453,true,2661668112,28,2662999212,1331100
1646536632,197454,true,2661401972,28,2662999212,1597240
1646537697,197455,true,2661135858,28,2662999212,1863354
1646537737,197453,true,2661668112,28,2662999212,1331100
1646537998,197453,true,2661668112,28,2661934279,266167
1646538003,197453,true,2661668112,28,2661668112,0
1646538019,197455,true,2661135858,28,2661668112,532254
1646538716,197455,true,2661135858,28,2656350361,-4785497
1646538985,197454,true,2661401972,28,2654226237,-7175735
1646539152,197455,true,2661135858,28,2652899522,-8236336
1646539363,197457,true,2660603711,28,2650778157,-9825554
1646539413,197457,true,2660603711,28,2649983082,-10620629
1646541471,197458,true,2660337677,28,2628868843,-31468834
1646541545,197458,true,2660337677,28,2629131730,-31205947
1646541568,197460,true,2659805689,28,2629131730,-30673959
1646541595,197460,true,2659805689,28,2629394643,-30411046
1646541600,197461,true,2659539735,28,2629394643,-30145092
1646541627,197460,true,2659805689,28,2629394643,-30411046
1646541671,197460,true,2659805689,28,2629920548,-29885141
1646542647,197459,true,2660071670,28,2641252987,-18818683
1646543487,197459,true,2660071670,28,2649983082,-10088588
1646545284,197459,true,2660071670,28,2649983082,-10088588
1646545762,197459,true,2660071670,28,2649983082,-10088588
1646546935,197457,true,2660603711,28,2649983082,-10620629
1646546984,197458,true,2660337677,28,2649983082,-10354595
1646547810,197457,true,2660603711,28,2649983082,-10620629
1646549353,197457,true,2660603711,28,2651838627,-8765084
1646550439,197456,true,2660869771,28,2652103811,-8765960
1646550773,197456,true,2660869771,28,2651838627,-9031144
1646550872,197456,true,2660869771,28,2651573470,-9296301
1646551017,197456,true,2660869771,28,2651043235,-9826536
1646551069,197455,true,2661135858,28,2650778157,-10357701
1646551378,197456,true,2660869771,28,2649453165,-11416606
1646555996,197456,true,2660869771,28,2643895429,-16974342
1646556000,197456,true,2660869771,28,2643895429,-16974342
1646557309,197455,true,2661135858,28,2643366729,-17769129
1646557412,197457,true,2660603711,28,2643366729,-17236982
1646557445,197457,true,2660603711,28,2643366729,-17236982
1646557479,197457,true,2660603711,28,2643102419,-17501292
1646558276,197457,true,2660603711,28,2640988888,-19614823
1646558360,197458,true,2660337677,28,2640460770,-19876907
1646558364,197459,true,2660071670,28,2640460770,-19610900
1646558399,197460,true,2659805689,28,2640460770,-19344919
1646558470,197461,true,2659539735,28,2639932757,-19606978
1646558669,197463,true,2659007907,28,2638349351,-20658556
1646558764,197464,true,2658742033,28,2637558005,-21184028
1646560249,197466,true,2658210364,28,2627292073,-30918291
1646560285,197467,true,2657944570,28,2627292073,-30652497
1646560693,197470,true,2657147346,28,2625716250,-31431096
1646560710,197471,true,2656881658,28,2625716250,-31165408
1646560736,197473,true,2656350361,28,2625716250,-30634111
1646560830,197474,true,2656084753,28,2625191185,-30893568
1646560881,197477,true,2655288086,28,2624666226,-30621860
1646560892,197478,true,2655022584,28,2624666226,-30356358
1646560933,197480,true,2654491659,28,2624141371,-30350288
1646560967,197482,true,2653960841,28,2623616622,-30344219
1646561100,197486,true,2652899522,28,2622043003,-30856519
1646561422,197487,true,2652634258,28,2617327806,-35306452
1646561782,197489,true,2652103811,28,2611054064,-41049747
1646562035,197491,true,2651573470,28,2606879927,-44693543
1646562432,197495,true,2650513105,28,2601151381,-49361724
1646562963,197496,true,2650248081,28,2597772250,-52475831
1646563276,197498,true,2649718110,28,2597252774,-52465336
1646563357,197500,true,2649188246,28,2597512499,-51675747
1646563393,197504,true,2648128836,28,2597512499,-50616337
1646563535,197505,true,2647864049,28,2598032027,-49832022
1646563543,197507,true,2647334556,28,2598032027,-49302529
1646563954,197508,true,2647069849,28,2600371192,-46698657
1646564528,197513,true,2645746711,28,2602972733,-42773978
1646564589,197513,true,2645746711,28,2602972733,-42773978
1646564613,197515,true,2645217641,28,2603233031,-41984610
1646564633,197517,true,2644688677,28,2603233031,-41455646
1646564680,197521,true,2643631066,28,2603233031,-40398035
1646564693,197522,true,2643366729,28,2603233031,-40133698
1646566121,197525,true,2642573878,28,2601931804,-40642074
1646566476,197527,true,2642045442,28,2601151381,-40894061
1646567660,197531,true,2640988888,28,2600371192,-40617696
1646568023,197532,true,2640724816,28,2600371192,-40353624
1646568036,197535,true,2639932757,28,2600371192,-39561565
1646568111,197537,true,2639404849,28,2600631229,-38773620
1646568165,197541,true,2638349351,28,2600631229,-37718122
1646568172,197542,true,2638085543,28,2600631229,-37454314
1646568198,197544,true,2637558005,28,2600891292,-36666713
1646568228,197546,true,2637030572,28,2600891292,-36139280
1646568374,197550,true,2635976024,28,2601671637,-34304387
1646569412,197550,true,2635976024,28,2606879927,-29096097
1646569955,197553,true,2635185389,28,2609227057,-25958332
1646569983,197554,true,2634921897,28,2609227057,-25694840
1646569990,197558,true,2633868192,28,2609227057,-24641135
1646570346,197558,true,2633868192,28,2610009904,-23858288
1646570677,197560,true,2633341497,28,2610792985,-22548512
1646570683,197561,true,2633078189,28,2611054064,-22024125
1646570909,197565,true,2632025221,28,2611315170,-20710051
1646571142,197565,true,2632025221,28,2611837459,-20187762
1646571226,197566,true,2631762045,28,2612098643,-19663402
1646571726,197568,true,2631235771,28,2613404953,-17830818
1646571755,197572,true,2630183540,28,2613404953,-16778587
1646571818,197571,true,2630446559,28,2613666294,-16780265
1646572045,197573,true,2629920548,28,2614189053,-15731495
1646572428,197574,true,2629657582,28,2614973388,-14684194
1646572443,197578,true,2628605982,28,2614973388,-13632594
1646572460,197577,true,2628868843,28,2615234886,-13633957
1646572618,197579,true,2628343148,28,2616281136,-12062012
1646572634,197579,true,2628343148,28,2616281136,-12062012
1646572651,197583,true,2627292073,28,2616542765,-10749308
1646572672,197583,true,2627292073,28,2616804419,-10487654
1646572710,197584,true,2627029371,28,2617327806,-9701565
1646572740,197584,true,2627029371,28,2617589539,-9439832
1646575234,197587,true,2626241419,28,2639932757,13691338
1646575278,197587,true,2626241419,28,2639932757,13691338
1646575631,197587,true,2626241419,28,2639932757,13691338
1646575633,197587,true,2626241419,28,2639932757,13691338
1646575732,197590,true,2625453704,28,2639932757,14479053
1646575857,197590,true,2625453704,28,2639668790,14215086
1646576289,197590,true,2625453704,28,2638877048,13423344
1646576350,197591,true,2625191185,28,2638613186,13422001
1646576653,197594,true,2624403785,28,2637821761,13417976
1646576679,197593,true,2624666226,28,2637821761,13155535
1646576776,197593,true,2624666226,28,2637294275,12628049
1646576969,197593,true,2624666226,28,2636503245,11837019
1646577564,197596,true,2623878983,28,2633868192,9989209
1646577568,197596,true,2623878983,28,2633868192,9989209
1646577788,197596,true,2623878983,28,2632288424,8409441
1646577991,197595,true,2624141371,28,2630972674,6831303
1646578111,197597,true,2623616622,28,2630183540,6566918
1646578283,197597,true,2623616622,28,2629131730,5515108
1646578477,197596,true,2623878983,28,2628343148,4464165
1646579390,197596,true,2623878983,28,2626241419,2362436
1646579442,197598,true,2623354286,28,2626241419,2887133
1646579628,197598,true,2623354286,28,2626504043,3149757
1646579725,197598,true,2623354286,28,2626766694,3412408
1646579943,197599,true,2623091977,28,2626766694,3674717
1646581220,197602,true,2622305207,28,2623091977,786770
1646581418,197602,true,2622305207,28,2622567437,262230
1646582229,197602,true,2622305207,28,2621518673,-786534
1646582557,197603,true,2622043003,28,2621780825,-262178
1646582636,197606,true,2621256547,28,2621780825,524278
1646582809,197605,true,2621518673,28,2622829694,1311021
1646583111,197605,true,2621518673,28,2624403785,2885112
1646583298,197605,true,2621518673,28,2625978821,4460148
1646583312,197608,true,2620732374,28,2625978821,5246447
1646583342,197608,true,2620732374,28,2626241419,5509045
1646583364,197607,true,2620994448,28,2626504043,5509595
1646583370,197607,true,2620994448,28,2626504043,5509595
1646583382,197609,true,2620470327,28,2626766694,6296367
1646583455,197608,true,2620732374,28,2627817558,7085184
1646584906,197607,true,2620994448,28,2646011286,25016838
1646584956,197606,true,2621256547,28,2646275887,25019340
1646585084,197608,true,2620732374,28,2647069849,26337475
1646586241,197607,true,2620994448,28,2647069849,26075401
1646586268,197606,true,2621256547,28,2647069849,25813302
1646586287,197605,true,2621518673,28,2647069849,25551176
1646586297,197607,true,2620994448,28,2647069849,26075401
1646586317,197606,true,2621256547,28,2647069849,25813302
1646586467,197606,true,2621256547,28,2646540515,25283968
1646586507,197604,true,2621780825,28,2646540515,24759690
1646586519,197606,true,2621256547,28,2646275887,25019340
1646586760,197605,true,2621518673,28,2645482163,23963490
1646586782,197604,true,2621780825,28,2645482163,23701338
1646587487,197602,true,2622305207,28,2642573878,20268671
1646587965,197604,true,2621780825,28,2640724816,18943991
1646588417,197603,true,2622043003,28,2639668790,17625787
1646588895,197601,true,2622567437,28,2639140935,16573498
1646588925,197600,true,2622829694,28,2639140935,16311241
1646589084,197601,true,2622567437,28,2638877048,16309611
1646592017,197600,true,2622829694,28,2636239621,13409927
1646592380,197598,true,2623354286,28,2635712453,12358167
1646592391,197596,true,2623878983,28,2635712453,11833470
1646592675,197597,true,2623616622,28,2634394992,10778370
1646592694,197596,true,2623878983,28,2634131578,10252595
1646593482,197595,true,2624141371,28,2630183540,6042169
1646595778,197592,true,2624928692,28,2626504043,1575351
1646595878,197593,true,2624666226,28,2626504043,1837817
1646596034,197592,true,2624928692,28,2625978821,1050129
1646596300,197591,true,2625191185,28,2623878983,-1312202
1646598892,197590,true,2625453704,28,2612621088,-12832616
1646598902,197591,true,2625191185,28,2612882351,-12308834
1646600129,197590,true,2625453704,28,2613927660,-11526044
1646600707,197589,true,2625716250,28,2614450472,-11265778
1646600764,197589,true,2625716250,28,2614450472,-11265778
1646600822,197589,true,2625716250,28,2614711917,-11004333
1646600849,197589,true,2625716250,28,2614711917,-11004333
1646600851,197587,true,2626241419,28,2614711917,-11529502
1646601038,197586,true,2626504043,28,2616281136,-10222907
1646601578,197586,true,2626504043,28,2621256547,-5247496
1646601616,197585,true,2626766694,28,2621780825,-4985869
1646601626,197583,true,2627292073,28,2621780825,-5511248
1646601647,197582,true,2627554803,28,2622043003,-5511800
1646601667,197582,true,2627554803,28,2622043003,-5511800
1646601735,197582,true,2627554803,28,2622305207,-5249596
1646602606,197580,true,2628080340,28,2626766694,-1313646
1646602620,197579,true,2628343148,28,2626766694,-1576454
1646602630,197579,true,2628343148,28,2626766694,-1576454
1646604171,197579,true,2628343148,28,2627029371,-1313777
1646604432,197577,true,2628868843,28,2627817558,-1051285
1646605575,197576,true,2629131730,28,2631498895,2367165
1646605593,197576,true,2629131730,28,2631762045,2630315
1646606019,197576,true,2629131730,28,2633868192,4736462
1646606841,197574,true,2629657582,28,2635976024,6318442
1646607523,197572,true,2630183540,28,2636766896,6583356
1646607733,197572,true,2630183540,28,2636766896,6583356
1646607768,197572,true,2630183540,28,2636766896,6583356
1646607787,197571,true,2630446559,28,2636766896,6320337
1646607807,197569,true,2630972674,28,2636503245,5530571
1646607821,197570,true,2630709603,28,2636503245,5793642
1646607874,197570,true,2630709603,28,2636239621,5530018
1646607897,197569,true,2630972674,28,2635976024,5003350
1646608137,197568,true,2631235771,28,2633078189,1842418
1646608273,197570,true,2630709603,28,2631498895,789292
1646608323,197570,true,2630709603,28,2630709603,0
1646608354,197569,true,2630972674,28,2630183540,-789134
1646608368,197569,true,2630972674,28,2630183540,-789134
1646608373,197570,true,2630709603,28,2629920548,-789055
1646608380,197571,true,2630446559,28,2629920548,-526011
1646608386,197570,true,2630709603,28,2629920548,-789055
1646608406,197571,true,2630446559,28,2629394643,-1051916
1646608412,197573,true,2629920548,28,2629394643,-525905
1646608442,197574,true,2629657582,28,2628605982,-1051600
1646608594,197575,true,2629394643,28,2625453704,-3940939
1646608635,197577,true,2628868843,28,2624403785,-4465058
1646608735,197580,true,2628080340,28,2621256547,-6823793
1646608752,197581,true,2627817558,28,2620732374,-7085184
1646608842,197583,true,2627292073,28,2617851298,-9440775
1646608848,197585,true,2626766694,28,2617589539,-9177155
1646608935,197588,true,2625978821,28,2614711917,-11266904
1646608961,197589,true,2625716250,28,2613927660,-11788590
1646609017,197592,true,2624928692,28,2611315170,-13613522
1646609341,197595,true,2624141371,28,2597252774,-26888597
1646609407,197599,true,2623091977,28,2593619345,-29472632
1646609501,197601,true,2622567437,28,2588955263,-33612174
1646609520,197603,true,2622043003,28,2587919939,-34123064
1646609536,197607,true,2620994448,28,2587143719,-33850729
1646609538,197611,true,2619946312,28,2587143719,-32802593
1646609542,197612,true,2619684343,28,2586885030,-32799313
1646610385,197613,true,2619422401,28,2560890286,-58532115
1646610428,197617,true,2618374894,28,2560122172,-58252722
1646611144,197620,true,2617589539,28,2555518327,-62071212
1646611375,197622,true,2617066099,28,2556796342,-60269757
1646611465,197623,true,2616804419,28,2556285059,-60519360
1646611664,197627,true,2615757959,28,2555007300,-60750659
1646611677,197630,true,2614973388,28,2555007300,-59966088
1646611710,197633,true,2614189053,28,2554496375,-59692678
1646611798,197634,true,2613927660,28,2553730180,-60197480
1646611824,197639,true,2612621088,28,2553219510,-59401578
1646612137,197642,true,2611837459,28,2549902647,-61934812
1646612364,197645,true,2611054064,28,2547354146,-63699918
1646612480,197646,true,2610792985,28,2546080851,-64712134
1646612548,197651,true,2609487980,28,2545062673,-64425307
1646612580,197654,true,2608705290,28,2544553737,-64151553
1646612585,197657,true,2607922835,28,2544553737,-63369098
1646612635,197660,true,2607140615,28,2543536170,-63604445
1646612686,197666,true,2605576878,28,2542773262,-62803616
1646613033,197668,true,2605055841,28,2537946821,-67109020
1646613338,197671,true,2604274480,28,2535156753,-69117727
1646613477,197674,true,2603493354,28,2534396358,-69096996
1646613528,197680,true,2601931804,28,2534142944,-67788860
1646613555,197683,true,2601151381,28,2534142944,-67008437
1646613561,197686,true,2600371192,28,2534142944,-66228248
1646613657,197690,true,2599331303,28,2534142944,-65188359
1646613794,197696,true,2597772250,28,2534142944,-63629306
1646614313,197698,true,2597252774,28,2534142944,-63109830
1646614753,197702,true,2596214132,28,2535663810,-60550322
1646615010,197705,true,2595435424,28,2536424585,-59010839
1646615791,197711,true,2593878707,28,2537946821,-55931886
1646615827,197713,true,2593360009,28,2537946821,-55413188
1646615938,197716,true,2592582157,28,2538454435,-54127722
1646616269,197719,true,2591804538,28,2539216048,-52588490
1646616738,197725,true,2590249999,28,2540485910,-49764089
1646617098,197727,true,2589732027,28,2542773262,-46958765
1646617238,197729,true,2589214158,28,2543536170,-45677988
1646617345,197732,true,2588437549,28,2544044903,-44392646
1646618190,197737,true,2587143719,28,2548373241,-38770478
1646619755,197739,true,2586626368,28,2550157637,-36468731
1646619815,197742,true,2585850535,28,2550157637,-35692898
1646619886,197745,true,2585074935,28,2549902647,-35172288
1646619888,197749,true,2584041163,28,2549902647,-34138516
1646619956,197752,true,2583266106,28,2549647682,-33618424
1646619980,197755,true,2582491281,28,2549392743,-33098538
1646620160,197758,true,2581716689,28,2548118429,-33598260
1646620264,197763,true,2580426217,28,2547354146,-33072071
1646620846,197766,true,2579652244,28,2542519010,-37133234
1646621287,197768,true,2579136391,28,2539216048,-39920343
1646621401,197771,true,2578362805,28,2537693051,-40669754
1646621437,197776,true,2577074010,28,2537439307,-39634703
1646621468,197779,true,2576301043,28,2536931896,-39369147
1646621493,197782,true,2575528307,28,2536424585,-39103722
1646621518,197785,true,2574755803,28,2536170968,-38584835
1646621701,197789,true,2573726158,28,2533129540,-40596618
1646621715,197792,true,2572954195,28,2532876253,-40077942
1646621756,197795,true,2572182463,28,2532369753,-39812710
1646621833,197798,true,2571410962,28,2531357059,-40053903
1646621953,197803,true,2570125642,28,2529838776,-40286866
1646622014,197806,true,2569354759,28,2529079976,-40274783
1646622224,197809,true,2568584107,28,2526804942,-41779165
1646622262,197812,true,2567813685,28,2526299657,-41514028
1646622616,197818,true,2566273536,28,2522008810,-44264726
1646623662,197822,true,2565247284,28,2514203078,-51044206
1646623735,197825,true,2564477863,28,2514203078,-50274785
1646623785,197829,true,2563452328,28,2514203078,-49249250
1646624129,197834,true,2562170987,28,2514705944,-47465043
1646624143,197837,true,2561402489,28,2514705944,-46696545
1646624165,197840,true,2560634222,28,2514957414,-45676808
1646624245,197843,true,2559866185,28,2515208910,-44657275
1646624299,197849,true,2558330803,28,2515208910,-43121893
1646625962,197851,true,2557819214,28,2522261011,-35558203
1646627282,197854,true,2557052021,28,2522261011,-34791010
1646627647,197858,true,2556029456,28,2522261011,-33768445
1646627795,197864,true,2554496375,28,2522513237,-31983138
1646629146,197866,true,2553985553,28,2524784407,-29201146
1646629678,197869,true,2553219510,28,2525289389,-27930121
1646630275,197873,true,2552198478,28,2525289389,-26909089
1646630290,197879,true,2550667694,28,2525289389,-25378305
1646630301,197882,true,2549902647,28,2525289389,-24613258
1646630443,197885,true,2549137829,28,2525541918,-23595911
1646630511,197888,true,2548373241,28,2525794472,-22578769
1646630590,197893,true,2547099436,28,2526299657,-20799779
1646632514,197895,true,2546590093,28,2534396358,-12193735
1646633109,197898,true,2545826269,28,2533636192,-12190077
1646633165,197901,true,2545062673,28,2533636192,-11426481
1646634286,197905,true,2544044903,28,2531863355,-12181548
1646634911,197907,true,2543536170,28,2531863355,-11672815
1646636416,197909,true,2543027539,28,2531863355,-11164184
1646636418,197912,true,2542264783,28,2532116542,-10148241
1646636805,197916,true,2541248132,28,2532369753,-8878379
1646636858,197918,true,2540739958,28,2532369753,-8370205
1646638123,197920,true,2540231887,28,2533889555,-6342332
1646638330,197923,true,2539469969,28,2533889555,-5580414
1646638438,197927,true,2538454435,28,2533889555,-4564880
1646638465,197928,true,2538200615,28,2533889555,-4311060
1646638475,197930,true,2537693051,28,2533636192,-4056859
1646639445,197932,true,2537185589,28,2530850863,-6334726
1646639483,197936,true,2536170968,28,2530597803,-5573165
1646639694,197937,true,2535917376,28,2529332884,-6584492
1646640256,197939,true,2535410269,28,2526299657,-9110612
1646641124,197941,true,2534903263,28,2523017765,-11885498
1646641145,197944,true,2534142944,28,2522765488,-11377456
1646641172,197945,true,2533889555,28,2522765488,-11124067
1646641946,197947,true,2533382853,28,2518984366,-14398487
1646642043,197949,true,2532876253,28,2517977024,-14899229
1646642085,197951,true,2532369753,28,2517725251,-14644502
1646642293,197951,true,2532369753,28,2516718413,-15651340
1646642799,197953,true,2531863355,28,2514957414,-16905941
1646642813,197954,true,2531610194,28,2514957414,-16652780
1646642884,197955,true,2531357059,28,2514957414,-16399645
1646642929,197955,true,2531357059,28,2514705944,-16651115
1646642940,197957,true,2530850863,28,2514705944,-16144919
1646643021,197959,true,2530344769,28,2515208910,-15135859
1646643479,197960,true,2530091760,28,2517221782,-12869978
1646643501,197960,true,2530091760,28,2517221782,-12869978
1646643538,197961,true,2529838776,28,2517473504,-12365272
1646643542,197964,true,2529079976,28,2517473504,-11606472
1646643647,197964,true,2529079976,28,2518228821,-10851155
1646643666,197963,true,2529332884,28,2518480644,-10852240
1646643955,197963,true,2529332884,28,2521756634,-7576250
1646646470,197964,true,2529079976,28,2539977889,10897913
1646646703,197964,true,2529079976,28,2539977889,10897913
1646646774,197963,true,2529332884,28,2539977889,10645005
1646646837,197963,true,2529332884,28,2539977889,10645005
1646646924,197964,true,2529079976,28,2539723916,10643940
1646647008,197964,true,2529079976,28,2539469969,10389993
1646647073,197963,true,2529332884,28,2539216048,9883164
1646647365,197963,true,2529332884,28,2538708281,9375397
1646647608,197963,true,2529332884,28,2537946821,8613937
1646648317,197962,true,2529585817,28,2535156753,5570936
1646649009,197962,true,2529585817,28,2533636192,4050375
1646649176,197963,true,2529332884,28,2533129540,3796656
1646649224,197963,true,2529332884,28,2532876253,3543369
1646650304,197963,true,2529332884,28,2529079976,-252908
1646651262,197963,true,2529332884,28,2527057622,-2275262
1646652057,197964,true,2529079976,28,2526804942,-2275034
1646652166,197964,true,2529079976,28,2526804942,-2275034
1646652185,197964,true,2529079976,28,2526804942,-2275034
1646652792,197964,true,2529079976,28,2527563059,-1516917
1646653048,197965,true,2528827093,28,2528068597,-758496
1646653090,197965,true,2528827093,28,2528068597,-758496
1646653628,197965,true,2528827093,28,2529332884,505791
1646653792,197965,true,2528827093,28,2529585817,758724
1646653809,197966,true,2528574236,28,2529585817,1011581
1646654298,197966,true,2528574236,28,2531103948,2529712
1646654309,197967,true,2528321404,28,2531103948,2782544
1646654326,197967,true,2528321404,28,2531103948,2782544
1646654521,197967,true,2528321404,28,2531610194,3288790
1646654569,197968,true,2528068597,28,2531863355,3794758
1646654582,197969,true,2527815815,28,2531863355,4047540
1646654592,197969,true,2527815815,28,2532116542,4300727
1646654640,197969,true,2527815815,28,2532369753,4553938
1646654809,197969,true,2527815815,28,2533889555,6073740
1646654834,197969,true,2527815815,28,2533889555,6073740
1646654854,197969,true,2527815815,28,2534142944,6327129
1646654911,197968,true,2528068597,28,2534903263,6834666
1646654967,197967,true,2528321404,28,2535410269,7088865
1646655622,197967,true,2528321404,28,2542773262,14451858
1646655685,197967,true,2528321404,28,2543536170,15214766
1646655692,197966,true,2528574236,28,2543536170,14961934
1646655796,197965,true,2528827093,28,2545062673,16235580
1646655806,197965,true,2528827093,28,2545062673,16235580
1646656344,197963,true,2529332884,28,2552453697,23120813
1646656436,197962,true,2529585817,28,2553474832,23889015
1646656571,197960,true,2530091760,28,2554751825,24660065
1646656855,197959,true,2530344769,28,2557307727,26962958
1646657770,197957,true,2530850863,28,2562939715,32088852
1646658763,197955,true,2531357059,28,2564221441,32864382
1646658779,197953,true,2531863355,28,2564477863,32614508
1646658786,197952,true,2532116542,28,2564477863,32361321
1646658831,197950,true,2532622990,28,2564734311,32111321
1646658897,197947,true,2533382853,28,2564990784,31607931
1646658912,197945,true,2533889555,28,2564990784,31101229
1646658981,197943,true,2534396358,28,2565503808,31107450
1646659620,197941,true,2534903263,28,2570896757,35993494
1646660089,197938,true,2535663810,28,2574755803,39091993
1646660233,197936,true,2536170968,28,2576816329,40645361
1646660276,197934,true,2536678228,28,2577589451,40911223
1646660422,197931,true,2537439307,28,2579910210,42470903
1646660442,197928,true,2538200615,28,2580426217,42225602
1646660492,197924,true,2539216048,28,2581458543,42242495
1646660496,197923,true,2539469969,28,2581458543,41988574
1646660513,197920,true,2540231887,28,2581974860,41742973
1646660580,197916,true,2541248132,28,2583524433,42276301
1646660828,197912,true,2542264783,28,2588437549,46172766
1646660887,197911,true,2542519010,28,2589473080,46954070
1646660905,197908,true,2543281842,28,2589991000,46709158
1646660968,197903,true,2544553737,28,2591545383,46991646
1646661165,197899,true,2545571711,28,2596214132,50642421
1646661210,197897,true,2546080851,28,2597252774,51171923
1646661573,197894,true,2546844752,28,2606098019,59253267
1646661798,197890,true,2547863643,28,2611576301,63712658
1646661932,197886,true,2548882941,28,2614450472,65567531
1646662040,197885,true,2549137829,28,2616804419,67666590
1646662054,197882,true,2549902647,28,2617066099,67163452
1646662641,197876,true,2551432971,28,2628868843,77435872
1646663281,197872,true,2552453697,28,2635448908,82995211
1646663751,197870,true,2552964214,28,2640196750,87232536
1646664223,197867,true,2553730180,28,2640196750,86466570
1646664233,197861,true,2555262801,28,2640196750,84933949
1646664420,197857,true,2556285059,28,2639140935,82855876
1646664459,197855,true,2556796342,28,2638877048,82080706
1646664521,197853,true,2557307727,28,2638613186,81305459
1646664540,197848,true,2558586636,28,2638349351,79762715
1646664633,197844,true,2559610224,28,2637821761,78211537
1646664794,197842,true,2560122172,28,2636766896,76644724
1646665141,197840,true,2560634222,28,2633868192,73233970
1646665142,197835,true,2561914795,28,2633868192,71953397
1646665154,197830,true,2563196009,28,2633868192,70672183
1646665161,197829,true,2563452328,28,2633604831,70152503
1646665184,197827,true,2563965045,28,2633341497,69376452
1646665342,197822,true,2565247284,28,2631498895,66251611
1646665383,197817,true,2566530164,28,2630972674,64442510
1646665468,197815,true,2567043495,28,2629920548,62877053
1646666104,197814,true,2567300200,28,2622305207,55005007
1646666126,197808,true,2568840965,28,2622043003,53202038
1646666150,197803,true,2570125642,28,2621780825,51655183
1646666156,197801,true,2570639693,28,2621780825,51141132
1646666166,197800,true,2570896757,28,2621518673,50621916
1646666234,197795,true,2572182463,28,2620470327,48287864
1646666280,197790,true,2573468811,28,2619946312,46477501
1646667060,197789,true,2573726158,28,2609748929,36022771
1646667317,197788,true,2573983531,28,2607662069,33678538
1646667353,197783,true,2575270780,28,2607662069,32391289
1646667376,197778,true,2576558673,28,2607662069,31103396
1646667675,197777,true,2576816329,28,2606619265,29802936
1646667696,197776,true,2577074010,28,2606619265,29545255
1646667814,197771,true,2578362805,28,2606358629,27995824
1646667835,197766,true,2579652244,28,2606358629,26706385
1646668760,197765,true,2579910210,28,2610270905,30360695
1646669016,197764,true,2580168201,28,2611576301,31408100
1646669045,197760,true,2581200423,28,2611576301,30375878
1646669051,197756,true,2582233058,28,2611837459,29604401
1646669118,197755,true,2582491281,28,2612359853,29868572
1646669151,197753,true,2583007805,28,2612621088,29613283
1646669241,197748,true,2584299567,28,2613143639,28844072
1646669244,197744,true,2585333442,28,2613143639,27810197
1646669260,197743,true,2585591976,28,2613404953,27812977
1646669297,197741,true,2586109120,28,2613666294,27557174
1646669810,197735,true,2587661173,28,2619422401,31761228
1646669821,197731,true,2588696393,28,2619422401,30726008
1646670732,197729,true,2589214158,28,2629131730,39917572
1646670746,197727,true,2589732027,28,2629131730,39399703
1646670898,197722,true,2591027152,28,2630183540,39156388
1646670957,197718,true,2592063718,28,2630183540,38119822
1646671047,197716,true,2592582157,28,2630183540,37601383
1646671165,197713,true,2593360009,28,2629920548,36560539
1646671208,197708,true,2594656949,28,2629657582,35000633
1646671217,197704,true,2595694967,28,2629657582,33962615
1646671275,197703,true,2595954537,28,2629131730,33177193
1646671307,197701,true,2596473754,28,2628868843,32395089
1646671335,197696,true,2597772250,28,2628868843,31096593
1646671363,197692,true,2598811515,28,2628605982,29794467
1646671374,197691,true,2599071396,28,2628343148,29271752
1646671385,197689,true,2599591236,28,2628343148,28751912
1646671857,197685,true,2600631229,28,2622305207,21673978
1646671880,197681,true,2601671637,28,2622043003,20371366
1646672218,197680,true,2601931804,28,2617327806,15396002
1646672241,197679,true,2602191998,28,2616804419,14612421
1646672250,197675,true,2603233031,28,2616804419,13571388
1646672294,197672,true,2604014079,28,2616019535,12005456
1646672391,197671,true,2604274480,28,2614189053,9914573
1646672429,197670,true,2604534907,28,2613404953,8870046
1646672738,197667,true,2605316346,28,2607140615,1824269
1646672873,197665,true,2605837435,28,2604534907,-1302528
1646673261,197665,true,2605837435,28,2598811515,-7025920
1646674630,197664,true,2606098019,28,2585074935,-21023084
1646674926,197662,true,2606619265,28,2582491281,-24127984
1646674966,197660,true,2607140615,28,2582233058,-24907557
1646674988,197661,true,2606879927,28,2581974860,-24905067
1646675360,197660,true,2607140615,28,2581200423,-25940192
1646675419,197658,true,2607662069,28,2580942328,-26719741
1646675520,197656,true,2608183627,28,2581200423,-26983204
1646675889,197657,true,2607922835,28,2581974860,-25947975
1646675967,197657,true,2607922835,28,2581974860,-25947975
1646675991,197654,true,2608705290,28,2581974860,-26730430
1646675992,197653,true,2608966161,28,2581974860,-26991301
1646675993,197653,true,2608966161,28,2581974860,-26991301
1646676001,197654,true,2608705290,28,2581974860,-26730430
1646676009,197652,true,2609227057,28,2581974860,-27252197
1646676284,197652,true,2609227057,28,2579136391,-30090666
1646676440,197654,true,2608705290,28,2577074010,-31631280
1646676446,197654,true,2608705290,28,2577074010,-31631280
1646676521,197654,true,2608705290,28,2576043438,-32661852
1646676580,197655,true,2608444446,28,2575013279,-33431167
1646676593,197657,true,2607922835,28,2575013279,-32909556
1646676667,197659,true,2607401329,28,2573726158,-33675171
1646676687,197658,true,2607662069,28,2573468811,-34193258
1646676704,197660,true,2607140615,28,2572954195,-34186420
1646676921,197662,true,2606619265,28,2568584107,-38035158
1646676979,197665,true,2605837435,28,2567300200,-38537235
1646677266,197666,true,2605576878,28,2560122172,-45454706
1646677351,197668,true,2605055841,28,2557563457,-47492384
1646678195,197671,true,2604274480,28,2538200615,-66073865
1646678222,197674,true,2603493354,28,2537693051,-65800303
1646678250,197676,true,2602972733,28,2537185589,-65787144
1646678762,197679,true,2602191998,28,2531103948,-71088050
1646678766,197683,true,2601151381,28,2531103948,-70047433
1646678812,197686,true,2600371192,28,2530850863,-69520329
1646679694,197688,true,2599851195,28,2527310328,-72540867
1646679713,197692,true,2598811515,28,2527310328,-71501187
1646679744,197696,true,2597772250,28,2527057622,-70714628
1646680465,197700,true,2596733401,28,2525794472,-70938929
1646680848,197702,true,2596214132,28,2525541918,-70672214
1646680874,197706,true,2595175906,28,2525289389,-69886517
1646681131,197710,true,2594138095,28,2524279526,-69858569
1646681142,197714,true,2593100699,28,2524027123,-69073576
1646681328,197718,true,2592063718,28,2523017765,-69045953
1646681458,197723,true,2590768075,28,2522008810,-68759265
1646681471,197727,true,2589732027,28,2522008810,-67723217
1646681507,197731,true,2588696393,28,2521756634,-66939759
1646681524,197736,true,2587402433,28,2521504484,-65897949
1646681566,197741,true,2586109120,28,2521000259,-65108861
1646681576,197745,true,2585074935,28,2521000259,-64074676
1646681586,197749,true,2584041163,28,2520748184,-63292979
1646681602,197753,true,2583007805,28,2520748184,-62259621
1646681610,197758,true,2581716689,28,2520496134,-61220555
1646681664,197765,true,2579910210,28,2519236264,-60673946
1646681687,197768,true,2579136391,28,2518732492,-60403899
1646681772,197774,true,2577589451,28,2515963548,-61625903
1646681789,197780,true,2576043438,28,2515460431,-60583007
1646681832,197786,true,2574498353,28,2514203078,-60295275
1646681849,197790,true,2573468811,28,2513700313,-59768498
1646682474,197796,true,2571925270,28,2493921299,-78003971
1646682488,197801,true,2570639693,28,2493422590,-77217103
1646682617,197808,true,2568840965,28,2488938690,-79902275
1646682926,197811,true,2568070467,28,2479499141,-88571326
1646682952,197817,true,2566530164,28,2478755440,-87774724
1646683152,197823,true,2564990784,28,2472319369,-92671415
1646683155,197829,true,2563452328,28,2472072161,-91380167
1646683405,197833,true,2562427204,28,2464913895,-97513309
1646683638,197839,true,2560890286,28,2462204115,-98686171
1646683917,197844,true,2559610224,28,2459989239,-99620985
1646684017,197850,true,2558074996,28,2459251390,-98823606
1646684125,197854,true,2557052021,28,2458759614,-98292407
1646684507,197859,true,2555773879,28,2457530603,-98243276
1646684513,197864,true,2554496375,28,2457530603,-96965772
1646684702,197871,true,2552708943,28,2457284874,-95424069
1646684731,197875,true,2551688114,28,2457284874,-94403240
1646684735,197880,true,2550412653,28,2457284874,-93127779
1646684751,197885,true,2549137829,28,2457284874,-91852955
1646684818,197892,true,2547354146,28,2457776356,-89577790
1646684830,197895,true,2546590093,28,2457776356,-88813737
1646685199,197899,true,2545571711,28,2462204115,-83367596
1646685238,197904,true,2544299307,28,2462696581,-81602726
1646685553,197911,true,2542519010,28,2466393213,-76125797
1646685704,197915,true,2541502257,28,2467873419,-73628838
1646686046,197920,true,2540231887,28,2470836496,-69395391
1646686662,197925,true,2538962152,28,2474050511,-64911641
1646686891,197932,true,2537185589,28,2473061139,-64124450
1646687009,197937,true,2535917376,28,2472566601,-63350775
1646687198,197943,true,2534396358,28,2472319369,-62076989
1646687327,197948,true,2533129540,28,2472072161,-61057379
1646687475,197955,true,2531357059,28,2471824979,-59532080
1646687662,197959,true,2530344769,28,2471577821,-58766948
1646687787,197965,true,2528827093,28,2472072161,-56754932
1646687810,197970,true,2527563059,28,2472072161,-55490898
1646687818,197976,true,2526047052,28,2472319369,-53727683
1646687903,197980,true,2525036886,28,2472813857,-52223029
1646687949,197984,true,2524027123,28,2473555776,-50471347
1646687961,197988,true,2523017765,28,2473803131,-49214634
1646688068,197994,true,2521504484,28,2475287784,-46216700
1646688087,197996,true,2521000259,28,2475535313,-45464946
1646688134,198000,true,2519992110,28,2476278048,-43714062
1646688321,198005,true,2518732492,28,2478507590,-40224902
1646688350,198011,true,2517221782,28,2478755440,-38466342
1646688358,198013,true,2516718413,28,2479003316,-37715097
1646688383,198017,true,2515711977,28,2479251216,-36460761
1646688451,198022,true,2514454498,28,2479747091,-34707407
1646688455,198028,true,2512946354,28,2479747091,-33199263
1646688463,198030,true,2512443840,28,2479747091,-32696749
1646688492,198033,true,2511690257,28,2479995066,-31695191
1646688523,198039,true,2510183770,28,2480243066,-29940704
1646688603,198044,true,2508929055,28,2480739139,-28189916
1646688714,198047,true,2508176527,28,2481235312,-26941215
1646688800,198049,true,2507674967,28,2481235312,-26439655
1646688873,198055,true,2506170888,28,2481235312,-24935576
1646688950,198060,true,2504918179,28,2481235312,-23682867
1646689038,198063,true,2504166853,28,2481235312,-22931541
1646689130,198065,true,2503666095,28,2481235312,-22430783
1646689324,198071,true,2502164421,28,2481979757,-20184664
1646689368,198076,true,2500913714,28,2482227955,-18685759
1646689443,198077,true,2500663648,28,2482476177,-18187471
1646689797,198080,true,2499913599,28,2480739139,-19174460
1646689812,198085,true,2498664017,28,2480739139,-17924878
1646690553,198090,true,2497415059,28,2479995066,-17419993
1646690602,198092,true,2496915651,28,2480243066,-16672585
1646690769,198094,true,2496416343,28,2481979757,-14436586
1646690874,198099,true,2495168509,28,2482972698,-12195811
1646690940,198103,true,2494170691,28,2483469317,-10701374
1646691074,198105,true,2493671932,28,2484711300,-8960632
1646691109,198106,true,2493422590,28,2484959771,-8462819
1646691121,198110,true,2492425470,28,2485208267,-7217203
1646691235,198113,true,2491677892,28,2486202499,-5475393
1646691257,198114,true,2491428749,28,2486451120,-4977629
1646691267,198115,true,2491179631,28,2486699765,-4479866
1646691317,198118,true,2490432427,28,2487197130,-3235297
1646691321,198121,true,2489685446,28,2487197130,-2488316
1646691338,198121,true,2489685446,28,2487445849,-2239597
1646692598,198121,true,2489685446,28,2501413922,11728476
1646692630,198124,true,2488938690,28,2501664063,12725373
1646692642,198126,true,2488440977,28,2501664063,13223086
1646692664,198127,true,2488192158,28,2501914230,13722072
1646692681,198126,true,2488440977,28,2502164421,13723444
1646692931,198126,true,2488440977,28,2506170888,17729911
1646693206,198128,true,2487943363,28,2509681809,21738446
1646693232,198128,true,2487943363,28,2509932777,21989414
1646693301,198128,true,2487943363,28,2510434789,22491426
1646693336,198128,true,2487943363,28,2510434789,22491426
1646693351,198129,true,2487694594,28,2510685832,22991238
1646693565,198130,true,2487445849,28,2511187994,23742145
1646693578,198130,true,2487445849,28,2511187994,23742145
1646693711,198130,true,2487445849,28,2511187994,23742145
1646693752,198132,true,2486948435,28,2511187994,24239559
1646693760,198133,true,2486699765,28,2511187994,24488229
1646693767,198133,true,2486699765,28,2511187994,24488229
1646693771,198134,true,2486451120,28,2511187994,24736874
1646693787,198135,true,2486202499,28,2511187994,24985495
1646694279,198137,true,2485705334,28,2509179948,23474614
1646694292,198135,true,2486202499,28,2509179948,22977449
1646694585,198136,true,2485953904,28,2507925734,21971830
1646694655,198138,true,2485456788,28,2506672147,21215359
1646694768,198139,true,2485208267,28,2505168670,19960403
1646695772,198138,true,2485456788,28,2497165343,11708555
1646695782,198138,true,2485456788,28,2497165343,11708555
1646695844,198139,true,2485208267,28,2497165343,11957076
1646695862,198140,true,2484959771,28,2497415059,12455288
1646695886,198138,true,2485456788,28,2497664801,12208013
1646696188,198137,true,2485705334,28,2500663648,14958314
1646696508,198136,true,2485953904,28,2502664879,16710975
1646696729,198136,true,2485953904,28,2504667712,18713808
1646696768,198132,true,2486948435,28,2505168670,18220235
1646696828,198131,true,2487197130,28,2505419187,18222057
1646696855,198130,true,2487445849,28,2505419187,17973338
1646697404,198133,true,2486699765,28,2503666095,16966330
1646697742,198129,true,2487694594,28,2501163805,13469211
1646697937,198128,true,2487943363,28,2498164359,10220996
1646697953,198127,true,2488192158,28,2497914567,9722409
1646697957,198129,true,2487694594,28,2497914567,10219973
1646698244,198124,true,2488938690,28,2495917135,6978445
1646698303,198123,true,2489187584,28,2495418026,6230442
1646698421,198122,true,2489436503,28,2494170691,4734188
1646698440,198124,true,2488938690,28,2493921299,4982609
1646698537,198119,true,2490183408,28,2493422590,3239182
1646698563,198117,true,2490681470,28,2493173272,2491802
1646698584,198115,true,2491179631,28,2493173272,1993641
1646698699,198116,true,2490930538,28,2494170691,3240153
1646699549,198111,true,2492176252,28,2504166853,11990601
1646699638,198109,true,2492674713,28,2505168670,12493957
1646699838,198108,true,2492923980,28,2507173507,14249527
1646700082,198109,true,2492674713,28,2508929055,16254342
1646700369,198104,true,2493921299,28,2511941426,18020127
1646700415,198102,true,2494420108,28,2512192620,17772512
1646700878,198101,true,2494669550,28,2514705944,20036394
1646701145,198102,true,2494420108,28,2516215145,21795037
1646701383,198097,true,2495667568,28,2517473504,21805936
1646701595,198096,true,2495917135,28,2518480644,22563509
1646701625,198094,true,2496416343,28,2518480644,22064301
1646701641,198095,true,2496166726,28,2518480644,22313918
1646701864,198091,true,2497165343,28,2518984366,21819023
1646701885,198089,true,2497664801,28,2518984366,21319565
1646701893,198088,true,2497914567,28,2518984366,21069799
1646702366,198087,true,2498164359,28,2524279526,26115167
1646703393,198082,true,2499413691,28,2533636192,34222501
1646703511,198080,true,2499913599,28,2534903263,34989664
1646703558,198079,true,2500163590,28,2535410269,35246679
1646703598,198078,true,2500413606,28,2535663810,35250204
1646703803,198074,true,2501413922,28,2535156753,33742831
1646704208,198073,true,2501664063,28,2532369753,30705690
1646704312,198072,true,2501914230,28,2531863355,29949125
1646704365,198072,true,2501914230,28,2531610194,29695964
1646704525,198068,true,2502915145,28,2530850863,27935718
1646704901,198067,true,2503165437,28,2528827093,25661656
1646705047,198067,true,2503165437,28,2528068597,24903160
1646705071,198068,true,2502915145,28,2528068597,25153452
1646705148,198064,true,2503916462,28,2527563059,23646597
1646705243,198063,true,2504166853,28,2526804942,22638089
1646705691,198063,true,2504166853,28,2525794472,21627619
1646705744,198063,true,2504166853,28,2525794472,21627619
1646705827,198060,true,2504918179,28,2525794472,20876293
1646706066,198058,true,2505419187,28,2525794472,20375285
1646706641,198057,true,2505669729,28,2525541918,19872189
1646706644,198058,true,2505419187,28,2525541918,20122731
1646707391,198054,true,2506421505,28,2526552286,20130781
1646707399,198052,true,2506922815,28,2526804942,19882127
1646707550,198050,true,2507424224,28,2529332884,21908660
1646707576,198051,true,2507173507,28,2529838776,22665269
1646707689,198043,true,2509179948,28,2532116542,22936594
1646707735,198041,true,2509681809,28,2532876253,23194444
1646707967,198038,true,2510434789,28,2537439307,27004518
1646708028,198038,true,2510434789,28,2538454435,28019646
1646708226,198030,true,2512443840,28,2542010582,29566742
1646708286,198028,true,2512946354,28,2543027539,30081185
1646708329,198026,true,2513448968,28,2543790524,30341556
1646709697,198027,true,2513197648,28,2555007300,41809652
1646710484,198020,true,2514957414,28,2552198478,37241064
1646710681,198018,true,2515460431,28,2551432971,35972540
1646710915,198017,true,2515711977,28,2550667694,34955717
1646710979,198018,true,2515460431,28,2550157637,34697206
1646712001,198012,true,2516970085,28,2545062673,28092588
1646712181,198010,true,2517473504,28,2544553737,27080233
1646712210,198009,true,2517725251,28,2544553737,26828486
1646712243,198010,true,2517473504,28,2544299307,26825803
1646712257,198004,true,2518984366,28,2544299307,25314941
1646712524,198001,true,2519740136,28,2545317180,25577044
1646712534,198000,true,2519992110,28,2545317180,25325070
1646713294,198001,true,2519740136,28,2550922761,31182625
1646713736,197995,true,2521252359,28,2554496375,33244016
1646713757,197993,true,2521756634,28,2554496375,32739741
1646713817,197992,true,2522008810,28,2554751825,32743015
1646715017,197994,true,2521504484,28,2551432971,29928487
1646715057,197989,true,2522765488,28,2551177853,28412365
1646715186,197986,true,2523522394,28,2550667694,27145300
1646715337,197986,true,2523522394,28,2549647682,26125288
1646715419,197988,true,2523017765,28,2549137829,26120064
1646715931,197984,true,2524027123,28,2547608882,23581759
1646716095,197982,true,2524531954,28,2547354146,22822192
1646716129,197982,true,2524531954,28,2547354146,22822192
1646716146,197984,true,2524027123,28,2547354146,23327023
1646716180,197980,true,2525036886,28,2547099436,22062550
1646716197,197979,true,2525289389,28,2547099436,21810047
1646716776,197979,true,2525289389,28,2542773262,17483873
1646716794,197981,true,2524784407,28,2542773262,17988855
1646716816,197977,true,2525794472,28,2542519010,16724538
1646717031,197976,true,2526047052,28,2540485910,14438858
1646717422,197976,true,2526047052,28,2537439307,11392255
1646717433,197977,true,2525794472,28,2537185589,11391117
1646717533,197973,true,2526804942,28,2536170968,9366026
1646718169,197972,true,2527057622,28,2529585817,2528195
1646718956,197972,true,2527057622,28,2525036886,-2020736
1646719394,197973,true,2526804942,28,2523017765,-3787177
1646719424,197969,true,2527815815,28,2523017765,-4798050
1646719866,197969,true,2527815815,28,2523270067,-4545748
1646720177,197969,true,2527815815,28,2523270067,-4545748
1646720583,197970,true,2527563059,28,2524279526,-3283533
1646720612,197965,true,2528827093,28,2524279526,-4547567
1646720629,197964,true,2529079976,28,2524279526,-4800450
1646720752,197965,true,2528827093,28,2523522394,-5304699
1646720780,197967,true,2528321404,28,2523522394,-4799010
1646720820,197964,true,2529079976,28,2523522394,-5557582
1646720829,197964,true,2529079976,28,2523270067,-5809909
1646720876,197965,true,2528827093,28,2523270067,-5557026
1646720991,197967,true,2528321404,28,2522513237,-5808167
1646721112,197964,true,2529079976,28,2522008810,-7071166
1646721187,197964,true,2529079976,28,2521504484,-7575492
1646721217,197965,true,2528827093,28,2521252359,-7574734
1646721806,197965,true,2528827093,28,2514957414,-13869679
1646722185,197962,true,2529585817,28,2510434789,-19151028
1646722306,197962,true,2529585817,28,2509179948,-20405869
1646722620,197962,true,2529585817,28,2507424224,-22161593
1646722730,197962,true,2529585817,28,2507173507,-22412310
1646723805,197960,true,2530091760,28,2510434789,-19656971
1646723877,197960,true,2530091760,28,2510685832,-19405928
1646724031,197960,true,2530091760,28,2511187994,-18903766
1646724104,197960,true,2530091760,28,2511439113,-18652647
1646724462,197957,true,2530850863,28,2512695084,-18155779
1646724497,197958,true,2530597803,28,2512695084,-17902719
1646724547,197958,true,2530597803,28,2512946354,-17651449
1646724618,197959,true,2530344769,28,2513197648,-17147121
1646724627,197956,true,2531103948,28,2513197648,-17906300
1646725070,197956,true,2531103948,28,2515711977,-15391971
1646725131,197957,true,2530850863,28,2515963548,-14887315
1646725161,197957,true,2530850863,28,2516215145,-14635718
1646725254,197955,true,2531357059,28,2516970085,-14386974
1646725368,197954,true,2531610194,28,2518228821,-13381373
1646725379,197955,true,2531357059,28,2518228821,-13128238
1646725433,197956,true,2531103948,28,2518984366,-12119582
1646725494,197953,true,2531863355,28,2519992110,-11871245
1646726999,197952,true,2532116542,28,2536931896,4815354
1646727300,197953,true,2531863355,28,2537693051,5829696
1646727303,197953,true,2531863355,28,2537693051,5829696
1646727331,197950,true,2532622990,28,2537693051,5070061
1646727344,197949,true,2532876253,28,2537693051,4816798
1646727359,197949,true,2532876253,28,2537693051,4816798
1646727367,197952,true,2532116542,28,2537693051,5576509
1646727401,197949,true,2532876253,28,2537946821,5070568
1646727431,197948,true,2533129540,28,2537946821,4817281
1646727441,197948,true,2533129540,28,2537946821,4817281
1646727450,197951,true,2532369753,28,2537946821,5577068
1646728068,197946,true,2533636192,28,2542773262,9137070
1646728114,197944,true,2534142944,28,2543281842,9138898
1646728170,197945,true,2533889555,28,2543790524,9900969
1646728180,197947,true,2533382853,28,2543790524,10407671
1646728233,197942,true,2534649798,28,2544299307,9649509
1646728313,197940,true,2535156753,28,2545571711,10414958
1646728351,197940,true,2535156753,28,2546080851,10924098
1646728366,197942,true,2534649798,28,2546080851,11431053
1646728448,197937,true,2535917376,28,2547863643,11946267
1646728717,197933,true,2536931896,28,2553730180,16798284
1646729298,197933,true,2536931896,28,2566273536,29341640
1646729370,197935,true,2536424585,28,2567300200,30875615
1646729456,197929,true,2537946821,28,2568584107,30637286
1646729493,197926,true,2538708281,28,2569097849,30389568
1646729515,197925,true,2538962152,28,2569354759,30392607
1646729529,197928,true,2538200615,28,2569611694,31411079
1646729548,197922,true,2539723916,28,2569868656,30144740
1646730166,197920,true,2540231887,28,2575270780,35038893
1646730220,197920,true,2540231887,28,2575270780,35038893
1646731405,197922,true,2539723916,28,2571668103,31944187
1646731656,197920,true,2540231887,28,2571925270,31693383
1646731658,197918,true,2540739958,28,2571925270,31185312
1646732004,197918,true,2540739958,28,2572696925,31956967
1646732182,197920,true,2540231887,28,2573468811,33236924
1646732877,197917,true,2540994032,28,2578620641,37626609
1646733952,197915,true,2541502257,28,2585074935,43572678
1646734004,197915,true,2541502257,28,2585074935,43572678
1646734027,197916,true,2541248132,28,2585074935,43826803
1646734631,197913,true,2542010582,28,2582233058,40222476
1646734990,197911,true,2542519010,28,2580684260,38165250
1646735876,197911,true,2542519010,28,2577074010,34555000
1646735910,197912,true,2542264783,28,2577074010,34809227
1646735924,197909,true,2543027539,28,2577074010,34046471
1646736128,197906,true,2543790524,28,2577589451,33798927
1646736730,197905,true,2544044903,28,2579910210,35865307
1646736772,197906,true,2543790524,28,2580168201,36377677
1646736778,197903,true,2544553737,28,2580168201,35614464
1646736798,197902,true,2544808193,28,2580426217,35618024
1646736862,197900,true,2545317180,28,2581200423,35883243
1646736914,197900,true,2545317180,28,2581716689,36399509
1646737626,197897,true,2546080851,28,2589991000,43910149
1646737700,197896,true,2546335459,28,2590768075,44432616
1646738769,197894,true,2546844752,28,2594916414,48071662
1646739109,197894,true,2546844752,28,2594138095,47293343
1646739209,197891,true,2547608882,28,2594138095,46529213
1646739419,197890,true,2547863643,28,2593619345,45755702
1646739442,197888,true,2548373241,28,2593619345,45246104
1646739466,197888,true,2548373241,28,2593360009,44986768
1646739516,197885,true,2549137829,28,2593100699,43962870
1646739537,197884,true,2549392743,28,2592841415,43448672
1646739562,197883,true,2549647682,28,2592841415,43193733
1646739597,197883,true,2549647682,28,2592582157,42934475
1646739618,197880,true,2550412653,28,2592322925,41910272
1646739837,197879,true,2550667694,28,2590768075,40100381
1646739854,197877,true,2551177853,28,2590768075,39590222
1646739915,197877,true,2551177853,28,2590249999,39072146
1646739951,197874,true,2551943283,28,2589991000,38047717
1646739954,197873,true,2552198478,28,2589991000,37792522
1646740090,197870,true,2552964214,28,2589214158,36249944
1646740125,197869,true,2553219510,28,2589214158,35994648
1646740129,197866,true,2553985553,28,2589214158,35228605
1646741064,197864,true,2554496375,28,2585074935,30578560
1646741097,197861,true,2555262801,28,2584816453,29553652
1646741111,197861,true,2555262801,28,2584816453,29553652
1646741126,197857,true,2556285059,28,2584816453,28531394
1646741387,197855,true,2556796342,28,2585074935,28278593
1646741427,197852,true,2557563457,28,2585333442,27769985
1646741769,197851,true,2557819214,28,2587402433,29583219
1646742202,197848,true,2558586636,28,2588696393,30109757
1646742277,197846,true,2559098379,28,2588696393,29598014
1646742286,197843,true,2559866185,28,2588955263,29089078
1646742362,197841,true,2560378184,28,2588955263,28577079
1646742474,197838,true,2561146375,28,2588955263,27808888
1646742583,197836,true,2561658629,28,2589214158,27555529
1646742781,197832,true,2562683447,28,2588955263,26271816
1646742843,197831,true,2562939715,28,2588955263,26015548
1646743255,197828,true,2563708674,28,2587661173,23952499
1646743287,197826,true,2564221441,28,2587402433,23180992
1646743290,197822,true,2565247284,28,2587402433,22155149
1646743854,197821,true,2565503808,28,2582491281,16987473
1646744678,197818,true,2566273536,28,2577074010,10800474
1646744704,197816,true,2566786817,28,2577074010,10287193
1646744737,197813,true,2567556930,28,2576816329,9259399
1646744760,197811,true,2568070467,28,2576816329,8745862
1646744789,197809,true,2568584107,28,2576558673,7974566
1646745106,197806,true,2569354759,28,2576301043,6946284
1646745152,197803,true,2570125642,28,2576301043,6175401
1646745225,197802,true,2570382655,28,2575785860,5403205
1646745274,197800,true,2570896757,28,2575528307,4631550
1646745994,197799,true,2571153847,28,2570896757,-257090
1646746032,197796,true,2571925270,28,2570639693,-1285577
1646746183,197795,true,2572182463,28,2569868656,-2313807
1646746202,197794,true,2572439681,28,2569868656,-2571025
1646746222,197793,true,2572696925,28,2569868656,-2828269
1646746240,197790,true,2573468811,28,2569868656,-3600155
1646746546,197789,true,2573726158,28,2569097849,-4628309
1646746575,197787,true,2574240929,28,2568840965,-5399964
1646746659,197787,true,2574240929,28,2569097849,-5143080
1646747170,197783,true,2575270780,28,2571410962,-3859818
1646747307,197782,true,2575528307,28,2572954195,-2574112
1646747573,197780,true,2576043438,28,2575785860,-257578
1646747586,197780,true,2576043438,28,2575785860,-257578
1646748124,197776,true,2577074010,28,2582233058,5159048
1646748359,197775,true,2577331718,28,2585333442,8001724
1646748412,197773,true,2577847210,28,2585850535,8003325
1646748448,197773,true,2577847210,28,2586109120,8261910
1646748511,197769,true,2578878503,28,2586367731,7489228
1646748531,197767,true,2579394305,28,2586626368,7232063
1646749463,197767,true,2579394305,28,2588437549,9043244
1646749677,197767,true,2579394305,28,2588178731,8784426
1646749861,197763,true,2580426217,28,2588178731,7752514
1646749888,197761,true,2580942328,28,2587919939,6977611
1646749892,197762,true,2580684260,28,2587919939,7235679
1646749976,197763,true,2580426217,28,2587143719,6717502
1646749977,197759,true,2581458543,28,2587143719,5685176
1646750128,197758,true,2581716689,28,2585333442,3616753
1646750154,197759,true,2581458543,28,2585074935,3616392
1646750158,197760,true,2581200423,28,2585074935,3874512
1646750166,197757,true,2581974860,28,2585074935,3100075
1646750376,197755,true,2582491281,28,2584299567,1808286
1646750470,197757,true,2581974860,28,2583782785,1807925
1646750556,197760,true,2581200423,28,2583007805,1807382
1646750581,197757,true,2581974860,28,2582749530,774670
1646750605,197756,true,2582233058,28,2582749530,516472
1646750641,197758,true,2581716689,28,2582491281,774592
1646750642,197760,true,2581200423,28,2582491281,1290858
1646750754,197756,true,2582233058,28,2582491281,258223
1646750779,197754,true,2582749530,28,2582491281,-258249
1646750795,197756,true,2582233058,28,2582491281,258223
1646750912,197757,true,2581974860,28,2583524433,1549573
1646750941,197752,true,2583266106,28,2583782785,516679
1646751004,197751,true,2583524433,28,2584041163,516730
1646751025,197752,true,2583266106,28,2584041163,775057
1646751028,197754,true,2582749530,28,2584041163,1291633
1646751060,197750,true,2583782785,28,2584041163,258378
1646751281,197750,true,2583782785,28,2583782785,0
1646751342,197752,true,2583266106,28,2583524433,258327
1646751444,197754,true,2582749530,28,2583007805,258275
1646751796,197751,true,2583524433,28,2581716689,-1807744
1646751808,197751,true,2583524433,28,2581716689,-1807744
1646751994,197753,true,2583007805,28,2581458543,-1549262
1646752084,197754,true,2582749530,28,2580684260,-2065270
1646752565,197752,true,2583266106,28,2577589451,-5676655
1646752969,197751,true,2583524433,28,2573468811,-10055622
1646753097,197754,true,2582749530,28,2572696925,-10052605
1646753108,197755,true,2582491281,28,2572696925,-9794356
1646753116,197753,true,2583007805,28,2572696925,-10310880
1646753140,197753,true,2583007805,28,2572439681,-10568124
1646753150,197756,true,2582233058,28,2572439681,-9793377
1646753196,197758,true,2581716689,28,2572182463,-9534226
1646753234,197757,true,2581974860,28,2571925270,-10049590
1646753549,197758,true,2581716689,28,2569868656,-11848033
1646753562,197761,true,2580942328,28,2569611694,-11330634
1646753619,197762,true,2580684260,28,2569097849,-11586411
1646753637,197761,true,2580942328,28,2569097849,-11844479
1646753656,197763,true,2580426217,28,2568840965,-11585252
1646753711,197766,true,2579652244,28,2568070467,-11581777
1646753725,197768,true,2579136391,28,2567813685,-11322706
1646754433,197769,true,2578878503,28,2556540688,-22337815
1646754521,197770,true,2578620641,28,2555007300,-23613341
1646754593,197773,true,2577847210,28,2553730180,-24117030
1646754633,197775,true,2577331718,28,2552964214,-24367504
1646754880,197774,true,2577589451,28,2549137829,-28451622
1646754906,197776,true,2577074010,28,2548628078,-28445932
1646755091,197778,true,2576558673,28,2547099436,-29459237
1646755158,197779,true,2576301043,28,2546844752,-29456291
1646755217,197778,true,2576558673,28,2546335459,-30223214
1646755411,197779,true,2576301043,28,2546335459,-29965584
1646755440,197781,true,2575785860,28,2546335459,-29450401
1646755445,197782,true,2575528307,28,2546590093,-28938214
1646755449,197781,true,2575785860,28,2546590093,-29195767
1646755455,197781,true,2575785860,28,2546590093,-29195767
1646755473,197783,true,2575270780,28,2546844752,-28426028
1646755476,197784,true,2575013279,28,2546844752,-28168527
1646755486,197783,true,2575270780,28,2547099436,-28171344
1646755498,197783,true,2575270780,28,2547099436,-28171344
1646755520,197784,true,2575013279,28,2547608882,-27404397
1646755659,197785,true,2574755803,28,2550412653,-24343150
1646755932,197785,true,2574755803,28,2555773879,-18981924
1646755965,197785,true,2574755803,28,2556285059,-18470744
1646756033,197786,true,2574498353,28,2557563457,-16934896
1646756507,197788,true,2573983531,28,2565247284,-8736247
1646756563,197787,true,2574240929,28,2566016935,-8223994
1646756653,197788,true,2573983531,28,2567300200,-6683331
1646756673,197789,true,2573726158,28,2567556930,-6169228
1646756685,197791,true,2573211490,28,2567556930,-5654560
1646756697,197790,true,2573468811,28,2567813685,-5655126
1646756718,197791,true,2573211490,28,2567813685,-5397805
1646756750,197792,true,2572954195,28,2567813685,-5140510
1646756764,197794,true,2572439681,28,2567813685,-4625996
1646756783,197794,true,2572439681,28,2568070467,-4369214
1646756804,197794,true,2572439681,28,2567813685,-4625996
1646756813,197796,true,2571925270,28,2567813685,-4111585
1646757696,197800,true,2570896757,28,2552708943,-18187814
1646758072,197799,true,2571153847,28,2545062673,-26091174
1646758158,197800,true,2570896757,28,2543536170,-27360587
1646758517,197801,true,2570639693,28,2537946821,-32692872
1646758535,197806,true,2569354759,28,2537693051,-31661708
1646758941,197805,true,2569611694,28,2538708281,-30903413
1646759152,197805,true,2569611694,28,2539977889,-29633805
1646759220,197805,true,2569611694,28,2540485910,-29125784
1646759268,197808,true,2568840965,28,2540994032,-27846933
1646759539,197806,true,2569354759,28,2543790524,-25564235
1646759558,197806,true,2569354759,28,2544044903,-25309856
1646759594,197806,true,2569354759,28,2544553737,-24801022
1646759668,197809,true,2568584107,28,2545826269,-22757838
1646759702,197807,true,2569097849,28,2546335459,-22762390
1646759714,197807,true,2569097849,28,2546590093,-22507756
1646759727,197807,true,2569097849,28,2546844752,-22253097
1646759781,197810,true,2568327274,28,2547863643,-20463631
1646759797,197808,true,2568840965,28,2548373241,-20467724
1646759850,197808,true,2568840965,28,2549647682,-19193283
1646759882,197808,true,2568840965,28,2550412653,-18428312
1646759891,197810,true,2568327274,28,2550667694,-17659580
1646759901,197808,true,2568840965,28,2550922761,-17918204
1646759936,197808,true,2568840965,28,2551943283,-16897682
1646759981,197808,true,2568840965,28,2553219510,-15621455
1646760011,197810,true,2568327274,28,2553985553,-14341721
1646760040,197809,true,2568584107,28,2554751825,-13832282
1646760079,197808,true,2568840965,28,2556029456,-12811509
1646760260,197807,true,2569097849,28,2561402489,-7695360
1646760310,197810,true,2568327274,28,2562683447,-5643827
1646760326,197808,true,2568840965,28,2562939715,-5901250
1646760406,197808,true,2568840965,28,2564477863,-4363102
1646760507,197808,true,2568840965,28,2566530164,-2310801
1646760612,197810,true,2568327274,28,2568584107,256833
1646760779,197808,true,2568840965,28,2571925270,3084305
1646760807,197808,true,2568840965,28,2572439681,3598716
1646760814,197807,true,2569097849,28,2572439681,3341832
1646760834,197810,true,2568327274,28,2572954195,4626921
1646760847,197807,true,2569097849,28,2573211490,4113641
1646760909,197807,true,2569097849,28,2574498353,5400504
1646760981,197807,true,2569097849,28,2576043438,6945589
1646761200,197808,true,2568840965,28,2580426217,11585252
1646761232,197806,true,2569354759,28,2580942328,11587569
1646761585,197805,true,2569611694,28,2586626368,17014674
1646761602,197804,true,2569868656,28,2586885030,17016374
1646761857,197806,true,2569354759,28,2588696393,19341634
1646761882,197804,true,2569868656,28,2588696393,18827737
1646761896,197803,true,2570125642,28,2588696393,18570751
1646761901,197803,true,2570125642,28,2588696393,18570751
1646762113,197806,true,2569354759,28,2588955263,19600504
1646762445,197805,true,2569611694,28,2591286255,21674561
1646762461,197804,true,2569868656,28,2591545383,21676727
1646762484,197804,true,2569868656,28,2591804538,21935882
1646762577,197806,true,2569354759,28,2593100699,23745940
1646762653,197803,true,2570125642,28,2594138095,24012453
1646762862,197800,true,2570896757,28,2596473754,25576997
1646762866,197800,true,2570896757,28,2596473754,25576997
1646762881,197802,true,2570382655,28,2596733401,26350746
1646763794,197797,true,2571668103,28,2610009904,38341801
1646763880,197795,true,2572182463,28,2611315170,39132707
1646763895,197794,true,2572439681,28,2611576301,39136620
1646763912,197796,true,2571925270,28,2611837459,39912189
1646763940,197790,true,2573468811,28,2612359853,38891042
1646763969,197788,true,2573983531,28,2612621088,38637557
1646764006,197788,true,2573983531,28,2613143639,39160108
1646764032,197790,true,2573468811,28,2613404953,39936142
1646764194,197786,true,2574498353,28,2614450472,39952119
1646764223,197783,true,2575270780,28,2614711917,39441137
1646764243,197783,true,2575270780,28,2614711917,39441137
1646764252,197785,true,2574755803,28,2614711917,39956114
1646765053,197782,true,2575528307,28,2604534907,29006600
1646765088,197780,true,2576043438,28,2604014079,27970641
1646765315,197779,true,2576301043,28,2600111181,23810138
1646765341,197781,true,2575785860,28,2599591236,23805376
1646765394,197779,true,2576301043,28,2598551660,22250617
1646765534,197776,true,2577074010,28,2595694967,18620957
1646765665,197775,true,2577331718,28,2593100699,15768981
1646765672,197776,true,2577074010,28,2593100699,16026689
1646765685,197773,true,2577847210,28,2592841415,14994205
1646765741,197770,true,2578620641,28,2591545383,12924742
1646765777,197770,true,2578620641,28,2590768075,12147434
1646766065,197771,true,2578362805,28,2586367731,8004926
1646766095,197768,true,2579136391,28,2586109120,6972729
1646766112,197766,true,2579652244,28,2585850535,6198291
1646766156,197766,true,2579652244,28,2585333442,5681198
1646766185,197768,true,2579136391,28,2585074935,5938544
1646766251,197766,true,2579652244,28,2584299567,4647323
1646766295,197764,true,2580168201,28,2583782785,3614584
1646766486,197765,true,2579910210,28,2580942328,1032118
1646767229,197767,true,2579394305,28,2571668103,-7726202
1646767386,197765,true,2579910210,28,2570125642,-9784568
1646767400,197764,true,2580168201,28,2570125642,-10042559
1646767611,197765,true,2579910210,28,2568327274,-11582936
1646767647,197768,true,2579136391,28,2567813685,-11322706
1646767810,197766,true,2579652244,28,2566786817,-12865427
1646767858,197765,true,2579910210,28,2566530164,-13380046
1646767910,197767,true,2579394305,28,2566273536,-13120769
1646768868,197769,true,2578878503,28,2568327274,-10551229
1646768889,197767,true,2579394305,28,2568327274,-11067031
1646768977,197766,true,2579652244,28,2568840965,-10811279
1646769692,197767,true,2579394305,28,2572696925,-6697380
1646769742,197768,true,2579136391,28,2572954195,-6182196
1646769747,197766,true,2579652244,28,2572954195,-6698049
1646770827,197765,true,2579910210,28,2579652244,-257966
1646770881,197766,true,2579652244,28,2579652244,0
1646770946,197766,true,2579652244,28,2579910210,257966
1646771367,197764,true,2580168201,28,2580168201,0
1646771396,197762,true,2580684260,28,2580168201,-516059
1646771410,197763,true,2580426217,28,2580168201,-258016
1646771417,197764,true,2580168201,28,2580168201,0
1646771580,197762,true,2580684260,28,2579394305,-1289955
1646771703,197760,true,2581200423,28,2578620641,-2579782
1646771789,197760,true,2581200423,28,2578104995,-3095428
1646772212,197759,true,2581458543,28,2574755803,-6702740
1646772243,197758,true,2581716689,28,2574498353,-7218336
1646772297,197756,true,2582233058,28,2573726158,-8506900
1646772329,197756,true,2582233058,28,2573468811,-8764247
1646772693,197756,true,2582233058,28,2569097849,-13135209
1646774002,197755,true,2582491281,28,2560122172,-22369109
1646774007,197753,true,2583007805,28,2560122172,-22885633
1646774039,197754,true,2582749530,28,2560122172,-22627358
1646774102,197754,true,2582749530,28,2559866185,-22883345
1646774237,197754,true,2582749530,28,2559866185,-22883345
1646774261,197753,true,2583007805,28,2559866185,-23141620
1646774279,197754,true,2582749530,28,2559866185,-22883345
1646775701,197754,true,2582749530,28,2557563457,-25186073
1646777109,197755,true,2582491281,28,2557052021,-25439260
1646778009,197754,true,2582749530,28,2558330803,-24418727
1646778063,197755,true,2582491281,28,2558330803,-24160478
1646778083,197756,true,2582233058,28,2558586636,-23646422
1646778103,197757,true,2581974860,28,2558586636,-23388224
1646778696,197755,true,2582491281,28,2561402489,-21088792
1646778704,197756,true,2582233058,28,2561402489,-20830569
1646780539,197757,true,2581974860,28,2568070467,-13904393
1646781011,197759,true,2581458543,28,2568840965,-12617578
1646781271,197757,true,2581974860,28,2569097849,-12877011
1646781892,197759,true,2581458543,28,2569611694,-11846849
1646782110,197760,true,2581200423,28,2570125642,-11074781
1646782122,197761,true,2580942328,28,2570125642,-10816686
1646782347,197760,true,2581200423,28,2571410962,-9789461
1646782470,197761,true,2580942328,28,2571925270,-9017058
1646784181,197762,true,2580684260,28,2578104995,-2579265
1646784723,197763,true,2580426217,28,2578362805,-2063412
1646786805,197761,true,2580942328,28,2576816329,-4125999
1646786835,197762,true,2580684260,28,2577074010,-3610250
1646787031,197762,true,2580684260,28,2577331718,-3352542
1646787602,197763,true,2580426217,28,2579136391,-1289826
1646787609,197761,true,2580942328,28,2579136391,-1805937
1646788408,197761,true,2580942328,28,2584299567,3357239
1646788718,197761,true,2580942328,28,2586367731,5425403
1646788786,197762,true,2580684260,28,2586626368,5942108
1646789253,197761,true,2580942328,28,2588955263,8012935
1646789281,197761,true,2580942328,28,2589214158,8271830
1646789333,197761,true,2580942328,28,2589473080,8530752
1646789347,197762,true,2580684260,28,2589473080,8788820
1646789432,197760,true,2581200423,28,2590249999,9049576
1646789510,197760,true,2581200423,28,2590768075,9567652
1646789531,197760,true,2581200423,28,2591027152,9826729
1646789571,197761,true,2580942328,28,2591545383,10603055
1646789583,197759,true,2581458543,28,2591545383,10086840
1646789591,197759,true,2581458543,28,2591545383,10086840
1646790064,197757,true,2581974860,28,2598291831,16316971
1646790459,197758,true,2581716689,28,2603753703,22037014
1646790484,197756,true,2582233058,28,2604014079,21781021
1646790720,197755,true,2582491281,28,2607401329,24910048
1646790897,197755,true,2582491281,28,2610009904,27518623
1646792336,197757,true,2581974860,28,2616542765,34567905
1646793074,197755,true,2582491281,28,2616542765,34051484
1646793269,197754,true,2582749530,28,2616542765,33793235
1646793328,197754,true,2582749530,28,2617066099,34316569
1646793340,197757,true,2581974860,28,2617066099,35091239
1646794269,197754,true,2582749530,28,2622829694,40080164
1646795159,197753,true,2583007805,28,2626504043,43496238
1646796094,197753,true,2583007805,28,2625191185,42183380
1646796129,197756,true,2582233058,28,2625453704,43220646
1646796302,197753,true,2583007805,28,2626766694,43758889
1646796337,197752,true,2583266106,28,2627029371,43763265
1646796355,197749,true,2584041163,28,2627292073,43250910
1646796424,197751,true,2583524433,28,2628343148,44818715
1646796466,197747,true,2584557997,28,2629131730,44573733
1646796610,197745,true,2585074935,28,2631762045,46687110
1646796627,197742,true,2585850535,28,2632025221,46174686
1646796647,197742,true,2585850535,28,2632551652,46701117
1646796750,197737,true,2587143719,28,2634658431,47514712
1646796767,197735,true,2587661173,28,2634921897,47260724
1646796951,197731,true,2588696393,28,2640196750,51500357
1646796967,197730,true,2588955263,28,2640724816,51769553
1646797264,197725,true,2590249999,28,2649453165,59203166
1646797346,197722,true,2591027152,28,2651838627,60811475
1646797371,197718,true,2592063718,28,2652634258,60570540
1646797429,197718,true,2592063718,28,2654491659,62427941
1646797441,197712,true,2593619345,28,2654757108,61137763
1646797490,197708,true,2594656949,28,2656350361,61693412
1646797622,197704,true,2595694967,28,2660603711,64908744
1646797696,197703,true,2595954537,28,2663265512,67310975
1646797732,197697,true,2597512499,28,2664330978,66818479
1646797789,197693,true,2598551660,28,2666196569,67644909
1646797831,197689,true,2599591236,28,2667796687,68205451
1646797930,197687,true,2600111181,28,2670999805,70888624
1646798154,197680,true,2601931804,28,2679292336,77360532
1646798175,197675,true,2603233031,28,2679828221,76595190
1646798319,197670,true,2604534907,28,2684119164,79584257
1646798401,197668,true,2605055841,28,2686267211,81211370
1646798710,197661,true,2606879927,28,2692183208,85303281
1646798790,197657,true,2607922835,28,2693529569,85606734
1646799500,197651,true,2609487980,28,2702972967,93484987
1646799568,197649,true,2610009904,28,2703513588,93503684
1646799643,197642,true,2611837459,28,2704324723,92487264
1646799671,197638,true,2612882351,28,2704595156,91712805
1646799688,197633,true,2614189053,28,2704595156,90406103
1646799866,197631,true,2614711917,28,2705406616,90694699
1646799873,197624,true,2616542765,28,2705406616,88863851
1646800037,197619,true,2617851298,28,2706488941,88637643
1646803186,197614,true,2619160485,28,2717879528,98719043
1646803263,197612,true,2619684343,28,2717879528,98195185
1646803281,197605,true,2621518673,28,2717879528,96360855
1646804319,197601,true,2622567437,28,2716249371,93681934
1646804530,197596,true,2623878983,28,2715977773,92098790
1646804583,197594,true,2624403785,28,2715706203,91302418
1646805438,197586,true,2626504043,28,2712991989,86487946
1646807759,197582,true,2627554803,28,2711635900,84081097
1646807887,197578,true,2628605982,28,2711635900,83029918
1646807904,197575,true,2629394643,28,2711907064,82512421
1646807950,197567,true,2631498895,28,2711907064,80408169
1646808227,197563,true,2632551652,28,2712178255,79626603
1646808261,197558,true,2633868192,28,2712178255,78310063
1646808369,197555,true,2634658431,28,2712178255,77519824
1646808823,197547,true,2636766896,28,2712991989,76225093
1646809078,197543,true,2637821761,28,2713805968,75984207
1646809118,197537,true,2639404849,28,2713805968,74401119
1646809818,197534,true,2640196750,28,2716249371,76052621
1646809908,197526,true,2642309647,28,2716249371,73939724
1646810138,197522,true,2643366729,28,2716792648,73425919
1646810395,197516,true,2644953146,28,2717607767,72654621
1646810550,197512,true,2646011286,28,2718151316,72140030
1646810567,197504,true,2648128836,28,2718151316,70022480
1646810730,197500,true,2649188246,28,2718423131,69234885
1646811020,197493,true,2651043235,28,2721414892,70371657
1646811134,197489,true,2652103811,28,2722503621,70399810
1646811164,197481,true,2654226237,28,2723048149,68821912
1646811205,197476,true,2655553615,28,2723592786,68039171
1646811494,197468,true,2657678802,28,2726862896,69184094
1646811705,197464,true,2658742033,28,2729318054,70576021
1646812059,197457,true,2660603711,28,2733414898,72811187
1646812104,197452,true,2661934279,28,2733961609,72027330
1646812865,197445,true,2663798192,28,2739160814,75362622
1646812976,197441,true,2664863871,28,2739434730,74570859
1646813087,197434,true,2666729835,28,2739708673,72978838
1646813126,197429,true,2668063467,28,2739708673,71645206
1646813200,197422,true,2669931672,28,2739708673,69777001
1646813232,197418,true,2670999805,28,2739708673,68708868
1646813490,197413,true,2672335572,28,2738613064,66277492
1646814655,197408,true,2673672007,28,2733414898,59742891
1646814991,197401,true,2675544139,28,2731775423,56231284
1646815353,197398,true,2676346882,28,2731502273,55155391
1646815370,197392,true,2677953092,28,2731775423,53822331
1646815661,197387,true,2679292336,28,2733141584,53849248
1646815684,197380,true,2681168404,28,2733141584,51973180
1646815721,197376,true,2682241032,28,2733414898,51173866
1646815817,197370,true,2683850779,28,2734508428,50657649
1646815877,197365,true,2685192973,28,2735055357,49862384
1646815892,197358,true,2687073172,28,2735328863,48255691
1646816017,197354,true,2688148162,28,2736696801,48548639
1646816063,197348,true,2689761454,28,2737517892,47756438
1646816067,197343,true,2691106604,28,2737517892,46411288
1646816640,197336,true,2692990944,28,2747664961,54674017
1646816767,197331,true,2694337709,28,2749863863,55526154
1646816802,197326,true,2695685147,28,2750413863,54728716
1646817229,197321,true,2697033259,28,2757022453,59989194
1646817276,197314,true,2698921749,28,2757573885,58652136
1646818296,197310,true,2700001480,28,2761713143,61711663
1646819017,197305,true,2701351750,28,2761160883,59809133
1646819218,197301,true,2702432453,28,2761160883,58728430
1646819447,197294,true,2704324723,28,2761160883,56836160
1646819781,197290,true,2705406616,28,2761160883,55754267
1646820066,197285,true,2706759589,28,2761160883,54401294
1646820091,197281,true,2707842456,28,2761160883,53318427
1646820228,197275,true,2709467567,28,2761160883,51693316
1646820345,197271,true,2710551517,28,2760884795,50333278
1646820479,197267,true,2711635900,28,2760608734,48972834
1646820691,197262,true,2712991989,28,2760056695,47064706
1646821367,197256,true,2714620192,28,2758677080,44056888
1646821472,197253,true,2715434659,28,2758677080,43242421
1646822140,197249,true,2716520996,28,2756746778,40225782
1646822703,197245,true,2717607767,28,2755368819,37761052
1646823711,197239,true,2719238740,28,2753165515,33926775
1646823795,197236,true,2720054593,28,2753165515,33110922
1646824372,197232,true,2721142778,28,2753165515,32022737
1646825216,197229,true,2721959202,28,2753991547,32032345
1646825611,197224,true,2723320454,28,2753991547,30671093
1646825802,197221,true,2724137532,28,2753991547,29854015
1646826027,197219,true,2724682387,28,2753716176,29033789
1646826209,197216,true,2725499873,28,2753165515,27665642
1646826341,197212,true,2726590237,28,2752890226,26299989
1646826614,197209,true,2727408296,28,2752064524,24656228
1646827886,197207,true,2727953805,28,2749313973,21360168
1646827916,197205,true,2728499423,28,2749313973,20814550
1646827982,197201,true,2729590986,28,2749313973,19722987
1646828263,197199,true,2730136932,28,2749313973,19177041
1646828327,197198,true,2730409945,28,2749313973,18904028
1646828351,197195,true,2731229150,28,2749313973,18084823
1646828682,197192,true,2732048601,28,2749863863,17815262
1646828749,197189,true,2732868297,28,2749863863,16995566
1646828877,197188,true,2733141584,28,2750413863,17272279
1646829152,197186,true,2733688240,28,2751514194,17825954
1646829317,197182,true,2734781879,28,2752339731,17557852
1646829482,197180,true,2735328863,28,2753165515,17836652
1646829703,197179,true,2735602396,28,2753440832,17838436
1646829755,197177,true,2736149544,28,2753440832,17291288
1646829883,197174,true,2736970471,28,2752614965,15644494
1646829926,197172,true,2737517892,28,2752339731,14821839
1646830595,197173,true,2737244168,28,2747939728,10695560
1646832159,197171,true,2737791644,28,2738886925,1095281
1646833228,197169,true,2738339230,28,2738886925,547695
1646833295,197167,true,2738886925,28,2738886925,0
1646833320,197169,true,2738339230,28,2738886925,547695
1646833436,197167,true,2738886925,28,2738613064,-273861
1646833477,197165,true,2739434730,28,2738613064,-821666
1646833504,197164,true,2739708673,28,2738339230,-1369443
1646833605,197165,true,2739434730,28,2737791644,-1643086
1646833884,197164,true,2739708673,28,2735875956,-3832717
1646833961,197162,true,2740256642,28,2735328863,-4927779
1646834051,197161,true,2740530668,28,2734508428,-6022240
1646834206,197163,true,2739982644,28,2732868297,-7114347
1646834422,197163,true,2739982644,28,2730956055,-9026589
1646834565,197161,true,2740530668,28,2729590986,-10939682
1646834773,197160,true,2740804721,28,2727681036,-13123685
1646834807,197162,true,2740256642,28,2727408296,-12848346
1646834855,197162,true,2740256642,28,2726862896,-13393746
1646834900,197160,true,2740804721,28,2726590237,-14214484
1646835198,197158,true,2741352909,28,2726862896,-14490013
1646835493,197159,true,2741078801,28,2728499423,-12579378
1646835699,197158,true,2741352909,28,2729863945,-11488964
1646835708,197157,true,2741627045,28,2729863945,-11763100
1646836895,197154,true,2742449615,28,2738613064,-3836551
1646837834,197156,true,2741901207,28,2738613064,-3288143
1646840545,197155,true,2742175397,28,2738339230,-3836167
1646840593,197153,true,2742723860,28,2738613064,-4110796
1646840614,197151,true,2743272432,28,2738613064,-4659368
1646840628,197153,true,2742723860,28,2738613064,-4110796
1646840666,197152,true,2742998132,28,2738613064,-4385068
1646840678,197150,true,2743546759,28,2738613064,-4933695
1646840926,197146,true,2744644343,28,2741352909,-3291434
1646841103,197148,true,2744095496,28,2743272432,-823064
1646841207,197147,true,2744369906,28,2744369906,0
1646841693,197145,true,2744918807,28,2749039069,4120262
1646842221,197141,true,2746016939,28,2753991547,7974608
1646842277,197143,true,2745467818,28,2754542373,9074555
1646842353,197142,true,2745742365,28,2755093309,9350944
1646843787,197142,true,2745742365,28,2751239070,5496705
1646844817,197139,true,2746566170,28,2750688905,4122735
1646846358,197140,true,2746291541,28,2750963973,4672432
1646846411,197140,true,2746291541,28,2750963973,4672432
1646846466,197140,true,2746291541,28,2750963973,4672432
1646846511,197137,true,2747115511,28,2750963973,3848462
1646848845,197140,true,2746291541,28,2743821114,-2470427
1646849389,197139,true,2746566170,28,2743821114,-2745056
1646849447,197140,true,2746291541,28,2743821114,-2470427
1646849483,197137,true,2747115511,28,2743821114,-3294397
1646849496,197139,true,2746566170,28,2743821114,-2745056
1646849609,197139,true,2746566170,28,2743821114,-2745056
1646849871,197140,true,2746291541,28,2742998132,-3293409
1646849921,197137,true,2747115511,28,2742998132,-4117379
1646850040,197138,true,2746840827,28,2742449615,-4391212
1646850072,197138,true,2746840827,28,2742175397,-4665430
1646850076,197139,true,2746566170,28,2742175397,-4390773
1646850079,197136,true,2747390222,28,2742175397,-5214825
1646850890,197139,true,2746566170,28,2733688240,-12877930
1646851236,197140,true,2746291541,28,2729590986,-16700555
1646851279,197141,true,2746016939,28,2729045150,-16971789
1646851403,197139,true,2746566170,28,2727681036,-18885134
1646851619,197142,true,2745742365,28,2724682387,-21059978
1646851702,197144,true,2745193299,28,2723592786,-21600513
1646851722,197145,true,2744918807,28,2723320454,-21598353
1646851775,197144,true,2745193299,28,2722503621,-22689678
1646853069,197148,true,2744095496,28,2710822572,-33272924
1646853240,197150,true,2743546759,28,2710009488,-33537271
1646853372,197152,true,2742998132,28,2709196648,-33801484
1646853396,197151,true,2743272432,28,2708925755,-34346677
1646853409,197156,true,2741901207,28,2708925755,-32975452
1646854091,197159,true,2741078801,28,2700811561,-40267240
1646854298,197161,true,2740530668,28,2698382046,-42148622
1646854332,197160,true,2740804721,28,2698112234,-42692487
1646854405,197165,true,2739434730,28,2697572693,-41862037
1646854425,197168,true,2738613064,28,2697572693,-41040371
1646854897,197170,true,2738065423,28,2695146091,-42919332
1646854978,197168,true,2738613064,28,2694607142,-44005922
1646855034,197173,true,2737244168,28,2694337709,-42906459
1646855110,197176,true,2736423159,28,2694337709,-42085450
1646855153,197177,true,2736149544,28,2694337709,-41811835
1646855284,197176,true,2736423159,28,2695146091,-41277068
1646855336,197180,true,2735328863,28,2695685147,-39643716
1646855377,197183,true,2734508428,28,2696224311,-38284117
1646855397,197184,true,2734235005,28,2696493933,-37741072
1646855439,197182,true,2734781879,28,2697033259,-37748620
1646855465,197186,true,2733688240,28,2697302962,-36385278
1646855584,197189,true,2732868297,28,2698921749,-33946548
1646856158,197189,true,2732868297,28,2706218319,-26649978
1646856177,197187,true,2733414898,28,2706488941,-26925957
1646856343,197191,true,2732321806,28,2707571699,-24750107
1646856381,197194,true,2731502273,28,2708113240,-23389033
1646857134,197194,true,2731502273,28,2715706203,-15796070
1646857238,197192,true,2732048601,28,2716249371,-15799230
1646857427,197196,true,2730956055,28,2717064327,-13891728
1646857607,197198,true,2730409945,28,2717879528,-12530417
1646857752,197198,true,2730409945,28,2718423131,-11986814
1646857883,197196,true,2730956055,28,2718694974,-12261081
1646858020,197200,true,2729863945,28,2718966843,-10897102
1646858055,197202,true,2729318054,28,2718966843,-10351211
1646858066,197202,true,2729318054,28,2718966843,-10351211
1646858093,197200,true,2729863945,28,2719238740,-10625205
1646858121,197204,true,2728772273,28,2719238740,-9533533
1646858182,197207,true,2727953805,28,2718966843,-8986962
1646858203,197207,true,2727953805,28,2718966843,-8986962
1646858284,197205,true,2728499423,28,2718423131,-10076292
1646858330,197210,true,2727135582,28,2718151316,-8984266
1646858376,197213,true,2726317605,28,2717879528,-8438077
1646858391,197213,true,2726317605,28,2717607767,-8709838
1646858520,197212,true,2726590237,28,2716792648,-9797589
1646858542,197216,true,2725499873,28,2716520996,-8978877
1646858570,197219,true,2724682387,28,2716249371,-8433016
1646858619,197219,true,2724682387,28,2715706203,-8976184
1646859089,197218,true,2724954855,28,2710551517,-14403338
1646859143,197222,true,2723865146,28,2709467567,-14397579
1646859171,197225,true,2723048149,28,2709196648,-13851501
1646859227,197225,true,2723048149,28,2708113240,-14934909
1646859887,197225,true,2723048149,28,2697033259,-26014890
1646859908,197228,true,2722231398,28,2696763583,-25467815
1646859917,197231,true,2721414892,28,2696493933,-24920959
1646860047,197231,true,2721414892,28,2695146091,-26268801
1646860062,197231,true,2721414892,28,2694876603,-26538289
1646862000,197234,true,2720598631,28,2690299433,-30299198
1646862020,197236,true,2720054593,28,2690568463,-29486130
1646862039,197236,true,2720054593,28,2690568463,-29486130
1646862076,197235,true,2720326598,28,2690568463,-29758135
1646862091,197238,true,2719510664,28,2690568463,-28942201
1646862631,197240,true,2718966843,28,2692452426,-26514417
1646862680,197239,true,2719238740,28,2692721672,-26517068
1646862725,197239,true,2719238740,28,2692990944,-26247796
1646863516,197240,true,2718966843,28,2699191641,-19775202
1646863737,197242,true,2718423131,28,2701081642,-17341489
1646863759,197242,true,2718423131,28,2701351750,-17071381
1646863783,197242,true,2718423131,28,2701621886,-16801245
1646864744,197244,true,2717879528,28,2707300968,-10578560
1646864813,197246,true,2717336034,28,2707571699,-9764335
1646865023,197245,true,2717607767,28,2708113240,-9494527
1646865046,197246,true,2717336034,28,2708384051,-8951983
1646865102,197248,true,2716792648,28,2708384051,-8408597
1646865112,197250,true,2716249371,28,2708384051,-7865320
1646865125,197249,true,2716520996,28,2708654890,-7866106
1646865133,197250,true,2716249371,28,2708654890,-7594481
1646865154,197251,true,2715977773,28,2708654890,-7322883
1646865309,197253,true,2715434659,28,2709738514,-5696145
1646865321,197252,true,2715706203,28,2710009488,-5696715
1646865336,197255,true,2714891654,28,2710009488,-4882166
1646865770,197256,true,2714620192,28,2712720717,-1899475
1646865774,197258,true,2714077349,28,2712991989,-1085360
1646866120,197257,true,2714348757,28,2714348757,0
1646866472,197260,true,2713534615,28,2715434659,1900044
1646867405,197261,true,2713263289,28,2716249371,2986082
1646868351,197263,true,2712720717,28,2715706203,2985486
1646868426,197262,true,2712991989,28,2715706203,2714214
1646868593,197264,true,2712449472,28,2715706203,3256731
1646868673,197266,true,2711907064,28,2715706203,3799139
1646868881,197267,true,2711635900,28,2716249371,4613471
1646868916,197267,true,2711635900,28,2716249371,4613471
1646869046,197268,true,2711364764,28,2716792648,5427884
1646869388,197269,true,2711093654,28,2718694974,7601320
1646870070,197270,true,2710822572,28,2722231398,11408826
1646870225,197269,true,2711093654,28,2723048149,11954495
1646871404,197271,true,2710551517,28,2726590237,16038720
1646872302,197271,true,2710551517,28,2727408296,16856779
1646872341,197272,true,2710280489,28,2727408296,17127807
1646872373,197271,true,2710551517,28,2727408296,16856779
1646872426,197272,true,2710280489,28,2727408296,17127807
1646872449,197273,true,2710009488,28,2727135582,17126094
1646872590,197274,true,2709738514,28,2726317605,16579091
1646872682,197273,true,2710009488,28,2725772423,15762935
1646873490,197274,true,2709738514,28,2721414892,11676378
1646873891,197274,true,2709738514,28,2718423131,8684617
1646874193,197275,true,2709467567,28,2716249371,6781804
1646874256,197274,true,2709738514,28,2715977773,6239259
1646874952,197276,true,2709196648,28,2711093654,1897006
1646875014,197276,true,2709196648,28,2710551517,1354869
1646875215,197277,true,2708925755,28,2709467567,541812
1646875227,197276,true,2709196648,28,2709467567,270919
1646875242,197277,true,2708925755,28,2709196648,270893
1646875383,197276,true,2709196648,28,2708654890,-541758
1646875446,197277,true,2708925755,28,2708384051,-541704
1646875494,197276,true,2709196648,28,2708384051,-812597
1646875518,197277,true,2708925755,28,2708384051,-541704
1646875536,197275,true,2709467567,28,2708384051,-1083516
1646875543,197274,true,2709738514,28,2708384051,-1354463
1646875553,197272,true,2710280489,28,2708384051,-1896438
1646876257,197274,true,2709738514,28,2710280489,541975
1646876406,197272,true,2710280489,28,2710551517,271028
1646876410,197271,true,2710551517,28,2710551517,0
1646876587,197271,true,2710551517,28,2710280489,-271028
1646876648,197273,true,2710009488,28,2710009488,0
1646876713,197272,true,2710280489,28,2709738514,-541975
1646876822,197271,true,2710551517,28,2709196648,-1354869
1646876894,197272,true,2710280489,28,2708113240,-2167249
1646876902,197275,true,2709467567,28,2707842456,-1625111
1646877282,197275,true,2709467567,28,2701081642,-8385925
1646877508,197276,true,2709196648,28,2694607142,-14589506
1646877527,197277,true,2708925755,28,2694068302,-14857453
1646877544,197280,true,2708113240,28,2693529569,-14583671
1646878148,197281,true,2707842456,28,2677685323,-30157133
1646878202,197282,true,2707571699,28,2676346882,-31224817
1646878214,197283,true,2707300968,28,2676079274,-31221694
1646878487,197286,true,2706488941,28,2670732731,-35756210
1646878954,197287,true,2706218319,28,2666729835,-39488484
1646879230,197288,true,2705947724,28,2666196569,-39751155
1646880456,197290,true,2705406616,28,2665663410,-39743206
1646880804,197293,true,2704595156,28,2665663410,-38931746
1646881232,197295,true,2704054318,28,2665929976,-38124342
1646882267,197295,true,2704054318,28,2665396870,-38657448
1646882693,197297,true,2703513588,28,2665130357,-38383231
1646885572,197300,true,2702702696,28,2665396870,-37305826
1646885709,197302,true,2702162237,28,2665396870,-36765367
1646885748,197302,true,2702162237,28,2665396870,-36765367
1646885892,197304,true,2701621886,28,2665396870,-36225016
1646885998,197307,true,2700811561,28,2665130357,-35681204
1646886019,197308,true,2700541507,28,2665130357,-35411150
1646886180,197310,true,2700001480,28,2662999212,-37002268
1646886237,197312,true,2699461560,28,2662466692,-36994868
1646886257,197316,true,2698382046,28,2661934279,-36447767
1646886381,197318,true,2697842450,28,2659805689,-38036761
1646886397,197320,true,2697302962,28,2659539735,-37763227
1646886467,197322,true,2696763583,28,2658210364,-38553219
1646886697,197326,true,2695685147,28,2653960841,-41724306
1646886747,197328,true,2695146091,28,2652634258,-42511833
1646886816,197330,true,2694607142,28,2651043235,-43563907
1646886839,197332,true,2694068302,28,2650513105,-43555197
1646886976,197337,true,2692721672,28,2647069849,-45651823
1646886993,197339,true,2692183208,28,2646540515,-45642693
1646887031,197341,true,2691644852,28,2645482163,-46162689
1646887070,197343,true,2691106604,28,2644424235,-46682369
1646887108,197347,true,2690030430,28,2643366729,-46663701
1646887379,197348,true,2689761454,28,2635712453,-54049001
1646887384,197351,true,2688954687,28,2635712453,-53242234
1646887450,197353,true,2688416977,28,2633604831,-54812146
1646887536,197357,true,2687341879,28,2630446559,-56895320
1646888459,197361,true,2686267211,28,2607401329,-78865882
1646888676,197363,true,2685730038,28,2604534907,-81195131
1646888864,197365,true,2685192973,28,2602712462,-82480511
1646888875,197369,true,2684119164,28,2602452217,-81666947
1646888879,197373,true,2683045785,28,2602452217,-80593568
1646888888,197376,true,2682241032,28,2602452217,-79788815
1646889139,197378,true,2681704664,28,2600111181,-81593483
1646889151,197383,true,2680364214,28,2600111181,-80253033
1646889608,197387,true,2679292336,28,2599071396,-80220940
1646889626,197390,true,2678488709,28,2599071396,-79417313
1646891568,197393,true,2677685323,28,2598811515,-78873808
1646891612,197397,true,2676614517,28,2598811515,-77803002
1646891641,197402,true,2675276611,28,2598811515,-76465096
1646891644,197405,true,2674474188,28,2598811515,-75662673
1646891681,197409,true,2673404666,28,2598551660,-74853006
1646891717,197413,true,2672335572,28,2598291831,-74043741
1646891895,197418,true,2670999805,28,2597512499,-73487306
1646892254,197421,true,2670198665,28,2595694967,-74503698
1646892473,197425,true,2669130852,28,2594656949,-74473903
1646893022,197430,true,2667796687,28,2592063718,-75732969
1646893325,197435,true,2666463189,28,2590509024,-75954165
1646893375,197438,true,2665663410,28,2590249999,-75413411
1646893476,197442,true,2664597411,28,2590249999,-74347412
1646893479,197447,true,2663265512,28,2590249999,-73015513
1646893539,197453,true,2661668112,28,2590249999,-71418113
1646893647,197456,true,2660869771,28,2589991000,-70878771
1646893662,197460,true,2659805689,28,2589732027,-70073662
1646893716,197465,true,2658476185,28,2589732027,-68744158
1646894161,197471,true,2656881658,28,2587661173,-69220485
1646894193,197474,true,2656084753,28,2587661173,-68423580
1646894234,197478,true,2655022584,28,2587402433,-67620151
1646894299,197483,true,2653695471,28,2587402433,-66293038
1646894334,197488,true,2652369021,28,2587402433,-64966588
1646895173,197491,true,2651573470,28,2585850535,-65722935
1646895275,197495,true,2650513105,28,2585850535,-64662570
1646895528,197500,true,2649188246,28,2586109120,-63079126
1646895539,197506,true,2647599290,28,2586367731,-61231559
1646895920,197510,true,2646540515,28,2587919939,-58620576
1646896259,197513,true,2645746711,28,2588696393,-57050318
1646897576,197519,true,2644159819,28,2590249999,-53909820
1646897759,197525,true,2642573878,28,2590249999,-52323879
1646898578,197528,true,2641781264,28,2590509024,-51272240
1646898601,197532,true,2640724816,28,2590509024,-50215792
1646898605,197537,true,2639404849,28,2590509024,-48895825
1646898925,197542,true,2638085543,28,2591027152,-47058391
1646899754,197545,true,2637294275,28,2592582157,-44712118
1646900068,197549,true,2636239621,28,2592841415,-43398206
1646900078,197554,true,2634921897,28,2592841415,-42080482
1646900089,197559,true,2633604831,28,2592841415,-40763416
1646900105,197562,true,2632814908,28,2592841415,-39973493
1646900670,197566,true,2631762045,28,2591545383,-40216662
1646900707,197570,true,2630709603,28,2591545383,-39164220
1646900822,197575,true,2629394643,28,2591027152,-38367491
1646901070,197578,true,2628605982,28,2589473080,-39132902
1646901322,197582,true,2627554803,28,2588178731,-39376072
1646901398,197587,true,2626241419,28,2587661173,-38580246
1646901482,197592,true,2624928692,28,2587402433,-37526259
1646901535,197594,true,2624403785,28,2587143719,-37260066
1646901557,197599,true,2623091977,28,2587143719,-35948258
1646901570,197603,true,2622043003,28,2587143719,-34899284
1646901607,197608,true,2620732374,28,2587143719,-33588655
1646901636,197611,true,2619946312,28,2587143719,-32802593
1646902756,197615,true,2618898595,28,2589732027,-29166568
1646902792,197620,true,2617589539,28,2589991000,-27598539
1646902867,197624,true,2616542765,28,2590249999,-26292766
1646903768,197627,true,2615757959,28,2593360009,-22397950
1646903811,197631,true,2614711917,28,2593360009,-21351908
1646903821,197634,true,2613927660,28,2593360009,-20567651
1646903942,197639,true,2612621088,28,2593619345,-19001743
1646903983,197641,true,2612098643,28,2593619345,-18479298
1646903994,197644,true,2611315170,28,2593878707,-17436463
1646904047,197647,true,2610531932,28,2593878707,-16653225
1646904669,197650,true,2609748929,28,2595954537,-13794392
1646905160,197651,true,2609487980,28,2596993074,-12494906
1646905163,197654,true,2608705290,28,2596993074,-11712216
1646905169,197657,true,2607922835,28,2596993074,-10929761
1646905528,197659,true,2607401329,28,2598551660,-8849669
1646905790,197660,true,2607140615,28,2599591236,-7549379
1646905863,197663,true,2606358629,28,2599851195,-6507434
1646906011,197666,true,2605576878,28,2600111181,-5465697
1646906048,197667,true,2605316346,28,2600371192,-4945154
1646906345,197668,true,2605055841,28,2601151381,-3904460
1646906929,197671,true,2604274480,28,2603233031,-1041449
1646908135,197674,true,2603493354,28,2603753703,260349
1646908310,197676,true,2602972733,28,2603753703,780970
1646908316,197677,true,2602712462,28,2603753703,1041241
1646908391,197679,true,2602191998,28,2603753703,1561705
1646908714,197682,true,2601411496,28,2603753703,2342207
1646908738,197684,true,2600891292,28,2603753703,2862411
1646908766,197685,true,2600631229,28,2603753703,3122474
1646909600,197688,true,2599851195,28,2601151381,1300186
1646909630,197691,true,2599071396,28,2601151381,2079985
1646909750,197693,true,2598551660,28,2600631229,2079569
1646909903,197693,true,2598551660,28,2599851195,1299535
1646910379,197696,true,2597772250,28,2597772250,0
1646910476,197698,true,2597252774,28,2597252774,0
1646910931,197699,true,2596993074,28,2595954537,-1038537
1646911028,197699,true,2596993074,28,2595694967,-1298107
1646914631,197701,true,2596473754,28,2593619345,-2854409
1646914993,197703,true,2595954537,28,2593619345,-2335192
1646915078,197704,true,2595694967,28,2593878707,-1816260
1646915086,197704,true,2595694967,28,2593878707,-1816260
1646915166,197706,true,2595175906,28,2593878707,-1297199
1646915201,197707,true,2594916414,28,2594138095,-778319
1646915202,197707,true,2594916414,28,2594138095,-778319
1646917568,197706,true,2595175906,28,2603233031,8057125
1646917620,197708,true,2594656949,28,2603233031,8576082
1646918310,197708,true,2594656949,28,2603233031,8576082
1646918712,197709,true,2594397509,28,2603233031,8835522
1646919008,197707,true,2594916414,28,2603233031,8316617
1646919035,197709,true,2594397509,28,2603493354,9095845
1646919054,197709,true,2594397509,28,2603753703,9356194
1646919060,197708,true,2594656949,28,2603753703,9096754
1646919076,197705,true,2595435424,28,2604014079,8578655
1646919085,197706,true,2595175906,28,2604014079,8838173
1646919194,197706,true,2595175906,28,2605576878,10400972
1646919208,197705,true,2595435424,28,2605576878,10141454
1646919249,197700,true,2596733401,28,2606358629,9625228
1646919281,197702,true,2596214132,28,2607140615,10926483
1646919342,197700,true,2596733401,28,2608444446,11711045
1646919428,197700,true,2596733401,28,2608705290,11971889
1646919437,197697,true,2597512499,28,2608705290,11192791
1646919571,197700,true,2596733401,28,2608705290,11971889
1646919577,197699,true,2596993074,28,2608705290,11712216
1646919690,197700,true,2596733401,28,2608966161,12232760
1646919740,197696,true,2597772250,28,2608705290,10933040
1646919801,197698,true,2597252774,28,2608705290,11452516
1646919819,197697,true,2597512499,28,2608444446,10931947
1646919849,197699,true,2596993074,28,2608183627,11190553
1646919854,197696,true,2597772250,28,2608183627,10411377
1646919874,197699,true,2596993074,28,2607922835,10929761
1646919890,197699,true,2596993074,28,2607401329,10408255
1646920017,197702,true,2596214132,28,2604795361,8581229
1646920370,197699,true,2596993074,28,2597252774,259700
1646920382,197702,true,2596214132,28,2596993074,778942
1646920404,197702,true,2596214132,28,2596733401,519269
1646920511,197705,true,2595435424,28,2595435424,0
1646920634,197700,true,2596733401,28,2593878707,-2854694
1646920956,197703,true,2595954537,28,2587661173,-8293364
1646921986,197703,true,2595954537,28,2577589451,-18365086
1646921992,197705,true,2595435424,28,2577589451,-17845973
1646922343,197701,true,2596473754,28,2579136391,-17337363
1646922382,197704,true,2595694967,28,2579394305,-16300662
1646922723,197703,true,2595954537,28,2579910210,-16044327
1646922778,197706,true,2595175906,28,2579652244,-15523662
1646922820,197702,true,2596214132,28,2579652244,-16561888
1646922843,197705,true,2595435424,28,2579394305,-16041119
1646922846,197705,true,2595435424,28,2579394305,-16041119
1646923138,197707,true,2594916414,28,2579652244,-15264170
1646923305,197703,true,2595954537,28,2579652244,-16302293
1646924143,197706,true,2595175906,28,2581458543,-13717363
1646924225,197706,true,2595175906,28,2581716689,-13459217
1646924400,197708,true,2594656949,28,2582491281,-12165668
1646924759,197703,true,2595954537,28,2585333442,-10621095
1646925145,197706,true,2595175906,28,2587919939,-7255967
1646925384,197706,true,2595175906,28,2590249999,-4925907
1646925426,197708,true,2594656949,28,2590768075,-3888874
1646926044,197702,true,2596214132,28,2601411496,5197364
1646926105,197703,true,2595954537,28,2602191998,6237461
1646926124,197703,true,2595954537,28,2602452217,6497680
1646926213,197705,true,2595435424,28,2603493354,8057930
1646926234,197699,true,2596993074,28,2603753703,6760629
1646926339,197700,true,2596733401,28,2604795361,8061960
1646926373,197700,true,2596733401,28,2605055841,8322440
1646926383,197702,true,2596214132,28,2605055841,8841709
1646926420,197696,true,2597772250,28,2605316346,7544096
1646926455,197698,true,2597252774,28,2605316346,8063572
1646927240,197699,true,2596993074,28,2603233031,6239957
1646927277,197701,true,2596473754,28,2602712462,6238708
1646927319,197695,true,2598032027,28,2602191998,4159971
1646927520,197697,true,2597512499,28,2600891292,3378793
1646928467,197697,true,2597512499,28,2598551660,1039161
1646930118,197699,true,2596993074,28,2600371192,3378118
1646930145,197694,true,2598291831,28,2600371192,2079361
1646930173,197696,true,2597772250,28,2600371192,2598942
1646930183,197696,true,2597772250,28,2600371192,2598942
1646930339,197698,true,2597252774,28,2600111181,2858407
1646930610,197693,true,2598551660,28,2599331303,779643
1646930669,197695,true,2598032027,28,2599331303,1299276
1646930820,197696,true,2597772250,28,2598811515,1039265
1646930878,197698,true,2597252774,28,2598551660,1298886
1646932407,197693,true,2598551660,28,2593619345,-4932315
1646932913,197696,true,2597772250,28,2593360009,-4412241
1646933859,197696,true,2597772250,28,2594656949,-3115301
1646933934,197699,true,2596993074,28,2594916414,-2076660
1646934459,197694,true,2598291831,28,2595694967,-2596864
1646934779,197696,true,2597772250,28,2596214132,-1558118
1646935475,197696,true,2597772250,28,2596473754,-1298496
1646935541,197699,true,2596993074,28,2596473754,-519320
1646936184,197695,true,2598032027,28,2596473754,-1558273
1646936227,197697,true,2597512499,28,2596473754,-1038745
1646938011,197697,true,2597512499,28,2595175906,-2336593
1646938571,197700,true,2596733401,28,2595175906,-1557495
1646939058,197696,true,2597772250,28,2595435424,-2336826
1646939091,197698,true,2597252774,28,2595435424,-1817350
1646941307,197698,true,2597252774,28,2601411496,4158722
1646941676,197701,true,2596473754,28,2601411496,4937742
1646941700,197696,true,2597772250,28,2601411496,3639246
1646941734,197698,true,2597252774,28,2601671637,4418863
1646943559,197697,true,2597512499,28,2610270905,12758406
1646944668,197700,true,2596733401,28,2610531932,13798531
1646945577,197695,true,2598032027,28,2610009904,11977877
1646945649,197697,true,2597512499,28,2610009904,12497405
1646945711,197696,true,2597772250,28,2610009904,12237654
1646945874,197698,true,2597252774,28,2610270905,13018131
1646946216,197693,true,2598551660,28,2610792985,12241325
1646946288,197695,true,2598032027,28,2611054064,13022037
1646947272,197693,true,2598551660,28,2613404953,14853293
1646949349,197695,true,2598032027,28,2614189053,16157026
1646949572,197690,true,2599331303,28,2614189053,14857750
1646949689,197692,true,2598811515,28,2613927660,15116145
1646949775,197690,true,2599331303,28,2613666294,14334991
1646949854,197693,true,2598551660,28,2613143639,14591979
1646950641,197689,true,2599591236,28,2607922835,8331599
1646952310,197691,true,2599071396,28,2602191998,3120602
1646952348,197689,true,2599591236,28,2602191998,2600762
1646952447,197693,true,2598551660,28,2602452217,3900557
1646952475,197689,true,2599591236,28,2602452217,2860981
1646952482,197690,true,2599331303,28,2602452217,3120914
1646953224,197689,true,2599591236,28,2605055841,5464605
1646953483,197692,true,2598811515,28,2606098019,7286504
1646953487,197688,true,2599851195,28,2606098019,6246824
1646953604,197690,true,2599331303,28,2606619265,7287962
1646953882,197688,true,2599851195,28,2607922835,8071640
1646954058,197691,true,2599071396,28,2608966161,9894765
1646954443,197689,true,2599591236,28,2610531932,10940696
1646956294,197691,true,2599071396,28,2613404953,14333557
1646956916,197690,true,2599331303,28,2613404953,14073650
1646956993,197693,true,2598551660,28,2613404953,14853293
1646956999,197692,true,2598811515,28,2613404953,14593438
1646957009,197693,true,2598551660,28,2613404953,14853293
1646957931,197694,true,2598291831,28,2609487980,11196149
1646958546,197696,true,2597772250,28,2606879927,9107677
1646958612,197694,true,2598291831,28,2606619265,8327434
1646958636,197695,true,2598032027,28,2606358629,8326602
1646958665,197694,true,2598291831,28,2606098019,7806188
1646958676,197697,true,2597512499,28,2606098019,8585520
1646958856,197695,true,2598032027,28,2604795361,6763334
1646959817,197695,true,2598032027,28,2601411496,3379469
1646960119,197694,true,2598291831,28,2600371192,2079361
1646960568,197696,true,2597772250,28,2599591236,1818986
1646960589,197694,true,2598291831,28,2599591236,1299405
1646960625,197693,true,2598551660,28,2599591236,1039576
1646960652,197692,true,2598811515,28,2599331303,519788
1646960659,197692,true,2598811515,28,2599331303,519788
1646960682,197691,true,2599071396,28,2599071396,0
1646960693,197690,true,2599331303,28,2599071396,-259907
1646960701,197689,true,2599591236,28,2599071396,-519840
1646960717,197691,true,2599071396,28,2598811515,-259881
1646960781,197691,true,2599071396,28,2598032027,-1039369
1646960933,197690,true,2599331303,28,2595954537,-3376766
1646961422,197689,true,2599591236,28,2590509024,-9082212
1646961603,197691,true,2599071396,28,2587919939,-11151457
1646962006,197692,true,2598811515,28,2581974860,-16836655
1646962614,197691,true,2599071396,28,2574755803,-24315593
1646963415,197691,true,2599071396,28,2571668103,-27403293
1646963637,197692,true,2598811515,28,2571410962,-27400553
1646963725,197693,true,2598551660,28,2571153847,-27397813
1646964437,197693,true,2598551660,28,2569354759,-29196901
1646964586,197691,true,2599071396,28,2569097849,-29973547
1646964650,197694,true,2598291831,28,2568840965,-29450866
1646964683,197695,true,2598032027,28,2568584107,-29447920
1646964700,197695,true,2598032027,28,2568327274,-29704753
1646964731,197695,true,2598032027,28,2568070467,-29961560
1646964757,197698,true,2597252774,28,2567813685,-29439089
1646964770,197700,true,2596733401,28,2567556930,-29176471
1646964792,197701,true,2596473754,28,2567300200,-29173554
1646964818,197701,true,2596473754,28,2566786817,-29686937
1646964912,197705,true,2595435424,28,2565503808,-29931616
1646964945,197708,true,2594656949,28,2564990784,-29666165
1646965501,197710,true,2594138095,28,2556540688,-37597407
1646966553,197711,true,2593878707,28,2543790524,-50088183
1646967125,197715,true,2592841415,28,2543536170,-49305245
1646967513,197718,true,2592063718,28,2543027539,-49036179
1646967581,197720,true,2591545383,28,2542773262,-48772121
1646967856,197721,true,2591286255,28,2541248132,-50038123
1646969524,197725,true,2590249999,28,2532116542,-58133457
1646969536,197728,true,2589473080,28,2532116542,-57356538
1646969548,197729,true,2589214158,28,2532116542,-57097616
1646969677,197729,true,2589214158,28,2532369753,-56844405
1646969688,197733,true,2588178731,28,2532622990,-55555741
1646970308,197735,true,2587661173,28,2534903263,-52757910
1646970335,197737,true,2587143719,28,2534903263,-52240456
1646970467,197738,true,2586885030,28,2535410269,-51474761
1646970479,197741,true,2586109120,28,2535663810,-50445310
1646970555,197744,true,2585333442,28,2535917376,-49416066
1646970731,197745,true,2585074935,28,2536678228,-48396707
1646970755,197746,true,2584816453,28,2536678228,-48138225
1646970795,197749,true,2584041163,28,2536931896,-47109267
1646970809,197752,true,2583266106,28,2537185589,-46080517
1646970959,197752,true,2583266106,28,2538454435,-44811671
1646971400,197753,true,2583007805,28,2542010582,-40997223
1646971710,197756,true,2582233058,28,2543536170,-38696888
1646973339,197758,true,2581716689,28,2547608882,-34107807
1646973414,197759,true,2581458543,28,2547608882,-33849661
1646974121,197759,true,2581458543,28,2546590093,-34868450
1646974301,197763,true,2580426217,28,2546080851,-34345366
1646974676,197765,true,2579910210,28,2545062673,-34847537
1646976872,197766,true,2579652244,28,2542264783,-37387461
1646976997,197767,true,2579394305,28,2542519010,-36875295
1646977031,197770,true,2578620641,28,2542519010,-36101631
1646977145,197773,true,2577847210,28,2542773262,-35073948
1646977168,197773,true,2577847210,28,2542773262,-35073948
1646977202,197773,true,2577847210,28,2543027539,-34819671
1646978293,197776,true,2577074010,28,2551177853,-25896157
1646978321,197778,true,2576558673,28,2551177853,-25380820
1646978558,197779,true,2576301043,28,2553219510,-23081533
1646978722,197779,true,2576301043,28,2554751825,-21549218
1646980146,197781,true,2575785860,28,2564734311,-11051549
1646980166,197783,true,2575270780,28,2564734311,-10536469
1646980230,197784,true,2575013279,28,2565503808,-9509471
1646980805,197785,true,2574755803,28,2571410962,-3344841
1646980841,197785,true,2574755803,28,2571668103,-3087700
1646981385,197788,true,2573983531,28,2576043438,2059907
1646981781,197788,true,2573983531,28,2579136391,5152860
1646982226,197789,true,2573726158,28,2580684260,6958102
1646982239,197789,true,2573726158,28,2580684260,6958102
1646982271,197792,true,2572954195,28,2580942328,7988133
1646982297,197792,true,2572954195,28,2580942328,7988133
1646982328,197793,true,2572696925,28,2581200423,8503498
1646982332,197793,true,2572696925,28,2581200423,8503498
1646982345,197795,true,2572182463,28,2581200423,9017960
1646982382,197795,true,2572182463,28,2581458543,9276080
1646982541,197795,true,2572182463,28,2582749530,10567067
1646983567,197795,true,2572182463,28,2591545383,19362920
1646983578,197797,true,2571668103,28,2591804538,20136435
1646983583,197796,true,2571925270,28,2591804538,19879268
1646983597,197796,true,2571925270,28,2591804538,19879268
1646985899,197794,true,2572439681,28,2608966161,36526480
1646986725,197796,true,2571925270,28,2608966161,37040891
1646987248,197796,true,2571925270,28,2608966161,37040891
1646987289,197796,true,2571925270,28,2608966161,37040891
1646987361,197794,true,2572439681,28,2608705290,36265609
1646987436,197796,true,2571925270,28,2608705290,36780020
1646987507,197796,true,2571925270,28,2608444446,36519176
1646987512,197797,true,2571668103,28,2608444446,36776343
1646987567,197795,true,2572182463,28,2608444446,36261983
1646987644,197797,true,2571668103,28,2607922835,36254732
1646987743,197798,true,2571410962,28,2607401329,35990367
1646987749,197798,true,2571410962,28,2607401329,35990367
1646989448,197797,true,2571668103,28,2599331303,27663200
1646989721,197799,true,2571153847,28,2599071396,27917549
1646989864,197800,true,2570896757,28,2599071396,28174639
1646990241,197799,true,2571153847,28,2599071396,27917549
1646990456,197797,true,2571668103,28,2599591236,27923133
1646991228,197799,true,2571153847,28,2601151381,29997534
1646992139,197800,true,2570896757,28,2602452217,31555460
1646992190,197800,true,2570896757,28,2602452217,31555460
1646993931,197797,true,2571668103,28,2601931804,30263701
1646994340,197799,true,2571153847,28,2601671637,30517790
1646996490,197800,true,2570896757,28,2601671637,30774880
1646997755,197799,true,2571153847,28,2601671637,30517790
1646997765,197797,true,2571668103,28,2601671637,30003534
1646997777,197799,true,2571153847,28,2601671637,30517790
1646997838,197800,true,2570896757,28,2601411496,30514739
1646997857,197800,true,2570896757,28,2601411496,30514739
1646997870,197797,true,2571668103,28,2601411496,29743393
1646997894,197798,true,2571410962,28,2601411496,30000534
1646997966,197797,true,2571668103,28,2601671637,30003534
1646997971,197796,true,2571925270,28,2601931804,30006534
1646997989,197793,true,2572696925,28,2601931804,29234879
1646998179,197792,true,2572954195,28,2603493354,30539159
1646998306,197791,true,2573211490,28,2604534907,31323417
1646998332,197791,true,2573211490,28,2604795361,31583871
1646998349,197787,true,2574240929,28,2605055841,30814912
1646998351,197787,true,2574240929,28,2605055841,30814912
1646998356,197785,true,2574755803,28,2605055841,30300038
1646998372,197785,true,2574755803,28,2605055841,30300038
1646998383,197781,true,2575785860,28,2605316346,29530486
1646998484,197780,true,2576043438,28,2606358629,30315191
1646998588,197778,true,2576558673,28,2607662069,31103396
1646998615,197777,true,2576816329,28,2607922835,31106506
1646998665,197773,true,2577847210,28,2608705290,30858080
1646998714,197772,true,2578104995,28,2609227057,31122062
1646998890,197769,true,2578878503,28,2612621088,33742585
1646999005,197767,true,2579394305,28,2614973388,35579083
1646999016,197761,true,2580942328,28,2615234886,34292558
1646999051,197760,true,2581200423,28,2616019535,34819112
1646999070,197756,true,2582233058,28,2616542765,34309707
1646999167,197753,true,2583007805,28,2619160485,36152680
1646999211,197747,true,2584557997,28,2620208306,35650309
1646999215,197745,true,2585074935,28,2620470327,35395392
1646999328,197741,true,2586109120,28,2623878983,37769863
1646999558,197737,true,2587143719,28,2631235771,44092052
1646999635,197732,true,2588437549,28,2633604831,45167282
1646999983,197730,true,2588955263,28,2640724816,51769553
1647000150,197726,true,2589991000,28,2643631066,53640066
1647000166,197722,true,2591027152,28,2644159819,53132667
1647000203,197716,true,2592582157,28,2644688677,52106520
1647000571,197714,true,2593100699,28,2650513105,57412406
1647001686,197709,true,2594397509,28,2654757108,60359599
1647001791,197705,true,2595435424,28,2655288086,59852662
1647001847,197699,true,2596993074,28,2655288086,58295012
1647001873,197697,true,2597512499,28,2655553615,58041116
1647002013,197692,true,2598811515,28,2656084753,57273238
1647002049,197689,true,2599591236,28,2656084753,56493517
1647002062,197683,true,2601151381,28,2656350361,55198980
1647002071,197681,true,2601671637,28,2656350361,54678724
1647002105,197675,true,2603233031,28,2656615996,53382965
1647002202,197672,true,2604014079,28,2657147346,53133267
1647002572,197666,true,2605576878,28,2659273808,53696930
1647002601,197664,true,2606098019,28,2659273808,53175789
1647002746,197659,true,2607401329,28,2659805689,52404360
1647002752,197656,true,2608183627,28,2659805689,51622062
1647002830,197650,true,2609748929,28,2660337677,50588748
1647002885,197648,true,2610270905,28,2660337677,50066772
1647002944,197643,true,2611576301,28,2660603711,49027410
1647003091,197640,true,2612359853,28,2660603711,48243858
1647003275,197635,true,2613666294,28,2660603711,46937417
1647003350,197633,true,2614189053,28,2660603711,46414658
1647003459,197628,true,2615496409,28,2660337677,44841268
1647004360,197625,true,2616281136,28,2656084753,39803617
1647004387,197619,true,2617851298,28,2656084753,38233455
1647004434,197617,true,2618374894,28,2655553615,37178721
1647004466,197613,true,2619422401,28,2655288086,35865685
1647004615,197611,true,2619946312,28,2653430128,33483816
1647004657,197607,true,2620994448,28,2652899522,31905074
1647005016,197606,true,2621256547,28,2647599290,26342743
1647005046,197602,true,2622305207,28,2647334556,25029349
1647006156,197601,true,2622567437,28,2635712453,13145016
1647006215,197598,true,2623354286,28,2635185389,11831103
1647006237,197597,true,2623616622,28,2634921897,11305275
1647006481,197593,true,2624666226,28,2633078189,8411963
1647006555,197593,true,2624666226,28,2632814908,8148682
1647007088,197591,true,2625191185,28,2629920548,4729363
1647007997,197591,true,2625191185,28,2624403785,-787400
1647008391,197587,true,2626241419,28,2623616622,-2624797
1647008642,197587,true,2626241419,28,2623616622,-2624797
1647008728,197586,true,2626504043,28,2623616622,-2887421
1647008836,197585,true,2626766694,28,2623878983,-2887711
1647008872,197581,true,2627817558,28,2623878983,-3938575
1647009036,197582,true,2627554803,28,2624141371,-3413432
1647009067,197580,true,2628080340,28,2624141371,-3938969
1647009236,197579,true,2628343148,28,2624666226,-3676922
1647009364,197576,true,2629131730,28,2624928692,-4203038
1647009607,197577,true,2628868843,28,2625716250,-3152593
1647009766,197576,true,2629131730,28,2624666226,-4465504
1647009933,197576,true,2629131730,28,2623878983,-5252747
1647010439,197573,true,2629920548,28,2622043003,-7877545
1647010464,197574,true,2629657582,28,2621780825,-7876757
1647010714,197575,true,2629394643,28,2620470327,-8924316
1647010797,197575,true,2629394643,28,2619946312,-9448331
1647010852,197572,true,2630183540,28,2619684343,-10499197
1647010881,197574,true,2629657582,28,2619422401,-10235181
1647010960,197575,true,2629394643,28,2618636732,-10757911
1647010981,197574,true,2629657582,28,2618374894,-11282688
1647011167,197572,true,2630183540,28,2615757959,-14425581
1647011248,197574,true,2629657582,28,2614450472,-15207110
1647011340,197575,true,2629394643,28,2612882351,-16512292
1647011448,197575,true,2629394643,28,2611054064,-18340579
1647011462,197573,true,2629920548,28,2611054064,-18866484
1647011550,197574,true,2629657582,28,2610009904,-19647678
1647011801,197576,true,2629131730,28,2606619265,-22512465
1647011959,197576,true,2629131730,28,2604274480,-24857250
1647012306,197574,true,2629657582,28,2598291831,-31365751
1647012416,197576,true,2629131730,28,2596473754,-32657976
1647012469,197578,true,2628605982,28,2595694967,-32911015
1647012482,197578,true,2628605982,28,2595435424,-33170558
1647012540,197576,true,2629131730,28,2594656949,-34474781
1647013377,197578,true,2628605982,28,2587402433,-41203549
1647013716,197580,true,2628080340,28,2586885030,-41195310
1647013758,197580,true,2628080340,28,2586626368,-41453972
1647014115,197578,true,2628605982,28,2586626368,-41979614
1647014736,197581,true,2627817558,28,2583266106,-44551452
1647014792,197583,true,2627292073,28,2582749530,-44542543
1647014856,197583,true,2627292073,28,2581974860,-45317213
1647015525,197582,true,2627554803,28,2574240929,-53313874
1647016188,197585,true,2626766694,28,2568840965,-57925729
1647016524,197587,true,2626241419,28,2565760359,-60481060
1647018958,197588,true,2625978821,28,2560378184,-65600637
1647021041,197589,true,2625716250,28,2557307727,-68408523
1647021049,197591,true,2625191185,28,2557563457,-67627728
1647021059,197594,true,2624403785,28,2557563457,-66840328
1647022291,197596,true,2623878983,28,2559866185,-64012798
1647022951,197596,true,2623878983,28,2560890286,-62988697
1647022959,197599,true,2623091977,28,2561146375,-61945602
1647023099,197602,true,2622305207,28,2561146375,-61158832
1647023144,197604,true,2621780825,28,2561402489,-60378336
1647025120,197604,true,2621780825,28,2566273536,-55507289
1647025683,197607,true,2620994448,28,2565247284,-55747164
1647025922,197609,true,2620470327,28,2564734311,-55736016
1647027123,197611,true,2619946312,28,2561402489,-58543823
1647027389,197612,true,2619684343,28,2561146375,-58537968
1647028362,197615,true,2618898595,28,2560890286,-58008309
1647028380,197618,true,2618113083,28,2560890286,-57222797
1647030611,197620,true,2617589539,28,2560890286,-56699253
1647030686,197622,true,2617066099,28,2560890286,-56175813
1647030688,197625,true,2616281136,28,2560890286,-55390850
1647031028,197628,true,2615496409,28,2559866185,-55630224
1647031280,197631,true,2614711917,28,2559354289,-55357628
1647031614,197634,true,2613927660,28,2558330803,-55596857
1647031668,197638,true,2612882351,28,2558074996,-54807355
1647031735,197641,true,2612098643,28,2557819214,-54279429
1647031739,197644,true,2611315170,28,2557819214,-53495956
1647031758,197647,true,2610531932,28,2557563457,-52968475
1647031791,197653,true,2608966161,28,2557307727,-51658434
1647031840,197656,true,2608183627,28,2556796342,-51387285
1647032007,197660,true,2607140615,28,2555007300,-52133315
1647032025,197662,true,2606619265,28,2554751825,-51867440
1647032176,197668,true,2605055841,28,2552708943,-52346898
1647032478,197672,true,2604014079,28,2548628078,-55386001
1647032481,197676,true,2602972733,28,2548628078,-54344655
1647032534,197679,true,2602191998,28,2548118429,-54073569
1647032937,197683,true,2601151381,28,2547099436,-54051945
1647032980,197686,true,2600371192,28,2547099436,-53271756
1647033085,197690,true,2599331303,28,2547099436,-52231867
1647033743,197693,true,2598551660,28,2548628078,-49923582
1647033832,197697,true,2597512499,28,2549647682,-47864817
1647033852,197700,true,2596733401,28,2549902647,-46830754
1647033865,197704,true,2595694967,28,2550157637,-45537330
1647034568,197705,true,2595435424,28,2564221441,-31213983
1647034914,197709,true,2594397509,28,2569097849,-25299660
1647034974,197712,true,2593619345,28,2569611694,-24007651
1647038738,197716,true,2592582157,28,2572439681,-20142476
1647039631,197717,true,2592322925,28,2572696925,-19626000
1647039638,197721,true,2591286255,28,2572954195,-18332060
1647042638,197725,true,2590249999,28,2570896757,-19353242
1647042696,197729,true,2589214158,28,2570896757,-18317401
1647043216,197730,true,2588955263,28,2569097849,-19857414
1647043270,197734,true,2587919939,28,2568840965,-19078974
1647043809,197738,true,2586885030,28,2566016935,-20868095
1647043950,197742,true,2585850535,28,2565247284,-20603251
1647044788,197743,true,2585591976,28,2561914795,-23677181
1647044795,197746,true,2584816453,28,2561914795,-22901658
1647044971,197750,true,2583782785,28,2562170987,-21611798
1647045010,197754,true,2582749530,28,2562170987,-20578543
1647045794,197754,true,2582749530,28,2565503808,-17245722
1647045830,197757,true,2581974860,28,2565503808,-16471052
1647045930,197760,true,2581200423,28,2566016935,-15183488
1647046116,197763,true,2580426217,28,2567300200,-13126017
1647046147,197763,true,2580426217,28,2567300200,-13126017
1647046252,197765,true,2579910210,28,2568070467,-11839743
1647046610,197769,true,2578878503,28,2570382655,-8495848
1647046855,197772,true,2578104995,28,2571668103,-6436892
1647046935,197771,true,2578362805,28,2571925270,-6437535
1647047049,197773,true,2577847210,28,2572439681,-5407529
1647047497,197775,true,2577331718,28,2574240929,-3090789
1647047532,197778,true,2576558673,28,2574498353,-2060320
1647048901,197777,true,2576816329,28,2579910210,3093881
1647051446,197778,true,2576558673,28,2587143719,10585046
1647051999,197780,true,2576043438,28,2587919939,11876501
1647052848,197783,true,2575270780,28,2589214158,13943378
1647052929,197782,true,2575528307,28,2589214158,13685851
1647053077,197783,true,2575270780,28,2589473080,14202300
1647053410,197785,true,2574755803,28,2588955263,14199460
1647053833,197789,true,2573726158,28,2588437549,14711391
1647053907,197788,true,2573983531,28,2588178731,14195200
1647054659,197789,true,2573726158,28,2586626368,12900210
1647055808,197791,true,2573211490,28,2586367731,13156241
1647057631,197794,true,2572439681,28,2587402433,14962752
1647058148,197792,true,2572954195,28,2587402433,14448238
1647058206,197793,true,2572696925,28,2587402433,14705508
1647058260,197795,true,2572182463,28,2587402433,15219970
1647058292,197798,true,2571410962,28,2587402433,15991471
1647058771,197797,true,2571668103,28,2584557997,12889894
1647060438,197797,true,2571668103,28,2580684260,9016157
1647060461,197799,true,2571153847,28,2580942328,9788481
1647062908,197802,true,2570382655,28,2583266106,12883451
1647063061,197800,true,2570896757,28,2583524433,12627676
1647063087,197800,true,2570896757,28,2583524433,12627676
1647063486,197802,true,2570382655,28,2583524433,13141778
1647064159,197804,true,2569868656,28,2584041163,14172507
1647064800,197802,true,2570382655,28,2584299567,13916912
1647064837,197802,true,2570382655,28,2584299567,13916912
1647064944,197803,true,2570125642,28,2584557997,14432355
1647064961,197805,true,2569611694,28,2584557997,14946303
1647065729,197802,true,2570382655,28,2587402433,17019778
1647066572,197801,true,2570639693,28,2590768075,20128382
1647069660,197802,true,2570382655,28,2591286255,20903600
1647069719,197804,true,2569868656,28,2591545383,21676727
1647072248,197801,true,2570639693,28,2589732027,19092334
1647072758,197801,true,2570639693,28,2589732027,19092334
1647072764,197802,true,2570382655,28,2589732027,19349372
1647073022,197804,true,2569868656,28,2589732027,19863371
1647073038,197801,true,2570639693,28,2589732027,19092334
1647073075,197800,true,2570896757,28,2589732027,18835270
1647073150,197801,true,2570639693,28,2589732027,19092334
1647073179,197802,true,2570382655,28,2589732027,19349372
1647073339,197799,true,2571153847,28,2589473080,18319233
1647073427,197797,true,2571668103,28,2589214158,17546055
1647073455,197798,true,2571410962,28,2589214158,17803196
1647073457,197799,true,2571153847,28,2589214158,18060311
1647073467,197795,true,2572182463,28,2589214158,17031695
1647073495,197793,true,2572696925,28,2588955263,16258338
1647073535,197794,true,2572439681,28,2588955263,16515582
1647073574,197796,true,2571925270,28,2588696393,16771123
1647073628,197792,true,2572954195,28,2588696393,15742198
1647073636,197790,true,2573468811,28,2588696393,15227582
1647073651,197791,true,2573211490,28,2588437549,15226059
1647075235,197793,true,2572696925,28,2582491281,9794356
1647075335,197790,true,2573468811,28,2582491281,9022470
1647077650,197788,true,2573983531,28,2582233058,8249527
1647077704,197789,true,2573726158,28,2582491281,8765123
1647079254,197790,true,2573468811,28,2583266106,9797295
1647080547,197787,true,2574240929,28,2584299567,10058638
1647080922,197785,true,2574755803,28,2584557997,9802194
1647080975,197785,true,2574755803,28,2584557997,9802194
1647082094,197787,true,2574240929,28,2584557997,10317068
1647084162,197783,true,2575270780,28,2584557997,9287217
1647085882,197781,true,2575785860,28,2584557997,8772137
1647086454,197782,true,2575528307,28,2584041163,8512856
1647086877,197783,true,2575270780,28,2583782785,8512005
1647087352,197779,true,2576301043,28,2583266106,6965063
1647088498,197778,true,2576558673,28,2582749530,6190857
1647088670,197778,true,2576558673,28,2582749530,6190857
1647089517,197779,true,2576301043,28,2582233058,5932015
1647089640,197775,true,2577331718,28,2582233058,4901340
1647089783,197773,true,2577847210,28,2582233058,4385848
1647089838,197773,true,2577847210,28,2582233058,4385848
1647090328,197774,true,2577589451,28,2582233058,4643607
1647090345,197770,true,2578620641,28,2582233058,3612417
1647091207,197767,true,2579394305,28,2585333442,5939137
1647091806,197766,true,2579652244,28,2587143719,7491475
1647093633,197766,true,2579652244,28,2587919939,8267695
1647093657,197763,true,2580426217,28,2587919939,7493722
1647094293,197761,true,2580942328,28,2585333442,4391114
1647094440,197761,true,2580942328,28,2584816453,3874125
1647094495,197762,true,2580684260,28,2584557997,3873737
1647094842,197759,true,2581458543,28,2583266106,1807563
1647095764,197757,true,2581974860,28,2580942328,-1032532
1647096582,197759,true,2581458543,28,2575785860,-5672683
1647096735,197760,true,2581200423,28,2574755803,-6444620
1647097605,197759,true,2581458543,28,2569611694,-11846849
1647098169,197758,true,2581716689,28,2569611694,-12104995
1647098347,197760,true,2581200423,28,2569611694,-11588729
1647098645,197760,true,2581200423,28,2569611694,-11588729
1647099732,197760,true,2581200423,28,2569611694,-11588729
1647099786,197759,true,2581458543,28,2569868656,-11589887
1647099795,197760,true,2581200423,28,2569868656,-11331767
1647099820,197760,true,2581200423,28,2569868656,-11331767
1647099905,197759,true,2581458543,28,2570382655,-11075888
1647099961,197758,true,2581716689,28,2570639693,-11076996
1647100470,197757,true,2581974860,28,2574240929,-7733931
1647101509,197758,true,2581716689,28,2581974860,258171
1647101590,197756,true,2582233058,28,2582749530,516472
1647101847,197755,true,2582491281,28,2583524433,1033152
1647102037,197754,true,2582749530,28,2584041163,1291633
1647102320,197754,true,2582749530,28,2584557997,1808467
1647102338,197753,true,2583007805,28,2584557997,1550192
1647102350,197752,true,2583266106,28,2584557997,1291891
1647102371,197752,true,2583266106,28,2584557997,1291891
1647102379,197752,true,2583266106,28,2584557997,1291891
1647102390,197751,true,2583524433,28,2584557997,1033564
1647102864,197750,true,2583782785,28,2586109120,2326335
1647102906,197750,true,2583782785,28,2586109120,2326335
1647103246,197750,true,2583782785,28,2587402433,3619648
1647103677,197749,true,2584041163,28,2588178731,4137568
1647104468,197748,true,2584299567,28,2589214158,4914591
1647104507,197748,true,2584299567,28,2589214158,4914591
1647104643,197748,true,2584299567,28,2590249999,5950432
1647104688,197748,true,2584299567,28,2590509024,6209457
1647104692,197746,true,2584816453,28,2590509024,5692571
1647104730,197746,true,2584816453,28,2590768075,5951622
1647106127,197746,true,2584816453,28,2601931804,17115351
1647106213,197745,true,2585074935,28,2602712462,17637527
1647106279,197744,true,2585333442,28,2602972733,17639291
1647106295,197744,true,2585333442,28,2603233031,17899589
1647106309,197744,true,2585333442,28,2603233031,17899589
1647106511,197744,true,2585333442,28,2602712462,17379020
1647106614,197742,true,2585850535,28,2602452217,16601682
1647106666,197742,true,2585850535,28,2602191998,16341463
1647106937,197742,true,2585850535,28,2601151381,15300846
1647108039,197742,true,2585850535,28,2596733401,10882866
1647108054,197741,true,2586109120,28,2596733401,10624281
1647108194,197741,true,2586109120,28,2596214132,10105012
1647109211,197741,true,2586109120,28,2595175906,9066786
1647109356,197740,true,2586367731,28,2594916414,8548683
1647109369,197739,true,2586626368,28,2594916414,8290046
1647109407,197739,true,2586626368,28,2594656949,8030581
1647110716,197740,true,2586367731,28,2591286255,4918524
1647111799,197740,true,2586367731,28,2588178731,1811000
1647114210,197739,true,2586626368,28,2584816453,-1809915
1647116341,197739,true,2586626368,28,2584816453,-1809915
1647116431,197740,true,2586367731,28,2584816453,-1551278
1647119053,197739,true,2586626368,28,2584816453,-1809915
1647120081,197739,true,2586626368,28,2585074935,-1551433
1647121424,197739,true,2586626368,28,2586626368,0
1647122128,197739,true,2586626368,28,2586885030,258662
1647124979,197740,true,2586367731,28,2586885030,517299
1647128207,197739,true,2586626368,28,2586885030,258662
1647128301,197739,true,2586626368,28,2586885030,258662
1647128532,197740,true,2586367731,28,2586885030,517299
1647128613,197741,true,2586109120,28,2586885030,775910
1647128697,197740,true,2586367731,28,2586885030,517299
1647128703,197740,true,2586367731,28,2586885030,517299
1647128729,197741,true,2586109120,28,2586626368,517248
1647128755,197741,true,2586109120,28,2586626368,517248
1647128762,197741,true,2586109120,28,2586626368,517248
1647128806,197741,true,2586109120,28,2586626368,517248
1647128956,197741,true,2586109120,28,2586109120,0
1647129330,197742,true,2585850535,28,2585074935,-775600
1647129392,197741,true,2586109120,28,2584816453,-1292667
1647129502,197741,true,2586109120,28,2584299567,-1809553
1647129536,197742,true,2585850535,28,2584299567,-1550968
1647129797,197743,true,2585591976,28,2581716689,-3875287
1647129799,197743,true,2585591976,28,2581716689,-3875287
1647130027,197744,true,2585333442,28,2579394305,-5939137
1647130330,197744,true,2585333442,28,2576301043,-9032399
1647131202,197746,true,2584816453,28,2569097849,-15718604
1647132766,197745,true,2585074935,28,2567813685,-17261250
1647133630,197746,true,2584816453,28,2567813685,-17002768
1647133825,197746,true,2584816453,28,2568584107,-16232346
1647133938,197748,true,2584299567,28,2568840965,-15458602
1647133948,197747,true,2584557997,28,2569097849,-15460148
1647133985,197747,true,2584557997,28,2569097849,-15460148
1647133998,197747,true,2584557997,28,2569354759,-15203238
1647134015,197749,true,2584041163,28,2569354759,-14686404
1647134118,197748,true,2584299567,28,2569868656,-14430911
1647134163,197747,true,2584557997,28,2570382655,-14175342
1647134169,197748,true,2584299567,28,2570382655,-13916912
1647134206,197749,true,2584041163,28,2570896757,-13144406
1647135220,197747,true,2584557997,28,2583007805,-1550192
1647136115,197747,true,2584557997,28,2589473080,4915083
1647137067,197747,true,2584557997,28,2589473080,4915083
1647137712,197748,true,2584299567,28,2592322925,8023358
1647141405,197745,true,2585074935,28,2597252774,12177839
1647142233,197745,true,2585074935,28,2597252774,12177839
1647144561,197745,true,2585074935,28,2597252774,12177839
1647144780,197746,true,2584816453,28,2597252774,12436321
1647145026,197743,true,2585591976,28,2596733401,11141425
1647146546,197743,true,2585591976,28,2594138095,8546119
1647147936,197744,true,2585333442,28,2593878707,8545265
1647149086,197744,true,2585333442,28,2593619345,8285903
1647151184,197742,true,2585850535,28,2593360009,7509474
1647151324,197742,true,2585850535,28,2593360009,7509474
1647151345,197743,true,2585591976,28,2593360009,7768033
1647152715,197744,true,2585333442,28,2590509024,5175582
1647153022,197742,true,2585850535,28,2589991000,4140465
1647154902,197741,true,2586109120,28,2589732027,3622907
1647154911,197742,true,2585850535,28,2589732027,3881492
1647155109,197743,true,2585591976,28,2589732027,4140051
1647155522,197741,true,2586109120,28,2589732027,3622907
1647157656,197740,true,2586367731,28,2589732027,3364296
1647158394,197740,true,2586367731,28,2589732027,3364296
1647158858,197740,true,2586367731,28,2589732027,3364296
1647159189,197738,true,2586885030,28,2589473080,2588050
1647159215,197737,true,2587143719,28,2589473080,2329361
1647159522,197737,true,2587143719,28,2588696393,1552674
1647159562,197738,true,2586885030,28,2588696393,1811363
1647160148,197736,true,2587402433,28,2586626368,-776065
1647162505,197735,true,2587661173,28,2583782785,-3878388
1647162549,197735,true,2587661173,28,2583782785,-3878388
1647163953,197737,true,2587143719,28,2582749530,-4394189
1647163974,197735,true,2587661173,28,2582749530,-4911643
1647164501,197735,true,2587661173,28,2582233058,-5428115
1647164513,197735,true,2587661173,28,2582233058,-5428115
1647164662,197737,true,2587143719,28,2582233058,-4910661
1647165138,197735,true,2587661173,28,2581458543,-6202630
1647168698,197735,true,2587661173,28,2580942328,-6718845
1647169092,197736,true,2587402433,28,2580942328,-6460105
1647169309,197738,true,2586885030,28,2580942328,-5942702
1647169370,197736,true,2587402433,28,2581200423,-6202010
1647170115,197736,true,2587402433,28,2581716689,-5685744
1647170174,197737,true,2587143719,28,2581974860,-5168859
1647170955,197738,true,2586885030,28,2585074935,-1810095
1647171285,197736,true,2587402433,28,2586367731,-1034702
1647171330,197736,true,2587402433,28,2586626368,-776065
1647171344,197737,true,2587143719,28,2586626368,-517351
1647171649,197738,true,2586885030,28,2586626368,-258662
1647171657,197737,true,2587143719,28,2586626368,-517351
1647171678,197737,true,2587143719,28,2586626368,-517351
1647172006,197738,true,2586885030,28,2585591976,-1293054
1647172113,197740,true,2586367731,28,2585074935,-1292796
1647172210,197740,true,2586367731,28,2584557997,-1809734
1647172222,197740,true,2586367731,28,2584299567,-2068164
1647172247,197742,true,2585850535,28,2584299567,-1550968
1647172253,197744,true,2585333442,28,2584299567,-1033875
1647172461,197744,true,2585333442,28,2582491281,-2842161
1647172586,197744,true,2585333442,28,2581458543,-3874899
1647172662,197746,true,2584816453,28,2580942328,-3874125
1647172939,197747,true,2584557997,28,2578620641,-5937356
1647173883,197747,true,2584557997,28,2574498353,-10059644
1647173895,197747,true,2584557997,28,2574498353,-10059644
1647173991,197749,true,2584041163,28,2573983531,-10057632
1647174055,197750,true,2583782785,28,2573983531,-9799254
1647174075,197751,true,2583524433,28,2573726158,-9798275
1647174083,197751,true,2583524433,28,2573726158,-9798275
1647174171,197753,true,2583007805,28,2572954195,-10053610
1647174311,197756,true,2582233058,28,2571153847,-11079211
1647174391,197756,true,2582233058,28,2570125642,-12107416
1647174797,197757,true,2581974860,28,2564477863,-17496997
1647175197,197759,true,2581458543,28,2558586636,-22871907
1647176642,197762,true,2580684260,28,2545062673,-35621587
1647176883,197762,true,2580684260,28,2544553737,-36130523
1647176892,197762,true,2580684260,28,2544553737,-36130523
1647177725,197764,true,2580168201,28,2547099436,-33068765
1647177773,197767,true,2579394305,28,2547354146,-32040159
1647177786,197767,true,2579394305,28,2547354146,-32040159
1647178969,197766,true,2579652244,28,2558586636,-21065608
1647179209,197768,true,2579136391,28,2560378184,-18758207
1647179211,197770,true,2578620641,28,2560378184,-18242457
1647179714,197770,true,2578620641,28,2561658629,-16962012
1647181272,197770,true,2578620641,28,2558842495,-19778146
1647181310,197771,true,2578362805,28,2559098379,-19264426
1647181541,197774,true,2577589451,28,2559098379,-18491072
1647181659,197774,true,2577589451,28,2559354289,-18235162
1647181841,197774,true,2577589451,28,2559610224,-17979227
1647181872,197775,true,2577331718,28,2559866185,-17465533
1647182254,197777,true,2576816329,28,2560378184,-16438145
1647182372,197777,true,2576816329,28,2560634222,-16182107
1647182863,197776,true,2577074010,28,2562170987,-14903023
1647183164,197777,true,2576816329,28,2562683447,-14132882
1647183191,197780,true,2576043438,28,2562939715,-13103723
1647183499,197780,true,2576043438,28,2563196009,-12847429
1647183774,197779,true,2576301043,28,2563452328,-12848715
1647183802,197780,true,2576043438,28,2563708674,-12334764
1647183832,197781,true,2575785860,28,2563965045,-11820815
1647183905,197781,true,2575785860,28,2564221441,-11564419
1647186145,197778,true,2576558673,28,2574240929,-2317744
1647186194,197779,true,2576301043,28,2574498353,-1802690
1647186935,197780,true,2576043438,28,2574755803,-1287635
1647186951,197780,true,2576043438,28,2574755803,-1287635
1647188363,197777,true,2576816329,28,2580168201,3351872
1647188400,197777,true,2576816329,28,2580168201,3351872
1647188530,197778,true,2576558673,28,2580426217,3867544
1647188682,197778,true,2576558673,28,2580942328,4383655
1647194151,197776,true,2577074010,28,2579394305,2320295
1647194455,197777,true,2576816329,28,2579394305,2577976
1647195564,197778,true,2576558673,28,2579394305,2835632
1647196400,197778,true,2576558673,28,2579394305,2835632
1647198558,197776,true,2577074010,28,2579394305,2320295
1647198579,197777,true,2576816329,28,2579394305,2577976
1647198626,197778,true,2576558673,28,2579394305,2835632
1647199146,197779,true,2576301043,28,2578104995,1803952
1647199164,197778,true,2576558673,28,2578104995,1546322
1647200161,197779,true,2576301043,28,2574755803,-1545240
1647200185,197781,true,2575785860,28,2574498353,-1287507
1647200270,197783,true,2575270780,28,2573726158,-1544622
1647201826,197782,true,2575528307,28,2567043495,-8484812
1647202008,197783,true,2575270780,28,2566530164,-8740616
1647202164,197785,true,2574755803,28,2566016935,-8738868
1647202230,197787,true,2574240929,28,2566016935,-8223994
1647202257,197786,true,2574498353,28,2565760359,-8737994
1647202424,197788,true,2573983531,28,2565247284,-8736247
1647202817,197790,true,2573468811,28,2563196009,-10272802
1647204359,197792,true,2572954195,28,2553474832,-19479363
1647205589,197792,true,2572954195,28,2552708943,-20245252
1647208376,197793,true,2572696925,28,2552453697,-20243228
1647208398,197795,true,2572182463,28,2552708943,-19473520
1647208820,197798,true,2571410962,28,2552964214,-18446748
1647208938,197797,true,2571668103,28,2553474832,-18193271
1647210758,197798,true,2571410962,28,2560122172,-11288790
1647210762,197800,true,2570896757,28,2560378184,-10518573
1647210793,197802,true,2570382655,28,2560378184,-10004471
1647211261,197801,true,2570639693,28,2561658629,-8981064
1647211755,197801,true,2570639693,28,2563196009,-7443684
1647211760,197803,true,2570125642,28,2563196009,-6929633
1647211804,197805,true,2569611694,28,2562683447,-6928247
1647211830,197805,true,2569611694,28,2562427204,-7184490
1647211892,197809,true,2568584107,28,2561146375,-7437732
1647211937,197811,true,2568070467,28,2559866185,-8204282
1647211943,197814,true,2567300200,28,2559866185,-7434015
1647211972,197814,true,2567300200,28,2559098379,-8201821
1647212239,197819,true,2566016935,28,2551688114,-14328821
1647212264,197821,true,2565503808,28,2551177853,-14325955
1647212286,197824,true,2564734311,28,2550412653,-14321658
1647212299,197824,true,2564734311,28,2550157637,-14576674
1647212434,197829,true,2563452328,28,2546080851,-17371477
1647212481,197832,true,2562683447,28,2544808193,-17875254
1647212495,197834,true,2562170987,28,2544299307,-17871680
1647212514,197834,true,2562170987,28,2543790524,-18380463
1647212725,197840,true,2560634222,28,2536424585,-24209637
1647213389,197842,true,2560122172,28,2514203078,-45919094
1647213421,197845,true,2559354289,28,2513197648,-46156641
1647213659,197845,true,2559354289,28,2507173507,-52180782
1647213685,197851,true,2557819214,28,2507173507,-50645707
1647213753,197853,true,2557307727,28,2506922815,-50384912
1647214003,197856,true,2556540688,28,2506922815,-49617873
1647214061,197856,true,2556540688,28,2507173507,-49367181
1647215038,197861,true,2555262801,28,2513197648,-42065153
1647215513,197863,true,2554751825,28,2515460431,-39291394
1647216379,197865,true,2554240951,28,2515711977,-38528974
1647216410,197865,true,2554240951,28,2515460431,-38780520
1647216890,197871,true,2552708943,28,2513448968,-39259975
1647216980,197872,true,2552453697,28,2513197648,-39256049
1647217015,197875,true,2551688114,28,2513197648,-38490466
1647217018,197875,true,2551688114,28,2513197648,-38490466
1647217046,197880,true,2550412653,28,2513197648,-37215005
1647217595,197881,true,2550157637,28,2513951683,-36205954
1647218276,197883,true,2549647682,28,2515208910,-34438772
1647218391,197883,true,2549647682,28,2515711977,-33935705
1647218698,197888,true,2548373241,28,2516466766,-31906475
1647219657,197889,true,2548118429,28,2514203078,-33915351
1647219678,197892,true,2547354146,28,2514203078,-33151068
1647219725,197891,true,2547608882,28,2514454498,-33154384
1647219736,197897,true,2546080851,28,2514454498,-31626353
1647219836,197896,true,2546335459,28,2515208910,-31126549
1647220123,197897,true,2546080851,28,2517221782,-28859069
1647220198,197897,true,2546080851,28,2518228821,-27852030
1647220229,197901,true,2545062673,28,2518480644,-26582029
1647221065,197899,true,2545571711,28,2528827093,-16744618
1647221143,197900,true,2545317180,28,2529585817,-15731363
1647222100,197899,true,2545571711,28,2532622990,-12948721
1647223615,197904,true,2544299307,28,2527815815,-16483492
1647224794,197901,true,2545062673,28,2527057622,-18005051
1647225501,197902,true,2544808193,28,2527057622,-17750571
1647225617,197902,true,2544808193,28,2527057622,-17750571
1647225830,197907,true,2543536170,28,2527057622,-16478548
1647226390,197904,true,2544299307,28,2527310328,-16988979
1647226559,197906,true,2543790524,28,2527310328,-16480196
1647228232,197906,true,2543790524,28,2527310328,-16480196
1647228251,197911,true,2542519010,28,2527310328,-15208682
1647230026,197909,true,2543027539,28,2527563059,-15464480
1647230621,197910,true,2542773262,28,2527815815,-14957447
1647230640,197911,true,2542519010,28,2527815815,-14703195
1647230659,197916,true,2541248132,28,2527815815,-13432317
1647230726,197913,true,2542010582,28,2528068597,-13941985
1647230779,197914,true,2541756407,28,2528321404,-13435003
1647230947,197914,true,2541756407,28,2528827093,-12929314
1647230976,197920,true,2540231887,28,2528827093,-11404794
1647230986,197917,true,2540994032,28,2529079976,-11914056
1647231027,197918,true,2540739958,28,2529079976,-11659982
1647231062,197918,true,2540739958,28,2529332884,-11407074
1647231104,197923,true,2539469969,28,2529838776,-9631193
1647231111,197920,true,2540231887,28,2529838776,-10393111
1647231134,197921,true,2539977889,28,2530344769,-9633120
1647231137,197920,true,2540231887,28,2530344769,-9887118
1647231149,197925,true,2538962152,28,2530344769,-8617383
1647231180,197922,true,2539723916,28,2530850863,-8873053
1647231184,197922,true,2539723916,28,2531103948,-8619968
1647231201,197923,true,2539469969,28,2531357059,-8112910
1647231229,197927,true,2538454435,28,2531863355,-6591080
1647231275,197924,true,2539216048,28,2532622990,-6593058
1647231290,197924,true,2539216048,28,2533129540,-6086508
1647231302,197925,true,2538962152,28,2533382853,-5579299
1647231321,197929,true,2537946821,28,2533636192,-4310629
1647231364,197925,true,2538962152,28,2534903263,-4058889
1647231382,197925,true,2538962152,28,2535156753,-3805399
1647231431,197926,true,2538708281,28,2536424585,-2283696
1647231447,197930,true,2537693051,28,2536931896,-761155
1647231474,197925,true,2538962152,28,2537693051,-1269101
1647231475,197925,true,2538962152,28,2537946821,-1015331
1647231477,197926,true,2538708281,28,2537946821,-761460
1647231501,197929,true,2537946821,28,2538708281,761460
1647231523,197925,true,2538962152,28,2539216048,253896
1647232275,197925,true,2538962152,28,2562939715,23977563
1647232293,197924,true,2539216048,28,2563452328,24236280
1647233651,197928,true,2538200615,28,2576816329,38615714
1647233809,197924,true,2539216048,28,2575785860,36569812
1647234801,197924,true,2539216048,28,2573211490,33995442
1647235009,197924,true,2539216048,28,2573211490,33995442
1647235254,197928,true,2538200615,28,2573211490,35010875
1647235281,197923,true,2539469969,28,2572954195,33484226
1647235334,197923,true,2539469969,28,2572954195,33484226
1647237081,197922,true,2539723916,28,2573726158,34002242
1647237366,197926,true,2538708281,28,2573726158,35017877
1647237555,197921,true,2539977889,28,2573726158,33748269
1647237636,197921,true,2539977889,28,2573726158,33748269
1647237748,197920,true,2540231887,28,2573468811,33236924
1647237821,197923,true,2539469969,28,2573468811,33998842
1647239270,197918,true,2540739958,28,2572954195,32214237
1647240405,197918,true,2540739958,28,2574240929,33500971
1647240573,197917,true,2540994032,28,2574240929,33246897
1647242041,197921,true,2539977889,28,2574755803,34777914
1647242481,197916,true,2541248132,28,2574755803,33507671
1647242502,197916,true,2541248132,28,2575013279,33765147
1647243244,197915,true,2541502257,28,2577074010,35571753
1647243431,197919,true,2540485910,28,2578104995,37619085
1647243968,197914,true,2541756407,28,2581200423,39444016
1647243974,197913,true,2542010582,28,2581200423,39189841
1647244684,197911,true,2542519010,28,2584299567,41780557
1647245024,197911,true,2542519010,28,2585333442,42814432
1647245068,197906,true,2543790524,28,2585333442,41542918
1647245095,197904,true,2544299307,28,2585333442,41034135
1647245337,197902,true,2544808193,28,2585850535,41042342
1647245551,197901,true,2545062673,28,2586367731,41305058
1647245561,197895,true,2546590093,28,2586367731,39777638
1647245565,197893,true,2547099436,28,2586367731,39268295
1647245576,197891,true,2547608882,28,2586367731,38758849
1647245646,197889,true,2548118429,28,2586885030,38766601
1647245667,197883,true,2549647682,28,2586885030,37237348
1647246342,197881,true,2550157637,28,2590768075,40610438
1647247253,197878,true,2550922761,28,2594916414,43993653
1647247411,197876,true,2551432971,28,2595175906,43742935
1647249240,197870,true,2552964214,28,2594656949,41692735
1647249446,197868,true,2553474832,28,2594656949,41182117
1647249951,197866,true,2553985553,28,2594656949,40671396
1647250930,197863,true,2554751825,28,2594656949,39905124
1647251611,197858,true,2556029456,28,2594656949,38627493
1647251725,197857,true,2556285059,28,2594656949,38371890
1647251779,197854,true,2557052021,28,2594916414,37864393
1647251789,197852,true,2557563457,28,2594916414,37352957
1647251793,197847,true,2558842495,28,2594916414,36073919
1647252395,197845,true,2559354289,28,2597252774,37898485
1647252592,197842,true,2560122172,28,2597772250,37650078
1647252611,197840,true,2560634222,28,2598032027,37397805
1647253153,197834,true,2562170987,28,2599071396,36900409
1647253348,197832,true,2562683447,28,2599331303,36647856
1647253398,197830,true,2563196009,28,2599331303,36135294
1647253447,197828,true,2563708674,28,2599331303,35622629
1647254042,197823,true,2564990784,28,2597512499,32521715
1647254090,197821,true,2565503808,28,2597252774,31748966
1647254174,197819,true,2566016935,28,2596733401,30716466
1647256030,197817,true,2566530164,28,2590768075,24237911
1647256781,197813,true,2567556930,28,2590768075,23211145
1647257206,197811,true,2568070467,28,2590768075,22697608
1647257331,197808,true,2568840965,28,2591027152,22186187
1647257412,197807,true,2569097849,28,2590768075,21670226
1647257709,197804,true,2569868656,28,2590249999,20381343
1647258339,197803,true,2570125642,28,2588178731,18053089
1647258453,197801,true,2570639693,28,2587661173,17021480
1647259920,197799,true,2571153847,28,2583266106,12112259
1647260022,197797,true,2571668103,28,2583007805,11339702
1647260398,197796,true,2571925270,28,2582233058,10307788
1647260612,197794,true,2572439681,28,2581974860,9535179
1647261124,197792,true,2572954195,28,2581458543,8504348
1647261405,197790,true,2573468811,28,2580942328,7473517
1647261460,197789,true,2573726158,28,2580684260,6958102
1647262428,197787,true,2574240929,28,2578620641,4379712
1647262585,197785,true,2574755803,28,2578362805,3607002
1647262785,197783,true,2575270780,28,2577589451,2318671
1647264833,197782,true,2575528307,28,2575528307,0
1647264849,197780,true,2576043438,28,2575528307,-515131
1647265093,197778,true,2576558673,28,2575013279,-1545394
1647265300,197777,true,2576816329,28,2573983531,-2832798
1647265710,197776,true,2577074010,28,2571925270,-5148740
1647265778,197774,true,2577589451,28,2571668103,-5921348
1647266068,197773,true,2577847210,28,2570639693,-7207517
1647266167,197771,true,2578362805,28,2570382655,-7980150
1647266249,197771,true,2578362805,28,2570125642,-8237163
1647266502,197769,true,2578878503,28,2569354759,-9523744
1647266866,197767,true,2579394305,28,2570125642,-9268663
1647266969,197765,true,2579910210,28,2570382655,-9527555
1647267039,197765,true,2579910210,28,2570896757,-9013453
1647267063,197764,true,2580168201,28,2570896757,-9271444
1647267075,197762,true,2580684260,28,2571153847,-9530413
1647267097,197760,true,2581200423,28,2571153847,-10046576
1647267365,197760,true,2581200423,28,2573468811,-7731612
1647267379,197759,true,2581458543,28,2573726158,-7732385
1647268942,197758,true,2581716689,28,2584041163,2324474
1647269112,197756,true,2582233058,28,2584041163,1808105
1647269127,197757,true,2581974860,28,2584041163,2066303
1647270010,197755,true,2582491281,28,2581974860,-516421
1647270272,197755,true,2582491281,28,2581716689,-774592
1647270615,197754,true,2582749530,28,2581200423,-1549107
1647270725,197754,true,2582749530,28,2581200423,-1549107
1647271755,197753,true,2583007805,28,2583266106,258301
1647272224,197752,true,2583266106,28,2583782785,516679
1647272274,197752,true,2583266106,28,2584041163,775057
1647272325,197752,true,2583266106,28,2584041163,775057
1647272422,197751,true,2583524433,28,2584041163,516730
1647272459,197751,true,2583524433,28,2584041163,516730
1647272557,197751,true,2583524433,28,2583782785,258352
1647272589,197752,true,2583266106,28,2583782785,516679
1647272615,197751,true,2583524433,28,2583782785,258352
1647272713,197751,true,2583524433,28,2583524433,0
1647272781,197752,true,2583266106,28,2583266106,0
1647272802,197752,true,2583266106,28,2583266106,0
1647272833,197752,true,2583266106,28,2583266106,0
1647272918,197751,true,2583524433,28,2583007805,-516628
1647272989,197752,true,2583266106,28,2582491281,-774825
1647274437,197752,true,2583266106,28,2576301043,-6965063
1647274602,197751,true,2583524433,28,2575785860,-7738573
1647274939,197751,true,2583524433,28,2575013279,-8511154
1647276195,197751,true,2583524433,28,2573211490,-10312943
1647276920,197752,true,2583266106,28,2572954195,-10311911
1647277001,197752,true,2583266106,28,2572954195,-10311911
1647277016,197751,true,2583524433,28,2572954195,-10570238
1647277037,197751,true,2583524433,28,2572954195,-10570238
1647277064,197752,true,2583266106,28,2572954195,-10311911
1647277156,197752,true,2583266106,28,2572954195,-10311911
1647277278,197752,true,2583266106,28,2572439681,-10826425
1647277292,197752,true,2583266106,28,2572439681,-10826425
1647277341,197753,true,2583007805,28,2572182463,-10825342
1647277391,197753,true,2583007805,28,2571925270,-11082535
1647277406,197753,true,2583007805,28,2571668103,-11339702
1647277530,197754,true,2582749530,28,2570639693,-12109837
1647277568,197755,true,2582491281,28,2570382655,-12108626
1647277575,197756,true,2582233058,28,2570125642,-12107416
1647278046,197757,true,2581974860,28,2564221441,-17753419
1647278914,197759,true,2581458543,28,2552964214,-28494329
1647278944,197760,true,2581200423,28,2552708943,-28491480
1647279185,197761,true,2580942328,28,2550412653,-30529675
1647279269,197762,true,2580684260,28,2549902647,-30781613
1647279274,197764,true,2580168201,28,2549902647,-30265554
1647279286,197765,true,2579910210,28,2549902647,-30007563
1647280418,197767,true,2579394305,28,2545062673,-34331632
1647280756,197768,true,2579136391,28,2543790524,-35345867
1647281699,197770,true,2578620641,28,2542773262,-35847379
1647281940,197772,true,2578104995,28,2542773262,-35331733
1647282156,197773,true,2577847210,28,2542773262,-35073948
1647282210,197776,true,2577074010,28,2542519010,-34555000
1647282218,197778,true,2576558673,28,2542519010,-34039663
1647282329,197779,true,2576301043,28,2542010582,-34290461
1647282380,197782,true,2575528307,28,2541756407,-33771900
1647282393,197784,true,2575013279,28,2541756407,-33256872
1647282413,197786,true,2574498353,28,2541756407,-32741946
1647282435,197788,true,2573983531,28,2541502257,-32481274
1647282480,197791,true,2573211490,28,2541248132,-31963358
1647282522,197793,true,2572696925,28,2540739958,-31956967
1647282543,197795,true,2572182463,28,2540739958,-31442505
1647282614,197797,true,2571668103,28,2539977889,-31690214
1647282643,197800,true,2570896757,28,2539723916,-31172841
1647282658,197803,true,2570125642,28,2539469969,-30655673
1647284120,197805,true,2569611694,28,2525794472,-43817222
1647284559,197808,true,2568840965,28,2525289389,-43551576
1647286755,197810,true,2568327274,28,2527563059,-40764215
1647287061,197813,true,2567556930,28,2527563059,-39993871
1647287103,197815,true,2567043495,28,2527815815,-39227680
1647287289,197818,true,2566273536,28,2527815815,-38457721
1647287325,197820,true,2565760359,28,2528068597,-37691762
1647287740,197822,true,2565247284,28,2528574236,-36673048
1647287776,197824,true,2564734311,28,2528574236,-36160075
1647288116,197827,true,2563965045,28,2529332884,-34632161
1647288173,197829,true,2563452328,28,2529585817,-33866511
1647288263,197831,true,2562939715,28,2529838776,-33100939
1647288407,197832,true,2562683447,28,2530344769,-32338678
1647288500,197834,true,2562170987,28,2530850863,-31320124
1647288517,197837,true,2561402489,28,2530850863,-30551626
1647289133,197838,true,2561146375,28,2534396358,-26750017
1647291284,197840,true,2560634222,28,2538454435,-22179787
1647291331,197841,true,2560378184,28,2538454435,-21923749
1647291345,197843,true,2559866185,28,2538454435,-21411750
1647291401,197845,true,2559354289,28,2538454435,-20899854
1647291480,197846,true,2559098379,28,2538200615,-20897764
1647291777,197848,true,2558586636,28,2537439307,-21147329
1647292041,197850,true,2558074996,28,2536170968,-21904028
1647293285,197851,true,2557819214,28,2530850863,-26968351
1647293710,197853,true,2557307727,28,2530597803,-26709924
1647293729,197855,true,2556796342,28,2530597803,-26198539
1647293807,197857,true,2556285059,28,2530850863,-25434196
1647295354,197858,true,2556029456,28,2534142944,-21886512
1647295402,197859,true,2555773879,28,2534142944,-21630935
1647295560,197861,true,2555262801,28,2534396358,-20866443
1647295572,197863,true,2554751825,28,2534396358,-20355467
1647295844,197863,true,2554751825,28,2535156753,-19595072
1647295846,197864,true,2554496375,28,2535156753,-19339622
1647295884,197865,true,2554240951,28,2535156753,-19084198
1647296498,197866,true,2553985553,28,2540739958,-13245595
1647296508,197865,true,2554240951,28,2540994032,-13246919
1647296953,197867,true,2553730180,28,2545826269,-7903911
1647297465,197867,true,2553730180,28,2551432971,-2297209
1647298016,197868,true,2553474832,28,2555262801,1787969
1647298093,197868,true,2553474832,28,2555773879,2299047
1647298123,197869,true,2553219510,28,2555773879,2554369
1647298133,197869,true,2553219510,28,2556029456,2809946
1647298135,197870,true,2552964214,28,2556029456,3065242
1647298149,197869,true,2553219510,28,2556029456,2809946
1647298161,197869,true,2553219510,28,2556285059,3065549
1647298435,197869,true,2553219510,28,2560890286,7670776
1647298478,197870,true,2552964214,28,2561658629,8694415
1647299586,197870,true,2552964214,28,2573983531,21019317
1647299627,197870,true,2552964214,28,2574498353,21534139
1647299672,197870,true,2552964214,28,2575013279,22049065
1647299729,197871,true,2552708943,28,2575785860,23076917
1647299753,197870,true,2552964214,28,2576301043,23336829
1647299770,197870,true,2552964214,28,2576558673,23594459
1647299875,197870,true,2552964214,28,2578104995,25140781
1647300336,197870,true,2552964214,28,2580168201,27203987
1647300801,197869,true,2553219510,28,2583007805,29788295
1647300816,197869,true,2553219510,28,2583007805,29788295
1647301494,197869,true,2553219510,28,2587661173,34441663
1647302534,197869,true,2553219510,28,2588955263,35735753
1647302612,197869,true,2553219510,28,2588955263,35735753
1647302927,197868,true,2553474832,28,2589473080,35998248
1647303298,197868,true,2553474832,28,2589732027,36257195
1647303366,197868,true,2553474832,28,2589473080,35998248
1647304354,197868,true,2553474832,28,2587143719,33668887
1647304807,197868,true,2553474832,28,2585850535,32375703
1647304829,197867,true,2553730180,28,2585591976,31861796
1647305079,197867,true,2553730180,28,2585591976,31861796
1647305123,197867,true,2553730180,28,2585591976,31861796
1647305306,197866,true,2553985553,28,2586367731,32382178
1647305385,197865,true,2554240951,28,2586885030,32644079
1647305414,197865,true,2554240951,28,2586885030,32644079
1647306041,197864,true,2554496375,28,2589732027,35235652
1647306287,197863,true,2554751825,28,2590768075,36016250
1647306331,197862,true,2555007300,28,2590768075,35760775
1647306402,197862,true,2555007300,28,2590768075,35760775
1647306437,197862,true,2555007300,28,2590768075,35760775
1647306562,197862,true,2555007300,28,2590509024,35501724
1647306586,197861,true,2555262801,28,2590249999,34987198
1647306590,197861,true,2555262801,28,2590249999,34987198
1647306644,197861,true,2555262801,28,2589991000,34728199
1647306657,197861,true,2555262801,28,2589732027,34469226
1647306675,197861,true,2555262801,28,2589473080,34210279
1647306891,197861,true,2555262801,28,2586885030,31622229
1647306990,197860,true,2555518327,28,2585074935,29556608
1647307034,197860,true,2555518327,28,2584299567,28781240
1647307042,197860,true,2555518327,28,2584041163,28522836
1647307213,197861,true,2555262801,28,2580168201,24905400
1647307229,197860,true,2555518327,28,2579910210,24391883
1647307303,197860,true,2555518327,28,2578104995,22586668
1647307326,197859,true,2555773879,28,2577589451,21815572
1647309446,197861,true,2555262801,28,2545571711,-9691090
1647310562,197860,true,2555518327,28,2545826269,-9692058
1647310676,197860,true,2555518327,28,2545826269,-9692058
1647310698,197860,true,2555518327,28,2545826269,-9692058
1647310864,197861,true,2555262801,28,2546335459,-8927342
1647311709,197859,true,2555773879,28,2548118429,-7655450
1647311721,197859,true,2555773879,28,2548118429,-7655450
1647311776,197859,true,2555773879,28,2548373241,-7400638
1647311804,197860,true,2555518327,28,2548628078,-6890249
1647311860,197858,true,2556029456,28,2548882941,-7146515
1647311863,197857,true,2556285059,28,2548882941,-7402118
1647312023,197856,true,2556540688,28,2550412653,-6128035
1647312868,197856,true,2556540688,28,2557052021,511333
1647313823,197854,true,2557052021,28,2562170987,5118966
1647314617,197854,true,2557052021,28,2562170987,5118966
1647314658,197852,true,2557563457,28,2562170987,4607530
1647314728,197851,true,2557819214,28,2562170987,4351773
1647315101,197849,true,2558330803,28,2561402489,3071686
1647315752,197849,true,2558330803,28,2559610224,1279421
1647316069,197847,true,2558842495,28,2557819214,-1023281
1647316081,197847,true,2558842495,28,2557819214,-1023281
1647316315,197845,true,2559354289,28,2556285059,-3069230
1647316342,197846,true,2559098379,28,2556285059,-2813320
1647316711,197844,true,2559610224,28,2553730180,-5880044
1647317673,197844,true,2559610224,28,2548882941,-10727283
1647317810,197842,true,2560122172,28,2548628078,-11494094
1647317986,197843,true,2559866185,28,2548118429,-11747756
1647318639,197841,true,2560378184,28,2547863643,-12514541
1647321292,197842,true,2560122172,28,2547863643,-12258529
1647324185,197840,true,2560634222,28,2547863643,-12770579
1647324612,197840,true,2560634222,28,2547608882,-13025340
1647324616,197839,true,2560890286,28,2547608882,-13281404
1647324650,197839,true,2560890286,28,2547608882,-13281404
1647325017,197838,true,2561146375,28,2547608882,-13537493
1647325071,197838,true,2561146375,28,2547863643,-13282732
1647325496,197836,true,2561658629,28,2549647682,-12010947
1647325915,197836,true,2561658629,28,2552453697,-9204932
1647326185,197835,true,2561914795,28,2554240951,-7673844
1647326427,197835,true,2561914795,28,2555773879,-6140916
1647326792,197834,true,2562170987,28,2557563457,-4607530
1647326807,197834,true,2562170987,28,2557819214,-4351773
1647326847,197832,true,2562683447,28,2557819214,-4864233
1647327027,197832,true,2562683447,28,2558074996,-4608451
1647327073,197830,true,2563196009,28,2558074996,-5121013
1647327100,197830,true,2563196009,28,2558074996,-5121013
1647327214,197829,true,2563452328,28,2557819214,-5633114
1647327247,197829,true,2563452328,28,2557819214,-5633114
1647327415,197827,true,2563965045,28,2557307727,-6657318
1647327442,197827,true,2563965045,28,2557307727,-6657318
1647327491,197826,true,2564221441,28,2557052021,-7169420
1647327571,197826,true,2564221441,28,2556796342,-7425099
1647327701,197825,true,2564477863,28,2556029456,-8448407
1647327721,197825,true,2564477863,28,2556029456,-8448407
1647328264,197825,true,2564477863,28,2551688114,-12789749
1647328286,197825,true,2564477863,28,2551432971,-13044892
1647328299,197824,true,2564734311,28,2551432971,-13301340
1647328346,197825,true,2564477863,28,2550922761,-13555102
1647328371,197827,true,2563965045,28,2550412653,-13552392
1647328557,197829,true,2563452328,28,2546335459,-17116869
1647328818,197828,true,2563708674,28,2540739958,-22968716
1647328974,197830,true,2563196009,28,2537946821,-25249188
1647329488,197831,true,2562939715,28,2530091760,-32847955
1647329781,197834,true,2562170987,28,2527310328,-34860659
1647331631,197833,true,2562427204,28,2528321404,-34105800
1647331661,197835,true,2561914795,28,2528321404,-33593391
1647332297,197837,true,2561402489,28,2528321404,-33081085
1647332328,197840,true,2560634222,28,2528321404,-32312818
1647332349,197840,true,2560634222,28,2528321404,-32312818
1647332626,197842,true,2560122172,28,2527563059,-32559113
1647333840,197844,true,2559610224,28,2524279526,-35330698
1647335238,197848,true,2558586636,28,2523270067,-35316569
1647335261,197848,true,2558586636,28,2523270067,-35316569
1647335290,197850,true,2558074996,28,2523270067,-34804929
1647335541,197853,true,2557307727,28,2523017765,-34289962
1647335800,197857,true,2556285059,28,2522261011,-34024048
1647336247,197857,true,2556285059,28,2521504484,-34780575
1647336260,197859,true,2555773879,28,2521504484,-34269395
1647336340,197862,true,2555007300,28,2521504484,-33502816
1647336793,197866,true,2553985553,28,2522513237,-31472316
1647338089,197866,true,2553985553,28,2527310328,-26675225
1647338367,197868,true,2553474832,28,2527310328,-26164504
1647338426,197871,true,2552708943,28,2527310328,-25398615
1647338531,197874,true,2551943283,28,2527310328,-24632955
1647338622,197874,true,2551943283,28,2527310328,-24632955
1647338798,197877,true,2551177853,28,2527310328,-23867525
1647339095,197879,true,2550667694,28,2527310328,-23357366
1647339128,197882,true,2549902647,28,2527310328,-22592319
1647339254,197882,true,2549902647,28,2527310328,-22592319
1647340522,197885,true,2549137829,28,2528574236,-20563593
1647341520,197887,true,2548628078,28,2529585817,-19042261
1647341627,197891,true,2547608882,28,2529838776,-17770106
1647342234,197891,true,2547608882,28,2530850863,-16758019
1647342927,197893,true,2547099436,28,2532369753,-14729683
1647342976,197895,true,2546590093,28,2532622990,-13967103
1647343136,197899,true,2545571711,28,2533129540,-12442171
1647343267,197899,true,2545571711,28,2533636192,-11935519
1647343510,197901,true,2545062673,28,2534396358,-10666315
1647343772,197903,true,2544553737,28,2534903263,-9650474
1647344946,197906,true,2543790524,28,2536424585,-7365939
1647345552,197905,true,2544044903,28,2536424585,-7620318
1647345734,197907,true,2543536170,28,2536424585,-7111585
1647347428,197908,true,2543281842,28,2536424585,-6857257
1647347593,197911,true,2542519010,28,2536931896,-5587114
1647347611,197910,true,2542773262,28,2536931896,-5841366
1647349355,197911,true,2542519010,28,2542519010,0
1647350257,197912,true,2542264783,28,2542519010,254227
1647351520,197914,true,2541756407,28,2543281842,1525435
1647351542,197913,true,2542010582,28,2543281842,1271260
1647351596,197913,true,2542010582,28,2543027539,1016957
1647351653,197913,true,2542010582,28,2543027539,1016957
1647351685,197916,true,2541248132,28,2543027539,1779407
1647351700,197915,true,2541502257,28,2542773262,1271005
1647351717,197914,true,2541756407,28,2542773262,1016855
1647351762,197915,true,2541502257,28,2542519010,1016753
1647351775,197918,true,2540739958,28,2542264783,1524825
1647352151,197917,true,2540994032,28,2539723916,-1270116
1647352819,197916,true,2541248132,28,2534649798,-6598334
1647353132,197918,true,2540739958,28,2532622990,-8116968
1647353172,197920,true,2540231887,28,2532622990,-7608897
1647354493,197919,true,2540485910,28,2535663810,-4822100
1647354596,197918,true,2540739958,28,2536678228,-4061730
1647354622,197920,true,2540231887,28,2536931896,-3299991
1647354628,197923,true,2539469969,28,2537185589,-2284380
1647354666,197921,true,2539977889,28,2537439307,-2538582
1647354677,197920,true,2540231887,28,2537693051,-2538836
1647354696,197921,true,2539977889,28,2537946821,-2031068
1647355344,197924,true,2539216048,28,2545571711,6355663
1647355681,197922,true,2539723916,28,2549137829,9413913
1647355793,197920,true,2540231887,28,2550412653,10180766
1647356090,197922,true,2539723916,28,2553474832,13750916
1647356692,197924,true,2539216048,28,2557307727,18091679
1647357550,197922,true,2539723916,28,2558586636,18862720
1647357569,197920,true,2540231887,28,2558586636,18354749
1647357603,197921,true,2539977889,28,2558586636,18608747
1647357625,197923,true,2539469969,28,2558842495,19372526
1647358191,197919,true,2540485910,28,2560634222,20148312
1647358302,197918,true,2540739958,28,2561146375,20406417
1647358306,197919,true,2540485910,28,2561402489,20916579
1647358347,197920,true,2540231887,28,2561658629,21426742
1647358358,197917,true,2540994032,28,2561658629,20664597
1647358381,197915,true,2541502257,28,2561914795,20412538
1647358612,197915,true,2541502257,28,2563708674,22206417
1647358830,197916,true,2541248132,28,2566016935,24768803
1647358856,197913,true,2542010582,28,2566273536,24262954
1647359385,197910,true,2542773262,28,2572439681,29666419
1647359809,197911,true,2542519010,28,2576301043,33782033
1647360089,197912,true,2542264783,28,2578620641,36355858
1647360125,197909,true,2543027539,28,2578878503,35850964
1647360155,197907,true,2543536170,28,2578878503,35342333
1647360798,197908,true,2543281842,28,2579136391,35854549
1647360867,197909,true,2543027539,28,2578878503,35850964
1647360943,197906,true,2543790524,28,2578878503,35087979
1647361180,197904,true,2544299307,28,2578620641,34321334
1647361280,197905,true,2544044903,28,2578878503,34833600
1647361303,197906,true,2543790524,28,2578878503,35087979
1647361417,197903,true,2544553737,28,2578878503,34324766
1647361457,197901,true,2545062673,28,2579136391,34073718
1647361528,197901,true,2545062673,28,2579394305,34331632
1647362118,197902,true,2544808193,28,2582233058,37424865
1647362141,197898,true,2545826269,28,2582233058,36406789
1647362163,197896,true,2546335459,28,2582491281,36155822
1647362720,197896,true,2546335459,28,2587919939,41584480
1647362743,197896,true,2546335459,28,2588437549,42102090
1647362778,197892,true,2547354146,28,2588696393,41342247
1647362792,197890,true,2547863643,28,2588955263,41091620
1647362838,197888,true,2548373241,28,2589473080,41099839
1647363109,197888,true,2548373241,28,2593360009,44986768
1647363658,197884,true,2549392743,28,2599071396,49678653
1647364014,197881,true,2550157637,28,2602191998,52034361
1647364129,197878,true,2550922761,28,2602712462,51789701
1647364288,197877,true,2551177853,28,2603493354,52315501
1647364411,197872,true,2552453697,28,2604014079,51560382
1647364460,197870,true,2552964214,28,2604014079,51049865
1647364484,197867,true,2553730180,28,2604014079,50283899
1647364558,197866,true,2553985553,28,2604014079,50028526
1647364808,197863,true,2554751825,28,2602712462,47960637
1647364845,197860,true,2555518327,28,2602452217,46933890
1647364865,197858,true,2556029456,28,2602452217,46422761
1647365197,197857,true,2556285059,28,2599591236,43306177
1647365605,197854,true,2557052021,28,2596473754,39421733
1647366565,197851,true,2557819214,28,2590768075,32948861
1647366678,197848,true,2558586636,28,2590509024,31922388
1647366916,197848,true,2558586636,28,2590768075,32181439
1647367004,197844,true,2559610224,28,2590768075,31157851
1647367125,197842,true,2560122172,28,2591027152,30904980
1647367151,197839,true,2560890286,28,2591027152,30136866
1647367316,197837,true,2561402489,28,2591545383,30142894
1647367993,197834,true,2562170987,28,2593360009,31189022
1647369949,197831,true,2562939715,28,2598811515,35871800
1647370265,197828,true,2563708674,28,2600111181,36402507
1647370424,197827,true,2563965045,28,2600891292,36926247
1647370548,197824,true,2564734311,28,2601411496,36677185
1647370762,197820,true,2565760359,28,2602712462,36952103
1647370776,197816,true,2566786817,28,2602712462,35925645
1647370790,197815,true,2567043495,28,2602972733,35929238
1647370833,197812,true,2567813685,28,2603493354,35679669
1647370856,197806,true,2569354759,28,2604014079,34659320
1647370887,197803,true,2570125642,28,2604534907,34409265
1647370936,197801,true,2570639693,28,2605316346,34676653
1647371131,197797,true,2571668103,28,2608966161,37298058
1647371160,197792,true,2572954195,28,2609487980,36533785
1647371176,197788,true,2573983531,28,2609748929,35765398
1647371501,197786,true,2574498353,28,2617589539,43091186
1647371967,197782,true,2575528307,28,2629131730,53603423
1647371974,197777,true,2576816329,28,2629394643,52578314
1647374236,197772,true,2578104995,28,2652103811,73998816
1647374427,197770,true,2578620641,28,2652369021,73748380
1647374474,197765,true,2579910210,28,2652369021,72458811
1647374481,197761,true,2580942328,28,2652369021,71426693
1647374505,197756,true,2582233058,28,2652369021,70135963
1647374529,197754,true,2582749530,28,2652369021,69619491
1647374787,197749,true,2584041163,28,2653695471,69654308
1647374990,197744,true,2585333442,28,2654491659,69158217
1647375048,197739,true,2586626368,28,2654757108,68130740
1647375060,197737,true,2587143719,28,2654757108,67613389
1647375073,197732,true,2588437549,28,2654757108,66319559
1647375215,197728,true,2589473080,28,2655022584,65549504
1647375232,197724,true,2590509024,28,2655022584,64513560
1647375348,197722,true,2591027152,28,2654757108,63729956
1647375378,197717,true,2592322925,28,2654757108,62434183
1647375558,197713,true,2593360009,28,2654226237,60866228
1647375573,197709,true,2594397509,28,2654226237,59828728
1647375751,197707,true,2594916414,28,2653695471,58779057
1647375774,197702,true,2596214132,28,2653695471,57481339
1647375806,197698,true,2597252774,28,2653430128,56177354
1647375822,197694,true,2598291831,28,2653430128,55138297
1647376302,197692,true,2598811515,28,2650513105,51701590
1647377215,197687,true,2600111181,28,2640988888,40877707
1647377360,197683,true,2601151381,28,2639932757,38781376
1647377652,197679,true,2602191998,28,2638085543,35893545
1647377665,197677,true,2602712462,28,2638085543,35373081
1647377848,197673,true,2603753703,28,2637030572,33276869
1647377959,197670,true,2604534907,28,2636239621,31704714
1647378017,197666,true,2605576878,28,2635712453,30135575
1647378347,197664,true,2606098019,28,2633604831,27506812
1647378375,197662,true,2606619265,28,2633341497,26722232
1647378399,197660,true,2607140615,28,2633078189,25937574
1647378464,197656,true,2608183627,28,2632288424,24104797
1647378728,197656,true,2608183627,28,2629657582,21473955
1647378785,197653,true,2608966161,28,2628868843,19902682
1647378871,197651,true,2609487980,28,2627817558,18329578
1647379123,197648,true,2610270905,28,2624928692,14657787
1647379802,197648,true,2610270905,28,2618636732,8365827
1647379841,197646,true,2610792985,28,2618374894,7581909
1647380483,197643,true,2611576301,28,2618113083,6536782
1647380846,197640,true,2612359853,28,2619160485,6800632
1647381061,197639,true,2612621088,28,2620208306,7587218
1647381261,197637,true,2613143639,28,2621256547,8112908
1647381387,197635,true,2613666294,28,2622043003,8376709
1647381896,197631,true,2614711917,28,2624141371,9429454
1647381994,197630,true,2614973388,28,2624403785,9430397
1647382199,197629,true,2615234886,28,2625191185,9956299
1647382252,197627,true,2615757959,28,2625453704,9695745
1647382284,197624,true,2616542765,28,2625716250,9173485
1647382317,197623,true,2616804419,28,2625978821,9174402
1647382944,197621,true,2617327806,28,2630709603,13381797
1647382975,197619,true,2617851298,28,2630972674,13121376
1647382987,197616,true,2618636732,28,2630972674,12335942
1647383116,197615,true,2618898595,28,2631498895,12600300
1647383284,197614,true,2619160485,28,2631762045,12601560
1647383562,197612,true,2619684343,28,2632551652,12867309
1647383610,197609,true,2620470327,28,2632551652,12081325
1647384279,197608,true,2620732374,28,2631762045,11029671
1647385705,197607,true,2620994448,28,2628605982,7611534
1647385741,197605,true,2621518673,28,2628605982,7087309
1647385761,197602,true,2622305207,28,2628605982,6300775
1647386007,197601,true,2622567437,28,2628605982,6038545
1647386254,197601,true,2622567437,28,2627554803,4987366
1647388427,197599,true,2623091977,28,2622305207,-786770
1647388805,197597,true,2623616622,28,2622305207,-1311415
1647389220,197597,true,2623616622,28,2622305207,-1311415
1647389270,197596,true,2623878983,28,2622305207,-1573776
1647389642,197595,true,2624141371,28,2622305207,-1836164
1647390120,197592,true,2624928692,28,2622305207,-2623485
1647390175,197593,true,2624666226,28,2622305207,-2361019
1647390232,197592,true,2624928692,28,2622043003,-2885689
1647390813,197592,true,2624928692,28,2619422401,-5506291
1647393307,197591,true,2625191185,28,2614711917,-10479268
1647393311,197591,true,2625191185,28,2614973388,-10217797
1647393324,197591,true,2625191185,28,2614973388,-10217797
1647393325,197590,true,2625453704,28,2614973388,-10480316
1647393338,197589,true,2625716250,28,2614973388,-10742862
1647393851,197589,true,2625716250,28,2616542765,-9173485
1647394939,197589,true,2625716250,28,2620470327,-5245923
1647394973,197588,true,2625978821,28,2620732374,-5246447
1647394974,197586,true,2626504043,28,2620732374,-5771669
1647395149,197586,true,2626504043,28,2622043003,-4461040
1647395180,197584,true,2627029371,28,2622305207,-4724164
1647395428,197582,true,2627554803,28,2625191185,-2363618
1647395585,197581,true,2627817558,28,2626766694,-1050864
1647396186,197580,true,2628080340,28,2633604831,5524491
1647396242,197577,true,2628868843,28,2634394992,5526149
1647396320,197575,true,2629394643,28,2635448908,6054265
1647396366,197573,true,2629920548,28,2636503245,6582697
1647396395,197571,true,2630446559,28,2637030572,6584013
1647396437,197569,true,2630972674,28,2637821761,6849087
1647396449,197566,true,2631762045,28,2638085543,6323498
1647396461,197564,true,2632288424,28,2638613186,6324762
1647396482,197561,true,2633078189,28,2639140935,6062746
1647396507,197557,true,2634131578,28,2640196750,6065172
1647396531,197554,true,2634921897,28,2640988888,6066991
1647396540,197552,true,2635448908,28,2641517112,6068204
1647396620,197548,true,2636503245,28,2644688677,8185432
1647396679,197544,true,2637558005,28,2647334556,9776551
1647396706,197542,true,2638085543,28,2648393649,10308106
1647396716,197540,true,2638613186,28,2648923354,10310168
1647396797,197536,true,2639668790,28,2652634258,12965468
1647396885,197531,true,2640988888,28,2656881658,15892770
1647396931,197530,true,2641252987,28,2659007907,17754920
1647396974,197528,true,2641781264,28,2661135858,19354594
1647397136,197524,true,2642838135,28,2668330273,25492138
1647397242,197519,true,2644159819,28,2673137352,28977533
1647397392,197518,true,2644424235,28,2679828221,35403986
1647397461,197516,true,2644953146,28,2682777507,37824361
1647397470,197513,true,2645746711,28,2683314089,37567378
1647397505,197509,true,2646805169,28,2684656015,37850846
1647397509,197508,true,2647069849,28,2684924480,37854631
1647397522,197507,true,2647334556,28,2685461492,38126936
1647397596,197504,true,2648128836,28,2688416977,40288141
1647397685,197501,true,2648923354,28,2691644852,42721498
1647397722,197500,true,2649188246,28,2692990944,43802698
1647397779,197500,true,2649188246,28,2695146091,45957845
1647397823,197497,true,2649983082,28,2696493933,46510851
1647397849,197495,true,2650513105,28,2697572693,47059588
1647397891,197495,true,2650513105,28,2698921749,48408644
1647397940,197494,true,2650778157,28,2700541507,49763350
1647398906,197492,true,2651308339,28,2706488941,55180602
1647399009,197490,true,2651838627,28,2705136102,53297475
1647399252,197489,true,2652103811,28,2701892048,49788237
1647399288,197488,true,2652369021,28,2701351750,48982729
1647399355,197486,true,2652899522,28,2700811561,47912039
1647399375,197484,true,2653430128,28,2700541507,47111379
1647399941,197483,true,2653695471,28,2697572693,43877222
1647400003,197482,true,2653960841,28,2697302962,43342121
1647400140,197480,true,2654491659,28,2696763583,42271924
1647400274,197478,true,2655022584,28,2695954716,40932132
1647400296,197477,true,2655288086,28,2695685147,40397061
1647400305,197476,true,2655553615,28,2695685147,40131532
1647400322,197474,true,2656084753,28,2695415605,39330852
1647400372,197472,true,2656615996,28,2694607142,37991146
1647400787,197476,true,2655553615,28,2680096204,24542589
1647401025,197476,true,2655553615,28,2672335572,16781957
1647401118,197473,true,2656350361,28,2669130852,12780491
1647401539,197472,true,2656615996,28,2657413061,797065
1647401773,197475,true,2655819171,28,2650778157,-5041014
1647401878,197474,true,2656084753,28,2647864049,-8220704
1647401964,197471,true,2656881658,28,2645217641,-11664017
1647402024,197470,true,2657147346,28,2643631066,-13516280
1647402047,197473,true,2656350361,28,2642838135,-13512226
1647402086,197473,true,2656350361,28,2641252987,-15097374
1647402141,197470,true,2657147346,28,2639404849,-17742497
1647402301,197469,true,2657413061,28,2637558005,-19855056
1647402424,197473,true,2656350361,28,2636766896,-19583465
1647402674,197472,true,2656615996,28,2635185389,-21430607
1647404281,197469,true,2657413061,28,2624666226,-32746835
1647404594,197468,true,2657678802,28,2624141371,-33537431
1647404613,197472,true,2656615996,28,2624141371,-32474625
1647404618,197472,true,2656615996,28,2624141371,-32474625
1647409298,197470,true,2657147346,28,2617066099,-40081247
1647409441,197469,true,2657413061,28,2617327806,-40085255
1647410860,197473,true,2656350361,28,2622305207,-34045154
1647410907,197473,true,2656350361,28,2622305207,-34045154
1647411024,197470,true,2657147346,28,2622829694,-34317652
1647411101,197469,true,2657413061,28,2623354286,-34058775
1647411151,197473,true,2656350361,28,2623354286,-32996075
1647411329,197473,true,2656350361,28,2624141371,-32208990
1647411462,197471,true,2656881658,28,2624403785,-32477873
1647411481,197471,true,2656881658,28,2624403785,-32477873
1647411967,197474,true,2656084753,28,2626766694,-29318059
1647412467,197474,true,2656084753,28,2629394643,-26690110
1647412486,197471,true,2656881658,28,2629394643,-27487015
1647412623,197470,true,2657147346,28,2630183540,-26963806
1647412697,197474,true,2656084753,28,2630709603,-25375150
1647412733,197473,true,2656350361,28,2630972674,-25377687
1647412790,197470,true,2657147346,28,2631498895,-25648451
1647412804,197469,true,2657413061,28,2631762045,-25651016
1647413953,197472,true,2656615996,28,2637821761,-18794235
1647414385,197472,true,2656615996,28,2639404849,-17211147
1647414849,197469,true,2657413061,28,2639668790,-17744271
1647415844,197467,true,2657944570,28,2639932757,-18011813
1647417069,197470,true,2657147346,28,2639932757,-17214589
1647417118,197469,true,2657413061,28,2640196750,-17216311
1647417720,197466,true,2658210364,28,2640724816,-17485548
1647418081,197465,true,2658476185,28,2641517112,-16959073
1647418129,197467,true,2657944570,28,2641517112,-16427458
1647418153,197467,true,2657944570,28,2641781264,-16163306
1647418194,197463,true,2659007907,28,2642045442,-16962465
1647418896,197461,true,2659539735,28,2647069849,-12469886
1647419357,197462,true,2659273808,28,2650778157,-8495651
1647419903,197461,true,2659539735,28,2654757108,-4782627
1647419927,197458,true,2660337677,28,2655022584,-5315093
1647419952,197455,true,2661135858,28,2655288086,-5847772
1647419993,197456,true,2660869771,28,2655819171,-5050600
1647420027,197454,true,2661401972,28,2656084753,-5317219
1647420091,197451,true,2662200472,28,2656881658,-5318814
1647420398,197448,true,2662999212,28,2659539735,-3459477
1647420426,197450,true,2662466692,28,2659805689,-2661003
1647421113,197447,true,2663265512,28,2667529934,4264422
1647421354,197444,true,2664064572,28,2669931672,5867100
1647421554,197442,true,2664597411,28,2671801185,7203774
1647421714,197444,true,2664064572,28,2673939374,9874802
1647423221,197442,true,2664597411,28,2680096204,15498793
1647424148,197439,true,2665396870,28,2680364214,14967344
1647424728,197437,true,2665929976,28,2680364214,14434238
1647425739,197439,true,2665396870,28,2680364214,14967344
1647425892,197437,true,2665929976,28,2681168404,15238428
1647426875,197434,true,2666729835,28,2685730038,19000203
1647426953,197433,true,2666996508,28,2685998611,19002103
1647426976,197435,true,2666463189,28,2685998611,19535422
1647426994,197433,true,2666996508,28,2685998611,19002103
1647428521,197432,true,2667263208,28,2683582421,16319213
1647429016,197432,true,2667263208,28,2682509256,15246048
1647429337,197435,true,2666463189,28,2682509256,16046067
1647430388,197434,true,2666729835,28,2681168404,14438569
1647430435,197434,true,2666729835,28,2681168404,14438569
1647430492,197434,true,2666729835,28,2681168404,14438569
1647430516,197438,true,2665663410,28,2681436520,15773110
1647430648,197435,true,2666463189,28,2682509256,16046067
1647431712,197435,true,2666463189,28,2691106604,24643415
1647432554,197436,true,2666196569,28,2695685147,29488578
1647432774,197440,true,2665130357,28,2695685147,30554790
1647432833,197437,true,2665929976,28,2695685147,29755171
1647433107,197438,true,2665663410,28,2695415605,29752195
1647433169,197440,true,2665130357,28,2695146091,30015734
1647433209,197444,true,2664064572,28,2695146091,31081519
1647433269,197441,true,2664863871,28,2694607142,29743271
1647433339,197443,true,2664330978,28,2694337709,30006731
1647433642,197445,true,2663798192,28,2692452426,28654234
1647434337,197449,true,2662732939,28,2688148162,25415223
1647434629,197446,true,2663531839,28,2686267211,22735372
1647434824,197447,true,2663265512,28,2685192973,21927461
1647434857,197448,true,2662999212,28,2684924480,21925268
1647436062,197453,true,2661668112,28,2678488709,16820597
1647436447,197450,true,2662466692,28,2676346882,13880190
1647436453,197451,true,2662200472,28,2676079274,13878802
1647436472,197452,true,2661934279,28,2676079274,14144995
1647437448,197457,true,2660603711,28,2673137352,12533641
1647437722,197454,true,2661401972,28,2673137352,11735380
1647437823,197455,true,2661135858,28,2673137352,12001494
1647437844,197456,true,2660869771,28,2673137352,12267581
1647437944,197460,true,2659805689,28,2673404666,13598977
1647438850,197456,true,2660869771,28,2677685323,16815552
1647439258,197457,true,2660603711,28,2679828221,19224510
1647439260,197458,true,2660337677,28,2679828221,19490544
1647439270,197461,true,2659539735,28,2679828221,20288486
1647439469,197458,true,2660337677,28,2681436520,21098843
1647439473,197457,true,2660603711,28,2681436520,20832809
1647439478,197458,true,2660337677,28,2681436520,21098843
1647439998,197462,true,2659273808,28,2681972834,22699026
1647440087,197459,true,2660071670,28,2682241032,22169362
1647440148,197458,true,2660337677,28,2682241032,21903355
1647440159,197458,true,2660337677,28,2682241032,21903355
1647440179,197457,true,2660603711,28,2682509256,21905545
1647440200,197453,true,2661668112,28,2682509256,20841144
1647440391,197450,true,2662466692,28,2685461492,22994800
1647440436,197449,true,2662732939,28,2685998611,23265672
1647441622,197448,true,2662999212,28,2702162237,39163025
1647441757,197444,true,2664064572,28,2704324723,40260151
1647441798,197441,true,2664863871,28,2704865615,40001744
1647441977,197440,true,2665130357,28,2707300968,42170611
1647442762,197439,true,2665396870,28,2705947724,40550854
1647442810,197434,true,2666729835,28,2705947724,39217889
1647442974,197431,true,2667529934,28,2705677156,38147222
1647443007,197429,true,2668063467,28,2705677156,37613689
1647443078,197428,true,2668330273,28,2705677156,37346883
1647443096,197423,true,2669664705,28,2705947724,36283019
1647443158,197419,true,2670732731,28,2705947724,35214993
1647443343,197417,true,2671266905,28,2706759589,35492684
1647443512,197416,true,2671534031,28,2707571699,36037668
1647443626,197411,true,2672870065,28,2708113240,35243175
1647445160,197406,true,2674206768,28,2714620192,40413424
1647445387,197404,true,2674741636,28,2714077349,39335713
1647445623,197403,true,2675009110,28,2713534615,38525505
1647445838,197398,true,2676346882,28,2712991989,36645107
1647445867,197395,true,2677149866,28,2712991989,35842123
1647446632,197393,true,2677685323,28,2710009488,32324165
1647446667,197392,true,2677953092,28,2709738514,31785422
1647446671,197387,true,2679292336,28,2709738514,30446178
1647447720,197383,true,2680364214,28,2711635900,31271686
1647447796,197382,true,2680632250,28,2711635900,31003650
1647447906,197381,true,2680900313,28,2711635900,30735587
1647447920,197377,true,2681972834,28,2711635900,29663066
1647447956,197373,true,2683045785,28,2711364764,28318979
1647448067,197372,true,2683314089,28,2711093654,27779565
1647448297,197372,true,2683314089,28,2709738514,26424425
1647448922,197369,true,2684119164,28,2702162237,18043073
1647450496,197366,true,2684924480,28,2692721672,7797192
1647450693,197365,true,2685192973,28,2691914017,6721044
1647450783,197365,true,2685192973,28,2691644852,6451879
1647451702,197362,true,2685998611,28,2687073172,1074561
1647451841,197360,true,2686535838,28,2686804491,268653
1647451876,197359,true,2686804491,28,2686535838,-268653
1647451907,197359,true,2686804491,28,2686535838,-268653
1647451983,197355,true,2687879374,28,2687073172,-806202
1647452047,197352,true,2688685819,28,2687341879,-1343940
1647452338,197350,true,2689223583,28,2689492505,268922
1647453172,197351,true,2688954687,28,2698921749,9967062
1647453335,197347,true,2690030430,28,2700541507,10511077
1647453600,197344,true,2690837520,28,2702972967,12135447
1647453631,197344,true,2690837520,28,2702972967,12135447
1647453670,197345,true,2690568463,28,2702972967,12404504
1647453694,197341,true,2691644852,28,2702972967,11328115
1647453710,197339,true,2692183208,28,2703243264,11060056
1647453717,197339,true,2692183208,28,2703243264,11060056
1647453824,197340,true,2691914017,28,2702162237,10248220
1647453846,197338,true,2692452426,28,2701892048,9439622
1647453866,197337,true,2692721672,28,2701621886,8900214
1647453872,197337,true,2692721672,28,2701621886,8900214
1647453891,197339,true,2692183208,28,2701351750,9168542
1647453921,197338,true,2692452426,28,2700811561,8359135
1647454033,197339,true,2692183208,28,2697842450,5659242
1647454069,197338,true,2692452426,28,2696763583,4311157
1647454107,197341,true,2691644852,28,2695954716,4309864
1647454109,197340,true,2691914017,28,2695954716,4040699
1647454177,197340,true,2691914017,28,2694607142,2693125
1647454195,197340,true,2691914017,28,2694337709,2423692
1647454263,197343,true,2691106604,28,2692721672,1615068
1647454337,197343,true,2691106604,28,2690837520,-269084
1647454501,197344,true,2690837520,28,2686804491,-4033029
1647454707,197343,true,2691106604,28,2681704664,-9401940
1647454809,197346,true,2690299433,28,2679560265,-10739168
1647455155,197346,true,2690299433,28,2671801185,-18498248
1647455320,197346,true,2690299433,28,2668330273,-21969160
1647455405,197346,true,2690299433,28,2666729835,-23569598
1647455459,197349,true,2689492505,28,2665929976,-23562529
1647455488,197349,true,2689492505,28,2665130357,-24362148
1647455517,197349,true,2689492505,28,2664330978,-25161527
1647455536,197349,true,2689492505,28,2664064572,-25427933
1647455843,197353,true,2688416977,28,2659539735,-28877242
1647455851,197355,true,2687879374,28,2659539735,-28339639
1647455862,197356,true,2687610613,28,2659539735,-28070878
1647455965,197355,true,2687879374,28,2659007907,-28871467
1647456009,197358,true,2687073172,28,2658742033,-28331139
1647456100,197359,true,2686804491,28,2659007907,-27796584
1647456127,197360,true,2686535838,28,2659007907,-27527931
1647456162,197359,true,2686804491,28,2659273808,-27530683
1647457792,197361,true,2686267211,28,2675811693,-10455518
1647457824,197361,true,2686267211,28,2676079274,-10187937
1647457850,197362,true,2685998611,28,2676346882,-9651729
1647457856,197360,true,2686535838,28,2676346882,-10188956
1647457874,197361,true,2686267211,28,2676614517,-9652694
1647457925,197361,true,2686267211,28,2677149866,-9117345
1647457983,197361,true,2686267211,28,2677685323,-8581888
1647458005,197360,true,2686535838,28,2677685323,-8850515
1647458137,197360,true,2686535838,28,2678756558,-7779280
1647458182,197359,true,2686804491,28,2679024434,-7780057
1647458353,197359,true,2686804491,28,2681168404,-5636087
1647458365,197357,true,2687341879,28,2681168404,-6173475
1647458408,197356,true,2687610613,28,2681972834,-5637779
1647458430,197356,true,2687610613,28,2682241032,-5369581
1647458435,197354,true,2688148162,28,2682509256,-5638906
1647458467,197352,true,2688685819,28,2683045785,-5640034
1647458728,197351,true,2688954687,28,2688685819,-268868
1647458737,197351,true,2688954687,28,2688685819,-268868
1647458759,197350,true,2689223583,28,2689223583,0
1647458773,197348,true,2689761454,28,2689492505,-268949
1647458788,197346,true,2690299433,28,2690030430,-269003
1647458830,197346,true,2690299433,28,2691106604,807171
1647458846,197345,true,2690568463,28,2691644852,1076389
1647459043,197341,true,2691644852,28,2698651884,7007032
1647459150,197339,true,2692183208,28,2702432453,10249245
1647459280,197338,true,2692452426,28,2706759589,14307163
1647459562,197337,true,2692721672,28,2716249371,23527699
1647459565,197334,true,2693529569,28,2716520996,22991427
1647459766,197332,true,2694068302,28,2722231398,28163096
1647459842,197332,true,2694068302,28,2724409946,30341644
1647459943,197333,true,2693798922,28,2726862896,33063974
1647460005,197330,true,2694607142,28,2728499423,33892281
1647460068,197328,true,2695146091,28,2729863945,34717854
1647460122,197328,true,2695146091,28,2730956055,35809964
1647460170,197329,true,2694876603,28,2731775423,36898820
1647460245,197326,true,2695685147,28,2733141584,37456437
1647460319,197324,true,2696224311,28,2734235005,38010694
1647460756,197323,true,2696493933,28,2738886925,42392992
1647461085,197324,true,2696224311,28,2740256642,44032331
1647461260,197321,true,2697033259,28,2741078801,44045542
1647461509,197319,true,2697572693,28,2744095496,46522803
1647461568,197318,true,2697842450,28,2744644343,46801893
1647461628,197318,true,2697842450,28,2745742365,47899915
1647461640,197315,true,2698651884,28,2745742365,47090481
1647461671,197312,true,2699461560,28,2746291541,46829981
1647461778,197311,true,2699731506,28,2748214522,48483016
1647461780,197311,true,2699731506,28,2748214522,48483016
1647462008,197308,true,2700541507,28,2752339731,51798224
1647462080,197305,true,2701351750,28,2753440832,52089082
1647462148,197304,true,2701621886,28,2754542373,52920487
1647462312,197304,true,2701621886,28,2756746778,55124892
1647462351,197300,true,2702702696,28,2757298155,54595459
1647462678,197297,true,2703513588,28,2763646922,60133334
1647462723,197295,true,2704054318,28,2764752547,60698229
1647462792,197295,true,2704054318,28,2765858614,61804296
1647463246,197291,true,2705136102,28,2774168232,69032130
1647463938,197288,true,2705947724,28,2780277815,74330091
1647464231,197286,true,2706488941,28,2781946399,75457458
1647464326,197285,true,2706759589,28,2781946399,75186810
1647464403,197281,true,2707842456,28,2781668232,73825776
1647464964,197277,true,2708925755,28,2780277815,71352060
1647464987,197275,true,2709467567,28,2780277815,70810248
1647465287,197274,true,2709738514,28,2779721843,69983329
1647465421,197270,true,2710822572,28,2779443898,68621326
1647465433,197266,true,2711907064,28,2779443898,67536834
1647465484,197263,true,2712720717,28,2779165982,66445265
1647465636,197262,true,2712991989,28,2778332399,65340410
1647466095,197259,true,2713805968,28,2775000566,61194598
1647467026,197255,true,2714891654,28,2769733334,54841680
1647467074,197253,true,2715434659,28,2769456388,54021729
1647467383,197253,true,2715434659,28,2768072075,52637416
1647468378,197250,true,2716249371,28,2766688454,50439083
1647468959,197247,true,2717064327,28,2766135199,49070872
1647469391,197245,true,2717607767,28,2765029022,47421255
1647470713,197246,true,2717336034,28,2756195512,38859478
1647470790,197243,true,2718151316,28,2755919920,37768604
1647472710,197239,true,2719238740,28,2753440832,34202092
1647472773,197238,true,2719510664,28,2753716176,34205512
1647472911,197238,true,2719510664,28,2753716176,34205512
1647472963,197235,true,2720326598,28,2753991547,33664949
1647473058,197231,true,2721414892,28,2754542373,33127481
1647473951,197228,true,2722231398,28,2761436999,39205601
1647474239,197227,true,2722503621,28,2763923287,41419666
1647474942,197225,true,2723048149,28,2767518544,44470395
1647474979,197220,true,2724409946,28,2767795296,43385350
1647475265,197216,true,2725499873,28,2767795296,42295423
1647475288,197213,true,2726317605,28,2767795296,41477691
1647475312,197211,true,2726862896,28,2767795296,40932400
1647475317,197205,true,2728499423,28,2767795296,39295873
1647475670,197201,true,2729590986,28,2768902580,39311594
1647475741,197199,true,2730136932,28,2769179470,39042538
1647476873,197197,true,2730682986,28,2770564337,39881351
1647477139,197192,true,2732048601,28,2770564337,38515736
1647477178,197187,true,2733414898,28,2770564337,37149439
1647477455,197185,true,2733961609,28,2769733334,35771725
1647477654,197183,true,2734508428,28,2768902580,34394152
1647479602,197178,true,2735875956,28,2763646922,27770966
1647480245,197174,true,2736970471,28,2763923287,26952816
1647480427,197172,true,2737517892,28,2763923287,26405395
1647481628,197170,true,2738065423,28,2763370585,25305162
1647481640,197165,true,2739434730,28,2763370585,23935855
1647481682,197160,true,2740804721,28,2763370585,22565864
1647481822,197158,true,2741352909,28,2764476099,23123190
1647481846,197154,true,2742449615,28,2764476099,22026484
1647482568,197149,true,2743821114,28,2767518544,23697430
1647483922,197144,true,2745193299,28,2772504314,27311015
1647485596,197141,true,2746016939,28,2772781564,26764625
1647486492,197138,true,2746840827,28,2772504314,25663487
1647486618,197133,true,2748214522,28,2772504314,24289792
1647489146,197129,true,2749313973,28,2772504314,23190341
1647489798,197127,true,2749863863,28,2772504314,22640451
1647489817,197124,true,2750688905,28,2772504314,21815409
1647489935,197121,true,2751514194,28,2772504314,20990120
1647490035,197117,true,2752614965,28,2772227091,19612126
1647490110,197115,true,2753165515,28,2771949896,18784381
1647490898,197112,true,2753991547,28,2768902580,14911033
1647492705,197110,true,2754542373,28,2765858614,11316241
1647493135,197106,true,2755644355,28,2766135199,10490844
1647494306,197104,true,2756195512,28,2766135199,9939687
1647497087,197102,true,2756746778,28,2766135199,9388421
1647498677,197099,true,2757573885,28,2766411813,8837928
1647498697,197096,true,2758401240,28,2766411813,8010573
1647498855,197095,true,2758677080,28,2766411813,7734733
1647498888,197093,true,2759228843,28,2766411813,7182970
1647499143,197091,true,2759780717,28,2766135199,6354482
1647499644,197088,true,2760608734,28,2765582055,4973321
1647499788,197087,true,2760884795,28,2765029022,4144227
1647499877,197085,true,2761436999,28,2764752547,3315548
1647499915,197084,true,2761713143,28,2764476099,2762956
1647500006,197082,true,2762265513,28,2763923287,1657774
1647500137,197082,true,2762265513,28,2763370585,1105072
1647500540,197080,true,2762817994,28,2760884795,-1933199
1647501224,197080,true,2762817994,28,2757573885,-5244109
1647503923,197077,true,2763646922,28,2755919920,-7727002
1647504378,197078,true,2763370585,28,2755919920,-7450665
1647504754,197078,true,2763370585,28,2756195512,-7175073
1647505556,197077,true,2763646922,28,2756471131,-7175791
1647505637,197075,true,2764199679,28,2756746778,-7452901
1647505841,197076,true,2763923287,28,2757022453,-6900834
1647505927,197075,true,2764199679,28,2757298155,-6901524
1647506001,197074,true,2764476099,28,2757573885,-6902214
1647506331,197072,true,2765029022,28,2758677080,-6351942
1647506434,197072,true,2765029022,28,2758952948,-6076074
1647507016,197072,true,2765029022,28,2760608734,-4420288
1647507182,197071,true,2765305525,28,2761160883,-4144642
1647507833,197069,true,2765858614,28,2763094276,-2764338
1647507963,197069,true,2765858614,28,2763094276,-2764338
1647508150,197068,true,2766135199,28,2763370585,-2764614
1647508237,197067,true,2766411813,28,2763646922,-2764891
1647508424,197066,true,2766688454,28,2763646922,-3041532
1647508458,197066,true,2766688454,28,2763646922,-3041532
1647508501,197066,true,2766688454,28,2763923287,-2765167
1647509595,197065,true,2766965123,28,2764199679,-2765444
1647510698,197064,true,2767241819,28,2764199679,-3042140
1647510828,197065,true,2766965123,28,2764199679,-2765444
1647511565,197065,true,2766965123,28,2764476099,-2489024
1647511672,197065,true,2766965123,28,2764476099,-2489024
1647513185,197064,true,2767241819,28,2762265513,-4976306
1647513653,197066,true,2766688454,28,2761713143,-4975311
1647513666,197066,true,2766688454,28,2761989314,-4699140
1647513684,197066,true,2766688454,28,2761989314,-4699140
1647514216,197065,true,2766965123,28,2762817994,-4147129
1647514386,197066,true,2766688454,28,2763094276,-3594178
1647514980,197066,true,2766688454,28,2764199679,-2488775
1647515346,197067,true,2766411813,28,2765858614,-553199
1647515371,197066,true,2766688454,28,2766135199,-553255
1647515399,197068,true,2766135199,28,2766135199,0
1647515800,197068,true,2766135199,28,2767518544,1383345
1647517275,197069,true,2765858614,28,2770287308,4428694
1647517648,197068,true,2766135199,28,2770287308,4152109
1647518493,197069,true,2765858614,28,2770287308,4428694
1647518634,197069,true,2765858614,28,2770287308,4428694
1647518652,197070,true,2765582055,28,2770564337,4982282
1647518676,197069,true,2765858614,28,2770564337,4705723
1647518678,197070,true,2765582055,28,2770564337,4982282
1647518689,197069,true,2765858614,28,2770564337,4705723
1647518887,197069,true,2765858614,28,2772227091,6368477
1647518983,197068,true,2766135199,28,2773336148,7200949
1647519194,197068,true,2766135199,28,2775278066,9142867
1647519232,197067,true,2766411813,28,2775555594,9143781
1647519262,197066,true,2766688454,28,2775833149,9144695
1647519328,197065,true,2766965123,28,2776665982,9700859
1647519382,197065,true,2766965123,28,2777221343,10256220
1647519400,197064,true,2767241819,28,2777499066,10257247
1647519443,197063,true,2767518544,28,2778054593,10536049
1647519458,197062,true,2767795296,28,2778332399,10537103
1647519461,197061,true,2768072075,28,2778332399,10260324
1647519470,197059,true,2768625717,28,2778332399,9706682
1647519520,197058,true,2768902580,28,2779165982,10263402
1647519522,197056,true,2769456388,28,2779165982,9709594
1647519529,197055,true,2769733334,28,2779443898,9710564
1647519557,197053,true,2770287308,28,2779999815,9712507
1647519745,197051,true,2770841393,28,2784172735,13331342
1647519775,197050,true,2771118477,28,2784729597,13611120
1647519953,197050,true,2771118477,28,2788073111,16954634
1647520032,197048,true,2771672729,28,2789467427,17794698
1647520141,197046,true,2772227091,28,2791420640,19193549
1647520311,197046,true,2772227091,28,2794492738,22265647
1647522146,197046,true,2772227091,28,2801487360,29260269
1647522202,197044,true,2772781564,28,2801767509,28985945
1647522348,197042,true,2773336148,28,2801767509,28431361
1647522438,197042,true,2773336148,28,2802047685,28711537
1647522466,197042,true,2773336148,28,2802047685,28711537
1647522503,197039,true,2774168232,28,2802047685,27879453
1647522527,197038,true,2774445649,28,2802047685,27602036
1647522561,197037,true,2774723093,28,2802327890,27604797
1647522585,197037,true,2774723093,28,2802327890,27604797
1647522588,197034,true,2775555594,28,2802327890,26772296
1647524074,197032,true,2776110733,28,2809061217,32950484
1647524332,197032,true,2776110733,28,2809904020,33793287
1647524757,197031,true,2776388344,28,2809904020,33515676
1647525072,197028,true,2777221343,28,2810185010,32963667
1647525496,197026,true,2777776815,28,2810466029,32689214
1647525556,197025,true,2778054593,28,2810747075,32692482
1647526256,197025,true,2778054593,28,2814966149,36911556
1647526263,197023,true,2778610232,28,2814966149,36355917
1647526636,197019,true,2779721843,28,2818627801,38905958
1647526706,197019,true,2779721843,28,2819191555,39469712
1647527237,197018,true,2779999815,28,2823140989,43141174
1647527440,197016,true,2780555843,28,2823988016,43432173
1647527475,197013,true,2781390093,28,2823988016,42597923
1647527710,197012,true,2781668232,28,2823988016,42319784
1647527827,197012,true,2781668232,28,2823705646,42037414
1647527880,197010,true,2782224593,28,2823705646,41481053
1647528453,197007,true,2783059344,28,2820883493,37824149
1647528470,197007,true,2783059344,28,2820601433,37542089
1647528497,197006,true,2783337650,28,2820319401,36981751
1647528773,197004,true,2783894345,28,2817500632,33606287
1647528846,197002,true,2784451152,28,2816655551,32204399
1647530470,197002,true,2784451152,28,2805131479,20680327
1647530600,197001,true,2784729597,28,2805131479,20401882
1647530644,196999,true,2785286571,28,2805131479,19844908
1647530738,196997,true,2785843656,28,2805131479,19287823
1647530773,196997,true,2785843656,28,2805131479,19287823
1647530808,196995,true,2786400853,28,2805131479,18730626
1647531045,196994,true,2786679493,28,2805692534,19013041
1647531082,196991,true,2787515580,28,2805692534,18176954
1647531095,196991,true,2787515580,28,2805692534,18176954
1647531644,196989,true,2788073111,28,2808218667,20145556
1647532193,196988,true,2788351919,28,2810747075,22395156
1647532286,196985,true,2789188508,28,2811309253,22120745
1647532289,196984,true,2789467427,28,2811309253,21841826
1647532292,196982,true,2790025348,28,2811309253,21283905
1647532335,196980,true,2790583381,28,2811309253,20725872
1647532364,196978,true,2791141526,28,2811590384,20448858
1647532944,196977,true,2791420640,28,2811590384,20169744
1647532973,196975,true,2791978952,28,2811309253,19330301
1647534328,196974,true,2792258150,28,2805411993,13153843
1647534510,196971,true,2793095911,28,2805131479,12035568
1647534626,196971,true,2793095911,28,2805131479,12035568
1647535882,196969,true,2793654558,28,2807095661,13441103
1647535900,196968,true,2793933923,28,2807095661,13161738
1647535910,196965,true,2794772187,28,2807095661,12323474
1647536978,196966,true,2794492738,28,2803448990,8956252
1647537050,196964,true,2795051665,28,2802888384,7836719
1647537052,196963,true,2795331170,28,2802888384,7557214
1647537082,196960,true,2796169853,28,2802888384,6718531
1647537133,196961,true,2795890264,28,2802327890,6437626
1647537152,196960,true,2796169853,28,2802327890,6158037
1647537167,196959,true,2796449470,28,2802047685,5598215
1647537180,196957,true,2797008788,28,2802047685,5038897
1647537220,196958,true,2796729115,28,2801487360,4758245
1647537876,196957,true,2797008788,28,2793654558,-3354230
1647538003,196956,true,2797288489,28,2792816629,-4471860
1647538057,196954,true,2797847974,28,2792258150,-5589824
1647538106,196955,true,2797568218,28,2791978952,-5589266
1647538157,196954,true,2797847974,28,2791699782,-6148192
1647538668,196953,true,2798127759,28,2789746373,-8381386
1647538806,196950,true,2798967282,28,2789188508,-9778774
1647538867,196951,true,2798687413,28,2789188508,-9498905
1647539055,196950,true,2798967282,28,2789746373,-9220909
1647539125,196948,true,2799527103,28,2790025348,-9501755
1647539300,196946,true,2800087036,28,2791420640,-8666396
1647539394,196947,true,2799807056,28,2792258150,-7548906
1647539459,196946,true,2800087036,28,2792816629,-7270407
1647539838,196944,true,2800647082,28,2797008788,-3638294
1647540330,196941,true,2801487360,28,2800367045,-1120315
1647540352,196942,true,2801207239,28,2800367045,-840194
1647543428,196941,true,2801487360,28,2809061217,7573857
1647543855,196939,true,2802047685,28,2809061217,7013532
1647543984,196936,true,2802888384,28,2809623058,6734674
1647544214,196937,true,2802608123,28,2810185010,7576887
1647544233,196935,true,2803168673,28,2810185010,7016337
1647544807,196933,true,2803729334,28,2811871543,8142209
1647545999,196930,true,2804570537,28,2814684680,10114143
1647546013,196931,true,2804290108,28,2814966149,10676041
1647546037,196930,true,2804570537,28,2814966149,10395612
1647546071,196928,true,2805131479,28,2814966149,9834670
1647548010,196925,true,2805973103,28,2825117781,19144678
1647548049,196926,true,2805692534,28,2825117781,19425247
1647548382,196925,true,2805973103,28,2824835298,18862195
1647548506,196923,true,2806534326,28,2824552842,18018516
1647548556,196921,true,2807095661,28,2824270415,17174754
1647548926,196922,true,2806814979,28,2823140989,16326010
1647549598,196922,true,2806814979,28,2819191555,12376576
1647552463,196921,true,2807095661,28,2809342123,2246462
1647552982,196918,true,2807937874,28,2809904020,1966146
1647553297,196920,true,2807376370,28,2810466029,3089659
1647554348,196920,true,2807376370,28,2812152730,4776360
1647554553,196919,true,2807657108,28,2812433945,4776837
1647555037,196916,true,2808499489,28,2812996460,4496971
1647557358,196918,true,2807937874,28,2813840444,5902570
1647557833,196918,true,2807937874,28,2813840444,5902570
1647558270,196917,true,2808218667,28,2813840444,5621777
1647558820,196916,true,2808499489,28,2813840444,5340955
1647560839,196918,true,2807937874,28,2813840444,5902570
1647562006,196917,true,2808218667,28,2813840444,5621777
1647562077,196916,true,2808499489,28,2813840444,5340955
1647562107,196915,true,2808780339,28,2813840444,5060105
1647562122,196916,true,2808499489,28,2813559088,5059599
1647562126,196916,true,2808499489,28,2813559088,5059599
1647563811,196915,true,2808780339,28,2808499489,-280850
1647564155,196914,true,2809061217,28,2808218667,-842550
1647564205,196916,true,2808499489,28,2808218667,-280822
1647564312,196915,true,2808780339,28,2807937874,-842465
1647564749,196915,true,2808780339,28,2805692534,-3087805
1647564786,196914,true,2809061217,28,2805692534,-3368683
1647564812,196916,true,2808499489,28,2805411993,-3087496
1647564838,196916,true,2808499489,28,2805131479,-3368010
1647564916,196917,true,2808218667,28,2804290108,-3928559
1647565073,196917,true,2808218667,28,2802047685,-6170982
1647566745,196920,true,2807376370,28,2777776815,-29599555
1647566765,196920,true,2807376370,28,2777776815,-29599555
1647566781,196921,true,2807095661,28,2777776815,-29318846
1647567515,196922,true,2806814979,28,2778332399,-28482580
1647567998,196924,true,2806253700,28,2778888093,-27365607
1647568690,196925,true,2805973103,28,2779443898,-26529205
1647568694,196926,true,2805692534,28,2779443898,-26248636
1647568742,196927,true,2805411993,28,2779721843,-25690150
1647568857,196930,true,2804570537,28,2779721843,-24848694
1647568991,196930,true,2804570537,28,2779721843,-24848694
1647570277,196932,true,2804009707,28,2781946399,-22063308
1647570427,196933,true,2803729334,28,2781946399,-21782935
1647570467,196935,true,2803168673,28,2782224593,-20944080
1647570491,196935,true,2803168673,28,2782224593,-20944080
1647571309,196937,true,2802608123,28,2782224593,-20383530
1647571461,196937,true,2802608123,28,2782224593,-20383530
1647571867,196940,true,2801767509,28,2782224593,-19542916
1647572539,196940,true,2801767509,28,2782224593,-19542916
1647572549,196940,true,2801767509,28,2782224593,-19542916
1647574212,196940,true,2801767509,28,2782224593,-19542916
1647575104,196942,true,2801207239,28,2781946399,-19260840
1647575114,196943,true,2800927147,28,2781946399,-18980748
1647576568,196944,true,2800647082,28,2778332399,-22314683
1647577512,196944,true,2800647082,28,2777221343,-23425739
1647578169,196946,true,2800087036,28,2777221343,-22865693
1647578309,196946,true,2800087036,28,2777499066,-22587970
1647579302,196947,true,2799807056,28,2778332399,-21474657
1647579662,196947,true,2799807056,28,2778888093,-20918963
1647579950,196950,true,2798967282,28,2779443898,-19523384
1647580300,196950,true,2798967282,28,2781111982,-17855300
1647580352,196951,true,2798687413,28,2781390093,-17297320
1647580446,196951,true,2798687413,28,2781946399,-16741014
1647580568,196953,true,2798127759,28,2782502816,-15624943
1647580616,196953,true,2798127759,28,2782781066,-15346693
1647580705,196954,true,2797847974,28,2783337650,-14510324
1647581978,196953,true,2798127759,28,2790304351,-7823408
1647582580,196955,true,2797568218,28,2790862439,-6705779
1647582608,196956,true,2797288489,28,2791141526,-6146963
1647582656,196956,true,2797288489,28,2791141526,-6146963
1647582766,196955,true,2797568218,28,2791699782,-5868436
1647582818,196956,true,2797288489,28,2791699782,-5588707
1647582919,196957,true,2797008788,28,2792258150,-4750638
1647583273,196957,true,2797008788,28,2793933923,-3074865
1647583361,196956,true,2797288489,28,2794492738,-2795751
1647583442,196957,true,2797008788,28,2794772187,-2236601
1647583514,196957,true,2797008788,28,2795331170,-1677618
1647583567,196957,true,2797008788,28,2795610703,-1398085
1647583576,196956,true,2797288489,28,2795610703,-1677786
1647583799,196956,true,2797288489,28,2796729115,-559374
1647583932,196956,true,2797288489,28,2797568218,279729
1647584123,196956,true,2797288489,28,2798967282,1678793
1647584254,196955,true,2797568218,28,2799527103,1958885
1647584813,196955,true,2797568218,28,2801487360,3919142
1647585453,196954,true,2797847974,28,2802327890,4479916
1647585669,196954,true,2797847974,28,2802608123,4760149
1647586123,196953,true,2798127759,28,2802888384,4760625
1647586154,196953,true,2798127759,28,2802888384,4760625
1647587883,196952,true,2798407572,28,2803729334,5321762
1647588026,196952,true,2798407572,28,2803729334,5321762
1647588149,196951,true,2798687413,28,2803729334,5041921
1647588229,196951,true,2798687413,28,2803729334,5041921
1647588245,196950,true,2798967282,28,2803729334,4762052
1647589317,196952,true,2798407572,28,2801487360,3079788
1647589336,196951,true,2798687413,28,2801487360,2799947
1647589644,196951,true,2798687413,28,2800927147,2239734
1647590799,196950,true,2798967282,28,2800367045,1399763
1647590806,196952,true,2798407572,28,2800367045,1959473
1647590853,196951,true,2798687413,28,2800087036,1399623
1647590911,196951,true,2798687413,28,2800087036,1399623
1647590923,196952,true,2798407572,28,2800087036,1679464
1647591666,196954,true,2797847974,28,2797568218,-279756
1647591717,196953,true,2798127759,28,2797568218,-559541
1647591774,196953,true,2798127759,28,2797288489,-839270
1647591819,196954,true,2797847974,28,2797288489,-559485
1647592774,196955,true,2797568218,28,2798967282,1399064
1647592912,196955,true,2797568218,28,2799807056,2238838
1647594128,196955,true,2797568218,28,2805973103,8404885
1647594362,196955,true,2797568218,28,2806534326,8966108
1647594377,196956,true,2797288489,28,2806534326,9245837
1647595007,196957,true,2797008788,28,2806534326,9525538
1647595967,196957,true,2797008788,28,2805973103,8964315
1647596895,196958,true,2796729115,28,2805692534,8963419
1647597362,196959,true,2796449470,28,2805411993,8962523
1647597400,196959,true,2796449470,28,2805411993,8962523
1647597654,196959,true,2796449470,28,2805411993,8962523
1647597764,196959,true,2796449470,28,2805411993,8962523
1647598354,196960,true,2796169853,28,2805411993,9242140
1647600933,196960,true,2796169853,28,2804850994,8681141
1647601222,196960,true,2796169853,28,2804850994,8681141
1647601491,196960,true,2796169853,28,2804850994,8681141
1647601520,196961,true,2795890264,28,2804850994,8960730
1647601525,196961,true,2795890264,28,2804850994,8960730
1647601537,196961,true,2795890264,28,2804850994,8960730
1647601574,196961,true,2795890264,28,2804850994,8960730
1647601659,196962,true,2795610703,28,2804570537,8959834
1647601724,196963,true,2795331170,28,2804290108,8958938
1647602090,196963,true,2795331170,28,2802047685,6716515
1647602318,196964,true,2795051665,28,2800647082,5595417
1647602943,196965,true,2794772187,28,2796449470,1677283
1647603368,196966,true,2794492738,28,2793654558,-838180
1647603568,196966,true,2794492738,28,2793095911,-1396827
1647604028,196966,true,2794492738,28,2792537375,-1955363
1647604867,196967,true,2794213317,28,2791699782,-2513535
1647604949,196968,true,2793933923,28,2791978952,-1954971
1647605010,196968,true,2793933923,28,2791978952,-1954971
1647605091,196968,true,2793933923,28,2791978952,-1954971
1647605096,196968,true,2793933923,28,2791978952,-1954971
1647605155,196968,true,2793933923,28,2792258150,-1675773
1647605178,196968,true,2793933923,28,2792258150,-1675773
1647605393,196968,true,2793933923,28,2793095911,-838012
1647606215,196967,true,2794213317,28,2796729115,2515798
1647606578,196967,true,2794213317,28,2798407572,4194255
1647606653,196966,true,2794492738,28,2798687413,4194675
1647606831,196965,true,2794772187,28,2799527103,4754916
1647606852,196964,true,2795051665,28,2799527103,4475438
1647606870,196964,true,2795051665,28,2799527103,4475438
1647607165,196963,true,2795331170,28,2800087036,4755866
1647607209,196962,true,2795610703,28,2800367045,4756342
1647607248,196961,true,2795890264,28,2800367045,4476781
1647607363,196961,true,2795890264,28,2801207239,5316975
1647607384,196959,true,2796449470,28,2801207239,4757769
1647607435,196959,true,2796449470,28,2801487360,5037890
1647607594,196958,true,2796729115,28,2802888384,6159269
1647607880,196957,true,2797008788,28,2805411993,8403205
1647608070,196955,true,2797568218,28,2806814979,9246761
1647608187,196955,true,2797568218,28,2807657108,10088890
1647608916,196954,true,2797847974,28,2812996460,15148486
1647609486,196953,true,2798127759,28,2812715189,14587430
1647609665,196951,true,2798687413,28,2812433945,13746532
1647609682,196951,true,2798687413,28,2812152730,13465317
1647609834,196950,true,2798967282,28,2811590384,12623102
1647609874,196949,true,2799247178,28,2811590384,12343206
1647609975,196948,true,2799527103,28,2811028150,11501047
1647610466,196948,true,2799527103,28,2808218667,8691564
1647611404,196947,true,2799807056,28,2802888384,3081328
1647611590,196946,true,2800087036,28,2802047685,1960649
1647611908,196945,true,2800367045,28,2801767509,1400464
1647611948,196945,true,2800367045,28,2801767509,1400464
1647611983,196944,true,2800647082,28,2801767509,1120427
1647612015,196943,true,2800927147,28,2801767509,840362
1647612106,196942,true,2801207239,28,2801767509,560270
1647612161,196942,true,2801207239,28,2802047685,840446
1647612232,196941,true,2801487360,28,2802327890,840530
1647612239,196940,true,2801767509,28,2802608123,840614
1647612255,196939,true,2802047685,28,2802608123,560438
1647612580,196938,true,2802327890,28,2805973103,3645213
1647612632,196937,true,2802608123,28,2806534326,3926203
1647612665,196937,true,2802608123,28,2806814979,4206856
1647612714,196935,true,2803168673,28,2807657108,4488435
1647612963,196933,true,2803729334,28,2811590384,7861050
1647613050,196932,true,2804009707,28,2812996460,8986753
1647613716,196932,true,2804009707,28,2823140989,19131282
1647613755,196931,true,2804290108,28,2823988016,19697908
1647613819,196929,true,2804850994,28,2825400293,20549299
1647613989,196928,true,2805131479,28,2828792639,23661160
1647614242,196926,true,2805692534,28,2833322103,27629569
1647614315,196925,true,2805973103,28,2834455602,28482499
1647614497,196923,true,2806534326,28,2836723960,30189634
1647614795,196922,true,2806814979,28,2838994134,32179155
1647614852,196920,true,2807376370,28,2839561961,32185591
1647615533,196919,true,2807657108,28,2844961987,37304879
1647615577,196918,true,2807937874,28,2844961987,37024113
1647615690,196917,true,2808218667,28,2844961987,36743320
1647615730,196915,true,2808780339,28,2844961987,36181648
1647615784,196914,true,2809061217,28,2844961987,35900770
1647615875,196913,true,2809342123,28,2844677519,35335396
1647615938,196911,true,2809904020,28,2844677519,34773499
1647615950,196909,true,2810466029,28,2844677519,34211490
1647616025,196908,true,2810747075,28,2844677519,33930444
1647616032,196906,true,2811309253,28,2844677519,33368266
1647616044,196905,true,2811590384,28,2844677519,33087135
1647616064,196903,true,2812152730,28,2844961987,32809257
1647616290,196901,true,2812715189,28,2847238753,34523564
1647616782,196899,true,2813277760,28,2852368142,39090382
1647616835,196897,true,2813840444,28,2853223938,39383494
1647616892,196895,true,2814403240,28,2854079991,39676751
1647616952,196893,true,2814966149,28,2854936300,39970151
1647617414,196889,true,2816092304,28,2864086271,47993967
1647617848,196887,true,2816655551,28,2871829365,55173814
1647617903,196885,true,2817218910,28,2872403760,55184850
1647618269,196882,true,2818064160,28,2877578484,59514324
1647618308,196878,true,2819191555,28,2878154028,58962473
1647618387,196876,true,2819755421,28,2879305463,59550042
1647618443,196873,true,2820601433,28,2880457357,59855924
1647618491,196870,true,2821447698,28,2881033478,59585780
1647618597,196866,true,2822576446,28,2882762530,60186084
1647618782,196864,true,2823140989,28,2884781069,61640080
1647619186,196862,true,2823705646,28,2888533536,64827890
1647619613,196859,true,2824552842,28,2892580112,68027270
1647619775,196855,true,2825682833,28,2893737318,68054485
1647619944,196853,true,2826247998,28,2894605526,68357528
1647619973,196851,true,2826813276,28,2894894986,68081710
1647620208,196848,true,2827661404,28,2895473994,67812590
1647620265,196843,true,2829075518,28,2895473994,66398476
1647620535,196842,true,2829358425,28,2896053118,66694693
1647620680,196839,true,2830207318,28,2896053118,65845800
1647621008,196836,true,2831056465,28,2896053118,64996653
1647621139,196832,true,2832189057,28,2896632358,64443301
1647621466,196830,true,2832755524,28,2898370772,65615248
1647621588,196827,true,2833605435,28,2899240370,65634935
1647622031,196824,true,2834455602,28,2901270447,66814845
1647622329,196819,true,2835873113,28,2903011645,67138532
1647622641,196817,true,2836440316,28,2905915963,69475647
1647622682,196814,true,2837291333,28,2906206555,68915222
1647622711,196811,true,2838142606,28,2906497175,68354569
1647622843,196805,true,2839845917,28,2908532334,68686417
1647622904,196802,true,2840697956,28,2909404981,68707025
1647623091,196798,true,2841834406,28,2911733319,69898913
1647623242,196794,true,2842971310,28,2914063521,71092211
1647623329,196788,true,2844677519,28,2915520845,70843326
1647623647,196784,true,2845815561,28,2921941730,76126169
1647623714,196780,true,2846954058,28,2923110682,76156624
1647624735,196776,true,2848093010,28,2937174636,89081626
1647626236,196770,true,2849802294,28,2937174636,87372342
1647626554,196766,true,2850942385,28,2937174636,86232251
1647627112,196762,true,2852082933,28,2937174636,85091703
1647628225,196758,true,2853223938,28,2937174636,83950698
1647628359,196752,true,2854936300,28,2937174636,82238336
1647628384,196748,true,2856078446,28,2937174636,81096190
1647628424,196744,true,2857221049,28,2937174636,79953587
1647630139,196741,true,2858078301,28,2931306451,73228150
1647630176,196735,true,2859793577,28,2931306451,71512874
1647630410,196731,true,2860937666,28,2931599581,70661915
1647630512,196728,true,2861796033,28,2931892741,70096708
1647631317,196724,true,2862940923,28,2933652317,70711394
1647631615,196718,true,2864659117,28,2934239077,69579960
1647631923,196715,true,2865518601,28,2934825954,69307353
1647632050,196711,true,2866664980,28,2934825954,68160974
1647632065,196707,true,2867811818,28,2934825954,67014136
1647632105,196702,true,2869246011,28,2934825954,65579943
1647632640,196698,true,2870393881,28,2936000060,65606179
1647633012,196694,true,2871542211,28,2936587290,65045079
1647633116,196691,true,2872403760,28,2936880948,64477188
1647633359,196686,true,2873840249,28,2938055877,64215628
1647633474,196682,true,2874989958,28,2939231276,64241318
1647633552,196678,true,2876140126,28,2940407145,64267019
1647633596,196674,true,2877290755,28,2940995255,63704500
1647633625,196668,true,2879017561,28,2941289355,62271794
1647633670,196664,true,2880169341,28,2942171830,62002489
1647633741,196659,true,2881609713,28,2943643210,62033497
1647633778,196655,true,2882762530,28,2944231968,61469438
1647633795,196649,true,2884492620,28,2944820844,60328224
1647634164,196643,true,2886223748,28,2952486957,66263209
1647635013,196639,true,2887378411,28,2966692249,79313838
1647635056,196635,true,2888533536,28,2967285617,78752081
1647635560,196628,true,2890556116,28,2969957243,79401127
1647636114,196623,true,2892001683,28,2966692249,74690566
1647636276,196619,true,2893158657,28,2966395610,73236953
1647636407,196615,true,2894316094,28,2965802419,71486325
1647636444,196608,true,2896342723,28,2965505869,69163146
1647637196,196603,true,2897791184,28,2962838248,65047064
1647637338,196599,true,2898950475,28,2962245769,63295294
1647637363,196595,true,2900110229,28,2962245769,62135540
1647637435,196589,true,2901850730,28,2961949574,60098844
1647637801,196585,true,2903011645,28,2959581080,56569435
1647639562,196581,true,2904173023,28,2952191737,48018714
1647640951,196578,true,2905044362,28,2951896548,46852186
1647640980,196572,true,2906787825,28,2952191737,45403912
1647641053,196568,true,2907950714,28,2952191737,44241023
1647641132,196565,true,2908823187,28,2952191737,43368550
1647641788,196561,true,2909986891,28,2953077483,43090592
1647642251,196557,true,2911151060,28,2953668128,42517068
1647642360,196553,true,2912315695,28,2953668128,41352433
1647642395,196550,true,2913189477,28,2953668128,40478651
1647642420,196546,true,2914354928,28,2953668128,39313200
1647642440,196542,true,2915520845,28,2953668128,38147283
1647643109,196539,true,2916395588,28,2951011156,34615568
1647644339,196538,true,2916687228,28,2941583484,24896256
1647645519,196534,true,2917854078,28,2939525199,21671121
1647645933,196530,true,2919021395,28,2939525199,20503804
1647646181,196527,true,2919897189,28,2939525199,19628010
1647646225,196526,true,2920189178,28,2939525199,19336021
1647646328,196522,true,2921357429,28,2939819151,18461722
1647647102,196518,true,2922526147,28,2940701185,18175038
1647647357,196515,true,2923402993,28,2941289355,17886362
1647647360,196514,true,2923695333,28,2941289355,17594022
1647648933,196510,true,2924864987,28,2943937574,19072587
1647648969,196506,true,2926035108,28,2943937574,17902466
1647649429,196503,true,2926913007,28,2945115326,18202319
1647649558,196502,true,2927205698,28,2945704379,18498681
1647649594,196498,true,2928376756,28,2945998949,17622193
1647649843,196494,true,2929548282,28,2947472243,17923961
1647650383,196490,true,2930720277,28,2953372791,22652514
1647650501,196489,true,2931013349,28,2954849773,23836424
1647650548,196486,true,2931892741,28,2955440772,23548031
1647650669,196481,true,2933358981,28,2957214480,23855499
1647652006,196477,true,2934532501,28,2971145404,36612903
1647652632,196475,true,2935119436,28,2971739663,36620227
1647652802,196473,true,2935706490,28,2971442518,35736028
1647652932,196470,true,2936587290,28,2971145404,34558114
1647653002,196465,true,2938055877,28,2971145404,33089527
1647653010,196464,true,2938349683,28,2971145404,32795721
1647654334,196462,true,2938937382,28,2966988918,28051536
1647654852,196459,true,2939819151,28,2965802419,25983268
1647655265,196456,true,2940701185,28,2965802419,25101234
1647655400,196455,true,2940995255,28,2965802419,24807164
1647655652,196453,true,2941583484,28,2965209348,23625864
1647655743,196451,true,2942171830,28,2965209348,23037518
1647655820,196448,true,2943054570,28,2964616395,21561825
1647656049,196447,true,2943348875,28,2963727188,20378313
1647656520,196446,true,2943643210,28,2961061167,17417957
1647657290,196443,true,2944526391,28,2956918788,12392397
1647657502,196440,true,2945409838,28,2956031890,10622052
1647658662,196440,true,2945409838,28,2955440772,10030934
1647659018,196439,true,2945704379,28,2955440772,9736393
1647660559,196436,true,2946588178,28,2955440772,8852594
1647660612,196433,true,2947472243,28,2955440772,7968529
1647660641,196433,true,2947472243,28,2955440772,7968529
1647660723,196431,true,2948061767,28,2955440772,7379005
1647661082,196429,true,2948651409,28,2954849773,6198364
1647661473,196427,true,2949241169,28,2953963495,4722326
1647661507,196426,true,2949536093,28,2953963495,4427402
1647661537,196426,true,2949536093,28,2953963495,4427402
1647661565,196424,true,2950126030,28,2953668128,3542098
1647661663,196422,true,2950716084,28,2953077483,2361399
1647661780,196422,true,2950716084,28,2952486957,1770873
1647662926,196421,true,2951011156,28,2946293549,-4717607
1647665370,196420,true,2951306257,28,2944526391,-6779866
1647666171,196419,true,2951601388,28,2945115326,-6486062
1647667634,196419,true,2951601388,28,2945704379,-5897009
1647668212,196419,true,2951601388,28,2945704379,-5897009
1647668821,196419,true,2951601388,28,2945704379,-5897009
1647669156,196418,true,2951896548,28,2945704379,-6192169
1647669205,196419,true,2951601388,28,2945409838,-6191550
1647669364,196419,true,2951601388,28,2945409838,-6191550
1647669382,196418,true,2951896548,28,2945409838,-6486710
1647669646,196417,true,2952191737,28,2945115326,-7076411
1647669716,196418,true,2951896548,28,2944820844,-7075704
1647669770,196418,true,2951896548,28,2944820844,-7075704
1647669938,196417,true,2952191737,28,2944231968,-7959769
1647670113,196417,true,2952191737,28,2944231968,-7959769
1647670151,196417,true,2952191737,28,2944231968,-7959769
1647670240,196416,true,2952486957,28,2944231968,-8254989
1647670304,196415,true,2952782205,28,2944231968,-8550237
1647670409,196415,true,2952782205,28,2944231968,-8550237
1647670450,196416,true,2952486957,28,2943937574,-8549383
1647671935,196416,true,2952486957,28,2941877642,-10609315
1647672193,196415,true,2952782205,28,2941583484,-11198721
1647673848,196414,true,2953077483,28,2941289355,-11788128
1647674190,196415,true,2952782205,28,2941289355,-11492850
1647674232,196415,true,2952782205,28,2941289355,-11492850
1647674326,196414,true,2953077483,28,2940995255,-12082228
1647674328,196414,true,2953077483,28,2940995255,-12082228
1647674938,196415,true,2952782205,28,2938349683,-14432522
1647676190,196415,true,2952782205,28,2933945682,-18836523
1647676331,196415,true,2952782205,28,2933945682,-18836523
1647678808,196415,true,2952782205,28,2932185931,-20596274
1647680148,196417,true,2952191737,28,2932185931,-20005806
1647680431,196417,true,2952191737,28,2932185931,-20005806
1647680544,196417,true,2952191737,28,2932185931,-20005806
1647680871,196418,true,2951896548,28,2932185931,-19710617
1647680977,196421,true,2951011156,28,2932479149,-18532007
1647681187,196422,true,2950716084,28,2932772397,-17943687
1647681216,196422,true,2950716084,28,2933065674,-17650410
1647681468,196423,true,2950421042,28,2933945682,-16475360
1647681598,196425,true,2949831046,28,2934532501,-15298545
1647681774,196425,true,2949831046,28,2935412948,-14418098
1647681877,196425,true,2949831046,28,2935706490,-14124556
1647682244,196426,true,2949536093,28,2937762101,-11773992
1647682268,196428,true,2948946274,28,2937762101,-11184173
1647682612,196428,true,2948946274,28,2940407145,-8539129
1647682880,196428,true,2948946274,28,2942171830,-6774444
1647688309,196428,true,2948946274,28,2945998949,-2947325
1647688433,196430,true,2948356573,28,2945998949,-2357624
1647689417,196430,true,2948356573,28,2945998949,-2357624
1647689623,196429,true,2948651409,28,2945998949,-2652460
1647691028,196429,true,2948651409,28,2945998949,-2652460
1647692920,196431,true,2948061767,28,2945998949,-2062818
1647692935,196430,true,2948356573,28,2946293549,-2063024
1647692958,196430,true,2948356573,28,2946293549,-2063024
1647692966,196430,true,2948356573,28,2946293549,-2063024
1647692990,196431,true,2948061767,28,2946293549,-1768218
1647693023,196431,true,2948061767,28,2946293549,-1768218
1647693096,196430,true,2948356573,28,2946882837,-1473736
1647693196,196430,true,2948356573,28,2947177525,-1179048
1647693470,196431,true,2948061767,28,2948651409,589642
1647694065,196431,true,2948061767,28,2951011156,2949389
1647694079,196430,true,2948356573,28,2951011156,2654583
1647694228,196429,true,2948651409,28,2951896548,3245139
1647694265,196429,true,2948651409,28,2952191737,3540328
1647694282,196429,true,2948651409,28,2952191737,3540328
1647694390,196428,true,2948946274,28,2952782205,3835931
1647694447,196427,true,2949241169,28,2953372791,4131622
1647694530,196427,true,2949241169,28,2953963495,4722326
1647694562,196427,true,2949241169,28,2954258892,5017723
1647694750,196426,true,2949536093,28,2956031890,6495797
1647694773,196424,true,2950126030,28,2956031890,5905860
1647694875,196424,true,2950126030,28,2956623126,6497096
1647694950,196424,true,2950126030,28,2957214480,7088450
1647694961,196423,true,2950421042,28,2957214480,6793438
1647695102,196422,true,2950716084,28,2958101733,7385649
1647695118,196422,true,2950716084,28,2958101733,7385649
1647696235,196422,true,2950716084,28,2965209348,14493264
1647696249,196421,true,2951011156,28,2965209348,14198192
1647696892,196421,true,2951011156,28,2967582346,16571190
1647696961,196421,true,2951011156,28,2967879104,16867948
1647696968,196421,true,2951011156,28,2967879104,16867948
1647697052,196421,true,2951011156,28,2967879104,16867948
1647697066,196421,true,2951011156,28,2967879104,16867948
1647697106,196422,true,2950716084,28,2967582346,16866262
1647697109,196422,true,2950716084,28,2967582346,16866262
1647697390,196422,true,2950716084,28,2966395610,15679526
1647697473,196423,true,2950421042,28,2966099000,15677958
1647697956,196423,true,2950421042,28,2963727188,13306146
1647698046,196423,true,2950421042,28,2963134531,12713489
1647698347,196423,true,2950421042,28,2961061167,10640125
1647698680,196424,true,2950126030,28,2958693383,8567353
1647698705,196424,true,2950126030,28,2958397544,8271514
1647698748,196424,true,2950126030,28,2958101733,7975703
1647698796,196424,true,2950126030,28,2957510202,7384172
1647699057,196425,true,2949831046,28,2956031890,6200844
1647700366,196426,true,2949536093,28,2951011156,1475063
1647700569,196425,true,2949831046,28,2950716084,885038
1647701111,196425,true,2949831046,28,2951306257,1475211
1647701226,196426,true,2949536093,28,2951601388,2065295
1647701542,196426,true,2949536093,28,2952191737,2655644
1647701557,196425,true,2949831046,28,2952191737,2360691
1647701755,196425,true,2949831046,28,2952782205,2951159
1647701811,196426,true,2949536093,28,2953077483,3541390
1647702113,196426,true,2949536093,28,2954258892,4722799
1647702652,196425,true,2949831046,28,2956327493,6496447
1647702923,196425,true,2949831046,28,2957214480,7383434
1647703044,196425,true,2949831046,28,2957805953,7974907
1647703195,196425,true,2949831046,28,2958101733,8270687
1647703311,196424,true,2950126030,28,2958693383,8567353
1647703412,196423,true,2950421042,28,2958989253,8568211
1647703425,196423,true,2950421042,28,2959285152,8864110
1647703451,196423,true,2950421042,28,2959285152,8864110
1647703463,196421,true,2951011156,28,2959285152,8273996
1647703472,196421,true,2951011156,28,2959581080,8569924
1647703509,196421,true,2951011156,28,2959581080,8569924
1647703617,196420,true,2951306257,28,2960469043,9162786
1647704042,196419,true,2951601388,28,2962541993,10940605
1647704163,196418,true,2951896548,28,2963134531,11237983
1647704853,196418,true,2951896548,28,2967879104,15982556
1647705817,196417,true,2952191737,28,2971442518,19250781
1647706223,196416,true,2952486957,28,2971442518,18955561
1647706255,196415,true,2952782205,28,2971442518,18660313
1647706354,196414,true,2953077483,28,2971442518,18365035
1647707574,196414,true,2953077483,28,2969066434,15988951
1647707864,196412,true,2953668128,28,2968769557,15101429
1647707942,196412,true,2953668128,28,2968472710,14804582
1647707990,196411,true,2953963495,28,2968769557,14806062
1647708307,196410,true,2954258892,28,2969957243,15698351
1647708389,196409,true,2954554318,28,2970254238,15699920
1647709734,196408,true,2954849773,28,2976795664,21945891
1647709766,196407,true,2955145258,28,2976795664,21650406
1647709780,196406,true,2955440772,28,2976795664,21354892
1647709962,196404,true,2956031890,28,2976795664,20763774
1647710278,196404,true,2956031890,28,2975605243,19573353
1647710445,196404,true,2956031890,28,2975010211,18978321
1647710935,196403,true,2956327493,28,2972928537,16601044
1647710964,196401,true,2956918788,28,2972928537,16009749
1647710974,196401,true,2956918788,28,2972928537,16009749
1647710990,196400,true,2957214480,28,2972631274,15416794
1647711045,196399,true,2957510202,28,2972334040,14823838
1647711097,196397,true,2958101733,28,2972036837,13935104
1647711182,196397,true,2958101733,28,2971739663,13637930
1647711191,196396,true,2958397544,28,2971442518,13044974
1647711225,196395,true,2958693383,28,2971442518,12749135
1647711459,196393,true,2959285152,28,2969660277,10375125
1647711528,196393,true,2959285152,28,2969363340,10078188
1647712767,196392,true,2959581080,28,2963727188,4146108
1647712988,196391,true,2959877038,28,2963134531,3257493
1647713035,196389,true,2960469043,28,2963134531,2665488
1647713214,196389,true,2960469043,28,2962838248,2369205
1647713218,196389,true,2960469043,28,2962838248,2369205
1647714311,196389,true,2960469043,28,2959877038,-592005
1647714341,196387,true,2961061167,28,2959877038,-1184129
1647714421,196387,true,2961061167,28,2959581080,-1480087
1647714978,196387,true,2961061167,28,2957510202,-3550965
1647715471,196387,true,2961061167,28,2956623126,-4438041
1647715633,196386,true,2961357273,28,2956623126,-4734147
1647716003,196386,true,2961357273,28,2956031890,-5325383
1647716210,196386,true,2961357273,28,2956031890,-5325383
1647716788,196386,true,2961357273,28,2955736317,-5620956
1647717893,196384,true,2961949574,28,2955736317,-6213257
1647719470,196385,true,2961653408,28,2955440772,-6212636
1647720242,196385,true,2961653408,28,2955440772,-6212636
1647720448,196384,true,2961949574,28,2955145258,-6804316
1647721156,196383,true,2962245769,28,2953963495,-8282274
1647721309,196384,true,2961949574,28,2953668128,-8281446
1647722296,196384,true,2961949574,28,2951601388,-10348186
1647722406,196384,true,2961949574,28,2951896548,-10053026
1647722478,196383,true,2962245769,28,2951896548,-10349221
1647722500,196384,true,2961949574,28,2951896548,-10053026
1647722513,196384,true,2961949574,28,2951896548,-10053026
1647726158,196384,true,2961949574,28,2959581080,-2368494
1647727271,196383,true,2962245769,28,2959581080,-2664689
1647727298,196383,true,2962245769,28,2959581080,-2664689
1647727426,196384,true,2961949574,28,2959285152,-2664422
1647727669,196383,true,2962245769,28,2958397544,-3848225
1647727692,196383,true,2962245769,28,2958101733,-4144036
1647727702,196384,true,2961949574,28,2958101733,-3847841
1647727708,196384,true,2961949574,28,2958101733,-3847841
1647727722,196385,true,2961653408,28,2957805953,-3847455
1647727805,196385,true,2961653408,28,2956918788,-4734620
1647727876,196386,true,2961357273,28,2956031890,-5325383
1647727979,196387,true,2961061167,28,2954849773,-6211394
1647728072,196388,true,2960765090,28,2953668128,-7096962
1647728088,196388,true,2960765090,28,2953372791,-7392299
1647728158,196390,true,2960173026,28,2952486957,-7686069
1647728232,196391,true,2959877038,28,2950716084,-9160954
1647728330,196393,true,2959285152,28,2948356573,-10928579
1647729687,196394,true,2958989253,28,2919021395,-39967858
1647729894,196396,true,2958397544,28,2916687228,-41710316
1647729914,196398,true,2957805953,28,2916395588,-41410365
1647730419,196399,true,2957510202,28,2916978897,-40531305
1647730468,196401,true,2956918788,28,2917270595,-39648193
1647730477,196402,true,2956623126,28,2917270595,-39352531
1647730533,196403,true,2956327493,28,2917562322,-38765171
1647731092,196403,true,2956327493,28,2921649565,-34677928
1647731144,196405,true,2955736317,28,2922233924,-33502393
1647731197,196405,true,2955736317,28,2922526147,-33210170
1647731648,196406,true,2955440772,28,2927205698,-28235074
1647731660,196406,true,2955440772,28,2927498419,-27942353
1647731679,196408,true,2954849773,28,2927791168,-27058605
1647731683,196408,true,2954849773,28,2927791168,-27058605
1647731698,196409,true,2954554318,28,2928083947,-26470371
1647731893,196408,true,2954849773,28,2930134221,-24715552
1647731918,196410,true,2954258892,28,2930427235,-23831657
1647732009,196410,true,2954258892,28,2931599581,-22659311
1647732067,196410,true,2954258892,28,2932185931,-22072961
1647732084,196409,true,2954554318,28,2932479149,-22075169
1647732113,196411,true,2953963495,28,2932772397,-21191098
1647732176,196411,true,2953963495,28,2933652317,-20311178
1647732206,196411,true,2953963495,28,2934239077,-19724418
1647732211,196410,true,2954258892,28,2934239077,-20019815
1647732393,196412,true,2953668128,28,2936293660,-17374468
1647734635,196412,true,2953668128,28,2946588178,-7079950
1647734720,196412,true,2953668128,28,2946882837,-6785291
1647734744,196411,true,2953963495,28,2946882837,-7080658
1647734749,196413,true,2953372791,28,2946882837,-6489954
1647734752,196413,true,2953372791,28,2946882837,-6489954
1647736415,196412,true,2953668128,28,2954849773,1181645
1647736461,196412,true,2953668128,28,2955145258,1477130
1647736507,196414,true,2953077483,28,2954849773,1772290
1647736656,196414,true,2953077483,28,2953963495,886012
1647737098,196414,true,2953077483,28,2950716084,-2361399
1647738771,196414,true,2953077483,28,2942466047,-10611436
1647738853,196416,true,2952486957,28,2942466047,-10020910
1647738946,196417,true,2952191737,28,2942466047,-9725690
1647739002,196417,true,2952191737,28,2942171830,-10019907
1647739106,196418,true,2951896548,28,2941877642,-10018906
1647739126,196420,true,2951306257,28,2941877642,-9428615
1647739138,196420,true,2951306257,28,2941583484,-9722773
1647739209,196422,true,2950716084,28,2941289355,-9426729
1647739356,196423,true,2950421042,28,2940113133,-10307909
1647739409,196425,true,2949831046,28,2939525199,-10305847
1647739842,196426,true,2949536093,28,2934825954,-14710139
1647739876,196427,true,2949241169,28,2934532501,-14708668
1647739895,196428,true,2948946274,28,2934239077,-14707197
1647740759,196431,true,2948061767,28,2923110682,-24951085
1647740770,196432,true,2947766990,28,2923110682,-24656308
1647741092,196433,true,2947472243,28,2921065323,-26406920
1647741686,196435,true,2946882837,28,2920189178,-26693659
1647741967,196437,true,2946293549,28,2920481197,-25812352
1647742143,196439,true,2945704379,28,2921065323,-24639056
1647742236,196440,true,2945409838,28,2921065323,-24344515
1647742291,196441,true,2945115326,28,2921357429,-23757897
1647742920,196444,true,2944231968,28,2923110682,-21121286
1647743022,196444,true,2944231968,28,2923695333,-20536635
1647743329,196445,true,2943937574,28,2924864987,-19072587
1647743798,196447,true,2943348875,28,2926913007,-16435868
1647743836,196449,true,2942760294,28,2926913007,-15847287
1647744015,196449,true,2942760294,28,2927205698,-15554596
1647744416,196450,true,2942466047,28,2927498419,-14967628
1647744993,196452,true,2941877642,28,2926913007,-14964635
1647747086,196454,true,2941289355,28,2925742534,-15546821
1647747100,196454,true,2941289355,28,2926035108,-15254247
1647747109,196455,true,2940995255,28,2926035108,-14960147
1647747182,196456,true,2940701185,28,2926035108,-14666077
1647747229,196458,true,2940113133,28,2926035108,-14078025
1647747607,196459,true,2939819151,28,2926913007,-12906144
1647748005,196459,true,2939819151,28,2927498419,-12320732
1647748310,196461,true,2939231276,28,2928083947,-11147329
1647748505,196462,true,2938937382,28,2928376756,-10560626
1647748630,196463,true,2938643518,28,2928669594,-9973924
1647748748,196463,true,2938643518,28,2928962461,-9681057
1647748891,196464,true,2938349683,28,2929255357,-9094326
1647750089,196466,true,2937762101,28,2929841237,-7920864
1647752255,196466,true,2937762101,28,2929841237,-7920864
1647752523,196467,true,2937468354,28,2929841237,-7627117
1647752553,196467,true,2937468354,28,2929841237,-7627117
1647754852,196469,true,2936880948,28,2927205698,-9675250
1647756059,196469,true,2936880948,28,2927205698,-9675250
1647756345,196470,true,2936587290,28,2927205698,-9381592
1647758485,196471,true,2936293660,28,2927498419,-8795241
1647762606,196472,true,2936000060,28,2927498419,-8501641
1647762994,196473,true,2935706490,28,2927498419,-8208071
1647763763,196474,true,2935412948,28,2927498419,-7914529
1647766067,196474,true,2935412948,28,2927498419,-7914529
1647767493,196476,true,2934825954,28,2927498419,-7327535
1647767626,196476,true,2934825954,28,2927498419,-7327535
1647768086,196477,true,2934532501,28,2927498419,-7034082
1647768096,196477,true,2934532501,28,2927498419,-7034082
1647768349,196479,true,2933945682,28,2927498419,-6447263
1647768368,196479,true,2933945682,28,2927498419,-6447263
1647768377,196480,true,2933652317,28,2927498419,-6153898
1647768460,196481,true,2933358981,28,2927205698,-6153283
1647768552,196483,true,2932772397,28,2926913007,-5859390
1647768603,196484,true,2932479149,28,2926620345,-5858804
1647769031,196486,true,2931892741,28,2921649565,-10243176
1647769084,196487,true,2931599581,28,2921065323,-10534258
1647769157,196489,true,2931013349,28,2920481197,-10532152
1647769224,196489,true,2931013349,28,2919897189,-11116160
1647769875,196491,true,2930427235,28,2914063521,-16363714
1647770347,196491,true,2930427235,28,2910568917,-19858318
1647770366,196492,true,2930134221,28,2910568917,-19565304
1647772725,196492,true,2930134221,28,2913772144,-16362077
1647772855,196494,true,2929548282,28,2913772144,-15776138
1647772885,196494,true,2929548282,28,2914063521,-15484761
1647772900,196495,true,2929255357,28,2914063521,-15191836
1647773901,196495,true,2929255357,28,2915520845,-13734512
1647774434,196496,true,2928962461,28,2916395588,-12566873
1647774467,196495,true,2929255357,28,2916395588,-12859769
1647776535,196495,true,2929255357,28,2916687228,-12568129
1647776967,196495,true,2929255357,28,2916687228,-12568129
1647776975,196495,true,2929255357,28,2916687228,-12568129
1647777042,196495,true,2929255357,28,2916395588,-12859769
1647777054,196496,true,2928962461,28,2916395588,-12566873
1647777064,196496,true,2928962461,28,2916395588,-12566873
1647777078,196496,true,2928962461,28,2916395588,-12566873
1647777163,196497,true,2928669594,28,2916103978,-12565616
1647777177,196498,true,2928376756,28,2916103978,-12272778
1647777326,196498,true,2928376756,28,2915520845,-12855911
1647777329,196499,true,2928083947,28,2915520845,-12563102
1647777336,196500,true,2927791168,28,2915520845,-12270323
1647777402,196501,true,2927498419,28,2915229322,-12269097
1647777423,196501,true,2927498419,28,2914937828,-12560591
1647777700,196504,true,2926620345,28,2911733319,-14887026
1647777779,196505,true,2926327712,28,2910859974,-15467738
1647777993,196506,true,2926035108,28,2907659948,-18375160
1647778132,196507,true,2925742534,28,2905044362,-20698172
1647778199,196510,true,2924864987,28,2903882635,-20982352
1647778261,196512,true,2924280102,28,2902721372,-21558730
1647778298,196514,true,2923695333,28,2902140915,-21554418
1647778972,196515,true,2923402993,28,2889111271,-34291722
1647779249,196518,true,2922526147,28,2885069547,-37456600
1647779333,196520,true,2921941730,28,2884204200,-37737530
1647779585,196522,true,2921357429,28,2882474283,-38883146
1647779643,196523,true,2921065323,28,2882474283,-38591040
1647779726,196526,true,2920189178,28,2882186064,-38003114
1647779837,196528,true,2919605228,28,2882186064,-37419164
1647780134,196529,true,2919313297,28,2883050806,-36262491
1647780184,196530,true,2919021395,28,2883339111,-35682284
1647780195,196534,true,2917854078,28,2883339111,-34514967
1647780243,196536,true,2917270595,28,2883627445,-33643150
1647780310,196537,true,2916978897,28,2883915808,-33063089
1647780528,196538,true,2916687228,28,2885069547,-31617681
1647780692,196541,true,2915812397,28,2885646590,-30165807
1647781894,196542,true,2915520845,28,2890556116,-24964729
1647781921,196543,true,2915229322,28,2890556116,-24673206
1647781984,196545,true,2914646363,28,2890556116,-24090247
1647781985,196547,true,2914063521,28,2890556116,-23507405
1647782509,196548,true,2913772144,28,2890267089,-23505055
1647782520,196549,true,2913480796,28,2890267089,-23213707
1647783119,196551,true,2912898187,28,2888244711,-24653476
1647783413,196553,true,2912315695,28,2887378411,-24937284
1647783423,196554,true,2912024493,28,2887378411,-24646082
1647783782,196555,true,2911733319,28,2885646590,-26086729
1647784865,196556,true,2911442175,28,2882762530,-28679645
1647786483,196558,true,2910859974,28,2880745403,-30114571
1647787287,196559,true,2910568917,28,2879305463,-31263454
1647787323,196560,true,2910277889,28,2879305463,-30972426
1647787382,196561,true,2909986891,28,2879017561,-30969330
1647787406,196563,true,2909404981,28,2879017561,-30387420
1647787655,196565,true,2908823187,28,2877290755,-31532432
1647788165,196566,true,2908532334,28,2873552894,-34979440
1647789891,196567,true,2908241509,28,2867238342,-41003167
1647789964,196570,true,2907369212,28,2867238342,-40130870
1647790001,196572,true,2906787825,28,2867238342,-39549483
1647790190,196573,true,2906497175,28,2866378342,-40118833
1647790601,196575,true,2905915963,28,2864659117,-41256846
1647791134,196578,true,2905044362,28,2862368421,-42675941
1647791435,196580,true,2904463441,28,2861223759,-43239682
1647791450,196582,true,2903882635,28,2861223759,-42658876
1647791667,196584,true,2903301946,28,2860079556,-43222390
1647791842,196587,true,2902431129,28,2859793577,-42637552
1647792239,196589,true,2901850730,28,2859793577,-42057153
1647792388,196590,true,2901560574,28,2859221704,-42338870
1647792986,196593,true,2900690280,28,2857221049,-43469231
1647793000,196595,true,2900110229,28,2857221049,-42889180
1647793050,196598,true,2899240370,28,2856935355,-42305015
1647793099,196599,true,2898950475,28,2856935355,-42015120
1647793106,196601,true,2898370772,28,2856935355,-41435417
1647793116,196604,true,2897501434,28,2856935355,-40566079
1647793120,196606,true,2896922021,28,2856935355,-39986666
1647793381,196607,true,2896632358,28,2858649945,-37982413
1647793646,196609,true,2896053118,28,2860079556,-35973562
1647794491,196611,true,2895473994,28,2866091733,-29382261
1647794507,196613,true,2894894986,28,2866378342,-28516644
1647794551,196614,true,2894605526,28,2866664980,-27940546
1647794644,196616,true,2894026692,28,2867238342,-26788350
1647794652,196619,true,2893158657,28,2867238342,-25920315
1647794709,196621,true,2892580112,28,2867525065,-25055047
1647795233,196622,true,2892290883,28,2866951646,-25339237
1647795266,196624,true,2891712512,28,2866664980,-25047532
1647795423,196627,true,2890845171,28,2865518601,-25326570
1647795751,196630,true,2889978091,28,2863227217,-26750874
1647795802,196631,true,2889689122,28,2862940923,-26748199
1647795804,196633,true,2889111271,28,2862940923,-26170348
1647795832,196636,true,2888244711,28,2862654657,-25590054
1647796644,196639,true,2887378411,28,2856649690,-30728721
1647796985,196640,true,2887089702,28,2854936300,-32153402
1647797333,196642,true,2886512371,28,2854079991,-32432380
1647797567,196645,true,2885646590,28,2852653379,-32993211
1647797734,196648,true,2884781069,28,2851797754,-32983315
1647797952,196650,true,2884204200,28,2850942385,-33261815
1647798002,196652,true,2883627445,28,2850657320,-32970125
1647798020,196656,true,2882474283,28,2850372282,-32102001
1647798085,196658,true,2881897874,28,2850087274,-31810600
1647798230,196660,true,2881321581,28,2848662658,-32658923
1647798403,196663,true,2880457357,28,2847238753,-33218604
1647798704,196665,true,2879881352,28,2844393080,-35488272
1647798751,196667,true,2879305463,28,2843824287,-35481176
1647798809,196669,true,2878729688,28,2843255607,-35474081
1647798943,196672,true,2877866242,28,2841550251,-36315991
1647798951,196675,true,2877003054,28,2841550251,-35452803
1647799019,196678,true,2876140126,28,2840697956,-35442170
1647799175,196679,true,2875852541,28,2838710263,-37142278
1647799328,196682,true,2874989958,28,2837291333,-37698625
1647799712,196685,true,2874127633,28,2833322103,-40805530
1647799929,196688,true,2873265567,28,2831905867,-41359700
1647799938,196690,true,2872691000,28,2831905867,-40785133
1647800614,196693,true,2871829365,28,2828509788,-43319577
1647800665,196696,true,2870967989,28,2828509788,-42458201
1647800738,196699,true,2870106871,28,2828509788,-41597083
1647800743,196701,true,2869532935,28,2828509788,-41023147
1647800766,196704,true,2868672248,28,2828792639,-39879609
1647800952,196706,true,2868098599,28,2829358425,-38740174
1647800958,196709,true,2867238342,28,2829358425,-37879917
1647802834,196711,true,2866664980,28,2835873113,-30791867
1647802884,196713,true,2866091733,28,2836156700,-29935033
1647803089,196716,true,2865232077,28,2836156700,-29075377
1647803173,196719,true,2864372680,28,2836156700,-28215980
1647803211,196720,true,2864086271,28,2836156700,-27929571
1647803247,196722,true,2863513540,28,2836156700,-27356840
1647803260,196725,true,2862654657,28,2836156700,-26497957
1647803301,196727,true,2862082212,28,2836440316,-25641896
1647803456,196728,true,2861796033,28,2837007633,-24788400
1647804059,196730,true,2861223759,28,2840413915,-20809844
1647804311,196731,true,2860937666,28,2842118589,-18819077
1647804471,196734,true,2860079556,28,2843255607,-16823949
1647804632,196734,true,2860079556,28,2844393080,-15686476
1647804652,196736,true,2859507626,28,2844393080,-15114546
1647804849,196736,true,2859507626,28,2846384753,-13122873
1647805072,196738,true,2858935810,28,2848947524,-9988286
1647805128,196738,true,2858935810,28,2849517342,-9418468
1647805197,196739,true,2858649945,28,2850087274,-8562671
1647805388,196739,true,2858649945,28,2851797754,-6852191
1647805534,196740,true,2858364109,28,2852938644,-5425465
1647805624,196740,true,2858364109,28,2853794611,-4569498
1647805784,196741,true,2858078301,28,2854936300,-3142001
1647805805,196741,true,2858078301,28,2855221794,-2856507
1647805854,196743,true,2857506771,28,2855792867,-1713904
1647805879,196743,true,2857506771,28,2855792867,-1713904
1647805886,196744,true,2857221049,28,2856078446,-1142603
1647805940,196744,true,2857221049,28,2856649690,-571359
1647806202,196746,true,2856649690,28,2859507626,2857936
1647806235,196746,true,2856649690,28,2860079556,3429866
1647806708,196747,true,2856364054,28,2864945583,8581529
1647806782,196747,true,2856364054,28,2865805152,9441098
1647806790,196748,true,2856078446,28,2865805152,9726706
1647806848,196748,true,2856078446,28,2866378342,10299896
1647806858,196749,true,2855792867,28,2866378342,10585475
1647807020,196748,true,2856078446,28,2868098599,12020153
1647807028,196749,true,2855792867,28,2868385409,12592542
1647807036,196749,true,2855792867,28,2868385409,12592542
1647807101,196749,true,2855792867,28,2869246011,13453144
1647807116,196748,true,2856078446,28,2869532935,13454489
1647807171,196749,true,2855792867,28,2870680921,14888054
1647807231,196748,true,2856078446,28,2871829365,15750919
1647807334,196747,true,2856364054,28,2874127633,17763579
1647807434,196746,true,2856649690,28,2876140126,19490436
1647807864,196746,true,2856649690,28,2884492620,27842930
1647807876,196746,true,2856649690,28,2884781069,28131379
1647807932,196745,true,2856935355,28,2885646590,28711235
1647808260,196743,true,2857506771,28,2890845171,33338400
1647808471,196743,true,2857506771,28,2893737318,36230547
1647808636,196742,true,2857792522,28,2895763542,37971020
1647808661,196741,true,2858078301,28,2896053118,37974817
1647808664,196740,true,2858364109,28,2896053118,37689009
1647808770,196739,true,2858649945,28,2896922021,38272076
1647809283,196739,true,2858649945,28,2895473994,36824049
1647809290,196737,true,2859221704,28,2895473994,36252290
1647809750,196736,true,2859507626,28,2892869370,33361744
1647809803,196736,true,2859507626,28,2892580112,33072486
1647809856,196736,true,2859507626,28,2892001683,32494057
1647810000,196734,true,2860079556,28,2890845171,30765615
1647810008,196733,true,2860365564,28,2890845171,30479607
1647810026,196733,true,2860365564,28,2890556116,30190552
1647810059,196733,true,2860365564,28,2890267089,29901525
1647810187,196731,true,2860937666,28,2888822389,27884723
1647810222,196730,true,2861223759,28,2888244711,27020952
1647810262,196730,true,2861223759,28,2887667149,26443390
1647810658,196730,true,2861223759,28,2882762530,21538771
1647810988,196730,true,2861223759,28,2879305463,18081704
1647811007,196729,true,2861509882,28,2879305463,17795581
1647811335,196728,true,2861796033,28,2877290755,15494722
1647811915,196730,true,2861223759,28,2874989958,13766199
1647811936,196729,true,2861509882,28,2874989958,13480076
1647812122,196728,true,2861796033,28,2875852541,14056508
1647812478,196727,true,2862082212,28,2877578484,15496272
1647813976,196728,true,2861796033,28,2880169341,18373308
1647814030,196727,true,2862082212,28,2879881352,17799140
1647814038,196726,true,2862368421,28,2879881352,17512931
1647814055,196725,true,2862654657,28,2879881352,17226695
1647815129,196727,true,2862082212,28,2874989958,12907746
1647815232,196726,true,2862368421,28,2874415046,12046625
1647815237,196725,true,2862654657,28,2874415046,11760389
1647815936,196724,true,2862940923,28,2869819889,6878966
1647816182,196726,true,2862368421,28,2868959115,6590694
1647816325,196725,true,2862654657,28,2868672248,6017591
1647816339,196723,true,2863227217,28,2868672248,5445031
1647816424,196723,true,2863227217,28,2868098599,4871382
1647816774,196724,true,2862940923,28,2866664980,3724057
1647817031,196723,true,2863227217,28,2865805152,2577935
1647817067,196722,true,2863513540,28,2865805152,2291612
1647817088,196721,true,2863799891,28,2865805152,2005261
1647817208,196722,true,2863513540,28,2865805152,2291612
1647817240,196721,true,2863799891,28,2865805152,2005261
1647818959,196719,true,2864372680,28,2868672248,4299568
1647819010,196718,true,2864659117,28,2868672248,4013131
1647819024,196719,true,2864372680,28,2868385409,4012729
1647820924,196717,true,2864945583,28,2860365564,-4580019
1647821143,196716,true,2865232077,28,2860365564,-4866513
1647821400,196715,true,2865518601,28,2860365564,-5153037
1647822140,196716,true,2865232077,28,2860937666,-4294411
1647822324,196714,true,2865805152,28,2860937666,-4867486
1647822361,196712,true,2866378342,28,2860937666,-5440676
1647823863,196711,true,2866664980,28,2858364109,-8300871
1647824089,196712,true,2866378342,28,2858078301,-8300041
1647824135,196711,true,2866664980,28,2857792522,-8872458
1647824194,196709,true,2867238342,28,2857792522,-9445820
1647824202,196708,true,2867525065,28,2857792522,-9732543
1647824245,196708,true,2867525065,28,2858078301,-9446764
1647824331,196707,true,2867811818,28,2858078301,-9733517
1647824413,196705,true,2868385409,28,2858364109,-10021300
1647824487,196703,true,2868959115,28,2858649945,-10309170
1647825227,196704,true,2868672248,28,2861796033,-6876215
1647825272,196702,true,2869246011,28,2861796033,-7449978
1647825282,196701,true,2869532935,28,2862082212,-7450723
1647825288,196700,true,2869819889,28,2862082212,-7737677
1647825296,196700,true,2869819889,28,2862082212,-7737677
1647825403,196698,true,2870393881,28,2862654657,-7739224
1647826584,196697,true,2870680921,28,2868385409,-2295512
1647829139,196695,true,2871255086,28,2869532935,-1722151
1647829200,196696,true,2870967989,28,2869532935,-1435054
1647829425,196694,true,2871542211,28,2869532935,-2009276
1647829605,196693,true,2871829365,28,2869532935,-2296430
1647829721,196692,true,2872116548,28,2868959115,-3157433
1647830025,196693,true,2871829365,28,2867811818,-4017547
1647830056,196692,true,2872116548,28,2867525065,-4591483
1647830060,196691,true,2872403760,28,2867525065,-4878695
1647830070,196690,true,2872691000,28,2867238342,-5452658
1647830934,196693,true,2871829365,28,2854650835,-17178530
1647831110,196693,true,2871829365,28,2851797754,-20031611
1647831180,196692,true,2872116548,28,2850942385,-21174163
1647831440,196691,true,2872403760,28,2846954058,-25449702
1647832759,196695,true,2871255086,28,2841266124,-29988962
1647833052,196695,true,2871255086,28,2840982026,-30273060
1647833923,196694,true,2871542211,28,2840982026,-30560185
1647833942,196694,true,2871542211,28,2841266124,-30276087
1647834385,196697,true,2870680921,28,2842118589,-28562332
1647840139,196697,true,2870680921,28,2845531008,-25149913
1647840160,196696,true,2870967989,28,2845531008,-25436981
1647840167,196696,true,2870967989,28,2845815561,-25152428
1647840438,196700,true,2869819889,28,2846100143,-23719746
1647840531,196699,true,2870106871,28,2846100143,-24006728
1647840613,196698,true,2870393881,28,2846384753,-24009128
1647840645,196698,true,2870393881,28,2846384753,-24009128
1647840832,196702,true,2869246011,28,2846669391,-22576620
1647841052,196701,true,2869532935,28,2847238753,-22294182
1647841097,196701,true,2869532935,28,2847523477,-22009458
1647841807,196701,true,2869532935,28,2850657320,-18875615
1647841956,196704,true,2868672248,28,2851227480,-17444768
1647842262,196704,true,2868672248,28,2852653379,-16018869
1647842278,196704,true,2868672248,28,2852938644,-15733604
1647842342,196704,true,2868672248,28,2853223938,-15448310
1647842364,196707,true,2867811818,28,2853509260,-14302558
1647842402,196707,true,2867811818,28,2853509260,-14302558
1647842422,196707,true,2867811818,28,2853794611,-14017207
1647842773,196707,true,2867811818,28,2856364054,-11447764
1647843181,196711,true,2866664980,28,2859221704,-7443276
1647843217,196711,true,2866664980,28,2859507626,-7157354
1647843234,196711,true,2866664980,28,2859507626,-7157354
1647843264,196711,true,2866664980,28,2859793577,-6871403
1647843276,196715,true,2865518601,28,2859793577,-5725024
1647843461,196715,true,2865518601,28,2861509882,-4008719
1647844307,196715,true,2865518601,28,2867525065,2006464
1647845970,196715,true,2865518601,28,2867525065,2006464
1647846215,196718,true,2864659117,28,2867238342,2579225
1647846671,196718,true,2864659117,28,2866951646,2292529
1647846724,196719,true,2864372680,28,2866951646,2578966
1647846945,196718,true,2864659117,28,2867238342,2579225
1647847315,196721,true,2863799891,28,2867811818,4011927
1647847379,196721,true,2863799891,28,2868098599,4298708
1647847438,196721,true,2863799891,28,2868098599,4298708
1647847562,196721,true,2863799891,28,2868385409,4585518
1647848663,196723,true,2863227217,28,2870393881,7166664
1647848677,196723,true,2863227217,28,2870680921,7453704
1647848706,196723,true,2863227217,28,2870680921,7453704
1647848733,196722,true,2863513540,28,2870680921,7167381
1647848752,196724,true,2862940923,28,2870680921,7739998
1647848872,196723,true,2863227217,28,2871542211,8314994
1647848992,196722,true,2863513540,28,2872403760,8890220
1647849051,196722,true,2863513540,28,2872691000,9177460
1647849062,196723,true,2863227217,28,2872978269,9751052
1647849119,196721,true,2863799891,28,2873265567,9465676
1647849688,196720,true,2864086271,28,2878154028,14067757
1647849705,196720,true,2864086271,28,2878441844,14355573
1647849711,196722,true,2863513540,28,2878441844,14928304
1647851461,196719,true,2864372680,28,2894026692,29654012
1647852175,196718,true,2864659117,28,2894026692,29367575
1647852763,196718,true,2864659117,28,2893737318,29078201
1647853629,196720,true,2864086271,28,2891423369,27337098
1647853670,196718,true,2864659117,28,2891423369,26764252
1647853778,196717,true,2864945583,28,2890845171,25899588
1647853952,196717,true,2864945583,28,2889978091,25032508
1647855117,196719,true,2864372680,28,2885935155,21562475
1647855248,196716,true,2865232077,28,2885646590,20414513
1647855256,196715,true,2865518601,28,2885646590,20127989
1647855264,196715,true,2865518601,28,2885646590,20127989
1647855304,196716,true,2865232077,28,2885646590,20414513
1647855312,196714,true,2865805152,28,2885646590,19841438
1647855322,196713,true,2866091733,28,2885646590,19554857
1647855338,196713,true,2866091733,28,2885646590,19554857
1647855355,196713,true,2866091733,28,2885646590,19554857
1647855385,196711,true,2866664980,28,2885646590,18981610
1647855427,196710,true,2866951646,28,2885646590,18694944
1647855500,196709,true,2867238342,28,2885935155,18696813
1647855559,196710,true,2866951646,28,2886223748,19272102
1647855569,196707,true,2867811818,28,2886512371,18700553
1647855616,196706,true,2868098599,28,2886801022,18702423
1647856706,196705,true,2868385409,28,2896632358,28246949
1647856743,196706,true,2868098599,28,2896922021,28823422
1647856753,196702,true,2869246011,28,2896922021,27676010
1647856762,196701,true,2869532935,28,2897211713,27678778
1647856886,196699,true,2870106871,28,2898660609,28553738
1647856911,196700,true,2869819889,28,2898950475,29130586
1647857230,196696,true,2870967989,28,2903011645,32043656
1647857698,196695,true,2871255086,28,2905915963,34660877
1647858529,196693,true,2871829365,28,2911442175,39612810
1647859392,196693,true,2871829365,28,2912898187,41068822
1647860747,196690,true,2872691000,28,2912898187,40207187
1647861580,196688,true,2873265567,28,2912898187,39632620
1647861900,196686,true,2873840249,28,2913189477,39349228
1647863859,196686,true,2873840249,28,2915812397,41972148
1647864247,196683,true,2874702487,28,2915520845,40818358
1647864254,196681,true,2875277457,28,2915520845,40243388
1647864272,196680,true,2875564984,28,2915520845,39955861
1647864293,196680,true,2875564984,28,2915520845,39955861
1647864411,196677,true,2876427740,28,2915229322,38801582
1647864644,196676,true,2876715383,28,2914354928,37639545
1647864720,196674,true,2877290755,28,2914063521,36772766
1647864768,196675,true,2877003054,28,2914063521,37060467
1647864955,196672,true,2877866242,28,2913189477,35323235
1647865141,196671,true,2878154028,28,2912606927,34452899
1647866122,196669,true,2878729688,28,2908823187,30093499
1647866447,196670,true,2878441844,28,2908532334,30090490
1647866451,196667,true,2879305463,28,2908532334,29226871
1647866521,196666,true,2879593393,28,2908241509,28648116
1647866579,196664,true,2880169341,28,2907950714,27781373
1647867158,196666,true,2879593393,28,2904753887,25160494
1647867287,196663,true,2880457357,28,2903882635,23425278
1647867323,196661,true,2881033478,28,2903882635,22849157
1647867448,196660,true,2881321581,28,2903301946,21980365
1647867451,196659,true,2881609713,28,2903301946,21692233
1647867471,196655,true,2882762530,28,2903301946,20539416
1647867493,196654,true,2883050806,28,2903301946,20251140
1647867509,196652,true,2883627445,28,2903301946,19674501
1647867678,196650,true,2884204200,28,2903592276,19388076
1647867979,196647,true,2885069547,28,2904463441,19393894
1647868005,196645,true,2885646590,28,2904463441,18816851
1647868573,196642,true,2886512371,28,2909404981,22892610
1647868655,196641,true,2886801022,28,2910568917,23767895
1647868677,196637,true,2887955916,28,2910859974,22904058
1647868714,196636,true,2888244711,28,2911442175,23197464
1647869182,196632,true,2889400182,28,2919313297,29913115
1647869350,196631,true,2889689122,28,2921649565,31960443
1647870165,196627,true,2890845171,28,2928376756,37531585
1647870223,196626,true,2891134256,28,2928669594,37535338
1647870378,196622,true,2892290883,28,2930427235,38136352
1647870501,196620,true,2892869370,28,2931306451,38437081
1647870724,196616,true,2894026692,28,2932479149,38452457
1647870725,196615,true,2894316094,28,2932479149,38163055
1647870748,196611,true,2895473994,28,2932479149,37005155
1647870872,196610,true,2895763542,28,2932772397,37008855
1647870884,196607,true,2896632358,28,2932772397,36140039
1647871162,196606,true,2896922021,28,2931892741,34970720
1647871204,196602,true,2898080964,28,2931892741,33811777
1647871680,196602,true,2898080964,28,2928669594,30588630
1647871723,196599,true,2898950475,28,2928376756,29426281
1647871742,196598,true,2899240370,28,2928376756,29136386
1647871904,196596,true,2899820247,28,2926620345,26800098
1647872392,196596,true,2899820247,28,2920189178,20368931
1647872567,196593,true,2900690280,28,2917562322,16872042
1647872578,196593,true,2900690280,28,2917562322,16872042
1647872629,196590,true,2901560574,28,2916687228,15126654
1647872661,196591,true,2901270447,28,2916103978,14833531
1647872871,196589,true,2901850730,28,2913480796,11630066
1647874328,196588,true,2902140915,28,2902721372,580457
1647874580,196586,true,2902721372,28,2902431129,-290243
1647874610,196587,true,2902431129,28,2902431129,0
1647874620,196584,true,2903301946,28,2902431129,-870817
1647874628,196584,true,2903301946,28,2902431129,-870817
1647874646,196581,true,2904173023,28,2902431129,-1741894
1647874689,196582,true,2903882635,28,2902431129,-1451506
1647874723,196580,true,2904463441,28,2902721372,-1742069
1647874746,196579,true,2904753887,28,2902721372,-2032515
1647874794,196576,true,2905625400,28,2903011645,-2613755
1647874844,196577,true,2905334867,28,2903592276,-1742591
1647874869,196574,true,2906206555,28,2903882635,-2323920
1647875560,196573,true,2906497175,28,2911442175,4945000
1647875652,196570,true,2907369212,28,2912606927,5237715
1647875673,196571,true,2907078504,28,2912898187,5819683
1647875700,196569,true,2907659948,28,2913189477,5529529
1647875778,196568,true,2907950714,28,2914063521,6112807
1647875814,196565,true,2908823187,28,2914646363,5823176
1647875827,196565,true,2908823187,28,2914937828,6114641
1647875832,196564,true,2909114069,28,2914937828,5823759
1647875862,196562,true,2909695921,28,2915520845,5824924
1647876038,196558,true,2910859974,28,2918729522,7869548
1647876137,196559,true,2910568917,28,2920773245,10204328
1647876184,196558,true,2910859974,28,2921649565,10789591
1647876276,196557,true,2911151060,28,2923402993,12251933
1647876290,196553,true,2912315695,28,2923695333,11379638
1647876325,196554,true,2912024493,28,2924572530,12548037
1647876331,196552,true,2912606927,28,2924572530,11965603
1647876371,196551,true,2912898187,28,2925449989,12551802
1647876386,196547,true,2914063521,28,2925742534,11679013
1647876489,196546,true,2914354928,28,2928083947,13729019
1647877001,196545,true,2914646363,28,2935412948,20766585
1647877030,196543,true,2915229322,28,2936000060,20770738
1647877720,196539,true,2916395588,28,2944820844,28425256
1647878312,196539,true,2916395588,28,2947472243,31076655
1647878380,196537,true,2916978897,28,2947766990,30788093
1647878432,196536,true,2917270595,28,2948061767,30791172
1647878497,196531,true,2918729522,28,2948061767,29332245
1647878567,196531,true,2918729522,28,2948356573,29627051
1647878580,196530,true,2919021395,28,2948356573,29335178
1647878604,196529,true,2919313297,28,2948356573,29043276
1647879420,196524,true,2920773245,28,2952782205,32008960
1647879458,196524,true,2920773245,28,2953077483,32304238
1647879480,196523,true,2921065323,28,2953077483,32012160
1647879663,196521,true,2921649565,28,2953963495,32313930
1647879765,196517,true,2922818400,28,2954258892,31440492
1647880049,196517,true,2922818400,28,2955440772,32622372
1647880067,196516,true,2923110682,28,2955440772,32330090
1647880095,196515,true,2923402993,28,2955736317,32333324
1647880132,196511,true,2924572530,28,2955736317,31163787
1647880169,196511,true,2924572530,28,2955736317,31163787
1647880214,196511,true,2924572530,28,2955736317,31163787
1647880254,196510,true,2924864987,28,2955736317,30871330
1647880259,196506,true,2926035108,28,2955736317,29701209
1647880286,196507,true,2925742534,28,2955736317,29993783
1647880308,196506,true,2926035108,28,2955736317,29701209
1647880317,196506,true,2926035108,28,2955440772,29405664
1647880558,196503,true,2926913007,28,2953077483,26164476
1647880562,196504,true,2926620345,28,2953077483,26457138
1647880576,196504,true,2926620345,28,2952782205,26161860
1647880607,196503,true,2926913007,28,2952486957,25573950
1647880675,196501,true,2927498419,28,2951601388,24102969
1647881536,196501,true,2927498419,28,2940407145,12908726
1647881564,196501,true,2927498419,28,2940113133,12614714
1647881619,196501,true,2927498419,28,2939231276,11732857
1647881628,196498,true,2928376756,28,2938937382,10560626
1647881662,196499,true,2928083947,28,2938349683,10265736
1647881705,196499,true,2928083947,28,2937762101,9678154
1647881825,196499,true,2928083947,28,2935412948,7329001
1647881886,196496,true,2928962461,28,2934239077,5276616
1647881898,196498,true,2928376756,28,2933945682,5568926
1647881929,196498,true,2928376756,28,2933358981,4982225
1647882096,196498,true,2928376756,28,2930134221,1757465
1647882140,196495,true,2929255357,28,2929548282,292925
1647882230,196496,true,2928962461,28,2928083947,-878514
1647882735,196496,true,2928962461,28,2921357429,-7605032
1647882784,196496,true,2928962461,28,2920773245,-8189216
1647883078,196494,true,2929548282,28,2916978897,-12569385
1647883112,196495,true,2929255357,28,2916395588,-12859769
1647883118,196495,true,2929255357,28,2916395588,-12859769
1647883806,196496,true,2928962461,28,2909404981,-19557480
1647883817,196494,true,2929548282,28,2909404981,-20143301
1647883898,196495,true,2929255357,28,2908823187,-20432170
1647883925,196496,true,2928962461,28,2909114069,-19848392
1647884754,196496,true,2928962461,28,2912024493,-16937968
1647884759,196494,true,2929548282,28,2912024493,-17523789
1647885072,196495,true,2929255357,28,2913189477,-16065880
1647885389,196496,true,2928962461,28,2914646363,-14316098
1647885620,196496,true,2928962461,28,2915812397,-13150064
1647886803,196495,true,2929255357,28,2917270595,-11984762
1647887981,196497,true,2928669594,28,2917270595,-11398999
1647889166,196498,true,2928376756,28,2916978897,-11397859
1647889177,196498,true,2928376756,28,2916978897,-11397859
1647889600,196497,true,2928669594,28,2916687228,-11982366
1647889630,196499,true,2928083947,28,2916687228,-11396719
1647889761,196500,true,2927791168,28,2916395588,-11395580
1647889768,196500,true,2927791168,28,2916395588,-11395580
1647889822,196500,true,2927791168,28,2916395588,-11395580
1647889849,196501,true,2927498419,28,2916395588,-11102831
1647890365,196503,true,2926913007,28,2913480796,-13432211
1647892597,196503,true,2926913007,28,2906206555,-20706452
1647892680,196502,true,2927205698,28,2906497175,-20708523
1647892708,196503,true,2926913007,28,2906497175,-20415832
1647892898,196505,true,2926327712,28,2906787825,-19539887
1647893037,196504,true,2926620345,28,2907369212,-19251133
1647893506,196503,true,2926913007,28,2908532334,-18380673
1647893601,196503,true,2926913007,28,2908823187,-18089820
1647893666,196505,true,2926327712,28,2909114069,-17213643
1647894133,196504,true,2926620345,28,2911442175,-15178170
1647894958,196503,true,2926913007,28,2914063521,-12849486
1647896028,196502,true,2927205698,28,2915229322,-11976376
1647897110,196504,true,2926620345,28,2915229322,-11391023
1647897150,196502,true,2927205698,28,2915229322,-11976376
1647899095,196501,true,2927498419,28,2910859974,-16638445
1647899551,196501,true,2927498419,28,2910859974,-16638445
1647899644,196503,true,2926913007,28,2910859974,-16053033
1647899784,196501,true,2927498419,28,2911151060,-16347359
1647900427,196500,true,2927791168,28,2911733319,-16057849
1647900665,196500,true,2927791168,28,2912024493,-15766675
1647900824,196502,true,2927205698,28,2912315695,-14890003
1647901388,196501,true,2927498419,28,2912898187,-14600232
1647902327,196500,true,2927791168,28,2916395588,-11395580
1647902340,196500,true,2927791168,28,2916395588,-11395580
1647902827,196502,true,2927205698,28,2917562322,-9643376
1647903703,196501,true,2927498419,28,2917562322,-9936097
1647903742,196500,true,2927791168,28,2917562322,-10228846
1647905062,196501,true,2927498419,28,2915520845,-11977574
1647905200,196503,true,2926913007,28,2915229322,-11683685
1647905208,196502,true,2927205698,28,2915229322,-11976376
1647905236,196502,true,2927205698,28,2914937828,-12267870
1647905245,196503,true,2926913007,28,2914937828,-11975179
1647905318,196506,true,2926035108,28,2914354928,-11680180
1647905410,196506,true,2926035108,28,2913480796,-12554312
1647907323,196507,true,2925742534,28,2894894986,-30847548
1647910207,196508,true,2925449989,28,2894894986,-30555003
1647910366,196511,true,2924572530,28,2895184476,-29388054
1647910412,196511,true,2924572530,28,2895184476,-29388054
1647910856,196512,true,2924280102,28,2896053118,-28226984
1647910893,196513,true,2923987703,28,2896053118,-27934585
1647911092,196515,true,2923402993,28,2896632358,-26770635
1647911212,196516,true,2923110682,28,2896922021,-26188661
1647911547,196517,true,2922818400,28,2898080964,-24737436
1647911572,196518,true,2922526147,28,2898080964,-24445183
1647911592,196521,true,2921649565,28,2898370772,-23278793
1647911610,196522,true,2921357429,28,2898370772,-22986657
1647911708,196522,true,2921357429,28,2898950475,-22406954
1647911803,196524,true,2920773245,28,2899240370,-21532875
1647911896,196526,true,2920189178,28,2899820247,-20368931
1647912609,196527,true,2919897189,28,2902431129,-17466060
1647912630,196528,true,2919605228,28,2902431129,-17174099
1647912913,196529,true,2919313297,28,2902721372,-16591925
1647913535,196532,true,2918437678,28,2902721372,-15716306
1647914565,196533,true,2918145863,28,2900980349,-17165514
1647914573,196535,true,2917562322,28,2901270447,-16291875
1647914593,196536,true,2917270595,28,2901270447,-16000148
1647914613,196539,true,2916395588,28,2901560574,-14835014
1647914748,196536,true,2917270595,28,2903882635,-13387960
1647914846,196538,true,2916687228,28,2905625400,-11061828
1647915059,196539,true,2916395588,28,2908241509,-8154079
1647915072,196542,true,2915520845,28,2908532334,-6988511
1647915327,196540,true,2916103978,28,2912315695,-3788283
1647915372,196541,true,2915812397,28,2913189477,-2622920
1647915415,196543,true,2915229322,28,2913772144,-1457178
1647915742,196545,true,2914646363,28,2920189178,5542815
1647915887,196542,true,2915520845,28,2923402993,7882148
1647915889,196543,true,2915229322,28,2923402993,8173671
1647916131,196544,true,2914937828,28,2929255357,14317529
1647916175,196545,true,2914646363,28,2930720277,16073914
1647916191,196541,true,2915812397,28,2931013349,15200952
1647916425,196541,true,2915812397,28,2937174636,21362239
1647916445,196542,true,2915520845,28,2937468354,21947509
1647916661,196543,true,2915229322,28,2940407145,25177823
1647917072,196539,true,2916395588,28,2947177525,30781937
1647917100,196539,true,2916395588,28,2947472243,31076655
1647917197,196539,true,2916395588,28,2949241169,32845581
1647917201,196540,true,2916103978,28,2949241169,33137191
1647917224,196536,true,2917270595,28,2949831046,32560451
1647917373,196535,true,2917562322,28,2952191737,34629415
1647917398,196534,true,2917854078,28,2952782205,34928127
1647917647,196535,true,2917562322,28,2957214480,39652158
1647917682,196530,true,2919021395,28,2957805953,38784558
1647917685,196529,true,2919313297,28,2957805953,38492656
1647918588,196528,true,2919605228,28,2966988918,47383690
1647918605,196529,true,2919313297,28,2966988918,47675621
1647919022,196523,true,2921065323,28,2970551264,49485941
1647919089,196522,true,2921357429,28,2970848319,49490890
1647919124,196521,true,2921649565,28,2970848319,49198754
1647919167,196521,true,2921649565,28,2971442518,49792953
1647919189,196515,true,2923402993,28,2971739663,48336670
1647919261,196512,true,2924280102,28,2973225830,48945728
1647919286,196510,true,2924864987,28,2973820505,48955518
1647919302,196510,true,2924864987,28,2974117887,49252900
1647919313,196503,true,2926913007,28,2974415298,47502291
1647919412,196499,true,2928083947,28,2977093343,49009396
1647919656,196497,true,2928669594,28,2983649830,54980236
1647919689,196496,true,2928962461,28,2984545015,55582554
1647919884,196491,true,2930427235,28,2989323870,58896635
1647920200,196487,true,2931599581,28,2996806154,65206573
1647920697,196485,true,2932185931,28,3008215111,76029180
1647920709,196485,true,2932185931,28,3008515932,76330001
1647921215,196479,true,2933945682,28,3015141622,81195940
1647921504,196475,true,2935119436,28,3015141622,80022186
1647921698,196473,true,2935706490,28,3015443136,79736646
1647922330,196473,true,2935706490,28,3016046254,80339764
1647923192,196467,true,2937468354,28,3015141622,77673268
1647923222,196463,true,2938643518,28,3015141622,76498104
1647923232,196461,true,2939231276,28,3015443136,76211860
1647923251,196461,true,2939231276,28,3015443136,76211860
1647923260,196454,true,2941289355,28,3015443136,74153781
1647923264,196450,true,2942466047,28,3015443136,72977089
1647923875,196446,true,2943643210,28,3022990797,79347587
1647924050,196445,true,2943937574,28,3025107525,81169951
1647924528,196438,true,2945998949,28,3031466608,85467659
1647924975,196434,true,2947177525,28,3037535304,90357779
1647925011,196431,true,2948061767,28,3037839058,89777291
1647925027,196429,true,2948651409,28,3038142842,89491433
1647925956,196423,true,2950421042,28,3036320594,85899552
1647925986,196419,true,2951601388,28,3036016992,84415604
1647926050,196416,true,2952486957,28,3035713421,83226464
1647926058,196415,true,2952782205,28,3035713421,82931216
1647926318,196409,true,2954554318,28,3034196019,79641701
1647926351,196406,true,2955440772,28,3033892630,78451858
1647927037,196403,true,2956327493,28,3029042526,72715033
1647927805,196401,true,2956918788,28,3024805045,67886257
1647927870,196396,true,2958397544,28,3024502595,66105051
1647928381,196392,true,2959581080,28,3023897785,64316705
1647928407,196389,true,2960469043,28,3023897785,63428742
1647928870,196388,true,2960765090,28,3023595425,62830335
1647928893,196383,true,2962245769,28,3023595425,61349656
1647928901,196379,true,2963430845,28,3023595425,60164580
1647928908,196376,true,2964319963,28,3023595425,59275462
1647928921,196376,true,2964319963,28,3023595425,59275462
1647928928,196371,true,2965802419,28,3023293096,57490677
1647928943,196369,true,2966395610,28,3022990797,56595187
1647929149,196366,true,2967285617,28,3019969468,52683851
1647929217,196366,true,2967285617,28,3019063658,51778041
1647929238,196362,true,2968472710,28,3018459936,49987226
1647929280,196359,true,2969363340,28,3017554579,48191239
1647929634,196358,true,2969660277,28,3009117665,39457388
1647931407,196358,true,2969660277,28,2984843469,15183192
1647931446,196353,true,2971145404,28,2985141954,13996550
1647931941,196351,true,2971739663,28,2985739012,13999349
1647932804,196349,true,2972334040,28,2985440468,13106428
1647932964,196348,true,2972631274,28,2985440468,12809194
1647933446,196343,true,2974117887,28,2985440468,11322581
1647933838,196340,true,2975010211,28,2985739012,10728801
1647934139,196338,true,2975605243,28,2986037586,10432343
1647936032,196337,true,2975902804,28,2987829656,11926852
1647936425,196332,true,2977391053,28,2988128439,10737386
1647936442,196329,true,2978284359,28,2988128439,9844080
1647936501,196327,true,2978880046,28,2988128439,9248393
1647936516,196326,true,2979177934,28,2988128439,8950505
1647936535,196321,true,2980667821,28,2988427252,7759431
1647936659,196318,true,2981562111,28,2988726095,7163984
1647936792,196315,true,2982456669,28,2989622802,7166133
1647936892,196314,true,2982754914,28,2990220757,7465843
1647937144,196309,true,2984246590,28,2992314539,8067949
1647937456,196306,true,2985141954,28,2994709229,9567275
1647937547,196304,true,2985739012,28,2995308201,9569189
1647937568,196302,true,2986336189,28,2995607732,9271543
1647938066,196297,true,2987829656,28,3001004411,13174755
1647938284,196293,true,2989024967,28,3003105745,14080778
1647938313,196291,true,2989622802,28,3003406055,13783253
1647938469,196290,true,2989921765,28,3004607598,14685833
1647938561,196284,true,2991716166,28,3005208549,13492383
1647938612,196280,true,2992913032,28,3005509070,12596038
1647939938,196277,true,2993810996,28,3016046254,22235258
1647940198,196276,true,2994110377,28,3017252854,23142477
1647940614,196273,true,2995008700,28,3017554579,22545879
1647940990,196270,true,2995907292,28,3016951159,21043867
1647941119,196267,true,2996806154,28,3016649494,19843340
1647941291,196265,true,2997405546,28,3016046254,18640708
1647941341,196263,true,2998005057,28,3015744680,17739623
1647941415,196260,true,2998904548,28,3015443136,16538588
1647942170,196257,true,2999804309,28,3011826955,12022646
1647943037,196256,true,3000104290,28,3009418577,9314287
1647943323,196254,true,3000704341,28,3009418577,8714236
1647944034,196251,true,3001604642,28,3009719519,8114877
1647944517,196249,true,3002204993,28,3009719519,7514526
1647945086,196248,true,3002505214,28,3009719519,7214305
1647945109,196247,true,3002805464,28,3009719519,6914055
1647945512,196244,true,3003706396,28,3009719519,6013123
1647945584,196242,true,3004307167,28,3010020491,5713324
1647945791,196242,true,3004307167,28,3010020491,5713324
1647945983,196240,true,3004908059,28,3010020491,5112432
1647946196,196237,true,3005809621,28,3010321493,4511872
1647946227,196235,true,3006410813,28,3010321493,3910680
1647947217,196235,true,3006410813,28,3012429350,6018537
1647947291,196234,true,3006711454,28,3012730593,6019139
1647947749,196231,true,3007613558,28,3014538684,6925126
1647948326,196230,true,3007914319,28,3016046254,8131935
1647948636,196229,true,3008215111,28,3016951159,8736048
1647949682,196228,true,3008515932,28,3018158120,9642188
1647950469,196225,true,3009418577,28,3018158120,8739543
1647950955,196224,true,3009719519,28,3019063658,9344139
1647951216,196223,true,3010020491,28,3019365565,9345074
1647951385,196222,true,3010321493,28,3019667501,9346008
1647951499,196219,true,3011224680,28,3019667501,8442821
1647951523,196218,true,3011525802,28,3019667501,8141699
1647951649,196218,true,3011525802,28,3019667501,8141699
1647951666,196218,true,3011525802,28,3019667501,8141699
1647951704,196217,true,3011826955,28,3019667501,7840546
1647952104,196216,true,3012128138,28,3018459936,6331798
1647952163,196217,true,3011826955,28,3018459936,6632981
1647952412,196217,true,3011826955,28,3017252854,5425899
1647952605,196217,true,3011826955,28,3016347859,4520904
1647952631,196217,true,3011826955,28,3016347859,4520904
1647952736,196217,true,3011826955,28,3015744680,3917725
1647952752,196217,true,3011826955,28,3015744680,3917725
1647952832,196217,true,3011826955,28,3015443136,3616181
1647952860,196217,true,3011826955,28,3015141622,3314667
1647953248,196218,true,3011525802,28,3013031866,1506064
1647954074,196218,true,3011525802,28,3010622525,-903277
1647955376,196218,true,3011525802,28,3009719519,-1806283
1647955806,196218,true,3011525802,28,3009719519,-1806283
1647955939,196219,true,3011224680,28,3009719519,-1505161
1647956074,196219,true,3011224680,28,3009719519,-1505161
1647956770,196219,true,3011224680,28,3009719519,-1505161
1647956853,196219,true,3011224680,28,3009719519,-1505161
1647956856,196219,true,3011224680,28,3009719519,-1505161
1647957024,196220,true,3010923587,28,3009418577,-1505010
1647957026,196221,true,3010622525,28,3009418577,-1203948
1647957103,196223,true,3010020491,28,3009117665,-902826
1647957131,196223,true,3010020491,28,3009117665,-902826
1647958250,196225,true,3009418577,28,3004006766,-5411811
1647958653,196225,true,3009418577,28,3003105745,-6312832
1647958718,196227,true,3008816784,28,3003105745,-5711039
1647958735,196227,true,3008816784,28,3003105745,-5711039
1647958807,196228,true,3008515932,28,3003105745,-5410187
1647959162,196228,true,3008515932,28,3005208549,-3307383
1647959290,196229,true,3008215111,28,3005809621,-2405490
1647959624,196230,true,3007914319,28,3007914319,0
1647959678,196230,true,3007914319,28,3008215111,300792
1647959713,196230,true,3007914319,28,3008515932,601613
1647959880,196231,true,3007613558,28,3010321493,2707935
1647960527,196230,true,3007914319,28,3016951159,9036840
1647960540,196230,true,3007914319,28,3017252854,9338535
1647960790,196230,true,3007914319,28,3017856335,9942016
1647960833,196231,true,3007613558,28,3018158120,10544562
1647960909,196231,true,3007613558,28,3018459936,10846378
1647960977,196231,true,3007613558,28,3018459936,10846378
1647961019,196231,true,3007613558,28,3018459936,10846378
1647961214,196232,true,3007312827,28,3018761782,11448955
1647961243,196231,true,3007613558,28,3018761782,11148224
1647962979,196230,true,3007914319,28,3014840137,6925818
1647964749,196229,true,3008215111,28,3014840137,6625026
1647964906,196230,true,3007914319,28,3014840137,6925818
1647965345,196229,true,3008215111,28,3014538684,6323573
1647966368,196228,true,3008515932,28,3013333170,4817238
1647966516,196227,true,3008816784,28,3013031866,4215082
1647967374,196226,true,3009117665,28,3012730593,3612928
1647967701,196225,true,3009418577,28,3012730593,3312016
1647967838,196224,true,3009719519,28,3012429350,2709831
1647968141,196224,true,3009719519,28,3011224680,1505161
1647968406,196223,true,3010020491,28,3010020491,0
1647970065,196223,true,3010020491,28,3005208549,-4811942
1647971151,196222,true,3010321493,28,3005208549,-5112944
1647971306,196222,true,3010321493,28,3005208549,-5112944
1647973745,196221,true,3010622525,28,3005208549,-5413976
1647973828,196221,true,3010622525,28,3005208549,-5413976
1647973830,196220,true,3010923587,28,3005208549,-5715038
1647973903,196220,true,3010923587,28,3005208549,-5715038
1647976102,196220,true,3010923587,28,3001904803,-9018784
1647976488,196219,true,3011224680,28,3002204993,-9019687
1647976526,196219,true,3011224680,28,3002204993,-9019687
1647976676,196218,true,3011525802,28,3002505214,-9020588
1647978561,196218,true,3011525802,28,3005509070,-6016732
1647978916,196218,true,3011525802,28,3005509070,-6016732
1647978957,196218,true,3011525802,28,3005509070,-6016732
1647978977,196218,true,3011525802,28,3005509070,-6016732
1647980250,196219,true,3011224680,28,2997405546,-13819134
1647980282,196219,true,3011224680,28,2997405546,-13819134
1647980400,196219,true,3011224680,28,2996806154,-14418526
1647980515,196219,true,3011224680,28,2996206883,-15017797
1647980631,196220,true,3010923587,28,2995607732,-15315855
1647980650,196220,true,3010923587,28,2995607732,-15315855
1647980791,196220,true,3010923587,28,2995308201,-15615386
1647981858,196220,true,3010923587,28,2998604688,-12318899
1647983147,196222,true,3010321493,28,2999504359,-10817134
1647983738,196222,true,3010321493,28,2999504359,-10817134
1647983979,196222,true,3010321493,28,2999804309,-10517184
1647984549,196223,true,3010020491,28,3000104290,-9916201
1647984746,196224,true,3009719519,28,3000704341,-9015178
1647985375,196224,true,3009719519,28,3002204993,-7514526
1647985418,196224,true,3009719519,28,3002505214,-7214305
1647985878,196223,true,3010020491,28,3003706396,-6314095
1647985933,196224,true,3009719519,28,3003706396,-6013123
1647986104,196224,true,3009719519,28,3004307167,-5412352
1647986334,196224,true,3009719519,28,3005509070,-4210449
1647986746,196223,true,3010020491,28,3009719519,-300972
1647986790,196224,true,3009719519,28,3010020491,300972
1647986796,196223,true,3010020491,28,3010020491,0
1647986865,196223,true,3010020491,28,3010923587,903096
1647986879,196221,true,3010622525,28,3010923587,301062
1647986894,196222,true,3010321493,28,3011224680,903187
1647986897,196222,true,3010321493,28,3011224680,903187
1647986950,196221,true,3010622525,28,3011525802,903277
1647987121,196220,true,3010923587,28,3013031866,2108279
1647987172,196221,true,3010622525,28,3013333170,2710645
1647987220,196221,true,3010622525,28,3013634503,3011978
1647987243,196221,true,3010622525,28,3013634503,3011978
1647987268,196220,true,3010923587,28,3013935866,3012279
1647987341,196221,true,3010622525,28,3014237260,3614735
1647987386,196222,true,3010321493,28,3014237260,3915767
1647988611,196222,true,3010321493,28,3012429350,2107857
1647988648,196221,true,3010622525,28,3012128138,1505613
1647988861,196223,true,3010020491,28,3010923587,903096
1647988903,196223,true,3010020491,28,3010622525,602034
1647989136,196223,true,3010020491,28,3009418577,-601914
1647990201,196223,true,3010020491,28,3006410813,-3609678
1647990211,196224,true,3009719519,28,3006410813,-3308706
1647990809,196225,true,3009418577,28,3004006766,-5411811
1647991078,196225,true,3009418577,28,3003406055,-6012522
1647991559,196224,true,3009719519,28,3002805464,-6914055
1647991618,196226,true,3009117665,28,3002505214,-6612451
1647991643,196226,true,3009117665,28,3002505214,-6612451
1647991658,196226,true,3009117665,28,3002204993,-6912672
1647991699,196226,true,3009117665,28,3002204993,-6912672
1647991799,196228,true,3008515932,28,3001604642,-6911290
1647991872,196229,true,3008215111,28,3000404300,-7810811
1647991944,196230,true,3007914319,28,2999204439,-8709880
1647992458,196230,true,3007914319,28,2991117913,-16796406
1647992803,196233,true,3007012125,28,2984843469,-22168656
1647993088,196233,true,3007012125,28,2979475852,-27536273
1647994448,196234,true,3006711454,28,2968769557,-37941897
1647994498,196235,true,3006410813,28,2968769557,-37641256
1647994561,196238,true,3005509070,28,2968769557,-36739513
1647994569,196238,true,3005509070,28,2968769557,-36739513
1647996783,196239,true,3005208549,28,2971145404,-34063145
1647997364,196240,true,3004908059,28,2971145404,-33762655
1647997406,196242,true,3004307167,28,2971145404,-33161763
1647997436,196243,true,3004006766,28,2971145404,-32861362
1647997437,196244,true,3003706396,28,2971145404,-32560992
1647997451,196245,true,3003406055,28,2970848319,-32557736
1647997456,196247,true,3002805464,28,2970848319,-31957145
1647997483,196249,true,3002204993,28,2970848319,-31356674
1647997538,196250,true,3001904803,28,2969957243,-31947560
1647997546,196251,true,3001604642,28,2969957243,-31647399
1647997557,196254,true,3000704341,28,2969660277,-31044064
1647997567,196255,true,3000404300,28,2969660277,-30744023
1647998120,196257,true,2999804309,28,2961061167,-38743142
1647998557,196259,true,2999204439,28,2954258892,-44945547
1647999020,196262,true,2998304857,28,2947177525,-51127332
1647999265,196264,true,2997705286,28,2943643210,-54062076
1647999369,196265,true,2997405546,28,2943348875,-54056671
1647999801,196268,true,2996506504,28,2943348875,-53157629
1647999832,196271,true,2995607732,28,2943643210,-51964522
1648000140,196273,true,2995008700,28,2944231968,-50776732
1648000412,196275,true,2994409788,28,2945115326,-49294462
1648000450,196277,true,2993810996,28,2945115326,-48695670
1648000505,196279,true,2993212323,28,2945409838,-47802485
1648000584,196281,true,2992613771,28,2945409838,-47203933
1648000631,196283,true,2992015338,28,2945704379,-46310959
1648000651,196285,true,2991417024,28,2945704379,-45712645
1648001048,196287,true,2990818831,28,2947472243,-43346588
1648001161,196289,true,2990220757,28,2948061767,-42158990
1648001537,196290,true,2989921765,28,2950126030,-39795735
1648001603,196292,true,2989323870,28,2950421042,-38902828
1648001751,196294,true,2988726095,28,2951011156,-37714939
1648001765,196296,true,2988128439,28,2951306257,-36822182
1648001775,196297,true,2987829656,28,2951306257,-36523399
1648001854,196299,true,2987232180,28,2951601388,-35630792
1648001894,196301,true,2986634823,28,2951896548,-34738275
1648001956,196302,true,2986336189,28,2952486957,-33849232
1648001994,196303,true,2986037586,28,2952782205,-33255381
1648002004,196305,true,2985440468,28,2952782205,-32658263
1648002020,196306,true,2985141954,28,2952782205,-32359749
1648002028,196308,true,2984545015,28,2953077483,-31467532
1648002101,196308,true,2984545015,28,2953963495,-30581520
1648002198,196309,true,2984246590,28,2955145258,-29101332
1648002202,196311,true,2983649830,28,2955145258,-28504572
1648002245,196312,true,2983351495,28,2955736317,-27615178
1648002258,196312,true,2983351495,28,2955736317,-27615178
1648002276,196313,true,2983053190,28,2956031890,-27021300
1648002461,196313,true,2983053190,28,2959285152,-23768038
1648002502,196315,true,2982456669,28,2959877038,-22579631
1648002534,196315,true,2982456669,28,2960469043,-21987626
1648002986,196315,true,2982456669,28,2968472710,-13983959
1648003017,196316,true,2982158453,28,2969066434,-13092019
1648004193,196317,true,2981860267,28,2984246590,2386323
1648004657,196317,true,2981860267,28,2984545015,2684748
1648004862,196318,true,2981562111,28,2984246590,2684479
1648004885,196318,true,2981562111,28,2984246590,2684479
1648005115,196319,true,2981263984,28,2983351495,2087511
1648006228,196319,true,2981263984,28,2978582188,-2681796
1648006260,196320,true,2980965888,28,2978284359,-2681529
1648006299,196320,true,2980965888,28,2977986561,-2979327
1648006365,196321,true,2980667821,28,2977688792,-2979029
1648006385,196322,true,2980369784,28,2977391053,-2978731
1648007449,196323,true,2980071777,28,2973820505,-6251272
1648007580,196323,true,2980071777,28,2973225830,-6845947
1648007627,196325,true,2979475852,28,2972928537,-6547315
1648007737,196326,true,2979177934,28,2972036837,-7141097
1648007768,196327,true,2978880046,28,2971739663,-7140383
1648007788,196328,true,2978582188,28,2971739663,-6842525
1648007820,196329,true,2978284359,28,2971442518,-6841841
1648007864,196331,true,2977688792,28,2970848319,-6840473
1648008846,196333,true,2977093343,28,2962245769,-14847574
1648008877,196333,true,2977093343,28,2961949574,-15143769
1648008898,196335,true,2976498014,28,2961653408,-14844606
1648009004,196337,true,2975902804,28,2960765090,-15137714
1648009017,196340,true,2975010211,28,2960469043,-14541168
1648009032,196341,true,2974712740,28,2960469043,-14243697
1648009047,196343,true,2974117887,28,2960173026,-13944861
1648009140,196346,true,2973225830,28,2958693383,-14532447
1648009340,196350,true,2972036837,28,2955736317,-16300520
1648009636,196350,true,2972036837,28,2952191737,-19845100
1648009650,196353,true,2971145404,28,2951896548,-19248856
1648009654,196355,true,2970551264,28,2951896548,-18654716
1648009663,196359,true,2969363340,28,2951896548,-17466792
1648009853,196360,true,2969066434,28,2949536093,-19530341
1648010437,196363,true,2968175892,28,2941583484,-26592408
1648011194,196366,true,2967285617,28,2934239077,-33046540
1648012103,196369,true,2966395610,28,2933652317,-32743293
1648012758,196370,true,2966099000,28,2934239077,-31859923
1648012905,196372,true,2965505869,28,2934239077,-31266792
1648012930,196375,true,2964616395,28,2934239077,-30377318
1648013139,196378,true,2963727188,28,2934532501,-29194687
1648013599,196379,true,2963430845,28,2934532501,-28898344
1648013723,196381,true,2962838248,28,2934532501,-28305747
1648013741,196384,true,2961949574,28,2934532501,-27417073
1648013787,196387,true,2961061167,28,2934532501,-26528666
1648013815,196388,true,2960765090,28,2934532501,-26232589
1648013844,196389,true,2960469043,28,2934825954,-25643089
1648013898,196391,true,2959877038,28,2934825954,-25051084
1648014760,196394,true,2958989253,28,2938937382,-20051871
1648015068,196395,true,2958693383,28,2940407145,-18286238
1648015079,196396,true,2958397544,28,2940407145,-17990399
1648015205,196398,true,2957805953,28,2940995255,-16810698
1648015663,196400,true,2957214480,28,2943348875,-13865605
1648016588,196400,true,2957214480,28,2946293549,-10920931
1648016868,196402,true,2956623126,28,2947472243,-9150883
1648016917,196403,true,2956327493,28,2947472243,-8855250
1648016957,196404,true,2956031890,28,2947766990,-8264900
1648017211,196403,true,2956327493,28,2948651409,-7676084
1648017250,196404,true,2956031890,28,2948946274,-7085616
1648017253,196405,true,2955736317,28,2948946274,-6790043
1648017544,196406,true,2955440772,28,2950126030,-5314742
1648017629,196405,true,2955736317,28,2950126030,-5610287
1648017822,196406,true,2955440772,28,2951011156,-4429616
1648019170,196407,true,2955145258,28,2955145258,0
1648019529,196408,true,2954849773,28,2955145258,295485
1648021861,196407,true,2955145258,28,2952782205,-2363053
1648021867,196408,true,2954849773,28,2952782205,-2067568
1648022388,196409,true,2954554318,28,2952782205,-1772113
1648022637,196409,true,2954554318,28,2952782205,-1772113
1648022869,196408,true,2954849773,28,2952782205,-2067568
1648022905,196408,true,2954849773,28,2952782205,-2067568
1648023470,196409,true,2954554318,28,2951896548,-2657770
1648023501,196409,true,2954554318,28,2951896548,-2657770
1648023531,196408,true,2954849773,28,2951896548,-2953225
1648023533,196408,true,2954849773,28,2951896548,-2953225
1648023647,196409,true,2954554318,28,2951306257,-3248061
1648023994,196409,true,2954554318,28,2949831046,-4723272
1648024356,196408,true,2954849773,28,2948651409,-6198364
1648024576,196408,true,2954849773,28,2947766990,-7082783
1648024671,196409,true,2954554318,28,2947472243,-7082075
1648024790,196408,true,2954849773,28,2947472243,-7377530
1648025056,196407,true,2955145258,28,2947177525,-7967733
1648025065,196407,true,2955145258,28,2947177525,-7967733
1648025074,196409,true,2954554318,28,2947177525,-7376793
1648025614,196408,true,2954849773,28,2947766990,-7082783
1648025621,196407,true,2955145258,28,2947766990,-7378268
1648025669,196407,true,2955145258,28,2948061767,-7083491
1648025718,196408,true,2954849773,28,2948356573,-6493200
1648026261,196408,true,2954849773,28,2950421042,-4428731
1648026381,196407,true,2955145258,28,2950716084,-4429174
1648027692,196407,true,2955145258,28,2954554318,-590940
1648028425,196408,true,2954849773,28,2956623126,1773353
1648028615,196407,true,2955145258,28,2957214480,2069222
1648028713,196407,true,2955145258,28,2957510202,2364944
1648030133,196406,true,2955440772,28,2957214480,1773708
1648030927,196408,true,2954849773,28,2956623126,1773353
1648030991,196407,true,2955145258,28,2956918788,1773530
1648031050,196407,true,2955145258,28,2957214480,2069222
1648031139,196407,true,2955145258,28,2957214480,2069222
1648031313,196408,true,2954849773,28,2957805953,2956180
1648034465,196407,true,2955145258,28,2964319963,9174705
1648034488,196406,true,2955440772,28,2964319963,8879191
1648034509,196406,true,2955440772,28,2964319963,8879191
1648035649,196408,true,2954849773,28,2962245769,7395996
1648035666,196408,true,2954849773,28,2962245769,7395996
1648035671,196408,true,2954849773,28,2962245769,7395996
1648035684,196407,true,2955145258,28,2961949574,6804316
1648035776,196410,true,2954258892,28,2961653408,7394516
1648035851,196410,true,2954258892,28,2961357273,7098381
1648035866,196410,true,2954258892,28,2961357273,7098381
1648035874,196410,true,2954258892,28,2961357273,7098381
1648035891,196413,true,2953372791,28,2961061167,7688376
1648036235,196413,true,2953372791,28,2959285152,5912361
1648037796,196414,true,2953077483,28,2954258892,1181409
1648037841,196414,true,2953077483,28,2953963495,886012
1648037907,196416,true,2952486957,28,2953963495,1476538
1648038002,196417,true,2952191737,28,2953963495,1771758
1648038099,196418,true,2951896548,28,2953668128,1771580
1648038105,196417,true,2952191737,28,2953668128,1476391
1648038152,196419,true,2951601388,28,2953668128,2066740
1648038984,196420,true,2951306257,28,2951306257,0
1648039237,196421,true,2951011156,28,2950716084,-295072
1648039292,196421,true,2951011156,28,2950421042,-590114
1648039443,196422,true,2950716084,28,2950126030,-590054
1648039492,196423,true,2950421042,28,2949831046,-589996
1648039520,196424,true,2950126030,28,2949831046,-294984
1648039549,196423,true,2950421042,28,2949831046,-589996
1648039569,196424,true,2950126030,28,2950126030,0
1648039635,196424,true,2950126030,28,2950126030,0
1648040364,196424,true,2950126030,28,2953963495,3837465
1648040475,196424,true,2950126030,28,2954554318,4428288
1648040614,196424,true,2950126030,28,2955440772,5314742
1648040837,196424,true,2950126030,28,2956918788,6792758
1648040885,196424,true,2950126030,28,2957510202,7384172
1648043516,196423,true,2950421042,28,2961061167,10640125
1648043765,196424,true,2950126030,28,2961061167,10935137
1648044401,196423,true,2950421042,28,2960765090,10344048
1648044420,196423,true,2950421042,28,2960765090,10344048
1648044475,196422,true,2950716084,28,2960765090,10049006
1648044497,196422,true,2950716084,28,2960765090,10049006
1648044534,196420,true,2951306257,28,2961061167,9754910
1648044916,196419,true,2951601388,28,2963727188,12125800
1648044977,196419,true,2951601388,28,2964023561,12422173
1648044986,196418,true,2951896548,28,2964319963,12423415
1648045090,196416,true,2952486957,28,2965209348,12722391
1648045164,196414,true,2953077483,28,2965802419,12724936
1648045457,196413,true,2953372791,28,2968769557,15396766
1648046045,196413,true,2953372791,28,2975010211,21637420
1648046056,196411,true,2953963495,28,2975307712,21344217
1648046067,196409,true,2954554318,28,2975307712,20753394
1648046081,196408,true,2954849773,28,2975605243,20755470
1648046163,196407,true,2955145258,28,2976795664,21650406
1648046626,196404,true,2956031890,28,2981562111,25530221
1648047182,196402,true,2956623126,28,2985141954,28518828
1648047245,196401,true,2956918788,28,2985440468,28521680
1648047402,196400,true,2957214480,28,2986336189,29121709
1648047527,196398,true,2957805953,28,2987232180,29426227
1648047586,196395,true,2958693383,28,2987829656,29136273
1648047628,196394,true,2958989253,28,2988128439,29139186
1648047669,196393,true,2959285152,28,2988427252,29142100
1648047688,196391,true,2959877038,28,2988726095,28849057
1648047695,196389,true,2960469043,28,2988726095,28257052
1648047718,196387,true,2961061167,28,2989024967,27963800
1648047758,196386,true,2961357273,28,2989622802,28265529
1648047788,196384,true,2961949574,28,2990220757,28271183
1648048237,196382,true,2962541993,28,2994709229,32167236
1648049374,196380,true,2963134531,28,3004908059,41773528
1648049637,196379,true,2963430845,28,3005809621,42378776
1648049770,196377,true,2964023561,28,3005809621,41786060
1648049781,196375,true,2964616395,28,3005809621,41193226
1648049803,196374,true,2964912857,28,3005809621,40896764
1648049926,196372,true,2965505869,28,3006711454,41205585
1648050045,196369,true,2966395610,28,3007613558,41217948
1648050110,196367,true,2966988918,28,3008215111,41226193
1648050337,196366,true,2967285617,28,3010622525,43336908
1648050405,196364,true,2967879104,28,3011224680,43345576
1648050425,196361,true,2968769557,28,3011525802,42756245
1648050813,196358,true,2969660277,28,3016951159,47290882
1648051288,196357,true,2969957243,28,3023595425,53638182
1648051304,196355,true,2970551264,28,3023897785,53346521
1648051311,196352,true,2971442518,28,3023897785,52455267
1648051449,196349,true,2972334040,28,3026317750,53983710
1648051520,196347,true,2972928537,28,3027528458,54599921
1648051547,196344,true,2973820505,28,3028133994,54313489
1648051552,196341,true,2974712740,28,3028133994,53421254
1648051597,196339,true,2975307712,28,3028739652,53431940
1648051863,196337,true,2975902804,28,3030557350,54654546
1648052188,196335,true,2976498014,28,3031163491,54665477
1648052344,196331,true,2977688792,28,3030860405,53171613
1648053301,196329,true,2978284359,28,3028133994,49849635
1648053890,196327,true,2978880046,28,3026015148,47135102
1648053898,196325,true,2979475852,28,3026015148,46539296
1648054066,196322,true,2980369784,28,3024805045,44435261
1648055734,196321,true,2980667821,28,3015744680,35076859
1648056109,196319,true,2981263984,28,3015141622,33877638
1648056204,196317,true,2981860267,28,3014840137,32979870
1648056343,196314,true,2982754914,28,3014237260,31482346
1648056944,196313,true,2983053190,28,3010923587,27870397
1648057202,196313,true,2983053190,28,3009117665,26064475
1648057307,196310,true,2983948195,28,3008215111,24266916
1648057399,196308,true,2984545015,28,3007312827,22767812
1648057438,196308,true,2984545015,28,3006711454,22166439
1648057643,196307,true,2984843469,28,3004607598,19764129
1648057689,196306,true,2985141954,28,3004307167,19165213
1648057695,196304,true,2985739012,28,3004006766,18267754
1648057713,196303,true,2986037586,28,3004006766,17969180
1648057723,196303,true,2986037586,28,3003706396,17668810
1648057734,196302,true,2986336189,28,3003706396,17370207
1648057806,196300,true,2986933487,28,3002204993,15271506
1648057812,196300,true,2986933487,28,3002204993,15271506
1648057841,196301,true,2986634823,28,3001604642,14969819
1648058020,196300,true,2986933487,28,2998304857,11371370
1648058108,196299,true,2987232180,28,2996506504,9274324
1648058294,196299,true,2987232180,28,2992913032,5680852
1648058391,196299,true,2987232180,28,2990818831,3586651
1648058455,196299,true,2987232180,28,2989622802,2390622
1648059482,196298,true,2987530903,28,2969363340,-18167563
1648059506,196298,true,2987530903,28,2969066434,-18464469
1648060378,196299,true,2987232180,28,2966099000,-21133180
1648061072,196298,true,2987530903,28,2966692249,-20838654
1648061966,196297,true,2987829656,28,2966988918,-20840738
1648062008,196297,true,2987829656,28,2966988918,-20840738
1648062283,196298,true,2987530903,28,2966395610,-21135293
1648062688,196297,true,2987829656,28,2964319963,-23509693
1648063360,196297,true,2987829656,28,2960765090,-27064566
1648063457,196297,true,2987829656,28,2960173026,-27656630
1648063473,196297,true,2987829656,28,2960173026,-27656630
1648063567,196296,true,2988128439,28,2959877038,-28251401
1648063944,196295,true,2988427252,28,2959877038,-28550214
1648063953,196295,true,2988427252,28,2959877038,-28550214
1648066227,196295,true,2988427252,28,2966988918,-21438334
1648066382,196294,true,2988726095,28,2967285617,-21440478
1648066804,196293,true,2989024967,28,2968175892,-20849075
1648067054,196293,true,2989024967,28,2968472710,-20552257
1648067244,196293,true,2989024967,28,2968769557,-20255410
1648067320,196292,true,2989323870,28,2969066434,-20257436
1648067374,196291,true,2989622802,28,2969363340,-20259462
1648068225,196290,true,2989921765,28,2973523152,-16398613
1648068282,196290,true,2989921765,28,2973523152,-16398613
1648068336,196289,true,2990220757,28,2973820505,-16400252
1648068458,196288,true,2990519779,28,2974415298,-16104481
1648070309,196287,true,2990818831,28,2979475852,-11342979
1648071170,196287,true,2990818831,28,2979773799,-11045032
1648071584,196287,true,2990818831,28,2980071777,-10747054
1648071695,196286,true,2991117913,28,2980071777,-11046136
1648071730,196285,true,2991417024,28,2980071777,-11345247
1648071934,196285,true,2991417024,28,2980667821,-10749203
1648072133,196284,true,2991716166,28,2981562111,-10154055
1648072161,196283,true,2992015338,28,2981860267,-10155071
1648072208,196282,true,2992314539,28,2981860267,-10454272
1648072211,196282,true,2992314539,28,2981860267,-10454272
1648072215,196281,true,2992613771,28,2981860267,-10753504
1648072222,196280,true,2992913032,28,2982158453,-10754579
1648072242,196280,true,2992913032,28,2982158453,-10754579
1648072243,196279,true,2993212323,28,2982158453,-11053870
1648072257,196278,true,2993511645,28,2982158453,-11353192
1648072282,196278,true,2993511645,28,2982456669,-11054976
1648072731,196278,true,2993511645,28,2986037586,-7474059
1648073740,196277,true,2993810996,28,2994110377,299381
1648073772,196276,true,2994110377,28,2994110377,0
1648073797,196276,true,2994110377,28,2994409788,299411
1648073829,196276,true,2994110377,28,2994709229,598852
1648073999,196275,true,2994409788,28,2995907292,1497504
1648074125,196274,true,2994709229,28,2996806154,2096925
1648074132,196274,true,2994709229,28,2996806154,2096925
1648074699,196274,true,2994709229,28,3000104290,5395061
1648074702,196273,true,2995008700,28,3000104290,5095590
1648074841,196272,true,2995308201,28,3001004411,5696210
1648076553,196272,true,2995308201,28,3008816784,13508583
1648077272,196272,true,2995308201,28,3008816784,13508583
1648077390,196271,true,2995607732,28,3008816784,13209052
1648077396,196271,true,2995607732,28,3008816784,13209052
1648078029,196271,true,2995607732,28,3007312827,11705095
1648078130,196271,true,2995607732,28,3007012125,11404393
1648078178,196270,true,2995907292,28,3007012125,11104833
1648079071,196270,true,2995907292,28,3007914319,12007027
1648079105,196270,true,2995907292,28,3007914319,12007027
1648079188,196270,true,2995907292,28,3008215111,12307819
1648079280,196270,true,2995907292,28,3009117665,13210373
1648079347,196269,true,2996206883,28,3009719519,13512636
1648079414,196268,true,2996506504,28,3010622525,14116021
1648079544,196268,true,2996506504,28,3012128138,15621634
1648079576,196268,true,2996506504,28,3012429350,15922846
1648079859,196267,true,2996806154,28,3016347859,19541705
1648080059,196267,true,2996806154,28,3018761782,21955628
1648080173,196267,true,2996806154,28,3019969468,23163314
1648080542,196266,true,2997105835,28,3025107525,28001690
1648080591,196265,true,2997405546,28,3025712577,28307031
1648080743,196265,true,2997405546,28,3028133994,30728448
1648080801,196266,true,2997105835,28,3029042526,31936691
1648080911,196264,true,2997705286,28,3032376139,34670853
1648081109,196262,true,2998304857,28,3038142842,39837985
1648081283,196261,true,2998604688,28,3042703247,44098559
1648081474,196261,true,2998604688,28,3047270499,48665811
1648081753,196261,true,2998604688,28,3053065526,54460838
1648081792,196259,true,2999204439,28,3053981538,54777099
1648081861,196258,true,2999504359,28,3055203313,55698954
1648081867,196258,true,2999504359,28,3055203313,55698954
1648082536,196258,true,2999504359,28,3061319528,61815169
1648082544,196256,true,3000104290,28,3061319528,61215238
1648082644,196255,true,3000404300,28,3061625660,61221360
1648083642,196254,true,3000704341,28,3056425578,55721237
1648083695,196254,true,3000704341,28,3056425578,55721237
1648083725,196252,true,3001304512,28,3056731221,55426709
1648083786,196251,true,3001604642,28,3056731221,55126579
1648083855,196250,true,3001904803,28,3056731221,54826418
1648083933,196250,true,3001904803,28,3056731221,54826418
1648083939,196247,true,3002805464,28,3056731221,53925757
1648084124,196247,true,3002805464,28,3055814385,53008921
1648084578,196246,true,3003105745,28,3052149790,49044045
1648084938,196245,true,3003406055,28,3048489590,45083535
1648084952,196243,true,3004006766,28,3048489590,44482824
1648085101,196243,true,3004006766,28,3046356500,42349734
1648085284,196242,true,3004307167,28,3043616150,39308983
1648085765,196241,true,3004607598,28,3037231581,32623983
1648085796,196239,true,3005208549,28,3036927888,31719339
1648085839,196239,true,3005208549,28,3036624226,31415677
1648085882,196237,true,3005809621,28,3036016992,30207371
1648086958,196237,true,3005809621,28,3026015148,20205527
1648087000,196235,true,3006410813,28,3025712577,19301764
1648087687,196234,true,3006711454,28,3023595425,16883971
1648088043,196233,true,3007012125,28,3023595425,16583300
1648088460,196232,true,3007312827,28,3023897785,16584958
1648088492,196229,true,3008215111,28,3023897785,15682674
1648088499,196228,true,3008515932,28,3023897785,15381853
1648088513,196227,true,3008816784,28,3023897785,15081001
1648088554,196227,true,3008816784,28,3023897785,15081001
1648088651,196224,true,3009719519,28,3023293096,13573577
1648088935,196222,true,3010321493,28,3022084081,11762588
1648089268,196221,true,3010622525,28,3020271465,9648940
1648090135,196221,true,3010622525,28,3016951159,6328634
1648090206,196218,true,3011525802,28,3016649494,5123692
1648090329,196216,true,3012128138,28,3016649494,4521356
1648090376,196215,true,3012429350,28,3016649494,4220144
1648090559,196214,true,3012730593,28,3017554579,4823986
1648090724,196211,true,3013634503,28,3018761782,5127279
1648090863,196208,true,3014538684,28,3019667501,5128817
1648090968,196207,true,3014840137,28,3020573492,5733355
1648091822,196206,true,3015141622,28,3027528458,12386836
1648092080,196202,true,3016347859,28,3029345430,12997571
1648092157,196200,true,3016951159,28,3029951329,13000170
1648092306,196198,true,3017554579,28,3031163491,13608912
1648093470,196197,true,3017856335,28,3035409880,17553545
1648093740,196194,true,3018761782,28,3036016992,17255210
1648093748,196192,true,3019365565,28,3036016992,16651427
1648093907,196190,true,3019969468,28,3036320594,16351126
1648093972,196190,true,3019969468,28,3036320594,16351126
1648094086,196186,true,3021177637,28,3036016992,14839355
1648094100,196185,true,3021479755,28,3036016992,14537237
1648094113,196183,true,3022084081,28,3036016992,13932911
1648094132,196183,true,3022084081,28,3035713421,13629340
1648094202,196180,true,3022990797,28,3035409880,12419083
1648094207,196178,true,3023595425,28,3035409880,11814455
1648094375,196178,true,3023595425,28,3034802889,11207464
1648095641,196177,true,3023897785,28,3028739652,4841867
1648096194,196174,true,3024805045,28,3027528458,2723413
1648096895,196173,true,3025107525,28,3027528458,2420933
1648097450,196172,true,3025410036,28,3027528458,2118422
1648097817,196172,true,3025410036,28,3027528458,2118422
1648099010,196169,true,3026317750,28,3026923044,605294
1648099520,196168,true,3026620382,28,3026923044,302662
1648100324,196167,true,3026923044,28,3026923044,0
1648100340,196167,true,3026923044,28,3027225736,302692
1648100680,196165,true,3027528458,28,3027225736,-302722
1648100719,196163,true,3028133994,28,3027225736,-908258
1648100741,196163,true,3028133994,28,3027225736,-908258
1648100881,196163,true,3028133994,28,3027831211,-302783
1648100895,196160,true,3029042526,28,3027831211,-1211315
1648101129,196158,true,3029648364,28,3029345430,-302934
1648101165,196158,true,3029648364,28,3029648364,0
1648101224,196157,true,3029951329,28,3029951329,0
1648101232,196155,true,3030557350,28,3029951329,-606021
1648101266,196153,true,3031163491,28,3030254324,-909167
1648101378,196152,true,3031466608,28,3031163491,-303117
1648101675,196153,true,3031163491,28,3033589271,2425780
1648102093,196150,true,3032072931,28,3037231581,5158650
1648102662,196148,true,3032679376,28,3043311818,10632442
1648103252,196147,true,3032982644,28,3046965802,13983158
1648103295,196148,true,3032679376,28,3047270499,14591123
1648103617,196144,true,3033892630,28,3050929235,17036605
1648103665,196142,true,3034499439,28,3051234328,16734889
1648103672,196141,true,3034802889,28,3051234328,16431439
1648103812,196142,true,3034499439,28,3052149790,17650351
1648106032,196139,true,3035409880,28,3052455005,17045125
1648106312,196137,true,3036016992,28,3051844605,15827613
1648107824,196136,true,3036320594,28,3045138262,8817668
1648107997,196136,true,3036320594,28,3044833779,8513185
1648108183,196135,true,3036624226,28,3045138262,8514036
1648108583,196133,true,3037231581,28,3046356500,9124919
1648108591,196132,true,3037535304,28,3046356500,8821196
1648108673,196132,true,3037535304,28,3046661136,9125832
1648108679,196131,true,3037839058,28,3046661136,8822078
1648108805,196129,true,3038446656,28,3046965802,8519146
1648108912,196129,true,3038446656,28,3047270499,8823843
1648108958,196129,true,3038446656,28,3047270499,8823843
1648109008,196129,true,3038446656,28,3047270499,8823843
1648109155,196127,true,3039054376,28,3047270499,8216123
1648109222,196127,true,3039054376,28,3047270499,8216123
1648110106,196128,true,3038750501,28,3046051895,7301394
1648110521,196127,true,3039054376,28,3044833779,5779403
1648110847,196126,true,3039358281,28,3044224903,4866622
1648111470,196126,true,3039358281,28,3043920511,4562230
1648112213,196128,true,3038750501,28,3044833779,6083278
1648112552,196129,true,3038446656,28,3045442776,6996120
1648113836,196129,true,3038446656,28,3046965802,8519146
1648113859,196129,true,3038446656,28,3046965802,8519146
1648113886,196131,true,3037839058,28,3046965802,9126744
1648113892,196131,true,3037839058,28,3046965802,9126744
1648113957,196131,true,3037839058,28,3047270499,9431441
1648113960,196130,true,3038142842,28,3047270499,9127657
1648114137,196130,true,3038142842,28,3048184771,10041929
1648114435,196131,true,3037839058,28,3049404228,11565170
1648114497,196130,true,3038142842,28,3049709168,11566326
1648114901,196130,true,3038142842,28,3051844605,13701763
1648114953,196131,true,3037839058,28,3051844605,14005547
1648115128,196132,true,3037535304,28,3052760250,15224946
1648115357,196131,true,3037839058,28,3053981538,16142480
1648115368,196130,true,3038142842,28,3053981538,15838696
1648115491,196131,true,3037839058,28,3054286936,16447878
1648115621,196131,true,3037839058,28,3054592364,16753306
1648115744,196130,true,3038142842,28,3054592364,16449522
1648116360,196129,true,3038446656,28,3053370833,14924177
1648118733,196130,true,3038142842,28,3050014139,11871297
1648118804,196130,true,3038142842,28,3050319141,12176299
1648118876,196129,true,3038446656,28,3050319141,11872485
1648118943,196128,true,3038750501,28,3050319141,11568640
1648118999,196127,true,3039054376,28,3050624173,11569797
1648119205,196128,true,3038750501,28,3050929235,12178734
1648120053,196126,true,3039358281,28,3053065526,13707245
1648121304,196125,true,3039662217,28,3054286936,14624719
1648121542,196124,true,3039966183,28,3054286936,14320753
1648122597,196124,true,3039966183,28,3054286936,14320753
1648124048,196123,true,3040270180,28,3054286936,14016756
1648124357,196121,true,3040878264,28,3054286936,13408672
1648124514,196120,true,3041182352,28,3054286936,13104584
1648124526,196121,true,3040878264,28,3054286936,13408672
1648124537,196119,true,3041486470,28,3054286936,12800466
1648124681,196118,true,3041790619,28,3054286936,12496317
1648124951,196116,true,3042399008,28,3053676170,11277162
1648124970,196116,true,3042399008,28,3053676170,11277162
1648124989,196115,true,3042703247,28,3053676170,10972923
1648125029,196114,true,3043007518,28,3053370833,10363315
1648125195,196113,true,3043311818,28,3052760250,9448432
1648125353,196113,true,3043311818,28,3052149790,8837972
1648125424,196111,true,3043920511,28,3051844605,7924094
1648125457,196110,true,3044224903,28,3051844605,7619702
1648125519,196110,true,3044224903,28,3051539451,7314548
1648125555,196110,true,3044224903,28,3051234328,7009425
1648125576,196109,true,3044529326,28,3050929235,6399909
1648125613,196108,true,3044833779,28,3050624173,5790394
1648125636,196108,true,3044833779,28,3050624173,5790394
1648125661,196109,true,3044529326,28,3050319141,5789815
1648125800,196109,true,3044529326,28,3048489590,3960264
1648125883,196108,true,3044833779,28,3047575226,2741447
1648126044,196109,true,3044529326,28,3045138262,608936
1648126055,196110,true,3044224903,28,3045138262,913359
1648126110,196109,true,3044529326,28,3044224903,-304423
1648126170,196109,true,3044529326,28,3043311818,-1217508
1648126441,196110,true,3044224903,28,3039358281,-4866622
1648126454,196111,true,3043920511,28,3039054376,-4866135
1648126502,196110,true,3044224903,28,3038446656,-5778247
1648126513,196110,true,3044224903,28,3038142842,-6082061
1648126538,196111,true,3043920511,28,3037839058,-6081453
1648126560,196112,true,3043616150,28,3037535304,-6080846
1648126632,196111,true,3043920511,28,3036320594,-7599917
1648127707,196111,true,3043920511,28,3022386289,-21534222
1648128092,196112,true,3043616150,28,3020875549,-22740601
1648128420,196112,true,3043616150,28,3020271465,-23344685
1648128574,196112,true,3043616150,28,3019667501,-23948649
1648128672,196112,true,3043616150,28,3019365565,-24250585
1648128688,196113,true,3043311818,28,3019365565,-23946253
1648128877,196114,true,3043007518,28,3018761782,-24245736
1648128887,196114,true,3043007518,28,3018761782,-24245736
1648129268,196114,true,3043007518,28,3017554579,-25452939
1648129299,196114,true,3043007518,28,3017252854,-25754664
1648129324,196115,true,3042703247,28,3017252854,-25450393
1648129634,196115,true,3042703247,28,3017252854,-25450393
1648130141,196115,true,3042703247,28,3017856335,-24846912
1648130223,196115,true,3042703247,28,3017856335,-24846912
1648130461,196117,true,3042094798,28,3019365565,-22729233
1648130590,196116,true,3042399008,28,3020271465,-22127543
1648130655,196116,true,3042399008,28,3020875549,-21523459
1648130708,196117,true,3042094798,28,3021479755,-20615043
1648130729,196118,true,3041790619,28,3021479755,-20310864
1648132526,196118,true,3041790619,28,3031163491,-10627128
1648133153,196117,true,3042094798,28,3031163491,-10931307
1648133195,196118,true,3041790619,28,3031163491,-10627128
1648133237,196119,true,3041486470,28,3032072931,-9413539
1648133266,196119,true,3041486470,28,3032679376,-8807094
1648133288,196116,true,3042399008,28,3032982644,-9416364
1648133596,196116,true,3042399008,28,3039054376,-3344632
1648133912,196117,true,3042094798,28,3045138262,3043464
1648133998,196117,true,3042094798,28,3046661136,4566338
1648134023,196116,true,3042399008,28,3047270499,4871491
1648134070,196115,true,3042703247,28,3048489590,5786343
1648134340,196115,true,3042703247,28,3055508834,12805587
1648134359,196114,true,3043007518,28,3056119966,13112448
1648134401,196112,true,3043616150,28,3057342597,13726447
1648134812,196111,true,3043920511,28,3068982018,25061507
1648134884,196110,true,3044224903,28,3071130950,26906047
1648134957,196110,true,3044224903,28,3073281387,29056484
1648135085,196108,true,3044833779,28,3075740873,30907094
1648135602,196107,true,3045138262,28,3083131146,37992884
1648135864,196106,true,3045442776,28,3086524287,41081511
1648136021,196105,true,3045747320,28,3087450336,41703016
1648136030,196103,true,3046356500,28,3087759081,41402581
1648136059,196101,true,3046965802,28,3088067857,41102055
1648136094,196100,true,3047270499,28,3088376664,41106165
1648136120,196099,true,3047575226,28,3088685502,41110276
1648136147,196096,true,3048489590,28,3089303270,40813680
1648136233,196095,true,3048794439,28,3090230154,41435715
1648136271,196093,true,3049404228,28,3090848230,41444002
1648136352,196092,true,3049709168,28,3092393964,42684796
1648136404,196089,true,3050624173,28,3093012473,42388300
1648136422,196087,true,3051234328,28,3093321775,42087447
1648137029,196085,true,3051844605,28,3104166826,52322221
1648137398,196083,true,3052455005,28,3108826337,56371332
1648137827,196081,true,3053065526,28,3113804192,60738666
1648137906,196079,true,3053676170,28,3114426984,60750814
1648137999,196077,true,3054286936,28,3114738427,60451491
1648138006,196076,true,3054592364,28,3114738427,60146063
1648138944,196074,true,3055203313,28,3111003169,55799856
1648139055,196072,true,3055814385,28,3111003169,55188784
1648139094,196071,true,3056119966,28,3111003169,54883203
1648139120,196070,true,3056425578,28,3111003169,54577591
1648139302,196067,true,3057342597,28,3111625401,54282804
1648139334,196065,true,3057954096,28,3111625401,53671305
1648139371,196064,true,3058259892,28,3111625401,53365509
1648139516,196063,true,3058565718,28,3111003169,52437451
1648141281,196061,true,3059177462,28,3105408679,46231217
1648141295,196059,true,3059789328,28,3105408679,45619351
1648141367,196058,true,3060095307,28,3105408679,45313372
1648141615,196057,true,3060401316,28,3105719220,45317904
1648141660,196055,true,3061013427,28,3105719220,44705793
1648141868,196053,true,3061625660,28,3106029792,44404132
1648142010,196051,true,3062238016,28,3106340395,44102379
1648142019,196050,true,3062544240,28,3106340395,43796155
1648142240,196048,true,3063156779,28,3107272390,44115611
1648142345,196046,true,3063769441,28,3107583118,43813677
1648142432,196044,true,3064382226,28,3107893876,43511650
1648142450,196043,true,3064688664,28,3107893876,43205212
1648142507,196041,true,3065301632,28,3108204665,42903033
1648142606,196039,true,3065914723,28,3108826337,42911614
1648142810,196037,true,3066527937,28,3109759079,43231142
1648144471,196036,true,3066834590,28,3115361405,48526815
1648144601,196034,true,3067447987,28,3115361405,47913418
1648144702,196032,true,3068061508,28,3115361405,47299897
1648144712,196030,true,3068675151,28,3115361405,46686254
1648144727,196029,true,3068982018,28,3115361405,46379387
1648144759,196027,true,3069595845,28,3115361405,45765560
1648144771,196025,true,3070209795,28,3115361405,45151610
1648144776,196023,true,3070823868,28,3115361405,44537537
1648144826,196023,true,3070823868,28,3115049900,44226032
1648145830,196021,true,3071438063,28,3109448134,38010071
1648145890,196018,true,3072359587,28,3109137220,36777633
1648145938,196017,true,3072666823,28,3108515486,35848663
1648146299,196016,true,3072974090,28,3105098170,32124080
1648146318,196015,true,3073281387,28,3105098170,31816783
1648147864,196012,true,3074203464,28,3097655241,23451777
1648148304,196010,true,3074818335,28,3097655241,22836906
1648148660,196010,true,3074818335,28,3097965007,23146672
1648148851,196008,true,3075433329,28,3098274803,22841474
1648148878,196006,true,3076048447,28,3098274803,22226356
1648149287,196003,true,3076971354,28,3099514299,22542945
1648149376,196002,true,3077279051,28,3099824250,22545199
1648149397,196000,true,3077894537,28,3100134233,22239696
1648149715,195997,true,3078817998,28,3102304978,23486980
1648149740,195994,true,3079741736,28,3102615208,22873472
1648150026,195992,true,3080357715,28,3105098170,24740455
1648150125,195990,true,3080973817,28,3105719220,24745403
1648150696,195987,true,3081898202,28,3111003169,29104967
1648151534,195984,true,3082822864,28,3115049900,32227036
1648151721,195982,true,3083439459,28,3115049900,31610441
1648152341,195980,true,3084056178,28,3115361405,31305227
1648152513,195976,true,3085289985,28,3115361405,30071420
1648152557,195973,true,3086215665,28,3115361405,29145740
1648152959,195971,true,3086832939,28,3114738427,27905488
1648153026,195969,true,3087450336,28,3114738427,27288091
1648153682,195965,true,3088685502,28,3113492843,24807341
1648154120,195962,true,3089612200,28,3112558982,22946782
1648154240,195961,true,3089921161,28,3112247757,22326596
1648154257,195958,true,3090848230,28,3112247757,21399527
1648155469,195954,true,3092084755,28,3110381061,18296306
1648155738,195951,true,3093012473,28,3110070054,17057581
1648156223,195949,true,3093631107,28,3109759079,16127972
1648156340,195947,true,3094249864,28,3109759079,15509215
1648156383,195943,true,3095487750,28,3109759079,14271329
1648156416,195940,true,3096416489,28,3109759079,13342590
1648156684,195939,true,3096726130,28,3108826337,12100207
1648158089,195938,true,3097035803,28,3100134233,3098430
1648158174,195934,true,3098274803,28,3099514299,1239496
1648159048,195931,true,3099204379,28,3098894489,-309890
1648159146,195930,true,3099514299,28,3098894489,-619810
1648159165,195929,true,3099824250,28,3098894489,-929761
1648159469,195926,true,3100754291,28,3099514299,-1239992
1648160622,195923,true,3101684610,28,3101684610,0
1648160781,195922,true,3101994778,28,3101994778,0
1648160861,195921,true,3102304978,28,3102304978,0
1648160985,195917,true,3103546086,28,3102615208,-930878
1648161144,195914,true,3104477243,28,3103235763,-1241480
1648161205,195914,true,3104477243,28,3103235763,-1241480
1648161252,195915,true,3104166826,28,3103546086,-620740
1648161282,195912,true,3105098170,28,3103546086,-1552084
1648163284,195909,true,3106029792,28,3111936563,5906771
1648165163,195908,true,3106340395,28,3111936563,5596168
1648165447,195910,true,3105719220,28,3112247757,6528537
1648166788,195907,true,3106651029,28,3112247757,5596728
1648167059,195905,true,3107272390,28,3112247757,4975367
1648167410,195904,true,3107583118,28,3112247757,4664639
1648167435,195906,true,3106961694,28,3111936563,4974869
1648167493,195904,true,3107583118,28,3111936563,4353445
1648167508,195901,true,3108515486,28,3111936563,3421077
1648167779,195901,true,3108515486,28,3111003169,2487683
1648171819,195903,true,3107893876,28,3106651029,-1242847
1648171857,195902,true,3108204665,28,3106961694,-1242971
1648171874,195899,true,3109137220,28,3107272390,-1864830
1648172042,195900,true,3108826337,28,3109759079,932742
1648172072,195898,true,3109448134,28,3110070054,621920
1648172096,195897,true,3109759079,28,3110692100,933021
1648172134,195895,true,3110381061,28,3111003169,622108
1648172174,195896,true,3110070054,28,3111314269,1244215
1648172217,195895,true,3110381061,28,3111936563,1555502
1648172317,195894,true,3110692100,28,3112870237,2178137
1648172708,195892,true,3111314269,28,3117231090,5916821
1648173013,195894,true,3110692100,28,3120661759,9969659
1648173280,195893,true,3111003169,28,3123471478,12468309
1648173827,195893,true,3111003169,28,3126909015,15905846
1648174205,195891,true,3111625401,28,3126283727,14658326
1648174245,195893,true,3111003169,28,3126283727,15280558
1648174328,195892,true,3111314269,28,3126283727,14969458
1648175283,195892,true,3111314269,28,3122534624,11220355
1648175286,195891,true,3111625401,28,3122534624,10909223
1648175293,195892,true,3111314269,28,3122534624,11220355
1648175408,195891,true,3111625401,28,3122222402,10597001
1648175566,195890,true,3111936563,28,3122222402,10285839
1648176669,195889,true,3112247757,28,3123783825,11536068
1648176798,195890,true,3111936563,28,3124096204,12159641
1648176965,195890,true,3111936563,28,3124721054,12784491
1648178463,195889,true,3112247757,28,3125033526,12785769
1648178753,195888,true,3112558982,28,3125033526,12474544
1648179241,195889,true,3112247757,28,3125033526,12785769
1648180385,195888,true,3112558982,28,3125346030,12787048
1648180630,195887,true,3112870237,28,3125346030,12475793
1648180795,195886,true,3113181524,28,3125346030,12164506
1648181065,195887,true,3112870237,28,3125658564,12788327
1648181083,195885,true,3113492843,28,3125971130,12478287
1648181162,195885,true,3113492843,28,3125971130,12478287
1648181173,195883,true,3114115572,28,3125971130,11855558
1648181212,195884,true,3113804192,28,3125971130,12166938
1648181243,195883,true,3114115572,28,3126283727,12168155
1648181367,195882,true,3114426984,28,3126596355,12169371
1648182343,195881,true,3114738427,28,3131289534,16551107
1648182846,195882,true,3114426984,28,3134108822,19681838
1648182910,195881,true,3114738427,28,3134422233,19683806
1648182924,195880,true,3115049900,28,3134422233,19372333
1648183272,195878,true,3115672942,28,3135049149,19376207
1648183910,195879,true,3115361405,28,3135989758,20628353
1648184508,195878,true,3115672942,28,3135989758,20316816
1648185001,195878,true,3115672942,28,3136303357,20630415
1648185286,195876,true,3116296107,28,3136303357,20007250
1648185600,195877,true,3115984509,28,3136616987,20632478
1648185701,195876,true,3116296107,28,3136930649,20634542
1648186357,195875,true,3116607737,28,3137558066,20950329
1648186382,195873,true,3117231090,28,3137558066,20326976
1648187462,195874,true,3116919398,28,3138185609,21266211
1648187873,195872,true,3117542813,28,3138185609,20642796
1648188540,195871,true,3117854567,28,3137558066,19703499
1648189121,195869,true,3118478169,28,3137244342,18766173
1648189448,195870,true,3118166352,28,3136930649,18764297
1648190160,195868,true,3118790017,28,3136616987,17826970
1648190364,195867,true,3119101896,28,3136616987,17515091
1648190630,195865,true,3119725747,28,3136616987,16891240
1648190727,195865,true,3119725747,28,3136616987,16891240
1648190989,195863,true,3120349724,28,3136616987,16267263
1648192013,195862,true,3120661759,28,3136616987,15955228
1648192252,195861,true,3120973825,28,3136930649,15956824
1648192596,195861,true,3120973825,28,3136930649,15956824
1648192621,195859,true,3121598051,28,3136930649,15332598
1648192834,195859,true,3121598051,28,3136930649,15332598
1648192944,195858,true,3121910211,28,3136930649,15020438
1648193294,195858,true,3121910211,28,3137244342,15334131
1648193524,195857,true,3122222402,28,3137558066,15335664
1648193662,195856,true,3122534624,28,3137558066,15023442
1648193964,195855,true,3122846877,28,3137871822,15024945
1648194214,195856,true,3122534624,28,3138185609,15650985
1648194360,195854,true,3123159162,28,3138185609,15026447
1648194610,195853,true,3123471478,28,3138499428,15027950
1648194658,195852,true,3123783825,28,3138499428,14715603
1648194689,195853,true,3123471478,28,3138499428,15027950
1648194709,195851,true,3124096204,28,3138499428,14403224
1648194771,195850,true,3124408613,28,3138499428,14090815
1648195131,195849,true,3124721054,28,3138499428,13778374
1648195215,195850,true,3124408613,28,3138499428,14090815
1648195295,195848,true,3125033526,28,3138185609,13152083
1648195319,195847,true,3125346030,28,3138185609,12839579
1648195365,195846,true,3125658564,28,3138185609,12527045
1648195404,195847,true,3125346030,28,3138185609,12839579
1648195527,195845,true,3125971130,28,3137871822,11900692
1648195544,195845,true,3125971130,28,3137871822,11900692
1648195549,195844,true,3126283727,28,3137871822,11588095
1648195567,195844,true,3126283727,28,3137558066,11274339
1648195568,195842,true,3126909015,28,3137558066,10649051
1648195628,195841,true,3127221706,28,3137244342,10022636
1648195662,195840,true,3127534428,28,3137244342,9709914
1648195681,195841,true,3127221706,28,3136930649,9708943
1648195726,195838,true,3128159966,28,3136616987,8457021
1648195760,195838,true,3128159966,28,3136303357,8143391
1648195785,195837,true,3128472782,28,3136303357,7830575
1648195820,195838,true,3128159966,28,3135989758,7829792
1648195836,195836,true,3128785630,28,3135676190,6890560
1648195943,195836,true,3128785630,28,3134108822,5323192
1648196271,195837,true,3128472782,28,3129098508,625726
1648196504,195838,true,3128159966,28,3125346030,-2813936
1648196545,195836,true,3128785630,28,3124721054,-4064576
1648196717,195836,true,3128785630,28,3121910211,-6875419
1648196731,195837,true,3128472782,28,3121910211,-6562571
1648196737,195838,true,3128159966,28,3121598051,-6561915
1648196757,195836,true,3128785630,28,3121285922,-7499708
1648196807,195836,true,3128785630,28,3120661759,-8123871
1648196913,195837,true,3128472782,28,3119413806,-9058976
1648197020,195837,true,3128472782,28,3118166352,-10306430
1648197188,195835,true,3129098508,28,3116296107,-12802401
1648197191,195836,true,3128785630,28,3116296107,-12489523
1648197229,195836,true,3128785630,28,3115672942,-13112688
1648197319,195837,true,3128472782,28,3115049900,-13422882
1648197845,195834,true,3129411418,28,3113492843,-15918575
1648197857,195835,true,3129098508,28,3113492843,-15605665
1648197874,195835,true,3129098508,28,3113492843,-15605665
1648197890,195836,true,3128785630,28,3113804192,-14981438
1648197910,195836,true,3128785630,28,3113804192,-14981438
1648198022,195836,true,3128785630,28,3114426984,-14358646
1648198149,195837,true,3128472782,28,3115361405,-13111377
1648198622,195837,true,3128472782,28,3118166352,-10306430
1648200332,195837,true,3128472782,28,3121598051,-6874731
1648200339,195837,true,3128472782,28,3121598051,-6874731
1648200873,195837,true,3128472782,28,3121285922,-7186860
1648201141,195837,true,3128472782,28,3121285922,-7186860
1648201219,195837,true,3128472782,28,3121598051,-6874731
1648201254,195837,true,3128472782,28,3121598051,-6874731
1648201275,195838,true,3128159966,28,3121598051,-6561915
1648201299,195838,true,3128159966,28,3121598051,-6561915
1648201324,195837,true,3128472782,28,3121598051,-6874731
1648201420,195837,true,3128472782,28,3122222402,-6250380
1648201573,195837,true,3128472782,28,3122846877,-5625905
1648202054,195837,true,3128472782,28,3124721054,-3751728
1648202213,195836,true,3128785630,28,3125346030,-3439600
1648202491,195836,true,3128785630,28,3126909015,-1876615
1648202548,195836,true,3128785630,28,3127221706,-1563924
1648203755,195835,true,3129098508,28,3134422233,5323725
1648204318,195835,true,3129098508,28,3135989758,6891250
1648204706,195835,true,3129098508,28,3135989758,6891250
1648205040,195835,true,3129098508,28,3135989758,6891250
1648205783,195834,true,3129411418,28,3135989758,6578340
1648205830,195834,true,3129411418,28,3136303357,6891939
1648206059,195833,true,3129724359,28,3137871822,8147463
1648206642,195833,true,3129724359,28,3141011107,11286748
1648207078,195832,true,3130037332,28,3143524795,13487463
1648207137,195831,true,3130350335,28,3144153531,13803196
1648208092,195831,true,3130350335,28,3148243384,17893049
1648208512,195831,true,3130350335,28,3149817821,19467486
1648208536,195829,true,3130976437,28,3149817821,18841384
1648208559,195829,true,3130976437,28,3150132803,19156366
1648208750,195828,true,3131289534,28,3151708184,20418650
1648208784,195827,true,3131602663,28,3152023355,20420692
1648208828,195826,true,3131915824,28,3152653791,20737967
1648208855,195826,true,3131915824,28,3152969057,21053233
1648208864,195824,true,3132542238,28,3153284353,20742115
1648208869,195823,true,3132855492,28,3153284353,20428861
1648209124,195822,true,3133168778,28,3156123445,22954667
1648209623,195822,true,3133168778,28,3162125479,28956701
1648209920,195821,true,3133482095,28,3165289028,31806933
1648210203,195820,true,3133795443,28,3168138928,34343485
1648210839,195818,true,3134422233,28,3170357291,35935058
1648211450,195818,true,3134422233,28,3170357291,35935058
1648211468,195817,true,3134735676,28,3170357291,35621615
1648211580,195816,true,3135049149,28,3170674326,35625177
1648211996,195815,true,3135362654,28,3170991394,35628740
1648212106,195814,true,3135676190,28,3170991394,35315204
1648212188,195813,true,3135989758,28,3170991394,35001636
1648212197,195812,true,3136303357,28,3170991394,34688037
1648212236,195811,true,3136616987,28,3171308493,34691506
1648212253,195810,true,3136930649,28,3171308493,34377844
1648213209,195808,true,3137558066,28,3178610532,41052466
1648214050,195807,true,3137871822,28,3184018495,46146673
1648214055,195805,true,3138499428,28,3184018495,45519067
1648215150,195804,true,3138813278,28,3184018495,45205217
1648215164,195802,true,3139441072,28,3184018495,44577423
1648215215,195801,true,3139755016,28,3184018495,44263479
1648215552,195800,true,3140068992,28,3184018495,43949503
1648215626,195799,true,3140382998,28,3184018495,43635497
1648217059,195797,true,3141011107,28,3184018495,43007388
1648217090,195796,true,3141325208,28,3184018495,42693287
1648217535,195795,true,3141639340,28,3184018495,42379155
1648217680,195794,true,3141953504,28,3184018495,42064991
1648217716,195792,true,3142581926,28,3183700125,41118199
1648217739,195791,true,3142896184,28,3183700125,40803941
1648217758,195790,true,3143210474,28,3183700125,40489651
1648217792,195790,true,3143210474,28,3183381786,40171312
1648217950,195788,true,3143839148,28,3182108752,38269604
1648218239,195788,true,3143839148,28,3179564210,35725062
1648218388,195786,true,3144467947,28,3178292702,33824755
1648218430,195786,true,3144467947,28,3177974905,33506958
1648218685,195785,true,3144782394,28,3176386394,31604000
1648219230,195784,true,3145096872,28,3172259981,27163109
1648219269,195783,true,3145411382,28,3172259981,26848599
1648219329,195783,true,3145411382,28,3171942786,26531404
1648219449,195781,true,3146040495,28,3171308493,25267998
1648220063,195779,true,3146669735,28,3172894464,26224729
1648220137,195778,true,3146984402,28,3173211754,26227352
1648220179,195778,true,3146984402,28,3173529075,26544673
1648220508,195776,true,3147613830,28,3174163813,26549983
1648220624,195775,true,3147928592,28,3174481229,26552637
1648220836,195773,true,3148558209,28,3174798677,26240468
1648220861,195773,true,3148558209,28,3174798677,26240468
1648220968,195771,true,3149187952,28,3174481229,25293277
1648221071,195770,true,3149502871,28,3174163813,24660942
1648221146,195769,true,3149817821,28,3173529075,23711254
1648221212,195769,true,3149817821,28,3172894464,23076643
1648221674,195768,true,3150132803,28,3168138928,18006125
1648221694,195766,true,3150762861,28,3168138928,17376067
1648221769,195765,true,3151077937,28,3167188676,16110739
1648221874,195765,true,3151077937,28,3165605557,14527620
1648221987,195764,true,3151393045,28,3164023229,12630184
1648222018,195762,true,3152023355,28,3163706858,11683503
1648222060,195761,true,3152338557,28,3163074212,10735655
1648222070,195761,true,3152338557,28,3162757936,10419379
1648222087,195759,true,3152969057,28,3162441692,9472635
1648222100,195758,true,3153284353,28,3162125479,8841126
1648222128,195757,true,3153599682,28,3161809298,8209616
1648222171,195757,true,3153599682,28,3160860945,7261263
1648222224,195756,true,3153915042,28,3159596917,5681875
1648222262,195755,true,3154230433,28,3158965092,4734659
1648222600,195755,true,3154230433,28,3150762861,-3467572
1648222616,195755,true,3154230433,28,3150447816,-3782617
1648223636,195754,true,3154545856,28,3136303357,-18242499
1648223729,195753,true,3154861311,28,3135362654,-19498657
1648223740,195753,true,3154861311,28,3135362654,-19498657
1648223757,195753,true,3154861311,28,3135049149,-19812162
1648223789,195753,true,3154861311,28,3134422233,-20439078
1648224608,195752,true,3155176797,28,3127847182,-27329615
1648224626,195752,true,3155176797,28,3127534428,-27642369
1648224712,195753,true,3154861311,28,3127221706,-27639605
1648224762,195753,true,3154861311,28,3127221706,-27639605
1648225145,195751,true,3155492315,28,3126283727,-29208588
1648225313,195752,true,3155176797,28,3125971130,-29205667
1648225349,195752,true,3155176797,28,3125658564,-29518233
1648225777,195752,true,3155176797,28,3124408613,-30768184
1648226659,195751,true,3155492315,28,3123471478,-32020837
1648226737,195752,true,3155176797,28,3123159162,-32017635
1648227208,195752,true,3155176797,28,3119413806,-35762991
1648227479,195753,true,3154861311,28,3117542813,-37318498
1648227581,195752,true,3155176797,28,3116607737,-38569060
1648228127,195753,true,3154861311,28,3111314269,-43547042
1648228134,195754,true,3154545856,28,3111314269,-43231587
1648228164,195755,true,3154230433,28,3111003169,-43227264
1648228225,195755,true,3154230433,28,3110070054,-44160379
1648228788,195758,true,3153284353,28,3101374473,-51909880
1648229744,195759,true,3152969057,28,3091775578,-61193479
1648229817,195760,true,3152653791,28,3091157315,-61496476
1648229952,195760,true,3152653791,28,3090539177,-62114614
1648229973,195763,true,3151708184,28,3090539177,-61169007
1648231317,195763,true,3151708184,28,3095178232,-56529952
1648231381,195765,true,3151077937,28,3095487750,-55590187
1648231579,195764,true,3151393045,28,3096726130,-54666915
1648231590,195767,true,3150447816,28,3096726130,-53721686
1648231677,195767,true,3150447816,28,3097345507,-53102309
1648231751,195769,true,3149817821,28,3097655241,-52162580
1648231763,195769,true,3149817821,28,3097655241,-52162580
1648231772,195772,true,3148873065,28,3097965007,-50908058
1648231812,195772,true,3148873065,28,3097965007,-50908058
1648231817,195773,true,3148558209,28,3097965007,-50593202
1648231849,195773,true,3148558209,28,3098274803,-50283406
1648231867,195777,true,3147299100,28,3098584631,-48714469
1648231933,195776,true,3147613830,28,3099204379,-48409451
1648231936,195778,true,3146984402,28,3099204379,-47780023
1648231961,195779,true,3146669735,28,3099514299,-47155436
1648232034,195782,true,3145725923,28,3100754291,-44971632
1648232080,195781,true,3146040495,28,3101374473,-44666022
1648234939,195783,true,3145411382,28,3127534428,-17876954
1648234951,195783,true,3145411382,28,3127534428,-17876954
1648234972,195787,true,3144153531,28,3127534428,-16619103
1648235151,195786,true,3144467947,28,3127221706,-17246241
1648235162,195788,true,3143839148,28,3127221706,-16617442
1648235170,195789,true,3143524795,28,3127221706,-16303089
1648235192,195792,true,3142581926,28,3127221706,-15360220
1648235246,195792,true,3142581926,28,3126909015,-15672911
1648235277,195794,true,3141953504,28,3126596355,-15357149
1648235323,195795,true,3141639340,28,3126596355,-15042985
1648235790,195798,true,3140697037,28,3123471478,-17225559
1648235815,195798,true,3140697037,28,3123471478,-17225559
1648235862,195800,true,3140068992,28,3123159162,-16909830
1648236125,195801,true,3139755016,28,3120661759,-19093257
1648236176,195805,true,3138499428,28,3120037720,-18461708
1648236214,195805,true,3138499428,28,3119725747,-18773681
1648236236,195808,true,3137558066,28,3119413806,-18144260
1648236725,195810,true,3136930649,28,3111936563,-24994086
1648236762,195814,true,3135676190,28,3111314269,-24361921
1648236830,195815,true,3135362654,28,3110381061,-24981593
1648237523,195818,true,3134422233,28,3101374473,-33047760
1648237540,195821,true,3133482095,28,3101374473,-32107622
1648237624,195824,true,3132542238,28,3100444246,-32097992
1648237952,195825,true,3132229015,28,3097965007,-34264008
1648237976,195828,true,3131289534,28,3097965007,-33324527
1648238104,195830,true,3130663370,28,3097655241,-33008129
1648238253,195834,true,3129411418,28,3097965007,-31446411
1648238317,195834,true,3129411418,28,3097965007,-31446411
1648238356,195837,true,3128472782,28,3097965007,-30507775
1648238376,195839,true,3127847182,28,3097965007,-29882175
1648238519,195843,true,3126596355,28,3098584631,-28011724
1648238568,195842,true,3126909015,28,3098894489,-28014526
1648238638,195844,true,3126283727,28,3099514299,-26769428
1648240943,195846,true,3125658564,28,3111625401,-14033163
1648241042,195849,true,3124721054,28,3111936563,-12784491
1648241096,195849,true,3124721054,28,3111936563,-12784491
1648241878,195851,true,3124096204,28,3114426984,-9669220
1648241926,195852,true,3123783825,28,3114426984,-9356841
1648241947,195855,true,3122846877,28,3114738427,-8108450
1648242217,195855,true,3122846877,28,3115984509,-6862368
1648243643,195857,true,3122222402,28,3117542813,-4679589
1648243728,195859,true,3121598051,28,3117542813,-4055238
1648243872,195862,true,3120661759,28,3116607737,-4054022
1648243980,195861,true,3120973825,28,3115672942,-5300883
1648244074,195864,true,3120037720,28,3115049900,-4987820
1648245014,195867,true,3119101896,28,3108515486,-10586410
1648245033,195870,true,3118166352,28,3108515486,-9650866
1648245255,195869,true,3118478169,28,3107272390,-11205779
1648245328,195872,true,3117542813,28,3106961694,-10581119
1648245409,195873,true,3117231090,28,3106961694,-10269396
1648249064,195876,true,3116296107,28,3113492843,-2803264
1648249230,195875,true,3116607737,28,3113181524,-3426213
1648249307,195877,true,3115984509,28,3112870237,-3114272
1648250969,195879,true,3115361405,28,3105098170,-10263235
1648251362,195882,true,3114426984,28,3104787691,-9639293
1648252195,195881,true,3114738427,28,3104787691,-9950736
1648252549,195883,true,3114115572,28,3104787691,-9327881
1648253750,195884,true,3113804192,28,3104477243,-9326949
1648253779,195887,true,3112870237,28,3104477243,-8392994
1648253857,195886,true,3113181524,28,3104477243,-8704281
1648255792,195887,true,3112870237,28,3108515486,-4354751
1648255808,195888,true,3112558982,28,3108515486,-4043496
1648255858,195891,true,3111625401,28,3108515486,-3109915
1648255879,195890,true,3111936563,28,3108515486,-3421077
1648255948,195892,true,3111314269,28,3107893876,-3420393
1648258690,195893,true,3111003169,28,3095178232,-15824937
1648258753,195895,true,3110381061,28,3095487750,-14893311
1648258770,195894,true,3110692100,28,3095487750,-15204350
1648258864,195896,true,3110070054,28,3095487750,-14582304
1648259128,195897,true,3109759079,28,3096416489,-13342590
1648259364,195899,true,3109137220,28,3097035803,-12101417
1648259559,195898,true,3109448134,28,3097655241,-11792893
1648260419,195899,true,3109137220,28,3100444246,-8692974
1648261280,195900,true,3108826337,28,3101374473,-7451864
1648261490,195901,true,3108515486,28,3101684610,-6830876
1648261516,195900,true,3108826337,28,3101684610,-7141727
1648261781,195901,true,3108515486,28,3101994778,-6520708
1648263821,195903,true,3107893876,28,3103546086,-4347790
1648264373,195904,true,3107583118,28,3103546086,-4037032
1648264378,195903,true,3107893876,28,3103546086,-4347790
1648265094,195904,true,3107583118,28,3103546086,-4037032
1648265129,195905,true,3107272390,28,3103546086,-3726304
1648265973,195906,true,3106961694,28,3104166826,-2794868
1648268105,195905,true,3107272390,28,3104477243,-2795147
1648268744,195906,true,3106961694,28,3104477243,-2484451
1648268850,195906,true,3106961694,28,3104477243,-2484451
1648270283,195907,true,3106651029,28,3104477243,-2173786
1648270364,195905,true,3107272390,28,3104787691,-2484699
1648270391,195905,true,3107272390,28,3104787691,-2484699
1648270503,195905,true,3107272390,28,3104787691,-2484699
1648270524,195905,true,3107272390,28,3104787691,-2484699
1648272571,195903,true,3107893876,28,3106651029,-1242847
1648272619,195904,true,3107583118,28,3106651029,-932089
1648272771,195903,true,3107893876,28,3106961694,-932182
1648272866,195903,true,3107893876,28,3106961694,-932182
1648272885,195902,true,3108204665,28,3106961694,-1242971
1648272911,195902,true,3108204665,28,3107272390,-932275
1648273020,195902,true,3108204665,28,3107583118,-621547
1648273379,195901,true,3108515486,28,3108515486,0
1648273451,195900,true,3108826337,28,3108826337,0
1648273558,195901,true,3108515486,28,3109137220,621734
1648273580,195901,true,3108515486,28,3109137220,621734
1648274471,195900,true,3108826337,28,3115361405,6535068
1648274481,195899,true,3109137220,28,3115361405,6224185
1648274661,195899,true,3109137220,28,3116607737,7470517
1648274846,195900,true,3108826337,28,3117854567,9028230
1648274885,195898,true,3109448134,28,3117854567,8406433
1648274954,195898,true,3109448134,28,3118478169,9030035
1648276795,195898,true,3109448134,28,3127847182,18399048
1648277271,195898,true,3109448134,28,3127847182,18399048
1648277530,195897,true,3109759079,28,3127847182,18088103
1648277557,195897,true,3109759079,28,3127847182,18088103
1648277720,195898,true,3109448134,28,3127847182,18399048
1648277937,195898,true,3109448134,28,3127847182,18399048
1648278247,195897,true,3109759079,28,3127534428,17775349
1648278877,195897,true,3109759079,28,3127221706,17462627
1648279417,195898,true,3109448134,28,3126909015,17460881
1648279606,195898,true,3109448134,28,3126909015,17460881
1648279904,195897,true,3109759079,28,3126596355,16837276
1648280895,195897,true,3109759079,28,3126283727,16524648
1648281000,195897,true,3109759079,28,3126596355,16837276
1648281470,195897,true,3109759079,28,3127534428,17775349
1648283463,195896,true,3110070054,28,3130663370,20593316
1648283720,195895,true,3110381061,28,3130663370,20282309
1648283761,195895,true,3110381061,28,3130663370,20282309
1648284214,195895,true,3110381061,28,3130663370,20282309
1648284561,195894,true,3110692100,28,3130663370,19971270
1648284920,195893,true,3111003169,28,3130663370,19660201
1648285013,195893,true,3111003169,28,3130663370,19660201
1648285393,195892,true,3111314269,28,3130663370,19349101
1648285454,195890,true,3111936563,28,3130663370,18726807
1648285496,195889,true,3112247757,28,3130663370,18415613
1648285588,195889,true,3112247757,28,3130663370,18415613
1648285972,195888,true,3112558982,28,3130663370,18104388
1648286700,195886,true,3113181524,28,3130663370,17481846
1648286781,195885,true,3113492843,28,3130663370,17170527
1648287021,195885,true,3113492843,28,3130663370,17170527
1648288980,195884,true,3113804192,28,3130663370,16859178
1648289088,195883,true,3114115572,28,3130663370,16547798
1648289192,195882,true,3114426984,28,3130663370,16236386
1648289444,195882,true,3114426984,28,3130663370,16236386
1648289697,195881,true,3114738427,28,3130663370,15924943
1648289738,195880,true,3115049900,28,3130663370,15613470
1648289878,195879,true,3115361405,28,3130663370,15301965
1648289915,195879,true,3115361405,28,3130663370,15301965
1648290141,195879,true,3115361405,28,3130663370,15301965
1648290223,195877,true,3115984509,28,3130663370,14678861
1648290245,195877,true,3115984509,28,3130663370,14678861
1648290716,195877,true,3115984509,28,3130663370,14678861
1648290776,195877,true,3115984509,28,3130663370,14678861
1648290887,195876,true,3116296107,28,3130663370,14367263
1648290930,195876,true,3116296107,28,3130663370,14367263
1648291209,195876,true,3116296107,28,3130663370,14367263
1648291267,195876,true,3116296107,28,3130663370,14367263
1648291407,195874,true,3116919398,28,3130663370,13743972
1648291443,195874,true,3116919398,28,3130663370,13743972
1648291451,195873,true,3117231090,28,3130663370,13432280
1648291583,195873,true,3117231090,28,3130663370,13432280
1648291751,195872,true,3117542813,28,3130350335,12807522
1648292411,195871,true,3117854567,28,3129724359,11869792
1648292783,195871,true,3117854567,28,3129411418,11556851
1648292903,195871,true,3117854567,28,3129411418,11556851
1648293152,195870,true,3118166352,28,3129098508,10932156
1648293511,195869,true,3118478169,28,3128785630,10307461
1648293637,195869,true,3118478169,28,3128785630,10307461
1648294238,195869,true,3118478169,28,3128785630,10307461
1648294373,195867,true,3119101896,28,3129098508,9996612
1648294832,195867,true,3119101896,28,3129411418,10309522
1648294900,195866,true,3119413806,28,3129411418,9997612
1648294927,195866,true,3119413806,28,3129411418,9997612
1648295040,195864,true,3120037720,28,3129411418,9373698
1648295835,195864,true,3120037720,28,3130037332,9999612
1648295930,195864,true,3120037720,28,3130037332,9999612
1648295940,195863,true,3120349724,28,3130037332,9687608
1648296048,195862,true,3120661759,28,3130037332,9375573
1648296196,195861,true,3120973825,28,3130037332,9063507
1648296282,195860,true,3121285922,28,3130037332,8751410
1648296414,195859,true,3121598051,28,3130037332,8439281
1648296509,195858,true,3121910211,28,3130037332,8127121
1648296691,195857,true,3122222402,28,3130037332,7814930
1648296829,195856,true,3122534624,28,3130037332,7502708
1648296865,195856,true,3122534624,28,3130037332,7502708
1648297114,195854,true,3123159162,28,3130037332,6878170
1648297499,195854,true,3123159162,28,3130037332,6878170
1648297537,195853,true,3123471478,28,3130037332,6565854
1648297550,195852,true,3123783825,28,3130037332,6253507
1648297691,195851,true,3124096204,28,3130037332,5941128
1648297799,195851,true,3124096204,28,3130037332,5941128
1648297822,195850,true,3124408613,28,3130037332,5628719
1648297854,195849,true,3124721054,28,3130037332,5316278
1648297880,195848,true,3125033526,28,3129724359,4690833
1648297935,195848,true,3125033526,28,3129724359,4690833
1648297973,195847,true,3125346030,28,3129411418,4065388
1648298199,195847,true,3125346030,28,3128159966,2813936
1648298526,195846,true,3125658564,28,3126283727,625163
1648298843,195846,true,3125658564,28,3123783825,-1874739
1648299042,195846,true,3125658564,28,3122534624,-3123940
1648299148,195846,true,3125658564,28,3121598051,-4060513
1648299606,195845,true,3125971130,28,3118790017,-7181113
1648299704,195845,true,3125971130,28,3118166352,-7804778
1648299854,195844,true,3126283727,28,3117854567,-8429160
1648299877,195844,true,3126283727,28,3117854567,-8429160
1648300174,195844,true,3126283727,28,3117542813,-8740914
1648300278,195844,true,3126283727,28,3117854567,-8429160
1648300309,195843,true,3126596355,28,3117854567,-8741788
1648301006,195843,true,3126596355,28,3119101896,-7494459
1648301294,195842,true,3126909015,28,3119725747,-7183268
1648301542,195842,true,3126909015,28,3120349724,-6559291
1648302206,195842,true,3126909015,28,3120973825,-5935190
1648303695,195842,true,3126909015,28,3120973825,-5935190
1648304334,195841,true,3127221706,28,3120973825,-6247881
1648305550,195841,true,3127221706,28,3120973825,-6247881
1648305761,195841,true,3127221706,28,3120973825,-6247881
1648305852,195841,true,3127221706,28,3120973825,-6247881
1648306104,195841,true,3127221706,28,3120973825,-6247881
1648306138,195841,true,3127221706,28,3120973825,-6247881
1648306184,195840,true,3127534428,28,3120973825,-6560603
1648306557,195841,true,3127221706,28,3120661759,-6559947
1648307126,195841,true,3127221706,28,3119725747,-7495959
1648307251,195841,true,3127221706,28,3119725747,-7495959
1648307422,195841,true,3127221706,28,3119413806,-7807900
1648307539,195842,true,3126909015,28,3119413806,-7495209
1648307554,195842,true,3126909015,28,3119413806,-7495209
1648308272,195842,true,3126909015,28,3118790017,-8118998
1648308615,195842,true,3126909015,28,3118790017,-8118998
1648308937,195843,true,3126596355,28,3118790017,-7806338
1648308954,195843,true,3126596355,28,3118790017,-7806338
1648309484,195843,true,3126596355,28,3118790017,-7806338
1648310473,195843,true,3126596355,28,3118790017,-7806338
1648311806,195844,true,3126283727,28,3118790017,-7493710
1648312450,195844,true,3126283727,28,3118790017,-7493710
1648312557,195844,true,3126283727,28,3118790017,-7493710
1648313428,195844,true,3126283727,28,3118790017,-7493710
1648313621,195845,true,3125971130,28,3118790017,-7181113
1648314787,195845,true,3125971130,28,3118790017,-7181113
1648314839,195845,true,3125971130,28,3119101896,-6869234
1648314932,195846,true,3125658564,28,3119101896,-6556668
1648318822,195846,true,3125658564,28,3121285922,-4372642
1648319899,195846,true,3125658564,28,3121285922,-4372642
1648321015,195847,true,3125346030,28,3121285922,-4060108
1648325293,195847,true,3125346030,28,3121285922,-4060108
1648325340,195847,true,3125346030,28,3121598051,-3747979
1648325385,195847,true,3125346030,28,3121598051,-3747979
1648325416,195848,true,3125033526,28,3121598051,-3435475
1648325448,195848,true,3125033526,28,3121598051,-3435475
1648325494,195848,true,3125033526,28,3121598051,-3435475
1648325521,195848,true,3125033526,28,3121598051,-3435475
1648325523,195848,true,3125033526,28,3121598051,-3435475
1648325533,195848,true,3125033526,28,3121598051,-3435475
1648325569,195848,true,3125033526,28,3121910211,-3123315
1648325609,195848,true,3125033526,28,3121910211,-3123315
1648325636,195849,true,3124721054,28,3121910211,-2810843
1648325727,195849,true,3124721054,28,3122222402,-2498652
1648325810,195849,true,3124721054,28,3122534624,-2186430
1648325830,195849,true,3124721054,28,3122534624,-2186430
1648326207,195849,true,3124721054,28,3124408613,-312441
1648326252,195849,true,3124721054,28,3124721054,0
1648326464,195849,true,3124721054,28,3125658564,937510
1648326882,195848,true,3125033526,28,3129411418,4377892
1648326884,195848,true,3125033526,28,3129411418,4377892
1648326939,195848,true,3125033526,28,3130037332,5003806
1648327043,195848,true,3125033526,28,3130976437,5942911
1648327058,195847,true,3125346030,28,3131289534,5943504
1648327442,195847,true,3125346030,28,3135362654,10016624
1648327911,195847,true,3125346030,28,3139441072,14095042
1648328613,195846,true,3125658564,28,3143839148,18180584
1648328809,195846,true,3125658564,28,3144467947,18809383
1648328988,195846,true,3125658564,28,3144153531,18494967
1648329000,195845,true,3125971130,28,3144153531,18182401
1648329009,195845,true,3125971130,28,3144153531,18182401
1648330071,195845,true,3125971130,28,3141325208,15354078
1648330215,195844,true,3126283727,28,3140697037,14413310
1648331115,195844,true,3126283727,28,3138813278,12529551
1648333308,195844,true,3126283727,28,3138185609,11901882
1648333349,195844,true,3126283727,28,3138499428,12215701
1648333749,195843,true,3126596355,28,3138499428,11903073
1648334868,195843,true,3126596355,28,3139127159,12530804
1648335209,195842,true,3126909015,28,3139441072,12532057
1648336535,195842,true,3126909015,28,3139441072,12532057
1648336671,195842,true,3126909015,28,3139441072,12532057
1648336763,195842,true,3126909015,28,3139441072,12532057
1648337795,195841,true,3127221706,28,3139441072,12219366
1648337880,195841,true,3127221706,28,3139441072,12219366
1648338465,195841,true,3127221706,28,3139441072,12219366
1648338547,195841,true,3127221706,28,3139755016,12533310
1648338871,195840,true,3127534428,28,3140068992,12534564
1648342419,195840,true,3127534428,28,3141011107,13476679
1648342444,195840,true,3127534428,28,3141325208,13790780
1648342460,195839,true,3127847182,28,3141325208,13478026
1648342605,195839,true,3127847182,28,3141325208,13478026
1648342704,195839,true,3127847182,28,3141639340,13792158
1648342747,195838,true,3128159966,28,3141639340,13479374
1648342829,195838,true,3128159966,28,3141639340,13479374
1648342861,195837,true,3128472782,28,3141639340,13166558
1648342974,195837,true,3128472782,28,3141953504,13480722
1648343110,195837,true,3128472782,28,3142581926,14109144
1648345587,195836,true,3128785630,28,3146669735,17884105
1648345726,195835,true,3129098508,28,3146669735,17571227
1648346373,195835,true,3129098508,28,3146669735,17571227
1648347063,195834,true,3129411418,28,3146669735,17258317
1648347134,195834,true,3129411418,28,3146984402,17572984
1648347226,195833,true,3129724359,28,3147299100,17574741
1648347261,195833,true,3129724359,28,3147299100,17574741
1648347283,195832,true,3130037332,28,3147299100,17261768
1648347447,195830,true,3130663370,28,3148558209,17894839
1648347742,195829,true,3130976437,28,3151077937,20101500
1648347945,195828,true,3131289534,28,3152653791,21364257
1648347950,195827,true,3131602663,28,3152653791,21051128
1648348071,195825,true,3132229015,28,3153915042,21686027
1648349333,195824,true,3132542238,28,3161809298,29267060
1648350560,195823,true,3132855492,28,3161809298,28953806
1648350707,195822,true,3133168778,28,3161809298,28640520
1648350792,195820,true,3133795443,28,3161809298,28013855
1648350887,195819,true,3134108822,28,3161809298,27700476
1648351293,195818,true,3134422233,28,3161809298,27387065
1648351642,195817,true,3134735676,28,3161809298,27073622
1648351650,195815,true,3135362654,28,3161809298,26446644
1648351946,195814,true,3135676190,28,3161809298,26133108
1648351963,195813,true,3135989758,28,3161809298,25819540
1648352013,195812,true,3136303357,28,3161809298,25505941
1648352538,195811,true,3136616987,28,3159596917,22979930
1648352665,195810,true,3136930649,28,3158965092,22034443
1648352747,195810,true,3136930649,28,3158333394,21402745
1648353137,195809,true,3137244342,28,3155807864,18563522
1648353290,195808,true,3137558066,28,3154861311,17303245
1648353455,195807,true,3137871822,28,3153915042,16043220
1648353530,195806,true,3138185609,28,3153284353,15098744
1648354115,195805,true,3138499428,28,3151077937,12578509
1648354556,195805,true,3138499428,28,3150447816,11948388
1648354785,195804,true,3138813278,28,3150447816,11634538
1648354985,195803,true,3139127159,28,3150132803,11005644
1648355052,195802,true,3139441072,28,3150132803,10691731
1648355082,195801,true,3139755016,28,3150132803,10377787
1648355106,195800,true,3140068992,28,3150132803,10063811
1648355197,195799,true,3140382998,28,3150132803,9749805
1648355315,195798,true,3140697037,28,3150132803,9435766
1648355326,195798,true,3140697037,28,3150132803,9435766
1648355391,195797,true,3141011107,28,3150132803,9121696
1648355452,195796,true,3141325208,28,3149817821,8492613
1648355512,195795,true,3141639340,28,3149817821,8178481
1648355834,195794,true,3141953504,28,3149187952,7234448
1648355904,195793,true,3142267699,28,3149187952,6920253
1648355977,195793,true,3142267699,28,3148873065,6605366
1648356013,195792,true,3142581926,28,3148873065,6291139
1648356199,195791,true,3142896184,28,3148243384,5347200
1648356444,195790,true,3143210474,28,3147613830,4403356
1648356466,195790,true,3143210474,28,3147613830,4403356
1648356511,195789,true,3143524795,28,3147613830,4089035
1648356874,195788,true,3143839148,28,3146355099,2515951
1648356884,195788,true,3143839148,28,3146355099,2515951
1648357023,195787,true,3144153531,28,3146040495,1886964
1648357096,195786,true,3144467947,28,3146040495,1572548
1648357151,195786,true,3144467947,28,3146040495,1572548
1648357242,195785,true,3144782394,28,3145725923,943529
1648358152,195784,true,3145096872,28,3145096872,0
1648358202,195783,true,3145411382,28,3145096872,-314510
1648358368,195783,true,3145411382,28,3145096872,-314510
1648358386,195782,true,3145725923,28,3145096872,-629051
1648358832,195782,true,3145725923,28,3145096872,-629051
1648359137,195781,true,3146040495,28,3145096872,-943623
1648359317,195781,true,3146040495,28,3145096872,-943623
1648359435,195780,true,3146355099,28,3145096872,-1258227
1648359629,195780,true,3146355099,28,3145096872,-1258227
1648359894,195779,true,3146669735,28,3145096872,-1572863
1648359966,195779,true,3146669735,28,3145096872,-1572863
1648360077,195778,true,3146984402,28,3145096872,-1887530
1648360110,195778,true,3146984402,28,3145096872,-1887530
1648360137,195777,true,3147299100,28,3145096872,-2202228
1648360552,195777,true,3147299100,28,3145096872,-2202228
1648361043,195776,true,3147613830,28,3145096872,-2516958
1648361274,195776,true,3147613830,28,3145096872,-2516958
1648361357,195776,true,3147613830,28,3145096872,-2516958
1648361534,195776,true,3147613830,28,3145725923,-1887907
1648361725,195775,true,3147928592,28,3146040495,-1888097
1648361774,195775,true,3147928592,28,3146355099,-1573493
1648361886,195775,true,3147928592,28,3146355099,-1573493
1648362250,195775,true,3147928592,28,3147299100,-629492
1648362404,195775,true,3147928592,28,3147613830,-314762
1648362527,195775,true,3147928592,28,3147928592,0
1648362549,195775,true,3147928592,28,3147928592,0
1648362603,195774,true,3148243384,28,3147928592,-314792
1648362646,195774,true,3148243384,28,3148243384,0
1648362706,195774,true,3148243384,28,3148243384,0
1648362714,195773,true,3148558209,28,3148243384,-314825
1648362971,195773,true,3148558209,28,3148873065,314856
1648362974,195773,true,3148558209,28,3148873065,314856
1648362996,195772,true,3148873065,28,3148873065,0
1648363241,195772,true,3148873065,28,3149187952,314887
1648363270,195772,true,3148873065,28,3149187952,314887
1648363301,195772,true,3148873065,28,3149187952,314887
1648363333,195771,true,3149187952,28,3149187952,0
1648363900,195771,true,3149187952,28,3149187952,0
1648364080,195771,true,3149187952,28,3149187952,0
1648364486,195771,true,3149187952,28,3149187952,0
1648364700,195770,true,3149502871,28,3149187952,-314919
1648364721,195770,true,3149502871,28,3149187952,-314919
1648364764,195770,true,3149502871,28,3149187952,-314919
1648364857,195770,true,3149502871,28,3149187952,-314919
1648365135,195769,true,3149817821,28,3149187952,-629869
1648365172,195769,true,3149817821,28,3149187952,-629869
1648365258,195769,true,3149817821,28,3149187952,-629869
1648365261,195769,true,3149817821,28,3149187952,-629869
1648365291,195769,true,3149817821,28,3149187952,-629869
1648365519,195768,true,3150132803,28,3149187952,-944851
1648365555,195768,true,3150132803,28,3149187952,-944851
1648365725,195768,true,3150132803,28,3149187952,-944851
1648365831,195768,true,3150132803,28,3149187952,-944851
1648366106,195768,true,3150132803,28,3149187952,-944851
1648366249,195768,true,3150132803,28,3149187952,-944851
1648366354,195768,true,3150132803,28,3149187952,-944851
1648366517,195768,true,3150132803,28,3149187952,-944851
1648366644,195768,true,3150132803,28,3149187952,-944851
1648366683,195768,true,3150132803,28,3149187952,-944851
1648366713,195768,true,3150132803,28,3149187952,-944851
1648367002,195767,true,3150447816,28,3150132803,-315013
1648367087,195768,true,3150132803,28,3150132803,0
1648367174,195768,true,3150132803,28,3150447816,315013
1648367193,195768,true,3150132803,28,3150447816,315013
1648367216,195768,true,3150132803,28,3150447816,315013
1648367259,195769,true,3149817821,28,3150447816,629995
1648367395,195769,true,3149817821,28,3150762861,945040
1648367554,195769,true,3149817821,28,3151393045,1575224
1648367584,195769,true,3149817821,28,3151393045,1575224
1648368008,195770,true,3149502871,28,3152338557,2835686
1648368123,195770,true,3149502871,28,3152653791,3150920
1648368475,195770,true,3149502871,28,3153284353,3781482
1648368517,195770,true,3149502871,28,3153284353,3781482
1648368535,195770,true,3149502871,28,3153284353,3781482
1648368599,195771,true,3149187952,28,3153284353,4096401
1648368607,195771,true,3149187952,28,3153284353,4096401
1648368636,195771,true,3149187952,28,3153284353,4096401
1648368712,195771,true,3149187952,28,3153284353,4096401
1648368889,195772,true,3148873065,28,3153284353,4411288
1648369038,195771,true,3149187952,28,3153284353,4096401
1648369417,195771,true,3149187952,28,3153284353,4096401
1648369500,195771,true,3149187952,28,3153284353,4096401
1648369672,195771,true,3149187952,28,3153284353,4096401
1648369692,195771,true,3149187952,28,3153284353,4096401
1648369701,195771,true,3149187952,28,3153284353,4096401
1648369842,195771,true,3149187952,28,3153284353,4096401
1648369946,195771,true,3149187952,28,3153284353,4096401
1648370089,195771,true,3149187952,28,3153284353,4096401
1648370139,195771,true,3149187952,28,3153284353,4096401
1648370181,195771,true,3149187952,28,3153284353,4096401
1648370270,195771,true,3149187952,28,3153284353,4096401
1648370469,195770,true,3149502871,28,3153284353,3781482
1648370477,195770,true,3149502871,28,3153284353,3781482
1648370533,195770,true,3149502871,28,3153284353,3781482
1648370617,195770,true,3149502871,28,3153284353,3781482
1648370625,195770,true,3149502871,28,3153284353,3781482
1648370697,195770,true,3149502871,28,3153284353,3781482
1648370786,195769,true,3149817821,28,3153284353,3466532
1648370893,195769,true,3149817821,28,3153284353,3466532
1648371038,195769,true,3149817821,28,3153284353,3466532
1648371210,195769,true,3149817821,28,3153284353,3466532
1648371267,195769,true,3149817821,28,3153284353,3466532
1648371320,195769,true,3149817821,28,3153284353,3466532
1648371384,195768,true,3150132803,28,3153284353,3151550
1648371482,195768,true,3150132803,28,3153284353,3151550
1648371542,195768,true,3150132803,28,3153284353,3151550
1648371579,195768,true,3150132803,28,3153284353,3151550
1648371590,195767,true,3150447816,28,3153284353,2836537
1648371621,195767,true,3150447816,28,3153284353,2836537
1648371631,195767,true,3150447816,28,3153284353,2836537
1648371655,195767,true,3150447816,28,3153284353,2836537
1648371707,195767,true,3150447816,28,3153284353,2836537
1648371975,195766,true,3150762861,28,3153284353,2521492
1648372037,195766,true,3150762861,28,3153284353,2521492
1648372118,195766,true,3150762861,28,3153284353,2521492
1648372146,195766,true,3150762861,28,3153284353,2521492
1648372181,195765,true,3151077937,28,3153284353,2206416
1648372329,195765,true,3151077937,28,3153284353,2206416
1648372345,195765,true,3151077937,28,3153284353,2206416
1648372780,195765,true,3151077937,28,3153284353,2206416
1648372870,195764,true,3151393045,28,3153284353,1891308
1648372902,195764,true,3151393045,28,3153284353,1891308
1648373186,195764,true,3151393045,28,3153284353,1891308
1648373374,195764,true,3151393045,28,3153284353,1891308
1648373461,195763,true,3151708184,28,3153284353,1576169
1648373672,195763,true,3151708184,28,3153284353,1576169
1648373801,195763,true,3151708184,28,3153284353,1576169
1648373816,195763,true,3151708184,28,3153284353,1576169
1648373881,195762,true,3152023355,28,3153284353,1260998
1648373907,195762,true,3152023355,28,3153284353,1260998
1648373923,195762,true,3152023355,28,3153284353,1260998
1648373940,195762,true,3152023355,28,3153284353,1260998
1648373985,195762,true,3152023355,28,3153284353,1260998
1648374022,195762,true,3152023355,28,3153284353,1260998
1648374343,195762,true,3152023355,28,3153284353,1260998
1648374406,195762,true,3152023355,28,3153284353,1260998
1648374603,195761,true,3152338557,28,3153284353,945796
1648374635,195761,true,3152338557,28,3153284353,945796
1648374797,195761,true,3152338557,28,3153284353,945796
1648374911,195761,true,3152338557,28,3153284353,945796
1648375200,195761,true,3152338557,28,3153284353,945796
1648375522,195761,true,3152338557,28,3153284353,945796
1648375653,195761,true,3152338557,28,3153284353,945796
1648375676,195761,true,3152338557,28,3153284353,945796
1648375797,195761,true,3152338557,28,3153284353,945796
1648375877,195760,true,3152653791,28,3153284353,630562
1648375918,195760,true,3152653791,28,3153284353,630562
1648375930,195760,true,3152653791,28,3153284353,630562
1648375948,195760,true,3152653791,28,3153284353,630562
1648375959,195760,true,3152653791,28,3153284353,630562
1648376009,195760,true,3152653791,28,3153284353,630562
1648376043,195760,true,3152653791,28,3153284353,630562
1648376084,195760,true,3152653791,28,3153284353,630562
1648376101,195760,true,3152653791,28,3153284353,630562
1648376139,195759,true,3152969057,28,3153284353,315296
1648376286,195759,true,3152969057,28,3153284353,315296
1648376400,195759,true,3152969057,28,3153284353,315296
1648376663,195759,true,3152969057,28,3153284353,315296
1648376678,195759,true,3152969057,28,3153284353,315296
1648377285,195759,true,3152969057,28,3152969057,0
1648377440,195759,true,3152969057,28,3152969057,0
1648377531,195759,true,3152969057,28,3152969057,0
1648377710,195759,true,3152969057,28,3152969057,0
1648377759,195759,true,3152969057,28,3152969057,0
1648377852,195758,true,3153284353,28,3152969057,-315296
1648377925,195758,true,3153284353,28,3152969057,-315296
1648377936,195758,true,3153284353,28,3152969057,-315296
1648377966,195758,true,3153284353,28,3152969057,-315296
1648378029,195758,true,3153284353,28,3152969057,-315296
1648378099,195758,true,3153284353,28,3152969057,-315296
1648378121,195758,true,3153284353,28,3152969057,-315296
1648378380,195758,true,3153284353,28,3152969057,-315296
1648378474,195758,true,3153284353,28,3152969057,-315296
1648378486,195758,true,3153284353,28,3152969057,-315296
1648378561,195758,true,3153284353,28,3152969057,-315296
1648378668,195758,true,3153284353,28,3152969057,-315296
1648378740,195758,true,3153284353,28,3152969057,-315296
1648378775,195758,true,3153284353,28,3152969057,-315296
1648379121,195758,true,3153284353,28,3152969057,-315296
1648379239,195758,true,3153284353,28,3152969057,-315296
1648379266,195758,true,3153284353,28,3152969057,-315296
1648379310,195758,true,3153284353,28,3152969057,-315296
1648379436,195758,true,3153284353,28,3152969057,-315296
1648379588,195758,true,3153284353,28,3152969057,-315296
1648379604,195758,true,3153284353,28,3152969057,-315296
1648379632,195758,true,3153284353,28,3152969057,-315296
1648379656,195758,true,3153284353,28,3152969057,-315296
1648379779,195758,true,3153284353,28,3152969057,-315296
1648379826,195758,true,3153284353,28,3152969057,-315296
1648379898,195758,true,3153284353,28,3152969057,-315296
1648380059,195758,true,3153284353,28,3152969057,-315296
1648380220,195758,true,3153284353,28,3152969057,-315296
1648380231,195758,true,3153284353,28,3152969057,-315296
1648380438,195758,true,3153284353,28,3152969057,-315296
1648380536,195758,true,3153284353,28,3152969057,-315296
1648380602,195758,true,3153284353,28,3152969057,-315296
1648380739,195758,true,3153284353,28,3152969057,-315296
1648380803,195758,true,3153284353,28,3152969057,-315296
1648380826,195758,true,3153284353,28,3152969057,-315296
1648380864,195758,true,3153284353,28,3152969057,-315296
1648380912,195758,true,3153284353,28,3152969057,-315296
1648380941,195758,true,3153284353,28,3152969057,-315296
1648380956,195758,true,3153284353,28,3152969057,-315296
1648381003,195758,true,3153284353,28,3152969057,-315296
1648381050,195758,true,3153284353,28,3152969057,-315296
1648381185,195758,true,3153284353,28,3152969057,-315296
1648381204,195758,true,3153284353,28,3152969057,-315296
1648381224,195758,true,3153284353,28,3152969057,-315296
1648381345,195758,true,3153284353,28,3152969057,-315296
1648381430,195758,true,3153284353,28,3152969057,-315296
1648381527,195758,true,3153284353,28,3152969057,-315296
1648381587,195758,true,3153284353,28,3152969057,-315296
1648381730,195758,true,3153284353,28,3152969057,-315296
1648381918,195758,true,3153284353,28,3152969057,-315296
1648381942,195758,true,3153284353,28,3152969057,-315296
1648382283,195758,true,3153284353,28,3152969057,-315296
1648382395,195758,true,3153284353,28,3152969057,-315296
1648382516,195758,true,3153284353,28,3152969057,-315296
1648382744,195758,true,3153284353,28,3152969057,-315296
1648382806,195758,true,3153284353,28,3152969057,-315296
1648382981,195758,true,3153284353,28,3152969057,-315296
1648382995,195758,true,3153284353,28,3152969057,-315296
1648383097,195758,true,3153284353,28,3152969057,-315296
1648383265,195758,true,3153284353,28,3152969057,-315296
1648383271,195758,true,3153284353,28,3152969057,-315296
1648383377,195758,true,3153284353,28,3152969057,-315296
1648383427,195758,true,3153284353,28,3152969057,-315296
1648383464,195758,true,3153284353,28,3152969057,-315296
1648383502,195758,true,3153284353,28,3152969057,-315296
1648383558,195759,true,3152969057,28,3152969057,0
1648383607,195759,true,3152969057,28,3152653791,-315266
1648383700,195759,true,3152969057,28,3152653791,-315266
1648383810,195759,true,3152969057,28,3152023355,-945702
1648384010,195759,true,3152969057,28,3151393045,-1576012
1648384266,195759,true,3152969057,28,3150132803,-2836254
1648384533,195760,true,3152653791,28,3148873065,-3780726
1648384625,195760,true,3152653791,28,3148558209,-4095582
1648384646,195760,true,3152653791,28,3148243384,-4410407
1648385214,195760,true,3152653791,28,3145725923,-6927868
1648385322,195761,true,3152338557,28,3145411382,-6927175
1648385450,195761,true,3152338557,28,3144782394,-7556163
1648385635,195761,true,3152338557,28,3144467947,-7870610
1648385853,195762,true,3152023355,28,3144153531,-7869824
1648385901,195762,true,3152023355,28,3144153531,-7869824
1648385909,195762,true,3152023355,28,3144153531,-7869824
1648386030,195763,true,3151708184,28,3143839148,-7869036
1648386041,195763,true,3151708184,28,3143839148,-7869036
1648387631,195764,true,3151393045,28,3138185609,-13207436
1648388519,195764,true,3151393045,28,3137871822,-13521223
1648388608,195764,true,3151393045,28,3137871822,-13521223
1648388645,195765,true,3151077937,28,3137871822,-13206115
1648388663,195765,true,3151077937,28,3137871822,-13206115
1648388801,195765,true,3151077937,28,3137871822,-13206115
1648388837,195766,true,3150762861,28,3137871822,-12891039
1648389056,195767,true,3150447816,28,3137871822,-12575994
1648389218,195767,true,3150447816,28,3137871822,-12575994
1648389444,195767,true,3150447816,28,3137871822,-12575994
1648389470,195768,true,3150132803,28,3137871822,-12260981
1648390066,195768,true,3150132803,28,3137871822,-12260981
1648390153,195769,true,3149817821,28,3137871822,-11945999
1648390238,195769,true,3149817821,28,3138185609,-11632212
1648390244,195769,true,3149817821,28,3138185609,-11632212
1648390510,195770,true,3149502871,28,3138499428,-11003443
1648391476,195770,true,3149502871,28,3140382998,-9119873
1648391578,195770,true,3149502871,28,3140697037,-8805834
1648392459,195770,true,3149502871,28,3146669735,-2833136
1648392551,195770,true,3149502871,28,3147299100,-2203771
1648392596,195770,true,3149502871,28,3147613830,-1889041
1648392783,195770,true,3149502871,28,3148558209,-944662
1648392833,195770,true,3149502871,28,3148873065,-629806
1648392928,195771,true,3149187952,28,3149502871,314919
1648393014,195770,true,3149502871,28,3150132803,629932
1648393168,195770,true,3149502871,28,3151077937,1575066
1648394587,195770,true,3149502871,28,3152023355,2520484
1648394624,195771,true,3149187952,28,3152338557,3150605
1648394630,195770,true,3149502871,28,3152338557,2835686
1648394653,195770,true,3149502871,28,3152338557,2835686
1648394679,195770,true,3149502871,28,3152338557,2835686
1648394709,195770,true,3149502871,28,3152338557,2835686
1648394750,195770,true,3149502871,28,3152338557,2835686
1648395129,195770,true,3149502871,28,3153915042,4412171
1648395970,195770,true,3149502871,28,3158017592,8514721
1648395978,195770,true,3149502871,28,3158333394,8830523
1648396075,195769,true,3149817821,28,3158965092,9147271
1648396152,195769,true,3149817821,28,3159912877,10095056
1648397289,195768,true,3150132803,28,3166555334,16422531
1648397364,195768,true,3150132803,28,3166871989,16739186
1648397500,195767,true,3150447816,28,3167505395,17057579
1648397600,195767,true,3150447816,28,3168138928,17691112
1648397975,195766,true,3150762861,28,3169406374,18643513
1648398394,195766,true,3150762861,28,3170040287,19277426
1648399141,195765,true,3151077937,28,3170674326,19596389
1648399162,195765,true,3151077937,28,3170991394,19913457
1648399655,195764,true,3151393045,28,3172577207,21184162
1648399689,195764,true,3151393045,28,3172577207,21184162
1648401179,195763,true,3151708184,28,3177974905,26266721
1648401960,195762,true,3152023355,28,3178292702,26269347
1648403419,195761,true,3152338557,28,3178292702,25954145
1648403953,195761,true,3152338557,28,3178292702,25954145
1648405218,195760,true,3152653791,28,3178292702,25638911
1648405245,195759,true,3152969057,28,3178610532,25641475
1648407360,195758,true,3153284353,28,3181472426,28188073
1648407406,195758,true,3153284353,28,3181472426,28188073
1648407474,195756,true,3153915042,28,3181472426,27557384
1648408640,195756,true,3153915042,28,3181472426,27557384
1648412598,195754,true,3154545856,28,3181472426,26926570
1648412606,195754,true,3154545856,28,3181472426,26926570
1648412619,195753,true,3154861311,28,3181472426,26611115
1648413315,195753,true,3154861311,28,3179564210,24702899
1648413338,195752,true,3155176797,28,3179564210,24387413
1648413361,195752,true,3155176797,28,3179564210,24387413
1648413375,195751,true,3155492315,28,3179882167,24389852
1648413387,195749,true,3156123445,28,3179882167,23758722
1648413404,195748,true,3156439057,28,3179882167,23443110
1648413424,195748,true,3156439057,28,3179882167,23443110
1648413453,195746,true,3157070377,28,3180200155,23129778
1648413473,195744,true,3157701822,28,3180518175,22816353
1648413496,195743,true,3158017592,28,3180836227,22818635
1648413541,195741,true,3158649227,28,3182108752,23459525
1648413580,195738,true,3159596917,28,3183381786,23784869
1648413645,195736,true,3160228868,28,3185292293,25063425
1648413994,195734,true,3160860945,28,3195181525,34320580
1648414001,195732,true,3161493149,28,3195501043,34007894
1648414104,195729,true,3162441692,28,3198058339,35616647
1648414225,195727,true,3163074212,28,3201257837,38183625
1648414272,195725,true,3163706858,28,3202538532,38831674
1648414595,195723,true,3164339631,28,3212160092,47820461
1648416466,195720,true,3165289028,28,3233106086,67817058
1648416474,195718,true,3165922118,28,3233429396,67507278
1648416513,195716,true,3166555334,28,3233429396,66874062
1648416537,195714,true,3167188676,28,3233429396,66240720
1648416561,195711,true,3168138928,28,3233429396,65290468
1648416585,195708,true,3169089465,28,3233752739,64663274
1648416718,195705,true,3170040287,28,3235693476,65653189
1648416772,195702,true,3170991394,28,3236664281,65672887
1648416872,195698,true,3172259981,28,3238606765,66346784
1648417009,195695,true,3173211754,28,3241198558,67986804
1648417422,195692,true,3174163813,28,3249311285,75147472
1648417461,195689,true,3175116157,28,3250286176,75170019
1648417467,195685,true,3176386394,28,3250611205,74224811
1648417473,195682,true,3177339405,28,3250611205,73271800
1648417512,195678,true,3178610532,28,3251586486,72975954
1648417781,195674,true,3179882167,28,3259725214,79843047
1648417854,195670,true,3181154310,28,3261681538,80527228
1648417985,195667,true,3182108752,28,3265924269,83815517
1648418039,195662,true,3183700125,28,3267230835,83530710
1648418053,195659,true,3184655330,28,3267557558,82902228
1648418063,195655,true,3185929383,28,3267884314,81954931
1648418078,195652,true,3186885258,28,3268211102,81325844
1648418099,195648,true,3188160203,28,3268537923,80377720
1648418107,195644,true,3189435658,28,3268864777,79429119
1648418163,195640,true,3190711624,28,3270172519,79460895
1648418207,195638,true,3191349798,28,3271153669,79803871
1648418254,195633,true,3192945792,28,3272135113,79189321
1648418267,195630,true,3193903772,28,3272135113,78231341
1648418407,195626,true,3195181525,28,3273771508,78589983
1648418419,195624,true,3195820593,28,3274098885,78278292
1648418447,195619,true,3197418823,28,3274098885,76680062
1648418813,195616,true,3198378145,28,3274753738,76375593
1648419617,195612,true,3199657688,28,3271480784,71823096
1648419701,195610,true,3200297652,28,3270499536,70201884
1648419813,195605,true,3201898120,28,3269518583,67620463
1648419863,195601,true,3203179072,28,3269518583,66339511
1648419931,195597,true,3204460536,28,3269518583,65058047
1648420033,195595,true,3205101460,28,3269845535,64744075
1648421740,195589,true,3207025002,28,3278029965,71004963
1648423688,195585,true,3208308004,28,3278029965,69721961
1648423798,195581,true,3209591520,28,3278029965,68438445
1648423877,195579,true,3210233470,28,3278357768,68124298
1648424105,195574,true,3211838908,28,3278357768,66518860
1648424138,195570,true,3213123836,28,3278685604,65561768
1648424198,195566,true,3214409278,28,3278685604,64276326
1648424244,195563,true,3215373698,28,3278685604,63311906
1648424521,195558,true,3216981706,28,3279341374,62359668
1648424598,195554,true,3218268692,28,3279669308,61400616
1648424670,195550,true,3219556192,28,3279997275,60441083
1648424777,195547,true,3220522156,28,3280981373,60459217
1648425085,195541,true,3222454952,28,3283607077,61152125
1648425993,195537,true,3223744128,28,3290838603,67094475
1648426036,195534,true,3224711348,28,3291167686,66456338
1648427274,195532,true,3225356322,28,3288864790,63508468
1648427320,195526,true,3227292020,28,3288864790,61572770
1648427536,195523,true,3228260304,28,3287878328,59618024
1648427596,195519,true,3229551802,28,3287549573,57997771
1648427609,195517,true,3230197745,28,3287549573,57351828
1648427638,195511,true,3232136348,28,3287220851,55084503
1648427654,195507,true,3233429396,28,3287549573,54120177
1648427673,195503,true,3234722962,28,3287549573,52826611
1648427680,195501,true,3235369939,28,3287549573,52179634
1648427740,195495,true,3237311646,28,3287878328,50566682
1648427791,195491,true,3238606765,28,3288535937,49929172
1648427863,195486,true,3240226393,28,3289193677,48967284
1648427884,195484,true,3240874470,28,3289522596,48648126
1648427955,195478,true,3242819481,28,3290509552,47690071
1648428247,195474,true,3244116804,28,3294789782,50672978
1648428259,195470,true,3245414645,28,3294789782,49375137
1648428330,195468,true,3246063760,28,3295448772,49385012
1648428338,195462,true,3248011886,28,3295448772,47436886
1648428347,195459,true,3248986387,28,3295448772,46462385
1648429567,195456,true,3249961180,28,3299735427,49774247
1648429963,195454,true,3250611205,28,3296107895,45496690
1648430042,195449,true,3252236835,28,3295119261,42882426
1648430694,195445,true,3253537925,28,3295448772,41910847
1648430731,195442,true,3254514084,28,3295778317,41264233
1648431352,195440,true,3255165020,28,3296767150,41602130
1648432025,195435,true,3256792928,28,3297426536,40633608
1648432382,195431,true,3258095840,28,3297756279,39660439
1648432717,195429,true,3258747492,28,3297756279,39008787
1648433088,195427,true,3259399274,28,3297756279,38357005
1648433160,195422,true,3261029300,28,3297756279,36726979
1648433257,195418,true,3262333907,28,3297756279,35422372
1648433352,195415,true,3263312705,28,3297756279,34443574
1648433442,195414,true,3263639036,28,3297756279,34117243
1648433998,195409,true,3265271182,28,3297756279,32485097
1648435060,195405,true,3266577487,28,3297756279,31178792
1648435334,195403,true,3267230835,28,3297756279,30525444
1648435490,195401,true,3267884314,28,3297756279,29871965
1648435741,195396,true,3269518583,28,3298086054,28567471
1648436109,195392,true,3270826586,28,3298086054,27259468
1648436392,195390,true,3271480784,28,3298745705,27264921
1648437635,195388,true,3272135113,28,3301715764,29580651
1648437656,195382,true,3274098885,28,3301715764,27616879
1648438104,195378,true,3275408721,28,3303366952,27958231
1648438135,195376,true,3276063836,28,3303697288,27633452
1648438191,195374,true,3276719081,28,3303697288,26978207
1648438423,195369,true,3278357768,28,3304688497,26330729
1648439124,195365,true,3279669308,28,3307002473,27333165
1648439313,195363,true,3280325275,28,3307663906,27338631
1648439629,195362,true,3280653307,28,3308656305,28002998
1648441107,195357,true,3282293962,28,3309318069,27024107
1648441284,195355,true,3282950454,28,3309318069,26367615
1648441422,195354,true,3283278749,28,3308987170,25708421
1648442056,195353,true,3283607077,28,3308325472,24718395
1648442293,195349,true,3284920717,28,3308325472,23404755
1648442387,195347,true,3285577734,28,3307994673,22416939
1648442912,195346,true,3285906291,28,3307333173,21426882
1648443355,195345,true,3286234882,28,3307333173,21098291
1648443388,195340,true,3287878328,28,3307333173,19454845
1648443474,195338,true,3288535937,28,3307663906,19127969
1648443510,195337,true,3288864790,28,3307663906,18799116
1648443659,195337,true,3288864790,28,3307663906,18799116
1648443705,195332,true,3290509552,28,3307994673,17485121
1648443737,195330,true,3291167686,28,3307994673,16826987
1648443751,195330,true,3291167686,28,3307994673,16826987
1648443783,195329,true,3291496803,28,3307994673,16497870
1648443799,195325,true,3292813599,28,3308325472,15511873
1648443811,195324,true,3293142881,28,3308325472,15182591
1648443821,195324,true,3293142881,28,3308325472,15182591
1648443827,195323,true,3293472195,28,3308325472,14853277
1648443862,195319,true,3294789782,28,3308656305,13866523
1648443955,195318,true,3295119261,28,3309649001,14529740
1648444160,195318,true,3295119261,28,3311635287,16516026
1648444180,195317,true,3295448772,28,3311635287,16186515
1648444441,195315,true,3296107895,28,3314285522,18177627
1648444479,195314,true,3296437506,28,3314616951,18179445
1648444723,195313,true,3296767150,28,3317933060,21165910
1648445051,195313,true,3296767150,28,3321916770,25149620
1648445135,195310,true,3297756279,28,3323245736,25489457
1648445653,195309,true,3298086054,28,3328566919,30480865
1648445973,195308,true,3298415863,28,3329898546,31482683
1648446124,195307,true,3298745705,28,3330231535,31485830
1648446602,195304,true,3299735427,28,3330564559,30829132
1648447560,195303,true,3300065401,28,3329898546,29833145
1648447613,195302,true,3300395407,28,3329898546,29503139
1648447623,195301,true,3300725447,28,3329898546,29173099
1648447653,195298,true,3301715764,28,3329898546,28182782
1648447670,195297,true,3302045935,28,3329565589,27519654
1648447729,195296,true,3302376140,28,3329232666,26856526
1648447759,195295,true,3302706377,28,3329232666,26526289
1648447770,195292,true,3303697288,28,3328899776,25202488
1648447824,195291,true,3304027658,28,3328899776,24872118
1648448007,195291,true,3304027658,28,3327568549,23540891
1648449085,195290,true,3304358061,28,3319260432,14902371
1648449554,195287,true,3305349467,28,3316274591,10925124
1648449868,195286,true,3305680002,28,3315611435,9931433
1648449961,195286,true,3305680002,28,3315611435,9931433
1648450626,195285,true,3306010570,28,3315611435,9600865
1648450730,195283,true,3306671805,28,3315611435,8939630
1648451305,195282,true,3307002473,28,3315611435,8608962
1648451320,195282,true,3307002473,28,3315942997,8940524
1648451509,195281,true,3307333173,28,3315942997,8609824
1648451559,195279,true,3307994673,28,3315942997,7948324
1648452168,195278,true,3308325472,28,3316606218,8280746
1648452572,195278,true,3308325472,28,3316937879,8612407
1648452942,195277,true,3308656305,28,3317269573,8613268
1648452996,195275,true,3309318069,28,3317269573,7951504
1648453939,195274,true,3309649001,28,3317269573,7620572
1648454580,195274,true,3309649001,28,3317269573,7620572
1648454964,195274,true,3309649001,28,3317269573,7620572
1648455130,195272,true,3310310964,28,3317269573,6958609
1648455183,195272,true,3310310964,28,3317269573,6958609
1648455312,195272,true,3310310964,28,3317269573,6958609
1648455683,195271,true,3310641995,28,3317269573,6627578
1648455718,195269,true,3311304156,28,3317269573,5965417
1648455775,195268,true,3311635287,28,3317269573,5634286
1648456182,195268,true,3311635287,28,3317269573,5634286
1648456336,195267,true,3311966450,28,3317269573,5303123
1648457081,195266,true,3312297647,28,3317269573,4971926
1648457406,195265,true,3312628877,28,3317269573,4640696
1648457855,195266,true,3312297647,28,3317601300,5303653
1648458030,195265,true,3312628877,28,3317601300,4972423
1648458181,195264,true,3312960140,28,3317601300,4641160
1648458183,195264,true,3312960140,28,3317601300,4641160
1648458268,195265,true,3312628877,28,3317601300,4972423
1648458362,195264,true,3312960140,28,3317933060,4972920
1648458479,195263,true,3313291436,28,3318264853,4973417
1648458599,195263,true,3313291436,28,3318596680,5305244
1648458880,195264,true,3312960140,28,3319260432,6300292
1648458931,195263,true,3313291436,28,3319592358,6300922
1648459448,195262,true,3313622765,28,3322248962,8626197
1648460792,195261,true,3313954127,28,3326237854,12283727
1648460867,195260,true,3314285522,28,3326570478,12284956
1648460915,195259,true,3314616951,28,3326570478,11953527
1648460975,195258,true,3314948413,28,3326570478,11622065
1648461189,195256,true,3315611435,28,3328234096,12622661
1648462453,195256,true,3315611435,28,3338567113,22955678
1648462495,195255,true,3315942997,28,3338900969,22957972
1648462753,195254,true,3316274591,28,3340904811,24630220
1648463380,195252,true,3316937879,28,3342909855,25971976
1648463468,195250,true,3317601300,28,3342909855,25308555
1648463954,195250,true,3317601300,28,3344581644,26980344
1648464004,195248,true,3318264853,28,3344581644,26316791
1648464974,195246,true,3318928539,28,3345919677,26991138
1648465419,195245,true,3319260432,28,3346254269,26993837
1648465686,195244,true,3319592358,28,3346254269,26661911
1648465697,195243,true,3319924317,28,3346254269,26329952
1648465908,195241,true,3320588336,28,3346254269,25665933
1648466491,195240,true,3320920394,28,3346588895,25668501
1648467198,195239,true,3321252486,28,3346588895,25336409
1648468161,195238,true,3321584612,28,3347592972,26008360
1648469525,195236,true,3322248962,28,3347927731,25678769
1648470061,195235,true,3322581187,28,3347927731,25346544
1648470434,195234,true,3322913445,28,3347927731,25014286
1648471079,195233,true,3323245736,28,3347927731,24681995
1648471434,195231,true,3323910419,28,3347927731,24017312
1648471553,195230,true,3324242810,28,3347592972,23350162
1648472249,195230,true,3324242810,28,3345250594,21007784
1648472905,195229,true,3324575234,28,3342909855,18334621
1648473258,195227,true,3325240182,28,3342241373,17001191
1648473387,195226,true,3325572706,28,3342909855,17337149
1648474217,195226,true,3325572706,28,3348932210,23359504
1648474281,195225,true,3325905263,28,3349267103,23361840
1648474347,195223,true,3326570478,28,3349936990,23366512
1648474411,195221,true,3327235825,28,3350271984,23036159
1648474551,195220,true,3327568549,28,3351947455,24378906
1648474681,195219,true,3327901306,28,3353288435,25387129
1648474691,195217,true,3328566919,28,3353623764,25056845
1648474727,195216,true,3328899776,28,3353959126,25059350
1648474736,195214,true,3329565589,28,3353959126,24393537
1648474753,195213,true,3329898546,28,3354294522,24395976
1648474814,195211,true,3330564559,28,3354965415,24400856
1648475043,195209,true,3331230705,28,3358321890,27091185
1648475698,195208,true,3331563828,28,3364035607,32471779
1648475741,195206,true,3332230174,28,3364372011,32141837
1648476031,195204,true,3332896653,28,3368411478,35514825
1648476251,195202,true,3333563266,28,3371444261,37880995
1648476723,195201,true,3333896622,28,3375492220,41595598
1648477085,195199,true,3334563435,28,3377855774,43292339
1648477172,195197,true,3335230381,28,3378193560,42963179
1648477203,195196,true,3335563904,28,3378531379,42967475
1648477267,195194,true,3336231050,28,3378531379,42300329
1648477288,195194,true,3336231050,28,3378531379,42300329
1648477336,195192,true,3336898330,28,3378531379,41633049
1648477351,195191,true,3337232020,28,3378531379,41299359
1648477943,195189,true,3337899499,28,3376504969,38605470
1648478175,195189,true,3337899499,28,3375154705,37255206
1648478744,195187,true,3338567113,28,3372118584,33551471
1648478776,195186,true,3338900969,28,3371781406,32880437
1648478838,195185,true,3339234859,28,3371444261,32209402
1648478871,195184,true,3339568783,28,3371444261,31875478
1648478879,195183,true,3339902740,28,3371444261,31541521
1648478902,195182,true,3340236730,28,3371444261,31207531
1648479005,195180,true,3340904811,28,3371107151,30202340
1648479007,195179,true,3341238901,28,3371107151,29868250
1648479023,195178,true,3341573025,28,3371444261,29871236
1648479052,195176,true,3342241373,28,3371444261,29202888
1648479064,195175,true,3342575597,28,3371444261,28868664
1648479083,195174,true,3342909855,28,3371781406,28871551
1648479208,195172,true,3343578470,28,3372793041,29214571
1648481011,195170,true,3344247219,28,3386987851,42740632
1648481028,195168,true,3344916102,28,3387326549,42410447
1648481066,195167,true,3345250594,28,3387326549,42075955
1648481136,195164,true,3346254269,28,3387326549,41072280
1648481154,195162,true,3346923554,28,3387326549,40402995
1648481608,195160,true,3347592972,28,3388681683,41088711
1648481685,195159,true,3347927731,28,3388681683,40753952
1648481711,195156,true,3348932210,28,3388681683,39749473
1648481787,195154,true,3349602030,28,3388681683,39079653
1648482845,195152,true,3350271984,28,3385633394,35361410
1648482908,195152,true,3350271984,28,3385294865,35022881
1648482955,195149,true,3351277166,28,3384617907,33340741
1648482961,195147,true,3351947455,28,3384617907,32670452
1648483065,195146,true,3352282650,28,3383602725,31320075
1648483083,195145,true,3352617878,28,3383264399,30646521
1648483170,195143,true,3353288435,28,3382587847,29299412
1648483294,195141,true,3353959126,28,3380897060,26937934
1648484273,195141,true,3353959126,28,3372793041,18833915
1648484329,195140,true,3354294522,28,3372118584,17824062
1648484332,195138,true,3354965415,28,3372118584,17153169
1648484374,195136,true,3355636441,28,3371781406,16144965
1648484375,195135,true,3355972005,28,3371781406,15809401
1648484388,195135,true,3355972005,28,3371781406,15809401
1648484425,195134,true,3356307602,28,3371107151,14799549
1648484486,195132,true,3356978897,28,3369759045,12780148
1648484505,195132,true,3356978897,28,3369422103,12443206
1648485959,195132,true,3356978897,28,3350942072,-6036825
1648486294,195130,true,3357650327,28,3350271984,-7378343
1648487949,195128,true,3358321890,28,3360001387,1679497
1648488446,195128,true,3358321890,28,3360337387,2015497
1648488603,195127,true,3358657722,28,3360673421,2015699
1648488829,195125,true,3359329487,28,3360337387,1007900
1648488908,195123,true,3360001387,28,3360673421,672034
1648489079,195123,true,3360001387,28,3361345589,1344202
1648489108,195122,true,3360337387,28,3361345589,1008202
1648489151,195120,true,3361009488,28,3361681724,672236
1648489287,195118,true,3361681724,28,3362354094,672370
1648489317,195118,true,3361681724,28,3362354094,672370
1648489650,195117,true,3362017892,28,3364372011,2354119
1648489698,195115,true,3362690329,28,3364708448,2018119
1648489788,195113,true,3363362901,28,3365044919,1682018
1648489988,195112,true,3363699237,28,3367064450,3365213
1648490022,195112,true,3363699237,28,3367064450,3365213
1648490042,195110,true,3364372011,28,3367401157,3029146
1648490605,195107,true,3365381423,28,3373467634,8086211
1648490636,195107,true,3365381423,28,3373804981,8423558
1648491637,195106,true,3365717961,28,3381911431,16193470
1648491993,195105,true,3366054533,28,3383264399,17209866
1648492054,195103,true,3366727778,28,3383602725,16874947
1648492136,195102,true,3367064450,28,3383941085,16876635
1648492293,195101,true,3367401157,28,3384617907,17216750
1648492354,195100,true,3367737897,28,3384956369,17218472
1648492379,195098,true,3368411478,28,3384956369,16544891
1648492735,195097,true,3368748319,28,3385971958,17223639
1648492977,195096,true,3369085194,28,3386649186,17563992
1648492984,195095,true,3369422103,28,3386649186,17227083
1648493001,195094,true,3369759045,28,3386649186,16890141
1648493078,195093,true,3370096021,28,3386649186,16553165
1648493090,195092,true,3370433030,28,3386987851,16554821
1648493135,195090,true,3371107151,28,3387326549,16219398
1648493234,195088,true,3371781406,28,3388342849,16561443
1648493353,195087,true,3372118584,28,3389698390,17579806
1648493588,195085,true,3372793041,28,3393428923,20635882
1648493596,195084,true,3373130321,28,3393428923,20298602
1648494143,195081,true,3374142361,28,3401582525,27440164
1648495487,195080,true,3374479775,28,3414532480,40052705
1648495665,195078,true,3375154705,28,3415215421,40060716
1648495870,195077,true,3375492220,28,3415556942,40064722
1648495897,195074,true,3376504969,28,3415898498,39393529
1648496055,195072,true,3377180304,28,3416240088,39059784
1648496123,195070,true,3377855774,28,3416581712,38725938
1648497046,195068,true,3378531379,28,3419657866,41126487
1648497159,195066,true,3379207119,28,3419999832,40792713
1648497165,195064,true,3379882994,28,3419999832,40116838
1648497172,195063,true,3380220982,28,3419999832,39778850
1648497409,195062,true,3380559005,28,3419657866,39098861
1648500042,195060,true,3381235150,28,3407369844,26134694
1648500562,195059,true,3381573274,28,3407369844,25796570
1648500640,195058,true,3381911431,28,3407710581,25799150
1648501243,195057,true,3382249622,28,3408392157,26142535
1648501338,195056,true,3382587847,28,3408392157,25804310
1648501355,195054,true,3383264399,28,3408392157,25127758
1648501523,195053,true,3383602725,28,3409414777,25812052
1648502254,195052,true,3383941085,28,3414191061,30249976
1648502306,195050,true,3384617907,28,3414532480,29914573
1648502351,195049,true,3384956369,28,3414532480,29576111
1648502476,195048,true,3385294865,28,3415215421,29920556
1648502554,195047,true,3385633394,28,3415215421,29582027
1648502567,195046,true,3385971958,28,3415556942,29584984
1648502604,195045,true,3386310555,28,3415556942,29246387
1648502622,195044,true,3386649186,28,3415556942,28907756
1648502661,195044,true,3386649186,28,3415556942,28907756
1648502680,195042,true,3387326549,28,3415556942,28230393
1648502722,195042,true,3387326549,28,3415556942,28230393
1648502766,195041,true,3387665282,28,3415556942,27891660
1648502830,195040,true,3388004049,28,3415215421,27211372
1648502962,195039,true,3388342849,28,3415215421,26872572
1648503006,195038,true,3388681683,28,3414873933,26192250
1648503133,195037,true,3389020552,28,3414532480,25511928
1648503162,195036,true,3389359454,28,3414191061,24831607
1648503248,195036,true,3389359454,28,3413508325,24148871
1648503273,195035,true,3389698390,28,3413167009,23468619
1648503293,195034,true,3390037359,28,3412825726,22788367
1648503306,195033,true,3390376363,28,3412825726,22449363
1648503341,195033,true,3390376363,28,3412143263,21766900
1648503418,195033,true,3390376363,28,3411119825,20743462
1648503465,195032,true,3390715401,28,3410437703,19722302
1648503486,195032,true,3390715401,28,3410096694,19381293
1648503508,195032,true,3390715401,28,3409755718,19040317
1648503533,195032,true,3390715401,28,3409073869,18358468
1648503539,195032,true,3390715401,28,3409073869,18358468
1648503558,195032,true,3390715401,28,3408732996,18017595
1648503646,195033,true,3390376363,28,3406347837,15971474
1648504154,195034,true,3390037359,28,3394107642,4070283
1648505852,195033,true,3390376363,28,3374479775,-15896588
1648505930,195033,true,3390376363,28,3374817223,-15559140
1648506332,195034,true,3390037359,28,3375154705,-14882654
1648506679,195035,true,3389698390,28,3375829770,-13868620
1648508354,195034,true,3390037359,28,3380220982,-9816377
1648508595,195035,true,3389698390,28,3380220982,-9477408
1648508999,195035,true,3389698390,28,3380220982,-9477408
1648509035,195036,true,3389359454,28,3380220982,-9138472
1648509105,195035,true,3389698390,28,3380220982,-9477408
1648509177,195035,true,3389698390,28,3379545040,-10153350
1648509466,195036,true,3389359454,28,3377855774,-11503680
1648509472,195036,true,3389359454,28,3377855774,-11503680
1648509536,195035,true,3389698390,28,3377180304,-12518086
1648509564,195036,true,3389359454,28,3376842620,-12516834
1648509571,195037,true,3389020552,28,3376842620,-12177932
1648509626,195037,true,3389020552,28,3376167353,-12853199
1648509770,195037,true,3389020552,28,3373804981,-15215571
1648509856,195037,true,3389020552,28,3372455796,-16564756
1648509983,195039,true,3388342849,28,3370433030,-17909819
1648511576,195039,true,3388342849,28,3350607011,-37735838
1648511603,195038,true,3388681683,28,3350607011,-38074672
1648511606,195038,true,3388681683,28,3350607011,-38074672
1648511617,195039,true,3388342849,28,3350607011,-37735838
1648511630,195039,true,3388342849,28,3350271984,-38070865
1648511650,195039,true,3388342849,28,3350271984,-38070865
1648511677,195040,true,3388004049,28,3349936990,-38067059
1648512058,195042,true,3387326549,28,3345585119,-41741430
1648512100,195042,true,3387326549,28,3345250594,-42075955
1648512556,195042,true,3387326549,28,3341238901,-46087648
1648512572,195042,true,3387326549,28,3340904811,-46421738
1648512914,195044,true,3386649186,28,3339234859,-47414327
1648513003,195045,true,3386310555,28,3338900969,-47409586
1648513014,195044,true,3386649186,28,3338900969,-47748217
1648513505,195045,true,3386310555,28,3338567113,-47743442
1648513531,195047,true,3385633394,28,3338900969,-46732425
1648513539,195047,true,3385633394,28,3338900969,-46732425
1648513593,195047,true,3385633394,28,3339568783,-46064611
1648513841,195047,true,3385633394,28,3342241373,-43392021
1648513878,195049,true,3384956369,28,3342909855,-42046514
1648514081,195049,true,3384956369,28,3344916102,-40040267
1648514213,195049,true,3384956369,28,3346588895,-38367474
1648514248,195049,true,3384956369,28,3346923554,-38032815
1648514730,195051,true,3384279479,28,3351947455,-32332024
1648514733,195052,true,3383941085,28,3351947455,-31993630
1648514772,195052,true,3383941085,28,3352617878,-31323207
1648516405,195051,true,3384279479,28,3367064450,-17215029
1648516513,195053,true,3383602725,28,3367401157,-16201568
1648516689,195053,true,3383602725,28,3367737897,-15864828
1648517676,195054,true,3383264399,28,3368074671,-15189728
1648517833,195053,true,3383602725,28,3368074671,-15528054
1648517909,195055,true,3382926106,28,3368411478,-14514628
1648517942,195055,true,3382926106,28,3368411478,-14514628
1648518330,195055,true,3382926106,28,3370433030,-12493076
1648518414,195054,true,3383264399,28,3370770074,-12494325
1648518500,195056,true,3382587847,28,3371444261,-11143586
1648518693,195057,true,3382249622,28,3372793041,-9456581
1648518712,195056,true,3382587847,28,3373130321,-9457526
1648518770,195056,true,3382587847,28,3373467634,-9120213
1648520312,195058,true,3381911431,28,3384956369,3044938
1648520376,195059,true,3381573274,28,3384956369,3383095
1648520770,195058,true,3381911431,28,3385633394,3721963
1648520842,195058,true,3381911431,28,3385971958,4060527
1648522205,195060,true,3381235150,28,3392071890,10836740
1648522237,195061,true,3380897060,28,3392071890,11174830
1648522256,195061,true,3380897060,28,3392071890,11174830
1648522315,195060,true,3381235150,28,3392411098,11175948
1648522349,195062,true,3380559005,28,3392411098,11852093
1648522422,195064,true,3379882994,28,3392411098,12528104
1648522783,195064,true,3379882994,28,3391732717,11849723
1648522834,195064,true,3379882994,28,3391732717,11849723
1648523618,195066,true,3379207119,28,3388004049,8796930
1648523632,195068,true,3378531379,28,3387665282,9133903
1648523688,195068,true,3378531379,28,3387326549,8795170
1648523705,195067,true,3378869232,28,3387326549,8457317
1648525841,195069,true,3378193560,28,3380559005,2365445
1648526011,195071,true,3377518022,28,3380559005,3040983
1648526251,195071,true,3377518022,28,3380220982,2702960
1648526965,195070,true,3377855774,28,3379545040,1689266
1648527975,195072,true,3377180304,28,3378531379,1351075
1648528038,195074,true,3376504969,28,3378869232,2364263
1648528061,195074,true,3376504969,28,3378869232,2364263
1648528161,195074,true,3376504969,28,3379207119,2702150
1648528186,195076,true,3375829770,28,3379207119,3377349
1648528585,195078,true,3375154705,28,3380559005,5404300
1648529585,195078,true,3375154705,28,3384279479,9124774
1648530237,195077,true,3375492220,28,3385633394,10141174
1648530262,195079,true,3374817223,28,3385633394,10816171
1648530353,195081,true,3374142361,28,3385971958,11829597
1648530365,195081,true,3374142361,28,3385971958,11829597
1648530857,195080,true,3374479775,28,3387326549,12846774
1648531146,195081,true,3374142361,28,3388004049,13861688
1648531702,195083,true,3373467634,28,3389698390,16230756
1648531884,195083,true,3373467634,28,3390037359,16569725
1648531888,195081,true,3374142361,28,3390037359,15894998
1648532003,195083,true,3373467634,28,3390376363,16908729
1648532070,195084,true,3373130321,28,3390715401,17585080
1648532081,195084,true,3373130321,28,3390715401,17585080
1648532547,195083,true,3373467634,28,3391054472,17586838
1648532678,195084,true,3373130321,28,3391393578,18263257
1648532705,195085,true,3372793041,28,3391393578,18600537
1648532716,195085,true,3372793041,28,3391393578,18600537
1648533048,195083,true,3373467634,28,3393768266,20300632
1648534206,195083,true,3373467634,28,3401922683,28455049
1648534283,195084,true,3373130321,28,3402603102,29472781
1648534621,195083,true,3373467634,28,3403964347,30496713
1648535002,195081,true,3374142361,28,3404985638,30843277
1648535057,195082,true,3373804981,28,3405326137,31521156
1648535142,195082,true,3373804981,28,3405666670,31861689
1648535183,195081,true,3374142361,28,3405666670,31524309
1648535195,195078,true,3375154705,28,3405666670,30511965
1648535234,195078,true,3375154705,28,3406007236,30852531
1648535355,195078,true,3375154705,28,3406688472,31533767
1648535547,195077,true,3375492220,28,3407710581,32218361
1648536442,195074,true,3376504969,28,3412484478,35979509
1648536454,195074,true,3376504969,28,3412484478,35979509
1648536481,195074,true,3376504969,28,3412484478,35979509
1648536487,195073,true,3376842620,28,3412484478,35641858
1648536663,195071,true,3377518022,28,3412825726,35307704
1648536774,195070,true,3377855774,28,3413167009,35311235
1648537802,195071,true,3377518022,28,3413508325,35990303
1648538355,195070,true,3377855774,28,3413508325,35652551
1648538428,195067,true,3378869232,28,3413508325,34639093
1648538841,195066,true,3379207119,28,3413167009,33959890
1648539007,195066,true,3379207119,28,3413167009,33959890
1648539236,195065,true,3379545040,28,3412825726,33280686
1648539301,195062,true,3380559005,28,3412825726,32266721
1648539526,195061,true,3380897060,28,3412484478,31587418
1648539870,195061,true,3380897060,28,3411802083,30905023
1648539884,195059,true,3381573274,28,3411460937,29887663
1648539928,195056,true,3382587847,28,3411460937,28873090
1648539960,195055,true,3382926106,28,3411460937,28534831
1648540041,195055,true,3382926106,28,3411119825,28193719
1648540160,195054,true,3383264399,28,3410437703,27173304
1648540464,195051,true,3384279479,28,3409073869,24794390
1648540609,195049,true,3384956369,28,3408392157,23435788
1648540733,195049,true,3384956369,28,3407710581,22754212
1648540784,195047,true,3385633394,28,3407369844,21736450
1648540871,195044,true,3386649186,28,3406688472,20039286
1648540972,195042,true,3387326549,28,3406007236,18680687
1648541074,195041,true,3387665282,28,3404985638,17320356
1648541231,195040,true,3388004049,28,3403964347,15960298
1648541332,195037,true,3389020552,28,3403283656,14263104
1648541727,195035,true,3389698390,28,3401242401,11544011
1648541737,195035,true,3389698390,28,3401242401,11544011
1648541857,195034,true,3390037359,28,3400902310,10864951
1648541866,195031,true,3391054472,28,3400902310,9847838
1648542103,195030,true,3391393578,28,3400562254,9168676
1648542124,195029,true,3391732717,28,3400562254,8829537
1648542369,195028,true,3392071890,28,3400222232,8150342
1648542889,195025,true,3393089614,28,3400902310,7812696
1648543071,195024,true,3393428923,28,3401242401,7813478
1648543153,195024,true,3393428923,28,3401242401,7813478
1648543200,195023,true,3393768266,28,3401582525,7814259
1648543242,195020,true,3394786498,28,3401582525,6796027
1648543276,195019,true,3395125976,28,3401582525,6456549
1648543441,195019,true,3395125976,28,3402262875,7136899
1648543470,195018,true,3395465489,28,3402262875,6797386
1648543617,195016,true,3396144616,28,3402943362,6798746
1648543710,195015,true,3396484231,28,3403283656,6799425
1648543756,195015,true,3396484231,28,3403283656,6799425
1648544394,195013,true,3397163561,28,3406347837,9184276
1648544547,195012,true,3397503278,28,3407029141,9525863
1648544681,195011,true,3397843028,28,3407710581,9867553
1648544692,195010,true,3398182812,28,3407710581,9527769
1648544694,195009,true,3398522631,28,3407710581,9187950
1648544784,195008,true,3398862483,28,3408392157,9529674
1648544824,195007,true,3399202369,28,3408732996,9530627
1648544859,195007,true,3399202369,28,3408732996,9530627
1648544924,195006,true,3399542289,28,3409414777,9872488
1648544943,195004,true,3400222232,28,3409414777,9192545
1648545257,195003,true,3400562254,28,3412484478,11922224
1648545271,195003,true,3400562254,28,3412484478,11922224
1648545392,195002,true,3400902310,28,3413508325,12606015
1648545403,195001,true,3401242401,28,3413849676,12607275
1648545469,195000,true,3401582525,28,3414532480,12949955
1648545524,194999,true,3401922683,28,3415215421,13292738
1648545585,194998,true,3402262875,28,3416240088,13977213
1648548335,194996,true,3402943362,28,3434049911,31106549
1648549045,194995,true,3403283656,28,3434049911,30766255
1648549097,194994,true,3403623985,28,3434049911,30425926
1648549149,194993,true,3403964347,28,3434049911,30085564
1648549223,194992,true,3404304743,28,3434049911,29745168
1648549443,194990,true,3404985638,28,3433363204,28377566
1648549606,194990,true,3404985638,28,3433019902,28034264
1648550754,194989,true,3405326137,28,3429245845,23919708
1648551865,194987,true,3406007236,28,3428560099,22552863
1648552007,194985,true,3406688472,28,3429245845,22557373
1648552193,194985,true,3406688472,28,3429588770,22900298
1648552323,194983,true,3407369844,28,3429931729,22561885
1648552339,194981,true,3408051352,28,3429931729,21880377
1648552374,194980,true,3408392157,28,3430274722,21882565
1648552429,194979,true,3408732996,28,3430274722,21541726
1648553253,194977,true,3409414777,28,3435767280,26352503
1648553637,194975,true,3410096694,28,3438173038,28076344
1648553971,194974,true,3410437703,28,3439204594,28766891
1648554253,194973,true,3410778747,28,3439892469,29113722
1648554453,194971,true,3411460937,28,3440580482,29119545
1648554507,194969,true,3412143263,28,3440924540,28781277
1648554571,194967,true,3412825726,28,3441612759,28787033
1648554623,194966,true,3413167009,28,3441956920,28789911
1648554659,194964,true,3413849676,28,3442301116,28451440
1648554876,194962,true,3414532480,28,3444022611,29490131
1648554913,194961,true,3414873933,28,3444367013,29493080
1648554953,194959,true,3415556942,28,3445055921,29498979
1648555482,194957,true,3416240088,28,3451607422,35367334
1648555635,194955,true,3416923370,28,3453678904,36755534
1648555717,194953,true,3417606789,28,3454715111,37108322
1648555781,194952,true,3417948550,28,3455751629,37803079
1648555873,194949,true,3418974037,28,3457134137,38160100
1648555905,194947,true,3419657866,28,3457825599,38167733
1648555923,194945,true,3420341832,28,3457825599,37483767
1648556441,194944,true,3420683866,28,3464401384,43717518
1648556493,194941,true,3421710174,28,3464747824,43037650
1648556503,194940,true,3422052345,28,3465094299,43041954
1648556747,194938,true,3422736789,28,3466827192,44090403
1648556845,194937,true,3423079063,28,3467520592,44441529
1648556846,194934,true,3424106089,28,3467520592,43414503
1648556960,194933,true,3424448500,28,3467867344,43418844
1648557085,194932,true,3424790945,28,3468560953,43770008
1648557360,194930,true,3425475937,28,3469948585,44472648
1648557529,194928,true,3426161067,28,3470295580,44134513
1648557568,194927,true,3426503683,28,3470642610,44138927
1648558178,194926,true,3426846333,28,3470642610,43796277
1648558848,194924,true,3427531737,28,3469948585,42416848
1648558898,194922,true,3428217277,28,3469948585,41731308
1648560195,194921,true,3428560099,28,3468560953,40000854
1648560489,194920,true,3428902955,28,3468214131,39311176
1648560645,194919,true,3429245845,28,3467520592,38274747
1648561207,194916,true,3430274722,28,3466827192,36552470
1648561280,194915,true,3430617749,28,3466480544,35862795
1648561460,194915,true,3430617749,28,3465440808,34823059
1648561573,194914,true,3430960811,28,3464401384,33440573
1648561612,194912,true,3431647038,28,3464401384,32754346
1648561688,194911,true,3431990202,28,3463362271,31372069
1648561702,194911,true,3431990202,28,3463362271,31372069
1648561713,194910,true,3432333401,28,3463362271,31028870
1648562539,194909,true,3432676635,28,3450572146,17895511
1648563124,194908,true,3433019902,28,3442989611,9969709
1648563682,194908,true,3433019902,28,3439548514,6528612
1648564216,194907,true,3433363204,28,3439892469,6529265
1648564315,194906,true,3433706541,28,3439892469,6185928
1648564331,194905,true,3434049911,28,3439892469,5842558
1648564538,194904,true,3434393316,28,3440236458,5843142
1648564586,194903,true,3434736756,28,3440580482,5843726
1648564595,194902,true,3435080229,28,3440580482,5500253
1648565023,194901,true,3435423737,28,3441956920,6533183
1648565454,194900,true,3435767280,28,3443678243,7910963
1648565950,194899,true,3436110856,28,3445400427,9289571
1648566450,194897,true,3436798113,28,3446089541,9291428
1648567711,194896,true,3437141793,28,3448157712,11015919
1648568267,194895,true,3437485507,28,3448847378,11361871
1648568309,194893,true,3438173038,28,3448847378,10674340
1648568343,194892,true,3438516856,28,3448847378,10330522
1648568434,194891,true,3438860707,28,3448847378,9986671
1648568477,194890,true,3439204594,28,3448502528,9297934
1648568659,194889,true,3439548514,28,3447812931,8264417
1648568717,194888,true,3439892469,28,3447468184,7575715
1648568792,194887,true,3440236458,28,3446778794,6542336
1648568821,194886,true,3440580482,28,3446434150,5853668
1648568826,194885,true,3440924540,28,3446434150,5509610
1648568846,194885,true,3440924540,28,3446089541,5165001
1648568879,194884,true,3441268632,28,3445744967,4476335
1648569066,194885,true,3440924540,28,3441956920,1032380
1648569086,194884,true,3441268632,28,3441268632,0
1648569112,194883,true,3441612759,28,3440924540,-688219
1648569142,194883,true,3441612759,28,3440236458,-1376301
1648569457,194884,true,3441268632,28,3432676635,-8591997
1648569730,194884,true,3441268632,28,3426503683,-14764949
1648569803,194883,true,3441612759,28,3424790945,-16821814
1648570070,194883,true,3441612759,28,3417948550,-23664209
1648570124,194884,true,3441268632,28,3416581712,-24686920
1648570162,194884,true,3441268632,28,3415556942,-25711690
1648570175,194884,true,3441268632,28,3415215421,-26053211
1648570217,194884,true,3441268632,28,3414191061,-27077571
1648570250,194886,true,3440580482,28,3413167009,-27413473
1648570252,194886,true,3440580482,28,3413167009,-27413473
1648570278,194885,true,3440924540,28,3412484478,-28440062
1648570374,194886,true,3440580482,28,3409755718,-30824764
1648570425,194888,true,3439892469,28,3408051352,-31841117
1648570443,194888,true,3439892469,28,3407710581,-32181888
1648570452,194888,true,3439892469,28,3407369844,-32522625
1648570460,194889,true,3439548514,28,3407029141,-32519373
1648570483,194892,true,3438516856,28,3406347837,-32169019
1648570812,194892,true,3438516856,28,3398862483,-39654373
1648570855,194892,true,3438516856,28,3398182812,-40334044
1648570907,194893,true,3438173038,28,3397843028,-40330010
1648571003,194896,true,3437141793,28,3396823879,-40317914
1648571063,194896,true,3437141793,28,3396484231,-40657562
1648571079,194896,true,3437141793,28,3396144616,-40997177
1648571862,194897,true,3436798113,28,3391732717,-45065396
1648571898,194900,true,3435767280,28,3391393578,-44373702
1648571910,194900,true,3435767280,28,3391393578,-44373702
1648571921,194900,true,3435767280,28,3391393578,-44373702
1648571938,194901,true,3435423737,28,3391393578,-44030159
1648572076,194903,true,3434736756,28,3392411098,-42325658
1648572107,194902,true,3435080229,28,3392750339,-42329890
1648572184,194903,true,3434736756,28,3393428923,-41307833
1648572227,194903,true,3434736756,28,3394107642,-40629114
1648572284,194904,true,3434393316,28,3394786498,-39606818
1648572301,194904,true,3434393316,28,3395125976,-39267340
1648572322,194904,true,3434393316,28,3395465489,-38927827
1648572510,194905,true,3434049911,28,3398862483,-35187428
1648572587,194906,true,3433706541,28,3400222232,-33484309
1648572842,194906,true,3433706541,28,3403964347,-29742194
1648573769,194907,true,3433363204,28,3414191061,-19172143
1648574241,194908,true,3433019902,28,3415215421,-17804481
1648574267,194909,true,3432676635,28,3415215421,-17461214
1648574279,194909,true,3432676635,28,3415215421,-17461214
1648574316,194910,true,3432333401,28,3415215421,-17117980
1648574406,194911,true,3431990202,28,3414873933,-17116269
1648574455,194913,true,3431303907,28,3414191061,-17112846
1648574482,194914,true,3430960811,28,3414191061,-16769750
1648574505,194915,true,3430617749,28,3413849676,-16768073
1648574539,194917,true,3429931729,28,3413508325,-16423404
1648574939,194919,true,3429245845,28,3409073869,-20171976
1648576452,194920,true,3428902955,28,3393768266,-35134689
1648576911,194922,true,3428217277,28,3393428923,-34788354
1648577003,194924,true,3427531737,28,3393768266,-33763471
1648577022,194927,true,3426503683,28,3393768266,-32735417
1648577186,194927,true,3426503683,28,3394447053,-32056630
1648577385,194929,true,3425818485,28,3395125976,-30692509
1648578019,194931,true,3425133424,28,3397843028,-27290396
1648578585,194933,true,3424448500,28,3400562254,-23886246
1648579942,194934,true,3424106089,28,3403623985,-20482104
1648579973,194936,true,3423421371,28,3403623985,-19797386
1648580002,194938,true,3422736789,28,3403623985,-19112804
1648580165,194940,true,3422052345,28,3403964347,-18087998
1648580331,194941,true,3421710174,28,3404645174,-17065000
1648580572,194942,true,3421368037,28,3405326137,-16041900
1648580778,194945,true,3420341832,28,3406347837,-13993995
1648580963,194946,true,3419999832,28,3407369844,-12629988
1648580970,194947,true,3419657866,28,3407369844,-12288022
1648580975,194948,true,3419315934,28,3407369844,-11946090
1648580992,194950,true,3418632174,28,3407710581,-10921593
1648581160,194952,true,3417948550,28,3409414777,-8533773
1648581352,194952,true,3417948550,28,3411460937,-6487613
1648581397,194953,true,3417606789,28,3412143263,-5463526
1648581412,194955,true,3416923370,28,3412143263,-4780107
1648581475,194956,true,3416581712,28,3412825726,-3755986
1648581516,194956,true,3416581712,28,3413508325,-3073387
1648581519,194957,true,3416240088,28,3413508325,-2731763
1648581600,194959,true,3415556942,28,3414873933,-683009
1648581619,194960,true,3415215421,28,3415215421,0
1648582011,194959,true,3415556942,28,3420683866,5126924
1648583250,194960,true,3415215421,28,3432333401,17117980
1648583732,194961,true,3414873933,28,3433706541,18832608
1648584154,194961,true,3414873933,28,3434393316,19519383
1648584165,194961,true,3414873933,28,3434393316,19519383
1648586280,194961,true,3414873933,28,3428560099,13686166
1648586482,194962,true,3414532480,28,3428560099,14027619
1648586510,194963,true,3414191061,28,3428560099,14369038
1648586869,194962,true,3414532480,28,3427874490,13342010
1648587037,194962,true,3414532480,28,3427531737,12999257
1648587042,194963,true,3414191061,28,3427531737,13340676
1648587086,194964,true,3413849676,28,3427531737,13682061
1648587255,194965,true,3413508325,28,3425475937,11967612
1648587324,194966,true,3413167009,28,3424448500,11281491
1648587619,194968,true,3412484478,28,3419315934,6831456
1648588328,194969,true,3412143263,28,3407710581,-4432682
1648588895,194970,true,3411802083,28,3398182812,-13619271
1648590201,194971,true,3411460937,28,3394107642,-17353295
1648590544,194973,true,3410778747,28,3392071890,-18706857
1648591073,194975,true,3410096694,28,3386310555,-23786139
1648592370,194977,true,3409414777,28,3373804981,-35609796
1648593200,194979,true,3408732996,28,3373130321,-35602675
1648593204,194981,true,3408051352,28,3373130321,-34921031
1648593268,194983,true,3407369844,28,3372793041,-34576803
1648593278,194984,true,3407029141,28,3372793041,-34236100
1648593345,194987,true,3406007236,28,3372118584,-33888652
1648593404,194989,true,3405326137,28,3371781406,-33544731
1648593483,194991,true,3404645174,28,3371107151,-33538023
1648593495,194992,true,3404304743,28,3371107151,-33197592
1648593535,194995,true,3403283656,28,3370770074,-32513582
1648593635,194996,true,3402943362,28,3370433030,-32510332
1648593667,194996,true,3402943362,28,3370096021,-32847341
1648593973,194997,true,3402603102,28,3369759045,-32844057
1648594016,194999,true,3401922683,28,3370096021,-31826662
1648594077,195000,true,3401582525,28,3370096021,-31486504
1648594250,195000,true,3401582525,28,3370433030,-31149495
1648594297,195000,true,3401582525,28,3370770074,-30812451
1648594642,195002,true,3400902310,28,3372118584,-28783726
1648594847,195003,true,3400562254,28,3373130321,-27431933
1648595049,195002,true,3400902310,28,3374142361,-26759949
1648595897,195002,true,3400902310,28,3380220982,-20681328
1648596205,195005,true,3399882244,28,3381235150,-18647094
1648596293,195005,true,3399882244,28,3381573274,-18308970
1648596594,195004,true,3400222232,28,3382926106,-17296126
1648596795,195003,true,3400562254,28,3383602725,-16959529
1648597362,195005,true,3399882244,28,3386987851,-12894393
1648597793,195005,true,3399882244,28,3389359454,-10522790
1648597961,195004,true,3400222232,28,3390376363,-9845869
1648598232,195003,true,3400562254,28,3391732717,-8829537
1648599568,195005,true,3399882244,28,3396144616,-3737628
1648599679,195004,true,3400222232,28,3395805036,-4417196
1648599790,195003,true,3400562254,28,3395805036,-4757218
1648600085,195002,true,3400902310,28,3394447053,-6455257
1648600128,195004,true,3400222232,28,3394107642,-6114590
1648600333,195004,true,3400222232,28,3392750339,-7471893
1648600380,195003,true,3400562254,28,3392411098,-8151156
1648600413,195003,true,3400562254,28,3392071890,-8490364
1648600559,195005,true,3399882244,28,3390376363,-9505881
1648600778,195006,true,3399542289,28,3387665282,-11877007
1648600843,195005,true,3399882244,28,3386987851,-12894393
1648601460,195005,true,3399882244,28,3377518022,-22364222
1648601841,195008,true,3398862483,28,3373130321,-25732162
1648603019,195009,true,3398522631,28,3368074671,-30447960
1648604194,195009,true,3398522631,28,3368748319,-29774312
1648604370,195009,true,3398522631,28,3369085194,-29437437
1648604396,195012,true,3397503278,28,3368748319,-28754959
1648604461,195013,true,3397163561,28,3368748319,-28415242
1648604490,195013,true,3397163561,28,3368748319,-28415242
1648604518,195014,true,3396823879,28,3368748319,-28075560
1648604555,195017,true,3395805036,28,3368411478,-27393558
1648604581,195019,true,3395125976,28,3368411478,-26714498
1648604604,195019,true,3395125976,28,3368074671,-27051305
1648604667,195021,true,3394447053,28,3367401157,-27045896
1648604713,195024,true,3393428923,28,3367064450,-26364473
1648604730,195026,true,3392750339,28,3366727778,-26022561
1648605360,195026,true,3392750339,28,3359665420,-33084919
1648605565,195028,true,3392071890,28,3357314595,-34757295
1648605831,195031,true,3391054472,28,3353959126,-37095346
1648606033,195032,true,3390715401,28,3351612294,-39103107
1648606290,195032,true,3390715401,28,3348932210,-41783191
1648606320,195034,true,3390037359,28,3348597350,-41440009
1648606427,195037,true,3389020552,28,3348597350,-40423202
1648606441,195037,true,3389020552,28,3348597350,-40423202
1648606494,195037,true,3389020552,28,3348597350,-40423202
1648606575,195038,true,3388681683,28,3348932210,-39749473
1648606978,195041,true,3387665282,28,3350942072,-36723210
1648607626,195041,true,3387665282,28,3354294522,-33370760
1648607684,195041,true,3387665282,28,3354629952,-33035330
1648607700,195042,true,3387326549,28,3354629952,-32696597
1648607841,195045,true,3386310555,28,3355636441,-30674114
1648608002,195045,true,3386310555,28,3356643233,-29667322
1648608055,195045,true,3386310555,28,3357314595,-28995960
1648608075,195046,true,3385971958,28,3357314595,-28657363
1648608168,195049,true,3384956369,28,3358321890,-26634479
1648608184,195049,true,3384956369,28,3358321890,-26634479
1648608741,195049,true,3384956369,28,3362017892,-22938477
1648608813,195051,true,3384279479,28,3362690329,-21589150
1648609377,195053,true,3383602725,28,3365717961,-17884764
1648609493,195054,true,3383264399,28,3366727778,-16536621
1648609562,195054,true,3383264399,28,3367064450,-16199949
1648609563,195055,true,3382926106,28,3367064450,-15861656
1648609816,195058,true,3381911431,28,3368748319,-13163112
1648609821,195058,true,3381911431,28,3368748319,-13163112
1648609839,195058,true,3381911431,28,3369085194,-12826237
1648609879,195060,true,3381235150,28,3369085194,-12149956
1648610017,195063,true,3380220982,28,3369759045,-10461937
1648610676,195063,true,3380220982,28,3373130321,-7090661
1648610872,195064,true,3379882994,28,3374142361,-5740633
1648613215,195065,true,3379545040,28,3378869232,-675808
1648613267,195068,true,3378531379,28,3378869232,337853
1648613364,195068,true,3378531379,28,3379207119,675740
1648614875,195069,true,3378193560,28,3382587847,4394287
1648614966,195070,true,3377855774,28,3382926106,5070332
1648615003,195073,true,3376842620,28,3382926106,6083486
1648615031,195074,true,3376504969,28,3382926106,6421137
1648615305,195074,true,3376504969,28,3382249622,5744653
1648615405,195076,true,3375829770,28,3381911431,6081661
1648615435,195079,true,3374817223,28,3381911431,7094208
1648617170,195079,true,3374817223,28,3374479775,-337448
1648617888,195080,true,3374479775,28,3375154705,674930
1648617959,195082,true,3373804981,28,3375154705,1349724
1648617993,195084,true,3373130321,28,3375154705,2024384
1648618106,195085,true,3372793041,28,3375829770,3036729
1648618132,195085,true,3372793041,28,3375829770,3036729
1648618158,195086,true,3372455796,28,3375829770,3373974
1648619778,195086,true,3372455796,28,3389698390,17242594
1648619839,195086,true,3372455796,28,3390376363,17920567
1648620197,195086,true,3372455796,28,3392411098,19955302
1648620206,195086,true,3372455796,28,3392411098,19955302
1648620209,195086,true,3372455796,28,3392411098,19955302
1648620392,195085,true,3372793041,28,3393768266,20975225
1648620405,195084,true,3373130321,28,3393768266,20637945
1648620444,195084,true,3373130321,28,3394107642,20977321
1648620462,195083,true,3373467634,28,3394107642,20640008
1648620478,195082,true,3373804981,28,3394447053,20642072
1648620503,195081,true,3374142361,28,3394447053,20304692
1648620618,195080,true,3374479775,28,3395465489,20985714
1648621437,195077,true,3375492220,28,3406007236,30515016
1648622156,195077,true,3375492220,28,3412484478,36992258
1648622296,195075,true,3376167353,28,3413167009,36999656
1648622339,195075,true,3376167353,28,3413167009,36999656
1648622479,195072,true,3377180304,28,3413167009,35986705
1648622583,195072,true,3377180304,28,3412484478,35304174
1648622701,195071,true,3377518022,28,3412143263,34625241
1648622956,195071,true,3377518022,28,3410778747,33260725
1648622988,195068,true,3378531379,28,3410778747,32247368
1648623253,195068,true,3378531379,28,3409073869,30542490
1648623346,195068,true,3378531379,28,3408732996,30201617
1648624107,195068,true,3378531379,28,3404645174,26113795
1648624575,195066,true,3379207119,28,3404304743,25097624
1648624711,195066,true,3379207119,28,3404304743,25097624
1648625593,195065,true,3379545040,28,3403964347,24419307
1648625703,195066,true,3379207119,28,3404304743,25097624
1648625711,195063,true,3380220982,28,3404304743,24083761
1648625773,195063,true,3380220982,28,3404304743,24083761
1648626930,195063,true,3380220982,28,3405326137,25105155
1648627060,195064,true,3379882994,28,3405326137,25443143
1648627137,195061,true,3380897060,28,3405666670,24769610
1648627301,195062,true,3380559005,28,3406007236,25448231
1648627518,195061,true,3380897060,28,3406347837,25450777
1648627532,195062,true,3380559005,28,3406347837,25788832
1648627554,195060,true,3381235150,28,3406347837,25112687
1648627577,195060,true,3381235150,28,3406347837,25112687
1648627585,195060,true,3381235150,28,3406347837,25112687
1648627609,195061,true,3380897060,28,3406347837,25450777
1648627617,195059,true,3381573274,28,3406347837,24774563
1648627896,195059,true,3381573274,28,3405326137,23752863
1648629058,195059,true,3381573274,28,3401242401,19669127
1648629578,195059,true,3381573274,28,3399882244,18308970
1648629938,195057,true,3382249622,28,3399882244,17632622
1648630674,195057,true,3382249622,28,3400902310,18652688
1648630721,195056,true,3382587847,28,3400902310,18314463
1648630907,195056,true,3382587847,28,3400902310,18314463
1648631394,195053,true,3383602725,28,3401242401,17639676
1648631564,195053,true,3383602725,28,3401242401,17639676
1648631615,195052,true,3383941085,28,3401242401,17301316
1648631842,195052,true,3383941085,28,3401242401,17301316
1648631907,195050,true,3384617907,28,3401242401,16624494
1648632018,195050,true,3384617907,28,3401242401,16624494
1648632600,195049,true,3384956369,28,3401242401,16286032
1648633065,195049,true,3384956369,28,3401242401,16286032
1648633192,195046,true,3385971958,28,3401242401,15270443
1648633353,195045,true,3386310555,28,3400902310,14591755
1648633482,195045,true,3386310555,28,3399542289,13231734
1648633588,195045,true,3386310555,28,3398522631,12212076
1648633869,195042,true,3387326549,28,3395465489,8138940
1648633909,195042,true,3387326549,28,3395125976,7799427
1648634099,195041,true,3387665282,28,3393428923,5763641
1648634128,195041,true,3387665282,28,3393089614,5424332
1648634509,195038,true,3388681683,28,3389698390,1016707
1648636144,195038,true,3388681683,28,3386987851,-1693832
1648636204,195037,true,3389020552,28,3386987851,-2032701
1648636616,195037,true,3389020552,28,3387326549,-1694003
1648636804,195034,true,3390037359,28,3387665282,-2372077
1648636927,195034,true,3390037359,28,3388004049,-2033310
1648636959,195033,true,3390376363,28,3388004049,-2372314
1648636985,195033,true,3390376363,28,3388342849,-2033514
1648637081,195030,true,3391393578,28,3388681683,-2711895
1648637627,195030,true,3391393578,28,3390376363,-1017215
1648637761,195029,true,3391732717,28,3391054472,-678245
1648637984,195029,true,3391732717,28,3391732717,0
1648638350,195026,true,3392750339,28,3393089614,339275
1648638378,195026,true,3392750339,28,3393089614,339275
1648638796,195026,true,3392750339,28,3394107642,1357303
1648639084,195025,true,3393089614,28,3394447053,1357439
1648639286,195023,true,3393768266,28,3395125976,1357710
1648639334,195023,true,3393768266,28,3395465489,1697223
1648639614,195022,true,3394107642,28,3396484231,2376589
1648639698,195022,true,3394107642,28,3396823879,2716237
1648639807,195019,true,3395125976,28,3397503278,2377302
1648639899,195019,true,3395125976,28,3398522631,3396655
1648639930,195018,true,3395465489,28,3398522631,3057142
1648640818,195018,true,3395465489,28,3405666670,10201181
1648641002,195015,true,3396484231,28,3407029141,10544910
1648642086,195015,true,3396484231,28,3409414777,12930546
1648642216,195015,true,3396484231,28,3409414777,12930546
1648642264,195014,true,3396823879,28,3409414777,12590898
1648642373,195012,true,3397503278,28,3409073869,11570591
1648642395,195012,true,3397503278,28,3409073869,11570591
1648642619,195012,true,3397503278,28,3407710581,10207303
1648642843,195011,true,3397843028,28,3406688472,8845444
1648643779,195010,true,3398182812,28,3402262875,4080063
1648644167,195010,true,3398182812,28,3401242401,3059589
1648644231,195010,true,3398182812,28,3401242401,3059589
1648645909,195010,true,3398182812,28,3399882244,1699432
1648645968,195008,true,3398862483,28,3399542289,679806
1648646194,195008,true,3398862483,28,3398862483,0
1648646334,195008,true,3398862483,28,3398522631,-339852
1648646646,195008,true,3398862483,28,3396823879,-2038604
1648647381,195006,true,3399542289,28,3393428923,-6113366
1648647415,195007,true,3399202369,28,3393428923,-5773446
1648647439,195006,true,3399542289,28,3393089614,-6452675
1648647479,195006,true,3399542289,28,3392750339,-6791950
1648647505,195006,true,3399542289,28,3392411098,-7131191
1648647535,195006,true,3399542289,28,3392071890,-7470399
1648647983,195006,true,3399542289,28,3386649186,-12893103
1648648453,195007,true,3399202369,28,3382587847,-16614522
1648648534,195007,true,3399202369,28,3381911431,-17290938
1648648557,195008,true,3398862483,28,3381573274,-17289209
1648648815,195008,true,3398862483,28,3379545040,-19317443
1648648970,195009,true,3398522631,28,3378193560,-20329071
1648648973,195009,true,3398522631,28,3378193560,-20329071
1648648977,195010,true,3398182812,28,3378193560,-19989252
1648648996,195011,true,3397843028,28,3377855774,-19987254
1648649483,195012,true,3397503278,28,3374142361,-23360917
1648650906,195013,true,3397163561,28,3368748319,-28415242
1648651552,195014,true,3396823879,28,3368411478,-28412401
1648651586,195015,true,3396484231,28,3368748319,-27735912
1648651640,195016,true,3396144616,28,3368748319,-27396297
1648652010,195017,true,3395805036,28,3369759045,-26045991
1648652044,195018,true,3395465489,28,3369759045,-25706444
1648652669,195019,true,3395125976,28,3373130321,-21995655
1648652780,195020,true,3394786498,28,3373804981,-20981517
1648652811,195021,true,3394447053,28,3374142361,-20304692
1648652855,195022,true,3394107642,28,3374142361,-19965281
1648652983,195022,true,3394107642,28,3374479775,-19627867
1648653959,195023,true,3393768266,28,3374817223,-18951043
1648653984,195024,true,3393428923,28,3374479775,-18949148
1648654698,195026,true,3392750339,28,3368074671,-24675668
1648654716,195026,true,3392750339,28,3368074671,-24675668
1648654729,195028,true,3392071890,28,3367737897,-24333993
1648655159,195029,true,3391732717,28,3365717961,-26014756
1648655391,195030,true,3391393578,28,3364708448,-26685130
1648655511,195030,true,3391393578,28,3364372011,-27021567
1648655673,195032,true,3390715401,28,3364372011,-26343390
1648655698,195033,true,3390376363,28,3364372011,-26004352
1648655832,195033,true,3390376363,28,3364708448,-25667915
1648656036,195033,true,3390376363,28,3366054533,-24321830
1648656092,195035,true,3389698390,28,3366391138,-23307252
1648657003,195036,true,3389359454,28,3373130321,-16229133
1648657146,195037,true,3389020552,28,3374479775,-14540777
1648657251,195037,true,3389020552,28,3375492220,-13528332
1648657443,195039,true,3388342849,28,3377180304,-11162545
1648657627,195039,true,3388342849,28,3378531379,-9811470
1648657751,195039,true,3388342849,28,3379545040,-8797809
1648658232,195039,true,3388342849,28,3382249622,-6093227
1648658485,195040,true,3388004049,28,3383941085,-4062964
1648658534,195040,true,3388004049,28,3384279479,-3724570
1648658594,195040,true,3388004049,28,3384617907,-3386142
1648658695,195040,true,3388004049,28,3385633394,-2370655
1648658708,195041,true,3387665282,28,3385633394,-2031888
1648658905,195041,true,3387665282,28,3387326549,-338733
1648659012,195041,true,3387665282,28,3388004049,338767
1648659381,195040,true,3388004049,28,3390715401,2711352
1648661780,195042,true,3387326549,28,3398182812,10856263
1648662072,195041,true,3387665282,28,3398182812,10517530
1648662155,195041,true,3387665282,28,3398522631,10857349
1648662182,195041,true,3387665282,28,3398522631,10857349
1648662456,195041,true,3387665282,28,3401922683,14257401
1648662591,195040,true,3388004049,28,3403623985,15619936
1648662693,195039,true,3388342849,28,3404985638,16642789
1648662731,195039,true,3388342849,28,3405326137,16983288
1648662838,195039,true,3388342849,28,3407029141,18686292
1648662853,195037,true,3389020552,28,3407029141,18008589
1648662922,195037,true,3389020552,28,3408051352,19030800
1648662994,195036,true,3389359454,28,3409073869,19714415
1648663049,195035,true,3389698390,28,3410096694,20398304
1648663208,195033,true,3390376363,28,3412825726,22449363
1648663232,195032,true,3390715401,28,3413167009,22451608
1648663431,195031,true,3391054472,28,3416923370,25868898
1648663551,195030,true,3391393578,28,3419315934,27922356
1648663757,195028,true,3392071890,28,3423763713,31691823
1648663839,195027,true,3392411098,28,3425475937,33064839
1648664264,195026,true,3392750339,28,3431303907,38553568
1648664288,195025,true,3393089614,28,3431303907,38214293
1648665655,195023,true,3393768266,28,3431990202,38221936
1648665687,195023,true,3393768266,28,3431647038,37878772
1648665716,195021,true,3394447053,28,3431303907,36856854
1648665913,195021,true,3394447053,28,3429931729,35484676
1648666164,195020,true,3394786498,28,3427874490,33087992
1648666214,195020,true,3394786498,28,3427531737,32745239
1648666544,195019,true,3395125976,28,3425818485,30692509
1648666678,195018,true,3395465489,28,3424790945,29325456
1648666687,195017,true,3395805036,28,3424790945,28985909
1648666706,195017,true,3395805036,28,3424790945,28985909
1648666723,195016,true,3396144616,28,3424448500,28303884
1648666734,195016,true,3396144616,28,3424448500,28303884
1648666783,195016,true,3396144616,28,3423763713,27619097
1648666788,195016,true,3396144616,28,3423763713,27619097
1648666846,195015,true,3396484231,28,3423079063,26594832
1648666906,195016,true,3396144616,28,3422052345,25907729
1648666914,195016,true,3396144616,28,3421710174,25565558
1648666921,195016,true,3396144616,28,3421710174,25565558
1648666954,195016,true,3396144616,28,3421025934,24881318
1648666966,195018,true,3395465489,28,3420683866,25218377
1648667036,195018,true,3395465489,28,3419315934,23850445
1648667106,195018,true,3395465489,28,3417606789,22141300
1648669737,195018,true,3395465489,28,3388342849,-7122640
1648669820,195020,true,3394786498,28,3388342849,-6443649
1648669826,195020,true,3394786498,28,3388342849,-6443649
1648670402,195020,true,3394786498,28,3387665282,-7121216
1648670418,195020,true,3394786498,28,3387665282,-7121216
1648670909,195021,true,3394447053,28,3388681683,-5765370
1648671225,195021,true,3394447053,28,3389359454,-5087599
1648673145,195020,true,3394786498,28,3392411098,-2375400
1648673287,195021,true,3394447053,28,3392411098,-2035955
1648673357,195022,true,3394107642,28,3392750339,-1357303
1648673380,195022,true,3394107642,28,3392750339,-1357303
1648673446,195021,true,3394447053,28,3392750339,-1696714
1648673466,195021,true,3394447053,28,3392750339,-1696714
1648673651,195021,true,3394447053,28,3393768266,-678787
1648673694,195021,true,3394447053,28,3393768266,-678787
1648673821,195020,true,3394786498,28,3394447053,-339445
1648673903,195020,true,3394786498,28,3395125976,339478
1648674214,195020,true,3394786498,28,3398182812,3396314
1648676535,195018,true,3395465489,28,3410778747,15313258
1648676593,195017,true,3395805036,28,3410778747,14973711
1648676752,195017,true,3395805036,28,3410437703,14632667
1648676763,195016,true,3396144616,28,3410437703,14293087
1648678299,195016,true,3396144616,28,3393428923,-2715693
1648678465,195015,true,3396484231,28,3391732717,-4751514
1648678478,195015,true,3396484231,28,3391393578,-5090653
1648678531,195014,true,3396823879,28,3391054472,-5769407
1648678638,195015,true,3396484231,28,3390376363,-6107868
1648679438,195014,true,3396823879,28,3387665282,-9158597
1648685732,195014,true,3396823879,28,3386649186,-10174693
1648686413,195013,true,3397163561,28,3387326549,-9837012
1648686527,195013,true,3397163561,28,3387326549,-9837012
1648686720,195012,true,3397503278,28,3387665282,-9837996
1648686942,195012,true,3397503278,28,3388342849,-9160429
1648686960,195010,true,3398182812,28,3388342849,-9839963
1648687141,195011,true,3397843028,28,3389020552,-8822476
1648687615,195010,true,3398182812,28,3391393578,-6789234
1648687656,195010,true,3398182812,28,3391732717,-6450095
1648687664,195008,true,3398862483,28,3391732717,-7129766
1648687832,195009,true,3398522631,28,3392750339,-5772292
1648687920,195007,true,3399202369,28,3393428923,-5773446
1648688051,195007,true,3399202369,28,3394786498,-4415871
1648688496,195005,true,3399882244,28,3398862483,-1019761
1648689736,195005,true,3399882244,28,3405666670,5784426
1648690889,195004,true,3400222232,28,3405666670,5444438
1648691285,195003,true,3400562254,28,3405666670,5104416
1648691318,195000,true,3401582525,28,3406007236,4424711
1648691344,195001,true,3401242401,28,3406007236,4764835
1648691387,194999,true,3401922683,28,3406007236,4084553
1648691692,194998,true,3402262875,28,3407369844,5106969
1648694750,194995,true,3403283656,28,3414532480,11248824
1648695612,194996,true,3402943362,28,3414532480,11589118
1648695791,194994,true,3403623985,28,3414532480,10908495
1648695795,194993,true,3403964347,28,3414532480,10568133
1648695904,194991,true,3404645174,28,3414532480,9887306
1648695933,194992,true,3404304743,28,3414532480,10227737
1648695970,194991,true,3404645174,28,3414191061,9545887
1648696061,194990,true,3404985638,28,3413849676,8864038
1648696704,194988,true,3405666670,28,3410437703,4771033
1648698874,194990,true,3404985638,28,3404985638,0
1648698910,194989,true,3405326137,28,3404985638,-340499
1648698988,194988,true,3405666670,28,3404985638,-681032
1648699044,194986,true,3406347837,28,3404985638,-1362199
1648700404,194988,true,3405666670,28,3404304743,-1361927
1648700465,194987,true,3406007236,28,3404304743,-1702493
1648700747,194987,true,3406007236,28,3404304743,-1702493
1648700891,194985,true,3406688472,28,3403964347,-2724125
1648701556,194987,true,3406007236,28,3403964347,-2042889
1648701569,194986,true,3406347837,28,3403964347,-2383490
1648702390,194986,true,3406347837,28,3402262875,-4084962
1648702623,194984,true,3407029141,28,3401922683,-5106458
1648702798,194986,true,3406347837,28,3401582525,-4765312
1648702932,194985,true,3406688472,28,3401242401,-5446071
1648703257,194986,true,3406347837,28,3400222232,-6125605
1648703786,194985,true,3406688472,28,3399202369,-7486103
1648704925,194988,true,3405666670,28,3397503278,-8163392
1648705395,194988,true,3405666670,28,3397163561,-8503109
1648706923,194988,true,3405666670,28,3397163561,-8503109
1648706989,194988,true,3405666670,28,3397163561,-8503109
1648707041,194991,true,3404645174,28,3397163561,-7481613
1648707140,194991,true,3404645174,28,3397503278,-7141896
1648710021,194991,true,3404645174,28,3398182812,-6462362
1648710936,194991,true,3404645174,28,3398182812,-6462362
1648711398,194994,true,3403623985,28,3398182812,-5441173
1648713942,194994,true,3403623985,28,3398182812,-5441173
1648714221,194994,true,3403623985,28,3398522631,-5101354
1648714244,194994,true,3403623985,28,3398522631,-5101354
1648714403,194998,true,3402262875,28,3398862483,-3400392
1648714436,194997,true,3402603102,28,3398862483,-3740619
1648714806,194998,true,3402262875,28,3399542289,-2720586
1648714963,194998,true,3402262875,28,3399882244,-2380631
1648715026,195001,true,3401242401,28,3400222232,-1020169
1648715615,195000,true,3401582525,28,3401922683,340158
1648715948,195001,true,3401242401,28,3402603102,1360701
1648716496,195001,true,3401242401,28,3403283656,2041255
1648716653,195003,true,3400562254,28,3403283656,2721402
1648716705,195002,true,3400902310,28,3403283656,2381346
1648716943,195003,true,3400562254,28,3403283656,2721402
1648717239,195002,true,3400902310,28,3403283656,2381346
1648717363,195004,true,3400222232,28,3403283656,3061424
1648717440,195004,true,3400222232,28,3403623985,3401753
1648717824,195004,true,3400222232,28,3404985638,4763406
1648718143,195003,true,3400562254,28,3406007236,5444982
1648718247,195005,true,3399882244,28,3406347837,6465593
1648718375,195004,true,3400222232,28,3406688472,6466240
1648718634,195004,true,3400222232,28,3407369844,7147612
1648719086,195002,true,3400902310,28,3408732996,7830686
1648720185,195004,true,3400222232,28,3408732996,8510764
1648720577,195003,true,3400562254,28,3408732996,8170742
1648720642,195002,true,3400902310,28,3409073869,8171559
1648720708,195001,true,3401242401,28,3409073869,7831468
1648720990,195002,true,3400902310,28,3410437703,9535393
1648721952,195001,true,3401242401,28,3415556942,14314541
1648722444,194999,true,3401922683,28,3417948550,16025867
1648722481,194998,true,3402262875,28,3417948550,15685675
1648723223,194999,true,3401922683,28,3417948550,16025867
1648724222,194997,true,3402603102,28,3417948550,15345448
1648724689,194996,true,3402943362,28,3417948550,15005188
1648725787,194995,true,3403283656,28,3417948550,14664894
1648726172,194996,true,3402943362,28,3417606789,14663427
1648726282,194995,true,3403283656,28,3417606789,14323133
1648726640,194993,true,3403964347,28,3417265062,13300715
1648726720,194992,true,3404304743,28,3417265062,12960319
1648728756,194994,true,3403623985,28,3411460937,7836952
1648729876,194993,true,3403964347,28,3411460937,7496590
1648729890,194992,true,3404304743,28,3411802083,7497340
1648729972,194991,true,3404645174,28,3412143263,7498089
1648729993,194992,true,3404304743,28,3412143263,7838520
1648730015,194991,true,3404645174,28,3412484478,7839304
1648730021,194990,true,3404985638,28,3412484478,7498840
1648730096,194989,true,3405326137,28,3413167009,7840872
1648730535,194990,true,3404985638,28,3419657866,14672228
1648730584,194988,true,3405666670,28,3420683866,15017196
1648730687,194987,true,3406007236,28,3422052345,16045109
1648730727,194986,true,3406347837,28,3422394550,16046713
1648730772,194985,true,3406688472,28,3423079063,16390591
1648731025,194983,true,3407369844,28,3426161067,18791223
1648731712,194982,true,3407710581,28,3434736756,27026175
1648731841,194981,true,3408051352,28,3435423737,27372385
1648732271,194980,true,3408392157,28,3434736756,26344599
1648732289,194978,true,3409073869,28,3434736756,25662887
1648732320,194977,true,3409414777,28,3434393316,24978539
1648732338,194976,true,3409755718,28,3434393316,24637598
1648732380,194976,true,3409755718,28,3433706541,23950823
1648732392,194974,true,3410437703,28,3433706541,23268838
1648732698,194974,true,3410437703,28,3430960811,20523108
1648732741,194973,true,3410778747,28,3430617749,19839002
1648733404,194974,true,3410437703,28,3422736789,12299086
1648733629,194972,true,3411119825,28,3420341832,9222007
1648733649,194972,true,3411119825,28,3419999832,8880007
1648733663,194971,true,3411460937,28,3419999832,8538895
1648733681,194972,true,3411119825,28,3419657866,8538041
1648733705,194971,true,3411460937,28,3419315934,7854997
1648733752,194972,true,3411119825,28,3418290345,7170520
1648734953,194972,true,3411119825,28,3404645174,-6474651
1648734995,194972,true,3411119825,28,3404304743,-6815082
1648735110,194972,true,3411119825,28,3402943362,-8176463
1648735241,194972,true,3411119825,28,3400562254,-10557571
1648735262,194974,true,3410437703,28,3400222232,-10215471
1648735363,194975,true,3410096694,28,3397843028,-12253666
1648735471,194975,true,3410096694,28,3395125976,-14970718
1648735701,194978,true,3409073869,28,3389359454,-19714415
1648735789,194979,true,3408732996,28,3387326549,-21406447
1648736877,194981,true,3408051352,28,3361681724,-46369628
1648736897,194981,true,3408051352,28,3361345589,-46705763
1648736913,194984,true,3407029141,28,3361009488,-46019653
1648736939,194985,true,3406688472,28,3360673421,-46015051
1648737067,194988,true,3405666670,28,3358321890,-47344780
1648737170,194988,true,3405666670,28,3356978897,-48687773
1648737468,194990,true,3404985638,28,3354965415,-50020223
1648737541,194991,true,3404645174,28,3354629952,-50015222
1648737952,194993,true,3403964347,28,3352953140,-51011207
1648737964,194994,true,3403623985,28,3352953140,-50670845
1648737977,194996,true,3402943362,28,3352617878,-50325484
1648737982,194997,true,3402603102,28,3352617878,-49985224
1648738001,194999,true,3401922683,28,3352617878,-49304805
1648738012,194999,true,3401922683,28,3352617878,-49304805
1648738106,195001,true,3401242401,28,3352617878,-48624523
1648738127,195002,true,3400902310,28,3352953140,-47949170
1648738188,195003,true,3400562254,28,3352953140,-47609114
1648738499,195003,true,3400562254,28,3354629952,-45932302
1648738765,195004,true,3400222232,28,3356978897,-43243335
1648738877,195005,true,3399882244,28,3358657722,-41224522
1648739013,195007,true,3399202369,28,3360673421,-38528948
1648739148,195006,true,3399542289,28,3362690329,-36851960
1648739746,195007,true,3399202369,28,3371107151,-28095218
1648740338,195008,true,3398862483,28,3373804981,-25057502
1648740390,195009,true,3398522631,28,3373804981,-24717650
1648740408,195008,true,3398862483,28,3373804981,-25057502
1648740740,195009,true,3398522631,28,3373130321,-25392310
1648740763,195011,true,3397843028,28,3373130321,-24712707
1648740806,195012,true,3397503278,28,3372793041,-24710237
1648740872,195011,true,3397843028,28,3372455796,-25387232
1648741872,195013,true,3397163561,28,3368411478,-28752083
1648741910,195014,true,3396823879,28,3368074671,-28749208
1648742194,195015,true,3396484231,28,3366391138,-30093093
1648742209,195015,true,3396484231,28,3366391138,-30093093
1648742508,195017,true,3395805036,28,3363699237,-32105799
1648742580,195018,true,3395465489,28,3363362901,-32102588
1648742777,195020,true,3394786498,28,3361345589,-33440909
1648742787,195020,true,3394786498,28,3361345589,-33440909
1648742802,195022,true,3394107642,28,3361345589,-32762053
1648742818,195024,true,3393428923,28,3361009488,-32419435
1648742821,195026,true,3392750339,28,3361009488,-31740851
1648742828,195026,true,3392750339,28,3360673421,-32076918
1648742851,195030,true,3391393578,28,3360337387,-31056191
1648743035,195032,true,3390715401,28,3355972005,-34743396
1648743041,195035,true,3389698390,28,3355636441,-34061949
1648743484,195034,true,3390037359,28,3346923554,-43113805
1648743513,195038,true,3388681683,28,3346254269,-42427414
1648743763,195040,true,3388004049,28,3341573025,-46431024
1648743831,195042,true,3387326549,28,3340236730,-47089819
1648743905,195042,true,3387326549,28,3338900969,-48425580
1648743954,195046,true,3385971958,28,3337565743,-48406215
1648743992,195049,true,3384956369,28,3336898330,-48058039
1648744016,195052,true,3383941085,28,3336231050,-47710035
1648744112,195052,true,3383941085,28,3333896622,-50044463
1648744126,195056,true,3382587847,28,3333563266,-49024581
1648744150,195059,true,3381573274,28,3333229943,-48343331
1648744154,195062,true,3380559005,28,3332896653,-47662352
1648744210,195062,true,3380559005,28,3331563828,-48995177
1648744377,195067,true,3378869232,28,3326570478,-52298754
1648744456,195071,true,3377518022,28,3323910419,-53607603
1648744782,195074,true,3376504969,28,3316274591,-60230378
1648744802,195075,true,3376167353,28,3315942997,-60224356
1648744953,195080,true,3374479775,28,3313622765,-60857010
1648745632,195083,true,3373467634,28,3302045935,-71421699
1648745634,195087,true,3372118584,28,3302045935,-70072649
1648745675,195088,true,3371781406,28,3301385625,-70395781
1648745694,195093,true,3370096021,28,3301055519,-69040502
1648745962,195097,true,3368748319,28,3296767150,-71981169
1648746031,195101,true,3367401157,28,3295778317,-71622840
1648746113,195102,true,3367064450,28,3294789782,-72274668
1648747895,195107,true,3365381423,28,3278357768,-87023655
1648747964,195112,true,3363699237,28,3278685604,-85013633
1648748172,195115,true,3362690329,28,3279341374,-83348955
1648748451,195116,true,3362354094,28,3280653307,-81700787
1648748473,195121,true,3360673421,28,3280653307,-80020114
1648748502,195125,true,3359329487,28,3280981373,-78348114
1648749017,195128,true,3358321890,28,3283935437,-74386453
1648749045,195130,true,3357650327,28,3283935437,-73714890
1648749245,195135,true,3355972005,28,3285577734,-70394271
1648749982,195140,true,3354294522,28,3290838603,-63455919
1648750169,195144,true,3352953140,28,3291496803,-61456337
1648750221,195146,true,3352282650,28,3291496803,-60785847
1648750393,195150,true,3350942072,28,3291167686,-59774386
1648750590,195156,true,3348932210,28,3290838603,-58093607
1648750628,195160,true,3347592972,28,3290509552,-57083420
1648750664,195162,true,3346923554,28,3290509552,-56414002
1648750708,195166,true,3345585119,28,3290180534,-55404585
1648750948,195173,true,3343244146,28,3287878328,-55365818
1648751029,195177,true,3341907182,28,3286892162,-55015020
1648751371,195178,true,3341573025,28,3283935437,-57637588
1648751405,195183,true,3339902740,28,3283607077,-56295663
1648751524,195189,true,3337899499,28,3282622192,-55277307
1648751585,195192,true,3336898330,28,3282293962,-54604368
1648751616,195194,true,3336231050,28,3282293962,-53937088
1648751780,195198,true,3334896891,28,3281309471,-53587420
1648751838,195204,true,3332896653,28,3281309471,-51587182
1648752147,195206,true,3332230174,28,3281637602,-50592572
1648752795,195207,true,3331896984,28,3286563506,-45333478
1648752833,195211,true,3330564559,28,3287220851,-43343708
1648752846,195217,true,3328566919,28,3287220851,-41346068
1648753057,195218,true,3328234096,28,3289522596,-38711500
1648753080,195219,true,3327901306,28,3289851548,-38049758
1648753171,195222,true,3326903135,28,3290838603,-36064532
1648753183,195228,true,3324907691,28,3290838603,-34069088
1648753215,195229,true,3324575234,28,3291167686,-33407548
1648753421,195230,true,3324242810,28,3293472195,-30770615
1648753509,195233,true,3323245736,28,3294130922,-29114814
1648753673,195237,true,3321916770,28,3295778317,-26138453
1648754680,195238,true,3321584612,28,3302045935,-19538677
1648754986,195237,true,3321916770,28,3302706377,-19210393
1648755169,195239,true,3321252486,28,3302706377,-18546109
1648755944,195243,true,3319924317,28,3300065401,-19858916
1648755968,195244,true,3319592358,28,3300065401,-19526957
1648756619,195244,true,3319592358,28,3297426536,-22165822
1648757091,195246,true,3318928539,28,3295778317,-23150222
1648757190,195250,true,3317601300,28,3295448772,-22152528
1648757554,195250,true,3317601300,28,3294460336,-23140964
1648757564,195250,true,3317601300,28,3294460336,-23140964
1648757612,195252,true,3316937879,28,3294130922,-22806957
1648757845,195256,true,3315611435,28,3293472195,-22139240
1648757947,195257,true,3315279907,28,3293142881,-22137026
1648757997,195256,true,3315611435,28,3293142881,-22468554
1648758943,195258,true,3314948413,28,3292155135,-22793278
1648759309,195263,true,3313291436,28,3292484351,-20807085
1648759897,195263,true,3313291436,28,3292813599,-20477837
1648760751,195263,true,3313291436,28,3293142881,-20148555
1648762032,195265,true,3312628877,28,3294789782,-17839095
1648762053,195269,true,3311304156,28,3295119261,-16184895
1648762342,195270,true,3310973059,28,3295448772,-15524287
1648762833,195270,true,3310973059,28,3296107895,-14865164
1648763231,195273,true,3309979966,28,3296107895,-13872071
1648764187,195277,true,3308656305,28,3296437506,-12218799
1648764323,195278,true,3308325472,28,3296437506,-11887966
1648764369,195278,true,3308325472,28,3296437506,-11887966
1648764487,195281,true,3307333173,28,3296437506,-10895667
1648764504,195286,true,3305680002,28,3296107895,-9572107
1648764539,195287,true,3305349467,28,3296107895,-9241572
1648764961,195287,true,3305349467,28,3294789782,-10559685
1648764997,195290,true,3304358061,28,3294460336,-9897725
1648765051,195294,true,3303036648,28,3294130922,-8905726
1648767518,195296,true,3302376140,28,3284592257,-17783883
1648767689,195296,true,3302376140,28,3284592257,-17783883
1648767796,195299,true,3301385625,28,3284592257,-16793368
1648769403,195303,true,3300065401,28,3284592257,-15473144
1648769459,195305,true,3299405487,28,3284592257,-14813230
1648769499,195305,true,3299405487,28,3284920717,-14484770
1648770289,195307,true,3298745705,28,3286563506,-12182199
1648770397,195311,true,3297426536,28,3286234882,-11191654
1648770470,195312,true,3297096826,28,3285906291,-11190535
1648770802,195312,true,3297096826,28,3283935437,-13161389
1648771314,195315,true,3296107895,28,3281965766,-14142129
1648771387,195319,true,3294789782,28,3281309471,-13480311
1648771490,195319,true,3294789782,28,3280653307,-14136475
1648771517,195320,true,3294460336,28,3280653307,-13807029
1648771568,195321,true,3294130922,28,3280325275,-13805647
1648771780,195323,true,3293472195,28,3279669308,-13802887
1648771963,195324,true,3293142881,28,3279013473,-14129408
1648772000,195325,true,3292813599,28,3279013473,-13800126
1648772180,195326,true,3292484351,28,3279013473,-13470878
1648772274,195328,true,3291825953,28,3279341374,-12484579
1648772283,195329,true,3291496803,28,3279341374,-12155429
1648772831,195329,true,3291496803,28,3282950454,-8546349
1648773546,195330,true,3291167686,28,3286563506,-4604180
1648773632,195332,true,3290509552,28,3286892162,-3617390
1648773755,195332,true,3290509552,28,3287549573,-2959979
1648773762,195332,true,3290509552,28,3287549573,-2959979
1648773788,195333,true,3290180534,28,3287549573,-2630961
1648773854,195335,true,3289522596,28,3287878328,-1644268
1648773914,195334,true,3289851548,28,3288207116,-1644432
1648774009,195334,true,3289851548,28,3288864790,-986758
1648776353,195333,true,3290180534,28,3299075579,8895045
1648776374,195335,true,3289522596,28,3299075579,9552983
1648777135,195334,true,3289851548,28,3295778317,5926769
1648777558,195334,true,3289851548,28,3293801542,3949994
1648777618,195334,true,3289851548,28,3293472195,3620647
1648777629,195335,true,3289522596,28,3293472195,3949599
1648777846,195335,true,3289522596,28,3291496803,1974207
1648777906,195335,true,3289522596,28,3291167686,1645090
1648778017,195335,true,3289522596,28,3289851548,328952
1648778037,195336,true,3289193677,28,3289522596,328919
1648778080,195336,true,3289193677,28,3288864790,-328887
1648778457,195337,true,3288864790,28,3281965766,-6899024
1648778586,195337,true,3288864790,28,3279669308,-9195482
1648779316,195338,true,3288535937,28,3265924269,-22611668
1648779554,195338,true,3288535937,28,3262007706,-26528231
1648779561,195340,true,3287878328,28,3262007706,-25870622
1648779662,195341,true,3287549573,28,3260051187,-27498386
1648779732,195342,true,3287220851,28,3258747492,-28473359
1648779891,195343,true,3286892162,28,3256141667,-30750495
1648779968,195344,true,3286563506,28,3255165020,-31398486
1648779995,195346,true,3285906291,28,3254839536,-31066755
1648780006,195347,true,3285577734,28,3254839536,-30738198
1648780011,195348,true,3285249209,28,3254839536,-30409673
1648780065,195350,true,3284592257,28,3254188665,-30403592
1648780072,195352,true,3283935437,28,3253863279,-30072158
1648780105,195353,true,3283607077,28,3253537925,-30069152
1648780758,195354,true,3283278749,28,3244765659,-38513090
1648781613,195356,true,3282622192,28,3236664281,-45957911
1648781629,195357,true,3282293962,28,3236664281,-45629681
1648781666,195357,true,3282293962,28,3236340647,-45953315
1648781692,195358,true,3281965766,28,3236017045,-45948721
1648781695,195360,true,3281309471,28,3236017045,-45292426
1648781800,195362,true,3280653307,28,3235369939,-45283368
1648781831,195362,true,3280653307,28,3235046434,-45606873
1648782543,195364,true,3279997275,28,3230520764,-49476511
1648782547,195367,true,3279013473,28,3230520764,-48492709
1648782743,195368,true,3278685604,28,3229228879,-49456725
1648783022,195369,true,3278357768,28,3227614749,-50743019
1648783470,195371,true,3277702195,28,3225033819,-52668376
1648783855,195374,true,3276719081,28,3226001426,-50717655
1648784023,195375,true,3276391442,28,3226646658,-49744784
1648784047,195376,true,3276063836,28,3226646658,-49417178
1648784458,195378,true,3275408721,28,3228583130,-46825591
1648784473,195381,true,3274426295,28,3228583130,-45843165
1648784515,195383,true,3273771508,28,3228583130,-45188378
1648785531,195383,true,3273771508,28,3234722962,-39048546
1648785670,195385,true,3273116852,28,3236017045,-37099807
1648785768,195388,true,3272135113,28,3236664281,-35470832
1648785782,195389,true,3271807932,28,3236987948,-34819984
1648786034,195389,true,3271807932,28,3239254519,-32553413
1648786295,195391,true,3271153669,28,3241522678,-29630991
1648787048,195394,true,3270172519,28,3246063760,-24108759
1648787183,195395,true,3269845535,28,3246713006,-23132529
1648787203,195395,true,3269845535,28,3247037677,-22807858
1648787219,195396,true,3269518583,28,3247037677,-22480906
1648787249,195399,true,3268537923,28,3247362381,-21175542
1648787272,195400,true,3268211102,28,3247362381,-20848721
1648790165,195399,true,3268537923,28,3252236835,-16301088
1648790193,195401,true,3267884314,28,3252236835,-15647479
1648791150,195403,true,3267230835,28,3252887315,-14343520
1648792495,195404,true,3266904145,28,3256467281,-10436864
1648793452,195403,true,3267230835,28,3257444319,-9786516
1648793643,195404,true,3266904145,28,3257770063,-9134082
1648793671,195407,true,3265924269,28,3257770063,-8154206
1648794649,195408,true,3265597709,28,3257118607,-8479102
1648794743,195407,true,3265924269,28,3257118607,-8805662
1648796487,195408,true,3265597709,28,3259073367,-6524342
1648796588,195411,true,3264618226,28,3259073367,-5544859
1648797047,195412,true,3264291797,28,3259725214,-4566583
1648797098,195411,true,3264618226,28,3259725214,-4893012
1648797809,195412,true,3264291797,28,3260377192,-3914605
1648798131,195414,true,3263639036,28,3261355403,-2283633
1648799093,195416,true,3262986407,28,3263965400,978993
1648799130,195414,true,3263639036,28,3263965400,326364
1648799229,195415,true,3263312705,28,3264291797,979092
1648799338,195418,true,3262333907,28,3264618226,2284319
1648799509,195419,true,3262007706,28,3265271182,3263476
1648799744,195417,true,3262660141,28,3266250862,3590721
1648799878,195418,true,3262333907,28,3266904145,4570238
1648799898,195420,true,3261681538,28,3266904145,5222607
1648800118,195421,true,3261355403,28,3267884314,6528911
1648800285,195419,true,3262007706,28,3268864777,6857071
1648800619,195419,true,3262007706,28,3271153669,9145963
1648800660,195421,true,3261355403,28,3271153669,9798266
1648800693,195422,true,3261029300,28,3271480784,10451484
1648800707,195420,true,3261681538,28,3271807932,10126394
1648800748,195420,true,3261681538,28,3272135113,10453575
1648801717,195422,true,3261029300,28,3278685604,17656304
1648801761,195422,true,3261029300,28,3279013473,17984173
1648801810,195420,true,3261681538,28,3279341374,17659836
1648802820,195420,true,3261681538,28,3283607077,21925539
1648802960,195421,true,3261355403,28,3283935437,22580034
1648803311,195421,true,3261355403,28,3284592257,23236854
1648803705,195419,true,3262007706,28,3284920717,22913011
1648804223,195419,true,3262007706,28,3284920717,22913011
1648804782,195421,true,3261355403,28,3284920717,23565314
1648806414,195421,true,3261355403,28,3283607077,22251674
1648806492,195419,true,3262007706,28,3283278749,21271043
1648807270,195419,true,3262007706,28,3281965766,19958060
1648808566,195421,true,3261355403,28,3279997275,18641872
1648809857,195421,true,3261355403,28,3279997275,18641872
1648810902,195420,true,3261681538,28,3279997275,18315737
1648811847,195420,true,3261681538,28,3280653307,18971769
1648811868,195421,true,3261355403,28,3280653307,19297904
1648811906,195422,true,3261029300,28,3280981373,19952073
1648812081,195420,true,3261681538,28,3281637602,19956064
1648812209,195420,true,3261681538,28,3281965766,20284228
1648812355,195421,true,3261355403,28,3282622192,21266789
1648812404,195422,true,3261029300,28,3282950454,21921154
1648812472,195420,true,3261681538,28,3283607077,21925539
1648812759,195420,true,3261681538,28,3285249209,23567671
1648813234,195422,true,3261029300,28,3288207116,27177816
1648814454,195423,true,3260703229,28,3292155135,31451906
1648814533,195421,true,3261355403,28,3292155135,30799732
1648814592,195421,true,3261355403,28,3292155135,30799732
1648814595,195422,true,3261029300,28,3292155135,31125835
1648815186,195423,true,3260703229,28,3289851548,29148319
1648815197,195422,true,3261029300,28,3289851548,28822248
1648815838,195421,true,3261355403,28,3286563506,25208103
1648815866,195422,true,3261029300,28,3286234882,25205582
1648815906,195423,true,3260703229,28,3285906291,25203062
1648815923,195422,true,3261029300,28,3285906291,24876991
1648815933,195421,true,3261355403,28,3285906291,24550888
1648816043,195421,true,3261355403,28,3284592257,23236854
1648816265,195422,true,3261029300,28,3282622192,21592892
1648816320,195420,true,3261681538,28,3282293962,20612424
1648816518,195419,true,3262007706,28,3281309471,19301765
1648816529,195419,true,3262007706,28,3281309471,19301765
1648816566,195419,true,3262007706,28,3281309471,19301765
1648816579,195417,true,3262660141,28,3281309471,18649330
1648816590,195415,true,3263312705,28,3281309471,17996766
1648816654,195414,true,3263639036,28,3281965766,18326730
1648816793,195413,true,3263965400,28,3283278749,19313349
1648816981,195411,true,3264618226,28,3285249209,20630983
1648817077,195408,true,3265597709,28,3286234882,20637173
1648817404,195407,true,3265924269,28,3289522596,23598327
1648817547,195406,true,3266250862,28,3291167686,24916824
1648817942,195403,true,3267230835,28,3296437506,29206671
1648818066,195400,true,3268211102,28,3298415863,30204761
1648818089,195399,true,3268537923,28,3298745705,30207782
1648818112,195399,true,3268537923,28,3299405487,30867564
1648818150,195396,true,3269518583,28,3299735427,30216844
1648818168,195393,true,3270499536,28,3300065401,29565865
1648818237,195391,true,3271153669,28,3301715764,30562095
1648818271,195390,true,3271480784,28,3302376140,30895356
1648818573,195386,true,3272789573,28,3306010570,33220997
1648818677,195382,true,3274098885,28,3307002473,32903588
1648819017,195380,true,3274753738,28,3309979966,35226228
1648819025,195379,true,3275081213,28,3310310964,35229751
1648819027,195376,true,3276063836,28,3310310964,34247128
1648819039,195372,true,3277374458,28,3310310964,32936506
1648819117,195370,true,3278029965,28,3311304156,33274191
1648819147,195369,true,3278357768,28,3311635287,33277519
1648819228,195365,true,3279669308,28,3312628877,32959569
1648819297,195362,true,3280653307,28,3313622765,32969458
1648819327,195360,true,3281309471,28,3313954127,32644656
1648819463,195358,true,3281965766,28,3316274591,34308825
1648819489,195355,true,3282950454,28,3316937879,33987425
1648819592,195352,true,3283935437,28,3318596680,34661243
1648819938,195349,true,3284920717,28,3325240182,40319465
1648819970,195348,true,3285249209,28,3325572706,40323497
1648820007,195345,true,3286234882,28,3326237854,40002972
1648820039,195342,true,3287220851,28,3326903135,39682284
1648820075,195338,true,3288535937,28,3327568549,39032612
1648820254,195337,true,3288864790,28,3330897615,42032825
1648820267,195334,true,3289851548,28,3331230705,41379157
1648820297,195331,true,3290838603,28,3331896984,41058381
1648820340,195327,true,3292155135,28,3332563397,40408262
1648820857,195325,true,3292813599,28,3343578470,50764871
1648821113,195322,true,3293801542,28,3348262524,54460982
1648821155,195319,true,3294789782,28,3348597350,53807568
1648821175,195316,true,3295778317,28,3348932210,53153893
1648821874,195314,true,3296437506,28,3353288435,56850929
1648821921,195312,true,3297096826,28,3353288435,56191609
1648821942,195309,true,3298086054,28,3353623764,55537710
1648821956,195306,true,3299075579,28,3353623764,54548185
1648821999,195304,true,3299735427,28,3353959126,54223699
1648822042,195301,true,3300725447,28,3353959126,53233679
1648822084,195298,true,3301715764,28,3354294522,52578758
1648822119,195295,true,3302706377,28,3354629952,51923575
1648822153,195292,true,3303697288,28,3354629952,50932664
1648822262,195290,true,3304358061,28,3355636441,51278380
1648822289,195286,true,3305680002,28,3355636441,49956439
1648822449,195283,true,3306671805,28,3357314595,50642790
1648822475,195280,true,3307663906,28,3357650327,49986421
1648823124,195277,true,3308656305,28,3367401157,58744852
1648823462,195274,true,3309649001,28,3373467634,63818633
1648823486,195270,true,3310973059,28,3373804981,62831922
1648824030,195268,true,3311635287,28,3381911431,70276144
1648824044,195265,true,3312628877,28,3381911431,69282554
1648824154,195261,true,3313954127,28,3382587847,68633720
1648824182,195258,true,3314948413,28,3382587847,67639434
1648824451,195256,true,3315611435,28,3383602725,67991290
1648824471,195252,true,3316937879,28,3383941085,67003206
1648824500,195249,true,3317933060,28,3383941085,66008025
1648824602,195245,true,3319260432,28,3384956369,65695937
1648824615,195243,true,3319924317,28,3384956369,65032052
1648824879,195239,true,3321252486,28,3388004049,66751563
1648825080,195236,true,3322248962,28,3390376363,68127401
1648825240,195232,true,3323578061,28,3393089614,69511553
1648825264,195230,true,3324242810,28,3393768266,69525456
1648825273,195226,true,3325572706,28,3393768266,68195560
1648825312,195222,true,3326903135,28,3394786498,67883363
1648825472,195217,true,3328566919,28,3398522631,69955712
1648825596,195214,true,3329565589,28,3401582525,72016936
1648825942,195210,true,3330897615,28,3410437703,79540088
1648826151,195207,true,3331896984,28,3415556942,83659958
1648827105,195201,true,3333896622,28,3436454468,102557846
1648827133,195198,true,3334896891,28,3436798113,101901222
1648827278,195194,true,3336231050,28,3437485507,101254457
1648827327,195190,true,3337565743,28,3437829256,100263513
1648827338,195184,true,3339568783,28,3437829256,98260473
1648827633,195181,true,3340570754,28,3438860707,98289953
1648828034,195177,true,3341907182,28,3438860707,96953525
1648828606,195173,true,3343244146,28,3436454468,93210322
1648829338,195168,true,3344916102,28,3434049911,89133809
1648829421,195165,true,3345919677,28,3434049911,88130234
1648830127,195161,true,3347258246,28,3434736756,87478510
1648830173,195158,true,3348262524,28,3435080229,86817705
1648830691,195152,true,3350271984,28,3435423737,85151753
1648830725,195149,true,3351277166,28,3435423737,84146571
1648830836,195146,true,3352282650,28,3435080229,82797579
1648830957,195143,true,3353288435,28,3434736756,81448321
1648830987,195137,true,3355300911,28,3434393316,79092405
1648832372,195135,true,3355972005,28,3425818485,69846480
1648832388,195132,true,3356978897,28,3425818485,68839588
1648832436,195129,true,3357986092,28,3425475937,67489845
1648832919,195124,true,3359665420,28,3422394550,62729130
1648833174,195121,true,3360673421,28,3421710174,61036753
1648833270,195117,true,3362017892,28,3421368037,59350145
1648833366,195114,true,3363026598,28,3421368037,58341439
1648833554,195109,true,3364708448,28,3421025934,56317486
1648833592,195106,true,3365717961,28,3421025934,55307973
1648833881,195102,true,3367064450,28,3421710174,54645724
1648833911,195098,true,3368411478,28,3422052345,53640867
1648834022,195093,true,3370096021,28,3422394550,52298529
1648834079,195090,true,3371107151,28,3422736789,51629638
1648834698,195085,true,3372793041,28,3428902955,56109914
1648834707,195081,true,3374142361,28,3429245845,55103484
1648834718,195076,true,3375829770,28,3429245845,53416075
1648834733,195073,true,3376842620,28,3429588770,52746150
1648834755,195068,true,3378531379,28,3429931729,51400350
1648834760,195065,true,3379545040,28,3429931729,50386689
1648834802,195060,true,3381235150,28,3430617749,49382599
1648834855,195057,true,3382249622,28,3431647038,49397416
1648834922,195052,true,3383941085,28,3432676635,48735550
1648834950,195049,true,3384956369,28,3433363204,48406835
1648834970,195044,true,3386649186,28,3433706541,47057355
1648834996,195041,true,3387665282,28,3434393316,46728034
1648835203,195036,true,3389359454,28,3438516856,49157402
1648835412,195033,true,3390376363,28,3443333910,52957547
1648836081,195027,true,3392411098,28,3455406089,62994991
1648836273,195024,true,3393428923,28,3458517198,65088275
1648836301,195019,true,3395125976,28,3458863050,63737074
1648836522,195016,true,3396144616,28,3463362271,67217655
1648836796,195010,true,3398182812,28,3466133931,67951119
1648837020,195007,true,3399202369,28,3467520592,68318223
1648837334,195003,true,3400562254,28,3468907809,68345555
1648837405,195000,true,3401582525,28,3469254699,67672174
1648837675,194994,true,3403623985,28,3470295580,66671595
1648837981,194991,true,3404645174,28,3470989674,66344500
1648838192,194987,true,3406007236,28,3470642610,64635374
1648838271,194984,true,3407029141,28,3470642610,63613469
1648838401,194979,true,3408732996,28,3469948585,61215589
1648838460,194976,true,3409755718,28,3469948585,60192867
1648838724,194972,true,3411119825,28,3468560953,57441128
1648838744,194969,true,3412143263,28,3468560953,56417690
1648839516,194965,true,3413508325,28,3462669703,49161378
1648839724,194963,true,3414191061,28,3461631109,47440048
1648839759,194958,true,3415898498,28,3461284981,45386483
1648840557,194956,true,3416581712,28,3459554857,42973145
1648840783,194951,true,3418290345,28,3459900813,41610468
1648841468,194950,true,3418632174,28,3459554857,40922683
1648841714,194946,true,3419999832,28,3459208937,39209105
1648842894,194943,true,3421025934,28,3457825599,36799665
1648842984,194940,true,3422052345,28,3457825599,35773254
1648843120,194938,true,3422736789,28,3457825599,35088810
1648843966,194934,true,3424106089,28,3458517198,34411109
1648844200,194932,true,3424790945,28,3459208937,34417992
1648845943,194928,true,3426161067,28,3462323470,36162403
1648845959,194927,true,3426503683,28,3462323470,35819787
1648845985,194923,true,3427874490,28,3462323470,34448980
1648846042,194921,true,3428560099,28,3462323470,33763371
1648846049,194918,true,3429588770,28,3462323470,32734700
1648846075,194916,true,3430274722,28,3462323470,32048748
1648846146,194912,true,3431647038,28,3461631109,29984071
1648846565,194910,true,3432333401,28,3459208937,26875536
1648846670,194907,true,3433363204,28,3458517198,25153994
1648846923,194906,true,3433706541,28,3457134137,23427596
1648847192,194903,true,3434736756,28,3455406089,20669333
1648847600,194901,true,3435423737,28,3452643007,17219270
1648848766,194898,true,3436454468,28,3450572146,14117678
1648848862,194897,true,3436798113,28,3450572146,13774033
1648848882,194894,true,3437829256,28,3450572146,12742890
1648849913,194892,true,3438516856,28,3451952582,13435726
1648852992,194889,true,3439548514,28,3452297778,12749264
1648853021,194889,true,3439548514,28,3452297778,12749264
1648854081,194887,true,3440236458,28,3447812931,7576473
1648854847,194885,true,3440924540,28,3444711450,3786910
1648856927,194883,true,3441612759,28,3438173038,-3439721
1648857116,194883,true,3441612759,28,3438516856,-3095903
1648857380,194881,true,3442301116,28,3439204594,-3096522
1648857445,194879,true,3442989611,28,3439548514,-3441097
1648859473,194877,true,3443678243,28,3447468184,3789941
1648859564,194877,true,3443678243,28,3447812931,4134688
1648859606,194874,true,3444711450,28,3447812931,3101481
1648859639,194873,true,3445055921,28,3448157712,3101791
1648859781,194870,true,3446089541,28,3448502528,2412987
1648859801,194870,true,3446089541,28,3448847378,2757837
1648859827,194869,true,3446434150,28,3448847378,2413228
1648859851,194868,true,3446778794,28,3449192263,2413469
1648859861,194865,true,3447812931,28,3449192263,1379332
1648859900,194865,true,3447812931,28,3449537182,1724251
1648859958,194863,true,3448502528,28,3450227124,1724596
1648860141,194862,true,3448847378,28,3451952582,3105204
1648860279,194860,true,3449537182,28,3453678904,4141722
1648860312,194861,true,3449192263,28,3454024272,4832009
1648860361,194859,true,3449882136,28,3454715111,4832975
1648860418,194858,true,3450227124,28,3455751629,5524505
1648860513,194856,true,3450917204,28,3457825599,6908395
1648860527,194856,true,3450917204,28,3458171381,7254177
1648860563,194854,true,3451607422,28,3458863050,7255628
1648860656,194853,true,3451952582,28,3460938887,8986305
1648860681,194851,true,3452643007,28,3461284981,8641974
1648860802,194850,true,3452988272,28,3464401384,11413112
1648860831,194848,true,3453678904,28,3465094299,11415395
1648860860,194847,true,3454024272,28,3466133931,12109659
1648860884,194845,true,3454715111,28,3466827192,12112081
1648860983,194844,true,3455060583,28,3469601625,14541042
1648861037,194842,true,3455751629,28,3471336773,15585144
1648861368,194840,true,3456442814,28,3482810532,26367718
1648861411,194837,true,3457479851,28,3484203865,26724014
1648862032,194836,true,3457825599,28,3502718239,44892640
1648862105,194833,true,3458863050,28,3504469949,45606899
1648862143,194831,true,3459554857,28,3505170878,45616021
1648862164,194829,true,3460246803,28,3505521395,45274592
1648862180,194827,true,3460938887,28,3505521395,44582508
1648862267,194825,true,3461631109,28,3506573157,44942048
1648862291,194824,true,3461977272,28,3506573157,44595885
1648862722,194822,true,3462669703,28,3504469949,41800246
1648862947,194820,true,3463362271,28,3502017801,38655530
1648863008,194819,true,3463708607,28,3500967406,37258799
1648863782,194817,true,3464401384,28,3486294910,21893526
1648864258,194816,true,3464747824,28,3481765897,17018073
1648864767,194814,true,3465440808,28,3480721577,15280769
1648865439,194813,true,3465787352,28,3481069649,15282297
1648865894,194811,true,3466480544,28,3481765897,15285353
1648866286,194810,true,3466827192,28,3482114074,15286882
1648866366,194809,true,3467173875,28,3482114074,14940199
1648866470,194808,true,3467520592,28,3482462285,14941693
1648866572,194806,true,3468214131,28,3482810532,14596401
1648866944,194805,true,3468560953,28,3484203865,15642912
1648866958,194803,true,3469254699,28,3484203865,14949166
1648867066,194803,true,3469254699,28,3484203865,14949166
1648867351,194803,true,3469254699,28,3482462285,13207586
1648867368,194802,true,3469601625,28,3482114074,12512449
1648867394,194801,true,3469948585,28,3481765897,11817312
1648867734,194802,true,3469601625,28,3477242769,7641144
1648867942,194802,true,3469601625,28,3474462226,4860601
1648868197,194802,true,3469601625,28,3471683906,2082281
1648868323,194800,true,3470295580,28,3469948585,-346995
1648871829,194802,true,3469601625,28,3463362271,-6239354
1648871902,194802,true,3469601625,28,3463362271,-6239354
1648871908,194802,true,3469601625,28,3463708607,-5893018
1648872052,194800,true,3470295580,28,3463708607,-6586973
1648872160,194802,true,3469601625,28,3464054978,-5546647
1648874285,194801,true,3469948585,28,3468907809,-1040776
1648874344,194802,true,3469601625,28,3469254699,-346926
1648874350,194801,true,3469948585,28,3469254699,-693886
1648874458,194802,true,3469601625,28,3469254699,-346926
1648874828,194801,true,3469948585,28,3470989674,1041089
1648875864,194801,true,3469948585,28,3476895079,6946494
1648875976,194800,true,3470295580,28,3477242769,6947189
1648878145,194801,true,3469948585,28,3479677569,9728984
1648879901,194800,true,3470295580,28,3476895079,6599499
1648881261,194800,true,3470295580,28,3477242769,6947189
1648882633,194799,true,3470642610,28,3477242769,6600159
1648882922,194799,true,3470642610,28,3478633874,7991264
1648883240,194799,true,3470642610,28,3480373539,9730929
1648883576,194798,true,3470989674,28,3481765897,10776223
1648883872,194796,true,3471683906,28,3483507129,11823223
1648884349,194797,true,3471336773,28,3485946315,14609542
1648884509,194796,true,3471683906,28,3486294910,14611004
1648884514,194795,true,3472031075,28,3486294910,14263835
1648884775,194793,true,3472725516,28,3486294910,13569394
1648887515,194794,true,3472378278,28,3484203865,11825587
1648887553,194793,true,3472725516,28,3484203865,11478349
1648889311,194792,true,3473072788,28,3484203865,11131077
1648889390,194791,true,3473420096,28,3484203865,10783769
1648889594,194791,true,3473420096,28,3484203865,10783769
1648892387,194791,true,3473420096,28,3482114074,8693978
1648893400,194790,true,3473767438,28,3482114074,8346636
1648893411,194788,true,3474462226,28,3482462285,8000059
1648893428,194789,true,3474114814,28,3482462285,8347471
1648893800,194789,true,3474114814,28,3483507129,9392315
1648894005,194787,true,3474809672,28,3483855479,9045807
1648894726,194785,true,3475504669,28,3486294910,10790241
1648895480,194786,true,3475157153,28,3487340903,12183750
1648897286,194785,true,3475504669,28,3487340903,11836234
1648897465,194784,true,3475852219,28,3487340903,11488684
1648897908,194782,true,3476547424,28,3488038406,11490982
1648898185,194782,true,3476547424,28,3489084922,12537498
1648898245,194781,true,3476895079,28,3489084922,12189843
1648898436,194779,true,3477590493,28,3489782774,12192281
1648899267,194777,true,3478286046,28,3492924835,14638789
1648901162,194778,true,3477938252,28,3487340903,9402651
1648901200,194777,true,3478286046,28,3487340903,9054857
1648901217,194776,true,3478633874,28,3487689637,9055763
1648901357,194774,true,3479329636,28,3488387210,9057574
1648901409,194774,true,3479329636,28,3488387210,9057574
1648901416,194772,true,3480025537,28,3488387210,8361673
1648902004,194771,true,3480373539,28,3487689637,7316098
1648902036,194769,true,3481069649,28,3487689637,6619988
1648902100,194769,true,3481069649,28,3487689637,6619988
1648902324,194767,true,3481765897,28,3488038406,6272509
1648902462,194766,true,3482114074,28,3488387210,6273136
1648902587,194764,true,3482810532,28,3489084922,6274390
1648902826,194764,true,3482810532,28,3490480766,7670234
1648902843,194762,true,3483507129,28,3490829814,7322685
1648902909,194761,true,3483855479,28,3491528014,7672535
1648902925,194760,true,3484203865,28,3491877167,7673302
1648903018,194758,true,3484900741,28,3493274128,8373387
1648903336,194756,true,3485597756,28,3498517708,12919952
1648903749,194755,true,3485946315,28,3506923814,20977499
1648904342,194754,true,3486294910,28,3516756468,30461558
1648904600,194752,true,3486992204,28,3519570858,32578654
1648904681,194750,true,3487689637,28,3519922815,32233178
1648905325,194750,true,3487689637,28,3516404828,28715191
1648905463,194749,true,3488038406,28,3515350117,27311711
1648905561,194748,true,3488387210,28,3514998617,26611407
1648905732,194746,true,3489084922,28,3514647153,25562231
1648905873,194747,true,3488736049,28,3514295723,25559674
1648907747,194745,true,3489433831,28,3516756468,27322637
1648907981,194745,true,3489433831,28,3516756468,27322637
1648908055,194743,true,3490131752,28,3516756468,26624716
1648908346,194744,true,3489782774,28,3516756468,26973694
1648908385,194743,true,3490131752,28,3516756468,26624716
1648908566,194742,true,3490480766,28,3515701652,25220886
1648908782,194741,true,3490829814,28,3514647153,23817339
1648909663,194743,true,3490131752,28,3508326794,18195042
1648909976,194742,true,3490480766,28,3506222534,15741768
1648910128,194742,true,3490480766,28,3504820396,14339630
1648910160,194742,true,3490480766,28,3504469949,13989183
1648910361,194743,true,3490131752,28,3503068511,12936759
1648910453,194744,true,3489782774,28,3502368003,12585229
1648911689,194744,true,3489782774,28,3493972817,4190043
1648911881,194744,true,3489782774,28,3492924835,3142061
1648912007,194746,true,3489084922,28,3492575578,3490656
1648912064,194746,true,3489084922,28,3492226355,3141433
1648912373,194746,true,3489084922,28,3491178897,2093975
1648912389,194745,true,3489433831,28,3490829814,1395983
1648912403,194746,true,3489084922,28,3490829814,1744892
1648912531,194746,true,3489084922,28,3489782774,697852
1648912863,194747,true,3488736049,28,3485597756,-3138293
1648912949,194746,true,3489084922,28,3484203865,-4881057
1648913186,194747,true,3488736049,28,3481069649,-7666400
1648913589,194747,true,3488736049,28,3476895079,-11840970
1648913685,194748,true,3488387210,28,3475852219,-12534991
1648913687,194747,true,3488736049,28,3475852219,-12883830
1648913697,194748,true,3488387210,28,3475852219,-12534991
1648913725,194748,true,3488387210,28,3475504669,-12882541
1648913838,194749,true,3488038406,28,3474114814,-13923592
1648913899,194749,true,3488038406,28,3473072788,-14965618
1648914664,194751,true,3487340903,28,3464747824,-22593079
1648914876,194751,true,3487340903,28,3463708607,-23632296
1648914966,194752,true,3486992204,28,3463015969,-23976235
1648914985,194751,true,3487340903,28,3463015969,-24324934
1648915405,194752,true,3486992204,28,3459208937,-27783267
1648915422,194753,true,3486643539,28,3459208937,-27434602
1648915916,194753,true,3486643539,28,3457479851,-29163688
1648915982,194752,true,3486992204,28,3457825599,-29166605
1648916022,194753,true,3486643539,28,3457825599,-28817940
1648916044,194753,true,3486643539,28,3457825599,-28817940
1648916114,194753,true,3486643539,28,3458171381,-28472158
1648917012,194751,true,3487340903,28,3462323470,-25017433
1648917884,194752,true,3486992204,28,3466480544,-20511660
1648918668,194752,true,3486992204,28,3471683906,-15308298
1648919252,194753,true,3486643539,28,3475504669,-11138870
1648920911,194751,true,3487340903,28,3478286046,-9054857
1648922503,194751,true,3487340903,28,3478633874,-8707029
1648922725,194751,true,3487340903,28,3478286046,-9054857
1648922771,194752,true,3486992204,28,3478286046,-8706158
1648922822,194750,true,3487689637,28,3477938252,-9751385
1648922877,194752,true,3486992204,28,3477590493,-9401711
1648922948,194752,true,3486992204,28,3476895079,-10097125
1648923026,194754,true,3486294910,28,3475504669,-10790241
1648923329,194753,true,3486643539,28,3470642610,-16000929
1648923332,194755,true,3485946315,28,3470642610,-15303705
1648923349,194755,true,3485946315,28,3470295580,-15650735
1648923351,194757,true,3485249231,28,3470295580,-14953651
1648923713,194754,true,3486294910,28,3469254699,-17040211
1648925229,194756,true,3485597756,28,3471336773,-14260983
1648925377,194757,true,3485249231,28,3470989674,-14259557
1648925400,194758,true,3484900741,28,3470989674,-13911067
1648925415,194755,true,3485946315,28,3470989674,-14956641
1648927483,194758,true,3484900741,28,3461977272,-22923469
1648927511,194759,true,3484552285,28,3462323470,-22228815
1648927547,194760,true,3484203865,28,3462323470,-21880395
1648927576,194758,true,3484900741,28,3462323470,-22577271
1648928019,194760,true,3484203865,28,3463015969,-21187896
1648928078,194761,true,3483855479,28,3463015969,-20839510
1648928092,194762,true,3483507129,28,3463015969,-20491160
1648928511,194759,true,3484552285,28,3465094299,-19457986
1648929711,194761,true,3483855479,28,3470642610,-13212869
1648929808,194762,true,3483507129,28,3470989674,-12517455
1648929832,194764,true,3482810532,28,3471336773,-11473759
1648929969,194760,true,3484203865,28,3470989674,-13214191
1648929986,194763,true,3483158813,28,3470989674,-12169139
1648929998,194764,true,3482810532,28,3470989674,-11820858
1648930084,194766,true,3482114074,28,3470989674,-11124400
1648930635,194762,true,3483507129,28,3471683906,-11823223
1648932847,194764,true,3482810532,28,3475157153,-7653379
1648934177,194766,true,3482114074,28,3475157153,-6956921
1648934478,194767,true,3481765897,28,3475157153,-6608744
1648934557,194763,true,3483158813,28,3475157153,-8001660
1648934704,194766,true,3482114074,28,3475157153,-6956921
1648934800,194768,true,3481417756,28,3474809672,-6608084
1648934837,194769,true,3481069649,28,3474809672,-6259977
1648934843,194765,true,3482462285,28,3474809672,-7652613
1648934946,194768,true,3481417756,28,3474462226,-6955530
1648934952,194770,true,3480721577,28,3474462226,-6259351
1648934958,194771,true,3480373539,28,3474462226,-5911313
1648935429,194768,true,3481417756,28,3472031075,-9386681
1648935559,194770,true,3480721577,28,3471336773,-9384804
1648935805,194772,true,3480025537,28,3469948585,-10076952
1648936535,194773,true,3479677569,28,3466827192,-12850377
1648936569,194770,true,3480721577,28,3466827192,-13894385
1648936656,194773,true,3479677569,28,3466827192,-12850377
1648936810,194774,true,3479329636,28,3466827192,-12502444
1648936951,194776,true,3478633874,28,3467173875,-11459999
1648936960,194773,true,3479677569,28,3467173875,-12503694
1648937034,194776,true,3478633874,28,3467520592,-11113282
1648937147,194777,true,3478286046,28,3468214131,-10071915
1648937689,194780,true,3477242769,28,3471683906,-5558863
1648938345,194777,true,3478286046,28,3475504669,-2781377
1648938429,194780,true,3477242769,28,3475852219,-1390550
1648938597,194782,true,3476547424,28,3476199804,-347620
1648938663,194784,true,3475852219,28,3476199804,347585
1648939135,194782,true,3476547424,28,3475852219,-695205
1648939264,194784,true,3475852219,28,3475504669,-347550
1648939507,194786,true,3475157153,28,3475157153,0
1648939555,194788,true,3474462226,28,3474809672,347446
1648939562,194786,true,3475157153,28,3474809672,-347481
1648939871,194789,true,3474114814,28,3473420096,-694718
1648940386,194790,true,3473767438,28,3470989674,-2777764
1648942380,194793,true,3472725516,28,3468214131,-4511385
1648942534,194791,true,3473420096,28,3468214131,-5205965
1648942753,194794,true,3472378278,28,3466827192,-5551086
1648943180,194796,true,3471683906,28,3464401384,-7282522
1648943282,194798,true,3470989674,28,3463708607,-7281067
1648943475,194796,true,3471683906,28,3462323470,-9360436
1648943568,194799,true,3470642610,28,3461284981,-9357629
1648943584,194801,true,3469948585,28,3461284981,-8663604
1648943725,194804,true,3468907809,28,3459900813,-9006996
1648943743,194802,true,3469601625,28,3459900813,-9700812
1648943791,194804,true,3468907809,28,3459208937,-9698872
1648944267,194806,true,3468214131,28,3453333571,-14880560
1648944425,194809,true,3467173875,28,3452297778,-14876097
1648944472,194806,true,3468214131,28,3451952582,-16261549
1648944943,194808,true,3467520592,28,3450227124,-17293468
1648945209,194810,true,3466827192,28,3449882136,-16945056
1648945266,194812,true,3466133931,28,3449882136,-16251795
1648945306,194810,true,3466827192,28,3449882136,-16945056
1648945881,194812,true,3466133931,28,3452297778,-13836153
1648947573,194813,true,3465787352,28,3456097205,-9690147
1648948453,194814,true,3465440808,28,3456788459,-8652349
1648948617,194812,true,3466133931,28,3456788459,-9345472
1648948737,194813,true,3465787352,28,3456442814,-9344538
1648948760,194814,true,3465440808,28,3456442814,-8997994
1648948780,194816,true,3464747824,28,3456097205,-8650619
1648948864,194814,true,3465440808,28,3455406089,-10034719
1648948879,194816,true,3464747824,28,3455060583,-9687241
1648948917,194818,true,3464054978,28,3454715111,-9339867
1648949314,194820,true,3463362271,28,3448502528,-14859743
1648949703,194818,true,3464054978,28,3441956920,-22098058
1648950296,194820,true,3463362271,28,3430960811,-32401460
1648950337,194821,true,3463015969,28,3430274722,-32741247
1648950392,194823,true,3462323470,28,3429588770,-32734700
1648951190,194821,true,3463015969,28,3428560099,-34455870
1648951403,194822,true,3462669703,28,3429245845,-33423858
1648951424,194824,true,3461977272,28,3429245845,-32731427
1648951465,194826,true,3461284981,28,3429245845,-32039136
1648951615,194824,true,3461977272,28,3430274722,-31702550
1648953007,194825,true,3461631109,28,3434393316,-27237793
1648953108,194826,true,3461284981,28,3434736756,-26548225
1648953116,194828,true,3460592828,28,3434736756,-25856072
1648953144,194827,true,3460938887,28,3434736756,-26202131
1648953271,194828,true,3460592828,28,3435423737,-25169091
1648954659,194829,true,3460246803,28,3440236458,-20010345
1648955732,194832,true,3459208937,28,3440924540,-18284397
1648955744,194830,true,3459900813,28,3440924540,-18976273
1648956442,194831,true,3459554857,28,3442645346,-16909511
1648956726,194833,true,3458863050,28,3443333910,-15529140
1648956815,194835,true,3458171381,28,3443678243,-14493138
1648956877,194834,true,3458517198,28,3443678243,-14838955
1648957080,194834,true,3458517198,28,3445055921,-13461277
1648958712,194835,true,3458171381,28,3451952582,-6218799
1648958779,194836,true,3457825599,28,3452297778,-5527821
1648958852,194834,true,3458517198,28,3452643007,-5874191
1648958974,194834,true,3458517198,28,3453333571,-5183627
1648959745,194833,true,3458863050,28,3457479851,-1383199
1648961200,194835,true,3458171381,28,3461977272,3805891
1648961700,194835,true,3458171381,28,3461977272,3805891
1648961825,194835,true,3458171381,28,3461977272,3805891
1648962004,194834,true,3458517198,28,3462323470,3806272
1648962688,194835,true,3458171381,28,3464401384,6230003
1648963560,194835,true,3458171381,28,3467867344,9695963
1648964256,194834,true,3458517198,28,3468907809,10390611
1648964761,194834,true,3458517198,28,3469601625,11084427
1648964799,194835,true,3458171381,28,3469601625,11430244
1648965896,194834,true,3458517198,28,3470989674,12472476
1648965946,194834,true,3458517198,28,3470989674,12472476
1648965959,194833,true,3458863050,28,3470989674,12126624
1648965981,194834,true,3458517198,28,3471336773,12819575
1648966032,194833,true,3458863050,28,3471683906,12820856
1648966070,194832,true,3459208937,28,3472031075,12822138
1648966128,194831,true,3459554857,28,3472725516,13170659
1648966178,194832,true,3459208937,28,3473420096,14211159
1648966350,194831,true,3459554857,28,3475504669,15949812
1648966801,194829,true,3460246803,28,3483507129,23260326
1648966810,194828,true,3460592828,28,3483855479,23262651
1648967548,194829,true,3460246803,28,3496069725,35822922
1648968294,194828,true,3460592828,28,3501667634,41074806
1648968299,194826,true,3461284981,28,3501667634,40382653
1648968841,194825,true,3461631109,28,3500967406,39336297
1648970265,194826,true,3461284981,28,3500617344,39332363
1648970309,194825,true,3461631109,28,3500617344,38986235
1648970517,194824,true,3461977272,28,3500267317,38290045
1648970593,194823,true,3462323470,28,3500267317,37943847
1648973608,194824,true,3461977272,28,3494322215,32344943
1648973679,194823,true,3462323470,28,3494322215,31998745
1648975767,194821,true,3463015969,28,3494322215,31306246
1648975912,194820,true,3463362271,28,3493972817,30610546
1648976040,194821,true,3463015969,28,3493623455,30607486
1648976048,194820,true,3463362271,28,3493623455,30261184
1648976397,194819,true,3463708607,28,3491877167,28168560
1648976628,194818,true,3464054978,28,3490480766,26425788
1648976986,194819,true,3463708607,28,3488387210,24678603
1648978232,194819,true,3463708607,28,3483158813,19450206
1648978525,194817,true,3464401384,28,3483158813,18757429
1648978731,194816,true,3464747824,28,3483855479,19107655
1648978813,194818,true,3464054978,28,3483855479,19800501
1648978956,194817,true,3464401384,28,3484203865,19802481
1648978984,194816,true,3464747824,28,3484552285,19804461
1648978997,194815,true,3465094299,28,3484552285,19457986
1648979042,194817,true,3464401384,28,3484900741,20499357
1648979056,194816,true,3464747824,28,3484900741,20152917
1648979086,194814,true,3465440808,28,3484900741,19459933
1648979144,194813,true,3465787352,28,3485597756,19810404
1648979223,194815,true,3465094299,28,3486294910,21200611
1648979557,194813,true,3465787352,28,3489433831,23646479
1648979960,194811,true,3466480544,28,3493623455,27142911
1648980753,194810,true,3466827192,28,3500267317,33440125
1648980758,194812,true,3466133931,28,3500267317,34133386
1648981084,194810,true,3466827192,28,3499917325,33090133
1648981320,194808,true,3467520592,28,3499217447,31696855
1648981403,194807,true,3467867344,28,3498867560,31000216
1648982653,194809,true,3467173875,28,3491877167,24703292
1648982716,194808,true,3467520592,28,3491877167,24356575
1648984030,194806,true,3468214131,28,3488736049,20521918
1648988267,194805,true,3468560953,28,3484900741,16339788
1648988393,194807,true,3467867344,28,3485249231,17381887
1648989378,194805,true,3468560953,28,3488736049,20175096
1648989793,194803,true,3469254699,28,3490131752,20877053
1648990923,194801,true,3469948585,28,3493274128,23325543
1648991147,194802,true,3469601625,28,3493623455,24021830
1648992148,194800,true,3470295580,28,3494671647,24376067
1648992851,194798,true,3470989674,28,3495720153,24730479
1648992980,194796,true,3471683906,28,3495720153,24036247
1648994171,194797,true,3471336773,28,3500967406,29630633
1648994187,194795,true,3472031075,28,3500967406,28936331
1648994602,194793,true,3472725516,28,3502718239,29992723
1648994811,194791,true,3473420096,28,3503068511,29648415
1648994847,194792,true,3473072788,28,3503068511,29995723
1648994877,194790,true,3473767438,28,3503068511,29301073
1648994889,194788,true,3474462226,28,3503068511,28606285
1648996251,194786,true,3475157153,28,3501317502,26160349
1648996396,194787,true,3474809672,28,3500967406,26157734
1648996577,194785,true,3475504669,28,3500267317,24762648
1648996767,194783,true,3476199804,28,3499567369,23367565
1648997568,194782,true,3476547424,28,3497118651,20571227
1648997859,194783,true,3476199804,28,3496069725,19869921
1648997892,194780,true,3477242769,28,3496069725,18826956
1648997927,194778,true,3477938252,28,3496069725,18131473
1648998167,194776,true,3478633874,28,3496768974,18135100
1648998170,194775,true,3478981738,28,3496768974,17787236
1648998183,194772,true,3480025537,28,3496768974,16743437
1648999303,194769,true,3481069649,28,3505170878,24101229
1648999310,194768,true,3481417756,28,3505170878,23753122
1648999360,194767,true,3481765897,28,3505871947,24106050
1648999511,194764,true,3482810532,28,3506923814,24113282
1649000904,194761,true,3483855479,28,3511485551,27630072
1649001719,194759,true,3484552285,28,3511836700,27284415
1649002010,194759,true,3484552285,28,3511836700,27284415
1649002063,194756,true,3485597756,28,3511836700,26238944
1649002641,194753,true,3486643539,28,3511134438,24490899
1649002970,194752,true,3486992204,28,3510783359,23791155
1649003004,194751,true,3487340903,28,3510783359,23442456
1649003098,194748,true,3488387210,28,3510081308,21694098
1649003612,194747,true,3488736049,28,3506573157,17837108
1649003766,194746,true,3489084922,28,3505521395,16436473
1649003903,194745,true,3489433831,28,3504119537,14685706
1649004504,194743,true,3490131752,28,3498867560,8735808
1649005526,194741,true,3490829814,28,3494322215,3492401
1649005696,194740,true,3491178897,28,3493972817,2793920
1649006912,194740,true,3491178897,28,3493972817,2793920
1649011923,194738,true,3491877167,28,3491528014,-349153
1649011969,194737,true,3492226355,28,3491877167,-349188
1649011989,194736,true,3492575578,28,3491877167,-698411
1649012010,194736,true,3492575578,28,3491877167,-698411
1649012125,194733,true,3493623455,28,3492924835,-698620
1649012131,194732,true,3493972817,28,3492924835,-1047982
1649012227,194732,true,3493972817,28,3493623455,-349362
1649012898,194731,true,3494322215,28,3500967406,6645191
1649014169,194728,true,3495370616,28,3511836700,16466084
1649014202,194727,true,3495720153,28,3511836700,16116547
1649014321,194727,true,3495720153,28,3511836700,16116547
1649014391,194726,true,3496069725,28,3511836700,15766975
1649014432,194723,true,3497118651,28,3511836700,14718049
1649014537,194722,true,3497468363,28,3511836700,14368337
1649014651,194723,true,3497118651,28,3511485551,14366900
1649014714,194722,true,3497468363,28,3511134438,13666075
1649014908,194720,true,3498167892,28,3509730335,11562443
1649018675,194719,true,3498517708,28,3499917325,1399617
1649021125,194720,true,3498167892,28,3499917325,1749433
1649021139,194719,true,3498517708,28,3500267317,1749609
1649021142,194718,true,3498867560,28,3500267317,1399757
1649021185,194718,true,3498867560,28,3500267317,1399757
1649021189,194718,true,3498867560,28,3500267317,1399757
1649022061,194718,true,3498867560,28,3503418818,4551258
1649022091,194716,true,3499567369,28,3503769160,4201791
1649022149,194717,true,3499217447,28,3504119537,4902090
1649023070,194717,true,3499217447,28,3509028494,9811047
1649023149,194717,true,3499217447,28,3509028494,9811047
1649023256,194715,true,3499917325,28,3509730335,9813010
1649023321,194716,true,3499567369,28,3510081308,10513939
1649023356,194716,true,3499567369,28,3510432316,10864947
1649023364,194715,true,3499917325,28,3510783359,10866034
1649023392,194713,true,3500617344,28,3511134438,10517094
1649023396,194713,true,3500617344,28,3511134438,10517094
1649023401,194712,true,3500967406,28,3511134438,10167032
1649023404,194711,true,3501317502,28,3511485551,10168049
1649023439,194708,true,3502368003,28,3511836700,9468697
1649023453,194708,true,3502368003,28,3512187883,9819880
1649024279,194708,true,3502368003,28,3526264065,23896062
1649024306,194706,true,3503068511,28,3526616691,23548180
1649024328,194704,true,3503769160,28,3527322050,23552890
1649024347,194703,true,3504119537,28,3527674782,23555245
1649024369,194702,true,3504469949,28,3528027550,23557601
1649024376,194700,true,3505170878,28,3528027550,22856672
1649024618,194697,true,3506222534,28,3534029997,27807463
1649024649,194696,true,3506573157,28,3534736838,28163681
1649024685,194694,true,3507274506,28,3535797365,28522859
1649024828,194692,true,3507975996,28,3540396661,32420665
1649025446,194688,true,3509379397,28,3555296850,45917453
1649025767,194688,true,3509379397,28,3560633530,51254133
1649025783,194686,true,3510081308,28,3560989594,50908286
1649025806,194684,true,3510783359,28,3561345693,50562334
1649026023,194680,true,3512187883,28,3565265132,53077249
1649026105,194680,true,3512187883,28,3566691452,54503569
1649026129,194678,true,3512890356,28,3567048121,54157765
1649026137,194676,true,3513592969,28,3567048121,53455152
1649026152,194673,true,3514647153,28,3567404826,52757673
1649026615,194673,true,3514647153,28,3568475155,53828002
1649026650,194672,true,3514998617,28,3568118343,53119726
1649026874,194670,true,3515701652,28,3565978221,50276569
1649026897,194667,true,3516756468,28,3565621659,48865191
1649026958,194668,true,3516404828,28,3564908641,48503813
1649026996,194667,true,3516756468,28,3564195766,47439298
1649027011,194665,true,3517459855,28,3563839383,46379528
1649027046,194662,true,3518515198,28,3563483034,44967836
1649027058,194663,true,3518163382,28,3563126722,44963340
1649027094,194661,true,3518867050,28,3562414203,43547153
1649027154,194660,true,3519218936,28,3561345693,42126757
1649028970,194657,true,3520274808,28,3532263512,11988704
1649029054,194658,true,3519922815,28,3532263512,12340697
1649029325,194657,true,3520274808,28,3531204045,10929237
1649029805,194656,true,3520626835,28,3529086064,8459229
1649030475,194654,true,3521330996,28,3526616691,5285695
1649030521,194655,true,3520978898,28,3526264065,5285167
1649030556,194654,true,3521330996,28,3525911474,4580478
1649030716,194654,true,3521330996,28,3524149047,2818051
1649031936,194653,true,3521683129,28,3515350117,-6333012
1649031971,194654,true,3521330996,28,3514998617,-6332379
1649031999,194654,true,3521330996,28,3514647153,-6683843
1649032009,194653,true,3521683129,28,3514295723,-7387406
1649032015,194653,true,3521683129,28,3514295723,-7387406
1649032038,194655,true,3520978898,28,3513944329,-7034569
1649032043,194654,true,3521330996,28,3513944329,-7386667
1649032615,194654,true,3521330996,28,3504820396,-16510600
1649032666,194654,true,3521330996,28,3504119537,-17211459
1649032689,194656,true,3520626835,28,3503769160,-16857675
1649033510,194655,true,3520978898,28,3496069725,-24909173
1649033836,194654,true,3521330996,28,3492575578,-28755418
1649033957,194654,true,3521330996,28,3492575578,-28755418
1649033991,194656,true,3520626835,28,3492226355,-28400480
1649034223,194656,true,3520626835,28,3491178897,-29447938
1649035036,194656,true,3520626835,28,3485946315,-34680520
1649035057,194656,true,3520626835,28,3485946315,-34680520
1649036289,194658,true,3519922815,28,3483507129,-36415686
1649040444,194658,true,3519922815,28,3485249231,-34673584
1649040463,194659,true,3519570858,28,3485597756,-33973102
1649040525,194659,true,3519570858,28,3485597756,-33973102
1649041059,194661,true,3518867050,28,3487340903,-31526147
1649041279,194660,true,3519218936,28,3488387210,-30831726
1649041813,194660,true,3519218936,28,3491528014,-27690922
1649041957,194661,true,3518867050,28,3492226355,-26640695
1649042117,194663,true,3518163382,28,3493274128,-24889254
1649042210,194662,true,3518515198,28,3493972817,-24542381
1649044774,194662,true,3518515198,28,3499217447,-19297751
1649044982,194662,true,3518515198,28,3499217447,-19297751
1649044999,194663,true,3518163382,28,3499217447,-18945935
1649045039,194662,true,3518515198,28,3499217447,-19297751
1649045223,194662,true,3518515198,28,3498867560,-19647638
1649045325,194662,true,3518515198,28,3498517708,-19997490
1649045353,194663,true,3518163382,28,3498517708,-19645674
1649045367,194662,true,3518515198,28,3498517708,-19997490
1649046249,194662,true,3518515198,28,3495021114,-23494084
1649046678,194662,true,3518515198,28,3493972817,-24542381
1649046693,194663,true,3518163382,28,3493972817,-24190565
1649046722,194662,true,3518515198,28,3493972817,-24542381
1649048167,194661,true,3518867050,28,3497118651,-21748399
1649048263,194662,true,3518515198,28,3497118651,-21396547
1649049955,194663,true,3518163382,28,3497468363,-20695019
1649050601,194662,true,3518515198,28,3497468363,-21046835
1649051116,194662,true,3518515198,28,3497818110,-20697088
1649052264,194664,true,3517811601,28,3497818110,-19993491
1649052407,194665,true,3517459855,28,3498167892,-19291963
1649052772,194664,true,3517811601,28,3498517708,-19293893
1649054231,194663,true,3518163382,28,3508677627,-9485755
1649055940,194664,true,3517811601,28,3510081308,-7730293
1649056010,194665,true,3517459855,28,3510081308,-7378547
1649056037,194663,true,3518163382,28,3510081308,-8082074
1649056077,194663,true,3518163382,28,3509730335,-8433047
1649060111,194664,true,3517811601,28,3502718239,-15093362
1649060315,194665,true,3517459855,28,3502718239,-14741616
1649061357,194663,true,3518163382,28,3502718239,-15445143
1649061717,194663,true,3518163382,28,3502718239,-15445143
1649061745,194664,true,3517811601,28,3502718239,-15093362
1649061975,194664,true,3517811601,28,3502368003,-15443598
1649062000,194663,true,3518163382,28,3502368003,-15795379
1649062131,194663,true,3518163382,28,3502017801,-16145581
1649062720,194664,true,3517811601,28,3500267317,-17544284
1649063128,194665,true,3517459855,28,3498867560,-18592295
1649063190,194665,true,3517459855,28,3498167892,-19291963
1649064751,194665,true,3517459855,28,3489084922,-28374933
1649065040,194667,true,3516756468,28,3488038406,-28718062
1649065565,194668,true,3516404828,28,3488038406,-28366422
1649065998,194667,true,3516756468,28,3488038406,-28718062
1649066026,194669,true,3516053222,28,3488038406,-28014816
1649066092,194671,true,3515350117,28,3488038406,-27311711
1649066587,194673,true,3514647153,28,3484203865,-30443288
1649066654,194674,true,3514295723,28,3483855479,-30440244
1649067701,194675,true,3513944329,28,3474114814,-39829515
1649068540,194677,true,3513241645,28,3472031075,-41210570
1649068625,194680,true,3512187883,28,3472031075,-40156808
1649068667,194680,true,3512187883,28,3471683906,-40503977
1649070588,194683,true,3511134438,28,3460246803,-50887635
1649070760,194685,true,3510432316,28,3460592828,-49839488
1649070838,194688,true,3509379397,28,3460592828,-48786569
1649070859,194689,true,3509028494,28,3460592828,-48435666
1649070917,194691,true,3508326794,28,3460938887,-47387907
1649070990,194694,true,3507274506,28,3461284981,-45989525
1649071016,194697,true,3506222534,28,3461284981,-44937553
1649071165,194698,true,3505871947,28,3461977272,-43894675
1649072057,194700,true,3505170878,28,3465440808,-39730070
1649072206,194704,true,3503769160,28,3465787352,-37981808
1649072222,194707,true,3502718239,28,3465787352,-36930887
1649072287,194708,true,3502368003,28,3466133931,-36234072
1649072394,194711,true,3501317502,28,3466827192,-34490310
1649073291,194715,true,3499917325,28,3468560953,-31356372
1649073503,194717,true,3499217447,28,3468907809,-30309638
1649074125,194718,true,3498867560,28,3471336773,-27530787
1649074213,194721,true,3497818110,28,3471683906,-26134204
1649074300,194724,true,3496768974,28,3472378278,-24390696
1649074415,194726,true,3496069725,28,3473072788,-22996937
1649074533,194727,true,3495720153,28,3474114814,-21605339
1649075562,194729,true,3495021114,28,3481069649,-13951465
1649075939,194732,true,3493972817,28,3482810532,-11162285
1649076388,194733,true,3493623455,28,3483158813,-10464642
1649076480,194733,true,3493623455,28,3482810532,-10812923
1649076503,194735,true,3492924835,28,3482810532,-10114303
1649076628,194738,true,3491877167,28,3482114074,-9763093
1649076646,194740,true,3491178897,28,3482114074,-9064823
1649076892,194740,true,3491178897,28,3480373539,-10805358
1649078051,194742,true,3490480766,28,3472031075,-18449691
1649078164,194745,true,3489433831,28,3471336773,-18097058
1649079080,194746,true,3489084922,28,3469601625,-19483297
1649079081,194746,true,3489084922,28,3469601625,-19483297
1649079373,194748,true,3488387210,28,3468214131,-20173079
1649079407,194751,true,3487340903,28,3468214131,-19126772
1649079439,194753,true,3486643539,28,3468214131,-18429408
1649079455,194753,true,3486643539,28,3468214131,-18429408
1649079532,194754,true,3486294910,28,3468214131,-18080779
1649079542,194755,true,3485946315,28,3468214131,-17732184
1649079628,194757,true,3485249231,28,3468214131,-17035100
1649080210,194757,true,3485249231,28,3469601625,-15647606
1649080692,194757,true,3485249231,28,3471336773,-13912458
1649080731,194758,true,3484900741,28,3471336773,-13563968
1649080806,194759,true,3484552285,28,3471683906,-12868379
1649081565,194759,true,3484552285,28,3475157153,-9395132
1649081930,194759,true,3484552285,28,3476199804,-8352481
1649082183,194759,true,3484552285,28,3476547424,-8004861
1649082749,194760,true,3484203865,28,3476547424,-7656441
1649082821,194760,true,3484203865,28,3476547424,-7656441
1649083419,194761,true,3483855479,28,3474809672,-9045807
1649083483,194761,true,3483855479,28,3474462226,-9393253
1649083773,194763,true,3483158813,28,3472378278,-10780535
1649084266,194762,true,3483507129,28,3468214131,-15292998
1649084301,194763,true,3483158813,28,3467867344,-15291469
1649084348,194764,true,3482810532,28,3467520592,-15289940
1649084613,194765,true,3482462285,28,3464401384,-18060901
1649084708,194766,true,3482114074,28,3463015969,-19098105
1649084735,194766,true,3482114074,28,3462669703,-19444371
1649084764,194767,true,3481765897,28,3462323470,-19442427
1649084786,194769,true,3481069649,28,3461977272,-19092377
1649084807,194770,true,3480721577,28,3461631109,-19090468
1649084906,194772,true,3480025537,28,3459900813,-20124724
1649084951,194773,true,3479677569,28,3459208937,-20468632
1649085045,194775,true,3478981738,28,3457479851,-21501887
1649085097,194776,true,3478633874,28,3456442814,-22191060
1649085141,194778,true,3477938252,28,3455406089,-22532163
1649085213,194779,true,3477590493,28,3454024272,-23566221
1649088026,194782,true,3476547424,28,3431990202,-44557222
1649088039,194783,true,3476199804,28,3431990202,-44209602
1649088098,194785,true,3475504669,28,3431990202,-43514467
1649088391,194786,true,3475157153,28,3430960811,-44196342
1649088720,194789,true,3474114814,28,3429931729,-44183085
1649088745,194790,true,3473767438,28,3429931729,-43835709
1649088811,194792,true,3473072788,28,3429931729,-43141059
1649088846,194792,true,3473072788,28,3429931729,-43141059
1649088948,194795,true,3472031075,28,3429931729,-42099346
1649089103,194796,true,3471683906,28,3430274722,-41409184
1649089160,194798,true,3470989674,28,3430617749,-40371925
1649090021,194798,true,3470989674,28,3436110856,-34878818
1649090464,194801,true,3469948585,28,3439892469,-30056116
1649090883,194802,true,3469601625,28,3442301116,-27300509
1649091499,194804,true,3468907809,28,3443333910,-25573899
1649091652,194804,true,3468907809,28,3443678243,-25229566
1649092465,194807,true,3467867344,28,3445055921,-22811423
1649092711,194808,true,3467520592,28,3445744967,-21775625
1649092778,194810,true,3466827192,28,3446089541,-20737651
1649094145,194810,true,3466827192,28,3449537182,-17290010
1649094208,194813,true,3465787352,28,3449537182,-16250170
1649094572,194814,true,3465440808,28,3447123471,-18317337
1649094693,194816,true,3464747824,28,3446089541,-18658283
1649094745,194817,true,3464401384,28,3445744967,-18656417
1649094763,194820,true,3463362271,28,3445744967,-17617304
1649095619,194821,true,3463015969,28,3437485507,-25530462
1649095795,194823,true,3462323470,28,3435423737,-26899733
1649095848,194824,true,3461977272,28,3434393316,-27583956
1649096235,194827,true,3460938887,28,3429931729,-31007158
1649096638,194829,true,3460246803,28,3427189018,-33057785
1649096983,194831,true,3459554857,28,3425818485,-33736372
1649097182,194832,true,3459208937,28,3425133424,-34075513
1649097282,194835,true,3458171381,28,3424790945,-33380436
1649097405,194836,true,3457825599,28,3424448500,-33377099
1649097437,194838,true,3457134137,28,3424790945,-32343192
1649097699,194838,true,3457134137,28,3426161067,-30973070
1649097898,194840,true,3456442814,28,3428217277,-28225537
1649097945,194842,true,3455751629,28,3428902955,-26848674
1649098017,194843,true,3455406089,28,3429931729,-25474360
1649098030,194843,true,3455406089,28,3429931729,-25474360
1649098069,194844,true,3455060583,28,3430617749,-24442834
1649098202,194845,true,3454715111,28,3432333401,-22381710
1649098508,194845,true,3454715111,28,3437141793,-17573318
1649098879,194845,true,3454715111,28,3442645346,-12069765
1649099055,194846,true,3454369674,28,3445744967,-8624707
1649099079,194847,true,3454024272,28,3446089541,-7934731
1649099123,194846,true,3454369674,28,3447123471,-7246203
1649099170,194845,true,3454715111,28,3447812931,-6902180
1649099299,194846,true,3454369674,28,3449882136,-4487538
1649100673,194846,true,3454369674,28,3465787352,11417678
1649100685,194846,true,3454369674,28,3465787352,11417678
1649100947,194845,true,3454715111,28,3468214131,13499020
1649101166,194846,true,3454369674,28,3469254699,14885025
1649101490,194845,true,3454715111,28,3470642610,15927499
1649101547,194845,true,3454715111,28,3470642610,15927499
1649101549,194844,true,3455060583,28,3470642610,15582027
1649101803,194845,true,3454715111,28,3472031075,17315964
1649101890,194844,true,3455060583,28,3472725516,17664933
1649101942,194844,true,3455060583,28,3473072788,18012205
1649102065,194843,true,3455406089,28,3474114814,18708725
1649102076,194843,true,3455406089,28,3474462226,19056137
1649102670,194843,true,3455406089,28,3480373539,24967450
1649102688,194842,true,3455751629,28,3480373539,24621910
1649103676,194842,true,3455751629,28,3487340903,31589274
1649103716,194842,true,3455751629,28,3487689637,31938008
1649103755,194842,true,3455751629,28,3487689637,31938008
1649103933,194842,true,3455751629,28,3488736049,32984420
1649103981,194840,true,3456442814,28,3489084922,32642108
1649104118,194841,true,3456097205,28,3489782774,33685569
1649104808,194840,true,3456442814,28,3493274128,36831314
1649104845,194840,true,3456442814,28,3493623455,37180641
1649104909,194839,true,3456788459,28,3493972817,37184358
1649104980,194839,true,3456788459,28,3494671647,37883188
1649105097,194837,true,3457479851,28,3495720153,38240302
1649106106,194837,true,3457479851,28,3503769160,46289309
1649106214,194835,true,3458171381,28,3504469949,46298568
1649112353,194835,true,3458171381,28,3509028494,50857113
1649112427,194833,true,3458863050,28,3509379397,50516347
1649112509,194832,true,3459208937,28,3509379397,50170460
1649112557,194831,true,3459554857,28,3509730335,50175478
1649112580,194829,true,3460246803,28,3509730335,49483532
1649112652,194828,true,3460592828,28,3510432316,49839488
1649112787,194826,true,3461284981,28,3511836700,50551719
1649113281,194824,true,3461977272,28,3517459855,55482583
1649114785,194823,true,3462323470,28,3529438972,67115502
1649116016,194822,true,3462669703,28,3529791916,67122213
1649116240,194821,true,3463015969,28,3529791916,66775947
1649116554,194819,true,3463708607,28,3529791916,66083309
1649116887,194818,true,3464054978,28,3529438972,65383994
1649116921,194816,true,3464747824,28,3529438972,64691148
1649117410,194816,true,3464747824,28,3528027550,63279726
1649117620,194814,true,3465440808,28,3527322050,61881242
1649118389,194813,true,3465787352,28,3525558918,59771566
1649118398,194812,true,3466133931,28,3525558918,59424987
1649118403,194810,true,3466827192,28,3525558918,58731726
1649118645,194809,true,3467173875,28,3524853912,57680037
1649118656,194807,true,3467867344,28,3524853912,56986568
1649118760,194806,true,3468214131,28,3524501462,56287331
1649118924,194804,true,3468907809,28,3523796667,54888858
1649118991,194803,true,3469254699,28,3523444323,54189624
1649119026,194801,true,3469948585,28,3523444323,53495738
1649124861,194800,true,3470295580,28,3512539102,42243522
1649124953,194798,true,3470989674,28,3512890356,41900682
1649125002,194797,true,3471336773,28,3512890356,41553583
1649125048,194795,true,3472031075,28,3513241645,41210570
1649129620,194792,true,3473072788,28,3518867050,45794262
1649129666,194790,true,3473767438,28,3519218936,45451498
1649131207,194788,true,3474462226,28,3524501462,50039236
1649131902,194786,true,3475157153,28,3525558918,50401765
1649132897,194783,true,3476199804,28,3525558918,49359114
1649133730,194781,true,3476895079,28,3525558918,48663839
1649138831,194779,true,3477590493,28,3525558918,47968425
1649139179,194777,true,3478286046,28,3525558918,47272872
1649140074,194774,true,3479329636,28,3525911474,46581838
1649141541,194772,true,3480025537,28,3526264065,46238528
1649141569,194769,true,3481069649,28,3526264065,45194416
1649141597,194766,true,3482114074,28,3526264065,44149991
1649141654,194763,true,3483158813,28,3526264065,43105252
1649142583,194762,true,3483507129,28,3523796667,40289538
1649144163,194760,true,3484203865,28,3521330996,37127131
1649144352,194757,true,3485249231,28,3521683129,36433898
1649144542,194754,true,3486294910,28,3522035297,35740387
1649145004,194753,true,3486643539,28,3523092013,36448474
1649148225,194751,true,3487340903,28,3525911474,38570571
1649148256,194749,true,3488038406,28,3525911474,37873068
1649151440,194746,true,3489084922,28,3525911474,36826552
1649152028,194744,true,3489782774,28,3525911474,36128700
1649152107,194742,true,3490480766,28,3525911474,35430708
1649152132,194740,true,3491178897,28,3525911474,34732577
1649152201,194738,true,3491877167,28,3525911474,34034307
1649152225,194736,true,3492575578,28,3525911474,33335896
1649152261,194735,true,3492924835,28,3525911474,32986639
1649152700,194733,true,3493623455,28,3525206397,31582942
1649152770,194730,true,3494671647,28,3525206397,30534750
1649152969,194728,true,3495370616,28,3524501462,29130846
1649153020,194726,true,3496069725,28,3524149047,28079322
1649153283,194724,true,3496768974,28,3522739739,25970765
1649154371,194721,true,3497818110,28,3516756468,18938358
1649155576,194720,true,3498167892,28,3514998617,16830725
1649156193,194717,true,3499217447,28,3514998617,15781170
1649157189,194716,true,3499567369,28,3514998617,15431248
1649157641,194712,true,3500967406,28,3514998617,14031211
1649158250,194710,true,3501667634,28,3514998617,13330983
1649159125,194708,true,3502368003,28,3514998617,12630614
1649159706,194706,true,3503068511,28,3514998617,11930106
1649160156,194703,true,3504119537,28,3514998617,10879080
1649160211,194701,true,3504820396,28,3515350117,10529721
1649160922,194699,true,3505521395,28,3519218936,13697541
1649161210,194697,true,3506222534,28,3520626835,14404301
1649161274,194694,true,3507274506,28,3520978898,13704392
1649161373,194693,true,3507625234,28,3522035297,14410063
1649161603,194690,true,3508677627,28,3524501462,15823835
1649161721,194688,true,3509379397,28,3526264065,16884668
1649162171,194684,true,3510783359,28,3532616738,21833379
1649162468,194683,true,3511134438,28,3535797365,24662927
1649162505,194680,true,3512187883,28,3536150945,23963062
1649162507,194679,true,3512539102,28,3536150945,23611843
1649163045,194676,true,3513592969,28,3537919374,24326405
1649163426,194675,true,3513944329,28,3536858211,22913882
1649163489,194673,true,3514647153,28,3536504560,21857407
1649163526,194672,true,3514998617,28,3536150945,21152328
1649163536,194670,true,3515701652,28,3536150945,20449293
1649163542,194669,true,3516053222,28,3536150945,20097723
1649163567,194667,true,3516756468,28,3535797365,19040897
1649163595,194667,true,3516756468,28,3535443821,18687353
1649164172,194665,true,3517459855,28,3526969353,9509498
1649164257,194665,true,3517459855,28,3525558918,8099063
1649164354,194663,true,3518163382,28,3524501462,6338080
1649164404,194662,true,3518515198,28,3524149047,5633849
1649164416,194661,true,3518867050,28,3524149047,5281997
1649164467,194661,true,3518867050,28,3523444323,4577273
1649164474,194660,true,3519218936,28,3523092013,3873077
1649164670,194661,true,3518867050,28,3519218936,351886
1649164673,194660,true,3519218936,28,3519218936,0
1649164814,194660,true,3519218936,28,3516404828,-2814108
1649164868,194659,true,3519570858,28,3515350117,-4220741
1649164870,194660,true,3519218936,28,3515350117,-3868819
1649165021,194660,true,3519218936,28,3511836700,-7382236
1649165047,194660,true,3519218936,28,3511134438,-8084498
1649165426,194660,true,3519218936,28,3502368003,-16850933
1649166931,194661,true,3518867050,28,3482462285,-36404765
1649167555,194661,true,3518867050,28,3481417756,-37449294
1649167574,194662,true,3518515198,28,3481417756,-37097442
1649167609,194662,true,3518515198,28,3481417756,-37097442
1649167639,194663,true,3518163382,28,3481069649,-37093733
1649167680,194665,true,3517459855,28,3480721577,-36738278
1649168504,194667,true,3516756468,28,3469948585,-46807883
1649169527,194667,true,3516756468,28,3457134137,-59622331
1649169577,194668,true,3516404828,28,3456788459,-59616369
1649169590,194670,true,3515701652,28,3456788459,-58913193
1649170857,194672,true,3514998617,28,3453678904,-61319713
1649171467,194672,true,3514998617,28,3452643007,-62355610
1649171568,194675,true,3513944329,28,3452988272,-60956057
1649173006,194676,true,3513592969,28,3456442814,-57150155
1649174556,194679,true,3512539102,28,3457134137,-55404965
1649174577,194680,true,3512187883,28,3457134137,-55053746
1649174611,194682,true,3511485551,28,3457134137,-54351414
1649174625,194684,true,3510783359,28,3457134137,-53649222
1649174627,194687,true,3509730335,28,3457134137,-52596198
1649174722,194688,true,3509379397,28,3456442814,-52936583
1649174919,194691,true,3508326794,28,3455060583,-53266211
1649174967,194692,true,3507975996,28,3455060583,-52915413
1649175003,194696,true,3506573157,28,3454715111,-51858046
1649175159,194696,true,3506573157,28,3454369674,-52203483
1649175268,194698,true,3505871947,28,3454369674,-51502273
1649175379,194699,true,3505521395,28,3454715111,-50806284
1649175446,194702,true,3504469949,28,3455060583,-49409366
1649175659,194702,true,3504469949,28,3455751629,-48718320
1649176486,194704,true,3503769160,28,3459900813,-43868347
1649176614,194705,true,3503418818,28,3461284981,-42133837
1649176695,194708,true,3502368003,28,3461977272,-40390731
1649176939,194708,true,3502368003,28,3463362271,-39005732
1649177053,194710,true,3501667634,28,3463708607,-37959027
1649177127,194711,true,3501317502,28,3463362271,-37955231
1649177685,194714,true,3500267317,28,3460938887,-39328430
1649177711,194714,true,3500267317,28,3460938887,-39328430
1649177749,194715,true,3499917325,28,3460592828,-39324497
1649177962,194717,true,3499217447,28,3459208937,-40008510
1649178056,194721,true,3497818110,28,3458863050,-38955060
1649178500,194720,true,3498167892,28,3458863050,-39304842
1649178545,194722,true,3497468363,28,3458863050,-38605313
1649178577,194723,true,3497118651,28,3458863050,-38255601
1649178770,194727,true,3495720153,28,3459900813,-35819340
1649179180,194726,true,3496069725,28,3462323470,-33746255
1649181183,194728,true,3495370616,28,3468214131,-27156485
1649181206,194729,true,3495021114,28,3468214131,-26806983
1649181281,194733,true,3493623455,28,3468214131,-25409324
1649181573,194732,true,3493972817,28,3467173875,-26798942
1649181640,194734,true,3493274128,28,3467173875,-26100253
1649181763,194736,true,3492575578,28,3466480544,-26095034
1649182195,194739,true,3491528014,28,3464401384,-27126630
1649182226,194738,true,3491877167,28,3464054978,-27822189
1649184062,194741,true,3490829814,28,3455751629,-35078185
1649184082,194742,true,3490480766,28,3455751629,-34729137
1649185462,194746,true,3489084922,28,3455060583,-34024339
1649185518,194745,true,3489433831,28,3455060583,-34373248
1649185557,194748,true,3488387210,28,3455060583,-33326627
1649185617,194750,true,3487689637,28,3454715111,-32974526
1649185702,194754,true,3486294910,28,3454024272,-32270638
1649185724,194754,true,3486294910,28,3453678904,-32616006
1649185787,194756,true,3485597756,28,3453333571,-32264185
1649185828,194758,true,3484900741,28,3452988272,-31912469
1649185851,194762,true,3483507129,28,3452643007,-30864122
1649185879,194762,true,3483507129,28,3452297778,-31209351
1649186051,194765,true,3482462285,28,3450572146,-31890139
1649186702,194768,true,3481417756,28,3442989611,-38428145
1649186849,194771,true,3480373539,28,3441956920,-38416619
1649189114,194769,true,3481069649,28,3459208937,-21860712
1649190336,194772,true,3480025537,28,3461631109,-18394428
1649190404,194773,true,3479677569,28,3461631109,-18046460
1649190516,194777,true,3478286046,28,3461631109,-16654937
1649190674,194775,true,3478981738,28,3461284981,-17696757
1649190719,194778,true,3477938252,28,3461284981,-16653271
1649190787,194779,true,3477590493,28,3460938887,-16651606
1649190816,194783,true,3476199804,28,3460592828,-15606976
1649190854,194781,true,3476895079,28,3460592828,-16302251
1649190893,194784,true,3475852219,28,3460246803,-15605416
1649191003,194786,true,3475157153,28,3459208937,-15948216
1649191007,194790,true,3473767438,28,3459208937,-14558501
1649191020,194789,true,3474114814,28,3458863050,-15251764
1649191050,194792,true,3473072788,28,3458517198,-14555590
1649191203,194796,true,3471683906,28,3456097205,-15586701
1649191223,194800,true,3470295580,28,3455751629,-14543951
1649191240,194799,true,3470642610,28,3455406089,-15236521
1649191285,194803,true,3469254699,28,3454369674,-14885025
1649191358,194807,true,3467867344,28,3452988272,-14879072
1649191559,194811,true,3466480544,28,3449537182,-16943362
1649191621,194811,true,3466480544,28,3448157712,-18322832
1649192087,194815,true,3465094299,28,3439548514,-25545785
1649192133,194818,true,3464054978,28,3438860707,-25194271
1649192918,194822,true,3462669703,28,3430274722,-32394981
1649194376,194821,true,3463015969,28,3430960811,-32055158
1649194542,194825,true,3461631109,28,3431303907,-30327202
1649195044,194828,true,3460592828,28,3432333401,-28259427
1649195501,194831,true,3459554857,28,3434049911,-25504946
1649195726,194830,true,3459900813,28,3435080229,-24820584
1649195941,194834,true,3458517198,28,3436454468,-22062730
1649196030,194836,true,3457825599,28,3437141793,-20683806
1649196035,194839,true,3456788459,28,3437141793,-19646666
1649198692,194837,true,3457479851,28,3448847378,-8632473
1649199259,194841,true,3456097205,28,3449882136,-6215069
1649199372,194843,true,3455406089,28,3450227124,-5178965
1649199465,194846,true,3454369674,28,3450227124,-4142550
1649199993,194843,true,3455406089,28,3449537182,-5868907
1649201093,194846,true,3454369674,28,3447468184,-6901490
1649201115,194848,true,3453678904,28,3447468184,-6210720
1649201167,194851,true,3452643007,28,3447123471,-5519536
1649201250,194848,true,3453678904,28,3446778794,-6900110
1649201390,194851,true,3452643007,28,3446434150,-6208857
1649201425,194853,true,3451952582,28,3446089541,-5863041
1649202494,194856,true,3450917204,28,3439892469,-11024735
1649202504,194853,true,3451952582,28,3439892469,-12060113
1649202511,194856,true,3450917204,28,3439892469,-11024735
1649202573,194858,true,3450227124,28,3439548514,-10678610
1649202618,194861,true,3449192263,28,3438860707,-10331556
1649202654,194859,true,3449882136,28,3438516856,-11365280
1649202689,194861,true,3449192263,28,3438173038,-11019225
1649202934,194863,true,3448502528,28,3434049911,-14452617
1649202937,194866,true,3447468184,28,3433706541,-13761643
1649202952,194863,true,3448502528,28,3433706541,-14795987
1649203240,194866,true,3447468184,28,3428902955,-18565229
1649203291,194868,true,3446778794,28,3428217277,-18561517
1649203295,194870,true,3446089541,28,3428217277,-17872264
1649203439,194868,true,3446778794,28,3424790945,-21987849
1649203598,194872,true,3445400427,28,3420341832,-25058595
1649203601,194874,true,3444711450,28,3420341832,-24369618
1649203632,194877,true,3443678243,28,3419315934,-24362309
1649203647,194875,true,3444367013,28,3418974037,-25392976
1649203669,194880,true,3442645346,28,3417948550,-24696796
1649203674,194883,true,3441612759,28,3417948550,-23664209
1649203734,194885,true,3440924540,28,3415556942,-25367598
1649203777,194884,true,3441268632,28,3413849676,-27418956
1649203798,194888,true,3439892469,28,3413167009,-26725460
1649203834,194891,true,3438860707,28,3411460937,-27399770
1649203844,194894,true,3437829256,28,3410778747,-27050509
1649203909,194894,true,3437829256,28,3407710581,-30118675
1649203953,194899,true,3436110856,28,3405666670,-30444186
1649203983,194902,true,3435080229,28,3403964347,-31115882
1649203997,194906,true,3433706541,28,3403283656,-30422885
1649204037,194906,true,3433706541,28,3401242401,-32464140
1649204077,194912,true,3431647038,28,3399202369,-32444669
1649204087,194915,true,3430617749,28,3398522631,-32095118
1649204301,194919,true,3429245845,28,3386649186,-42596659
1649204307,194919,true,3429245845,28,3386310555,-42935290
1649204316,194925,true,3427189018,28,3385633394,-41555624
1649204330,194928,true,3426161067,28,3384956369,-41204698
1649204336,194933,true,3424448500,28,3384617907,-39830593
1649204392,194933,true,3424448500,28,3381235150,-43213350
1649204432,194940,true,3422052345,28,3378193560,-43858785
1649204484,194944,true,3420683866,28,3374479775,-46204091
1649204670,194949,true,3418974037,28,3362354094,-56619943
1649204677,194950,true,3418632174,28,3361681724,-56950450
1649204847,194957,true,3416240088,28,3351612294,-64627794
1649205206,194961,true,3414873933,28,3331896984,-82976949
1649205223,194966,true,3413167009,28,3330897615,-82269394
1649205229,194967,true,3412825726,28,3330564559,-82261167
1649205356,194974,true,3410437703,28,3325572706,-84864997
1649205551,194977,true,3409414777,28,3318596680,-90818097
1649205598,194982,true,3407710581,28,3317269573,-90441008
1649206069,194984,true,3407029141,28,3309318069,-97711072
1649206091,194989,true,3405326137,28,3309318069,-96008068
1649206141,194993,true,3403964347,28,3308987170,-94977177
1649206159,194998,true,3402262875,28,3308987170,-93275705
1649206175,194999,true,3401922683,28,3308987170,-92935513
1649206203,195004,true,3400222232,28,3308987170,-91235062
1649206297,195007,true,3399202369,28,3310310964,-88891405
1649206495,195012,true,3397503278,28,3312960140,-84543138
1649206507,195013,true,3397163561,28,3312960140,-84203421
1649206570,195018,true,3395465489,28,3313622765,-81842724
1649206665,195021,true,3394447053,28,3314616951,-79830102
1649206689,195025,true,3393089614,28,3314948413,-78141201
1649206758,195025,true,3393089614,28,3315611435,-77478179
1649207123,195030,true,3391393578,28,3319260432,-72133146
1649207189,195033,true,3390376363,28,3319592358,-70784005
1649207199,195037,true,3389020552,28,3319924317,-69096235
1649207255,195037,true,3389020552,28,3320256310,-68764242
1649207322,195042,true,3387326549,28,3320920394,-66406155
1649207945,195044,true,3386649186,28,3327568549,-59080637
1649208114,195048,true,3385294865,28,3328899776,-56395089
1649208185,195050,true,3384617907,28,3329565589,-55052318
1649210211,195054,true,3383264399,28,3342909855,-40354544
1649211156,195056,true,3382587847,28,3342909855,-39677992
1649211815,195060,true,3381235150,28,3342909855,-38325295
1649211844,195062,true,3380559005,28,3343244146,-37314859
1649212036,195066,true,3379207119,28,3343244146,-35962973
1649212802,195068,true,3378531379,28,3344916102,-33615277
1649212910,195071,true,3377518022,28,3345250594,-32267428
1649214122,195073,true,3376842620,28,3347258246,-29584374
1649217776,195077,true,3375492220,28,3347258246,-28233974
1649217803,195078,true,3375154705,28,3347258246,-27896459
1649217826,195082,true,3373804981,28,3347258246,-26546735
1649218334,195084,true,3373130321,28,3343244146,-29886175
1649218451,195088,true,3371781406,28,3342575597,-29205809
1649218505,195089,true,3371444261,28,3342241373,-29202888
1649218551,195092,true,3370433030,28,3342241373,-28191657
1649218653,195094,true,3369759045,28,3341907182,-27851863
1649218693,195097,true,3368748319,28,3341573025,-27175294
1649220950,195098,true,3368411478,28,3347258246,-21153232
1649221065,195101,true,3367401157,28,3347592972,-19808185
1649221085,195102,true,3367064450,28,3347592972,-19471478
1649221555,195106,true,3365717961,28,3348262524,-17455437
1649221631,195106,true,3365717961,28,3348262524,-17455437
1649221650,195109,true,3364708448,28,3348262524,-16445924
1649222039,195110,true,3364372011,28,3350271984,-14100027
1649222067,195114,true,3363026598,28,3350607011,-12419587
1649222163,195114,true,3363026598,28,3351277166,-11749432
1649222228,195117,true,3362017892,28,3351947455,-10070437
1649222284,195118,true,3361681724,28,3352282650,-9399074
1649223331,195122,true,3360337387,28,3361009488,672101
1649224198,195122,true,3360337387,28,3363699237,3361850
1649225603,195125,true,3359329487,28,3363699237,4369750
1649226215,195127,true,3358657722,28,3364035607,5377885
1649227442,195131,true,3357314595,28,3362690329,5375734
1649228000,195131,true,3357314595,28,3362017892,4703297
1649229456,195134,true,3356307602,28,3363699237,7391635
1649230528,195136,true,3355636441,28,3364372011,8735570
1649231774,195140,true,3354294522,28,3362354094,8059572
1649231780,195140,true,3354294522,28,3362354094,8059572
1649231901,195143,true,3353288435,28,3362017892,8729457
1649231929,195145,true,3352617878,28,3362017892,9400014
1649232722,195149,true,3351277166,28,3356643233,5366067
1649232726,195149,true,3351277166,28,3356643233,5366067
1649232735,195152,true,3350271984,28,3356643233,6371249
1649232788,195154,true,3349602030,28,3356307602,6705572
1649232926,195158,true,3348262524,28,3354965415,6702891
1649233520,195159,true,3347927731,28,3348932210,1004479
1649233866,195162,true,3346923554,28,3346588895,-334659
1649234282,195163,true,3346588895,28,3344916102,-1672793
1649234710,195167,true,3345250594,28,3343578470,-1672124
1649235047,195167,true,3345250594,28,3343912828,-1337766
1649235100,195169,true,3344581644,28,3343912828,-668816
1649235488,195171,true,3343912828,28,3346588895,2676067
1649235786,195174,true,3342909855,28,3348262524,5352669
1649236399,195173,true,3343244146,28,3351947455,8703309
1649237041,195175,true,3342575597,28,3354294522,11718925
1649237108,195176,true,3342241373,28,3354294522,12053149
1649237419,195178,true,3341573025,28,3353288435,11715410
1649238159,195177,true,3341907182,28,3350607011,8699829
1649238553,195180,true,3340904811,28,3348932210,8027399
1649238609,195180,true,3340904811,28,3348932210,8027399
1649238910,195182,true,3340236730,28,3347258246,7021516
1649239497,195181,true,3340570754,28,3346254269,5683515
1649239506,195183,true,3339902740,28,3346254269,6351529
1649239563,195183,true,3339902740,28,3346254269,6351529
1649239977,195184,true,3339568783,28,3344581644,5012861
1649240191,195183,true,3339902740,28,3343578470,3675730
1649240231,195185,true,3339234859,28,3343244146,4009287
1649240319,195184,true,3339568783,28,3342575597,3006814
1649240432,195186,true,3338900969,28,3341238901,2337932
1649240500,195185,true,3339234859,28,3340904811,1669952
1649240611,195187,true,3338567113,28,3339902740,1335627
1649240679,195186,true,3338900969,28,3339568783,667814
1649240697,195187,true,3338567113,28,3339568783,1001670
1649240772,195186,true,3338900969,28,3339234859,333890
1649240904,195187,true,3338567113,28,3338900969,333856
1649240978,195185,true,3339234859,28,3338900969,-333890
1649241572,195186,true,3338900969,28,3339902740,1001771
1649241579,195185,true,3339234859,28,3339902740,667881
1649242226,195185,true,3339234859,28,3341238901,2004042
1649242567,195183,true,3339902740,28,3342575597,2672857
1649242578,195184,true,3339568783,28,3342575597,3006814
1649242633,195181,true,3340570754,28,3342575597,2004843
1649242923,195181,true,3340570754,28,3341238901,668147
1649242967,195179,true,3341238901,28,3340904811,-334090
1649242974,195180,true,3340904811,28,3340904811,0
1649242976,195178,true,3341573025,28,3340904811,-668214
1649242989,195178,true,3341573025,28,3340904811,-668214
1649243031,195177,true,3341907182,28,3340236730,-1670452
1649243106,195178,true,3341573025,28,3339234859,-2338166
1649243229,195177,true,3341907182,28,3337899499,-4007683
1649243396,195177,true,3341907182,28,3335563904,-6343278
1649243491,195176,true,3342241373,28,3334230012,-8011361
1649243496,195177,true,3341907182,28,3334230012,-7677170
1649243537,195176,true,3342241373,28,3333563266,-8678107
1649243618,195177,true,3341907182,28,3332230174,-9677008
1649243659,195176,true,3342241373,28,3331896984,-10344389
1649243669,195178,true,3341573025,28,3331563828,-10009197
1649243683,195177,true,3341907182,28,3331230705,-10676477
1649243787,195178,true,3341573025,28,3329232666,-12340359
1649243911,195178,true,3341573025,28,3326903135,-14669890
1649243945,195180,true,3340904811,28,3326237854,-14666957
1649243979,195179,true,3341238901,28,3325240182,-15998719
1649244461,195181,true,3340570754,28,3314948413,-25622341
1649244505,195181,true,3340570754,28,3313954127,-26616627
1649244518,195182,true,3340236730,28,3313954127,-26282603
1649244547,195182,true,3340236730,28,3313291436,-26945294
1649244790,195184,true,3339568783,28,3307333173,-32235610
1649244797,195184,true,3339568783,28,3307333173,-32235610
1649244824,195186,true,3338900969,28,3307002473,-31898496
1649244832,195186,true,3338900969,28,3306671805,-32229164
1649244841,195188,true,3338233289,28,3306671805,-31561484
1649244922,195188,true,3338233289,28,3305680002,-32553287
1649244930,195190,true,3337565743,28,3305349467,-32216276
1649245528,195190,true,3337565743,28,3300395407,-37170336
1649245715,195193,true,3336564673,28,3300725447,-35839226
1649246319,195192,true,3336898330,28,3303366952,-33531378
1649246511,195194,true,3336231050,28,3304688497,-31542553
1649246870,195194,true,3336231050,28,3306671805,-29559245
1649246889,195197,true,3335230381,28,3306671805,-28558576
1649246907,195196,true,3335563904,28,3306671805,-28892099
1649246918,195199,true,3334563435,28,3306671805,-27891630
1649246949,195199,true,3334563435,28,3306671805,-27891630
1649246981,195201,true,3333896622,28,3306671805,-27224817
1649247040,195201,true,3333896622,28,3306671805,-27224817
1649247127,195202,true,3333563266,28,3306671805,-26891461
1649247155,195202,true,3333563266,28,3306671805,-26891461
1649247201,195205,true,3332563397,28,3306671805,-25891592
1649247227,195205,true,3332563397,28,3306671805,-25891592
1649247273,195206,true,3332230174,28,3307002473,-25227701
1649247299,195207,true,3331896984,28,3307002473,-24894511
1649247388,195209,true,3331230705,28,3307333173,-23897532
1649247508,195209,true,3331230705,28,3307663906,-23566799
1649247772,195210,true,3330897615,28,3308987170,-21910445
1649247992,195210,true,3330897615,28,3309979966,-20917649
1649248852,195212,true,3330231535,28,3314948413,-15283122
1649249983,195213,true,3329898546,28,3316606218,-13292328
1649250673,195214,true,3329565589,28,3314948413,-14617176
1649251038,195215,true,3329232666,28,3314285522,-14947144
1649252133,195217,true,3328566919,28,3312960140,-15606779
1649252177,195218,true,3328234096,28,3312960140,-15273956
1649252182,195219,true,3327901306,28,3312960140,-14941166
1649252321,195220,true,3327568549,28,3312628877,-14939672
1649252355,195223,true,3326570478,28,3312628877,-13941601
1649252519,195224,true,3326237854,28,3311635287,-14602567
1649252860,195226,true,3325572706,28,3308325472,-17247234
1649252885,195227,true,3325240182,28,3307994673,-17245509
1649252945,195230,true,3324242810,28,3306671805,-17571005
1649252947,195232,true,3323578061,28,3306671805,-16906256
1649252964,195235,true,3322581187,28,3306341171,-16240016
1649253062,195237,true,3321916770,28,3303697288,-18219482
1649253763,195241,true,3320588336,28,3284592257,-35996079
1649253779,195242,true,3320256310,28,3284263831,-35992479
1649253781,195245,true,3319260432,28,3284263831,-34996601
1649253791,195247,true,3318596680,28,3283935437,-34661243
1649253866,195251,true,3317269573,28,3281309471,-35960102
1649253877,195253,true,3316606218,28,3280981373,-35624845
1649253912,195255,true,3315942997,28,3279669308,-36273689
1649253991,195257,true,3315279907,28,3276719081,-38560826
1649254035,195262,true,3313622765,28,3275408721,-38214044
1649254039,195263,true,3313291436,28,3275081213,-38210223
1649254476,195266,true,3312297647,28,3261029300,-51268347
1649255083,195268,true,3311635287,28,3250286176,-61349111
1649255096,195272,true,3310310964,28,3249961180,-60349784
1649255506,195274,true,3309649001,28,3246063760,-63585241
1649255575,195277,true,3308656305,28,3245739186,-62917119
1649255601,195279,true,3307994673,28,3245739186,-62255487
1649255617,195284,true,3306341171,28,3245739186,-60601985
1649255697,195285,true,3306010570,28,3246063760,-59946810
1649255955,195287,true,3305349467,28,3248336687,-57012780
1649256525,195289,true,3304688497,28,3254188665,-50499832
1649256543,195293,true,3303366952,28,3254188665,-49178287
1649257460,195294,true,3303036648,28,3262007706,-41028942
1649257525,195297,true,3302045935,28,3262007706,-40038229
1649257561,195298,true,3301715764,28,3262007706,-39708058
1649257811,195302,true,3300395407,28,3260703229,-39692178
1649257940,195304,true,3299735427,28,3260051187,-39684240
1649258339,195307,true,3298745705,28,3257118607,-41627098
1649258342,195308,true,3298415863,28,3257118607,-41297256
1649258373,195312,true,3297096826,28,3256792928,-40303898
1649258444,195314,true,3296437506,28,3255816085,-40621421
1649258463,195317,true,3295448772,28,3255816085,-39632687
1649258527,195318,true,3295119261,28,3254839536,-40279725
1649258609,195322,true,3293801542,28,3253537925,-40263617
1649258636,195324,true,3293142881,28,3253212604,-39930277
1649258954,195326,true,3292484351,28,3249961180,-42523171
1649259067,195328,true,3291825953,28,3248661520,-43164433
1649259110,195333,true,3290180534,28,3248011886,-42168648
1649259132,195335,true,3289522596,28,3247687117,-41835479
1649259227,195338,true,3288535937,28,3246063760,-42472177
1649259255,195340,true,3287878328,28,3245414645,-42463683
1649259271,195345,true,3286234882,28,3245090136,-41144746
1649259576,195346,true,3285906291,28,3243143763,-42762528
1649260013,195349,true,3284920717,28,3242171015,-42749702
1649260027,195350,true,3284592257,28,3242171015,-42421242
1649260172,195355,true,3282950454,28,3242495232,-40455222
1649260207,195356,true,3282622192,28,3242819481,-39802711
1649261069,195357,true,3282293962,28,3251586486,-30707476
1649261149,195359,true,3281637602,28,3252236835,-29400767
1649261629,195363,true,3280325275,28,3255165020,-25160255
1649261648,195363,true,3280325275,28,3255165020,-25160255
1649261704,195365,true,3279669308,28,3255490536,-24178772
1649261743,195367,true,3279013473,28,3255490536,-23522937
1649261792,195371,true,3277702195,28,3255490536,-22211659
1649261877,195371,true,3277702195,28,3255490536,-22211659
1649261926,195373,true,3277046753,28,3255165020,-21881733
1649262021,195375,true,3276391442,28,3254514084,-21877358
1649262090,195379,true,3275081213,28,3253537925,-21543288
1649262118,195379,true,3275081213,28,3253212604,-21868609
1649262135,195381,true,3274426295,28,3253212604,-21213691
1649262146,195383,true,3273771508,28,3252887315,-20884193
1649262345,195388,true,3272135113,28,3249961180,-22173933
1649262555,195388,true,3272135113,28,3246063760,-26071353
1649262654,195390,true,3271480784,28,3244116804,-27363980
1649262682,195392,true,3270826586,28,3243468078,-27358508
1649262767,195396,true,3269518583,28,3241846830,-27671753
1649262810,195397,true,3269191664,28,3240874470,-28317194
1649262859,195399,true,3268537923,28,3239578445,-28959478
1649263181,195401,true,3267884314,28,3232459562,-35424752
1649263207,195405,true,3266577487,28,3231813167,-34764320
1649263361,195406,true,3266250862,28,3227292020,-38958842
1649263500,195408,true,3265597709,28,3223099476,-42498233
1649264035,195411,true,3264618226,28,3211838908,-52779318
1649264083,195415,true,3263312705,28,3211196636,-52116069
1649264138,195416,true,3262986407,28,3210554493,-52431914
1649264256,195419,true,3262007706,28,3209270593,-52737113
1649264588,195421,true,3261355403,28,3207025002,-54330401
1649264807,195426,true,3259725214,28,3204460536,-55264678
1649265259,195428,true,3259073367,28,3200937743,-58135624
1649265475,195431,true,3258095840,28,3199977654,-58118186
1649265764,195434,true,3257118607,28,3198697983,-58420624
1649265823,195439,true,3255490536,28,3198697983,-56792553
1649265981,195440,true,3255165020,28,3198058339,-57106681
1649266859,195442,true,3254514084,28,3198697983,-55816101
1649266878,195445,true,3253537925,28,3199017852,-54520073
1649267289,195450,true,3251911644,28,3202538532,-49373112
1649267342,195451,true,3251586486,28,3202858786,-48727700
1649267404,195452,true,3251261359,28,3203499390,-47761969
1649267560,195455,true,3250286176,28,3205421970,-44864206
1649267586,195459,true,3248986387,28,3205742512,-43243875
1649267623,195461,true,3248336687,28,3206063086,-42273601
1649267761,195462,true,3248011886,28,3207666439,-40345447
1649267783,195465,true,3247037677,28,3207987205,-39050472
1649268033,195469,true,3245739186,28,3210233470,-35505716
1649268055,195471,true,3245090136,28,3210554493,-34535643
1649268086,195472,true,3244765659,28,3211196636,-33569023
1649268100,195475,true,3243792424,28,3211517756,-32274668
1649268109,195479,true,3242495232,28,3211517756,-30977476
1649268140,195479,true,3242495232,28,3212160092,-30335140
1649268307,195480,true,3242171015,28,3216660040,-25510975
1649268454,195482,true,3241522678,28,3220200136,-21322542
1649268462,195486,true,3240226393,28,3220200136,-20026257
1649268509,195487,true,3239902402,28,3220844208,-19058194
1649268579,195488,true,3239578445,28,3221810558,-17767887
1649268649,195492,true,3238282937,28,3222777198,-15505739
1649268661,195495,true,3237311646,28,3222777198,-14534448
1649268677,195495,true,3237311646,28,3223099476,-14212170
1649268756,195497,true,3236664281,28,3223421785,-13242496
1649268845,195501,true,3235369939,28,3223744128,-11625811
1649268899,195504,true,3234399522,28,3223744128,-10655394
1649268987,195504,true,3234399522,28,3223744128,-10655394
1649268998,195504,true,3234399522,28,3223421785,-10977737
1649269038,195507,true,3233429396,28,3223421785,-10007611
1649269080,195511,true,3232136348,28,3223099476,-9036872
1649269116,195511,true,3232136348,28,3222777198,-9359150
1649269380,195511,true,3232136348,28,3220200136,-11936212
1649269446,195515,true,3230843817,28,3219234269,-11609548
1649269468,195517,true,3230197745,28,3218590519,-11607226
1649269482,195518,true,3229874757,28,3218590519,-11284238
1649269539,195519,true,3229551802,28,3217303404,-12248398
1649269555,195523,true,3228260304,28,3216660040,-11600264
1649269597,195525,true,3227614749,28,3216016805,-11597944
1649269851,195525,true,3227614749,28,3211196636,-16418113
1649269904,195525,true,3227614749,28,3209912479,-17702270
1649269940,195529,true,3226324026,28,3208949698,-17374328
1649269950,195531,true,3225678858,28,3208628835,-17050023
1649270050,195530,true,3226001426,28,3206063086,-19938340
1649270243,195530,true,3226001426,28,3202218310,-23783116
1649270313,195533,true,3225033819,28,3201577963,-23455856
1649270528,195535,true,3224388909,28,3200297652,-24091257
1649270641,195535,true,3224388909,28,3200297652,-24091257
1649271214,195534,true,3224711348,28,3207666439,-17044909
1649271253,195538,true,3223421785,28,3208308004,-15113781
1649271298,195539,true,3223099476,28,3209270593,-13828883
1649271557,195539,true,3223099476,28,3215373698,-7725778
1649271602,195538,true,3223421785,28,3216660040,-6761745
1649271630,195542,true,3222132739,28,3217303404,-4829335
1649271649,195543,true,3221810558,28,3217625135,-4185423
1649271706,195541,true,3222454952,28,3218912378,-3542574
1649271709,195540,true,3222777198,28,3219234269,-3542929
1649271713,195544,true,3221488409,28,3219234269,-2254140
1649271722,195544,true,3221488409,28,3219556192,-1932217
1649271740,195543,true,3221810558,28,3219878148,-1932410
1649271960,195540,true,3222777198,28,3223744128,966930
1649271997,195544,true,3221488409,28,3224388909,2900500
1649272302,195545,true,3221166292,28,3227614749,6448457
1649272328,195543,true,3221810558,28,3227614749,5804191
1649272344,195542,true,3222132739,28,3227937510,5804771
1649272505,195545,true,3221166292,28,3228905989,7739697
1649272514,195546,true,3220844208,28,3229228879,8384671
1649272972,195544,true,3221488409,28,3231813167,10324758
1649273135,195542,true,3222132739,28,3232782808,10650069
1649273198,195545,true,3221166292,28,3233106086,11939794
1649273231,195546,true,3220844208,28,3233106086,12261878
1649273245,195545,true,3221166292,28,3233106086,11939794
1649273348,195544,true,3221488409,28,3232782808,11294399
1649273583,195547,true,3220522156,28,3231813167,11291011
1649273609,195548,true,3220200136,28,3231490018,11289882
1649273643,195547,true,3220522156,28,3231166901,10644745
1649273657,195547,true,3220522156,28,3231166901,10644745
1649273696,195551,true,3219234269,28,3230520764,11286495
1649273785,195552,true,3218912378,28,3229551802,10639424
1649274103,195552,true,3218912378,28,3226969323,8056945
1649274377,195551,true,3219234269,28,3224388909,5154640
1649274419,195555,true,3217946897,28,3224066502,6119605
1649274444,195556,true,3217625135,28,3224066502,6441367
1649274537,195555,true,3217946897,28,3223421785,5474888
1649275441,195554,true,3218268692,28,3220844208,2575516
1649275573,195557,true,3217303404,28,3221810558,4507154
1649276015,195558,true,3216981706,28,3225033819,8052113
1649276070,195557,true,3217303404,28,3225356322,8052918
1649276095,195555,true,3217946897,28,3225678858,7731961
1649276129,195558,true,3216981706,28,3225678858,8697152
1649276175,195558,true,3216981706,28,3226001426,9019720
1649276205,195557,true,3217303404,28,3226001426,8698022
1649276226,195556,true,3217625135,28,3225678858,8053723
1649276261,195559,true,3216660040,28,3225678858,9018818
1649276998,195560,true,3216338406,28,3219234269,2895863
1649277207,195558,true,3216981706,28,3217625135,643429
1649278041,195556,true,3217625135,28,3210875549,-6749586
1649278058,195560,true,3216338406,28,3210875549,-5462857
1649278090,195560,true,3216338406,28,3211196636,-5141770
1649278152,195558,true,3216981706,28,3211517756,-5463950
1649278226,195555,true,3217946897,28,3211838908,-6107989
1649278442,195557,true,3217303404,28,3214087870,-3215534
1649278585,195557,true,3217303404,28,3215695235,-1608169
1649278686,195555,true,3217946897,28,3216981706,-965191
1649280490,195552,true,3218912378,28,3231490018,12577640
1649281689,195555,true,3217946897,28,3231490018,13543121
1649282787,195554,true,3218268692,28,3230520764,12252072
1649283679,195552,true,3218912378,28,3228905989,9993611
1649283790,195549,true,3219878148,28,3228583130,8704982
1649284104,195551,true,3219234269,28,3227292020,8057751
1649284440,195551,true,3219234269,28,3225033819,5799550
1649284459,195549,true,3219878148,28,3224711348,4833200
1649284521,195546,true,3220844208,28,3224066502,3222294
1649284936,195549,true,3219878148,28,3220522156,644008
1649284969,195550,true,3219556192,28,3220200136,643944
1649285015,195548,true,3220200136,28,3219878148,-321988
1649285207,195546,true,3220844208,28,3217625135,-3219073
1649285321,195550,true,3219556192,28,3216016805,-3539387
1649285626,195551,true,3219234269,28,3212802556,-6431713
1649285745,195549,true,3219878148,28,3211517756,-8360392
1649285904,195548,true,3220200136,28,3209912479,-10287657
1649285928,195551,true,3219234269,28,3209912479,-9321790
1649285952,195553,true,3218590519,28,3209591520,-8998999
1649286028,195551,true,3219234269,28,3208628835,-10605434
1649286374,195550,true,3219556192,28,3204780982,-14775210
1649286378,195554,true,3218268692,28,3204780982,-13487710
1649286398,195557,true,3217303404,28,3204460536,-12842868
1649286475,195556,true,3217625135,28,3203499390,-14125745
1649286603,195557,true,3217303404,28,3201898120,-15405284
1649286624,195561,true,3216016805,28,3201898120,-14118685
1649286645,195563,true,3215373698,28,3201577963,-13795735
1649286758,195562,true,3215695235,28,3200617681,-15077554
1649287283,195561,true,3216016805,28,3197418823,-18597982
1649287696,195564,true,3215052192,28,3195501043,-19551149
1649287884,195566,true,3214409278,28,3195181525,-19227753
1649288152,195565,true,3214730719,28,3195501043,-19229676
1649288207,195564,true,3215052192,28,3195501043,-19551149
1649288274,195566,true,3214409278,28,3195501043,-18908235
1649288411,195569,true,3213445149,28,3195820593,-17624556
1649288475,195567,true,3214087870,28,3195501043,-18586827
1649288527,195566,true,3214409278,28,3195501043,-18908235
1649288635,195568,true,3213766493,28,3195181525,-18584968
1649288666,195570,true,3213123836,28,3195181525,-17942311
1649288766,195568,true,3213766493,28,3194862039,-18904454
1649289089,195567,true,3214087870,28,3192945792,-21142078
1649289148,195569,true,3213445149,28,3192626530,-20818619
1649289161,195571,true,3212802556,28,3192307299,-20495257
1649289167,195570,true,3213123836,28,3192307299,-20816537
1649289471,195568,true,3213766493,28,3188160203,-25606290
1649290194,195570,true,3213123836,28,3179246286,-33877550
1649290227,195572,true,3212481308,28,3178928393,-33552915
1649290259,195571,true,3212802556,28,3178292702,-34509854
1649290263,195570,true,3213123836,28,3178292702,-34831134
1649290265,195572,true,3212481308,28,3178292702,-34188606
1649290296,195574,true,3211838908,28,3177974905,-33864003
1649290411,195574,true,3211838908,28,3177021703,-34817205
1649290418,195574,true,3211838908,28,3177021703,-34817205
1649290451,195576,true,3211196636,28,3176704033,-34492603
1649290463,195578,true,3210554493,28,3176704033,-33850460
1649290512,195577,true,3210875549,28,3176386394,-34489155
1649290576,195578,true,3210554493,28,3176386394,-34168099
1649290638,195579,true,3210233470,28,3176704033,-33529437
1649291022,195581,true,3209591520,28,3178292702,-31298818
1649291578,195581,true,3209591520,28,3184336896,-25254624
1649291669,195581,true,3209591520,28,3185610822,-23980698
1649291695,195583,true,3208949698,28,3185929383,-23020315
1649291768,195585,true,3208308004,28,3186566601,-21741403
1649291775,195585,true,3208308004,28,3186885258,-21422746
1649292321,195586,true,3207987205,28,3193584414,-14402791
1649292349,195587,true,3207666439,28,3193584414,-14082025
1649292491,195590,true,3206704331,28,3193903772,-12800559
1649292531,195589,true,3207025002,28,3193903772,-13121230
1649292551,195591,true,3206383693,28,3193903772,-12479921
1649292575,195593,true,3205742512,28,3193903772,-11838740
1649292608,195595,true,3205101460,28,3193584414,-11517046
1649292673,195595,true,3205101460,28,3193265087,-11836373
1649292691,195596,true,3204780982,28,3193265087,-11515895
1649292707,195598,true,3204140122,28,3192945792,-11194330
1649292719,195601,true,3203179072,28,3192945792,-10233280
1649292841,195603,true,3202538532,28,3190711624,-11826908
1649292898,195604,true,3202218310,28,3189435658,-12782652
1649292953,195607,true,3201257837,28,3188479019,-12778818
1649292993,195609,true,3200617681,28,3187522667,-13095014
1649293093,195612,true,3199657688,28,3185292293,-14365395
1649293108,195613,true,3199337754,28,3184973796,-14363958
1649293326,195615,true,3198697983,28,3179882167,-18815816
1649293442,195618,true,3197738565,28,3177021703,-20716862
1649293586,195620,true,3197099113,28,3173846428,-23252685
1649293669,195621,true,3196779435,28,3171942786,-24836649
1649293719,195622,true,3196459789,28,3170991394,-25468395
1649293925,195624,true,3195820593,28,3167188676,-28631917
1649293932,195626,true,3195181525,28,3167188676,-27992849
1649293980,195626,true,3195181525,28,3166555334,-28626191
1649294367,195627,true,3194862039,28,3162441692,-32420347
1649294820,195629,true,3194223162,28,3164023229,-30199933
1649295192,195631,true,3193584414,28,3168138928,-25445486
1649295214,195632,true,3193265087,28,3168138928,-25126159
1649295298,195633,true,3192945792,28,3169406374,-23539418
1649295408,195635,true,3192307299,28,3170991394,-21315905
1649295484,195636,true,3191988100,28,3171942786,-20045314
1649296462,195638,true,3191349798,28,3177974905,-13374893
1649296475,195639,true,3191030695,28,3177974905,-13055790
1649296541,195640,true,3190711624,28,3178610532,-12101092
1649296810,195641,true,3190392585,28,3181154310,-9238275
1649298225,195641,true,3190392585,28,3188797867,-1594718
1649298246,195642,true,3190073578,28,3188797867,-1275711
1649298486,195642,true,3190073578,28,3188479019,-1594559
1649299162,195643,true,3189754602,28,3186247976,-3506626
1649299488,195644,true,3189435658,28,3184973796,-4461862
1649299724,195645,true,3189116747,28,3184336896,-4779851
1649299793,195645,true,3189116747,28,3184018495,-5098252
1649299966,195647,true,3188479019,28,3183063480,-5415539
1649300245,195649,true,3187841419,28,3182108752,-5732667
1649300493,195650,true,3187522667,28,3181472426,-6050241
1649301164,195651,true,3187203946,28,3180200155,-7003791
1649302672,195652,true,3186885258,28,3179246286,-7638972
1649303408,195654,true,3186247976,28,3179564210,-6683766
1649303501,195656,true,3185610822,28,3179564210,-6046612
1649303702,195656,true,3185610822,28,3179882167,-5728655
1649304428,195658,true,3184973796,28,3181154310,-3819486
1649304662,195660,true,3184336896,28,3182108752,-2228144
1649304772,195661,true,3184018495,28,3182426963,-1591532
1649305681,195661,true,3184018495,28,3185610822,1592327
1649306065,195662,true,3183700125,28,3186566601,2866476
1649306081,195663,true,3183381786,28,3186566601,3184815
1649306172,195664,true,3183063480,28,3187203946,4140466
1649306185,195663,true,3183381786,28,3187203946,3822160
1649306258,195664,true,3183063480,28,3187522667,4459187
1649307001,195665,true,3182745206,28,3190711624,7966418
1649307051,195665,true,3182745206,28,3191030695,8285489
1649307160,195665,true,3182745206,28,3191668933,8923727
1649310290,195664,true,3183063480,28,3202858786,19795306
1649310315,195665,true,3182745206,28,3202858786,20113580
1649310885,195665,true,3182745206,28,3202858786,20113580
1649310963,195665,true,3182745206,28,3203179072,20433866
1649311044,195664,true,3183063480,28,3203499390,20435910
1649311117,195664,true,3183063480,28,3203819740,20756260
1649311255,195664,true,3183063480,28,3204140122,21076642
1649311323,195663,true,3183381786,28,3204460536,21078750
1649311336,195663,true,3183381786,28,3204460536,21078750
1649311645,195662,true,3183700125,28,3206383693,22683568
1649311990,195662,true,3183700125,28,3208308004,24607879
1649312029,195661,true,3184018495,28,3208628835,24610340
1649315941,195660,true,3184336896,28,3215052192,30715296
1649316020,195660,true,3184336896,28,3215373698,31036802
1649316037,195659,true,3184655330,28,3215373698,30718368
1649316117,195659,true,3184655330,28,3215373698,30718368
1649316269,195658,true,3184973796,28,3215373698,30399902
1649316304,195658,true,3184973796,28,3215695235,30721439
1649316486,195657,true,3185292293,28,3216016805,30724512
1649316499,195656,true,3185610822,28,3216016805,30405983
1649316627,195655,true,3185929383,28,3216338406,30409023
1649317137,195654,true,3186247976,28,3218268692,32020716
1649317220,195654,true,3186247976,28,3218912378,32664402
1649317255,195653,true,3186566601,28,3218912378,32345777
1649317373,195651,true,3187203946,28,3219556192,32352246
1649317507,195650,true,3187522667,28,3220200136,32677469
1649319674,195649,true,3187841419,28,3223421785,35580366
1649321482,195648,true,3188160203,28,3223421785,35261582
1649322674,195647,true,3188479019,28,3222454952,33975933
1649322914,195645,true,3189116747,28,3222132739,33015992
1649322924,195644,true,3189435658,28,3222132739,32697081
1649322961,195643,true,3189754602,28,3221810558,32055956
1649323399,195642,true,3190073578,28,3220844208,30770630
1649323737,195640,true,3190711624,28,3219878148,29166524
1649324391,195639,true,3191030695,28,3216981706,25951011
1649324425,195638,true,3191349798,28,3216660040,25310242
1649324629,195637,true,3191668933,28,3216660040,24991107
1649325008,195635,true,3192307299,28,3217303404,24996105
1649326369,195634,true,3192626530,28,3222132739,29506209
1649327100,195633,true,3192945792,28,3222454952,29509160
1649328322,195632,true,3193265087,28,3222454952,29189865
1649328493,195631,true,3193584414,28,3222454952,28870538
1649329344,195630,true,3193903772,28,3222454952,28551180
1649329385,195629,true,3194223162,28,3222454952,28231790
1649329681,195629,true,3194223162,28,3222454952,28231790
1649329717,195627,true,3194862039,28,3222454952,27592913
1649329726,195626,true,3195181525,28,3222454952,27273427
1649329819,195626,true,3195181525,28,3222777198,27595673
1649329853,195625,true,3195501043,28,3222777198,27276155
1649329915,195624,true,3195820593,28,3222777198,26956605
1649329976,195623,true,3196140175,28,3222777198,26637023
1649329982,195623,true,3196140175,28,3222777198,26637023
1649330012,195622,true,3196459789,28,3222777198,26317409
1649330273,195621,true,3196779435,28,3223099476,26320041
1649331081,195619,true,3197418823,28,3224066502,26647679
1649331127,195619,true,3197418823,28,3224066502,26647679
1649331276,195618,true,3197738565,28,3224711348,26972783
1649331417,195616,true,3198378145,28,3225678858,27300713
1649331419,195614,true,3199017852,28,3225678858,26661006
1649331516,195612,true,3199657688,28,3226324026,26666338
1649331612,195610,true,3200297652,28,3226969323,26671671
1649331670,195607,true,3201257837,28,3227292020,26034183
1649331708,195605,true,3201898120,28,3227614749,25716629
1649331725,195603,true,3202538532,28,3227937510,25398978
1649331759,195600,true,3203499390,28,3228260304,24760914
1649331774,195597,true,3204460536,28,3228583130,24122594
1649331795,195594,true,3205421970,28,3228905989,23484019
1649331817,195593,true,3205742512,28,3229228879,23486367
1649331819,195589,true,3207025002,28,3229228879,22203877
1649331891,195586,true,3207987205,28,3230197745,22210540
1649332298,195584,true,3208628835,28,3236017045,27388210
1649332988,195583,true,3208949698,28,3245414645,36464947
1649332996,195580,true,3209912479,28,3245414645,35502166
1649333042,195577,true,3210875549,28,3246063760,35188211
1649333417,195575,true,3211517756,28,3249961180,38443424
1649333464,195574,true,3211838908,28,3250611205,38772297
1649334682,195570,true,3213123836,28,3257770063,44646227
1649334744,195567,true,3214087870,28,3258095840,44007970
1649334776,195565,true,3214730719,28,3258095840,43365121
1649335062,195564,true,3215052192,28,3258747492,43695300
1649335261,195561,true,3216016805,28,3258747492,42730687
1649335451,195559,true,3216660040,28,3257444319,40784279
1649336002,195557,true,3217303404,28,3253863279,36559875
1649336042,195557,true,3217303404,28,3253537925,36234521
1649336113,195554,true,3218268692,28,3252887315,34618623
1649336291,195553,true,3218590519,28,3251261359,32670840
1649336744,195552,true,3218912378,28,3246388367,27475989
1649336832,195551,true,3219234269,28,3245090136,25855867
1649336859,195548,true,3220200136,28,3244765659,24565523
1649336918,195547,true,3220522156,28,3244116804,23594648
1649336961,195546,true,3220844208,28,3243468078,22623870
1649337218,195546,true,3220844208,28,3239254519,18410311
1649337260,195543,true,3221810558,28,3238930626,17120068
1649337874,195542,true,3222132739,28,3229551802,7419063
1649338084,195541,true,3222454952,28,3226646658,4191706
1649338304,195542,true,3222132739,28,3223421785,1289046
1649338360,195539,true,3223099476,28,3222777198,-322278
1649338651,195538,true,3223421785,28,3218590519,-4831266
1649338672,195538,true,3223421785,28,3218590519,-4831266
1649339578,195537,true,3223744128,28,3218912378,-4831750
1649340023,195535,true,3224388909,28,3220200136,-4188773
1649340446,195534,true,3224711348,28,3224066502,-644846
1649340455,195533,true,3225033819,28,3224066502,-967317
1649340473,195533,true,3225033819,28,3224066502,-967317
1649340494,195530,true,3226001426,28,3224066502,-1934924
1649340676,195530,true,3226001426,28,3224388909,-1612517
1649340738,195529,true,3226324026,28,3224388909,-1935117
1649341306,195529,true,3226324026,28,3222777198,-3546828
1649341364,195527,true,3226969323,28,3222454952,-4514371
1649342413,195527,true,3226969323,28,3216660040,-10309283
1649342421,195527,true,3226969323,28,3216660040,-10309283
1649342443,195527,true,3226969323,28,3216338406,-10630917
1649343196,195526,true,3227292020,28,3208949698,-18342322
1649343274,195527,true,3226969323,28,3207987205,-18982118
1649343379,195527,true,3226969323,28,3207025002,-19944321
1649343442,195527,true,3226969323,28,3206383693,-20585630
1649344329,195527,true,3226969323,28,3196140175,-30829148
1649344409,195529,true,3226324026,28,3195501043,-30822983
1649345328,195529,true,3226324026,28,3187203946,-39120080
1649345458,195530,true,3226001426,28,3186247976,-39753450
1649345560,195530,true,3226001426,28,3184973796,-41027630
1649345618,195532,true,3225356322,28,3184336896,-41019426
1649345798,195534,true,3224711348,28,3182108752,-42602596
1649345973,195534,true,3224711348,28,3180518175,-44193173
1649346372,195535,true,3224388909,28,3178610532,-45778377
1649346475,195536,true,3224066502,28,3178610532,-45455970
1649346936,195537,true,3223744128,28,3180200155,-43543973
1649347014,195538,true,3223421785,28,3180836227,-42585558
1649347234,195538,true,3223421785,28,3182108752,-41313033
1649347302,195539,true,3223099476,28,3182745206,-40354270
1649347771,195540,true,3222777198,28,3189435658,-33341540
1649347854,195540,true,3222777198,28,3190392585,-32384613
1649348058,195540,true,3222777198,28,3193265087,-29512111
1649348929,195541,true,3222454952,28,3203179072,-19275880
1649349375,195541,true,3222454952,28,3206063086,-16391866
1649350117,195542,true,3222132739,28,3207987205,-14145534
1649350712,195542,true,3222132739,28,3207025002,-15107737
1649350738,195543,true,3221810558,28,3207025002,-14785556
1649350753,195543,true,3221810558,28,3207025002,-14785556
1649350857,195544,true,3221488409,28,3207345704,-14142705
1649350998,195543,true,3221810558,28,3207987205,-13823353
1649351101,195544,true,3221488409,28,3208628835,-12859574
1649351155,195544,true,3221488409,28,3208949698,-12538711
1649351334,195544,true,3221488409,28,3210233470,-11254939
1649351464,195543,true,3221810558,28,3211196636,-10613922
1649351519,195544,true,3221488409,28,3211517756,-9970653
1649351570,195543,true,3221810558,28,3212160092,-9650466
1649351579,195543,true,3221810558,28,3212160092,-9650466
1649353631,195541,true,3222454952,28,3228905989,6451037
1649353670,195542,true,3222132739,28,3228905989,6773250
1649355948,195543,true,3221810558,28,3224388909,2578351
1649355961,195543,true,3221810558,28,3224711348,2900790
1649356057,195541,true,3222454952,28,3224711348,2256396
1649356105,195542,true,3222132739,28,3225033819,2901080
1649356600,195542,true,3222132739,28,3226646658,4513919
1649357569,195542,true,3222132739,28,3230197745,8065006
1649357625,195540,true,3222777198,28,3230520764,7743566
1649357963,195541,true,3222454952,28,3231490018,9035066
1649358191,195541,true,3222454952,28,3232136348,9681396
1649358703,195541,true,3222454952,28,3233752739,11297787
1649359185,195539,true,3223099476,28,3235693476,12594000
1649359266,195540,true,3222777198,28,3236017045,13239847
1649359637,195539,true,3223099476,28,3236664281,13564805
1649359851,195539,true,3223099476,28,3236340647,13241171
1649360227,195537,true,3223744128,28,3236017045,12272917
1649360291,195538,true,3223421785,28,3235693476,12271691
1649360346,195538,true,3223421785,28,3235369939,11948154
1649360366,195538,true,3223421785,28,3235369939,11948154
1649361161,195537,true,3223744128,28,3231813167,8069039
1649361543,195538,true,3223421785,28,3230520764,7098979
1649362982,195539,true,3223099476,28,3227937510,4838034
1649363445,195539,true,3223099476,28,3227292020,4192544
1649363879,195538,true,3223421785,28,3227292020,3870235
1649363973,195539,true,3223099476,28,3227292020,4192544
1649364212,195540,true,3222777198,28,3227614749,4837551
1649364328,195540,true,3222777198,28,3227937510,5160312
1649364331,195539,true,3223099476,28,3227937510,4838034
1649366144,195540,true,3222777198,28,3234399522,11622324
1649366207,195541,true,3222454952,28,3234399522,11944570
1649366375,195541,true,3222454952,28,3234076115,11621163
1649366425,195541,true,3222454952,28,3234076115,11621163
1649366457,195542,true,3222132739,28,3234076115,11943376
1649366460,195543,true,3221810558,28,3234076115,12265557
1649366469,195543,true,3221810558,28,3234076115,12265557
1649366494,195543,true,3221810558,28,3233752739,11942181
1649366507,195545,true,3221166292,28,3233752739,12586447
1649366518,195546,true,3220844208,28,3233752739,12908531
1649366549,195547,true,3220522156,28,3233429396,12907240
1649366557,195547,true,3220522156,28,3233106086,12583930
1649366572,195549,true,3219878148,28,3233106086,13227938
1649366651,195551,true,3219234269,28,3232136348,12902079
1649366682,195552,true,3218912378,28,3231813167,12900789
1649366749,195552,true,3218912378,28,3230843817,11931439
1649366921,195554,true,3218268692,28,3228260304,9991612
1649367300,195556,true,3217625135,28,3222454952,4829817
1649367337,195557,true,3217303404,28,3222132739,4829335
1649367821,195556,true,3217625135,28,3217625135,0
1649367991,195558,true,3216981706,28,3216016805,-964901
1649368608,195558,true,3216981706,28,3215052192,-1929514
1649369307,195559,true,3216660040,28,3217946897,1286857
1649370243,195559,true,3216660040,28,3217946897,1286857
1649370291,195560,true,3216338406,28,3218268692,1930286
1649370400,195560,true,3216338406,28,3218590519,2252113
1649371312,195560,true,3216338406,28,3220844208,4505802
1649371899,195559,true,3216660040,28,3222454952,5794912
1649372255,195560,true,3216338406,28,3223421785,7083379
1649372285,195560,true,3216338406,28,3223421785,7083379
1649372564,195559,true,3216660040,28,3224066502,7406462
1649372657,195558,true,3216981706,28,3224388909,7407203
1649372681,195558,true,3216981706,28,3224388909,7407203
1649372694,195558,true,3216981706,28,3224711348,7729642
1649372807,195558,true,3216981706,28,3225033819,8052113
1649372902,195557,true,3217303404,28,3225678858,8375454
1649372913,195558,true,3216981706,28,3225678858,8697152
1649373133,195557,true,3217303404,28,3226969323,9665919
1649373258,195557,true,3217303404,28,3227614749,10311345
1649373269,195556,true,3217625135,28,3227614749,9989614
1649373332,195556,true,3217625135,28,3228260304,10635169
1649373353,195556,true,3217625135,28,3228260304,10635169
1649373518,195555,true,3217946897,28,3230197745,12250848
1649373534,195554,true,3218268692,28,3230197745,11929053
1649373591,195554,true,3218268692,28,3230843817,12575125
1649373615,195553,true,3218590519,28,3231166901,12576382
1649373653,195551,true,3219234269,28,3231813167,12578898
1649374516,195549,true,3219878148,28,3242819481,22941333
1649374814,195548,true,3220200136,28,3245739186,25539050
1649374895,195548,true,3220200136,28,3246388367,26188231
1649375217,195546,true,3220844208,28,3248336687,27492479
1649375378,195543,true,3221810558,28,3248661520,26850962
1649375603,195542,true,3222132739,28,3248336687,26203948
1649375910,195541,true,3222454952,28,3246388367,23933415
1649376059,195540,true,3222777198,28,3245414645,22637447
1649376082,195537,true,3223744128,28,3245414645,21670517
1649376867,195536,true,3224066502,28,3237959141,13892639
1649378167,195535,true,3224388909,28,3233429396,9040487
1649378243,195533,true,3225033819,28,3233429396,8395577
1649378298,195530,true,3226001426,28,3233429396,7427970
1649378729,195530,true,3226001426,28,3233106086,7104660
1649379271,195529,true,3226324026,28,3232136348,5812322
1649379475,195528,true,3226646658,28,3231490018,4843360
1649379484,195526,true,3227292020,28,3231490018,4197998
1649380349,195526,true,3227292020,28,3228583130,1291110
1649380408,195526,true,3227292020,28,3228583130,1291110
1649380602,195524,true,3227937510,28,3229228879,1291369
1649381762,195522,true,3228583130,28,3233752739,5169609
1649381888,195522,true,3228583130,28,3234399522,5816392
1649381953,195523,true,3228260304,28,3234722962,6462658
1649382488,195521,true,3228905989,28,3236340647,7434658
1649382584,195519,true,3229551802,28,3236664281,7112479
1649382683,195519,true,3229551802,28,3236987948,7436146
1649382712,195519,true,3229551802,28,3236987948,7436146
1649383749,195517,true,3230197745,28,3242171015,11973270
1649383773,195515,true,3230843817,28,3242495232,11651415
1649384619,195515,true,3230843817,28,3249311285,18467468
1649385661,195515,true,3230843817,28,3253212604,22368787
1649385942,195513,true,3231490018,28,3254839536,23349518
1649386106,195512,true,3231813167,28,3255816085,24002918
1649386128,195511,true,3232136348,28,3255816085,23679737
1649388994,195510,true,3232459562,28,3266577487,34117925
1649389124,195508,true,3233106086,28,3266577487,33471401
1649389528,195508,true,3233106086,28,3266577487,33471401
1649390892,195507,true,3233429396,28,3264618226,31188830
1649391769,195506,true,3233752739,28,3264291797,30539058
1649394200,195504,true,3234399522,28,3262986407,28586885
1649394648,195503,true,3234722962,28,3262660141,27937179
1649395100,195503,true,3234722962,28,3261681538,26958576
1649395524,195503,true,3234722962,28,3261355403,26632441
1649396392,195501,true,3235369939,28,3260377192,25007253
1649396427,195500,true,3235693476,28,3260703229,25009753
1649396522,195500,true,3235693476,28,3260703229,25009753
1649396623,195500,true,3235693476,28,3260703229,25009753
1649396637,195498,true,3236340647,28,3260703229,24362582
1649396760,195497,true,3236664281,28,3261029300,24365019
1649397022,195497,true,3236664281,28,3262007706,25343425
1649397684,195497,true,3236664281,28,3263639036,26974755
1649397724,195495,true,3237311646,28,3263965400,26653754
1649398450,195493,true,3237959141,28,3267884314,29925173
1649398982,195493,true,3237959141,28,3270172519,32213378
1649399123,195492,true,3238282937,28,3270826586,32543649
1649399159,195490,true,3238930626,28,3271153669,32223043
1649399190,195488,true,3239578445,28,3271153669,31575224
1649399731,195489,true,3239254519,28,3271480784,32226265
1649399994,195488,true,3239578445,28,3271153669,31575224
1649400047,195486,true,3240226393,28,3270826586,30600193
1649400100,195484,true,3240874470,28,3270826586,29952116
1649400364,195484,true,3240874470,28,3268864777,27990307
1649401310,195484,true,3240874470,28,3262986407,22111937
1649401877,195482,true,3241522678,28,3260703229,19180551
1649402022,195480,true,3242171015,28,3260703229,18532214
1649402773,195481,true,3241846830,28,3261029300,19182470
1649402849,195481,true,3241846830,28,3261029300,19182470
1649402981,195479,true,3242495232,28,3261355403,18860171
1649403373,195477,true,3243143763,28,3261355403,18211640
1649404381,195478,true,3242819481,28,3258095840,15276359
1649404509,195478,true,3242819481,28,3257770063,14950582
1649404573,195476,true,3243468078,28,3257770063,14301985
1649404657,195474,true,3244116804,28,3258095840,13979036
1649404680,195474,true,3244116804,28,3258421650,14304846
1649404693,195473,true,3244441215,28,3258421650,13980435
1649404789,195471,true,3245090136,28,3259073367,13983231
1649404808,195468,true,3246063760,28,3259399274,13335514
1649404916,195468,true,3246063760,28,3260377192,14313432
1649405228,195466,true,3246713006,28,3264944688,18231682
1649405307,195463,true,3247687117,28,3266250862,18563745
1649405321,195460,true,3248661520,28,3266250862,17589342
1649405742,195459,true,3248986387,28,3273116852,24130465
1649405893,195457,true,3249636216,28,3276063836,26427620
1649406125,195454,true,3250611205,28,3280325275,29714070
1649406302,195452,true,3251261359,28,3283278749,32017390
1649406404,195451,true,3251586486,28,3284920717,33334231
1649406441,195450,true,3251911644,28,3285249209,33337565
1649406777,195446,true,3253212604,28,3287878328,34665724
1649407637,195444,true,3253863279,28,3291167686,37304407
1649407668,195443,true,3254188665,28,3291496803,37308138
1649407702,195441,true,3254839536,28,3291496803,36657267
1649407733,195438,true,3255816085,28,3291825953,36009868
1649408060,195435,true,3256792928,28,3294130922,37337994
1649408066,195434,true,3257118607,28,3294130922,37012315
1649408169,195433,true,3257444319,28,3295119261,37674942
1649408394,195430,true,3258421650,28,3296437506,38015856
1649408488,195427,true,3259399274,28,3296767150,37367876
1649409702,195427,true,3259399274,28,3298415863,39016589
1649409728,195425,true,3260051187,28,3298086054,38034867
1649411546,195423,true,3260703229,28,3296107895,35404666
1649412445,195420,true,3261681538,28,3293472195,31790657
1649412813,195420,true,3261681538,28,3291825953,30144415
1649414326,195419,true,3262007706,28,3285249209,23241503
1649415863,195417,true,3262660141,28,3284592257,21932116
1649415990,195414,true,3263639036,28,3284592257,20953221
1649415991,195414,true,3263639036,28,3284592257,20953221
1649416876,195414,true,3263639036,28,3280981373,17342337
1649416900,195413,true,3263965400,28,3280981373,17015973
1649417365,195410,true,3264944688,28,3278685604,13740916
1649417531,195411,true,3264618226,28,3277702195,13083969
1649417770,195410,true,3264944688,28,3276063836,11119148
1649417827,195409,true,3265271182,28,3275736262,10465080
1649418076,195408,true,3265597709,28,3274753738,9156029
1649418468,195408,true,3265597709,28,3273116852,7519143
1649418494,195408,true,3265597709,28,3273116852,7519143
1649418991,195407,true,3265924269,28,3271480784,5556515
1649419053,195405,true,3266577487,28,3271153669,4576182
1649420285,195406,true,3266250862,28,3267557558,1306696
1649421523,195405,true,3266577487,28,3264944688,-1632799
1649421934,195404,true,3266904145,28,3263965400,-2938745
1649422015,195403,true,3267230835,28,3263965400,-3265435
1649422080,195403,true,3267230835,28,3263639036,-3591799
1649422179,195402,true,3267557558,28,3263312705,-4244853
1649422376,195402,true,3267557558,28,3262333907,-5223651
1649422420,195400,true,3268211102,28,3262007706,-6203396
1649422446,195400,true,3268211102,28,3261681538,-6529564
1649423381,195401,true,3267884314,28,3248336687,-19547627
1649423414,195401,true,3267884314,28,3247687117,-20197197
1649423432,195399,true,3268537923,28,3247362381,-21175542
1649423932,195399,true,3268537923,28,3239902402,-28635521
1649424003,195400,true,3268211102,28,3238930626,-29280476
1649424085,195400,true,3268211102,28,3237959141,-30251961
1649424331,195399,true,3268537923,28,3235693476,-32844447
1649424375,195400,true,3268211102,28,3235693476,-32517626
1649424397,195401,true,3267884314,28,3235693476,-32190838
1649424459,195401,true,3267884314,28,3235369939,-32514375
1649424650,195400,true,3268211102,28,3234076115,-34134987
1649424684,195401,true,3267884314,28,3234076115,-33808199
1649424823,195402,true,3267557558,28,3233106086,-34451472
1649425255,195403,true,3267230835,28,3230520764,-36710071
1649425266,195402,true,3267557558,28,3230197745,-37359813
1649425873,195403,true,3267230835,28,3226969323,-40261512
1649426537,195405,true,3266577487,28,3225356322,-41221165
1649426578,195406,true,3266250862,28,3225356322,-40894540
1649426594,195405,true,3266577487,28,3225356322,-41221165
1649426677,195407,true,3265924269,28,3225678858,-40245411
1649426720,195408,true,3265597709,28,3226001426,-39596283
1649426738,195409,true,3265271182,28,3226001426,-39269756
1649426746,195409,true,3265271182,28,3226324026,-38947156
1649426761,195410,true,3264944688,28,3226324026,-38620662
1649427556,195410,true,3264944688,28,3237959141,-26985547
1649427620,195411,true,3264618226,28,3238930626,-25687600
1649427759,195410,true,3264944688,28,3241198558,-23746130
1649427833,195411,true,3264618226,28,3242495232,-22122994
1649427849,195411,true,3264618226,28,3242819481,-21798745
1649427874,195411,true,3264618226,28,3243143763,-21474463
1649427989,195410,true,3264944688,28,3245739186,-19205502
1649428034,195410,true,3264944688,28,3246713006,-18231682
1649428068,195410,true,3264944688,28,3247687117,-17257571
1649428078,195411,true,3264618226,28,3248011886,-16606340
1649428112,195409,true,3265271182,28,3248986387,-16284795
1649428176,195409,true,3265271182,28,3250936266,-14334916
1649428286,195409,true,3265271182,28,3253863279,-11407903
1649428305,195409,true,3265271182,28,3254514084,-10757098
1649428316,195408,true,3265597709,28,3254839536,-10758173
1649428323,195408,true,3265597709,28,3255165020,-10432689
1649428395,195407,true,3265924269,28,3257444319,-8479950
1649428765,195408,true,3265597709,28,3265597709,0
1649429061,195407,true,3265924269,28,3271153669,5229400
1649429065,195406,true,3266250862,28,3271153669,4902807
1649429078,195406,true,3266250862,28,3271153669,4902807
1649429143,195406,true,3266250862,28,3272462327,6211465
1649429371,195405,true,3266577487,28,3275736262,9158775
1649429406,195405,true,3266577487,28,3276063836,9486349
1649429478,195404,true,3266904145,28,3276719081,9814936
1649429505,195405,true,3266577487,28,3277046753,10469266
1649429542,195404,true,3266904145,28,3277702195,10798050
1649429576,195403,true,3267230835,28,3278357768,11126933
1649429736,195401,true,3267884314,28,3280653307,12768993
1649430105,195401,true,3267884314,28,3284592257,16707943
1649430526,195400,true,3268211102,28,3287549573,19338471
1649430806,195399,true,3268537923,28,3289522596,20984673
1649431661,195397,true,3269191664,28,3294460336,25268672
1649431718,195397,true,3269191664,28,3294460336,25268672
1649432239,195396,true,3269518583,28,3293142881,23624298
1649432303,195396,true,3269518583,28,3292813599,23295016
1649432377,195395,true,3269845535,28,3292484351,22638816
1649436568,195396,true,3269518583,28,3283278749,13760166
1649436672,195395,true,3269845535,28,3283278749,13433214
1649436676,195395,true,3269845535,28,3283278749,13433214
1649437617,195395,true,3269845535,28,3276391442,6545907
1649437765,195398,true,3268864777,28,3275081213,6216436
1649437927,195397,true,3269191664,28,3273771508,4579844
1649438044,195397,true,3269191664,28,3272462327,3270663
1649438193,195397,true,3269191664,28,3270499536,1307872
1649438210,195400,true,3268211102,28,3270172519,1961417
1649438225,195400,true,3268211102,28,3269845535,1634433
1649438253,195400,true,3268211102,28,3269518583,1307481
1649438279,195401,true,3267884314,28,3269191664,1307350
1649438308,195404,true,3266904145,28,3268537923,1633778
1649438982,195405,true,3266577487,28,3258747492,-7829995
1649438993,195405,true,3266577487,28,3258421650,-8155837
1649439041,195406,true,3266250862,28,3257770063,-8480799
1649439065,195409,true,3265271182,28,3257444319,-7826863
1649439296,195411,true,3264618226,28,3253863279,-10754947
1649439498,195412,true,3264291797,28,3249961180,-14330617
1649441016,195413,true,3263965400,28,3238930626,-25034774
1649441245,195416,true,3262986407,28,3238930626,-24055781
1649441526,195418,true,3262333907,28,3239254519,-23079388
1649441578,195419,true,3262007706,28,3238930626,-23077080
1649441593,195419,true,3262007706,28,3238930626,-23077080
1649441869,195423,true,3260703229,28,3236987948,-23715281
1649442047,195426,true,3259725214,28,3235693476,-24031738
1649442058,195426,true,3259725214,28,3235369939,-24355275
1649442308,195426,true,3259725214,28,3234399522,-25325692
1649442617,195429,true,3258747492,28,3232782808,-25964684
1649443247,195432,true,3257770063,28,3230520764,-27249299
1649443270,195432,true,3257770063,28,3230520764,-27249299
1649443283,195432,true,3257770063,28,3230520764,-27249299
1649443526,195434,true,3257118607,28,3232459562,-24659045
1649443643,195435,true,3256792928,28,3233752739,-23040189
1649443670,195435,true,3256792928,28,3234076115,-22716813
1649443882,195435,true,3256792928,28,3236664281,-20128647
1649443991,195437,true,3256141667,28,3238606765,-17534902
1649444260,195437,true,3256141667,28,3243792424,-12349243
1649444268,195437,true,3256141667,28,3243792424,-12349243
1649446116,195435,true,3256792928,28,3264291797,7498869
1649446411,195437,true,3256141667,28,3264291797,8150130
1649446560,195437,true,3256141667,28,3264291797,8150130
1649446712,195437,true,3256141667,28,3263965400,7823733
1649446809,195436,true,3256467281,28,3263965400,7498119
1649446842,195438,true,3255816085,28,3263639036,7822951
1649446885,195438,true,3255816085,28,3263312705,7496620
1649447164,195438,true,3255816085,28,3261029300,5213215
1649447340,195437,true,3256141667,28,3259725214,3583547
1649447394,195439,true,3255490536,28,3259073367,3582831
1649447433,195439,true,3255490536,28,3258747492,3256956
1649448598,195439,true,3255490536,28,3245414645,-10075891
1649449052,195437,true,3256141667,28,3243792424,-12349243
1649449266,195438,true,3255816085,28,3243143763,-12672322
1649449547,195438,true,3255816085,28,3243143763,-12672322
1649450168,195439,true,3255490536,28,3241846830,-13643706
1649451582,195436,true,3256467281,28,3239578445,-16888836
1649451616,195437,true,3256141667,28,3239578445,-16563222
1649451662,195438,true,3255816085,28,3239902402,-15913683
1649452244,195438,true,3255816085,28,3242171015,-13645070
1649453653,195435,true,3256792928,28,3246713006,-10079922
1649453663,195436,true,3256467281,28,3246713006,-9754275
1649453757,195436,true,3256467281,28,3246713006,-9754275
1649453771,195436,true,3256467281,28,3246713006,-9754275
1649453789,195433,true,3257444319,28,3246713006,-10731313
1649453811,195434,true,3257118607,28,3246713006,-10405601
1649453821,195434,true,3257118607,28,3246713006,-10405601
1649453831,195434,true,3257118607,28,3246713006,-10405601
1649453839,195431,true,3258095840,28,3246713006,-11382834
1649453848,195432,true,3257770063,28,3246713006,-11057057
1649453857,195432,true,3257770063,28,3246713006,-11057057
1649454042,195433,true,3257444319,28,3245090136,-12354183
1649454050,195431,true,3258095840,28,3245090136,-13005704
1649454246,195432,true,3257770063,28,3243468078,-14301985
1649454290,195433,true,3257444319,28,3243143763,-14300556
1649454297,195434,true,3257118607,28,3242819481,-14299126
1649454326,195433,true,3257444319,28,3242495232,-14949087
1649454341,195435,true,3256792928,28,3242495232,-14297696
1649454351,195435,true,3256792928,28,3242495232,-14297696
1649454433,195437,true,3256141667,28,3241522678,-14618989
1649455034,195436,true,3256467281,28,3234399522,-22067759
1649455776,195438,true,3255816085,28,3226969323,-28846762
1649455943,195439,true,3255490536,28,3226001426,-29489110
1649456043,195441,true,3254839536,28,3225356322,-29483214
1649456095,195441,true,3254839536,28,3225033819,-29805717
1649456149,195443,true,3254188665,28,3224388909,-29799756
1649456168,195445,true,3253537925,28,3224388909,-29149016
1649456199,195448,true,3252562059,28,3224066502,-28495557
1649456232,195448,true,3252562059,28,3223744128,-28817931
1649456362,195451,true,3251586486,28,3222777198,-28809288
1649456421,195453,true,3250936266,28,3222132739,-28803527
1649456439,195456,true,3249961180,28,3222132739,-27828441
1649456452,195456,true,3249961180,28,3221810558,-28150622
1649456488,195459,true,3248986387,28,3221488409,-27497978
1649457064,195462,true,3248011886,28,3214087870,-33924016
1649457645,195465,true,3247037677,28,3207025002,-40012675
1649457756,195465,true,3247037677,28,3205742512,-41295165
1649457780,195468,true,3246063760,28,3205421970,-40641790
1649458429,195470,true,3245414645,28,3200937743,-44476902
1649458656,195473,true,3244441215,28,3200297652,-44143563
1649458843,195474,true,3244116804,28,3199977654,-44139150
1649458868,195477,true,3243143763,28,3199977654,-43166109
1649458967,195479,true,3242495232,28,3199337754,-43157478
1649459211,195482,true,3241522678,28,3198058339,-43464339
1649459297,195484,true,3240874470,28,3197738565,-43135905
1649459424,195488,true,3239578445,28,3196779435,-42799010
1649459468,195490,true,3238930626,28,3196779435,-42151191
1649459532,195494,true,3237635378,28,3196140175,-41495203
1649459954,195496,true,3236987948,28,3193265087,-43722861
1649460129,195499,true,3236017045,28,3191988100,-44028945
1649460274,195502,true,3235046434,28,3191030695,-44015739
1649460350,195506,true,3233752739,28,3190711624,-43041115
1649461372,195507,true,3233429396,28,3185929383,-47500013
1649461538,195510,true,3232459562,28,3185929383,-46530179
1649461618,195513,true,3231490018,28,3185929383,-45560635
1649462049,195516,true,3230520764,28,3185292293,-45228471
1649462251,195518,true,3229874757,28,3184973796,-44900961
1649462448,195520,true,3229228879,28,3184973796,-44255083
1649462507,195522,true,3228583130,28,3184973796,-43609334
1649462546,195526,true,3227292020,28,3185292293,-41999727
1649462563,195527,true,3226969323,28,3185292293,-41677030
1649465255,195527,true,3226969323,28,3199017852,-27951471
1649465581,195529,true,3226324026,28,3199337754,-26986272
1649465617,195532,true,3225356322,28,3199657688,-25698634
1649465778,195533,true,3225033819,28,3200297652,-24736167
1649466265,195532,true,3225356322,28,3202538532,-22817790
1649466353,195533,true,3225033819,28,3202858786,-22175033
1649466379,195537,true,3223744128,28,3203179072,-20565056
1649466422,195537,true,3223744128,28,3203499390,-20244738
1649466516,195536,true,3224066502,28,3204140122,-19926380
1649468247,195537,true,3223744128,28,3212802556,-10941572
1649469392,195540,true,3222777198,28,3206063086,-16714112
1649469431,195540,true,3222777198,28,3205742512,-17034686
1649469574,195540,true,3222777198,28,3205421970,-17355228
1649469583,195541,true,3222454952,28,3205421970,-17032982
1649469652,195544,true,3221488409,28,3205101460,-16386949
1649469658,195544,true,3221488409,28,3205101460,-16386949
1649470732,195542,true,3222132739,28,3209912479,-12220260
1649471158,195542,true,3222132739,28,3212802556,-9330183
1649471750,195545,true,3221166292,28,3214087870,-7078422
1649471788,195545,true,3221166292,28,3214087870,-7078422
1649471882,195543,true,3221810558,28,3214087870,-7722688
1649471968,195544,true,3221488409,28,3213766493,-7721916
1649472070,195548,true,3220200136,28,3213123836,-7076300
1649472802,195548,true,3220200136,28,3208308004,-11892132
1649472856,195547,true,3220522156,28,3207987205,-12534951
1649472862,195549,true,3219878148,28,3207987205,-11890943
1649472938,195552,true,3218912378,28,3207025002,-11887376
1649473654,195554,true,3218268692,28,3199017852,-19250840
1649473691,195553,true,3218590519,28,3198697983,-19892536
1649473912,195556,true,3217625135,28,3196779435,-20845700
1649474030,195560,true,3216338406,28,3196459789,-19878617
1649475411,195562,true,3215695235,28,3197418823,-18276412
1649476087,195561,true,3216016805,28,3199657688,-16359117
1649476114,195563,true,3215373698,28,3199657688,-15716010
1649476129,195567,true,3214087870,28,3199657688,-14430182
1649476230,195568,true,3213766493,28,3199977654,-13788839
1649476254,195567,true,3214087870,28,3199977654,-14110216
1649476325,195569,true,3213445149,28,3200297652,-13147497
1649476451,195572,true,3212481308,28,3200937743,-11543565
1649477227,195573,true,3212160092,28,3205101460,-7058632
1649477988,195572,true,3212481308,28,3208628835,-3852473
1649478200,195573,true,3212160092,28,3209270593,-2889499
1649478458,195576,true,3211196636,28,3209912479,-1284157
1649479263,195577,true,3210875549,28,3210875549,0
1649479300,195575,true,3211517756,28,3210875549,-642207
1649479766,195577,true,3210875549,28,3211517756,642207
1649480349,195579,true,3210233470,28,3211517756,1284286
1649483797,195580,true,3209912479,28,3211517756,1605277
1649483823,195578,true,3210554493,28,3211838908,1284415
1649483875,195580,true,3209912479,28,3211838908,1926429
1649483901,195582,true,3209270593,28,3211838908,2568315
1649484634,195583,true,3208949698,28,3215052192,6102494
1649484878,195581,true,3209591520,28,3216016805,6425285
1649485101,195583,true,3208949698,28,3217303404,8353706
1649486060,195585,true,3208308004,28,3218268692,9960688
1649486265,195586,true,3207987205,28,3217946897,9959692
1649486333,195584,true,3208628835,28,3217946897,9318062
1649486503,195586,true,3207987205,28,3216981706,8994501
1649486606,195589,true,3207025002,28,3216660040,9635038
1649487111,195589,true,3207025002,28,3213766493,6741491
1649488108,195588,true,3207345704,28,3209912479,2566775
1649488324,195589,true,3207025002,28,3209912479,2887477
1649488386,195591,true,3206383693,28,3209912479,3528786
1649488582,195592,true,3206063086,28,3209591520,3528434
1649489574,195590,true,3206704331,28,3209270593,2566262
1649490740,195592,true,3206063086,28,3207345704,1282618
1649490929,195594,true,3205421970,28,3207025002,1603032
1649491849,195595,true,3205101460,28,3206383693,1282233
1649492391,195593,true,3205742512,28,3206383693,641181
1649492967,195594,true,3205421970,28,3206383693,961723
1649494075,195596,true,3204780982,28,3206383693,1602711
1649494142,195597,true,3204460536,28,3206383693,1923157
1649494161,195595,true,3205101460,28,3206383693,1282233
1649494851,195596,true,3204780982,28,3206383693,1602711
1649495087,195598,true,3204140122,28,3206383693,2243571
1649495741,195599,true,3203819740,28,3206383693,2563953
1649496558,195597,true,3204460536,28,3206383693,1923157
1649496838,195598,true,3204140122,28,3206383693,2243571
1649496915,195599,true,3203819740,28,3206383693,2563953
1649497106,195600,true,3203499390,28,3206383693,2884303
1649497176,195597,true,3204460536,28,3206383693,1923157
1649497288,195598,true,3204140122,28,3206383693,2243571
1649497326,195600,true,3203499390,28,3206383693,2884303
1649497605,195600,true,3203499390,28,3206383693,2884303
1649498039,195597,true,3204460536,28,3206383693,1923157
1649498219,195598,true,3204140122,28,3206383693,2243571
1649498499,195599,true,3203819740,28,3206383693,2563953
1649498766,195600,true,3203499390,28,3206383693,2884303
1649499765,195597,true,3204460536,28,3206383693,1923157
1649500324,195597,true,3204460536,28,3206383693,1923157
1649500346,195598,true,3204140122,28,3206383693,2243571
1649500708,195599,true,3203819740,28,3206063086,2243346
1649501472,195596,true,3204780982,28,3204780982,0
1649503055,195596,true,3204780982,28,3203819740,-961242
1649503161,195597,true,3204460536,28,3204140122,-320414
1649503258,195598,true,3204140122,28,3204140122,0
1649503336,195595,true,3205101460,28,3204460536,-640924
1649504638,195595,true,3205101460,28,3207666439,2564979
1649506171,195595,true,3205101460,28,3208308004,3206544
1649506675,195595,true,3205101460,28,3208308004,3206544
1649507283,195592,true,3206063086,28,3208308004,2244918
1649507292,195592,true,3206063086,28,3208308004,2244918
1649507596,195593,true,3205742512,28,3208308004,2565492
1649507698,195593,true,3205742512,28,3208628835,2886323
1649508146,195589,true,3207025002,28,3210554493,3529491
1649508222,195589,true,3207025002,28,3210875549,3850547
1649508376,195590,true,3206704331,28,3211196636,4492305
1649508762,195589,true,3207025002,28,3212481308,5456306
1649509034,195586,true,3207987205,28,3213445149,5457944
1649509095,195586,true,3207987205,28,3213766493,5779288
1649509218,195586,true,3207987205,28,3215052192,7064987
1649509220,195586,true,3207987205,28,3215052192,7064987
1649509886,195583,true,3208949698,28,3219556192,10606494
1649509979,195583,true,3208949698,28,3219878148,10928450
1649510509,195583,true,3208949698,28,3223099476,14149778
1649510684,195583,true,3208949698,28,3224388909,15439211
1649512077,195581,true,3209591520,28,3225356322,15764802
1649512826,195581,true,3209591520,28,3225356322,15764802
1649512895,195581,true,3209591520,28,3225356322,15764802
1649513537,195581,true,3209591520,28,3225356322,15764802
1649513597,195579,true,3210233470,28,3225356322,15122852
1649513670,195580,true,3209912479,28,3225356322,15443843
1649513924,195580,true,3209912479,28,3224711348,14798869
1649514338,195580,true,3209912479,28,3223744128,13831649
1649516246,195578,true,3210554493,28,3221166292,10611799
1649516446,195578,true,3210554493,28,3221166292,10611799
1649516509,195578,true,3210554493,28,3221166292,10611799
1649518462,195578,true,3210554493,28,3221166292,10611799
1649519405,195577,true,3210875549,28,3221166292,10290743
1649519710,195577,true,3210875549,28,3221166292,10290743
1649519733,195577,true,3210875549,28,3221166292,10290743
1649521182,195578,true,3210554493,28,3212160092,1605599
1649521266,195577,true,3210875549,28,3211838908,963359
1649521547,195577,true,3210875549,28,3210554493,-321056
1649521592,195577,true,3210875549,28,3210554493,-321056
1649521870,195577,true,3210875549,28,3211196636,321087
1649522045,195576,true,3211196636,28,3211838908,642272
1649522155,195576,true,3211196636,28,3212160092,963456
1649522262,195575,true,3211517756,28,3212481308,963552
1649522554,195574,true,3211838908,28,3213766493,1927585
1649522609,195573,true,3212160092,28,3213766493,1606401
1649522733,195573,true,3212160092,28,3214409278,2249186
1649523069,195573,true,3212160092,28,3215695235,3535143
1649523612,195572,true,3212481308,28,3216981706,4500398
1649524465,195571,true,3212802556,28,3217946897,5144341
1649524483,195571,true,3212802556,28,3217946897,5144341
1649524860,195571,true,3212802556,28,3218268692,5466136
1649524868,195570,true,3213123836,28,3218268692,5144856
1649525106,195569,true,3213445149,28,3218912378,5467229
1649525311,195569,true,3213445149,28,3219556192,6111043
1649525448,195569,true,3213445149,28,3219878148,6432999
1649528483,195567,true,3214087870,28,3239254519,25166649
1649528574,195566,true,3214409278,28,3239254519,24845241
1649529281,195566,true,3214409278,28,3239254519,24845241
1649530111,195566,true,3214409278,28,3239254519,24845241
1649530316,195564,true,3215052192,28,3239254519,24202327
1649531173,195563,true,3215373698,28,3239254519,23880821
1649532285,195563,true,3215373698,28,3239254519,23880821
1649533193,195562,true,3215695235,28,3239254519,23559284
1649534402,195561,true,3216016805,28,3239254519,23237714
1649534655,195560,true,3216338406,28,3239254519,22916113
1649535326,195560,true,3216338406,28,3239254519,22916113
1649537215,195559,true,3216660040,28,3240874470,24214430
1649537345,195558,true,3216981706,28,3240874470,23892764
1649537375,195558,true,3216981706,28,3240874470,23892764
1649537404,195557,true,3217303404,28,3240874470,23571066
1649537572,195557,true,3217303404,28,3240550415,23247011
1649538025,195556,true,3217625135,28,3238930626,21305491
1649539793,195556,true,3217625135,28,3234076115,16450980
1649539836,195555,true,3217946897,28,3234076115,16129218
1649539868,195555,true,3217946897,28,3234076115,16129218
1649539981,195554,true,3218268692,28,3234722962,16454270
1649541547,195552,true,3218912378,28,3241198558,22286180
1649543933,195552,true,3218912378,28,3241198558,22286180
1649544040,195551,true,3219234269,28,3241522678,22288409
1649545638,195550,true,3219556192,28,3241846830,22290638
1649546868,195549,true,3219878148,28,3242819481,22941333
1649546960,195548,true,3220200136,28,3242819481,22619345
1649547154,195547,true,3220522156,28,3243143763,22621607
1649547457,195546,true,3220844208,28,3245090136,24245928
1649547529,195544,true,3221488409,28,3245414645,23926236
1649547603,195543,true,3221810558,28,3245739186,23928628
1649548143,195542,true,3222132739,28,3249311285,27178546
1649548229,195541,true,3222454952,28,3249961180,27506228
1649550038,195538,true,3223421785,28,3259399274,35977489
1649550053,195537,true,3223744128,28,3259399274,35655146
1649550066,195536,true,3224066502,28,3259399274,35332772
1649554436,195535,true,3224388909,28,3257444319,33055410
1649554957,195532,true,3225356322,28,3257444319,32087997
1649555044,195532,true,3225356322,28,3257444319,32087997
1649555993,195531,true,3225678858,28,3257444319,31765461
1649558193,195529,true,3226324026,28,3257444319,31120293
1649558741,195527,true,3226969323,28,3257444319,30474996
1649560339,195526,true,3227292020,28,3257444319,30152299
1649560366,195525,true,3227614749,28,3257444319,29829570
1649560406,195524,true,3227937510,28,3257444319,29506809
1649560566,195521,true,3228905989,28,3257770063,28864074
1649561558,195520,true,3229228879,28,3258747492,29518613
1649562403,195519,true,3229551802,28,3259399274,29847472
1649564927,195518,true,3229874757,28,3259399274,29524517
1649564988,195515,true,3230843817,28,3259399274,28555457
1649565646,195514,true,3231166901,28,3259399274,28232373
1649565928,195513,true,3231490018,28,3259399274,27909256
1649565992,195512,true,3231813167,28,3259399274,27586107
1649566695,195509,true,3232782808,28,3259399274,26616466
1649567890,195508,true,3233106086,28,3259073367,25967281
1649568322,195507,true,3233429396,28,3259073367,25643971
1649568419,195506,true,3233752739,28,3259073367,25320628
1649569606,195503,true,3234722962,28,3258095840,23372878
1649569994,195503,true,3234722962,28,3257444319,22721357
1649570087,195502,true,3235046434,28,3257444319,22397885
1649570210,195501,true,3235369939,28,3257118607,21748668
1649570365,195498,true,3236340647,28,3256792928,20452281
1649570980,195498,true,3236340647,28,3255490536,19149889
1649571079,195497,true,3236664281,28,3255165020,18500739
1649571288,195496,true,3236987948,28,3254839536,17851588
1649571779,195494,true,3237635378,28,3253537925,15902547
1649571997,195493,true,3237959141,28,3253212604,15253463
1649572199,195493,true,3237959141,28,3252887315,14928174
1649572440,195492,true,3238282937,28,3252236835,13953898
1649572544,195489,true,3239254519,28,3252236835,12982316
1649572614,195489,true,3239254519,28,3252236835,12982316
1649573261,195489,true,3239254519,28,3251261359,12006840
1649573935,195488,true,3239578445,28,3250286176,10707731
1649573956,195487,true,3239902402,28,3250286176,10383774
1649573979,195487,true,3239902402,28,3250286176,10383774
1649573982,195486,true,3240226393,28,3250286176,10059783
1649574342,195485,true,3240550415,28,3250286176,9735761
1649574918,195484,true,3240874470,28,3250286176,9411706
1649575083,195484,true,3240874470,28,3250286176,9411706
1649575284,195483,true,3241198558,28,3250286176,9087618
1649575300,195482,true,3241522678,28,3250286176,8763498
1649575336,195481,true,3241846830,28,3250286176,8439346
1649575571,195481,true,3241846830,28,3250286176,8439346
1649575703,195481,true,3241846830,28,3250286176,8439346
1649575813,195479,true,3242495232,28,3250286176,7790944
1649575851,195478,true,3242819481,28,3250286176,7466695
1649575944,195478,true,3242819481,28,3250286176,7466695
1649575965,195477,true,3243143763,28,3250286176,7142413
1649576049,195476,true,3243468078,28,3249961180,6493102
1649576257,195475,true,3243792424,28,3249311285,5518861
1649576464,195475,true,3243792424,28,3248661520,4869096
1649576490,195475,true,3243792424,28,3248661520,4869096
1649576496,195473,true,3244441215,28,3248661520,4220305
1649577543,195472,true,3244765659,28,3245414645,648986
1649577628,195472,true,3244765659,28,3245090136,324477
1649578141,195471,true,3245090136,28,3244765659,-324477
1649578718,195470,true,3245414645,28,3244765659,-648986
1649578882,195468,true,3246063760,28,3244765659,-1298101
1649578910,195468,true,3246063760,28,3244765659,-1298101
1649579058,195468,true,3246063760,28,3244765659,-1298101
1649579138,195467,true,3246388367,28,3244765659,-1622708
1649579141,195465,true,3247037677,28,3244765659,-2272018
1649579318,195465,true,3247037677,28,3244765659,-2272018
1649579782,195465,true,3247037677,28,3244765659,-2272018
1649579949,195464,true,3247362381,28,3244765659,-2596722
1649579953,195462,true,3248011886,28,3244765659,-3246227
1649580678,195462,true,3248011886,28,3244765659,-3246227
1649580811,195462,true,3248011886,28,3244765659,-3246227
1649582069,195461,true,3248336687,28,3244765659,-3571028
1649582179,195459,true,3248986387,28,3244765659,-4220728
1649582242,195460,true,3248661520,28,3244765659,-3895861
1649582387,195459,true,3248986387,28,3244765659,-4220728
1649582572,195460,true,3248661520,28,3244765659,-3895861
1649582888,195459,true,3248986387,28,3244765659,-4220728
1649583150,195459,true,3248986387,28,3244765659,-4220728
1649583175,195459,true,3248986387,28,3244765659,-4220728
1649583188,195459,true,3248986387,28,3244765659,-4220728
1649584343,195458,true,3249311285,28,3244765659,-4545626
1649584615,195458,true,3249311285,28,3244765659,-4545626
1649584633,195458,true,3249311285,28,3244765659,-4545626
1649584667,195459,true,3248986387,28,3244765659,-4220728
1649584789,195458,true,3249311285,28,3244441215,-4870070
1649584936,195458,true,3249311285,28,3244441215,-4870070
1649585087,195458,true,3249311285,28,3244441215,-4870070
1649585148,195458,true,3249311285,28,3244441215,-4870070
1649585181,195457,true,3249636216,28,3244441215,-5195001
1649585230,195457,true,3249636216,28,3244441215,-5195001
1649585618,195457,true,3249636216,28,3244441215,-5195001
1649586051,195457,true,3249636216,28,3244441215,-5195001
1649586128,195456,true,3249961180,28,3244441215,-5519965
1649586310,195456,true,3249961180,28,3244441215,-5519965
1649586366,195456,true,3249961180,28,3244441215,-5519965
1649586924,195456,true,3249961180,28,3244116804,-5844376
1649586979,195456,true,3249961180,28,3244116804,-5844376
1649586983,195456,true,3249961180,28,3244116804,-5844376
1649587031,195456,true,3249961180,28,3244116804,-5844376
1649587396,195456,true,3249961180,28,3244116804,-5844376
1649587588,195456,true,3249961180,28,3244116804,-5844376
1649587741,195456,true,3249961180,28,3244116804,-5844376
1649588027,195455,true,3250286176,28,3244116804,-6169372
1649588162,195456,true,3249961180,28,3244116804,-5844376
1649588203,195456,true,3249961180,28,3244116804,-5844376
1649588567,195456,true,3249961180,28,3244116804,-5844376
1649588897,195457,true,3249636216,28,3244116804,-5519412
1649589057,195457,true,3249636216,28,3244116804,-5519412
1649589084,195458,true,3249311285,28,3244116804,-5194481
1649589298,195458,true,3249311285,28,3244116804,-5194481
1649589362,195458,true,3249311285,28,3244116804,-5194481
1649589368,195459,true,3248986387,28,3244116804,-4869583
1649589401,195459,true,3248986387,28,3244116804,-4869583
1649589912,195460,true,3248661520,28,3244116804,-4544716
1649590376,195460,true,3248661520,28,3244116804,-4544716
1649590412,195460,true,3248661520,28,3244116804,-4544716
1649590524,195461,true,3248336687,28,3244116804,-4219883
1649590607,195461,true,3248336687,28,3244116804,-4219883
1649590622,195461,true,3248336687,28,3244116804,-4219883
1649591296,195462,true,3248011886,28,3244116804,-3895082
1649591389,195462,true,3248011886,28,3244441215,-3570671
1649591535,195463,true,3247687117,28,3244441215,-3245902
1649591660,195463,true,3247687117,28,3244765659,-2921458
1649592230,195463,true,3247687117,28,3245739186,-1947931
1649592365,195463,true,3247687117,28,3246063760,-1623357
1649592403,195464,true,3247362381,28,3246388367,-974014
1649592537,195464,true,3247362381,28,3246713006,-649375
1649592545,195464,true,3247362381,28,3247037677,-324704
1649593602,195464,true,3247362381,28,3250611205,3248824
1649594008,195465,true,3247037677,28,3251261359,4223682
1649594051,195465,true,3247037677,28,3251586486,4548809
1649594362,195465,true,3247037677,28,3251586486,4548809
1649594656,195465,true,3247037677,28,3251261359,4223682
1649594685,195465,true,3247037677,28,3251261359,4223682
1649594833,195466,true,3246713006,28,3251261359,4548353
1649595356,195465,true,3247037677,28,3250936266,3898589
1649595475,195466,true,3246713006,28,3250936266,4223260
1649595976,195466,true,3246713006,28,3250611205,3898199
1649596247,195466,true,3246713006,28,3250611205,3898199
1649596830,195466,true,3246713006,28,3250286176,3573170
1649597722,195466,true,3246713006,28,3249961180,3248174
1649597761,195466,true,3246713006,28,3249961180,3248174
1649597867,195466,true,3246713006,28,3249636216,2923210
1649598027,195466,true,3246713006,28,3249636216,2923210
1649601854,195467,true,3246388367,28,3244765659,-1622708
1649601897,195467,true,3246388367,28,3244765659,-1622708
1649601938,195467,true,3246388367,28,3244765659,-1622708
1649602304,195467,true,3246388367,28,3244765659,-1622708
1649602425,195467,true,3246388367,28,3245090136,-1298231
1649604926,195467,true,3246388367,28,3246713006,324639
1649605377,195467,true,3246388367,28,3247362381,974014
1649605743,195467,true,3246388367,28,3247687117,1298750
1649605921,195467,true,3246388367,28,3248011886,1623519
1649606015,195467,true,3246388367,28,3248336687,1948320
1649606572,195467,true,3246388367,28,3249636216,3247849
1649606580,195467,true,3246388367,28,3249636216,3247849
1649608581,195467,true,3246388367,28,3254188665,7800298
1649608600,195467,true,3246388367,28,3254514084,8125717
1649608948,195467,true,3246388367,28,3254839536,8451169
1649608991,195466,true,3246713006,28,3255165020,8452014
1649609020,195466,true,3246713006,28,3255165020,8452014
1649609120,195466,true,3246713006,28,3255816085,9103079
1649609142,195465,true,3247037677,28,3256141667,9103990
1649610045,195464,true,3247362381,28,3264618226,17255845
1649610121,195463,true,3247687117,28,3265597709,17910592
1649610139,195463,true,3247687117,28,3265597709,17910592
1649610147,195462,true,3248011886,28,3265924269,17912383
1649610258,195460,true,3248661520,28,3267230835,18569315
1649610488,195460,true,3248661520,28,3270172519,21510999
1649610835,195459,true,3248986387,28,3274426295,25439908
1649611283,195458,true,3249311285,28,3276719081,27407796
1649611318,195457,true,3249636216,28,3277046753,27410537
1649611325,195456,true,3249961180,28,3277046753,27085573
1649611336,195455,true,3250286176,28,3277046753,26760577
1649611361,195454,true,3250611205,28,3277374458,26763253
1649611424,195452,true,3251261359,28,3277702195,26440836
1649611650,195451,true,3251586486,28,3279669308,28082822
1649611746,195451,true,3251586486,28,3280653307,29066821
1649611828,195449,true,3252236835,28,3281637602,29400767
1649611861,195447,true,3252887315,28,3281965766,29078451
1649612126,195446,true,3253212604,28,3283935437,30722833
1649612409,195445,true,3253537925,28,3286563506,33025581
1649617575,195444,true,3253863279,28,3298086054,44222775
1649620576,195442,true,3254514084,28,3296437506,41923422
1649622892,195441,true,3254839536,28,3296437506,41597970
1649623235,195439,true,3255490536,28,3296437506,40946970
1649625629,195438,true,3255816085,28,3296437506,40621421
1649626063,195436,true,3256467281,28,3296437506,39970225
1649626183,195435,true,3256792928,28,3296437506,39644578
1649626250,195434,true,3257118607,28,3296437506,39318899
1649626468,195432,true,3257770063,28,3296107895,38337832
1649626533,195431,true,3258095840,28,3295778317,37682477
1649627328,195430,true,3258421650,28,3292484351,34062701
1649627450,195429,true,3258747492,28,3291825953,33078461
1649627555,195428,true,3259073367,28,3291496803,32423436
1649627668,195426,true,3259725214,28,3290838603,31113389
1649627747,195425,true,3260051187,28,3290180534,30129347
1649627868,195424,true,3260377192,28,3289522596,29145404
1649627905,195423,true,3260703229,28,3289193677,28490448
1649627917,195421,true,3261355403,28,3289193677,27838274
1649627941,195421,true,3261355403,28,3288864790,27509387
1649627964,195420,true,3261681538,28,3288864790,27183252
1649628111,195419,true,3262007706,28,3287549573,25541867
1649628130,195418,true,3262333907,28,3287549573,25215666
1649628779,195417,true,3262660141,28,3283278749,20618608
1649628808,195416,true,3262986407,28,3283278749,20292342
1649628837,195415,true,3263312705,28,3282950454,19637749
1649628983,195414,true,3263639036,28,3281637602,17998566
1649629069,195414,true,3263639036,28,3280653307,17014271
1649629226,195414,true,3263639036,28,3278029965,14390929
1649629395,195413,true,3263965400,28,3275081213,11115813
1649629847,195413,true,3263965400,28,3267557558,3592158
1649629852,195413,true,3263965400,28,3267230835,3265435
1649629900,195413,true,3263965400,28,3266577487,2612087
1649629909,195412,true,3264291797,28,3266250862,1959065
1649629917,195412,true,3264291797,28,3266250862,1959065
1649629923,195413,true,3263965400,28,3265924269,1958869
1649630065,195413,true,3263965400,28,3262986407,-978993
1649630069,195413,true,3263965400,28,3262986407,-978993
1649630131,195413,true,3263965400,28,3261355403,-2609997
1649630155,195413,true,3263965400,28,3260703229,-3262171
1649630161,195415,true,3263312705,28,3260377192,-2935513
1649630389,195415,true,3263312705,28,3253863279,-9449426
1649630451,195415,true,3263312705,28,3251911644,-11401061
1649630707,195415,true,3263312705,28,3244765659,-18547046
1649631130,195417,true,3262660141,28,3235693476,-26966665
1649631274,195417,true,3262660141,28,3232782808,-29877333
1649631564,195417,true,3262660141,28,3227614749,-35045392
1649631954,195418,true,3262333907,28,3223099476,-39234431
1649632027,195419,true,3262007706,28,3222777198,-39230508
1649632075,195419,true,3262007706,28,3222454952,-39552754
1649632090,195420,true,3261681538,28,3222454952,-39226586
1649632099,195421,true,3261355403,28,3222454952,-38900451
1649632554,195422,true,3261029300,28,3220200136,-40829164
1649632911,195422,true,3261029300,28,3219234269,-41795031
1649632949,195423,true,3260703229,28,3219234269,-41468960
1649633616,195424,true,3260377192,28,3220522156,-39855036
1649634754,195425,true,3260051187,28,3224711348,-35339839
1649634777,195425,true,3260051187,28,3224711348,-35339839
1649634793,195426,true,3259725214,28,3224711348,-35013866
1649634816,195427,true,3259399274,28,3224711348,-34687926
1649634836,195428,true,3259073367,28,3224711348,-34362019
1649634973,195428,true,3259073367,28,3224711348,-34362019
1649634998,195429,true,3258747492,28,3224388909,-34358583
1649635080,195430,true,3258421650,28,3224388909,-34032741
1649635085,195431,true,3258095840,28,3224388909,-33706931
1649635090,195432,true,3257770063,28,3224066502,-33703561
1649635105,195433,true,3257444319,28,3224066502,-33377817
1649635221,195434,true,3257118607,28,3223099476,-34019131
1649635600,195436,true,3256467281,28,3219234269,-37233012
1649635617,195437,true,3256141667,28,3219234269,-36907398
1649635623,195437,true,3256141667,28,3218912378,-37229289
1649635636,195439,true,3255490536,28,3218912378,-36578158
1649635646,195441,true,3254839536,28,3218912378,-35927158
1649635686,195442,true,3254514084,28,3218268692,-36245392
1649635711,195443,true,3254188665,28,3217946897,-36241768
1649635767,195444,true,3253863279,28,3216981706,-36881573
1649635981,195447,true,3252887315,28,3212802556,-40084759
1649636235,195448,true,3252562059,28,3207987205,-44574854
1649636560,195449,true,3252236835,28,3201577963,-50658872
1649636870,195451,true,3251586486,28,3196140175,-55446311
1649636949,195453,true,3250936266,28,3195181525,-55754741
1649636995,195454,true,3250611205,28,3194862039,-55749166
1649637031,195455,true,3250286176,28,3194542585,-55743591
1649638799,195456,true,3249961180,28,3200617681,-49343499
1649639189,195459,true,3248986387,28,3200617681,-48368706
1649639918,195460,true,3248661520,28,3201577963,-47083557
1649640512,195460,true,3248661520,28,3202858786,-45802734
1649640766,195461,true,3248336687,28,3203499390,-44837297
1649640789,195464,true,3247362381,28,3203499390,-43862991
1649641239,195465,true,3247037677,28,3203819740,-43217937
1649641639,195466,true,3246713006,28,3203819740,-42893266
1649641759,195467,true,3246388367,28,3203499390,-42888977
1649642418,195471,true,3245090136,28,3200297652,-44792484
1649642491,195473,true,3244441215,28,3199657688,-44783527
1649642611,195474,true,3244116804,28,3199017852,-45098952
1649642653,195476,true,3243468078,28,3198697983,-44770095
1649643034,195480,true,3242171015,28,3194542585,-47628430
1649643090,195482,true,3241522678,28,3194223162,-47299516
1649643432,195484,true,3240874470,28,3193265087,-47609383
1649643473,195486,true,3240226393,28,3192945792,-47280601
1649643557,195489,true,3239254519,28,3192626530,-46627989
1649643566,195491,true,3238606765,28,3192626530,-45980235
1649643604,195494,true,3237635378,28,3192626530,-45008848
1649643661,195496,true,3236987948,28,3192307299,-44680649
1649643667,195500,true,3235693476,28,3192307299,-43386177
1649643674,195502,true,3235046434,28,3192307299,-42739135
1649643885,195505,true,3234076115,28,3190392585,-43683530
1649644023,195507,true,3233429396,28,3189116747,-44312649
1649645232,195511,true,3232136348,28,3181472426,-50663922
1649645253,195514,true,3231166901,28,3181154310,-50012591
1649645323,195517,true,3230197745,28,3180518175,-49679570
1649645329,195520,true,3229228879,28,3180518175,-48710704
1649645425,195525,true,3227614749,28,3179564210,-48050539
1649645598,195528,true,3226646658,28,3178292702,-48353956
1649645628,195531,true,3225678858,28,3178292702,-47386156
1649645667,195534,true,3224711348,28,3177657139,-47054209
1649645789,195539,true,3223099476,28,3176704033,-46395443
1649646629,195543,true,3221810558,28,3167188676,-54621882
1649646676,195546,true,3220844208,28,3166555334,-54288874
1649648183,195549,true,3219878148,28,3162125479,-57752669
1649648822,195554,true,3218268692,28,3163390519,-54878173
1649648861,195557,true,3217303404,28,3163390519,-53912885
1649649495,195561,true,3216016805,28,3164972531,-51044274
1649649714,195562,true,3215695235,28,3165605557,-50089678
1649649933,195567,true,3214087870,28,3166238710,-47849160
1649651351,195570,true,3213123836,28,3169723314,-43400522
1649651423,195574,true,3211838908,28,3169723314,-42115594
1649652549,195575,true,3211517756,28,3169723314,-41794442
1649653440,195580,true,3209912479,28,3173211754,-36700725
1649653544,195583,true,3208949698,28,3173529075,-35420623
1649654793,195586,true,3207987205,28,3176386394,-31600811
1649655335,195587,true,3207666439,28,3176386394,-31280045
1649655353,195592,true,3206063086,28,3176386394,-29676692
1649655687,195594,true,3205421970,28,3176704033,-28717937
1649655888,195597,true,3204460536,28,3177021703,-27438833
1649655905,195598,true,3204140122,28,3177021703,-27118419
1649656675,195603,true,3202538532,28,3177339405,-25199127
1649657095,195606,true,3201577963,28,3177657139,-23920824
1649657715,195608,true,3200937743,28,3177657139,-23280604
1649658085,195609,true,3200617681,28,3177657139,-22960542
1649659212,195613,true,3199337754,28,3177657139,-21680615
1649659668,195615,true,3198697983,28,3177657139,-21040844
1649660409,195617,true,3198058339,28,3177657139,-20401200
1649660918,195617,true,3198058339,28,3177974905,-20083434
1649662244,195621,true,3196779435,28,3177974905,-18804530
1649662790,195623,true,3196140175,28,3178928393,-17211782
1649664182,195624,true,3195820593,28,3180836227,-14984366
1649664213,195625,true,3195501043,28,3180836227,-14664816
1649664618,195628,true,3194542585,28,3180836227,-13706358
1649664945,195630,true,3193903772,28,3180836227,-13067545
1649664954,195631,true,3193584414,28,3180836227,-12748187
1649665084,195631,true,3193584414,28,3180836227,-12748187
1649665154,195634,true,3192626530,28,3180518175,-12108355
1649665556,195636,true,3191988100,28,3178928393,-13059707
1649665635,195637,true,3191668933,28,3178610532,-13058401
1649665650,195637,true,3191668933,28,3178292702,-13376231
1649665798,195640,true,3190711624,28,3177339405,-13372219
1649666104,195642,true,3190073578,28,3175116157,-14957421
1649666111,195643,true,3189754602,28,3175116157,-14638445
1649666140,195643,true,3189754602,28,3174798677,-14955925
1649666142,195646,true,3188797867,28,3174798677,-13999190
1649666268,195648,true,3188160203,28,3173529075,-14631128
1649666966,195650,true,3187522667,28,3164972531,-22550136
1649668579,195650,true,3187522667,28,3158017592,-29505075
1649668671,195652,true,3186885258,28,3158017592,-28867666
1649668706,195655,true,3185929383,28,3158017592,-27911791
1649668751,195656,true,3185610822,28,3157701822,-27909000
1649668758,195657,true,3185292293,28,3157701822,-27590471
1649668770,195661,true,3184018495,28,3157701822,-26316673
1649668867,195664,true,3183063480,28,3157070377,-25993103
1649669224,195666,true,3182426963,28,3153599682,-28827281
1649669517,195667,true,3182108752,28,3151077937,-31030815
1649669641,195670,true,3181154310,28,3149817821,-31336489
1649669654,195673,true,3180200155,28,3149502871,-30697284
1649669685,195675,true,3179564210,28,3149187952,-30376258
1649669742,195676,true,3179246286,28,3148243384,-31002902
1649669801,195681,true,3177657139,28,3146669735,-30987404
1649669842,195684,true,3176704033,28,3145725923,-30978110
1649669857,195686,true,3176068787,28,3145411382,-30657405
1649669958,195687,true,3175751212,28,3143210474,-32540738
1649670365,195691,true,3174481229,28,3134735676,-39745553
1649670553,195694,true,3173529075,28,3130976437,-42552638
1649670769,195696,true,3172894464,28,3127847182,-45047282
1649671022,195697,true,3172577207,28,3124096204,-48481003
1649671115,195700,true,3171625624,28,3122534624,-49091000
1649671184,195704,true,3170357291,28,3121285922,-49071369
1649671186,195706,true,3169723314,28,3121285922,-48437392
1649671279,195708,true,3169089465,28,3118478169,-50611296
1649671315,195712,true,3167822146,28,3117231090,-50591056
1649671335,195716,true,3166555334,28,3116607737,-49947597
1649671421,195718,true,3165922118,28,3113492843,-52429275
1649671595,195721,true,3164972531,28,3108204665,-56767866
1649671744,195725,true,3163706858,28,3104477243,-59229615
1649672260,195729,true,3162441692,28,3091157315,-71284377
1649673272,195732,true,3161493149,28,3074818335,-86674814
1649673300,195735,true,3160544891,28,3074818335,-85726556
1649673580,195739,true,3159280989,28,3074818335,-84462654
1649673633,195743,true,3158017592,28,3074818335,-83199257
1649674245,195746,true,3157070377,28,3072974090,-84096287
1649674456,195750,true,3155807864,28,3072359587,-83448277
1649674463,195755,true,3154230433,28,3072359587,-81870846
1649675132,195758,true,3153284353,28,3070823868,-82460485
1649675362,195761,true,3152338557,28,3070516816,-81821741
1649675625,195765,true,3151077937,28,3070823868,-80254069
1649675822,195769,true,3149817821,28,3071130950,-78686871
1649675835,195773,true,3148558209,28,3071130950,-77427259
1649676196,195776,true,3147613830,28,3071745207,-75868623
1649676248,195779,true,3146669735,28,3071745207,-74924528
1649676556,195783,true,3145411382,28,3071438063,-73973319
1649676632,195786,true,3144467947,28,3071438063,-73029884
1649676664,195789,true,3143524795,28,3071130950,-72393845
1649676733,195793,true,3142267699,28,3070823868,-71443831
1649676834,195798,true,3140697037,28,3070209795,-70487242
1649676875,195801,true,3139755016,28,3069902805,-69852211
1649676905,195804,true,3138813278,28,3069595845,-69217433
1649676941,195808,true,3137558066,28,3069288916,-68269150
1649676970,195813,true,3135989758,28,3068982018,-67007740
1649676973,195817,true,3134735676,28,3068675151,-66060525
1649677028,195820,true,3133795443,28,3067754732,-66040711
1649677167,195824,true,3132542238,28,3065608163,-66934075
1649677230,195829,true,3130976437,28,3064688664,-66287773
1649677235,195833,true,3129724359,28,3064382226,-65342133
1649677247,195836,true,3128785630,28,3064382226,-64403404
1649677266,195839,true,3127847182,28,3064075818,-63771364
1649677408,195843,true,3126596355,28,3062544240,-64052115
1649677427,195847,true,3125346030,28,3062238016,-63108014
1649678157,195849,true,3124721054,28,3055508834,-69212220
1649678234,195852,true,3123783825,28,3054897824,-68886001
1649678608,195856,true,3122534624,28,3051844605,-70690019
1649678761,195859,true,3121598051,28,3051234328,-70363723
1649678896,195862,true,3120661759,28,3051539451,-69122308
1649679361,195866,true,3119413806,28,3050319141,-69094665
1649679375,195869,true,3118478169,28,3050014139,-68464030
1649679407,195873,true,3117231090,28,3050014139,-67216951
1649679453,195875,true,3116607737,28,3049709168,-66898569
1649679512,195879,true,3115361405,28,3049709168,-65652237
1649679637,195883,true,3114115572,28,3049404228,-64711344
1649679662,195886,true,3113181524,28,3049404228,-63777296
1649679807,195889,true,3112247757,28,3049099318,-63148439
1649680500,195892,true,3111314269,28,3051234328,-60079941
1649680708,195896,true,3110070054,28,3052455005,-57615049
1649680824,195900,true,3108826337,28,3053065526,-55760811
1649681032,195902,true,3108204665,28,3054286936,-53917729
1649681846,195906,true,3106961694,28,3055814385,-51147309
1649682287,195910,true,3105719220,28,3055203313,-50515907
1649682705,195914,true,3104477243,28,3054897824,-49579419
1649683256,195916,true,3103856441,28,3054286936,-49569505
1649683566,195920,true,3102615208,28,3053676170,-48939038
1649683601,195924,true,3101374473,28,3053676170,-47698303
1649683660,195928,true,3100134233,28,3053370833,-46763400
1649683777,195931,true,3099204379,28,3052760250,-46444129
1649683890,195935,true,3097965007,28,3052149790,-45815217
1649683950,195939,true,3096726130,28,3051539451,-45186679
1649683973,195943,true,3095487750,28,3051539451,-43948299
1649684055,195947,true,3094249864,28,3050319141,-43930723
1649684156,195952,true,3092703203,28,3048794439,-43908764
1649684182,195957,true,3091157315,28,3048184771,-42972544
1649684197,195961,true,3089921161,28,3048184771,-41736390
1649684226,195965,true,3088685502,28,3047575226,-41110276
1649684360,195969,true,3087450336,28,3046051895,-41398441
1649684524,195974,true,3085907074,28,3044224903,-41682171
1649684961,195978,true,3084673020,28,3039358281,-45314739
1649685013,195981,true,3083747803,28,3038750501,-44997302
1649685050,195986,true,3082206392,28,3038446656,-43759736
1649685269,195990,true,3080973817,28,3037535304,-43438513
1649685675,195993,true,3080049710,28,3036624226,-43425484
1649685709,195997,true,3078817998,28,3036624226,-42193772
1649686424,196001,true,3077586779,28,3043311818,-34274961
1649686435,196004,true,3076663687,28,3043616150,-33047537
1649686480,196007,true,3075740873,28,3043920511,-31820362
1649686631,196010,true,3074818335,28,3044833779,-29984556
1649686706,196015,true,3073281387,28,3045442776,-27838611
1649686718,196019,true,3072052382,28,3045442776,-26609606
1649686754,196020,true,3071745207,28,3045442776,-26302431
1649686774,196024,true,3070516816,28,3045442776,-25074040
1649687012,196029,true,3068982018,28,3044833779,-24148239
1649687062,196033,true,3067754732,28,3044833779,-22920953
1649687098,196034,true,3067447987,28,3044529326,-22918661
1649687165,196038,true,3066221315,28,3044224903,-21996412
1649687225,196042,true,3064995133,28,3043920511,-21074622
1649687231,196046,true,3063769441,28,3043920511,-19848930
1649687443,196047,true,3063463095,28,3042703247,-20759848
1649687848,196051,true,3062238016,28,3039358281,-22879735
1649687969,196055,true,3061013427,28,3038142842,-22870585
1649687998,196058,true,3060095307,28,3037839058,-22256249
1649688631,196060,true,3059483379,28,3032376139,-27107240
1649688686,196063,true,3058565718,28,3032072931,-26492787
1649689023,196067,true,3057342597,28,3030557350,-26785247
1649689913,196069,true,3056731221,28,3028436808,-28294413
1649689968,196071,true,3056119966,28,3028133994,-27985972
1649690003,196074,true,3055203313,28,3028133994,-27069319
1649692090,196077,true,3054286936,28,3029951329,-24335607
1649692200,196080,true,3053370833,28,3029951329,-23419504
1649692306,196081,true,3053065526,28,3029648364,-23417162
1649692555,196084,true,3052149790,28,3028739652,-23410138
1649692670,196089,true,3050624173,28,3027831211,-22792962
1649692706,196091,true,3050014139,28,3027528458,-22485681
1649692758,196092,true,3049709168,28,3026923044,-22786124
1649692799,196096,true,3048489590,28,3026620382,-21869208
1649693039,196099,true,3047575226,28,3024200174,-23375052
1649693092,196101,true,3046965802,28,3023293096,-23672706
1649693168,196101,true,3046965802,28,3022688528,-24277274
1649693817,196104,true,3046051895,28,3016347859,-29704036
1649694315,196106,true,3045442776,28,3013031866,-32410910
1649694412,196108,true,3044833779,28,3012429350,-32404429
1649694421,196108,true,3044833779,28,3012429350,-32404429
1649694437,196111,true,3043920511,28,3012429350,-31491161
1649694473,196114,true,3043007518,28,3012128138,-30879380
1649694487,196116,true,3042399008,28,3012128138,-30270870
1649694567,196117,true,3042094798,28,3011525802,-30568996
1649694596,196119,true,3041486470,28,3011224680,-30261790
1649694740,196123,true,3040270180,28,3009719519,-30550661
1649694824,196125,true,3039662217,28,3008515932,-31146285
1649694879,196126,true,3039358281,28,3008215111,-31143170
1649694904,196129,true,3038446656,28,3008215111,-30231545
1649694967,196132,true,3037535304,28,3007613558,-29921746
1649695030,196133,true,3037231581,28,3007312827,-29918754
1649695084,196134,true,3036927888,28,3007012125,-29915763
1649695291,196137,true,3036016992,28,3006110202,-29906790
1649695401,196140,true,3035106369,28,3005208549,-29897820
1649695559,196141,true,3034802889,28,3004307167,-30495722
1649695664,196142,true,3034499439,28,3004006766,-30492673
1649695829,196144,true,3033892630,28,3004006766,-29885864
1649695851,196147,true,3032982644,28,3004006766,-28975878
1649695874,196147,true,3032982644,28,3004006766,-28975878
1649696860,196147,true,3032982644,28,3014538684,-18443960
1649697314,196149,true,3032376139,28,3019063658,-13312481
1649697364,196151,true,3031769754,28,3019667501,-12102253
1649697389,196151,true,3031769754,28,3019667501,-12102253
1649697408,196151,true,3031769754,28,3019667501,-12102253
1649697441,196153,true,3031163491,28,3019667501,-11495990
1649697734,196156,true,3030254324,28,3017554579,-12699745
1649698140,196156,true,3030254324,28,3014840137,-15414187
1649698398,196155,true,3030557350,28,3013333170,-17224180
1649698497,196157,true,3029951329,28,3012730593,-17220736
1649698563,196160,true,3029042526,28,3012429350,-16613176
1649698710,196160,true,3029042526,28,3011826955,-17215571
1649698714,196159,true,3029345430,28,3011826955,-17518475
1649699050,196162,true,3028436808,28,3010321493,-18115315
1649699135,196165,true,3027528458,28,3010020491,-17507967
1649699377,196165,true,3027528458,28,3011224680,-16303778
1649699970,196164,true,3027831211,28,3015443136,-12388075
1649701001,196165,true,3027528458,28,3019667501,-7860957
1649701195,196169,true,3026317750,28,3019969468,-6348282
1649701968,196168,true,3026620382,28,3019063658,-7556724
1649702103,196167,true,3026923044,28,3018761782,-8161262
1649702198,196168,true,3026620382,28,3018761782,-7858600
1649702697,196172,true,3025410036,28,3018158120,-7251916
1649703016,196171,true,3025712577,28,3019365565,-6347012
1649703346,196170,true,3026015148,28,3022386289,-3628859
1649703431,196172,true,3025410036,28,3023293096,-2116940
1649703522,196175,true,3024502595,28,3023897785,-604810
1649704286,196174,true,3024805045,28,3030860405,6055360
1649704353,196172,true,3025410036,28,3031466608,6056572
1649704469,196174,true,3024805045,28,3032072931,7267886
1649704510,196178,true,3023595425,28,3032072931,8477506
1649704528,196177,true,3023897785,28,3032072931,8175146
1649704576,196176,true,3024200174,28,3032072931,7872757
1649704651,196178,true,3023595425,28,3032072931,8477506
1649704784,196181,true,3022688528,28,3031769754,9081226
1649704833,196181,true,3022688528,28,3031466608,8778080
1649704958,196179,true,3023293096,28,3030254324,6961228
1649705130,196182,true,3022386289,28,3028133994,5747705
1649705249,196185,true,3021479755,28,3026620382,5140627
1649705413,196185,true,3021479755,28,3023897785,2418030
1649705455,196184,true,3021781903,28,3023293096,1511193
1649705532,196186,true,3021177637,28,3021781903,604266
1649705587,196188,true,3020573492,28,3020573492,0
1649705656,196188,true,3020573492,28,3019063658,-1509834
1649705679,196188,true,3020573492,28,3018459936,-2113556
1649705811,196190,true,3019969468,28,3015443136,-4526332
1649706028,196193,true,3019063658,28,3010321493,-8742165
1649706396,196193,true,3019063658,28,3003406055,-15657603
1649706524,196192,true,3019365565,28,3001304512,-18061053
1649706589,196195,true,3018459936,28,3000404300,-18055636
1649706602,196198,true,3017554579,28,3000404300,-17150279
1649706615,196198,true,3017554579,28,3000104290,-17450289
1649707349,196197,true,3017856335,28,2997105835,-20750500
1649707574,196199,true,3017252854,28,2998304857,-18947997
1649707614,196203,true,3016046254,28,2998304857,-17741397
1649707627,196203,true,3016046254,28,2998304857,-17741397
1649707819,196204,true,3015744680,28,2997405546,-18339134
1649707847,196207,true,3014840137,28,2997105835,-17734302
1649708113,196210,true,3013935866,28,2996206883,-17728983
1649708325,196210,true,3013935866,28,2995308201,-18627665
1649708409,196210,true,3013935866,28,2994709229,-19226637
1649708906,196213,true,3013031866,28,2991716166,-21315700
1649708922,196216,true,3012128138,28,2991417024,-20711114
1649708932,196216,true,3012128138,28,2991417024,-20711114
1649709005,196216,true,3012128138,28,2991417024,-20711114
1649709038,196218,true,3011525802,28,2991117913,-20407889
1649709044,196220,true,3010923587,28,2991417024,-19506563
1649709052,196220,true,3010923587,28,2991417024,-19506563
1649709164,196219,true,3011224680,28,2991716166,-19508514
1649709450,196220,true,3010923587,28,2993810996,-17112591
1649709655,196223,true,3010020491,28,2997105835,-12914656
1649709728,196223,true,3010020491,28,2998005057,-12015434
1649709742,196221,true,3010622525,28,2998005057,-12617468
1649709851,196223,true,3010020491,28,2999204439,-10816052
1649709882,196226,true,3009117665,28,2999504359,-9613306
1649710327,196226,true,3009117665,28,3002505214,-6612451
1649710922,196224,true,3009719519,28,3004607598,-5111921
1649711173,196226,true,3009117665,28,3003105745,-6011920
1649711176,196229,true,3008215111,28,3003105745,-5109366
1649711210,196229,true,3008215111,28,3003105745,-5109366
1649711220,196228,true,3008515932,28,3002805464,-5710468
1649711468,196230,true,3007914319,28,3000404300,-7510019
1649711504,196232,true,3007312827,28,3000104290,-7208537
1649712463,196233,true,3007012125,28,2992613771,-14398354
1649712823,196232,true,3007312827,28,2989921765,-17391062
1649712854,196234,true,3006711454,28,2989622802,-17088652
1649712950,196235,true,3006410813,28,2988726095,-17684718
1649712998,196236,true,3006110202,28,2988427252,-17682950
1649713012,196235,true,3006410813,28,2988128439,-18282374
1649713096,196238,true,3005509070,28,2986933487,-18575583
1649713235,196241,true,3004607598,28,2984545015,-20062583
1649713366,196242,true,3004307167,28,2983053190,-21253977
1649713483,196241,true,3004607598,28,2981263984,-23343614
1649713485,196243,true,3004006766,28,2981263984,-22742782
1649713610,196246,true,3003105745,28,2979773799,-23331946
1649714043,196246,true,3003105745,28,2974712740,-28393005
1649714061,196245,true,3003406055,28,2974415298,-28990757
1649714063,196248,true,3002505214,28,2974415298,-28089916
1649714402,196249,true,3002204993,28,2972036837,-30168156
1649714722,196249,true,3002204993,28,2969957243,-32247750
1649715044,196247,true,3002805464,28,2969957243,-32848221
1649715125,196250,true,3001904803,28,2969957243,-31947560
1649715304,196252,true,3001304512,28,2970254238,-31050274
1649715315,196252,true,3001304512,28,2970254238,-31050274
1649715390,196251,true,3001604642,28,2970254238,-31350404
1649715422,196254,true,3000704341,28,2970551264,-30153077
1649715493,196255,true,3000404300,28,2970848319,-29555981
1649715587,196256,true,3000104290,28,2971739663,-28364627
1649715824,196254,true,3000704341,28,2974117887,-26586454
1649715978,196257,true,2999804309,28,2975307712,-24496597
1649716050,196258,true,2999504359,28,2975902804,-23601555
1649716112,196258,true,2999504359,28,2976498014,-23006345
1649716254,196257,true,2999804309,28,2977986561,-21817748
1649716288,196260,true,2998904548,28,2978284359,-20620189
1649716388,196261,true,2998604688,28,2979773799,-18830889
1649716500,196261,true,2998604688,28,2981263984,-17340704
1649716534,196260,true,2998904548,28,2981562111,-17342437
1649716581,196262,true,2998304857,28,2982456669,-15848188
1649716787,196262,true,2998304857,28,2985739012,-12565845
1649716886,196262,true,2998304857,28,2987232180,-11072677
1649716919,196261,true,2998604688,28,2988128439,-10476249
1649717023,196263,true,2998005057,28,2990220757,-7784300
1649717068,196262,true,2998304857,28,2991417024,-6887833
1649717446,196263,true,2998005057,28,2997705286,-299771
1649718371,196262,true,2998304857,28,3005208549,6903692
1649718507,196264,true,2997705286,28,3005509070,7803784
1649718537,196263,true,2998005057,28,3005509070,7504013
1649718550,196264,true,2997705286,28,3005509070,7803784
1649718562,196263,true,2998005057,28,3005509070,7504013
1649718591,196266,true,2997105835,28,3005509070,8403235
1649718641,196265,true,2997405546,28,3005509070,8103524
1649720204,196266,true,2997105835,28,2998904548,1798713
1649720333,196266,true,2997105835,28,2998604688,1498853
1649720363,196268,true,2996506504,28,2998304857,1798353
1649720424,196268,true,2996506504,28,2998005057,1498553
1649720438,196269,true,2996206883,28,2998005057,1798174
1649720586,196270,true,2995907292,28,2997105835,1198543
1649720715,196273,true,2995008700,28,2996506504,1497804
1649721281,196273,true,2995008700,28,2992314539,-2694161
1649721341,196275,true,2994409788,28,2991716166,-2693622
1649721432,196276,true,2994110377,28,2991117913,-2992464
1649721862,196278,true,2993511645,28,2986933487,-6578158
1649722124,196279,true,2993212323,28,2984246590,-8965733
1649722238,196281,true,2992613771,28,2983351495,-9262276
1649722392,196281,true,2992613771,28,2982158453,-10455318
1649722425,196284,true,2991716166,28,2981860267,-9855899
1649722532,196285,true,2991417024,28,2981263984,-10153040
1649722575,196286,true,2991117913,28,2980667821,-10450092
1649722707,196287,true,2990818831,28,2980071777,-10747054
1649722923,196289,true,2990220757,28,2979177934,-11042823
1649722944,196289,true,2990220757,28,2979177934,-11042823
1649723301,196290,true,2989921765,28,2978582188,-11339577
1649723353,196290,true,2989921765,28,2978582188,-11339577
1649723477,196292,true,2989323870,28,2978880046,-10443824
1649723504,196292,true,2989323870,28,2978880046,-10443824
1649723635,196292,true,2989323870,28,2979177934,-10145936
1649724209,196292,true,2989323870,28,2980965888,-8357982
1649724989,196293,true,2989024967,28,2984843469,-4181498
1649724997,196293,true,2989024967,28,2984843469,-4181498
1649725008,196293,true,2989024967,28,2984843469,-4181498
1649725303,196293,true,2989024967,28,2984545015,-4479952
1649725346,196294,true,2988726095,28,2984545015,-4181080
1649725392,196294,true,2988726095,28,2984246590,-4479505
1649725420,196295,true,2988427252,28,2984246590,-4180662
1649725431,196296,true,2988128439,28,2983948195,-4180244
1649725899,196298,true,2987530903,28,2979773799,-7757104
1649725943,196298,true,2987530903,28,2979475852,-8055051
1649725951,196299,true,2987232180,28,2979475852,-7756328
1649726021,196298,true,2987530903,28,2978880046,-8650857
1649726359,196299,true,2987232180,28,2976498014,-10734166
1649726380,196300,true,2986933487,28,2976498014,-10435473
1649726942,196300,true,2986933487,28,2974117887,-12815600
1649726990,196300,true,2986933487,28,2974117887,-12815600
1649727703,196300,true,2986933487,28,2978582188,-8351299
1649727735,196301,true,2986634823,28,2978582188,-8052635
1649729576,196301,true,2986634823,28,2976200394,-10434429
1649729827,196301,true,2986634823,28,2976200394,-10434429
1649729897,196303,true,2986037586,28,2976200394,-9837192
1649730128,196304,true,2985739012,28,2975605243,-10133769
1649730146,196305,true,2985440468,28,2975605243,-9835225
1649730380,196306,true,2985141954,28,2974415298,-10726656
1649730410,196308,true,2984545015,28,2974117887,-10427128
1649731301,196310,true,2983948195,28,2965802419,-18145776
1649731505,196311,true,2983649830,28,2964023561,-19626269
1649731675,196312,true,2983351495,28,2962541993,-20809502
1649732614,196314,true,2982754914,28,2960469043,-22285871
1649732924,196315,true,2982456669,28,2961061167,-21395502
1649733127,196315,true,2982456669,28,2961653408,-20803261
1649734747,196316,true,2982158453,28,2965802419,-16356034
1649734782,196318,true,2981562111,28,2966099000,-15463111
1649734968,196319,true,2981263984,28,2966395610,-14868374
1649735059,196319,true,2981263984,28,2966692249,-14571735
1649735115,196320,true,2980965888,28,2966988918,-13976970
1649735301,196321,true,2980667821,28,2967879104,-12788717
1649735377,196321,true,2980667821,28,2968472710,-12195111
1649736094,196321,true,2980667821,28,2973225830,-7441991
1649736096,196321,true,2980667821,28,2973225830,-7441991
1649737124,196322,true,2980369784,28,2977986561,-2383223
1649737190,196323,true,2980071777,28,2977986561,-2085216
1649737204,196322,true,2980369784,28,2977986561,-2383223
1649737303,196322,true,2980369784,28,2978284359,-2085425
1649737364,196322,true,2980369784,28,2978284359,-2085425
1649737489,196321,true,2980667821,28,2978582188,-2085633
1649737784,196320,true,2980965888,28,2979475852,-1490036
1649737994,196320,true,2980965888,28,2980369784,-596104
1649738589,196319,true,2981263984,28,2983351495,2087511
1649739434,196318,true,2981562111,28,2988427252,6865141
1649740273,196317,true,2981860267,28,2991716166,9855899
1649740787,196317,true,2981860267,28,2992613771,10753504
1649740886,196316,true,2982158453,28,2992913032,10754579
1649740915,196316,true,2982158453,28,2992913032,10754579
1649741016,196314,true,2982754914,28,2993511645,10756731
1649741091,196314,true,2982754914,28,2993810996,11056082
1649741501,196313,true,2983053190,28,2996206883,13153693
1649741774,196312,true,2983351495,28,2998005057,14653562
1649742076,196310,true,2983948195,28,2999804309,15856114
1649742100,196309,true,2984246590,28,2999804309,15557719
1649742405,196308,true,2984545015,28,3002505214,17960199
1649742675,196308,true,2984545015,28,3004607598,20062583
1649742760,196307,true,2984843469,28,3005208549,20365080
1649742852,196306,true,2985141954,28,3005509070,20367116
1649742916,196305,true,2985440468,28,3005809621,20369153
1649742925,196305,true,2985440468,28,3005809621,20369153
1649743300,196304,true,2985739012,28,3007613558,21874546
1649743351,196304,true,2985739012,28,3007613558,21874546
1649743376,196303,true,2986037586,28,3007914319,21876733
1649743749,196303,true,2986037586,28,3009719519,23681933
1649743959,196302,true,2986336189,28,3010622525,24286336
1649744019,196302,true,2986336189,28,3010622525,24286336
1649744074,196301,true,2986634823,28,3010923587,24288764
1649744081,196301,true,2986634823,28,3010923587,24288764
1649744162,196300,true,2986933487,28,3011224680,24291193
1649744183,196300,true,2986933487,28,3011525802,24592315
1649744266,196299,true,2987232180,28,3011826955,24594775
1649744279,196300,true,2986933487,28,3011826955,24893468
1649744333,196299,true,2987232180,28,3012128138,24895958
1649745061,196299,true,2987232180,28,3015744680,28512500
1649745159,196298,true,2987530903,28,3016347859,28816956
1649745267,196298,true,2987530903,28,3016649494,29118591
1649745585,196297,true,2987829656,28,3017554579,29724923
1649745798,196297,true,2987829656,28,3018158120,30328464
1649745902,196296,true,2988128439,28,3018158120,30029681
1649746023,196296,true,2988128439,28,3018158120,30029681
1649746202,196295,true,2988427252,28,3017856335,29429083
1649746426,196295,true,2988427252,28,3017252854,28825602
1649747086,196294,true,2988726095,28,3014538684,25812589
1649748410,196295,true,2988427252,28,3009117665,20690413
1649748470,196293,true,2989024967,28,3009117665,20092698
1649749362,196292,true,2989323870,28,3011224680,21900810
1649749838,196291,true,2989622802,28,3012429350,22806548
1649749993,196292,true,2989323870,28,3013031866,23707996
1649750167,196290,true,2989921765,28,3013935866,24014101
1649750766,196289,true,2990220757,28,3015744680,25523923
1649751153,196287,true,2990818831,28,3017554579,26735748
1649751174,196287,true,2990818831,28,3017856335,27037504
1649751211,196285,true,2991417024,28,3018158120,26741096
1649751305,196284,true,2991716166,28,3018761782,27045616
1649752408,196282,true,2992314539,28,3024502595,32188056
1649752867,196281,true,2992613771,28,3025712577,33098806
1649754318,196279,true,2993212323,28,3025712577,32500254
1649754363,196277,true,2993810996,28,3026015148,32204152
1649754748,196276,true,2994110377,28,3026317750,32207373
1649754804,196275,true,2994409788,28,3026317750,31907962
1649754900,196273,true,2995008700,28,3026317750,31309050
1649754913,196272,true,2995308201,28,3026015148,30706947
1649755890,196271,true,2995607732,28,3020271465,24663733
1649755899,196271,true,2995607732,28,3020271465,24663733
1649756230,196270,true,2995907292,28,3018158120,22250828
1649756318,196268,true,2996506504,28,3017856335,21349831
1649756408,196268,true,2996506504,28,3017252854,20746350
1649756778,196267,true,2996806154,28,3016046254,19240100
1649757362,196266,true,2997105835,28,3017252854,20147019
1649758157,196264,true,2997705286,28,3019063658,21358372
1649761644,196263,true,2998005057,28,3019667501,21662444
1649762928,196262,true,2998304857,28,3019667501,21362644
1649762967,196261,true,2998604688,28,3019969468,21364780
1649762990,196259,true,2999204439,28,3019969468,20765029
1649763200,196257,true,2999804309,28,3020875549,21071240
1649763261,196255,true,3000404300,28,3021479755,21075455
1649764204,196253,true,3001004411,28,3028739652,27735241
1649764985,196251,true,3001604642,28,3033892630,32287988
1649765147,196250,true,3001904803,28,3034196019,32291216
1649765360,196248,true,3002505214,28,3035106369,32601155
1649766102,196246,true,3003105745,28,3038446656,35340911
1649766199,196243,true,3004006766,28,3038750501,34743735
1649766374,196242,true,3004307167,28,3039054376,34747209
1649766556,196241,true,3004607598,28,3039662217,35054619
1649766603,196239,true,3005208549,28,3039662217,34453668
1649766646,196236,true,3006110202,28,3040270180,34159978
1649766677,196234,true,3006711454,28,3040574207,33862753
1649766692,196232,true,3007312827,28,3040878264,33565437
1649766834,196229,true,3008215111,28,3042094798,33879687
1649766942,196226,true,3009117665,28,3043007518,33889853
1649767263,196225,true,3009418577,28,3044529326,35110749
1649767375,196221,true,3010622525,28,3045138262,34515737
1649767387,196218,true,3011525802,28,3045138262,33612460
1649767413,196216,true,3012128138,28,3045442776,33314638
1649767495,196213,true,3013031866,28,3046356500,33324634
1649767646,196209,true,3014237260,28,3047879983,33642723
1649767817,196206,true,3015141622,28,3050624173,35482551
1649768251,196203,true,3016046254,28,3057648332,41602078
1649768389,196201,true,3016649494,28,3060095307,43445813
1649768398,196197,true,3017856335,28,3060095307,42238972
1649768610,196194,true,3018761782,28,3062850494,44088712
1649768634,196191,true,3019667501,28,3063156779,43489278
1649768664,196189,true,3020271465,28,3063463095,43191630
1649768669,196185,true,3021479755,28,3063769441,42289686
1649768905,196182,true,3022386289,28,3067141273,44754984
1649769212,196180,true,3022990797,28,3071130950,48140153
1649769292,196177,true,3023897785,28,3071745207,47847422
1649769397,196174,true,3024805045,28,3072666823,47861778
1649769527,196171,true,3025712577,28,3072974090,47261513
1649769769,196168,true,3026620382,28,3073588715,46968333
1649770378,196166,true,3027225736,28,3074203464,46977728
1649770398,196163,true,3028133994,28,3074203464,46069470
1649770428,196160,true,3029042526,28,3073896074,44853548
1649770466,196158,true,3029648364,28,3073588715,43940351
1649770486,196157,true,3029951329,28,3073588715,43637386
1649770715,196155,true,3030557350,28,3070823868,40266518
1649771279,196152,true,3031466608,28,3064688664,33222056
1649772088,196150,true,3032072931,28,3057036894,24963963
1649772112,196150,true,3032072931,28,3057036894,24963963
1649772128,196147,true,3032982644,28,3056731221,23748577
1649772183,196145,true,3033589271,28,3056119966,22530695
1649772199,196144,true,3033892630,28,3055814385,21921755
1649772226,196144,true,3033892630,28,3055814385,21921755
1649772310,196142,true,3034499439,28,3055203313,20703874
1649772422,196140,true,3035106369,28,3054897824,19791455
1649772816,196139,true,3035409880,28,3053065526,17655646
1649773092,196139,true,3035409880,28,3051844605,16434725
1649773176,196137,true,3036016992,28,3051234328,15217336
1649773199,196135,true,3036624226,28,3051234328,14610102
1649773281,196134,true,3036927888,28,3050624173,13696285
1649773441,196135,true,3036624226,28,3049404228,12780002
1649773567,196133,true,3037231581,28,3047575226,10343645
1649773605,196132,true,3037535304,28,3047270499,9735195
1649773657,196131,true,3037839058,28,3046356500,8517442
1649776429,196133,true,3037231581,28,3026620382,-10611199
1649776725,196132,true,3037535304,28,3027831211,-9704093
1649776773,196130,true,3038142842,28,3027831211,-10311631
1649776786,196129,true,3038446656,28,3028133994,-10312662
1649776868,196130,true,3038142842,28,3028436808,-9706034
1649776882,196129,true,3038446656,28,3028739652,-9707004
1649777045,196127,true,3039054376,28,3029951329,-9103047
1649777080,196126,true,3039358281,28,3030254324,-9103957
1649777141,196127,true,3039054376,28,3030860405,-8193971
1649777164,196126,true,3039358281,28,3031163491,-8194790
1649777403,196124,true,3039966183,28,3033285943,-6680240
1649778214,196123,true,3040270180,28,3042703247,2433067
1649778369,196124,true,3039966183,28,3043920511,3954328
1649778601,196122,true,3040574207,28,3045747320,5173113
1649779224,196120,true,3041182352,28,3047879983,6697631
1649779483,196120,true,3041182352,28,3048184771,7002419
1649779533,196120,true,3041182352,28,3048184771,7002419
1649779624,196119,true,3041486470,28,3048184771,6698301
1649779676,196117,true,3042094798,28,3048184771,6089973
1649779915,196116,true,3042399008,28,3047879983,5480975
1649780219,196117,true,3042094798,28,3047270499,5175701
1649780261,196115,true,3042703247,28,3047270499,4567252
1649780279,196113,true,3043311818,28,3047270499,3958681
1649780748,196111,true,3043920511,28,3048489590,4569079
1649780810,196112,true,3043616150,28,3048489590,4873440
1649780840,196110,true,3044224903,28,3048489590,4264687
1649780887,196108,true,3044833779,28,3048184771,3350992
1649781515,196109,true,3044529326,28,3044833779,304453
1649781600,196109,true,3044529326,28,3044529326,0
1649781615,196108,true,3044833779,28,3044529326,-304453
1649781661,196106,true,3045442776,28,3044224903,-1217873
1649781831,196107,true,3045138262,28,3043007518,-2130744
1649781960,196109,true,3044529326,28,3042094798,-2434528
1649782622,196107,true,3045138262,28,3034802889,-10335373
1649782683,196105,true,3045747320,28,3034499439,-11247881
1649782691,196107,true,3045138262,28,3034499439,-10638823
1649783272,196108,true,3044833779,28,3034196019,-10637760
1649783693,196106,true,3045442776,28,3035713421,-9729355
1649784034,196104,true,3046051895,28,3037231581,-8820314
1649785515,196105,true,3045747320,28,3041486470,-4260850
1649785877,196105,true,3045747320,28,3041182352,-4564968
1649786124,196103,true,3046356500,28,3040574207,-5782293
1649787121,196101,true,3046965802,28,3037535304,-9430498
1649787213,196103,true,3046356500,28,3037231581,-9124919
1649787224,196102,true,3046661136,28,3037231581,-9429555
1649787230,196101,true,3046965802,28,3037231581,-9734221
1649787298,196100,true,3047270499,28,3036320594,-10949905
1649787479,196102,true,3046661136,28,3034499439,-12161697
1649787508,196102,true,3046661136,28,3034196019,-12465117
1649787600,196101,true,3046965802,28,3032679376,-14286426
1649788795,196100,true,3047270499,28,3017252854,-30017645
1649789055,196103,true,3046356500,28,3013935866,-32420634
1649789345,196103,true,3046356500,28,3012429350,-33927150
1649790068,196103,true,3046356500,28,3011224680,-35131820
1649790190,196103,true,3046356500,28,3010923587,-35432913
1649790361,196106,true,3045442776,28,3010622525,-34820251
1649790467,196106,true,3045442776,28,3010020491,-35422285
1649790682,196106,true,3045442776,28,3009418577,-36024199
1649790740,196107,true,3045138262,28,3009117665,-36020597
1649790781,196110,true,3044224903,28,3008816784,-35408119
1649790912,196111,true,3043920511,28,3007914319,-36006192
1649790931,196111,true,3043920511,28,3007914319,-36006192
1649791095,196112,true,3043616150,28,3006410813,-37205337
1649791547,196116,true,3042399008,28,3001304512,-41094496
1649791717,196117,true,3042094798,28,2999204439,-42890359
1649791754,196118,true,3041790619,28,2998904548,-42886071
1649791759,196119,true,3041486470,28,2998604688,-42881782
1649791773,196123,true,3040270180,28,2998604688,-41665492
1649792416,196125,true,3039662217,28,2989622802,-50039415
1649792453,196126,true,3039358281,28,2989024967,-50333314
1649792489,196127,true,3039054376,28,2988726095,-50328281
1649792879,196131,true,3037839058,28,2986037586,-51801472
1649793354,196133,true,3037231581,28,2985440468,-51791113
1649793459,196135,true,3036624226,28,2985440468,-51183758
1649793507,196136,true,3036320594,28,2985440468,-50880126
1649793558,196141,true,3034802889,28,2985141954,-49660935
1649793563,196143,true,3034196019,28,2985141954,-49054065
1649793651,196145,true,3033589271,28,2984843469,-48745802
1649793679,196147,true,3032982644,28,2984843469,-48139175
1649794054,196152,true,3031466608,28,2983948195,-47518413
1649794250,196154,true,3030860405,28,2983649830,-47210575
1649794945,196156,true,3030254324,28,2981860267,-48394057
1649794961,196159,true,3029345430,28,2981860267,-47485163
1649795351,196163,true,3028133994,28,2981562111,-46571883
1649795522,196165,true,3027528458,28,2982456669,-45071789
1649795673,196167,true,3026923044,28,2982754914,-44168130
1649795730,196169,true,3026317750,28,2983053190,-43264560
1649795965,196173,true,3025107525,28,2983948195,-41159330
1649796027,196176,true,3024200174,28,2983948195,-40251979
1649796040,196177,true,3023897785,28,2983948195,-39949590
1649796094,196180,true,3022990797,28,2983948195,-39042602
1649796121,196184,true,3021781903,28,2983948195,-37833708
1649796724,196186,true,3021177637,28,2982158453,-39019184
1649796908,196187,true,3020875549,28,2982158453,-38717096
1649796947,196189,true,3020271465,28,2981860267,-38411198
1649797021,196193,true,3019063658,28,2981860267,-37203391
1649797111,196194,true,3018761782,28,2982158453,-36603329
1649797979,196195,true,3018459936,28,2982754914,-35705022
1649798041,196197,true,3017856335,28,2983053190,-34803145
1649798045,196201,true,3016649494,28,2983053190,-33596304
1649798093,196202,true,3016347859,28,2983649830,-32698029
1649799960,196201,true,3016649494,28,2995907292,-20742202
1649800009,196203,true,3016046254,28,2996206883,-19839371
1649800116,196207,true,3014840137,28,2996506504,-18333633
1649801692,196208,true,3014538684,28,3004908059,-9630625
1649802617,196206,true,3015141622,28,3005509070,-9632552
1649802794,196208,true,3014538684,28,3005509070,-9029614
1649803442,196212,true,3013333170,28,3006410813,-6922357
1649803669,196212,true,3013333170,28,3006711454,-6621716
1649803723,196210,true,3013935866,28,3006711454,-7224412
1649804207,196212,true,3013333170,28,3006410813,-6922357
1649804229,196215,true,3012429350,28,3006410813,-6018537
1649804411,196215,true,3012429350,28,3006711454,-5717896
1649804504,196213,true,3013031866,28,3007012125,-6019741
1649804536,196214,true,3012730593,28,3007012125,-5718468
1649805736,196217,true,3011826955,28,3010923587,-903368
1649805835,196217,true,3011826955,28,3011525802,-301153
1649805851,196216,true,3012128138,28,3011826955,-301183
1649805864,196217,true,3011826955,28,3011826955,0
1649806050,196220,true,3010923587,28,3013935866,3012279
1649806337,196219,true,3011224680,28,3016347859,5123179
1649806941,196218,true,3011525802,28,3020271465,8745663
1649807201,196220,true,3010923587,28,3022084081,11160494
1649807568,196222,true,3010321493,28,3024502595,14181102
1649808089,196222,true,3010321493,28,3025712577,15391084
1649808537,196220,true,3010923587,28,3026317750,15394163
1649808605,196222,true,3010321493,28,3026317750,15996257
1649808766,196225,true,3009418577,28,3027225736,17807159
1649808777,196224,true,3009719519,28,3027225736,17506217
1649808882,196222,true,3010321493,28,3027831211,17509718
1649810679,196223,true,3010020491,28,3036320594,26300103
1649811476,196226,true,3009117665,28,3036320594,27202929
1649811864,196225,true,3009418577,28,3035713421,26294844
1649811985,196223,true,3010020491,28,3035713421,25692930
1649812011,196225,true,3009418577,28,3035409880,25991303
1649812372,196228,true,3008515932,28,3033285943,24770011
1649812663,196228,true,3008515932,28,3031163491,22647559
1649812902,196226,true,3009117665,28,3029345430,20227765
1649812910,196228,true,3008515932,28,3029042526,20526594
1649813323,196230,true,3007914319,28,3025107525,17193206
1649814000,196230,true,3007914319,28,3019969468,12055149
1649814081,196229,true,3008215111,28,3019667501,11452390
1649814670,196230,true,3007914319,28,3018761782,10847463
1649815176,196232,true,3007312827,28,3019365565,12052738
1649815585,196232,true,3007312827,28,3020573492,13260665
1649817204,196230,true,3007914319,28,3024805045,16890726
1649817341,196231,true,3007613558,28,3025107525,17493967
1649817361,196233,true,3007012125,28,3025410036,18397911
1649817527,196233,true,3007012125,28,3026620382,19608257
1649817564,196230,true,3007914319,28,3026923044,19008725
1649818973,196231,true,3007613558,28,3041790619,34177061
1649819114,196232,true,3007312827,28,3043007518,35694691
1649819160,196232,true,3007312827,28,3043311818,35998991
1649819336,196230,true,3007914319,28,3043616150,35701831
1649819362,196230,true,3007914319,28,3043616150,35701831
1649819479,196232,true,3007312827,28,3043920511,36607684
1649819491,196231,true,3007613558,28,3043920511,36306953
1649819983,196228,true,3008515932,28,3045442776,36926844
1649820032,196228,true,3008515932,28,3045747320,37231388
1649820065,196228,true,3008515932,28,3046051895,37535963
1649820337,196228,true,3008515932,28,3048184771,39668839
1649820432,196224,true,3009719519,28,3048794439,39074920
1649822214,196223,true,3010020491,28,3058259892,48239401
1649822697,196223,true,3010020491,28,3058259892,48239401
1649822769,196222,true,3010321493,28,3058259892,47938399
1649822933,196218,true,3011525802,28,3057954096,46428294
1649823788,196217,true,3011826955,28,3056731221,44904266
1649823948,196217,true,3011826955,28,3056425578,44598623
1649824980,196217,true,3011826955,28,3053370833,41543878
1649825025,196213,true,3013031866,28,3053370833,40338967
1649826003,196212,true,3013333170,28,3051539451,38206281
1649826538,196212,true,3013333170,28,3051844605,38511435
1649826713,196211,true,3013634503,28,3051844605,38210102
1649828246,196207,true,3014840137,28,3053370833,38530696
1649828701,196205,true,3015443136,28,3053676170,38233034
1649828950,196205,true,3015443136,28,3053676170,38233034
1649829255,196204,true,3015744680,28,3053676170,37931490
1649829281,196199,true,3017252854,28,3053676170,36423316
1649829323,196198,true,3017554579,28,3053981538,36426959
1649829388,196197,true,3017856335,28,3054286936,36430601
1649830800,196195,true,3018459936,28,3060401316,41941380
1649831317,196190,true,3019969468,28,3061319528,41350060
1649831333,196188,true,3020573492,28,3061319528,40746036
1649831789,196187,true,3020875549,28,3061319528,40443979
1649832653,196186,true,3021177637,28,3061319528,40141891
1649832700,196181,true,3022688528,28,3061319528,38631000
1649832730,196180,true,3022990797,28,3061319528,38328731
1649832786,196179,true,3023293096,28,3061013427,37720331
1649832798,196178,true,3023595425,28,3061013427,37418002
1649834291,196173,true,3025107525,28,3050624173,25516648
1649834782,196171,true,3025712577,28,3049709168,23996591
1649837795,196170,true,3026015148,28,3051539451,25524303
1649838590,196169,true,3026317750,28,3051539451,25221701
1649838822,196165,true,3027528458,28,3051539451,24010993
1649840322,196163,true,3028133994,28,3051539451,23405457
1649844766,196162,true,3028436808,28,3051234328,22797520
1649844827,196161,true,3028739652,28,3051234328,22494676
1649845568,196157,true,3029951329,28,3050624173,20672844
1649845571,196155,true,3030557350,28,3050624173,20066823
1649845686,196155,true,3030557350,28,3050319141,19761791
1649845710,196153,true,3031163491,28,3050319141,19155650
1649846006,196150,true,3032072931,28,3049404228,17331297
1649846015,196148,true,3032679376,28,3049404228,16724852
1649846020,196147,true,3032982644,28,3049404228,16421584
1649846088,196145,true,3033589271,28,3049099318,15510047
1649846235,196142,true,3034499439,28,3048489590,13990151
1649847078,196140,true,3035106369,28,3044833779,9727410
1649847217,196139,true,3035409880,28,3044224903,8815023
1649847240,196138,true,3035713421,28,3043920511,8207090
1649847333,196135,true,3036624226,28,3043616150,6991924
1649848319,196134,true,3036927888,28,3041182352,4254464
1649850270,196133,true,3037231581,28,3039966183,2734602
1649850432,196132,true,3037535304,28,3039662217,2126913
1649850466,196130,true,3038142842,28,3039662217,1519375
1649851072,196129,true,3038446656,28,3037535304,-911352
1649851126,196128,true,3038750501,28,3036927888,-1822613
1649851213,196128,true,3038750501,28,3036016992,-2733509
1649852997,196128,true,3038750501,28,3022084081,-16666420
1649853049,196127,true,3039054376,28,3021781903,-17272473
1649853305,196127,true,3039054376,28,3021177637,-17876739
1649853381,196127,true,3039054376,28,3021177637,-17876739
1649853399,196126,true,3039358281,28,3020875549,-18482732
1649853445,196125,true,3039662217,28,3020875549,-18786668
1649853648,196125,true,3039662217,28,3020271465,-19390752
1649853701,196125,true,3039662217,28,3020271465,-19390752
1649854708,196125,true,3039662217,28,3017252854,-22409363
1649854924,196124,true,3039966183,28,3016649494,-23316689
1649854943,196125,true,3039662217,28,3016649494,-23012723
1649854991,196125,true,3039662217,28,3016347859,-23314358
1649855411,196125,true,3039662217,28,3015141622,-24520595
1649855424,196125,true,3039662217,28,3015141622,-24520595
1649856161,196126,true,3039358281,28,3011224680,-28133601
1649856188,196127,true,3039054376,28,3011224680,-27829696
1649856322,196127,true,3039054376,28,3010622525,-28431851
1649856358,196127,true,3039054376,28,3010321493,-28732883
1649856783,196128,true,3038750501,28,3009418577,-29331924
1649856820,196128,true,3038750501,28,3009418577,-29331924
1649856900,196129,true,3038446656,28,3009418577,-29028079
1649856939,196129,true,3038446656,28,3009418577,-29028079
1649856952,196129,true,3038446656,28,3009719519,-28727137
1649856968,196130,true,3038142842,28,3009719519,-28423323
1649857002,196131,true,3037839058,28,3010020491,-27818567
1649857074,196130,true,3038142842,28,3010622525,-27520317
1649857108,196130,true,3038142842,28,3010923587,-27219255
1649857414,196130,true,3038142842,28,3015141622,-23001220
1649857433,196131,true,3037839058,28,3015443136,-22395922
1649857450,196130,true,3038142842,28,3015744680,-22398162
1649857535,196130,true,3038142842,28,3017554579,-20588263
1649857562,196128,true,3038750501,28,3018158120,-20592381
1649857591,196128,true,3038750501,28,3019063658,-19686843
1649857593,196127,true,3039054376,28,3019063658,-19990718
1649857635,196126,true,3039358281,28,3019969468,-19388813
1649857866,196124,true,3039966183,28,3026015148,-13951035
1649857975,196124,true,3039966183,28,3028739652,-11226531
1649858051,196123,true,3040270180,28,3031163491,-9106689
1649858097,196122,true,3040574207,28,3032376139,-8198068
1649858144,196119,true,3041486470,28,3033892630,-7593840
1649858190,196119,true,3041486470,28,3035409880,-6076590
1649858198,196118,true,3041790619,28,3035713421,-6077198
1649858789,196116,true,3042399008,28,3056425578,14026570
1649859316,196114,true,3043007518,28,3068368314,25360796
1649859344,196114,true,3043007518,28,3068982018,25974500
1649859364,196114,true,3043007518,28,3069288916,26281398
1649859373,196112,true,3043616150,28,3069595845,25979695
1649859421,196109,true,3044529326,28,3070516816,25987490
1649859553,196109,true,3044529326,28,3072974090,28444764
1649859988,196109,true,3044529326,28,3080357715,35828389
1649860159,196107,true,3045138262,28,3081898202,36759940
1649860221,196104,true,3046051895,28,3082206392,36154497
1649860261,196104,true,3046051895,28,3082514612,36462717
1649860317,196104,true,3046051895,28,3082822864,36770969
1649860356,196103,true,3046356500,28,3082822864,36466364
1649862190,196101,true,3046965802,28,3073281387,26315585
1649862248,196102,true,3046661136,28,3073588715,26927579
1649862282,196102,true,3046661136,28,3073588715,26927579
1649862470,196101,true,3046965802,28,3073896074,26930272
1649862482,196099,true,3047575226,28,3073896074,26320848
1649862500,196100,true,3047270499,28,3073896074,26625575
1649862577,196100,true,3047270499,28,3074203464,26932965
1649862584,196099,true,3047575226,28,3074203464,26628238
1649862702,196096,true,3048489590,28,3074818335,26328745
1649862908,196097,true,3048184771,28,3076048447,27863676
1649863077,196096,true,3048489590,28,3076971354,28481764
1649863082,196095,true,3048794439,28,3076971354,28176915
1649863359,196092,true,3049709168,28,3078510147,28800979
1649863421,196093,true,3049404228,28,3079125880,29721652
1649863478,196092,true,3049709168,28,3079741736,30032568
1649863954,196091,true,3050014139,28,3086524287,36510148
1649863996,196087,true,3051234328,28,3087141622,35907294
1649864008,196088,true,3050929235,28,3087141622,36212387
1649864054,196087,true,3051234328,28,3088067857,36833529
1649864284,196085,true,3051844605,28,3091775578,39930973
1649864465,196082,true,3052760250,28,3094559289,41799039
1649864491,196083,true,3052455005,28,3094868745,42413740
1649865430,196082,true,3052760250,28,3103546086,50785836
1649865654,196080,true,3053370833,28,3104166826,50795993
1649865670,196077,true,3054286936,28,3104166826,49879890
1649865828,196078,true,3053981538,28,3103856441,49874903
1649865910,196077,true,3054286936,28,3104166826,49879890
1649865929,196075,true,3054897824,28,3104166826,49269002
1649867207,196071,true,3056119966,28,3106961694,50841728
1649867298,196071,true,3056119966,28,3106961694,50841728
1649867315,196070,true,3056425578,28,3106961694,50536116
1649867452,196068,true,3057036894,28,3106961694,49924800
1649867482,196065,true,3057954096,28,3107272390,49318294
1649867648,196065,true,3057954096,28,3107583118,49629022
1649867668,196064,true,3058259892,28,3107583118,49323226
1649867906,196063,true,3058565718,28,3106340395,47774677
1649867937,196059,true,3059789328,28,3106340395,46551067
1649867981,196059,true,3059789328,28,3106029792,46240464
1649868096,196059,true,3059789328,28,3105098170,45308842
1649868877,196057,true,3060401316,28,3099824250,39422934
1649869039,196054,true,3061319528,28,3098584631,37265103
1649869308,196054,true,3061319528,28,3096726130,35406602
1649871397,196054,true,3061319528,28,3082206392,20886864
1649871427,196053,true,3061625660,28,3082206392,20580732
1649872591,196049,true,3062850494,28,3080049710,17199216
1649872653,196049,true,3062850494,28,3079741736,16891242
1649874019,196050,true,3062544240,28,3078510147,15965907
1649874039,196048,true,3063156779,28,3078817998,15661219
1649874284,196045,true,3064075818,28,3079433792,15357974
1649874446,196045,true,3064075818,28,3080357715,16281897
1649874637,196045,true,3064075818,28,3081281915,17206097
1649874723,196043,true,3064688664,28,3081898202,17209538
1649875426,196039,true,3065914723,28,3086215665,20300942
1649875449,196039,true,3065914723,28,3086524287,20609564
1649875594,196038,true,3066221315,28,3087759081,21537766
1649875709,196036,true,3066834590,28,3088685502,21850912
1649875834,196032,true,3068061508,28,3089612200,21550692
1649876082,196031,true,3068368314,28,3091157315,22789001
1649876321,196030,true,3068675151,28,3092084755,23409604
1649876715,196027,true,3069595845,28,3094249864,24654019
1649876754,196023,true,3070823868,28,3094249864,23425996
1649878524,196021,true,3071438063,28,3104166826,32728763
1649878826,196020,true,3071745207,28,3104166826,32421619
1649878839,196017,true,3072666823,28,3104166826,31500003
1649878868,196013,true,3073896074,28,3104166826,30270752
1649878905,196011,true,3074510884,28,3104166826,29655942
1649879024,196010,true,3074818335,28,3103856441,29038106
1649879034,196007,true,3075740873,28,3103856441,28115568
1649879049,196003,true,3076971354,28,3103856441,26885087
1649879273,196001,true,3077586779,28,3103235763,25648984
1649879408,196000,true,3077894537,28,3102615208,24720671
1649879426,195997,true,3078817998,28,3102615208,23797210
1649879612,195993,true,3080049710,28,3101374473,21324763
1649880557,195991,true,3080665751,28,3095797298,15131547
1649880613,195990,true,3080973817,28,3095487750,14513933
1649882295,195987,true,3081898202,28,3092703203,10805001
1649882898,195983,true,3083131146,28,3092703203,9572057
1649882942,195981,true,3083747803,28,3092703203,8955400
1649883021,195980,true,3084056178,28,3093321775,9265597
1649883532,195978,true,3084673020,28,3096726130,12053110
1649885791,195973,true,3086215665,28,3104787691,18572026
1649886329,195971,true,3086832939,28,3104787691,17954752
1649886368,195971,true,3086832939,28,3104787691,17954752
1649886888,195969,true,3087450336,28,3104166826,16716490
1649887429,195965,true,3088685502,28,3103235763,14550261
1649887710,195963,true,3089303270,28,3102925470,13622200
1649888671,195963,true,3089303270,28,3101994778,12691508
1649888705,195961,true,3089921161,28,3102304978,12383817
1649889256,195958,true,3090848230,28,3102925470,12077240
1649889543,195956,true,3091466431,28,3105098170,13631739
1649889566,195956,true,3091466431,28,3105408679,13942248
1649889686,195954,true,3092084755,28,3106340395,14255640
1649890293,195950,true,3093321775,28,3111936563,18614788
1649890614,195949,true,3093631107,28,3114738427,21107320
1649890795,195949,true,3093631107,28,3115984509,22353402
1649892289,195947,true,3094249864,28,3119725747,25475883
1649892628,195943,true,3095487750,28,3120037720,24549970
1649893580,195943,true,3095487750,28,3120349724,24861974
1649894373,195943,true,3095487750,28,3120349724,24861974
1649894767,195941,true,3096106878,28,3120349724,24242846
1649895004,195938,true,3097035803,28,3120349724,23313921
1649898531,195937,true,3097345507,28,3120349724,23004217
1649898744,195938,true,3097035803,28,3120349724,23313921
1649900221,195936,true,3097655241,28,3120349724,22694483
1649900428,195934,true,3098274803,28,3120661759,22386956
1649900518,195934,true,3098274803,28,3120661759,22386956
1649900736,195934,true,3098274803,28,3121285922,23011119
1649901082,195932,true,3098894489,28,3122222402,23327913
1649901515,195930,true,3099514299,28,3125658564,26144265
1649904506,195928,true,3100134233,28,3135049149,34914916
1649904600,195929,true,3099824250,28,3135049149,35224899
1649904644,195926,true,3100754291,28,3135049149,34294858
1649904896,195922,true,3101994778,28,3134735676,32740898
1649905554,195922,true,3101994778,28,3134108822,32114044
1649905572,195922,true,3101994778,28,3134108822,32114044
1649906170,195920,true,3102615208,28,3131602663,28987455
1649906630,195916,true,3103856441,28,3129098508,25242067
1649906930,195916,true,3103856441,28,3127847182,23990741
1649907413,195916,true,3103856441,28,3125658564,21802123
1649907476,195914,true,3104477243,28,3125658564,21181321
1649910070,195912,true,3105098170,28,3123159162,18060992
1649910291,195911,true,3105408679,28,3123159162,17750483
1649910422,195911,true,3105408679,28,3123159162,17750483
1649910871,195910,true,3105719220,28,3123159162,17439942
1649910927,195907,true,3106651029,28,3123159162,16508133
1649911049,195907,true,3106651029,28,3123159162,16508133
1649911498,195907,true,3106651029,28,3123159162,16508133
1649911515,195906,true,3106961694,28,3123159162,16197468
1649911592,195904,true,3107583118,28,3123159162,15576044
1649911637,195904,true,3107583118,28,3122846877,15263759
1649911661,195905,true,3107272390,28,3122846877,15574487
1649911738,195905,true,3107272390,28,3122534624,15262234
1649914205,195903,true,3107893876,28,3117231090,9337214
1649914586,195903,true,3107893876,28,3117231090,9337214
1649915504,195904,true,3107583118,28,3116296107,8712989
1649916210,195903,true,3107893876,28,3115672942,7779066
1649916664,195902,true,3108204665,28,3115672942,7468277
1649917374,195901,true,3108515486,28,3114426984,5911498
1649917533,195902,true,3108204665,28,3114115572,5910907
1649919378,195902,true,3108204665,28,3111314269,3109604
1649919935,195901,true,3108515486,28,3111314269,2798783
1649920330,195901,true,3108515486,28,3111314269,2798783
1649920400,195902,true,3108204665,28,3111314269,3109604
1649921177,195902,true,3108204665,28,3110692100,2487435
1649922239,195900,true,3108826337,28,3109759079,932742
1649922480,195900,true,3108826337,28,3110070054,1243717
1649923481,195901,true,3108515486,28,3110381061,1865575
1649923938,195901,true,3108515486,28,3110381061,1865575
1649923961,195899,true,3109137220,28,3110381061,1243841
1649924220,195899,true,3109137220,28,3110692100,1554880
1649926154,195900,true,3108826337,28,3112558982,3732645
1649926458,195899,true,3109137220,28,3112558982,3421762
1649926706,195897,true,3109759079,28,3112558982,2799903
1649927667,195897,true,3109759079,28,3112558982,2799903
1649928325,195897,true,3109759079,28,3112558982,2799903
1649928342,195896,true,3110070054,28,3112558982,2488928
1649928499,195894,true,3110692100,28,3111314269,622169
1649930784,195895,true,3110381061,28,3096416489,-13964572
1649933160,195895,true,3110381061,28,3096726130,-13654931
1649933352,195894,true,3110692100,28,3096726130,-13965970
1649933401,195892,true,3111314269,28,3096416489,-14897780
1649933439,195893,true,3111003169,28,3096416489,-14586680
1649933651,195894,true,3110692100,28,3095487750,-15204350
1649933998,195893,true,3111003169,28,3094249864,-16753305
1649935133,195892,true,3111314269,28,3088685502,-22628767
1649936287,195893,true,3111003169,28,3087450336,-23552833
1649936333,195894,true,3110692100,28,3087450336,-23241764
1649936890,195894,true,3110692100,28,3086832939,-23859161
1649937003,195893,true,3111003169,28,3086832939,-24170230
1649937050,195894,true,3110692100,28,3086524287,-24167813
1649937053,195895,true,3110381061,28,3086524287,-23856774
1649937164,195895,true,3110381061,28,3086215665,-24165396
1649937314,195895,true,3110381061,28,3085598514,-24782547
1649937415,195897,true,3109759079,28,3084981487,-24777592
1649939955,195898,true,3109448134,28,3077894537,-31553597
1649940445,195898,true,3109448134,28,3077894537,-31553597
1649940521,195898,true,3109448134,28,3077894537,-31553597
1649940542,195900,true,3108826337,28,3077894537,-30931800
1649941132,195901,true,3108515486,28,3079125880,-29389606
1649941399,195900,true,3108826337,28,3079741736,-29084601
1649941520,195900,true,3108826337,28,3080049710,-28776627
1649941551,195902,true,3108204665,28,3080357715,-27846950
1649941731,195902,true,3108204665,28,3081281915,-26922750
1649941735,195902,true,3108204665,28,3081281915,-26922750
1649941962,195901,true,3108515486,28,3082822864,-25692622
1649943302,195902,true,3108204665,28,3088994370,-19210295
1649943612,195903,true,3107893876,28,3089303270,-18590606
1649943634,195902,true,3108204665,28,3089303270,-18901395
1649943653,195901,true,3108515486,28,3089303270,-19212216
1649943657,195903,true,3107893876,28,3089303270,-18590606
1649943693,195904,true,3107583118,28,3088994370,-18588748
1649943756,195905,true,3107272390,28,3088376664,-18895726
1649943827,195905,true,3107272390,28,3087450336,-19822054
1649943886,195907,true,3106651029,28,3086832939,-19818090
1649943924,195908,true,3106340395,28,3086524287,-19816108
1649943958,195909,true,3106029792,28,3085907074,-20122718
1649944310,195910,true,3105719220,28,3081281915,-24437305
1649944334,195911,true,3105408679,28,3080973817,-24434862
1649945008,195913,true,3104787691,28,3067447987,-37339704
1649945125,195915,true,3104166826,28,3064688664,-39478162
1649945142,195915,true,3104166826,28,3064382226,-39784600
1649945165,195917,true,3103546086,28,3063769441,-39776645
1649945995,195921,true,3102304978,28,3047879983,-54424995
1649946419,195923,true,3101684610,28,3044224903,-57459707
1649946559,195924,true,3101374473,28,3043311818,-58062655
1649946581,195926,true,3100754291,28,3043007518,-57746773
1649946623,195930,true,3099514299,28,3042703247,-56811052
1649946638,195932,true,3098894489,28,3042703247,-56191242
1649946711,195933,true,3098584631,28,3042703247,-55881384
1649947145,195934,true,3098274803,28,3043616150,-54658653
1649947916,195938,true,3097035803,28,3046051895,-50983908
1649947931,195940,true,3096416489,28,3046051895,-50364594
1649948191,195941,true,3096106878,28,3046965802,-49141076
1649949161,195943,true,3095487750,28,3046661136,-48826614
1649949769,195947,true,3094249864,28,3046661136,-47588728
1649950585,195948,true,3093940470,28,3046661136,-47279334
1649950646,195950,true,3093321775,28,3046661136,-46660639
1649950659,195951,true,3093012473,28,3046661136,-46351337
1649950671,195956,true,3091466431,28,3046661136,-44805295
1649950726,195958,true,3090848230,28,3046051895,-44796335
1649950997,195961,true,3089921161,28,3043311818,-46609343
1649951045,195963,true,3089303270,28,3043007518,-46295752
1649951222,195968,true,3087759081,28,3040878264,-46880817
1649951228,195971,true,3086832939,28,3040878264,-45954675
1649951277,195974,true,3085907074,28,3040270180,-45636894
1649951449,195976,true,3085289985,28,3037839058,-47450927
1649951513,195981,true,3083747803,28,3036927888,-46819915
1649953018,195984,true,3082822864,28,3021781903,-61040961
1649953282,195986,true,3082206392,28,3021781903,-60424489
1649953777,195988,true,3081590043,28,3021479755,-60110288
1649954052,195993,true,3080049710,28,3021479755,-58569955
1649954116,195996,true,3079125880,28,3021479755,-57646125
1649954144,195998,true,3078510147,28,3021479755,-57030392
1649954174,196000,true,3077894537,28,3021479755,-56414782
1649954198,196005,true,3076356052,28,3021177637,-55178415
1649954396,196008,true,3075433329,28,3020271465,-55161864
1649956262,196011,true,3074510884,28,3011826955,-62683929
1649957685,196013,true,3073896074,28,3011826955,-62069119
1649958330,196018,true,3072359587,28,3012730593,-59628994
1649958629,196021,true,3071438063,28,3013333170,-58104893
1649959395,196024,true,3070516816,28,3014237260,-56279556
1649959452,196026,true,3069902805,28,3014538684,-55364121
1649959864,196030,true,3068675151,28,3015141622,-53533529
1649962447,196033,true,3067754732,28,3016951159,-50803573
1649962461,196036,true,3066834590,28,3016951159,-49883431
1649962516,196037,true,3066527937,28,3016951159,-49576778
1649962537,196042,true,3064995133,28,3016649494,-48345639
1649962704,196047,true,3063463095,28,3014840137,-48622958
1649962878,196049,true,3062850494,28,3012429350,-50421144
1649964019,196052,true,3061931823,28,2993810996,-68120827
1649964041,196057,true,3060401316,28,2993511645,-66889671
1649964791,196061,true,3059177462,28,2989622802,-69554660
1649966075,196064,true,3058259892,28,2991417024,-66842868
1649966348,196066,true,3057648332,28,2992015338,-65632994
1649968491,196071,true,3056119966,28,2993511645,-62608321
1649968607,196075,true,3054897824,28,2993810996,-61086828
1649968653,196077,true,3054286936,28,2993810996,-60475940
1649968759,196080,true,3053370833,28,2994409788,-58961045
1649968970,196083,true,3052455005,28,2995907292,-56547713
1649969135,196087,true,3051234328,28,2996806154,-54428174
1649969786,196090,true,3050319141,28,3001304512,-49014629
1649969869,196092,true,3049709168,28,3001904803,-47804365
1649970189,196096,true,3048489590,28,3004607598,-43881992
1649970471,196100,true,3047270499,28,3006711454,-40559045
1649970505,196102,true,3046661136,28,3006711454,-39949682
1649970716,196104,true,3046051895,28,3007312827,-38739068
1649970791,196108,true,3044833779,28,3007613558,-37220221
1649971783,196112,true,3043616150,28,3010020491,-33595659
1649972118,196113,true,3043311818,28,3010321493,-32990325
1649972339,196114,true,3043007518,28,3010622525,-32384993
1649974127,196117,true,3042094798,28,3013634503,-28460295
1649974163,196121,true,3040878264,28,3013634503,-27243761
1649974226,196123,true,3040270180,28,3013935866,-26334314
1649975724,196124,true,3039966183,28,3017856335,-22109848
1649975766,196126,true,3039358281,28,3017856335,-21501946
1649976082,196130,true,3038142842,28,3018459936,-19682906
1649976616,196131,true,3037839058,28,3018459936,-19379122
1649978489,196132,true,3037535304,28,3018459936,-19075368
1649980253,196134,true,3036927888,28,3018459936,-18467952
1649980853,196138,true,3035713421,28,3018459936,-17253485
1649980974,196139,true,3035409880,28,3018459936,-16949944
1649981287,196140,true,3035106369,28,3018761782,-16344587
1649981465,196142,true,3034499439,28,3019063658,-15435781
1649981519,196145,true,3033589271,28,3019063658,-14525613
1649981532,196146,true,3033285943,28,3019063658,-14222285
1649982141,196147,true,3032982644,28,3020573492,-12409152
1649982273,196148,true,3032679376,28,3020875549,-11803827
1649982297,196152,true,3031466608,28,3020875549,-10591059
1649982540,196153,true,3031163491,28,3022084081,-9079410
1649982706,196153,true,3031163491,28,3022688528,-8474963
1649983306,196155,true,3030557350,28,3025107525,-5449825
1649983525,196158,true,3029648364,28,3025410036,-4238328
1649983558,196159,true,3029345430,28,3025410036,-3935394
1649984780,196159,true,3029345430,28,3024200174,-5145256
1649985609,196162,true,3028436808,28,3022990797,-5446011
1649986801,196165,true,3027528458,28,3022990797,-4537661
1649986977,196167,true,3026923044,28,3022990797,-3932247
1649987092,196167,true,3026923044,28,3022990797,-3932247
1649987154,196170,true,3026015148,28,3022990797,-3024351
1649992231,196173,true,3025107525,28,3022990797,-2116728
1649992406,196175,true,3024502595,28,3023293096,-1209499
1649993286,196175,true,3024502595,28,3024502595,0
1649993517,196176,true,3024200174,28,3025712577,1512403
1649993526,196179,true,3023293096,28,3025712577,2419481
1649995252,196179,true,3023293096,28,3033589271,10296175
1649995291,196179,true,3023293096,28,3033589271,10296175
1649995406,196180,true,3022990797,28,3033892630,10901833
1649995422,196183,true,3022084081,28,3033892630,11808549
1649996379,196183,true,3022084081,28,3035713421,13629340
1649996866,196183,true,3022084081,28,3036927888,14843807
1649996950,196183,true,3022084081,28,3037231581,15147500
1649997455,196185,true,3021479755,28,3037839058,16359303
1650000489,196184,true,3021781903,28,3038142842,16360939
1650003441,196184,true,3021781903,28,3038142842,16360939
1650004722,196183,true,3022084081,28,3038142842,16058761
1650004732,196185,true,3021479755,28,3038142842,16663087
1650004763,196185,true,3021479755,28,3038142842,16663087
1650004982,196185,true,3021479755,28,3037839058,16359303
1650005002,196184,true,3021781903,28,3037839058,16057155
1650005260,196186,true,3021177637,28,3036927888,15750251
1650005261,196186,true,3021177637,28,3036927888,15750251
1650006194,196187,true,3020875549,28,3032679376,11803827
1650006215,196186,true,3021177637,28,3032679376,11501739
1650006227,196188,true,3020573492,28,3032679376,12105884
1650006327,196188,true,3020573492,28,3032072931,11499439
1650007184,196189,true,3020271465,28,3028133994,7862529
1650007229,196188,true,3020573492,28,3028133994,7560502
1650007257,196191,true,3019667501,28,3028133994,8466493
1650007413,196191,true,3019667501,28,3027528458,7860957
1650007452,196192,true,3019365565,28,3027225736,7860171
1650007636,196191,true,3019667501,28,3026317750,6650249
1650008850,196193,true,3019063658,28,3022386289,3322631
1650008991,196192,true,3019365565,28,3022084081,2718516
1650009013,196193,true,3019063658,28,3022084081,3020423
1650009116,196192,true,3019365565,28,3022386289,3020724
1650009124,196193,true,3019063658,28,3022386289,3322631
1650009144,196192,true,3019365565,28,3022386289,3020724
1650009161,196192,true,3019365565,28,3022386289,3020724
1650010769,196190,true,3019969468,28,3035409880,15440412
1650011074,196191,true,3019667501,28,3036016992,16349491
1650011094,196190,true,3019969468,28,3036016992,16047524
1650011256,196190,true,3019969468,28,3035713421,15743953
1650011293,196189,true,3020271465,28,3035713421,15441956
1650011311,196190,true,3019969468,28,3035713421,15743953
1650011385,196189,true,3020271465,28,3035409880,15138415
1650011398,196189,true,3020271465,28,3035409880,15138415
1650011505,196187,true,3020875549,28,3034802889,13927340
1650011893,196188,true,3020573492,28,3032982644,12409152
1650013498,196187,true,3020875549,28,3026923044,6047495
1650013901,196187,true,3020875549,28,3026620382,5744833
1650017137,196185,true,3021479755,28,3026620382,5140627
1650018518,196187,true,3020875549,28,3026620382,5744833
1650018923,196185,true,3021479755,28,3026620382,5140627
1650019557,196186,true,3021177637,28,3026620382,5442745
1650019647,196184,true,3021781903,28,3026923044,5141141
1650019678,196185,true,3021479755,28,3026923044,5443289
1650019697,196184,true,3021781903,28,3026923044,5141141
1650019709,196185,true,3021479755,28,3026923044,5443289
1650019724,196183,true,3022084081,28,3026923044,4838963
1650020797,196182,true,3022386289,28,3029345430,6959141
1650025830,196180,true,3022990797,28,3030860405,7869608
1650026155,196180,true,3022990797,28,3030860405,7869608
1650026644,196178,true,3023595425,28,3030860405,7264980
1650027079,196177,true,3023897785,28,3030557350,6659565
1650027128,196175,true,3024502595,28,3030557350,6054755
1650027254,196175,true,3024502595,28,3030254324,5751729
1650027387,196173,true,3025107525,28,3029951329,4843804
1650027998,196173,true,3025107525,28,3028739652,3632127
1650028003,196171,true,3025712577,28,3028739652,3027075
1650028241,196172,true,3025410036,28,3027831211,2421175
1650028539,196171,true,3025712577,28,3026923044,1210467
1650029668,196171,true,3025712577,28,3021177637,-4534940
1650029712,196170,true,3026015148,28,3021177637,-4837511
1650029746,196170,true,3026015148,28,3020875549,-5139599
1650030363,196169,true,3026317750,28,3020271465,-6046285
1650030469,196169,true,3026317750,28,3020271465,-6046285
1650030614,196168,true,3026620382,28,3019969468,-6650914
1650030672,196168,true,3026620382,28,3019969468,-6650914
1650032573,196168,true,3026620382,28,3013031866,-13588516
1650033263,196169,true,3026317750,28,3008816784,-17500966
1650033993,196168,true,3026620382,28,3003706396,-22913986
1650034029,196169,true,3026317750,28,3003706396,-22611354
1650034070,196170,true,3026015148,28,3003706396,-22308752
1650034093,196170,true,3026015148,28,3003706396,-22308752
1650034131,196169,true,3026317750,28,3003706396,-22611354
1650034142,196169,true,3026317750,28,3003706396,-22611354
1650034148,196170,true,3026015148,28,3004006766,-22008382
1650034181,196170,true,3026015148,28,3004307167,-21707981
1650034198,196167,true,3026923044,28,3004307167,-22615877
1650034528,196166,true,3027225736,28,3011224680,-16001056
1650034595,196167,true,3026923044,28,3012730593,-14192451
1650034649,196167,true,3026923044,28,3013634503,-13288541
1650035771,196165,true,3027528458,28,3036927888,9399430
1650038598,196164,true,3027831211,28,3035106369,7275158
1650038669,196165,true,3027528458,28,3035106369,7577911
1650038804,196165,true,3027528458,28,3034802889,7274431
1650039064,196163,true,3028133994,28,3034196019,6062025
1650039075,196163,true,3028133994,28,3033892630,5758636
1650039102,196164,true,3027831211,28,3033892630,6061419
1650039358,196165,true,3027528458,28,3032072931,4544473
1650039391,196163,true,3028133994,28,3031769754,3635760
1650039473,196163,true,3028133994,28,3031163491,3029497
1650042238,196165,true,3027528458,28,3019365565,-8162893
1650042250,196165,true,3027528458,28,3019667501,-7860957
1650042274,196164,true,3027831211,28,3019667501,-8163710
1650042351,196164,true,3027831211,28,3019969468,-7861743
1650042531,196164,true,3027831211,28,3021177637,-6653574
1650043652,196164,true,3027831211,28,3028739652,908441
1650049510,196163,true,3028133994,28,3034196019,6062025
1650049705,196163,true,3028133994,28,3034196019,6062025
1650049892,196163,true,3028133994,28,3033892630,5758636
1650049924,196163,true,3028133994,28,3033892630,5758636
1650050229,196162,true,3028436808,28,3032982644,4545836
1650050804,196162,true,3028436808,28,3031163491,2726683
1650051587,196162,true,3028436808,28,3029042526,605718
1650054494,196163,true,3028133994,28,3028739652,605658
1650054755,196162,true,3028436808,28,3028739652,302844
1650059344,196163,true,3028133994,28,3027225736,-908258
1650059852,196163,true,3028133994,28,3027528458,-605536
1650060050,196164,true,3027831211,28,3027528458,-302753
1650060094,196163,true,3028133994,28,3027528458,-605536
1650060811,196163,true,3028133994,28,3028739652,605658
1650061588,196164,true,3027831211,28,3029951329,2120118
1650064514,196164,true,3027831211,28,3030254324,2423113
1650065863,196164,true,3027831211,28,3030254324,2423113
1650066035,196164,true,3027831211,28,3030254324,2423113
1650066061,196165,true,3027528458,28,3030557350,3028892
1650066277,196165,true,3027528458,28,3031163491,3635033
1650066319,196165,true,3027528458,28,3031163491,3635033
1650066718,196165,true,3027528458,28,3032679376,5150918
1650067559,196164,true,3027831211,28,3035713421,7882210
1650068170,196165,true,3027528458,28,3036927888,9399430
1650070883,196164,true,3027831211,28,3036624226,8793015
1650070975,196164,true,3027831211,28,3036624226,8793015
1650071772,196164,true,3027831211,28,3036624226,8793015
1650073256,196164,true,3027831211,28,3039054376,11223165
1650073362,196163,true,3028133994,28,3039054376,10920382
1650074442,196162,true,3028436808,28,3039358281,10921473
1650074636,196162,true,3028436808,28,3039358281,10921473
1650074770,196163,true,3028133994,28,3039358281,11224287
1650075073,196162,true,3028436808,28,3039358281,10921473
1650075198,196161,true,3028739652,28,3039358281,10618629
1650075219,196160,true,3029042526,28,3039358281,10315755
1650075426,196160,true,3029042526,28,3039358281,10315755
1650075582,196160,true,3029042526,28,3039358281,10315755
1650075656,196159,true,3029345430,28,3039358281,10012851
1650076433,196158,true,3029648364,28,3039358281,9709917
1650078352,196159,true,3029345430,28,3039358281,10012851
1650079065,196158,true,3029648364,28,3039662217,10013853
1650079346,196157,true,3029951329,28,3039662217,9710888
1650079759,196158,true,3029648364,28,3039662217,10013853
1650080066,196158,true,3029648364,28,3039662217,10013853
1650080439,196158,true,3029648364,28,3039662217,10013853
1650080744,196157,true,3029951329,28,3039662217,9710888
1650082556,196157,true,3029951329,28,3039358281,9406952
1650083537,196158,true,3029648364,28,3039358281,9709917
1650084793,196157,true,3029951329,28,3039358281,9406952
1650087137,196156,true,3030254324,28,3039662217,9407893
1650087421,196156,true,3030254324,28,3039662217,9407893
1650087861,196156,true,3030254324,28,3039662217,9407893
1650089248,196156,true,3030254324,28,3039662217,9407893
1650089875,196154,true,3030860405,28,3039662217,8801812
1650089966,196155,true,3030557350,28,3039662217,9104867
1650091623,196155,true,3030557350,28,3039054376,8497026
1650092929,196154,true,3030860405,28,3038750501,7890096
1650094103,196153,true,3031163491,28,3038750501,7587010
1650095211,196153,true,3031163491,28,3038750501,7587010
1650095883,196153,true,3031163491,28,3038750501,7587010
1650097505,196153,true,3031163491,28,3038750501,7587010
1650098808,196152,true,3031466608,28,3038750501,7283893
1650098857,196152,true,3031466608,28,3038750501,7283893
1650099013,196152,true,3031466608,28,3038750501,7283893
1650100142,196152,true,3031466608,28,3038750501,7283893
1650101729,196151,true,3031769754,28,3038750501,6980747
1650102648,196151,true,3031769754,28,3038750501,6980747
1650103532,196151,true,3031769754,28,3038750501,6980747
1650103675,196151,true,3031769754,28,3038750501,6980747
1650103847,196150,true,3032072931,28,3038750501,6677570
1650103940,196150,true,3032072931,28,3038750501,6677570
1650104209,196150,true,3032072931,28,3038750501,6677570
1650104252,196149,true,3032376139,28,3038750501,6374362
1650105049,196148,true,3032679376,28,3038750501,6071125
1650105612,196148,true,3032679376,28,3038750501,6071125
1650105649,196148,true,3032679376,28,3038750501,6071125
1650105876,196147,true,3032982644,28,3038750501,5767857
1650105889,196146,true,3033285943,28,3038750501,5464558
1650105965,196146,true,3033285943,28,3038750501,5464558
1650106985,196146,true,3033285943,28,3038750501,5464558
1650107216,196145,true,3033589271,28,3038750501,5161230
1650107279,196144,true,3033892630,28,3038750501,4857871
1650107899,196143,true,3034196019,28,3038750501,4554482
1650107909,196143,true,3034196019,28,3038750501,4554482
1650108106,196142,true,3034499439,28,3038750501,4251062
1650109067,196140,true,3035106369,28,3038750501,3644132
1650109886,196139,true,3035409880,28,3038750501,3340621
1650110231,196138,true,3035713421,28,3038750501,3037080
1650110857,196138,true,3035713421,28,3038750501,3037080
1650111182,196138,true,3035713421,28,3038750501,3037080
1650111375,196137,true,3036016992,28,3038750501,2733509
1650112643,196137,true,3036016992,28,3038750501,2733509
1650114065,196137,true,3036016992,28,3038142842,2125850
1650114782,196138,true,3035713421,28,3037839058,2125637
1650114924,196137,true,3036016992,28,3037839058,1822066
1650115193,196137,true,3036016992,28,3037839058,1822066
1650115338,196138,true,3035713421,28,3037839058,2125637
1650118658,196138,true,3035713421,28,3037839058,2125637
1650119102,196137,true,3036016992,28,3037839058,1822066
1650119818,196137,true,3036016992,28,3037839058,1822066
1650119930,196137,true,3036016992,28,3037839058,1822066
1650120956,196137,true,3036016992,28,3037839058,1822066
1650121203,196136,true,3036320594,28,3037839058,1518464
1650121209,196136,true,3036320594,28,3038142842,1822248
1650121315,196135,true,3036624226,28,3038750501,2126275
1650121430,196135,true,3036624226,28,3039358281,2734055
1650121803,196132,true,3037535304,28,3041790619,4255315
1650121824,196132,true,3037535304,28,3042094798,4559494
1650122002,196132,true,3037535304,28,3042703247,5167943
1650122019,196131,true,3037839058,28,3042703247,4864189
1650122159,196131,true,3037839058,28,3041790619,3951561
1650122775,196132,true,3037535304,28,3037231581,-303723
1650123070,196133,true,3037231581,28,3034499439,-2732142
1650123551,196132,true,3037535304,28,3027831211,-9704093
1650123571,196133,true,3037231581,28,3027528458,-9703123
1650123600,196134,true,3036927888,28,3026923044,-10004844
1650124342,196134,true,3036927888,28,3022386289,-14541599
1650125995,196133,true,3037231581,28,3019365565,-17866016
1650126918,196134,true,3036927888,28,3019365565,-17562323
1650127245,196135,true,3036624226,28,3019365565,-17258661
1650128771,196135,true,3036624226,28,3019667501,-16956725
1650128877,196134,true,3036927888,28,3019667501,-17260387
1650130799,196135,true,3036624226,28,3019365565,-17258661
1650131533,196136,true,3036320594,28,3019365565,-16955029
1650132724,196136,true,3036320594,28,3019365565,-16955029
1650132936,196136,true,3036320594,28,3019365565,-16955029
1650132967,196136,true,3036320594,28,3019365565,-16955029
1650134077,196137,true,3036016992,28,3019365565,-16651427
1650134681,196137,true,3036016992,28,3019365565,-16651427
1650136000,196137,true,3036016992,28,3019063658,-16953334
1650136411,196137,true,3036016992,28,3019365565,-16651427
1650136421,196138,true,3035713421,28,3019365565,-16347856
1650137237,196139,true,3035409880,28,3019667501,-15742379
1650137284,196139,true,3035409880,28,3019667501,-15742379
1650138472,196139,true,3035409880,28,3020271465,-15138415
1650138773,196140,true,3035106369,28,3020271465,-14834904
1650139540,196141,true,3034802889,28,3020271465,-14531424
1650139922,196141,true,3034802889,28,3020271465,-14531424
1650142361,196141,true,3034802889,28,3021177637,-13625252
1650145187,196142,true,3034499439,28,3031769754,-2729685
1650145322,196142,true,3034499439,28,3032072931,-2426508
1650145478,196142,true,3034499439,28,3032072931,-2426508
1650145520,196142,true,3034499439,28,3032072931,-2426508
1650145559,196142,true,3034499439,28,3032072931,-2426508
1650145628,196143,true,3034196019,28,3032376139,-1819880
1650145656,196143,true,3034196019,28,3032376139,-1819880
1650145927,196142,true,3034499439,28,3033892630,-606809
1650146336,196142,true,3034499439,28,3036016992,1517553
1650146382,196143,true,3034196019,28,3036320594,2124575
1650146429,196142,true,3034499439,28,3036927888,2428449
1650146779,196141,true,3034802889,28,3042094798,7291909
1650146821,196140,true,3035106369,28,3042703247,7596878
1650146932,196140,true,3035106369,28,3044833779,9727410
1650146936,196140,true,3035106369,28,3044833779,9727410
1650146967,196138,true,3035713421,28,3045442776,9729355
1650147008,196137,true,3036016992,28,3046356500,10339508
1650147557,196136,true,3036320594,28,3058259892,21939298
1650148851,196136,true,3036320594,28,3075125817,38805223
1650149346,196134,true,3036927888,28,3074818335,37890447
1650149497,196133,true,3037231581,28,3074510884,37279303
1650149560,196132,true,3037535304,28,3074510884,36975580
1650149599,196132,true,3037535304,28,3074203464,36668160
1650149642,196130,true,3038142842,28,3074203464,36060622
1650151157,196130,true,3038142842,28,3069595845,31453003
1650151283,196129,true,3038446656,28,3069288916,30842260
1650152005,196128,true,3038750501,28,3068982018,30231517
1650152208,196127,true,3039054376,28,3068982018,29927642
1650152305,196126,true,3039358281,28,3068982018,29623737
1650153670,196125,true,3039662217,28,3068982018,29319801
1650153793,196125,true,3039662217,28,3068982018,29319801
1650153995,196123,true,3040270180,28,3068982018,28711838
1650154111,196123,true,3040270180,28,3068982018,28711838
1650155014,196122,true,3040574207,28,3068982018,28407811
1650155133,196121,true,3040878264,28,3068675151,27796887
1650155156,196120,true,3041182352,28,3068675151,27492799
1650155221,196119,true,3041486470,28,3068675151,27188681
1650155230,196119,true,3041486470,28,3068675151,27188681
1650155362,196118,true,3041790619,28,3068368314,26577695
1650157228,196117,true,3042094798,28,3064382226,22287428
1650157288,196116,true,3042399008,28,3064382226,21983218
1650158627,196115,true,3042703247,28,3064382226,21678979
1650159619,196115,true,3042703247,28,3064382226,21678979
1650159812,196114,true,3043007518,28,3064382226,21374708
1650160049,196113,true,3043311818,28,3064382226,21070408
1650160677,196112,true,3043616150,28,3064382226,20766076
1650160802,196112,true,3043616150,28,3064382226,20766076
1650160875,196111,true,3043920511,28,3064382226,20461715
1650161092,196110,true,3044224903,28,3064382226,20157323
1650161581,196110,true,3044224903,28,3064382226,20157323
1650162279,196109,true,3044529326,28,3063769441,19240115
1650162468,196108,true,3044833779,28,3063769441,18935662
1650162524,196107,true,3045138262,28,3063769441,18631179
1650162559,196107,true,3045138262,28,3063463095,18324833
1650162581,196106,true,3045442776,28,3063463095,18020319
1650162787,196106,true,3045442776,28,3062238016,16795240
1650162845,196105,true,3045747320,28,3061625660,15878340
1650162849,196105,true,3045747320,28,3061625660,15878340
1650162887,196105,true,3045747320,28,3061319528,15572208
1650162989,196104,true,3046051895,28,3060401316,14349421
1650163427,196105,true,3045747320,28,3055814385,10067065
1650163627,196104,true,3046051895,28,3053370833,7318938
1650163859,196104,true,3046051895,28,3050319141,4267246
1650163871,196104,true,3046051895,28,3050319141,4267246
1650163891,196104,true,3046051895,28,3050014139,3962244
1650163955,196104,true,3046051895,28,3049099318,3047423
1650164061,196104,true,3046051895,28,3047575226,1523331
1650164159,196104,true,3046051895,28,3046051895,0
1650164739,196104,true,3046051895,28,3040574207,-5477688
1650164791,196104,true,3046051895,28,3040270180,-5781715
1650164808,196104,true,3046051895,28,3040270180,-5781715
1650164822,196104,true,3046051895,28,3039966183,-6085712
1650165762,196105,true,3045747320,28,3034802889,-10944431
1650166557,196105,true,3045747320,28,3032376139,-13371181
1650168131,196105,true,3045747320,28,3032072931,-13674389
1650168713,196105,true,3045747320,28,3032072931,-13674389
1650170874,196106,true,3045442776,28,3032072931,-13369845
1650171207,196106,true,3045442776,28,3032072931,-13369845
1650171231,196106,true,3045442776,28,3032072931,-13369845
1650171352,196107,true,3045138262,28,3032072931,-13065331
1650171362,196108,true,3044833779,28,3032072931,-12760848
1650171425,196108,true,3044833779,28,3032072931,-12760848
1650172251,196108,true,3044833779,28,3032072931,-12760848
1650172373,196107,true,3045138262,28,3032376139,-12762123
1650172453,196107,true,3045138262,28,3032376139,-12762123
1650173040,196107,true,3045138262,28,3032376139,-12762123
1650174437,196107,true,3045138262,28,3032376139,-12762123
1650174630,196106,true,3045442776,28,3032679376,-12763400
1650174881,196106,true,3045442776,28,3032982644,-12460132
1650174898,196105,true,3045747320,28,3032982644,-12764676
1650175066,196105,true,3045747320,28,3033285943,-12461377
1650176155,196104,true,3046051895,28,3036016992,-10034903
1650176261,196104,true,3046051895,28,3036320594,-9731301
1650176296,196103,true,3046356500,28,3036320594,-10035906
1650177945,196103,true,3046356500,28,3036624226,-9732274
1650178549,196102,true,3046661136,28,3036624226,-10036910
1650181806,196102,true,3046661136,28,3036624226,-10036910
1650182820,196101,true,3046965802,28,3036624226,-10341576
1650182869,196101,true,3046965802,28,3036927888,-10037914
1650183738,196100,true,3047270499,28,3040878264,-6392235
1650185093,196100,true,3047270499,28,3044833779,-2436720
1650185666,196098,true,3047879983,28,3044833779,-3046204
1650186251,196098,true,3047879983,28,3044833779,-3046204
1650187104,196097,true,3048184771,28,3044833779,-3350992
1650187127,196097,true,3048184771,28,3044833779,-3350992
1650187284,196095,true,3048794439,28,3044833779,-3960660
1650187805,196095,true,3048794439,28,3044833779,-3960660
1650187944,196094,true,3049099318,28,3044833779,-4265539
1650188560,196094,true,3049099318,28,3044833779,-4265539
1650189247,196092,true,3049709168,28,3044833779,-4875389
1650189438,196093,true,3049404228,28,3044833779,-4570449
1650190227,196092,true,3049709168,28,3044833779,-4875389
1650190725,196091,true,3050014139,28,3044833779,-5180360
1650190909,196090,true,3050319141,28,3044833779,-5485362
1650191954,196090,true,3050319141,28,3044833779,-5485362
1650191987,196090,true,3050319141,28,3044833779,-5485362
1650192399,196090,true,3050319141,28,3044833779,-5485362
1650192438,196089,true,3050624173,28,3044833779,-5790394
1650193131,196089,true,3050624173,28,3044833779,-5790394
1650193251,196089,true,3050624173,28,3044833779,-5790394
1650193285,196090,true,3050319141,28,3044833779,-5485362
1650193361,196089,true,3050624173,28,3044833779,-5790394
1650193693,196089,true,3050624173,28,3044833779,-5790394
1650194060,196090,true,3050319141,28,3044833779,-5485362
1650194124,196091,true,3050014139,28,3044833779,-5180360
1650194811,196090,true,3050319141,28,3044833779,-5485362
1650195569,196091,true,3050014139,28,3044833779,-5180360
1650195765,196092,true,3049709168,28,3044833779,-4875389
1650195903,196093,true,3049404228,28,3044833779,-4570449
1650195911,196094,true,3049099318,28,3044833779,-4265539
1650196235,196094,true,3049099318,28,3044833779,-4265539
1650196294,196096,true,3048489590,28,3044833779,-3655811
1650196459,196097,true,3048184771,28,3044833779,-3350992
1650197002,196097,true,3048184771,28,3044833779,-3350992
1650197188,196098,true,3047879983,28,3044833779,-3046204
1650197412,196099,true,3047575226,28,3045442776,-2132450
1650197767,196100,true,3047270499,28,3045747320,-1523179
1650197908,196100,true,3047270499,28,3046051895,-1218604
1650198256,196100,true,3047270499,28,3046661136,-609363
1650198281,196101,true,3046965802,28,3047879983,914181
1650198284,196101,true,3046965802,28,3047879983,914181
1650198652,196101,true,3046965802,28,3050319141,3353339
1650199054,196101,true,3046965802,28,3052760250,5794448
1650199536,196102,true,3046661136,28,3054592364,7931228
1650200695,196103,true,3046356500,28,3055508834,9152334
1650200714,196103,true,3046356500,28,3055508834,9152334
1650201017,196103,true,3046356500,28,3055814385,9457885
1650201716,196104,true,3046051895,28,3056731221,10679326
1650202451,196104,true,3046051895,28,3057954096,11902201
1650202561,196104,true,3046051895,28,3057954096,11902201
1650202677,196104,true,3046051895,28,3057954096,11902201
1650202860,196105,true,3045747320,28,3057648332,11901012
1650202875,196105,true,3045747320,28,3057954096,12206776
1650202960,196105,true,3045747320,28,3057954096,12206776
1650203032,196104,true,3046051895,28,3058259892,12207997
1650203039,196105,true,3045747320,28,3058259892,12512572
1650203061,196105,true,3045747320,28,3058565718,12818398
1650203090,196105,true,3045747320,28,3058565718,12818398
1650203113,196104,true,3046051895,28,3058871574,12819679
1650203120,196104,true,3046051895,28,3058871574,12819679
1650203397,196104,true,3046051895,28,3061013427,14961532
1650203989,196104,true,3046051895,28,3066221315,20169420
1650204000,196103,true,3046356500,28,3066221315,19864815
1650204025,196103,true,3046356500,28,3066527937,20171437
1650204036,196103,true,3046356500,28,3066527937,20171437
1650204468,196103,true,3046356500,28,3068061508,21705008
1650204640,196102,true,3046661136,28,3068982018,22320882
1650206471,196102,true,3046661136,28,3064688664,18027528
1650206666,196102,true,3046661136,28,3064995133,18333997
1650207642,196102,true,3046661136,28,3066221315,19560179
1650209501,196101,true,3046965802,28,3066834590,19868788
1650209628,196100,true,3047270499,28,3067141273,19870774
1650209697,196099,true,3047575226,28,3067141273,19566047
1650209712,196099,true,3047575226,28,3067141273,19566047
1650210436,196098,true,3047879983,28,3069288916,21408933
1650213682,196097,true,3048184771,28,3071745207,23560436
1650214185,196096,true,3048489590,28,3071745207,23255617
1650214606,196095,true,3048794439,28,3071745207,22950768
1650214673,196094,true,3049099318,28,3071745207,22645889
1650214721,196093,true,3049404228,28,3071745207,22340979
1650215018,196092,true,3049709168,28,3071130950,21421782
1650215062,196092,true,3049709168,28,3070823868,21114700
1650215264,196090,true,3050319141,28,3070209795,19890654
1650215620,196089,true,3050624173,28,3068982018,18357845
1650216546,196088,true,3050929235,28,3065608163,14678928
1650217415,196088,true,3050929235,28,3064688664,13759429
1650217472,196086,true,3051539451,28,3064688664,13149213
1650217792,196085,true,3051844605,28,3064688664,12844059
1650218052,196084,true,3052149790,28,3064688664,12538874
1650218234,196084,true,3052149790,28,3064382226,12232436
1650218258,196083,true,3052455005,28,3064382226,11927221
1650218262,196082,true,3052760250,28,3064382226,11621976
1650218423,196081,true,3053065526,28,3063463095,10397569
1650218545,196081,true,3053065526,28,3062850494,9784968
1650218744,196080,true,3053370833,28,3061931823,8560990
1650218763,196079,true,3053676170,28,3061931823,8255653
1650218818,196078,true,3053981538,28,3061319528,7337990
1650218835,196079,true,3053676170,28,3061013427,7337257
1650218883,196078,true,3053981538,28,3060707356,6725818
1650218923,196078,true,3053981538,28,3060095307,6113769
1650218932,196077,true,3054286936,28,3060095307,5808371
1650219012,196078,true,3053981538,28,3058871574,4890036
1650219064,196078,true,3053981538,28,3058259892,4278354
1650219298,196077,true,3054286936,28,3054592364,305428
1650219701,196077,true,3054286936,28,3048184771,-6102165
1650224230,196078,true,3053981538,28,3033285943,-20695595
1650224841,196078,true,3053981538,28,3033285943,-20695595
1650224851,196078,true,3053981538,28,3033589271,-20392267
1650224886,196077,true,3054286936,28,3033589271,-20697665
1650224891,196079,true,3053676170,28,3033589271,-20086899
1650224907,196078,true,3053981538,28,3033589271,-20392267
1650224997,196077,true,3054286936,28,3033892630,-20394306
1650225004,196078,true,3053981538,28,3033892630,-20088908
1650225031,196079,true,3053676170,28,3034196019,-19480151
1650228875,196077,true,3054286936,28,3048184771,-6102165
1650229107,196077,true,3054286936,28,3048184771,-6102165
1650232463,196077,true,3054286936,28,3048184771,-6102165
1650233340,196078,true,3053981538,28,3048184771,-5796767
1650233359,196077,true,3054286936,28,3048489590,-5797346
1650233371,196077,true,3054286936,28,3048489590,-5797346
1650233384,196077,true,3054286936,28,3048489590,-5797346
1650233399,196077,true,3054286936,28,3048489590,-5797346
1650233609,196075,true,3054897824,28,3049709168,-5188656
1650233618,196075,true,3054897824,28,3049709168,-5188656
1650233672,196075,true,3054897824,28,3050014139,-4883685
1650233680,196076,true,3054592364,28,3050319141,-4273223
1650233737,196073,true,3055508834,28,3050929235,-4579599
1650233835,196073,true,3055508834,28,3051844605,-3664229
1650234266,196072,true,3055814385,28,3056731221,916836
1650235199,196073,true,3055508834,28,3068368314,12859480
1650235308,196070,true,3056425578,28,3068982018,12556440
1650235507,196070,true,3056425578,28,3069902805,13477227
1650235631,196069,true,3056731221,28,3069595845,12864624
1650235673,196070,true,3056425578,28,3069595845,13170267
1650235692,196068,true,3057036894,28,3069288916,12252022
1650235732,196068,true,3057036894,28,3069288916,12252022
1650235755,196068,true,3057036894,28,3068982018,11945124
1650236549,196070,true,3056425578,28,3059177462,2751884
1650236622,196067,true,3057342597,28,3058259892,917295
1650236627,196067,true,3057342597,28,3058259892,917295
1650236673,196067,true,3057342597,28,3057342597,0
1650236770,196070,true,3056425578,28,3055814385,-611193
1650236818,196068,true,3057036894,28,3054897824,-2139070
1650236827,196068,true,3057036894,28,3054897824,-2139070
1650237012,196068,true,3057036894,28,3051539451,-5497443
1650237277,196071,true,3056119966,28,3046661136,-9458830
1650237386,196069,true,3056731221,28,3044833779,-11897442
1650237659,196069,true,3056731221,28,3041790619,-14940602
1650237747,196069,true,3056731221,28,3041182352,-15548869
1650237774,196072,true,3055814385,28,3040878264,-14936121
1650237788,196070,true,3056425578,28,3040574207,-15851371
1650237798,196071,true,3056119966,28,3040574207,-15545759
1650237975,196073,true,3055508834,28,3037839058,-17669776
1650237987,196076,true,3054592364,28,3037535304,-17057060
1650238025,196075,true,3054897824,28,3036624226,-18273598
1650238082,196076,true,3054592364,28,3035409880,-19182484
1650238104,196079,true,3053676170,28,3034802889,-18873281
1650238144,196082,true,3052760250,28,3033892630,-18867620
1650238324,196081,true,3053065526,28,3029345430,-23720096
1650238692,196082,true,3052760250,28,3020573492,-32186758
1650238859,196085,true,3051844605,28,3016951159,-34893446
1650238882,196089,true,3050624173,28,3016649494,-33974679
1650238909,196088,true,3050929235,28,3016046254,-34882981
1650239215,196089,true,3050624173,28,3009117665,-41506508
1650239462,196093,true,3049404228,28,3003406055,-45998173
1650240170,196097,true,3048184771,28,2994409788,-53774983
1650240399,196096,true,3048489590,28,2993212323,-55277267
1650240538,196098,true,3047879983,28,2992314539,-55565444
1650240625,196102,true,3046661136,28,2992015338,-54645798
1650242382,196106,true,3045442776,28,2988128439,-57314337
1650242411,196106,true,3045442776,28,2987829656,-57613120
1650242418,196107,true,3045138262,28,2987829656,-57308606
1650243212,196112,true,3043616150,28,2984843469,-58772681
1650243301,196117,true,3042094798,28,2984545015,-57549783
1650243310,196117,true,3042094798,28,2984545015,-57549783
1650243970,196118,true,3041790619,28,2983351495,-58439124
1650244142,196122,true,3040574207,28,2983351495,-57222712
1650244183,196126,true,3039358281,28,2983351495,-56006786
1650246003,196126,true,3039358281,28,2989921765,-49436516
1650249272,196127,true,3039054376,28,2989921765,-49132611
1650251296,196131,true,3037839058,28,2989921765,-47917293
1650251367,196135,true,3036624226,28,2990220757,-46403469
1650251972,196135,true,3036624226,28,2991417024,-45207202
1650252163,196136,true,3036320594,28,2992015338,-44305256
1650252264,196140,true,3035106369,28,2992015338,-43091031
1650253957,196144,true,3033892630,28,2993810996,-40081634
1650254438,196144,true,3033892630,28,2993810996,-40081634
1650255173,196145,true,3033589271,28,2994110377,-39478894
1650255178,196149,true,3032376139,28,2994110377,-38265762
1650255192,196153,true,3031163491,28,2994110377,-37053114
1650255251,196153,true,3031163491,28,2993810996,-37352495
1650255255,196155,true,3030557350,28,2993810996,-36746354
1650255269,196158,true,3029648364,28,2993810996,-35837368
1650255278,196162,true,3028436808,28,2993810996,-34625812
1650255283,196163,true,3028133994,28,2993810996,-34322998
1650255291,196165,true,3027528458,28,2993511645,-34016813
1650255503,196170,true,3026015148,28,2990818831,-35196317
1650255511,196174,true,3024805045,28,2990519779,-34285266
1650255519,196174,true,3024805045,28,2990519779,-34285266
1650255536,196176,true,3024200174,28,2990220757,-33979417
1650255546,196181,true,3022688528,28,2989921765,-32766763
1650255652,196187,true,3020875549,28,2987232180,-33643369
1650255674,196188,true,3020573492,28,2986634823,-33938669
1650255714,196191,true,3019667501,28,2984843469,-34824032
1650255761,196196,true,3018158120,28,2983053190,-35104930
1650255791,196203,true,3016046254,28,2981860267,-34185987
1650256164,196204,true,3015744680,28,2966988918,-48755762
1650256518,196207,true,3014840137,28,2952782205,-62057932
1650256649,196212,true,3013333170,28,2947177525,-66155645
1650256678,196218,true,3011525802,28,2945998949,-65526853
1650256756,196219,true,3011224680,28,2942760294,-68464386
1650257083,196222,true,3010321493,28,2928962461,-81359032
1650257417,196227,true,3008816784,28,2920481197,-88335587
1650257532,196233,true,3007012125,28,2919313297,-87698828
1650258336,196234,true,3006711454,28,2916978897,-89732557
1650259107,196237,true,3005809621,28,2914937828,-90871793
1650259135,196242,true,3004307167,28,2914937828,-89369339
1650259372,196248,true,3002505214,28,2914646363,-87858851
1650259705,196248,true,3002505214,28,2914354928,-88150286
1650259799,196251,true,3001604642,28,2914063521,-87541121
1650259837,196256,true,3000104290,28,2914063521,-86040769
1650261527,196262,true,2998304857,28,2917854078,-80450779
1650262718,196262,true,2998304857,28,2917854078,-80450779
1650262983,196266,true,2997105835,28,2917270595,-79835240
1650263952,196271,true,2995607732,28,2914354928,-81252804
1650264007,196277,true,2993810996,28,2914354928,-79456068
1650265787,196278,true,2993511645,28,2917562322,-75949323
1650265839,196282,true,2992314539,28,2917562322,-74752217
1650266205,196287,true,2990818831,28,2917562322,-73256509
1650266334,196293,true,2989024967,28,2917562322,-71462645
1650266999,196294,true,2988726095,28,2917562322,-71163773
1650267072,196297,true,2987829656,28,2917562322,-70267334
1650267188,196302,true,2986336189,28,2917270595,-69065594
1650267406,196309,true,2984246590,28,2916687228,-67559362
1650267695,196311,true,2983649830,28,2916103978,-67545852
1650267706,196315,true,2982456669,28,2916103978,-66352691
1650267934,196320,true,2980965888,28,2915812397,-65153491
1650268124,196326,true,2979177934,28,2915229322,-63948612
1650268137,196329,true,2978284359,28,2915229322,-63055037
1650268147,196333,true,2977093343,28,2914937828,-62155515
1650268326,196339,true,2975307712,28,2912898187,-62409525
1650268433,196347,true,2972928537,28,2911442175,-61486362
1650268456,196350,true,2972036837,28,2911151060,-60885777
1650268487,196354,true,2970848319,28,2910568917,-60279402
1650268513,196361,true,2968769557,28,2910277889,-58491668
1650268553,196369,true,2966395610,28,2909695921,-56699689
1650268953,196371,true,2965802419,28,2903882635,-61919784
1650268981,196374,true,2964912857,28,2903592276,-61320581
1650269883,196381,true,2962838248,28,2894316094,-68522154
1650270151,196387,true,2961061167,28,2894026692,-67034475
1650270319,196390,true,2960173026,28,2894316094,-65856932
1650270376,196393,true,2959285152,28,2894605526,-64679626
1650270437,196399,true,2957510202,28,2894894986,-62615216
1650270473,196405,true,2955736317,28,2895184476,-60551841
1650270670,196407,true,2955145258,28,2896342723,-58802535
1650270801,196410,true,2954258892,28,2896922021,-57336871
1650271008,196415,true,2952782205,28,2897501434,-55280771
1650271245,196421,true,2951011156,28,2898080964,-52930192
1650271715,196423,true,2950421042,28,2899530294,-50890748
1650272570,196426,true,2949536093,28,2900690280,-48845813
1650272600,196432,true,2947766990,28,2900690280,-47076710
1650274431,196437,true,2946293549,28,2898660609,-47632940
1650275073,196439,true,2945704379,28,2898660609,-47043770
1650275304,196442,true,2944820844,28,2898660609,-46160235
1650275583,196446,true,2943643210,28,2898660609,-44982601
1650275655,196452,true,2941877642,28,2898660609,-43217033
1650275680,196454,true,2941289355,28,2898660609,-42628746
1650275885,196456,true,2940701185,28,2898660609,-42040576
1650276297,196460,true,2939525199,28,2898660609,-40864590
1650276346,196465,true,2938055877,28,2898950475,-39105402
1650276361,196466,true,2937762101,28,2898950475,-38811626
1650276430,196468,true,2937174636,28,2898950475,-38224161
1650276462,196472,true,2936000060,28,2898950475,-37049585
1650276499,196477,true,2934532501,28,2899240370,-35292131
1650277355,196477,true,2934532501,28,2903882635,-30649866
1650277548,196479,true,2933945682,28,2904753887,-29191795
1650277635,196482,true,2933065674,28,2905334867,-27730807
1650277737,196487,true,2931599581,28,2906206555,-25393026
1650277887,196487,true,2931599581,28,2907078504,-24521077
1650277907,196489,true,2931013349,28,2907369212,-23644137
1650278160,196491,true,2930427235,28,2909404981,-21022254
1650279009,196496,true,2928962461,28,2912606927,-16355534
1650279245,196496,true,2928962461,28,2913480796,-15481665
1650279493,196498,true,2928376756,28,2914063521,-14313235
1650280746,196500,true,2927791168,28,2914354928,-13436240
1650282774,196504,true,2926620345,28,2914354928,-12265417
1650284253,196504,true,2926620345,28,2914354928,-12265417
1650284290,196506,true,2926035108,28,2914646363,-11388745
1650284325,196508,true,2925449989,28,2914937828,-10512161
1650284403,196512,true,2924280102,28,2915520845,-8759257
1650284471,196512,true,2924280102,28,2916103978,-8176124
1650284595,196513,true,2923987703,28,2917854078,-6133625
1650284880,196515,true,2923402993,28,2921357429,-2045564
1650285319,196519,true,2922233924,28,2926913007,4679083
1650285407,196518,true,2922526147,28,2928083947,5557800
1650285502,196519,true,2922233924,28,2929548282,7314358
1650285575,196522,true,2921357429,28,2930720277,9362848
1650286708,196525,true,2920481197,28,2940113133,19631936
1650286960,196524,true,2920773245,28,2940701185,19927940
1650287578,196526,true,2920189178,28,2940701185,20512007
1650288416,196528,true,2919605228,28,2940701185,21095957
1650288598,196532,true,2918437678,28,2940701185,22263507
1650288619,196531,true,2918729522,28,2940701185,21971663
1650288703,196531,true,2918729522,28,2940995255,22265733
1650288880,196534,true,2917854078,28,2941289355,23435277
1650289166,196537,true,2916978897,28,2941877642,24898745
1650289179,196536,true,2917270595,28,2941877642,24607047
1650289806,196536,true,2917270595,28,2940113133,22842538
1650290038,196538,true,2916687228,28,2939525199,22837971
1650290070,196541,true,2915812397,28,2939525199,23712802
1650290433,196540,true,2916103978,28,2936587290,20483312
1650290815,196541,true,2915812397,28,2933065674,17253277
1650291134,196542,true,2915520845,28,2931599581,16078736
1650291229,196544,true,2914937828,28,2931306451,16368623
1650291241,196542,true,2915520845,28,2931306451,15785606
1650291895,196542,true,2915520845,28,2930720277,15199432
1650291932,196542,true,2915520845,28,2931013349,15492504
1650292736,196543,true,2915229322,28,2934239077,19009755
1650292737,196541,true,2915812397,28,2934239077,18426680
1650293450,196541,true,2915812397,28,2933945682,18133285
1650293907,196541,true,2915812397,28,2933358981,17546584
1650295061,196541,true,2915812397,28,2932185931,16373534
1650295077,196539,true,2916395588,28,2932185931,15790343
1650295267,196539,true,2916395588,28,2931892741,15497153
1650295400,196539,true,2916395588,28,2931599581,15203993
1650295429,196540,true,2916103978,28,2931599581,15495603
1650295455,196538,true,2916687228,28,2931306451,14619223
1650295522,196538,true,2916687228,28,2931013349,14326121
1650295674,196538,true,2916687228,28,2930134221,13446993
1650295694,196539,true,2916395588,28,2930134221,13738633
1650296178,196537,true,2916978897,28,2926620345,9641448
1650296238,196537,true,2916978897,28,2926035108,9056211
1650296380,196537,true,2916978897,28,2925157473,8178576
1650296431,196539,true,2916395588,28,2924572530,8176942
1650296492,196537,true,2916978897,28,2923987703,7008806
1650296612,196537,true,2916978897,28,2922526147,5547250
1650298245,196538,true,2916687228,28,2910859974,-5827254
1650298320,196539,true,2916395588,28,2910568917,-5826671
1650298321,196538,true,2916687228,28,2910568917,-6118311
1650298326,196538,true,2916687228,28,2910568917,-6118311
1650298330,196539,true,2916395588,28,2910568917,-5826671
1650298388,196541,true,2915812397,28,2910568917,-5243480
1650299277,196539,true,2916395588,28,2907369212,-9026376
1650299419,196539,true,2916395588,28,2907078504,-9317084
1650299494,196540,true,2916103978,28,2907078504,-9025474
1650299721,196542,true,2915520845,28,2906787825,-8733020
1650299748,196540,true,2916103978,28,2906787825,-9316153
1650299787,196540,true,2916103978,28,2906787825,-9316153
1650300197,196541,true,2915812397,28,2908532334,-7280063
1650300337,196542,true,2915520845,28,2909404981,-6115864
1650300371,196540,true,2916103978,28,2909695921,-6408057
1650300416,196539,true,2916395588,28,2910277889,-6117699
1650300618,196538,true,2916687228,28,2913480796,-3206432
1650301098,196537,true,2916978897,28,2921357429,4378532
1650301278,196535,true,2917562322,28,2923987703,6425381
1650301738,196535,true,2917562322,28,2929548282,11985960
1650301837,196533,true,2918145863,28,2930427235,12281372
1650301862,196532,true,2918437678,28,2930720277,12282599
1650301866,196529,true,2919313297,28,2931013349,11700052
1650302297,196527,true,2919897189,28,2939819151,19921962
1650302366,196525,true,2920481197,28,2940701185,20219988
1650302436,196524,true,2920773245,28,2941877642,21104397
1650302565,196522,true,2921357429,28,2943643210,22285781
1650302753,196519,true,2922233924,28,2945998949,23765025
1650303135,196518,true,2922526147,28,2950126030,27599883
1650303146,196517,true,2922818400,28,2950126030,27307630
1650303329,196515,true,2923402993,28,2952486957,29083964
1650303376,196513,true,2923987703,28,2953372791,29385088
1650303392,196511,true,2924572530,28,2953668128,29095598
1650303414,196510,true,2924864987,28,2953963495,29098508
1650304021,196507,true,2925742534,28,2958989253,33246719
1650304061,196505,true,2926327712,28,2959285152,32957440
1650304599,196503,true,2926913007,28,2962245769,35332762
1650304604,196502,true,2927205698,28,2962245769,35040071
1650304614,196499,true,2928083947,28,2962541993,34458046
1650304684,196496,true,2928962461,28,2963430845,34468384
1650304889,196493,true,2929841237,28,2966988918,37147681
1650304916,196492,true,2930134221,28,2967582346,37448125
1650305732,196489,true,2931013349,28,2978582188,47568839
1650305781,196486,true,2931892741,28,2979475852,47583111
1650305994,196482,true,2933065674,28,2984246590,51180916
1650306218,196480,true,2933652317,28,2989323870,55671553
1650306294,196476,true,2934825954,28,2991117913,56291959
1650306311,196473,true,2935706490,28,2991417024,55710534
1650306327,196468,true,2937174636,28,2991716166,54541530
1650306387,196467,true,2937468354,28,2993511645,56043291
1650306455,196463,true,2938643518,28,2994709229,56065711
1650307014,196460,true,2939525199,28,3004307167,64781968
1650307854,196456,true,2940701185,28,3014538684,73837499
1650308961,196454,true,2941289355,28,3015141622,73852267
1650309125,196450,true,2942466047,28,3014840137,72374090
1650309189,196447,true,2943348875,28,3014840137,71491262
1650309272,196443,true,2944526391,28,3014538684,70012293
1650309329,196442,true,2944820844,28,3014237260,69416416
1650309427,196439,true,2945704379,28,3013634503,67930124
1650310432,196436,true,2946588178,28,3009117665,62529487
1650310469,196432,true,2947766990,28,3008816784,61049794
1650310675,196431,true,2948061767,28,3007613558,59551791
1650310822,196428,true,2948946274,28,3006410813,57464539
1650311390,196426,true,2949536093,28,3003706396,54170303
1650311994,196422,true,2950716084,28,3001004411,50288327
1650312005,196421,true,2951011156,28,3001004411,49993255
1650312057,196419,true,2951601388,28,3000704341,49102953
1650312253,196418,true,2951896548,28,3000104290,48207742
1650312402,196414,true,2953077483,28,3000104290,47026807
1650312457,196413,true,2953372791,28,3000104290,46731499
1650312465,196411,true,2953963495,28,3000104290,46140795
1650312844,196409,true,2954554318,28,3002805464,48251146
1650312861,196405,true,2955736317,28,3003105745,47369428
1650313763,196405,true,2955736317,28,3009418577,53682260
1650314119,196403,true,2956327493,28,3011224680,54897187
1650314652,196401,true,2956918788,28,3011525802,54607014
1650314661,196397,true,2958101733,28,3011525802,53424069
1650316725,196396,true,2958397544,28,3014237260,55839716
1650316830,196394,true,2958989253,28,3014840137,55850884
1650316847,196392,true,2959581080,28,3014840137,55259057
1650316855,196388,true,2960765090,28,3015141622,54376532
1650316950,196386,true,2961357273,28,3016046254,54688981
1650316979,196383,true,2962245769,28,3016347859,54102090
1650317004,196381,true,2962838248,28,3016649494,53811246
1650317447,196376,true,2964319963,28,3022386289,58066326
1650317493,196374,true,2964912857,28,3022990797,58077940
1650317588,196371,true,2965802419,28,3024200174,58397755
1650317657,196368,true,2966692249,28,3024805045,58112796
1650317666,196363,true,2968175892,28,3025107525,56931633
1650317686,196361,true,2968769557,28,3025410036,56640479
1650317861,196357,true,2969957243,28,3028133994,58176751
1650318586,196354,true,2970848319,28,3039662217,68813898
1650319240,196350,true,2972036837,28,3042703247,70666410
1650320240,196348,true,2972631274,28,3043311818,70680544
1650321173,196344,true,2973820505,28,3043311818,69491313
1650322012,196341,true,2974712740,28,3042703247,67990507
1650322289,196337,true,2975902804,28,3042399008,66496204
1650322313,196335,true,2976498014,28,3042399008,65900994
1650322394,196331,true,2977688792,28,3042703247,65014455
1650322453,196328,true,2978582188,28,3043007518,64425330
1650322858,196322,true,2980369784,28,3046356500,65986716
1650323436,196319,true,2981263984,28,3052149790,70885806
1650324585,196315,true,2982456669,28,3060095307,77638638
1650325280,196312,true,2983351495,28,3060095307,76743812
1650326909,196306,true,2985141954,28,3060095307,74953353
1650326926,196303,true,2986037586,28,3060401316,74363730
1650327062,196299,true,2987232180,28,3060707356,73475176
1650327198,196295,true,2988427252,28,3061013427,72586175
1650327254,196288,true,2990519779,28,3061625660,71105881
1650329001,196284,true,2991716166,28,3077279051,85562885
1650329183,196280,true,2992913032,28,3077279051,84366019
1650329220,196276,true,2994110377,28,3077279051,83168674
1650329281,196268,true,2996506504,28,3077279051,80772547
1650329351,196264,true,2997705286,28,3076971354,79266068
1650329361,196260,true,2998904548,28,3076971354,78066806
1650329379,196256,true,3000104290,28,3076971354,76867064
1650329499,196249,true,3002204993,28,3076356052,74151059
1650329517,196245,true,3003406055,28,3076356052,72949997
1650331189,196241,true,3004607598,28,3068061508,63453910
1650332202,196237,true,3005809621,28,3067754732,61945111
1650332305,196230,true,3007914319,28,3067754732,59840413
1650332436,196226,true,3009117665,28,3067754732,58637067
1650332701,196221,true,3010622525,28,3067754732,57132207
1650332730,196218,true,3011525802,28,3067754732,56228930
1650333205,196211,true,3013634503,28,3067754732,54120229
1650333208,196208,true,3014538684,28,3067754732,53216048
1650333343,196203,true,3016046254,28,3067754732,51708478
1650333457,196200,true,3016951159,28,3067447987,50496828
1650333476,196195,true,3018459936,28,3067447987,48988051
1650334180,196192,true,3019365565,28,3065301632,45936067
1650334184,196188,true,3020573492,28,3065301632,44728140
1650334665,196185,true,3021479755,28,3062544240,41064485
1650335064,196180,true,3022990797,28,3060095307,37104510
1650335449,196177,true,3023897785,28,3058259892,34362107
1650335801,196173,true,3025107525,28,3057036894,31929369
1650335964,196173,true,3025107525,28,3056425578,31318053
1650335965,196168,true,3026620382,28,3056425578,29805196
1650336016,196166,true,3027225736,28,3056425578,29199842
1650336127,196162,true,3028436808,28,3056425578,27988770
1650336164,196161,true,3028739652,28,3056119966,27380314
1650336270,196156,true,3030254324,28,3056119966,25865642
1650336276,196154,true,3030860405,28,3055814385,24953980
1650336548,196150,true,3032072931,28,3054897824,22824893
1650337325,196150,true,3032072931,28,3051234328,19161397
1650339214,196146,true,3033285943,28,3046965802,13679859
1650339386,196143,true,3034196019,28,3046965802,12769783
1650339603,196141,true,3034802889,28,3046965802,12162913
1650340135,196140,true,3035106369,28,3046356500,11250131
1650342711,196136,true,3036320594,28,3044833779,8513185
1650344706,196134,true,3036927888,28,3045138262,8210374
1650345675,196131,true,3037839058,28,3045138262,7299204
1650346781,196131,true,3037839058,28,3045138262,7299204
1650349153,196129,true,3038446656,28,3045747320,7300664
1650349179,196127,true,3039054376,28,3045747320,6692944
1650349463,196124,true,3039966183,28,3045747320,5781137
1650350066,196124,true,3039966183,28,3045442776,5476593
1650350570,196122,true,3040574207,28,3045442776,4868569
1650351458,196121,true,3040878264,28,3045138262,4259998
1650351544,196120,true,3041182352,28,3045138262,3955910
1650351788,196120,true,3041182352,28,3045138262,3955910
1650352143,196118,true,3041790619,28,3045138262,3347643
1650352632,196117,true,3042094798,28,3045442776,3347978
1650354529,196116,true,3042399008,28,3041182352,-1216656
1650355395,196116,true,3042399008,28,3041182352,-1216656
1650361927,196115,true,3042703247,28,3041182352,-1520895
1650362178,196114,true,3043007518,28,3041182352,-1825166
1650362376,196113,true,3043311818,28,3041182352,-2129466
1650364126,196113,true,3043311818,28,3040270180,-3041638
1650364323,196112,true,3043616150,28,3040574207,-3041943
1650364398,196110,true,3044224903,28,3040878264,-3346639
1650364670,196109,true,3044529326,28,3041182352,-3346974
1650364740,196109,true,3044529326,28,3041486470,-3042856
1650365218,196108,true,3044833779,28,3042703247,-2130532
1650365304,196105,true,3045747320,28,3042703247,-3044073
1650365873,196105,true,3045747320,28,3044224903,-1522417
1650366217,196104,true,3046051895,28,3045138262,-913633
1650366490,196102,true,3046661136,28,3045747320,-913816
1650367222,196100,true,3047270499,28,3047270499,0
1650367242,196099,true,3047575226,28,3047270499,-304727
1650368285,196098,true,3047879983,28,3049404228,1524245
1650369053,196096,true,3048489590,28,3050014139,1524549
1650369130,196094,true,3049099318,28,3050319141,1219823
1650369520,196093,true,3049404228,28,3050929235,1525007
1650369534,196093,true,3049404228,28,3050929235,1525007
1650370329,196092,true,3049709168,28,3050624173,915005
1650371631,196089,true,3050624173,28,3051844605,1220432
1650371635,196089,true,3050624173,28,3051844605,1220432
1650371648,196088,true,3050929235,28,3052149790,1220555
1650371655,196087,true,3051234328,28,3052149790,915462
1650371696,196085,true,3051844605,28,3052149790,305185
1650371736,196084,true,3052149790,28,3052455005,305215
1650371764,196084,true,3052149790,28,3052455005,305215
1650371801,196082,true,3052760250,28,3052455005,-305245
1650372133,196081,true,3053065526,28,3054592364,1526838
1650372139,196081,true,3053065526,28,3054592364,1526838
1650373851,196080,true,3053370833,28,3062544240,9173407
1650375143,196079,true,3053676170,28,3062238016,8561846
1650375790,196078,true,3053981538,28,3060401316,6419778
1650375803,196078,true,3053981538,28,3060401316,6419778
1650375837,196077,true,3054286936,28,3060401316,6114380
1650375927,196077,true,3054286936,28,3060707356,6420420
1650376063,196074,true,3055203313,28,3061625660,6422347
1650376093,196074,true,3055203313,28,3061931823,6728510
1650376099,196074,true,3055203313,28,3061931823,6728510
1650376229,196073,true,3055508834,28,3062850494,7341660
1650376322,196070,true,3056425578,28,3063769441,7343863
1650376349,196071,true,3056119966,28,3064075818,7955852
1650376400,196070,true,3056425578,28,3064382226,7956648
1650376449,196069,true,3056731221,28,3064995133,8263912
1650376643,196065,true,3057954096,28,3068368314,10414218
1650376787,196065,true,3057954096,28,3070516816,12562720
1650376866,196065,true,3057954096,28,3072052382,14098286
1650376868,196064,true,3058259892,28,3072052382,13792490
1650376878,196061,true,3059177462,28,3072359587,13182125
1650376900,196061,true,3059177462,28,3072666823,13489361
1650376968,196060,true,3059483379,28,3074203464,14720085
1650377063,196059,true,3059789328,28,3076971354,17182026
1650377103,196056,true,3060707356,28,3077894537,17187181
1650377114,196056,true,3060707356,28,3078202327,17494971
1650377129,196055,true,3061013427,28,3078817998,17804571
1650377228,196054,true,3061319528,28,3081590043,20270515
1650380314,196051,true,3062238016,28,3116296107,54058091
1650380623,196051,true,3062238016,28,3116607737,54369721
1650380894,196050,true,3062544240,28,3116607737,54063497
1650380925,196050,true,3062544240,28,3116607737,54063497
1650381442,196046,true,3063769441,28,3118166352,54396911
1650381482,196046,true,3063769441,28,3118166352,54396911
1650381643,196045,true,3064075818,28,3118478169,54402351
1650383879,196044,true,3064382226,28,3121285922,56903696
1650384794,196040,true,3065608163,28,3119725747,54117584
1650386193,196040,true,3065608163,28,3118166352,52558189
1650386276,196039,true,3065914723,28,3118166352,52251629
1650386356,196038,true,3066221315,28,3118166352,51945037
1650386386,196034,true,3067447987,28,3117854567,50406580
1650386460,196035,true,3067141273,28,3117854567,50713294
1650386476,196033,true,3067754732,28,3117542813,49788081
1650386500,196033,true,3067754732,28,3117542813,49788081
1650386514,196029,true,3068982018,28,3117542813,48560795
1650386594,196030,true,3068675151,28,3116919398,48244247
1650388116,196029,true,3068982018,28,3106961694,37979676
1650388172,196029,true,3068982018,28,3106961694,37979676
1650388201,196024,true,3070516816,28,3106651029,36134213
1650388351,196025,true,3070209795,28,3106340395,36130600
1650388419,196024,true,3070516816,28,3106029792,35512976
1650389200,196024,true,3070516816,28,3103546086,33029270
1650389871,196020,true,3071745207,28,3097345507,25600300
1650390070,196020,true,3071745207,28,3095487750,23742543
1650390427,196019,true,3072052382,28,3093321775,21269393
1650392986,196020,true,3071745207,28,3089612200,17866993
1650393068,196016,true,3072974090,28,3089921161,16947071
1650395023,196016,true,3072974090,28,3093940470,20966380
1650395321,196015,true,3073281387,28,3093940470,20659083
1650395489,196015,true,3073281387,28,3093940470,20659083
1650395549,196011,true,3074510884,28,3094249864,19738980
1650395584,196011,true,3074510884,28,3094249864,19738980
1650395795,196009,true,3075125817,28,3095487750,20361933
1650395847,196009,true,3075125817,28,3095797298,20671481
1650396222,196005,true,3076356052,28,3098274803,21918751
1650396238,196004,true,3076663687,28,3098274803,21611116
1650396252,196002,true,3077279051,28,3098274803,20995752
1650396361,196002,true,3077279051,28,3099204379,21925328
1650396820,195997,true,3078817998,28,3103235763,24417765
1650398753,195997,true,3078817998,28,3110070054,31252056
1650398843,195995,true,3079433792,28,3110070054,30636262
1650398898,195994,true,3079741736,28,3109759079,30017343
1650399040,195990,true,3080973817,28,3109448134,28474317
1650399061,195990,true,3080973817,28,3109448134,28474317
1650399222,195988,true,3081590043,28,3108515486,26925443
1650399229,195987,true,3081898202,28,3108515486,26617284
1650399276,195983,true,3083131146,28,3108204665,25073519
1650400321,195984,true,3082822864,28,3102615208,19792344
1650400720,195982,true,3083439459,28,3100754291,17314832
1650400987,195981,true,3083747803,28,3099514299,15766496
1650401044,195977,true,3084981487,28,3099514299,14532812
1650404301,195977,true,3084981487,28,3096416489,11435002
1650406445,195975,true,3085598514,28,3097035803,11437289
1650407596,195975,true,3085598514,28,3097035803,11437289
1650407696,195970,true,3087141622,28,3097345507,10203885
1650407806,195971,true,3086832939,28,3097655241,10822302
1650408061,195969,true,3087450336,28,3098274803,10824467
1650408530,195968,true,3087759081,28,3099514299,11755218
1650412161,195963,true,3089303270,28,3101994778,12691508
1650414124,195964,true,3088994370,28,3101994778,13000408
1650414158,195962,true,3089612200,28,3101994778,12382578
1650414208,195961,true,3089921161,28,3101994778,12073617
1650414220,195957,true,3091157315,28,3101994778,10837463
1650414306,195958,true,3090848230,28,3101684610,10836380
1650414351,195956,true,3091466431,28,3101064366,9597935
1650414400,195956,true,3091466431,28,3100444246,8977815
1650414414,195952,true,3092703203,28,3100444246,7741043
1650414491,195954,true,3092084755,28,3099514299,7429544
1650414564,195953,true,3092393964,28,3098584631,6190667
1650414570,195952,true,3092703203,28,3098584631,5881428
1650417140,195949,true,3093631107,28,3078202327,-15428780
1650417905,195951,true,3093012473,28,3077586779,-15425694
1650418656,195950,true,3093321775,28,3077279051,-16042724
1650418897,195949,true,3093631107,28,3076971354,-16659753
1650419272,195946,true,3094559289,28,3076971354,-17587935
1650419468,195948,true,3093940470,28,3077279051,-16661419
1650419585,195947,true,3094249864,28,3077586779,-16663085
1650419614,195946,true,3094559289,28,3077586779,-16972510
1650420077,195942,true,3095797298,28,3079433792,-16363506
1650420788,195944,true,3095178232,28,3081898202,-13280030
1650421115,195943,true,3095487750,28,3083439459,-12048291
1650421649,195943,true,3095487750,28,3084056178,-11431572
1650422770,195939,true,3096726130,28,3084364584,-12361546
1650423016,195941,true,3096106878,28,3084364584,-11742294
1650424363,195941,true,3096106878,28,3084364584,-11742294
1650424601,195940,true,3096416489,28,3084364584,-12051905
1650424622,195937,true,3097345507,28,3084364584,-12980923
1650426438,195939,true,3096726130,28,3084364584,-12361546
1650426921,195938,true,3097035803,28,3084364584,-12671219
1650426974,195938,true,3097035803,28,3084673020,-12362783
1650427312,195935,true,3097965007,28,3084364584,-13600423
1650427535,195937,true,3097345507,28,3084364584,-12980923
1650429245,195937,true,3097345507,28,3084673020,-12672487
1650430766,195936,true,3097655241,28,3084673020,-12982221
1650432451,195934,true,3098274803,28,3084673020,-13601783
1650433445,195936,true,3097655241,28,3084673020,-12982221
1650433516,195936,true,3097655241,28,3084981487,-12673754
1650433661,195936,true,3097655241,28,3084981487,-12673754
1650433699,195935,true,3097965007,28,3084981487,-12983520
1650433818,195937,true,3097345507,28,3085289985,-12055522
1650433937,195936,true,3097655241,28,3085289985,-12365256
1650433968,195936,true,3097655241,28,3085598514,-12056727
1650434106,195935,true,3097965007,28,3085907074,-12057933
1650434485,195937,true,3097345507,28,3087450336,-9895171
1650434794,195937,true,3097345507,28,3088685502,-8660005
1650434842,195938,true,3097035803,28,3088994370,-8041433
1650434874,195936,true,3097655241,28,3088994370,-8660871
1650435012,195939,true,3096726130,28,3090230154,-6495976
1650435378,195938,true,3097035803,28,3093012473,-4023330
1650436343,195939,true,3096726130,28,3097965007,1238877
1650438494,195938,true,3097035803,28,3098894489,1858686
1650438520,195941,true,3096106878,28,3099204379,3097501
1650439102,195940,true,3096416489,28,3101374473,4957984
1650439178,195941,true,3096106878,28,3101684610,5577732
1650439548,195940,true,3096416489,28,3102925470,6508981
1650439649,195942,true,3095797298,28,3103235763,7438465
1650439820,195942,true,3095797298,28,3103235763,7438465
1650440674,195943,true,3095487750,28,3103235763,7748013
1650440763,195942,true,3095797298,28,3102925470,7128172
1650440807,195944,true,3095178232,28,3102615208,7436976
1650441237,195944,true,3095178232,28,3101374473,6196241
1650441367,195945,true,3094868745,28,3100754291,5885546
1650442156,195944,true,3095178232,28,3098584631,3406399
1650442481,195946,true,3094559289,28,3097655241,3095952
1650442533,195946,true,3094559289,28,3097655241,3095952
1650443152,195947,true,3094249864,28,3096726130,2476266
1650443589,195946,true,3094559289,28,3097035803,2476514
1650445686,195947,true,3094249864,28,3097035803,2785939
1650446495,195947,true,3094249864,28,3097035803,2785939
1650446546,195948,true,3093940470,28,3097345507,3405037
1650447520,195947,true,3094249864,28,3101994778,7744914
1650447585,195948,true,3093940470,28,3102304978,8364508
1650448128,195947,true,3094249864,28,3105408679,11158815
1650448676,195947,true,3094249864,28,3106651029,12401165
1650449096,195946,true,3094559289,28,3106961694,12402405
1650449991,195947,true,3094249864,28,3106961694,12711830
1650450223,195945,true,3094868745,28,3106961694,12092949
1650450295,195945,true,3094868745,28,3106961694,12092949
1650450342,195944,true,3095178232,28,3106961694,11783462
1650450399,195945,true,3094868745,28,3107272390,12403645
1650450452,195943,true,3095487750,28,3107272390,11784640
1650450853,195943,true,3095487750,28,3108204665,12716915
1650451302,195942,true,3095797298,28,3109137220,13339922
1650451329,195943,true,3095487750,28,3109137220,13649470
1650451379,195942,true,3095797298,28,3109759079,13961781
1650452408,195941,true,3096106878,28,3120037720,23930842
1650453034,195939,true,3096726130,28,3125033526,28307396
1650453805,195941,true,3096106878,28,3125658564,29551686
1650454871,195940,true,3096416489,28,3125346030,28929541
1650455086,195939,true,3096726130,28,3125346030,28619900
1650455155,195937,true,3097345507,28,3125346030,28000523
1650455200,195939,true,3096726130,28,3125346030,28619900
1650455368,195938,true,3097035803,28,3125658564,28622761
1650455407,195937,true,3097345507,28,3125971130,28625623
1650455418,195935,true,3097965007,28,3125971130,28006123
1650455429,195936,true,3097655241,28,3126283727,28628486
1650455706,195932,true,3098894489,28,3130663370,31768881
1650455785,195931,true,3099204379,28,3131915824,32711445
1650455866,195929,true,3099824250,28,3133168778,33344528
1650456057,195930,true,3099514299,28,3136303357,36789058
1650456191,195926,true,3100754291,28,3138499428,37745137
1650456342,195925,true,3101064366,28,3140697037,39632671
1650456403,195923,true,3101684610,28,3141639340,39954730
1650456616,195923,true,3101684610,28,3145096872,43412262
1650456642,195920,true,3102615208,28,3145411382,42796174
1650458268,195919,true,3102925470,28,3150447816,47522346
1650458532,195917,true,3103546086,28,3150132803,46586717
1650458996,195917,true,3103546086,28,3149817821,46271735
1650459064,195914,true,3104477243,28,3149817821,45340578
1650459118,195913,true,3104787691,28,3149817821,45030130
1650459489,195911,true,3105408679,28,3150132803,44724124
1650459505,195911,true,3105408679,28,3150132803,44724124
1650460267,195908,true,3106340395,28,3151393045,45052650
1650461567,195907,true,3106651029,28,3152338557,45687528
1650461639,195906,true,3106961694,28,3152338557,45376863
1650461681,195905,true,3107272390,28,3152023355,44750965
1650461704,195901,true,3108515486,28,3152023355,43507869
1650461721,195901,true,3108515486,28,3152023355,43507869
1650461736,195899,true,3109137220,28,3151708184,42570964
1650461772,195898,true,3109448134,28,3151393045,41944911
1650461797,195895,true,3110381061,28,3151077937,40696876
1650462105,195894,true,3110692100,28,3148243384,37551284
1650462134,195893,true,3111003169,28,3147928592,36925423
1650462165,195892,true,3111314269,28,3147613830,36299561
1650462180,195888,true,3112558982,28,3147299100,34740118
1650462370,195889,true,3112247757,28,3143839148,31591391
1650462820,195888,true,3112558982,28,3133482095,20923113
1650462867,195888,true,3112558982,28,3132229015,19670033
1650462893,195884,true,3113804192,28,3131602663,17798471
1650464021,195886,true,3113181524,28,3106029792,-7151732
1650464058,195886,true,3113181524,28,3105719220,-7462304
1650466865,195885,true,3113492843,28,3103546086,-9946757
1650466946,195882,true,3114426984,28,3103546086,-10880898
1650466983,195884,true,3113804192,28,3103235763,-10568429
1650467058,195884,true,3113804192,28,3102615208,-11188984
1650467363,195884,true,3113804192,28,3100754291,-13049901
1650467497,195881,true,3114738427,28,3099514299,-15224128
1650467836,195883,true,3114115572,28,3096416489,-17699083
1650467948,195883,true,3114115572,28,3095178232,-18937340
1650467958,195884,true,3113804192,28,3095178232,-18625960
1650467966,195881,true,3114738427,28,3094868745,-19869682
1650467983,195883,true,3114115572,28,3094559289,-19556283
1650468043,195885,true,3113492843,28,3093631107,-19861736
1650468131,195886,true,3113181524,28,3091775578,-21405946
1650468169,195883,true,3114115572,28,3090848230,-23267342
1650468201,195885,true,3113492843,28,3090230154,-23262689
1650468320,195887,true,3112870237,28,3087759081,-25111156
1650470652,195888,true,3112558982,28,3064688664,-47870318
1650471366,195885,true,3113492843,28,3064688664,-48804179
1650471488,195888,true,3112558982,28,3064688664,-47870318
1650472299,195889,true,3112247757,28,3064382226,-47865531
1650472423,195891,true,3111625401,28,3064382226,-47243175
1650472457,195888,true,3112558982,28,3064688664,-47870318
1650472682,195890,true,3111936563,28,3065301632,-46634931
1650474240,195891,true,3111625401,28,3073588715,-38036686
1650478652,195893,true,3111003169,28,3077586779,-33416390
1650478694,195890,true,3111936563,28,3077586779,-34349784
1650478903,195892,true,3111314269,28,3077279051,-34035218
1650479129,195893,true,3111003169,28,3076356052,-34647117
1650479461,195895,true,3110381061,28,3074818335,-35562726
1650479476,195893,true,3111003169,28,3074818335,-36184834
1650479785,195895,true,3110381061,28,3072666823,-37714238
1650480000,195897,true,3109759079,28,3071130950,-38628129
1650480043,195899,true,3109137220,28,3070516816,-38620404
1650481642,195899,true,3109137220,28,3049099318,-60037902
1650481947,195901,true,3108515486,28,3047270499,-61244987
1650481967,195903,true,3107893876,28,3047575226,-60318650
1650482008,195906,true,3106961694,28,3047575226,-59386468
1650482279,195904,true,3107583118,28,3049404228,-58178890
1650482476,195907,true,3106651029,28,3050624173,-56026856
1650482742,195908,true,3106340395,28,3052455005,-53885390
1650483437,195911,true,3105408679,28,3058259892,-47148787
1650483525,195909,true,3106029792,28,3059177462,-46852330
1650484128,195911,true,3105408679,28,3064075818,-41332861
1650485081,195912,true,3105098170,28,3068368314,-36729856
1650485107,195914,true,3104477243,28,3068675151,-35802092
1650485757,195912,true,3105098170,28,3070823868,-34274302
1650485954,195914,true,3104477243,28,3071130950,-33346293
1650485979,195915,true,3104166826,28,3071130950,-33035876
1650485981,195917,true,3103546086,28,3071130950,-32415136
1650486047,195915,true,3104166826,28,3071438063,-32728763
1650487972,195917,true,3103546086,28,3069595845,-33950241
1650488075,195918,true,3103235763,28,3069902805,-33332958
1650488093,195920,true,3102615208,28,3069902805,-32712403
1650488152,195919,true,3102925470,28,3070209795,-32715675
1650488270,195920,true,3102615208,28,3070516816,-32098392
1650488351,195922,true,3101994778,28,3070823868,-31170910
1650488367,195924,true,3101374473,28,3070823868,-30550605
1650488552,195923,true,3101684610,28,3071745207,-29939403
1650490260,195924,true,3101374473,28,3078510147,-22864326
1650490500,195925,true,3101064366,28,3078817998,-22246368
1650490913,195927,true,3100444246,28,3079125880,-21318366
1650491125,195926,true,3100754291,28,3079433792,-21320499
1650493008,195927,true,3100444246,28,3080049710,-20394536
1650493037,195929,true,3099824250,28,3080357715,-19466535
1650493228,195931,true,3099204379,28,3080665751,-18538628
1650493242,195930,true,3099514299,28,3080665751,-18848548
1650493661,195931,true,3099204379,28,3082206392,-16997987
1650496185,195933,true,3098584631,28,3086832939,-11751692
1650496201,195935,true,3097965007,28,3086832939,-11132068
1650496228,195934,true,3098274803,28,3086832939,-11441864
1650496268,195936,true,3097655241,28,3086832939,-10822302
1650496506,195938,true,3097035803,28,3086215665,-10820138
1650497525,195940,true,3096416489,28,3083131146,-13285343
1650498797,195939,true,3096726130,28,3081281915,-15444215
1650500332,195941,true,3096106878,28,3081281915,-14824963
1650500871,195944,true,3095178232,28,3081590043,-13588189
1650502764,195946,true,3094559289,28,3081281915,-13277374
1650502826,195947,true,3094249864,28,3081590043,-12659821
1650503896,195949,true,3093631107,28,3081898202,-11732905
1650504140,195952,true,3092703203,28,3081898202,-10805001
1650504372,195954,true,3092084755,28,3081898202,-10186553
1650504574,195955,true,3091775578,28,3082206392,-9569186
1650504648,195958,true,3090848230,28,3082514612,-8333618
1650504836,195960,true,3090230154,28,3082822864,-7407290
1650504967,195962,true,3089612200,28,3083131146,-6481054
1650504988,195963,true,3089303270,28,3083131146,-6172124
1650505329,195965,true,3088685502,28,3084673020,-4012482
1650505381,195967,true,3088067857,28,3084673020,-3394837
1650505500,195969,true,3087450336,28,3085598514,-1851822
1650505554,195970,true,3087141622,28,3085907074,-1234548
1650505812,195971,true,3086832939,28,3088067857,1234918
1650507353,195973,true,3086215665,28,3095487750,9272085
1650508439,195975,true,3085598514,28,3096106878,10508364
1650509706,195976,true,3085289985,28,3096416489,11126504
1650510259,195978,true,3084673020,28,3096416489,11743469
1650510517,195980,true,3084056178,28,3096416489,12360311
1650510833,195982,true,3083439459,28,3096106878,12667419
1650512633,195983,true,3083131146,28,3094868745,11737599
1650514616,195983,true,3083131146,28,3095178232,12047086
1650515862,195985,true,3082514612,28,3095178232,12663620
1650517862,195987,true,3081898202,28,3089921161,8022959
1650518272,195988,true,3081590043,28,3089921161,8331118
1650518795,195989,true,3081281915,28,3090230154,8948239
1650519457,195990,true,3080973817,28,3090230154,9256337
1650519791,195992,true,3080357715,28,3090230154,9872439
1650519807,195993,true,3080049710,28,3090230154,10180444
1650519829,195992,true,3080357715,28,3090230154,9872439
1650520264,195993,true,3080049710,28,3089612200,9562490
1650520316,195995,true,3079433792,28,3089303270,9869478
1650520568,195996,true,3079125880,28,3088067857,8941977
1650520625,195994,true,3079741736,28,3087759081,8017345
1650520833,195996,true,3079125880,28,3086832939,7707059
1650520894,195998,true,3078510147,28,3086524287,8014140
1650520903,195999,true,3078202327,28,3086215665,8013338
1650522019,195997,true,3078817998,28,3079433792,615794
1650522560,195999,true,3078202327,28,3077894537,-307790
1650522840,195999,true,3078202327,28,3077586779,-615548
1650523157,196000,true,3077894537,28,3077894537,0
1650523613,195999,true,3078202327,28,3078202327,0
1650523749,196000,true,3077894537,28,3078202327,307790
1650525681,196000,true,3077894537,28,3078510147,615610
1650526382,196001,true,3077586779,28,3079125880,1539101
1650526736,195999,true,3078202327,28,3079125880,923553
1650526743,195999,true,3078202327,28,3079125880,923553
1650526848,195999,true,3078202327,28,3079433792,1231465
1650527030,196000,true,3077894537,28,3079741736,1847199
1650527111,195998,true,3078510147,28,3079741736,1231589
1650527148,195997,true,3078817998,28,3079741736,923738
1650527327,195997,true,3078817998,28,3080357715,1539717
1650527372,195998,true,3078510147,28,3080357715,1847568
1650527400,195995,true,3079433792,28,3080357715,923923
1650527453,195995,true,3079433792,28,3080665751,1231959
1650527467,195995,true,3079433792,28,3080665751,1231959
1650527475,195995,true,3079433792,28,3080665751,1231959
1650527667,195993,true,3080049710,28,3081590043,1540333
1650527669,195993,true,3080049710,28,3081590043,1540333
1650527838,195993,true,3080049710,28,3082514612,2464902
1650527872,195994,true,3079741736,28,3082822864,3081128
1650527941,195991,true,3080665751,28,3083439459,2773708
1650528045,195991,true,3080665751,28,3084364584,3698833
1650528260,195990,true,3080973817,28,3086832939,5859122
1650528672,195991,true,3080665751,28,3091466431,10800680
1650530574,195987,true,3081898202,28,3100754291,18856089
1650533173,195987,true,3081898202,28,3101374473,19476271
1650534050,195986,true,3082206392,28,3101374473,19168081
1650534092,195985,true,3082514612,28,3101374473,18859861
1650536129,195982,true,3083439459,28,3094559289,11119830
1650536135,195982,true,3083439459,28,3094868745,11429286
1650536156,195980,true,3084056178,28,3094868745,10812567
1650536175,195980,true,3084056178,28,3094868745,10812567
1650536178,195977,true,3084981487,28,3094868745,9887258
1650536308,195976,true,3085289985,28,3095487750,10197765
1650536367,195975,true,3085598514,28,3096106878,10508364
1650537483,195974,true,3085907074,28,3109448134,23541060
1650537615,195971,true,3086832939,28,3111003169,24170230
1650537640,195971,true,3086832939,28,3111314269,24481330
1650538259,195969,true,3087450336,28,3119413806,31963470
1650538606,195968,true,3087759081,28,3121598051,33838970
1650539402,195965,true,3088685502,28,3127221706,38536204
1650539618,195965,true,3088685502,28,3127534428,38848926
1650539825,195963,true,3089303270,28,3128159966,38856696
1650539859,195961,true,3089921161,28,3128159966,38238805
1650539875,195958,true,3090848230,28,3128159966,37311736
1650540278,195957,true,3091157315,28,3129724359,38567044
1650540579,195956,true,3091466431,28,3130663370,39196939
1650540620,195954,true,3092084755,28,3130976437,38891682
1650540779,195951,true,3093012473,28,3131915824,38903351
1650541018,195950,true,3093321775,28,3133482095,40160320
1650541053,195948,true,3093940470,28,3133795443,39854973
1650541131,195946,true,3094559289,28,3134422233,39862944
1650541212,195944,true,3095178232,28,3135362654,40184422
1650541217,195943,true,3095487750,28,3135362654,39874904
1650541231,195941,true,3096106878,28,3135676190,39569312
1650542104,195938,true,3097035803,28,3144467947,47432144
1650542477,195936,true,3097655241,28,3147299100,49643859
1650542491,195935,true,3097965007,28,3147613830,49648823
1650542529,195933,true,3098584631,28,3147928592,49343961
1650542650,195930,true,3099514299,28,3148873065,49358766
1650542835,195928,true,3100134233,28,3150447816,50313583
1650543327,195927,true,3100444246,28,3152653791,52209545
1650543363,195925,true,3101064366,28,3152969057,51904691
1650544384,195922,true,3101994778,28,3153599682,51604904
1650544519,195920,true,3102615208,28,3153284353,50669145
1650545010,195919,true,3102925470,28,3152023355,49097885
1650545046,195917,true,3103546086,28,3152023355,48477269
1650545092,195914,true,3104477243,28,3152023355,47546112
1650545113,195912,true,3105098170,28,3152023355,46925185
1650545121,195911,true,3105408679,28,3151708184,46299505
1650545148,195908,true,3106340395,28,3152023355,45682960
1650545202,195906,true,3106961694,28,3152023355,45061661
1650545205,195903,true,3107893876,28,3152023355,44129479
1650545216,195902,true,3108204665,28,3152338557,44133892
1650545299,195899,true,3109137220,28,3152969057,43831837
1650545348,195896,true,3110070054,28,3153284353,43214299
1650546308,195894,true,3110692100,28,3162125479,51433379
1650546402,195892,true,3111314269,28,3163074212,51759943
1650546557,195890,true,3111936563,28,3164339631,52403068
1650547783,195887,true,3112870237,28,3166238710,53368473
1650548010,195885,true,3113492843,28,3165605557,52112714
1650548029,195883,true,3114115572,28,3165605557,51489985
1650548038,195881,true,3114738427,28,3165605557,50867130
1650548099,195878,true,3115672942,28,3165605557,49932615
1650548491,195876,true,3116296107,28,3165922118,49626011
1650548785,195875,true,3116607737,28,3166555334,49947597
1650548821,195873,true,3117231090,28,3166555334,49324244
1650548933,195870,true,3118166352,28,3166871989,48705637
1650549228,195868,true,3118790017,28,3166871989,48081972
1650549396,195867,true,3119101896,28,3166555334,47453438
1650549480,195865,true,3119725747,28,3166555334,46829587
1650549640,195862,true,3120661759,28,3166238710,45576951
1650549899,195860,true,3121285922,28,3165922118,44636196
1650550006,195860,true,3121285922,28,3165289028,44003106
1650550019,195857,true,3122222402,28,3165289028,43066626
1650550032,195854,true,3123159162,28,3165289028,42129866
1650550046,195853,true,3123471478,28,3165289028,41817550
1650550068,195852,true,3123783825,28,3164972531,41188706
1650550185,195850,true,3124408613,28,3164339631,39931018
1650550248,195847,true,3125346030,28,3163706858,38360828
1650550317,195845,true,3125971130,28,3163390519,37419389
1650550479,195844,true,3126283727,28,3162125479,35841752
1650550675,195842,true,3126909015,28,3160860945,33951930
1650550724,195839,true,3127847182,28,3160544891,32697709
1650550892,195837,true,3128472782,28,3159596917,31124135
1650552374,195836,true,3128785630,28,3155492315,26706685
1650553281,195833,true,3129724359,28,3154545856,24821497
1650553992,195830,true,3130663370,28,3154230433,23567063
1650555146,195828,true,3131289534,28,3153915042,22625508
1650555167,195827,true,3131602663,28,3153915042,22312379
1650555489,195825,true,3132229015,28,3152653791,20424776
1650555533,195822,true,3133168778,28,3152338557,19169779
1650555595,195820,true,3133795443,28,3152023355,18227912
1650555654,195819,true,3134108822,28,3151393045,17284223
1650555669,195817,true,3134735676,28,3151393045,16657369
1650555680,195815,true,3135362654,28,3151393045,16030391
1650555779,195814,true,3135676190,28,3149817821,14141631
1650555932,195814,true,3135676190,28,3147613830,11937640
1650556035,195812,true,3136303357,28,3146040495,9737138
1650556082,195809,true,3137244342,28,3145096872,7852530
1650556641,195810,true,3136930649,28,3134735676,-2194973
1650556714,195809,true,3137244342,28,3133168778,-4075564
1650556790,195808,true,3137558066,28,3131602663,-5955403
1650556917,195805,true,3138499428,28,3128785630,-9713798
1650556976,195806,true,3138185609,28,3127221706,-10963903
1650557168,195806,true,3138185609,28,3123471478,-14714131
1650557343,195805,true,3138499428,28,3119413806,-19085622
1650558538,195803,true,3139127159,28,3105719220,-33407939
1650558587,195804,true,3138813278,28,3105408679,-33404599
1650558745,195804,true,3138813278,28,3104166826,-34646452
1650558923,195803,true,3139127159,28,3102615208,-36511951
1650560098,195802,true,3139441072,28,3096726130,-42714942
1650560322,195804,true,3138813278,28,3095487750,-43325528
1650560377,195804,true,3138813278,28,3095178232,-43635046
1650560786,195804,true,3138813278,28,3093012473,-45800805
1650560816,195804,true,3138813278,28,3092703203,-46110075
1650561204,195805,true,3138499428,28,3090230154,-48269274
1650561495,195806,true,3138185609,28,3088067857,-50117752
1650561566,195806,true,3138185609,28,3087759081,-50426528
1650562150,195806,true,3138185609,28,3082514612,-55670997
1650562226,195808,true,3137558066,28,3082206392,-55351674
1650562619,195808,true,3137558066,28,3080665751,-56892315
1650562736,195808,true,3137558066,28,3080049710,-57508356
1650562962,195808,true,3137558066,28,3078817998,-58740068
1650563642,195810,true,3136930649,28,3075433329,-61497320
1650564040,195811,true,3136616987,28,3073896074,-62720913
1650564175,195812,true,3136303357,28,3072974090,-63329267
1650564209,195813,true,3135989758,28,3072666823,-63322935
1650564568,195816,true,3135049149,28,3070209795,-64839354
1650564741,195817,true,3134735676,28,3069288916,-65446760
1650565069,195818,true,3134422233,28,3068368314,-66053919
1650565211,195820,true,3133795443,28,3068061508,-65733935
1650566015,195823,true,3132855492,28,3065608163,-67247329
1650566330,195824,true,3132542238,28,3065608163,-66934075
1650567667,195825,true,3132229015,28,3065608163,-66620852
1650567692,195827,true,3131602663,28,3065608163,-65994500
1650567791,195830,true,3130663370,28,3065608163,-65055207
1650567807,195832,true,3130037332,28,3065608163,-64429169
1650567848,195833,true,3129724359,28,3065608163,-64116196
1650567970,195835,true,3129098508,28,3064995133,-64103375
1650568082,195839,true,3127847182,28,3064688664,-63158518
1650569374,195841,true,3127221706,28,3058871574,-68350132
1650569663,195843,true,3126596355,28,3057954096,-68642259
1650569802,195845,true,3125971130,28,3057954096,-68017034
1650569809,195848,true,3125033526,28,3057954096,-67079430
1650570393,195851,true,3124096204,28,3057342597,-66753607
1650570410,195853,true,3123471478,28,3057342597,-66128881
1650570431,195856,true,3122534624,28,3057342597,-65192027
1650570436,195859,true,3121598051,28,3057342597,-64255454
1650570473,195862,true,3120661759,28,3057342597,-63319162
1650570571,195865,true,3119725747,28,3056731221,-62994526
1650570576,195868,true,3118790017,28,3056731221,-62058796
1650571200,195873,true,3117231090,28,3049709168,-67521922
1650571253,195876,true,3116296107,28,3049099318,-67196789
1650571420,195878,true,3115672942,28,3046661136,-69011806
1650571450,195881,true,3114738427,28,3046051895,-68686532
1650571864,195887,true,3112870237,28,3040270180,-72600057
1650572430,195890,true,3111936563,28,3032376139,-79560424
1650573192,195893,true,3111003169,28,3027831211,-83171958
1650573258,195895,true,3110381061,28,3027831211,-82549850
1650573342,195901,true,3108515486,28,3027225736,-81289750
1650573400,195905,true,3107272390,28,3026923044,-80349346
1650573419,195908,true,3106340395,28,3026923044,-79417351
1650573479,195911,true,3105408679,28,3026317750,-79090929
1650573631,195917,true,3103546086,28,3025107525,-78438561
1650573660,195921,true,3102304978,28,3024805045,-77499933
1650573709,195925,true,3101064366,28,3024200174,-76864192
1650573747,195929,true,3099824250,28,3023897785,-75926465
1650573910,195936,true,3097655241,28,3022084081,-75571160
1650574187,195940,true,3096416489,28,3018459936,-77956553
1650574633,195944,true,3095178232,28,3013634503,-81543729
1650574680,195947,true,3094249864,28,3013031866,-81217998
1650577190,195955,true,3091775578,28,3002204993,-89570585
1650577231,195959,true,3090539177,28,3002505214,-88033963
1650577265,195963,true,3089303270,28,3002505214,-86798056
1650578058,195966,true,3088376664,28,3006110202,-82266462
1650578443,195973,true,3086215665,28,3007914319,-78301346
1650578530,195977,true,3084981487,28,3007914319,-77067168
1650578577,195981,true,3083747803,28,3007914319,-75833484
1650579320,195985,true,3082514612,28,3004307167,-78207445
1650579446,195993,true,3080049710,28,3003706396,-76343314
1650579565,195997,true,3078817998,28,3003105745,-75712253
1650579599,196000,true,3077894537,28,3002805464,-75089073
1650579714,196004,true,3076663687,28,3002204993,-74458694
1650580154,196011,true,3074510884,28,3001004411,-73506473
1650580172,196015,true,3073281387,28,3000704341,-72577046
1650580198,196019,true,3072052382,28,3000404300,-71648082
1650580209,196023,true,3070823868,28,3000404300,-70419568
1650580224,196031,true,3068368314,28,3000104290,-68264024
1650580240,196035,true,3067141273,28,2999804309,-67336964
1650580252,196040,true,3065608163,28,2999504359,-66103804
1650580342,196045,true,3064075818,28,2997105835,-66969983
1650580468,196054,true,3061319528,28,2994709229,-66610299
1650580509,196058,true,3060095307,28,2993810996,-66284311
1650580644,196063,true,3058565718,28,2990818831,-67746887
1650580920,196068,true,3057036894,28,2985739012,-71297882
1650580951,196076,true,3054592364,28,2985141954,-69450410
1650580959,196081,true,3053065526,28,2985141954,-67923572
1650580973,196085,true,3051844605,28,2984843469,-67001136
1650581019,196090,true,3050319141,28,2984246590,-66072551
1650581027,196098,true,3047879983,28,2984246590,-63633393
1650581063,196102,true,3046661136,28,2983649830,-63011306
1650581305,196105,true,3045747320,28,2980965888,-64781432
1650581512,196110,true,3044224903,28,2978582188,-65642715
1650581546,196117,true,3042094798,28,2977986561,-64108237
1650581566,196121,true,3040878264,28,2977688792,-63189472
1650582801,196124,true,3039966183,28,2982456669,-57509514
1650583175,196128,true,3038750501,28,2983649830,-55100671
1650583402,196134,true,3036927888,28,2983649830,-53278058
1650583509,196138,true,3035713421,28,2983649830,-52063591
1650585792,196141,true,3034802889,28,2982456669,-52346220
1650586171,196145,true,3033589271,28,2981860267,-51729004
1650586460,196151,true,3031769754,28,2981860267,-49909487
1650587567,196154,true,3030860405,28,2980965888,-49894517
1650587569,196157,true,3029951329,28,2980965888,-48985441
1650587616,196161,true,3028739652,28,2981263984,-47475668
1650587620,196166,true,3027225736,28,2981263984,-45961752
1650587656,196169,true,3026317750,28,2981263984,-45053766
1650588064,196171,true,3025712577,28,2983948195,-41764382
1650588271,196174,true,3024805045,28,2985440468,-39364577
1650588308,196180,true,3022990797,28,2985440468,-37550329
1650588328,196182,true,3022386289,28,2985739012,-36647277
1650588405,196184,true,3021781903,28,2985739012,-36042891
1650588645,196187,true,3020875549,28,2985440468,-35435081
1650588805,196193,true,3019063658,28,2985440468,-33623190
1650589685,196195,true,3018459936,28,2983351495,-35108441
1650589707,196197,true,3017856335,28,2983351495,-34504840
1650590760,196200,true,3016951159,28,2981860267,-35090892
1650590860,196205,true,3015443136,28,2982158453,-33284683
1650591153,196207,true,3014840137,28,2983053190,-31786947
1650591373,196209,true,3014237260,28,2983948195,-30289065
1650591451,196211,true,3013634503,28,2984246590,-29387913
1650591509,196216,true,3012128138,28,2984246590,-27881548
1650591642,196218,true,3011525802,28,2984843469,-26682333
1650591708,196220,true,3010923587,28,2984843469,-26080118
1650592368,196222,true,3010321493,28,2986634823,-23686670
1650592391,196226,true,3009117665,28,2986634823,-22482842
1650592743,196228,true,3008515932,28,2988726095,-19789837
1650593267,196229,true,3008215111,28,2990519779,-17695332
1650593305,196231,true,3007613558,28,2990519779,-17093779
1650594378,196235,true,3006410813,28,2995008700,-11402113
1650594458,196236,true,3006110202,28,2995308201,-10802001
1650594922,196237,true,3005809621,28,2996506504,-9303117
1650594968,196239,true,3005208549,28,2996506504,-8702045
1650595202,196243,true,3004006766,28,2997105835,-6900931
1650595374,196244,true,3003706396,28,2997405546,-6300850
1650597317,196245,true,3003406055,28,2998904548,-4501507
1650597528,196247,true,3002805464,28,2999204439,-3601025
1650597541,196251,true,3001604642,28,2999204439,-2400203
1650599198,196252,true,3001304512,28,3001004411,-300101
1650599924,196252,true,3001304512,28,3001004411,-300101
1650603237,196254,true,3000704341,28,3000404300,-300041
1650603332,196258,true,2999504359,28,3000704341,1199982
1650603445,196258,true,2999504359,28,3000704341,1199982
1650603531,196259,true,2999204439,28,3001004411,1799972
1650603849,196260,true,2998904548,28,3002204993,3300445
1650604043,196264,true,2997705286,28,3003406055,5700769
1650604571,196264,true,2997705286,28,3006410813,8705527
1650604618,196265,true,2997405546,28,3006711454,9305908
1650606303,196265,true,2997405546,28,3012730593,15325047
1650607501,196269,true,2996206883,28,3012730593,16523710
1650607614,196269,true,2996206883,28,3012730593,16523710
1650607882,196269,true,2996206883,28,3012730593,16523710
1650608246,196270,true,2995907292,28,3012730593,16823301
1650608455,196272,true,2995308201,28,3012730593,17422392
1650608707,196272,true,2995308201,28,3012730593,17422392
1650610127,196272,true,2995308201,28,3012730593,17422392
1650612051,196272,true,2995308201,28,3012730593,17422392
1650612068,196274,true,2994709229,28,3012730593,18021364
1650612226,196274,true,2994709229,28,3011525802,16816573
1650613290,196274,true,2994709229,28,3002505214,7795985
1650613318,196276,true,2994110377,28,3002204993,8094616
1650613331,196278,true,2993511645,28,3002204993,8693348
1650613392,196277,true,2993810996,28,3001904803,8093807
1650613414,196276,true,2994110377,28,3001904803,7794426
1650613453,196277,true,2993810996,28,3001904803,8093807
1650613552,196278,true,2993511645,28,3002204993,8693348
1650613555,196277,true,2993810996,28,3002204993,8393997
1650613694,196276,true,2994110377,28,3003406055,9295678
1650614171,196276,true,2994110377,28,3009418577,15308200
1650614644,196276,true,2994110377,28,3016347859,22237482
1650614711,196275,true,2994409788,28,3017554579,23144791
1650614779,196273,true,2995008700,28,3018459936,23451236
1650615177,196274,true,2994709229,28,3024200174,29490945
1650615377,196274,true,2994709229,28,3025107525,30398296
1650615413,196272,true,2995308201,28,3025107525,29799324
1650615431,196271,true,2995607732,28,3025107525,29499793
1650615483,196271,true,2995607732,28,3024805045,29197313
1650616159,196273,true,2995008700,28,3020875549,25866849
1650616201,196272,true,2995308201,28,3020573492,25265291
1650616260,196270,true,2995907292,28,3020271465,24364173
1650616605,196270,true,2995907292,28,3017554579,21647287
1650617311,196271,true,2995607732,28,3012429350,16821618
1650617343,196270,true,2995907292,28,3012429350,16522058
1650617423,196268,true,2996506504,28,3012128138,15621634
1650617430,196269,true,2996206883,28,3012128138,15921255
1650617797,196271,true,2995607732,28,3010020491,14412759
1650618952,196270,true,2995907292,28,3005809621,9902329
1650619027,196268,true,2996506504,28,3005509070,9002566
1650619819,196269,true,2996206883,28,3004908059,8701176
1650620194,196269,true,2996206883,28,3004908059,8701176
1650620311,196267,true,2996806154,28,3004607598,7801444
1650621420,196265,true,2997405546,28,3002505214,5099668
1650621432,196264,true,2997705286,28,3002505214,4799928
1650621450,196264,true,2997705286,28,3002505214,4799928
1650621463,196262,true,2998304857,28,3002204993,3900136
1650621481,196261,true,2998604688,28,3002204993,3600305
1650621721,196260,true,2998904548,28,3000404300,1499752
1650621815,196261,true,2998604688,28,2999804309,1199621
1650621924,196259,true,2999204439,28,2998604688,-599751
1650622535,196258,true,2999504359,28,2992613771,-6890588
1650622556,196258,true,2999504359,28,2992613771,-6890588
1650622920,196259,true,2999204439,28,2989921765,-9282674
1650623820,196257,true,2999804309,28,2988128439,-11675870
1650624017,196256,true,3000104290,28,2989323870,-10780420
1650624178,196257,true,2999804309,28,2990220757,-9583552
1650624212,196258,true,2999504359,28,2990519779,-8984580
1650624309,196256,true,3000104290,28,2991117913,-8986377
1650624449,196255,true,3000404300,28,2992015338,-8388962
1650624550,196255,true,3000404300,28,2992913032,-7491268
1650625950,196256,true,3000104290,28,3001304512,1200222
1650626019,196253,true,3001004411,28,3001604642,600231
1650626397,196252,true,3001304512,28,3003406055,2101543
1650626781,196252,true,3001304512,28,3004607598,3303086
1650629072,196253,true,3001004411,28,3008215111,7210700
1650629117,196250,true,3001904803,28,3008515932,6611129
1650629421,196249,true,3002204993,28,3008816784,6611791
1650629440,196249,true,3002204993,28,3008816784,6611791
1650629448,196249,true,3002204993,28,3008816784,6611791
1650629638,196247,true,3002805464,28,3009418577,6613113
1650630244,196246,true,3003105745,28,3011224680,8118935
1650630889,196247,true,3002805464,28,3013333170,10527706
1650630894,196246,true,3003105745,28,3013333170,10227425
1650631191,196245,true,3003406055,28,3013634503,10228448
1650631237,196243,true,3004006766,28,3013634503,9627737
1650631552,196243,true,3004006766,28,3012730593,8723827
1650632641,196243,true,3004006766,28,3009418577,5411811
1650633036,196241,true,3004607598,28,3008215111,3607513
1650633132,196240,true,3004908059,28,3008215111,3307052
1650633225,196240,true,3004908059,28,3007914319,3006260
1650633271,196240,true,3004908059,28,3007914319,3006260
1650633446,196239,true,3005208549,28,3007312827,2104278
1650633450,196238,true,3005509070,28,3007312827,1803757
1650634217,196238,true,3005509070,28,3003105745,-2403325
1650634252,196239,true,3005208549,28,3003105745,-2102804
1650634281,196238,true,3005509070,28,3003105745,-2403325
1650634293,196236,true,3006110202,28,3003105745,-3004457
1650634561,196236,true,3006110202,28,3002805464,-3304738
1650634765,196236,true,3006110202,28,3002505214,-3604988
1650634768,196236,true,3006110202,28,3002505214,-3604988
1650634772,196235,true,3006410813,28,3002505214,-3905599
1650634802,196235,true,3006410813,28,3002505214,-3905599
1650634826,196236,true,3006110202,28,3002204993,-3905209
1650634829,196235,true,3006410813,28,3002204993,-4205820
1650635034,196235,true,3006410813,28,3001004411,-5406402
1650635535,196236,true,3006110202,28,2997705286,-8404916
1650635558,196237,true,3005809621,28,2997705286,-8104335
1650635631,196236,true,3006110202,28,2997405546,-8704656
1650636070,196236,true,3006110202,28,2996206883,-9903319
1650636534,196236,true,3006110202,28,2993212323,-12897879
1650636962,196237,true,3005809621,28,2993212323,-12597298
1650637027,196237,true,3005809621,28,2993212323,-12597298
1650637182,196236,true,3006110202,28,2993212323,-12897879
1650637293,196237,true,3005809621,28,2992913032,-12896589
1650637335,196239,true,3005208549,28,2992913032,-12295517
1650637417,196239,true,3005208549,28,2992314539,-12894010
1650637439,196239,true,3005208549,28,2992015338,-13193211
1650637441,196240,true,3004908059,28,2992015338,-12892721
1650637452,196242,true,3004307167,28,2991716166,-12591001
1650637483,196243,true,3004006766,28,2991417024,-12589742
1650637677,196243,true,3004006766,28,2989024967,-14981799
1650637713,196245,true,3003406055,28,2988726095,-14679960
1650637750,196247,true,3002805464,28,2988128439,-14677025
1650638204,196248,true,3002505214,28,2982456669,-20048545
1650638843,196248,true,3002505214,28,2975010211,-27495003
1650638939,196250,true,3001904803,28,2974415298,-27489505
1650639835,196252,true,3001304512,28,2973523152,-27781360
1650640092,196252,true,3001304512,28,2973523152,-27781360
1650640107,196253,true,3001004411,28,2973523152,-27481259
1650640134,196255,true,3000404300,28,2973523152,-26881148
1650640211,196256,true,3000104290,28,2973820505,-26283785
1650640234,196256,true,3000104290,28,2974117887,-25986403
1650640255,196256,true,3000104290,28,2974415298,-25688992
1650640565,196256,true,3000104290,28,2977093343,-23010947
1650640567,196257,true,2999804309,28,2977093343,-22710966
1650640961,196258,true,2999504359,28,2979177934,-20326425
1650641008,196258,true,2999504359,28,2979475852,-20028507
1650641118,196259,true,2999204439,28,2979773799,-19430640
1650641188,196261,true,2998604688,28,2979773799,-18830889
1650641192,196262,true,2998304857,28,2979773799,-18531058
1650641566,196263,true,2998005057,28,2980369784,-17635273
1650641642,196265,true,2997405546,28,2980667821,-16737725
1650641685,196267,true,2996806154,28,2980667821,-16138333
1650641977,196268,true,2996506504,28,2980369784,-16136720
1650642113,196269,true,2996206883,28,2979475852,-16731031
1650642171,196271,true,2995607732,28,2978582188,-17025544
1650642206,196273,true,2995008700,28,2977986561,-17022139
1650642816,196275,true,2994409788,28,2969363340,-25046448
1650642928,196277,true,2993810996,28,2968175892,-25635104
1650642985,196279,true,2993212323,28,2967285617,-25926706
1650643027,196280,true,2992913032,28,2966692249,-26220783
1650643354,196283,true,2992015338,28,2962245769,-29769569
1650643503,196285,true,2991417024,28,2960173026,-31243998
1650643523,196286,true,2991117913,28,2959877038,-31240875
1650643674,196288,true,2990519779,28,2957510202,-33009577
1650643999,196291,true,2989622802,28,2952486957,-37135845
1650644271,196293,true,2989024967,28,2949536093,-39488874
1650644446,196294,true,2988726095,28,2948356573,-40369522
1650644483,196295,true,2988427252,28,2948356573,-40070679
1650645112,196297,true,2987829656,28,2948356573,-39473083
1650645423,196299,true,2987232180,28,2949831046,-37401134
1650645582,196300,true,2986933487,28,2951011156,-35922331
1650646099,196301,true,2986634823,28,2955736317,-30898506
1650646479,196303,true,2986037586,28,2956918788,-29118798
1650646490,196304,true,2985739012,28,2956918788,-28820224
1650647103,196306,true,2985141954,28,2956327493,-28814461
1650647893,196306,true,2985141954,28,2954849773,-30292181
1650647978,196309,true,2984246590,28,2954554318,-29692272
1650648491,196310,true,2983948195,28,2953963495,-29984700
1650648844,196310,true,2983948195,28,2954258892,-29689303
1650649150,196311,true,2983649830,28,2954258892,-29390938
1650650689,196313,true,2983053190,28,2956327493,-26725697
1650651453,196313,true,2983053190,28,2955736317,-27316873
1650651478,196314,true,2982754914,28,2955736317,-27018597
1650651542,196314,true,2982754914,28,2955736317,-27018597
1650651584,196317,true,2981860267,28,2956031890,-25828377
1650652383,196316,true,2982158453,28,2960469043,-21689410
1650652626,196317,true,2981860267,28,2961949574,-19910693
1650652700,196318,true,2981562111,28,2962245769,-19316342
1650654866,196320,true,2980965888,28,2963430845,-17535043
1650655031,196320,true,2980965888,28,2964023561,-16942327
1650655733,196321,true,2980667821,28,2966692249,-13975572
1650655949,196322,true,2980369784,28,2967285617,-13084167
1650655965,196324,true,2979773799,28,2967285617,-12488182
1650656022,196324,true,2979773799,28,2967582346,-12191453
1650656065,196325,true,2979475852,28,2967879104,-11596748
1650656324,196326,true,2979177934,28,2969660277,-9517657
1650656579,196328,true,2978582188,28,2971442518,-7139670
1650656860,196328,true,2978582188,28,2972928537,-5653651
1650656887,196329,true,2978284359,28,2972928537,-5355822
1650656994,196330,true,2977986561,28,2973225830,-4760731
1650657072,196333,true,2977093343,28,2973225830,-3867513
1650657093,196333,true,2977093343,28,2973225830,-3867513
1650657143,196334,true,2976795664,28,2972928537,-3867127
1650657941,196336,true,2976200394,28,2969660277,-6540117
1650658479,196339,true,2975307712,28,2966099000,-9208712
1650658483,196339,true,2975307712,28,2966099000,-9208712
1650661803,196340,true,2975010211,28,2963134531,-11875680
1650663469,196341,true,2974712740,28,2963134531,-11578209
1650663718,196344,true,2973820505,28,2963430845,-10389660
1650664197,196345,true,2973523152,28,2964319963,-9203189
1650664949,196345,true,2973523152,28,2965802419,-7720733
1650665045,196346,true,2973225830,28,2965802419,-7423411
1650665052,196348,true,2972631274,28,2965802419,-6828855
1650665192,196349,true,2972334040,28,2965209348,-7124692
1650665206,196350,true,2972036837,28,2964912857,-7123980
1650665236,196352,true,2971442518,28,2964616395,-6826123
1650665413,196354,true,2970848319,28,2963134531,-7713788
1650665430,196355,true,2970551264,28,2962838248,-7713016
1650665451,196357,true,2969957243,28,2962838248,-7118995
1650665472,196359,true,2969363340,28,2962541993,-6821347
1650665531,196361,true,2968769557,28,2962245769,-6523788
1650665544,196362,true,2968472710,28,2962245769,-6226941
1650666295,196363,true,2968175892,28,2958101733,-10074159
1650668536,196364,true,2967879104,28,2955145258,-12733846
1650669012,196366,true,2967285617,28,2955736317,-11549300
1650669524,196367,true,2966988918,28,2956031890,-10957028
1650670316,196367,true,2966988918,28,2956327493,-10661425
1650670676,196368,true,2966692249,28,2956623126,-10069123
1650670718,196370,true,2966099000,28,2956623126,-9475874
1650670738,196371,true,2965802419,28,2956623126,-9179293
1650671135,196371,true,2965802419,28,2956918788,-8883631
1650671229,196373,true,2965209348,28,2957214480,-7994868
1650671258,196375,true,2964616395,28,2957214480,-7401915
1650672243,196375,true,2964616395,28,2959877038,-4739357
1650672533,196375,true,2964616395,28,2960765090,-3851305
1650672857,196376,true,2964319963,28,2961949574,-2370389
1650675296,196377,true,2964023561,28,2964616395,592834
1650675888,196377,true,2964023561,28,2964616395,592834
1650676545,196377,true,2964023561,28,2964616395,592834
1650677810,196377,true,2964023561,28,2963430845,-592716
1650677886,196378,true,2963727188,28,2963430845,-296343
1650677909,196378,true,2963727188,28,2963430845,-296343
1650678885,196378,true,2963727188,28,2962838248,-888940
1650683384,196379,true,2963430845,28,2962838248,-592597
1650683566,196380,true,2963134531,28,2962838248,-296283
1650683754,196379,true,2963430845,28,2962541993,-888852
1650683817,196379,true,2963430845,28,2962541993,-888852
1650684203,196380,true,2963134531,28,2962245769,-888762
1650684333,196381,true,2962838248,28,2961949574,-888674
1650684432,196381,true,2962838248,28,2961653408,-1184840
1650684595,196381,true,2962838248,28,2961061167,-1777081
1650684622,196382,true,2962541993,28,2961061167,-1480826
1650684680,196384,true,2961949574,28,2960765090,-1184484
1650685371,196384,true,2961949574,28,2955736317,-6213257
1650686308,196385,true,2961653408,28,2950421042,-11232366
1650687679,196387,true,2961061167,28,2949831046,-11230121
1650687751,196388,true,2960765090,28,2949831046,-10934044
1650688052,196389,true,2960469043,28,2945704379,-14764664
1650688567,196390,true,2960173026,28,2938643518,-21529508
1650688801,196393,true,2959285152,28,2935706490,-23578662
1650689356,196395,true,2958693383,28,2928962461,-29730922
1650689365,196395,true,2958693383,28,2928669594,-30023789
1650689390,196396,true,2958397544,28,2928669594,-29727950
1650689413,196399,true,2957510202,28,2928376756,-29133446
1650689440,196400,true,2957214480,28,2928083947,-29130533
1650689474,196400,true,2957214480,28,2927791168,-29423312
1650689782,196400,true,2957214480,28,2929255357,-27959123
1650689940,196403,true,2956327493,28,2930427235,-25900258
1650690056,196402,true,2956623126,28,2931599581,-25023545
1650690067,196402,true,2956623126,28,2931599581,-25023545
1650690215,196403,true,2956327493,28,2933065674,-23261819
1650690320,196405,true,2955736317,28,2934239077,-21497240
1650691397,196404,true,2956031890,28,2942760294,-13271596
1650691417,196403,true,2956327493,28,2943054570,-13272923
1650691721,196403,true,2956327493,28,2943937574,-12389919
1650691787,196406,true,2955440772,28,2944231968,-11208804
1650691940,196403,true,2956327493,28,2944526391,-11801102
1650692343,196403,true,2956327493,28,2945115326,-11212167
1650692641,196403,true,2956327493,28,2945704379,-10623114
1650692718,196405,true,2955736317,28,2945704379,-10031938
1650692855,196404,true,2956031890,28,2945998949,-10032941
1650693052,196404,true,2956031890,28,2946588178,-9443712
1650693601,196404,true,2956031890,28,2948061767,-7970123
1650694048,196406,true,2955440772,28,2948946274,-6494498
1650694431,196405,true,2955736317,28,2949536093,-6200224
1650694562,196404,true,2956031890,28,2949831046,-6200844
1650694620,196405,true,2955736317,28,2949831046,-5905271
1650694677,196406,true,2955440772,28,2950126030,-5314742
1650694866,196405,true,2955736317,28,2950716084,-5020233
1650695154,196404,true,2956031890,28,2951306257,-4725633
1650695708,196405,true,2955736317,28,2952191737,-3544580
1650695902,196407,true,2955145258,28,2952486957,-2658301
1650696182,196405,true,2955736317,28,2953077483,-2658834
1650696627,196405,true,2955736317,28,2952782205,-2954112
1650697219,196405,true,2955736317,28,2952486957,-3249360
1650697395,196407,true,2955145258,28,2952486957,-2658301
1650698634,196406,true,2955440772,28,2952486957,-2953815
1650699464,196406,true,2955440772,28,2952486957,-2953815
1650699748,196407,true,2955145258,28,2952486957,-2658301
1650699810,196409,true,2954554318,28,2952486957,-2067361
1650699921,196407,true,2955145258,28,2952486957,-2658301
1650701781,196408,true,2954849773,28,2952486957,-2362816
1650702393,196408,true,2954849773,28,2952486957,-2362816
1650702700,196410,true,2954258892,28,2952486957,-1771935
1650702772,196409,true,2954554318,28,2952782205,-1772113
1650702862,196410,true,2954258892,28,2952782205,-1476687
1650702993,196410,true,2954258892,28,2953372791,-886101
1650703138,196412,true,2953668128,28,2953963495,295367
1650703194,196411,true,2953963495,28,2954258892,295397
1650704146,196412,true,2953668128,28,2958397544,4729416
1650704168,196412,true,2953668128,28,2958693383,5025255
1650704906,196414,true,2953077483,28,2960765090,7687607
1650707484,196413,true,2953372791,28,2960765090,7392299
1650707772,196413,true,2953372791,28,2960765090,7392299
1650708677,196413,true,2953372791,28,2960469043,7096252
1650708691,196415,true,2952782205,28,2960173026,7390821
1650708936,196413,true,2953372791,28,2960173026,6800235
1650711935,196414,true,2953077483,28,2959877038,6799555
1650712715,196414,true,2953077483,28,2959877038,6799555
1650713790,196415,true,2952782205,28,2959877038,7094833
1650714750,196414,true,2953077483,28,2960469043,7391560
1650714849,196414,true,2953077483,28,2960469043,7391560
1650715052,196414,true,2953077483,28,2960469043,7391560
1650715710,196416,true,2952486957,28,2960469043,7982086
1650715835,196414,true,2953077483,28,2960469043,7391560
1650715942,196415,true,2952782205,28,2960469043,7686838
1650716954,196414,true,2953077483,28,2957805953,4728470
1650716971,196415,true,2952782205,28,2957805953,5023748
1650717028,196413,true,2953372791,28,2957805953,4433162
1650717076,196413,true,2953372791,28,2957805953,4433162
1650717357,196412,true,2953668128,28,2958397544,4729416
1650717896,196413,true,2953372791,28,2959285152,5912361
1650718534,196412,true,2953668128,28,2961061167,7393039
1650721228,196412,true,2953668128,28,2961357273,7689145
1650721691,196412,true,2953668128,28,2961357273,7689145
1650721792,196413,true,2953372791,28,2961357273,7984482
1650722066,196412,true,2953668128,28,2961357273,7689145
1650722323,196412,true,2953668128,28,2961357273,7689145
1650723014,196411,true,2953963495,28,2961357273,7393778
1650723149,196412,true,2953668128,28,2961357273,7689145
1650724397,196411,true,2953963495,28,2961357273,7393778
1650725535,196411,true,2953963495,28,2961357273,7393778
1650726073,196410,true,2954258892,28,2961357273,7098381
1650726759,196412,true,2953668128,28,2961357273,7689145
1650729295,196411,true,2953963495,28,2961653408,7689913
1650730186,196411,true,2953963495,28,2961653408,7689913
1650730236,196410,true,2954258892,28,2961949574,7690682
1650730475,196412,true,2953668128,28,2962838248,9170120
1650731414,196410,true,2954258892,28,2967879104,13620212
1650731795,196410,true,2954258892,28,2969957243,15698351
1650733153,196410,true,2954258892,28,2971442518,17183626
1650733181,196411,true,2953963495,28,2971442518,17479023
1650733391,196409,true,2954554318,28,2971442518,16888200
1650733414,196409,true,2954554318,28,2971442518,16888200
1650734203,196409,true,2954554318,28,2969660277,15105959
1650734952,196410,true,2954258892,28,2966988918,12730026
1650736046,196409,true,2954554318,28,2964912857,10358539
1650737095,196409,true,2954554318,28,2964616395,10062077
1650737267,196409,true,2954554318,28,2964616395,10062077
1650739020,196410,true,2954258892,28,2964023561,9764669
1650739027,196409,true,2954554318,28,2964023561,9469243
1650739248,196409,true,2954554318,28,2963134531,8580213
1650739263,196408,true,2954849773,28,2963134531,8284758
1650739780,196410,true,2954258892,28,2961357273,7098381
1650740210,196408,true,2954849773,28,2959877038,5027265
1650740464,196408,true,2954849773,28,2958693383,3843610
1650740761,196408,true,2954849773,28,2957214480,2364707
1650742466,196410,true,2954258892,28,2953668128,-590764
1650742629,196408,true,2954849773,28,2953372791,-1476982
1650743388,196407,true,2955145258,28,2953372791,-1772467
1650743429,196406,true,2955440772,28,2953668128,-1772644
1650745068,196406,true,2955440772,28,2954258892,-1181880
1650745918,196404,true,2956031890,28,2954258892,-1772998
1650746450,196404,true,2956031890,28,2954554318,-1477572
1650746762,196403,true,2956327493,28,2954849773,-1477720
1650747240,196403,true,2956327493,28,2955145258,-1182235
1650747355,196402,true,2956623126,28,2955440772,-1182354
1650748316,196401,true,2956918788,28,2956031890,-886898
1650748737,196401,true,2956918788,28,2956031890,-886898
1650749129,196401,true,2956918788,28,2956327493,-591295
1650749632,196400,true,2957214480,28,2956918788,-295692
1650749839,196399,true,2957510202,28,2956918788,-591414
1650750857,196399,true,2957510202,28,2958101733,591531
1650750908,196399,true,2957510202,28,2958397544,887342
1650753707,196398,true,2957805953,28,2960173026,2367073
1650755295,196397,true,2958101733,28,2960173026,2071293
1650755519,196397,true,2958101733,28,2960173026,2071293
1650756138,196397,true,2958101733,28,2960173026,2071293
1650756659,196396,true,2958397544,28,2958989253,591709
1650756678,196396,true,2958397544,28,2958989253,591709
1650756785,196395,true,2958693383,28,2958693383,0
1650756869,196396,true,2958397544,28,2958397544,0
1650756884,196395,true,2958693383,28,2958101733,-591650
1650756902,196395,true,2958693383,28,2958101733,-591650
1650757361,196397,true,2958101733,28,2950716084,-7385649
1650757501,196398,true,2957805953,28,2948356573,-9449380
1650758050,196397,true,2958101733,28,2940407145,-17694588
1650758972,196397,true,2958101733,28,2933065674,-25036059
1650759080,196399,true,2957510202,28,2933065674,-24444528
1650759352,196400,true,2957214480,28,2933358981,-23855499
1650759489,196400,true,2957214480,28,2933358981,-23855499
1650760019,196400,true,2957214480,28,2933652317,-23562163
1650760044,196401,true,2956918788,28,2933652317,-23266471
1650760777,196402,true,2956623126,28,2935412948,-21210178
1650761401,196402,true,2956623126,28,2936880948,-19742178
1650761421,196401,true,2956918788,28,2936880948,-20037840
1650762403,196403,true,2956327493,28,2937468354,-18859139
1650762647,196404,true,2956031890,28,2937468354,-18563536
1650765449,196404,true,2956031890,28,2937174636,-18857254
1650765483,196403,true,2956327493,28,2937174636,-19152857
1650766644,196405,true,2955736317,28,2934532501,-21203816
1650766907,196406,true,2955440772,28,2933945682,-21495090
1650767081,196406,true,2955440772,28,2933652317,-21788455
1650767535,196406,true,2955440772,28,2933358981,-22081791
1650768098,196407,true,2955145258,28,2933358981,-21786277
1650768731,196409,true,2954554318,28,2933358981,-21195337
1650769098,196408,true,2954849773,28,2933358981,-21490792
1650769450,196408,true,2954849773,28,2933358981,-21490792
1650769681,196410,true,2954258892,28,2933652317,-20606575
1650769810,196411,true,2953963495,28,2933652317,-20311178
1650769931,196411,true,2953963495,28,2933945682,-20017813
1650769950,196411,true,2953963495,28,2933945682,-20017813
1650770248,196413,true,2953372791,28,2934532501,-18840290
1650770461,196414,true,2953077483,28,2935119436,-17958047
1650770491,196414,true,2953077483,28,2935119436,-17958047
1650770589,196414,true,2953077483,28,2935706490,-17370993
1650770761,196415,true,2952782205,28,2936587290,-16194915
1650771127,196416,true,2952486957,28,2938643518,-13843439
1650771128,196416,true,2952486957,28,2938643518,-13843439
1650771200,196416,true,2952486957,28,2939231276,-13255681
1650771219,196417,true,2952191737,28,2939525199,-12666538
1650771265,196418,true,2951896548,28,2939819151,-12077397
1650771508,196418,true,2951896548,28,2941877642,-10018906
1650771559,196417,true,2952191737,28,2942171830,-10019907
1650771631,196418,true,2951896548,28,2942760294,-9136254
1650772040,196419,true,2951601388,28,2945998949,-5602439
1650772170,196419,true,2951601388,28,2946882837,-4718551
1650772198,196418,true,2951896548,28,2946882837,-5013711
1650773984,196419,true,2951601388,28,2951011156,-590232
1650774020,196420,true,2951306257,28,2951011156,-295101
1650774298,196419,true,2951601388,28,2951011156,-590232
1650774449,196419,true,2951601388,28,2951011156,-590232
1650776896,196421,true,2951011156,28,2951011156,0
1650776960,196421,true,2951011156,28,2951011156,0
1650777280,196421,true,2951011156,28,2951011156,0
1650778149,196420,true,2951306257,28,2951011156,-295101
1650778678,196422,true,2950716084,28,2951011156,295072
1650779642,196423,true,2950421042,28,2951011156,590114
1650779710,196422,true,2950716084,28,2951011156,295072
1650780238,196421,true,2951011156,28,2951011156,0
1650780373,196423,true,2950421042,28,2951011156,590114
1650781223,196424,true,2950126030,28,2951011156,885126
1650781291,196423,true,2950421042,28,2951011156,590114
1650781799,196423,true,2950421042,28,2951011156,590114
1650782631,196424,true,2950126030,28,2951011156,885126
1650782765,196425,true,2949831046,28,2951011156,1180110
1650783024,196425,true,2949831046,28,2951011156,1180110
1650783995,196424,true,2950126030,28,2950716084,590054
1650784119,196426,true,2949536093,28,2950716084,1179991
1650784348,196426,true,2949536093,28,2950716084,1179991
1650784816,196427,true,2949241169,28,2950716084,1474915
1650784848,196426,true,2949536093,28,2950716084,1179991
1650785140,196428,true,2948946274,28,2950716084,1769810
1650786001,196429,true,2948651409,28,2950716084,2064675
1650786349,196429,true,2948651409,28,2950716084,2064675
1650786361,196429,true,2948651409,28,2950716084,2064675
1650787340,196430,true,2948356573,28,2950716084,2359511
1650787407,196431,true,2948061767,28,2950716084,2654317
1650787525,196431,true,2948061767,28,2950716084,2654317
1650787875,196431,true,2948061767,28,2950716084,2654317
1650788062,196432,true,2947766990,28,2950716084,2949094
1650788203,196432,true,2947766990,28,2950716084,2949094
1650788419,196433,true,2947472243,28,2950716084,3243841
1650788686,196432,true,2947766990,28,2950716084,2949094
1650788739,196434,true,2947177525,28,2950716084,3538559
1650789215,196433,true,2947472243,28,2950716084,3243841
1650789440,196433,true,2947472243,28,2950716084,3243841
1650789554,196433,true,2947472243,28,2950716084,3243841
1650789646,196434,true,2947177525,28,2950716084,3538559
1650789748,196434,true,2947177525,28,2950716084,3538559
1650789784,196434,true,2947177525,28,2950716084,3538559
1650789883,196433,true,2947472243,28,2950716084,3243841
1650789944,196435,true,2946882837,28,2950716084,3833247
1650790219,196434,true,2947177525,28,2950716084,3538559
1650790401,196434,true,2947177525,28,2950716084,3538559
1650790475,196434,true,2947177525,28,2950716084,3538559
1650790579,196435,true,2946882837,28,2950716084,3833247
1650791292,196435,true,2946882837,28,2950716084,3833247
1650791302,196435,true,2946882837,28,2950716084,3833247
1650791386,196434,true,2947177525,28,2950716084,3538559
1650791533,196436,true,2946588178,28,2950716084,4127906
1650792469,196435,true,2946882837,28,2950716084,3833247
1650792510,196435,true,2946882837,28,2950716084,3833247
1650795050,196435,true,2946882837,28,2950716084,3833247
1650796069,196437,true,2946293549,28,2950716084,4422535
1650796136,196436,true,2946588178,28,2950716084,4127906
1650796828,196437,true,2946293549,28,2950716084,4422535
1650797920,196436,true,2946588178,28,2950716084,4127906
1650799671,196438,true,2945998949,28,2950716084,4717135
1650799735,196437,true,2946293549,28,2950716084,4422535
1650799763,196438,true,2945998949,28,2950716084,4717135
1650801710,196438,true,2945998949,28,2943054570,-2944379
1650803847,196440,true,2945409838,28,2941289355,-4120483
1650804712,196439,true,2945704379,28,2940701185,-5003194
1650805554,196439,true,2945704379,28,2940113133,-5591246
1650805586,196439,true,2945704379,28,2939819151,-5885228
1650807102,196439,true,2945704379,28,2935706490,-9997889
1650807660,196439,true,2945704379,28,2934825954,-10878425
1650807924,196439,true,2945704379,28,2934825954,-10878425
1650808302,196439,true,2945704379,28,2935119436,-10584943
1650809009,196439,true,2945704379,28,2936000060,-9704319
1650810367,196438,true,2945998949,28,2936880948,-9118001
1650810737,196438,true,2945998949,28,2936880948,-9118001
1650810768,196438,true,2945998949,28,2936587290,-9411659
1650810784,196439,true,2945704379,28,2936587290,-9117089
1650811258,196439,true,2945704379,28,2932479149,-13225230
1650811273,196440,true,2945409838,28,2932479149,-12930689
1650811360,196440,true,2945409838,28,2932185931,-13223907
1650811804,196440,true,2945409838,28,2931599581,-13810257
1650811820,196440,true,2945409838,28,2931599581,-13810257
1650811886,196440,true,2945409838,28,2931599581,-13810257
1650813419,196439,true,2945704379,28,2945704379,0
1650814914,196439,true,2945704379,28,2946588178,883799
1650815243,196438,true,2945998949,28,2946293549,294600
1650815341,196439,true,2945704379,28,2945998949,294570
1650817929,196438,true,2945998949,28,2943643210,-2355739
1650818206,196437,true,2946293549,28,2943643210,-2650339
1650818222,196437,true,2946293549,28,2943643210,-2650339
1650818562,196438,true,2945998949,28,2942760294,-3238655
1650818851,196437,true,2946293549,28,2941877642,-4415907
1650819053,196437,true,2946293549,28,2941289355,-5004194
1650819210,196437,true,2946293549,28,2940113133,-6180416
1650819249,196437,true,2946293549,28,2939819151,-6474398
1650819281,196437,true,2946293549,28,2939525199,-6768350
1650819339,196437,true,2946293549,28,2939231276,-7062273
1650819758,196436,true,2946588178,28,2938937382,-7650796
1650819905,196437,true,2946293549,28,2938937382,-7356167
1650819910,196437,true,2946293549,28,2938937382,-7356167
1650820065,196437,true,2946293549,28,2938643518,-7650031
1650820351,196437,true,2946293549,28,2937762101,-8531448
1650820509,196438,true,2945998949,28,2937468354,-8530595
1650820546,196438,true,2945998949,28,2937174636,-8824313
1650820961,196439,true,2945704379,28,2936587290,-9117089
1650820986,196439,true,2945704379,28,2936587290,-9117089
1650821050,196440,true,2945409838,28,2936587290,-8822548
1650821671,196440,true,2945409838,28,2932479149,-12930689
1650821994,196441,true,2945115326,28,2931013349,-14101977
1650823238,196441,true,2945115326,28,2928669594,-16445732
1650823874,196443,true,2944526391,28,2928376756,-16149635
1650824665,196443,true,2944526391,28,2929255357,-15271034
1650824781,196444,true,2944231968,28,2929548282,-14683686
1650824802,196444,true,2944231968,28,2929548282,-14683686
1650824967,196445,true,2943937574,28,2930134221,-13803353
1650826084,196445,true,2943937574,28,2936293660,-7643914
1650826637,196445,true,2943937574,28,2939231276,-4706298
1650826678,196445,true,2943937574,28,2939231276,-4706298
1650826749,196446,true,2943643210,28,2939525199,-4118011
1650826812,196446,true,2943643210,28,2939819151,-3824059
1650826850,196446,true,2943643210,28,2939819151,-3824059
1650826870,196446,true,2943643210,28,2940113133,-3530077
1650826877,196447,true,2943348875,28,2940113133,-3235742
1650826915,196446,true,2943643210,28,2940407145,-3236065
1650827036,196445,true,2943937574,28,2941877642,-2059932
1650831155,196445,true,2943937574,28,2958989253,15051679
1650831724,196446,true,2943643210,28,2957805953,14162743
1650832743,196445,true,2943937574,28,2954258892,10321318
1650832849,196445,true,2943937574,28,2953963495,10025921
1650832872,196445,true,2943937574,28,2953963495,10025921
1650833688,196446,true,2943643210,28,2952486957,8843747
1650833972,196445,true,2943937574,28,2952191737,8254163
1650834142,196445,true,2943937574,28,2951601388,7663814
1650834886,196445,true,2943937574,28,2949831046,5893472
1650835548,196446,true,2943643210,28,2948061767,4418557
1650837084,196445,true,2943937574,28,2947177525,3239951
1650837274,196445,true,2943937574,28,2947177525,3239951
1650837847,196445,true,2943937574,28,2947177525,3239951
1650837947,196447,true,2943348875,28,2947177525,3828650
1650839577,196446,true,2943643210,28,2943054570,-588640
1650840154,196446,true,2943643210,28,2942760294,-882916
1650840261,196446,true,2943643210,28,2942760294,-882916
1650840351,196448,true,2943054570,28,2942466047,-588523
1650840501,196447,true,2943348875,28,2941877642,-1471233
1650840897,196448,true,2943054570,28,2940113133,-2941437
1650841629,196448,true,2943054570,28,2936880948,-6173622
1650841726,196449,true,2942760294,28,2936293660,-6466634
1650841750,196449,true,2942760294,28,2936293660,-6466634
1650841768,196450,true,2942466047,28,2936293660,-6172387
1650842301,196450,true,2942466047,28,2934239077,-8226970
1650842309,196452,true,2941877642,28,2934239077,-7638565
1650842368,196451,true,2942171830,28,2934239077,-7932753
1650844315,196452,true,2941877642,28,2929548282,-12329360
1650844567,196453,true,2941583484,28,2929548282,-12035202
1650845047,196454,true,2941289355,28,2929255357,-12033998
1650845325,196454,true,2941289355,28,2928083947,-13205408
1650845351,196455,true,2940995255,28,2928083947,-12911308
1650845432,196456,true,2940701185,28,2927205698,-13495487
1650845511,196458,true,2940113133,28,2926327712,-13785421
1650845656,196459,true,2939819151,28,2924864987,-14954164
1650846051,196460,true,2939525199,28,2919605228,-19919971
1650846143,196461,true,2939231276,28,2918437678,-20793598
1650846163,196463,true,2938643518,28,2918145863,-20497655
1650846222,196464,true,2938349683,28,2916978897,-21370786
1650846236,196466,true,2937762101,28,2916687228,-21074873
1650846255,196468,true,2937174636,28,2916395588,-20779048
1650846267,196471,true,2936293660,28,2915812397,-20481263
1650846285,196473,true,2935706490,28,2915520845,-20185645
1650846381,196476,true,2934825954,28,2912315695,-22510259
1650846418,196478,true,2934239077,28,2911151060,-23088017
1650846446,196481,true,2933358981,28,2910277889,-23081092
1650846622,196482,true,2933065674,28,2905044362,-28021312
1650846788,196485,true,2932185931,28,2900110229,-32075702
1650846913,196487,true,2931599581,28,2896922021,-34677560
1650847561,196490,true,2930720277,28,2883050806,-47669471
1650847726,196491,true,2930427235,28,2880457357,-49969878
1650847801,196493,true,2929841237,28,2879017561,-50823676
1650848069,196495,true,2929255357,28,2875277457,-53977900
1650848086,196498,true,2928376756,28,2875277457,-53099299
1650848394,196500,true,2927791168,28,2873840249,-53950919
1650848423,196502,true,2927205698,28,2873552894,-53652804
1650848714,196505,true,2926327712,28,2870106871,-56220841
1650848992,196508,true,2925449989,28,2866378342,-59071647
1650850644,196510,true,2924864987,28,2853794611,-71070376
1650850772,196512,true,2924280102,28,2854079991,-70200111
1650850963,196515,true,2923402993,28,2854936300,-68466693
1650851114,196518,true,2922526147,28,2855221794,-67304353
1650851118,196519,true,2922233924,28,2855221794,-67012130
1650851195,196521,true,2921649565,28,2855507316,-66142249
1650851330,196523,true,2921065323,28,2856078446,-64986877
1650851451,196525,true,2920481197,28,2856649690,-63831507
1650851794,196527,true,2919897189,28,2858078301,-61818888
1650853418,196529,true,2919313297,28,2862654657,-56658640
1650853986,196532,true,2918437678,28,2862654657,-55783021
1650854038,196534,true,2917854078,28,2862654657,-55199421
1650854541,196537,true,2916978897,28,2862654657,-54324240
1650854606,196540,true,2916103978,28,2862654657,-53449321
1650854672,196542,true,2915520845,28,2862654657,-52866188
1650854911,196544,true,2914937828,28,2862654657,-52283171
1650854943,196547,true,2914063521,28,2862654657,-51408864
1650856252,196550,true,2913189477,28,2861509882,-51679595
1650856369,196553,true,2912315695,28,2861509882,-50805813
1650856488,196555,true,2911733319,28,2861509882,-50223437
1650856557,196557,true,2911151060,28,2861509882,-49641178
1650856689,196559,true,2910568917,28,2861796033,-48772884
1650856768,196561,true,2909986891,28,2862082212,-47904679
1650856813,196563,true,2909404981,28,2862368421,-47036560
1650858217,196565,true,2908823187,28,2870106871,-38716316
1650858252,196566,true,2908532334,28,2870393881,-38138453
1650858952,196570,true,2907369212,28,2871255086,-36114126
1650859055,196572,true,2906787825,28,2871255086,-35532739
1650859355,196573,true,2906497175,28,2871255086,-35242089
1650859452,196575,true,2905915963,28,2871255086,-34660877
1650859668,196578,true,2905044362,28,2871255086,-33789276
1650860029,196580,true,2904463441,28,2871255086,-33208355
1650860146,196581,true,2904173023,28,2871255086,-32917937
1650860555,196583,true,2903592276,28,2871542211,-32050065
1650862032,196586,true,2902721372,28,2871542211,-31179161
1650863290,196587,true,2902431129,28,2871255086,-31176043
1650863329,196588,true,2902140915,28,2871255086,-30885829
1650864120,196590,true,2901560574,28,2868959115,-32601459
1650864225,196593,true,2900690280,28,2868672248,-32018032
1650864349,196595,true,2900110229,28,2868385409,-31724820
1650865318,196596,true,2899820247,28,2866091733,-33728514
1650865567,196598,true,2899240370,28,2866091733,-33148637
1650865792,196601,true,2898370772,28,2865805152,-32565620
1650865862,196603,true,2897791184,28,2865805152,-31986032
1650865867,196605,true,2897211713,28,2865805152,-31406561
1650866638,196608,true,2896342723,28,2861223759,-35118964
1650866758,196611,true,2895473994,28,2860365564,-35108430
1650867144,196613,true,2894894986,28,2857506771,-37388215
1650867148,196616,true,2894026692,28,2857506771,-36519921
1650867736,196619,true,2893158657,28,2851227480,-41931177
1650867879,196623,true,2892001683,28,2850087274,-41914409
1650867908,196626,true,2891134256,28,2849802294,-41331962
1650867937,196629,true,2890267089,28,2849517342,-40749747
1650867967,196634,true,2888822389,28,2849232419,-39589970
1650868009,196637,true,2887955916,28,2849232419,-38723497
1650869043,196640,true,2887089702,28,2845815561,-41274141
1650869138,196643,true,2886223748,28,2845815561,-40408187
1650869180,196647,true,2885069547,28,2845815561,-39253986
1650869214,196650,true,2884204200,28,2845815561,-38388639
1650869249,196653,true,2883339111,28,2845815561,-37523550
1650869437,196656,true,2882474283,28,2845815561,-36658722
1650869446,196661,true,2881033478,28,2845815561,-35217917
1650869536,196664,true,2880169341,28,2845531008,-34638333
1650869627,196666,true,2879593393,28,2845246483,-34346910
1650869664,196670,true,2878441844,28,2844961987,-33479857
1650869728,196674,true,2877290755,28,2844961987,-32328768
1650869839,196678,true,2876140126,28,2844108669,-32031457
1650869875,196680,true,2875564984,28,2843539933,-32025051
1650869945,196683,true,2874702487,28,2842971310,-31731177
1650870051,196689,true,2872978269,28,2841550251,-31428018
1650870092,196692,true,2872116548,28,2840982026,-31134522
1650870146,196695,true,2871255086,28,2840413915,-30841171
1650870163,196698,true,2870393881,28,2840129902,-30263979
1650870230,196703,true,2868959115,28,2838994134,-29964981
1650870263,196706,true,2868098599,28,2838426420,-29672179
1650870299,196709,true,2867238342,28,2837858820,-29379522
1650870336,196713,true,2866091733,28,2837007633,-29084100
1650870449,196719,true,2864372680,28,2834455602,-29917078
1650870468,196722,true,2863513540,28,2833888796,-29624744
1650870513,196725,true,2862654657,28,2833038799,-29615858
1650871505,196728,true,2861796033,28,2814966149,-46829884
1650871633,196733,true,2860365564,28,2813559088,-46806476
1650872056,196737,true,2859221704,28,2811590384,-47631320
1650872992,196740,true,2858364109,28,2812433945,-45930164
1650873728,196743,true,2857506771,28,2812715189,-44791582
1650873768,196748,true,2856078446,28,2812715189,-43363257
1650874335,196751,true,2855221794,28,2812996460,-42225334
1650874665,196753,true,2854650835,28,2813277760,-41373075
1650874923,196755,true,2854079991,28,2812996460,-41083531
1650875893,196760,true,2852653379,28,2811871543,-40781836
1650875990,196763,true,2851797754,28,2811871543,-39926211
1650876407,196765,true,2851227480,28,2811871543,-39355937
1650876445,196767,true,2850657320,28,2811590384,-39066936
1650876818,196771,true,2849517342,28,2811028150,-38489192
1650878267,196773,true,2848947524,28,2808780339,-40167185
1650878490,196775,true,2848377820,28,2808780339,-39597481
1650878993,196776,true,2848093010,28,2808218667,-39874343
1650879025,196779,true,2847238753,28,2808218667,-39020086
1650879146,196781,true,2846669391,28,2808218667,-38450724
1650879165,196783,true,2846100143,28,2808499489,-37600654
1650879167,196784,true,2845815561,28,2808499489,-37316072
1650879179,196787,true,2844961987,28,2808499489,-36462498
1650879279,196789,true,2844393080,28,2808780339,-35612741
1650879322,196790,true,2844108669,28,2809061217,-35047452
1650879332,196791,true,2843824287,28,2809061217,-34763070
1650879462,196794,true,2842971310,28,2809904020,-33067290
1650879616,196796,true,2842402801,28,2810747075,-31655726
1650879698,196797,true,2842118589,28,2811309253,-30809336
1650879727,196797,true,2842118589,28,2811590384,-30528205
1650879772,196800,true,2841266124,28,2812152730,-29113394
1650880910,196800,true,2841266124,28,2823988016,-17278108
1650882130,196801,true,2840982026,28,2826530623,-14451403
1650882368,196801,true,2840982026,28,2826530623,-14451403
1650883085,196804,true,2840129902,28,2826247998,-13881904
1650883741,196804,true,2840129902,28,2826247998,-13881904
1650884516,196805,true,2839845917,28,2826247998,-13597919
1650884762,196805,true,2839845917,28,2826247998,-13597919
1650885183,196808,true,2838994134,28,2825682833,-13311301
1650885273,196808,true,2838994134,28,2825682833,-13311301
1650885771,196809,true,2838710263,28,2825117781,-13592482
1650885821,196809,true,2838710263,28,2825400293,-13309970
1650885848,196812,true,2837858820,28,2825682833,-12175987
1650885872,196812,true,2837858820,28,2825682833,-12175987
1650885976,196812,true,2837858820,28,2826530623,-11328197
1650887001,196812,true,2837858820,28,2835873113,-1985707
1650887219,196815,true,2837007633,28,2838142606,1134973
1650887285,196815,true,2837007633,28,2838710263,1702630
1650887322,196815,true,2837007633,28,2838994134,1986501
1650887333,196815,true,2837007633,28,2839278033,2270400
1650887338,196817,true,2836440316,28,2839278033,2837717
1650887357,196817,true,2836440316,28,2839561961,3121645
1650887837,196816,true,2836723960,28,2845815561,9091601
1650887987,196815,true,2837007633,28,2846954058,9946425
1650888216,196818,true,2836156700,28,2848662658,12505958
1650889010,196818,true,2836156700,28,2854936300,18779600
1650889150,196817,true,2836440316,28,2855792867,19352551
1650889339,196817,true,2836440316,28,2856078446,19638130
1650889361,196820,true,2835589554,28,2856078446,20488892
1650889972,196819,true,2835873113,28,2858649945,22776832
1650890383,196818,true,2836156700,28,2860365564,24208864
1650891914,196818,true,2836156700,28,2861796033,25639333
1650892994,196821,true,2835306024,28,2860365564,25059540
1650893448,196821,true,2835306024,28,2860079556,24773532
1650893496,196819,true,2835873113,28,2859793577,23920464
1650893697,196820,true,2835589554,28,2858935810,23346256
1650893788,196823,true,2834739047,28,2858649945,23910898
1650893819,196823,true,2834739047,28,2858649945,23910898
1650893823,196822,true,2835022521,28,2858649945,23627424
1650894303,196819,true,2835873113,28,2864086271,28213158
1650894351,196822,true,2835022521,28,2864659117,29636596
1650894720,196822,true,2835022521,28,2867811818,32789297
1650895083,196820,true,2835589554,28,2870680921,35091367
1650895095,196818,true,2836156700,28,2870680921,34524221
1650895182,196821,true,2835306024,28,2871255086,35949062
1650895197,196821,true,2835306024,28,2871255086,35949062
1650895241,196820,true,2835589554,28,2871542211,35952657
1650895320,196818,true,2836156700,28,2871829365,35672665
1650896405,196821,true,2835306024,28,2864372680,29066656
1650896511,196820,true,2835589554,28,2863513540,27923986
1650896733,196819,true,2835873113,28,2860937666,25064553
1650896943,196818,true,2836156700,28,2859221704,23065004
1650896945,196820,true,2835589554,28,2859221704,23632150
1650896966,196819,true,2835873113,28,2858935810,23062697
1650897011,196817,true,2836440316,28,2858935810,22495494
1650897017,196815,true,2837007633,28,2858935810,21928177
1650897092,196817,true,2836440316,28,2858935810,22495494
1650897117,196816,true,2836723960,28,2859221704,22497744
1650897306,196814,true,2837291333,28,2861223759,23932426
1650897335,196812,true,2837858820,28,2861509882,23651062
1650897422,196813,true,2837575062,28,2862654657,25079595
1650897463,196812,true,2837858820,28,2863227217,25368397
1650897965,196809,true,2838710263,28,2871255086,32544823
1650898304,196806,true,2839561961,28,2876715383,37153422
1650898360,196807,true,2839278033,28,2877578484,38300451
1650898435,196806,true,2839561961,28,2878729688,39167727
1650898656,196803,true,2840413915,28,2881609713,41195798
1650899146,196801,true,2840982026,28,2884204200,43222174
1650899563,196802,true,2840697956,28,2882186064,41488108
1650901612,196800,true,2841266124,28,2881321581,40055457
1650901767,196797,true,2842118589,28,2881321581,39202992
1650901876,196795,true,2842687041,28,2881033478,38346437
1650902063,196795,true,2842687041,28,2880457357,37770316
1650902113,196794,true,2842971310,28,2880169341,37198031
1650902170,196791,true,2843824287,28,2880169341,36345054
1650903046,196788,true,2844677519,28,2875564984,30887465
1650903139,196789,true,2844393080,28,2875277457,30884377
1650903206,196787,true,2844961987,28,2875277457,30315470
1650903223,196784,true,2845815561,28,2874989958,29174397
1650903275,196780,true,2846954058,28,2874989958,28035900
1650903291,196780,true,2846954058,28,2874989958,28035900
1650903292,196778,true,2847523477,28,2874989958,27466481
1650903360,196774,true,2848662658,28,2875564984,26902326
1650903410,196770,true,2849802294,28,2875852541,26050247
1650903668,196770,true,2849802294,28,2878441844,28639550
1650903723,196768,true,2850372282,28,2879305463,28933181
1650903785,196763,true,2851797754,28,2879881352,28083598
1650903851,196760,true,2852653379,28,2881033478,28380099
1650904009,196758,true,2853223938,28,2883627445,30403507
1650904036,196756,true,2853794611,28,2884204200,30409589
1650904390,196752,true,2854936300,28,2890556116,35619816
1650904559,196748,true,2856078446,28,2893737318,37658872
1650904599,196747,true,2856364054,28,2894605526,38241472
1650905000,196744,true,2857221049,28,2902721372,45500323
1650905373,196739,true,2858649945,28,2909114069,50464124
1650905466,196735,true,2859793577,28,2910568917,50775340
1650905681,196733,true,2860365564,28,2913189477,52823913
1650906712,196730,true,2861223759,28,2923695333,62471574
1650906744,196724,true,2862940923,28,2924280102,61339179
1650906964,196720,true,2864086271,28,2925449989,61363718
1650910120,196718,true,2864659117,28,2931892741,67233624
1650910982,196714,true,2865805152,28,2931892741,66087589
1650911583,196709,true,2867238342,28,2930720277,63481935
1650911635,196705,true,2868385409,28,2930720277,62334868
1650911657,196703,true,2868959115,28,2930427235,61468120
1650911880,196700,true,2869819889,28,2930427235,60607346
1650912333,196694,true,2871542211,28,2932185931,60643720
1650912355,196690,true,2872691000,28,2932185931,59494931
1650912358,196688,true,2873265567,28,2932185931,58920364
1650912385,196686,true,2873840249,28,2932479149,58638900
1650912420,196679,true,2875852541,28,2932772397,56919856
1650912490,196674,true,2877290755,28,2933652317,56361562
1650912512,196672,true,2877866242,28,2933945682,56079440
1650912695,196669,true,2878729688,28,2937174636,58444948
1650912726,196662,true,2880745403,28,2938055877,57310474
1650912862,196657,true,2882186064,28,2940995255,58809191
1650912874,196655,true,2882762530,28,2941289355,58526825
1650913196,196651,true,2883915808,28,2949241169,65325361
1650913236,196644,true,2885935155,28,2950126030,64190875
1650913436,196639,true,2887378411,28,2954849773,67471362
1650913619,196637,true,2887955916,28,2958397544,70441628
1650913820,196634,true,2888822389,28,2961653408,72831019
1650914003,196627,true,2890845171,28,2964319963,73474792
1650914414,196622,true,2892290883,28,2966988918,74698035
1650914419,196620,true,2892869370,28,2966988918,74119548
1650914515,196617,true,2893737318,28,2967285617,73548299
1650914523,196611,true,2895473994,28,2967285617,71811623
1650914552,196606,true,2896922021,28,2967285617,70363596
1650914586,196605,true,2897211713,28,2967285617,70073904
1650914961,196601,true,2898370772,28,2966988918,68618146
1650915012,196595,true,2900110229,28,2966988918,66878689
1650915028,196590,true,2901560574,28,2967285617,65725043
1650915058,196589,true,2901850730,28,2967285617,65434887
1650915128,196584,true,2903301946,28,2967879104,64577158
1650915225,196579,true,2904753887,28,2968769557,64015670
1650915304,196575,true,2905915963,28,2969660277,63744314
1650915346,196573,true,2906497175,28,2970254238,63757063
1650915420,196568,true,2907950714,28,2971442518,63491804
1650915474,196563,true,2909404981,28,2972334040,62929059
1650915513,196558,true,2910859974,28,2973225830,62365856
1650915558,196555,true,2911733319,28,2973820505,62087186
1650915584,196551,true,2912898187,28,2974415298,61517111
1650915603,196546,true,2914354928,28,2974712740,60357812
1650915622,196541,true,2915812397,28,2975307712,59495315
1650915747,196537,true,2916978897,28,2978880046,61901149
1650916307,196533,true,2918145863,28,2993810996,75665133
1650916827,196528,true,2919605228,28,3004307167,84701939
1650916883,196522,true,2921357429,28,3004908059,83550630
1650916998,196519,true,2922233924,28,3006711454,84477530
1650917060,196514,true,2923695333,28,3007613558,83918225
1650917259,196509,true,2925157473,28,3009719519,84562046
1650918263,196506,true,2926035108,28,3011224680,85189572
1650918375,196503,true,2926913007,28,3011525802,84612795
1650918417,196498,true,2928376756,28,3011525802,83149046
1650918694,196492,true,2930134221,28,3011826955,81692734
1650919949,196489,true,2931013349,28,3007312827,76299478
1650919972,196487,true,2931599581,28,3007312827,75713246
1650920056,196482,true,2933065674,28,3006711454,73645780
1650920154,196476,true,2934825954,28,3006110202,71284248
1650920806,196473,true,2935706490,28,3003406055,67699565
1650921414,196469,true,2936880948,28,3001304512,64423564
1650923129,196465,true,2938055877,28,2999804309,61748432
1650923177,196459,true,2939819151,28,2999804309,59985158
1650923717,196456,true,2940701185,28,2999804309,59103124
1650924010,196452,true,2941877642,28,3000104290,58226648
1650924031,196447,true,2943348875,28,3000104290,56755415
1650924609,196441,true,2945115326,28,3002805464,57690138
1650924686,196438,true,2945998949,28,3003406055,57407106
1650925138,196434,true,2947177525,28,3007312827,60135302
1650925252,196429,true,2948651409,28,3008515932,59864523
1650928073,196424,true,2950126030,28,3015141622,65015592
1650928112,196422,true,2950716084,28,3015141622,64425538
1650929464,196418,true,2951896548,28,3014237260,62340712
1650929523,196413,true,2953372791,28,3014237260,60864469
1650929756,196408,true,2954849773,28,3014237260,59387487
1650929768,196406,true,2955440772,28,3014237260,58796488
1650929780,196402,true,2956623126,28,3014237260,57614134
1650930018,196398,true,2957805953,28,3014237260,56431307
1650933357,196393,true,2959285152,28,3013634503,54349351
1650933624,196390,true,2960173026,28,3015443136,55270110
1650933800,196386,true,2961357273,28,3016347859,54990586
1650934035,196381,true,2962838248,28,3018459936,55621688
1650934166,196375,true,2964616395,28,3019365565,54749170
1650934293,196372,true,2965505869,28,3020271465,54765596
1650934910,196369,true,2966395610,28,3021479755,55084145
1650935728,196364,true,2967879104,28,3019667501,51788397
1650936995,196358,true,2969660277,28,3017252854,47592577
1650937154,196355,true,2970551264,28,3016951159,46399895
1650938282,196351,true,2971739663,28,3015141622,43401959
1650938419,196347,true,2972928537,28,3014538684,41610147
1650938444,196341,true,2974712740,28,3014538684,39825944
1650938463,196338,true,2975605243,28,3014538684,38933441
1650940560,196335,true,2976498014,28,3010321493,33823479
1650940620,196331,true,2977688792,28,3010321493,32632701
1650940670,196326,true,2979177934,28,3010321493,31143559
1650940713,196324,true,2979773799,28,3010321493,30547694
1650940810,196322,true,2980369784,28,3009719519,29349735
1650940855,196318,true,2981562111,28,3009418577,27856466
1650940938,196313,true,2983053190,28,3008816784,25763594
1650941249,196312,true,2983351495,28,3006410813,23059318
1650941704,196311,true,2983649830,28,3002805464,19155634
1650943214,196307,true,2984843469,28,2995907292,11063823
1650943390,196302,true,2986336189,28,2996206883,9870694
1650944254,196301,true,2986634823,28,2996506504,9871681
1650945748,196300,true,2986933487,28,2996506504,9573017
1650945914,196296,true,2988128439,28,2996506504,8378065
1650946520,196292,true,2989323870,28,2996506504,7182634
1650947872,196291,true,2989622802,28,2996506504,6883702
1650948188,196290,true,2989921765,28,2997105835,7184070
1650948349,196288,true,2990519779,28,2997405546,6885767
1650948776,196284,true,2991716166,28,2998304857,6588691
1650948865,196282,true,2992314539,28,2998604688,6290149
1650949402,196282,true,2992314539,28,3000404300,8089761
1650949499,196279,true,2993212323,28,3000704341,7492018
1650950241,196275,true,2994409788,28,3002204993,7795205
1650952299,196274,true,2994709229,28,3002805464,8096235
1650952459,196273,true,2995008700,28,3003105745,8097045
1650953807,196270,true,2995907292,28,3004607598,8700306
1650954147,196267,true,2996806154,28,3004908059,8101905
1650954405,196265,true,2997405546,28,3004908059,7502513
1650954439,196265,true,2997405546,28,3004908059,7502513
1650956073,196263,true,2998005057,28,3001604642,3599585
1650956214,196260,true,2998904548,28,3001604642,2700094
1650956779,196259,true,2999204439,28,3001304512,2100073
1650956788,196259,true,2999204439,28,3001304512,2100073
1650956929,196258,true,2999504359,28,3000404300,899941
1650956936,196256,true,3000104290,28,3000404300,300010
1650957093,196256,true,3000104290,28,2999204439,-899851
1650957128,196256,true,3000104290,28,2999204439,-899851
1650957169,196256,true,3000104290,28,2999204439,-899851
1650957209,196253,true,3001004411,28,2998904548,-2099863
1650957896,196253,true,3001004411,28,2997705286,-3299125
1650958218,196253,true,3001004411,28,2997105835,-3898576
1650958365,196252,true,3001304512,28,2996806154,-4498358
1650958667,196249,true,3002204993,28,2996806154,-5398839
1650959360,196249,true,3002204993,28,2998005057,-4199936
1650960525,196249,true,3002204993,28,2999504359,-2700634
1650960659,196248,true,3002505214,28,2999804309,-2700905
1650960697,196245,true,3003406055,28,2999804309,-3601746
1650961376,196245,true,3003406055,28,3001604642,-1801413
1650961956,196244,true,3003706396,28,3005208549,1502153
1650961993,196243,true,3004006766,28,3005208549,1201783
1650962219,196241,true,3004607598,28,3006410813,1803215
1650962295,196241,true,3004607598,28,3006711454,2103856
1650962806,196240,true,3004908059,28,3007914319,3006260
1650962841,196240,true,3004908059,28,3007914319,3006260
1650963022,196238,true,3005509070,28,3008215111,2706041
1650963105,196238,true,3005509070,28,3008215111,2706041
1650963910,196238,true,3005509070,28,3004607598,-901472
1650963979,196239,true,3005208549,28,3004307167,-901382
1650964724,196237,true,3005809621,28,3001904803,-3904818
1650966965,196238,true,3005509070,28,2999804309,-5704761
1650968725,196238,true,3005509070,28,2999804309,-5704761
1650970298,196238,true,3005509070,28,2999804309,-5704761
1650970455,196237,true,3005809621,28,2999804309,-6005312
1650970833,196238,true,3005509070,28,2999804309,-5704761
1650971052,196239,true,3005208549,28,2999804309,-5404240
1650971337,196240,true,3004908059,28,2999804309,-5103750
1650971616,196238,true,3005509070,28,2999204439,-6304631
1650972202,196239,true,3005208549,28,2998604688,-6603861
1650972231,196240,true,3004908059,28,2998604688,-6303371
1650972445,196241,true,3004607598,28,2998604688,-6002910
1650972660,196240,true,3004908059,28,2998604688,-6303371
1650974079,196241,true,3004607598,28,3000404300,-4203298
1650975044,196242,true,3004307167,28,3000404300,-3902867
1650975106,196243,true,3004006766,28,3000404300,-3602466
1650975180,196241,true,3004607598,28,3000404300,-4203298
1650975241,196241,true,3004607598,28,3000404300,-4203298
1650975528,196243,true,3004006766,28,3000404300,-3602466
1650975636,196243,true,3004006766,28,3000104290,-3902476
1650975710,196242,true,3004307167,28,3000104290,-4202877
1650976293,196242,true,3004307167,28,2999504359,-4802808
1650976337,196243,true,3004006766,28,2999504359,-4502407
1650976378,196244,true,3003706396,28,2999504359,-4202037
1650976467,196242,true,3004307167,28,2999504359,-4802808
1650976493,196242,true,3004307167,28,2999504359,-4802808
1650976675,196243,true,3004006766,28,2999804309,-4202457
1650976883,196243,true,3004006766,28,2999804309,-4202457
1650976910,196242,true,3004307167,28,2999804309,-4502858
1650977112,196242,true,3004307167,28,3000104290,-4202877
1650977187,196244,true,3003706396,28,3000104290,-3602106
1650977400,196245,true,3003406055,28,2999804309,-3601746
1650977445,196244,true,3003706396,28,2999804309,-3902087
1650977468,196244,true,3003706396,28,2999504359,-4202037
1650977507,196246,true,3003105745,28,2999504359,-3601386
1650977540,196248,true,3002505214,28,2999204439,-3300775
1650977571,196247,true,3002805464,28,2999204439,-3601025
1650977985,196248,true,3002505214,28,2996206883,-6298331
1650978010,196249,true,3002204993,28,2995907292,-6297701
1650978063,196251,true,3001604642,28,2995607732,-5996910
1650978512,196251,true,3001604642,28,2991417024,-10187618
1650979167,196251,true,3001604642,28,2985739012,-15865630
1650979172,196253,true,3001004411,28,2985739012,-15265399
1650979237,196255,true,3000404300,28,2985141954,-15262346
1650979254,196256,true,3000104290,28,2984843469,-15260821
1650979410,196257,true,2999804309,28,2983948195,-15856114
1650979504,196259,true,2999204439,28,2983053190,-16151249
1650979581,196260,true,2998904548,28,2982158453,-16746095
1650979965,196261,true,2998604688,28,2978880046,-19724642
1650980123,196263,true,2998005057,28,2977391053,-20614004
1650980258,196264,true,2997705286,28,2976200394,-21504892
1650980833,196266,true,2997105835,28,2969957243,-27148592
1650981321,196267,true,2996806154,28,2966395610,-30410544
1650981427,196269,true,2996206883,28,2965802419,-30404464
1650981478,196270,true,2995907292,28,2965209348,-30697944
1650981590,196272,true,2995308201,28,2964319963,-30988238
1650981612,196274,true,2994709229,28,2964023561,-30685668
1650981631,196276,true,2994110377,28,2963727188,-30383189
1650981660,196276,true,2994110377,28,2963430845,-30679532
1650981706,196279,true,2993212323,28,2962838248,-30374075
1650981736,196280,true,2992913032,28,2962541993,-30371039
1650981746,196282,true,2992314539,28,2962245769,-30068770
1650982446,196283,true,2992015338,28,2952782205,-39233133
1650982483,196285,true,2991417024,28,2952191737,-39225287
1650982558,196287,true,2990818831,28,2951011156,-39807675
1650982909,196289,true,2990220757,28,2943937574,-46283183
1650983429,196291,true,2989622802,28,2934239077,-55383725
1650983842,196294,true,2988726095,28,2929841237,-58884858
1650984004,196296,true,2988128439,28,2928376756,-59751683
1650984079,196298,true,2987530903,28,2927498419,-60032484
1650984102,196300,true,2986933487,28,2927498419,-59435068
1650984830,196303,true,2986037586,28,2921357429,-64680157
1650984902,196305,true,2985440468,28,2921065323,-64375145
1650984917,196308,true,2984545015,28,2921065323,-63479692
1650984957,196310,true,2983948195,28,2920773245,-63174950
1650985142,196314,true,2982754914,28,2919021395,-63733519
1650985196,196317,true,2981860267,28,2918145863,-63714404
1650985260,196319,true,2981263984,28,2917270595,-63993389
1650985272,196322,true,2980369784,28,2917270595,-63099189
1650985391,196327,true,2978880046,28,2915229322,-63650724
1650985540,196330,true,2977986561,28,2912606927,-65379634
1650985550,196333,true,2977093343,28,2912606927,-64486416
1650985775,196336,true,2976200394,28,2908241509,-67958885
1650985816,196340,true,2975010211,28,2907369212,-67640999
1650985838,196343,true,2974117887,28,2907078504,-67039383
1650985842,196346,true,2973225830,28,2907078504,-66147326
1650986194,196348,true,2972631274,28,2903592276,-69038998
1650986365,196352,true,2971442518,28,2901850730,-69591788
1650986490,196355,true,2970551264,28,2900690280,-69860984
1650986956,196357,true,2969957243,28,2897501434,-72455809
1650987656,196359,true,2969363340,28,2899530294,-69833046
1650987687,196363,true,2968175892,28,2899530294,-68645598
1650987692,196367,true,2966988918,28,2899530294,-67458624
1650987775,196369,true,2966395610,28,2899240370,-67155240
1650987777,196372,true,2965505869,28,2899240370,-66265499
1650988496,196376,true,2964319963,28,2895184476,-69135487
1650988545,196380,true,2963134531,28,2895184476,-67950055
1650988615,196382,true,2962541993,28,2894316094,-68225899
1650988640,196385,true,2961653408,28,2894026692,-67626716
1650988645,196391,true,2959877038,28,2894026692,-65850346
1650988678,196394,true,2958989253,28,2893447973,-65541280
1650988730,196398,true,2957805953,28,2892580112,-65225841
1650988791,196402,true,2956623126,28,2891423369,-65199757
1650988854,196407,true,2955145258,28,2890267089,-64878169
1650988859,196411,true,2953963495,28,2890267089,-63696406
1650988944,196416,true,2952486957,28,2888822389,-63664568
1650988952,196419,true,2951601388,28,2888533536,-63067852
1650988975,196425,true,2949831046,28,2887955916,-61875130
1650989002,196429,true,2948651409,28,2887378411,-61272998
1650989027,196434,true,2947177525,28,2886512371,-60665154
1650989079,196438,true,2945998949,28,2885069547,-60929402
1650989088,196444,true,2944231968,28,2884781069,-59450899
1650989170,196448,true,2943054570,28,2882474283,-60580287
1650989181,196453,true,2941583484,28,2882186064,-59397420
1650989290,196456,true,2940701185,28,2879305463,-61395722
1650989401,196462,true,2938937382,28,2876715383,-62221999
1650989467,196466,true,2937762101,28,2875277457,-62484644
1650989887,196470,true,2936587290,28,2867238342,-69348948
1650989973,196473,true,2935706490,28,2865518601,-70187889
1650990039,196479,true,2933945682,28,2864659117,-69286565
1650990082,196483,true,2932772397,28,2864086271,-68686126
1650990137,196487,true,2931599581,28,2863227217,-68372364
1650990159,196490,true,2930720277,28,2862654657,-68065620
1650990219,196495,true,2929255357,28,2862082212,-67173145
1650990233,196499,true,2928083947,28,2861796033,-66287914
1650990385,196503,true,2926913007,28,2860651600,-66261407
1650990829,196505,true,2926327712,28,2862940923,-63386789
1650990887,196511,true,2924572530,28,2863799891,-60772639
1650991023,196514,true,2923695333,28,2865518601,-58176732
1650991049,196518,true,2922526147,28,2865805152,-56720995
1650991065,196520,true,2921941730,28,2866091733,-55849997
1650991241,196526,true,2920189178,28,2867238342,-52950836
1650991920,196530,true,2919021395,28,2870393881,-48627514
1650992059,196534,true,2917854078,28,2870393881,-47460197
1650992229,196536,true,2917270595,28,2869819889,-47450706
1650992282,196542,true,2915520845,28,2869819889,-45700956
1650992485,196546,true,2914354928,28,2870106871,-44248057
1650992486,196549,true,2913480796,28,2870106871,-43373925
1650993242,196552,true,2912606927,28,2870967989,-41638938
1650993364,196558,true,2910859974,28,2871255086,-39604888
1650993415,196562,true,2909695921,28,2870967989,-38727932
1650993500,196565,true,2908823187,28,2870967989,-37855198
1650993558,196569,true,2907659948,28,2870680921,-36979027
1650993620,196575,true,2905915963,28,2870393881,-35522082
1650993675,196578,true,2905044362,28,2870393881,-34650481
1650993856,196582,true,2903882635,28,2869246011,-34636624
1650994874,196586,true,2902721372,28,2858935810,-43785562
1650994983,196591,true,2901270447,28,2858078301,-43192146
1650995381,196594,true,2900400240,28,2857792522,-42607718
1650996111,196598,true,2899240370,28,2860937666,-38302704
1650996129,196600,true,2898660609,28,2860937666,-37722943
1650996165,196606,true,2896922021,28,2861223759,-35698262
1650996253,196609,true,2896053118,28,2861223759,-34829359
1650996345,196613,true,2894894986,28,2861509882,-33385104
1650996934,196616,true,2894026692,28,2860365564,-33661128
1650996979,196622,true,2892290883,28,2860365564,-31925319
1650997027,196625,true,2891423369,28,2860079556,-31343813
1650998539,196628,true,2890556116,28,2858078301,-32477815
1650998577,196631,true,2889689122,28,2858078301,-31610821
1650998729,196636,true,2888244711,28,2858078301,-30166410
1650998814,196639,true,2887378411,28,2858078301,-29300110
1650999322,196642,true,2886512371,28,2857221049,-29291322
1650999565,196644,true,2885935155,28,2856935355,-28999800
1651000491,196650,true,2884204200,28,2855507316,-28696884
1651000553,196652,true,2883627445,28,2855507316,-28120129
1651000588,196655,true,2882762530,28,2855221794,-27540736
1651000645,196658,true,2881897874,28,2854936300,-26961574
1651000833,196664,true,2880169341,28,2852938644,-27230697
1651001180,196667,true,2879305463,28,2849232419,-30073044
1651001267,196669,true,2878729688,28,2848093010,-30636678
1651001506,196672,true,2877866242,28,2844961987,-32904255
1651001541,196678,true,2876140126,28,2844677519,-31462607
1651001561,196681,true,2875277457,28,2844393080,-30884377
1651001613,196684,true,2874415046,28,2843539933,-30875113
1651001636,196686,true,2873840249,28,2843255607,-30584642
1651001658,196692,true,2872116548,28,2842971310,-29145238
1651001673,196695,true,2871255086,28,2842687041,-28568045
1651001690,196697,true,2870680921,28,2842402801,-28278120
1651001882,196699,true,2870106871,28,2838710263,-31396608
1651001917,196705,true,2868385409,28,2838142606,-30242803
1651002014,196707,true,2867811818,28,2836723960,-31087858
1651002281,196709,true,2867238342,28,2833322103,-33916239
1651002620,196710,true,2866951646,28,2831339571,-35612075
1651002653,196716,true,2865232077,28,2831339571,-33892506
1651002669,196718,true,2864659117,28,2831339571,-33319546
1651002703,196719,true,2864372680,28,2831622705,-32749975
1651002997,196719,true,2864372680,28,2833888796,-30483884
1651003120,196723,true,2863227217,28,2834739047,-28488170
1651003274,196725,true,2862654657,28,2836156700,-26497957
1651003320,196727,true,2862082212,28,2836440316,-25641896
1651003495,196726,true,2862368421,28,2838142606,-24225815
1651003551,196730,true,2861223759,28,2838710263,-22513496
1651003585,196731,true,2860937666,28,2839278033,-21659633
1651003631,196733,true,2860365564,28,2839561961,-20803603
1651003647,196733,true,2860365564,28,2839845917,-20519647
1651003696,196737,true,2859221704,28,2840129902,-19091802
1651003739,196738,true,2858935810,28,2840129902,-18805908
1651003757,196740,true,2858364109,28,2840129902,-18234207
1651003804,196741,true,2858078301,28,2840129902,-17948399
1651003822,196746,true,2856649690,28,2840129902,-16519788
1651003829,196748,true,2856078446,28,2840129902,-15948544
1651003987,196750,true,2855507316,28,2838710263,-16797053
1651004018,196751,true,2855221794,28,2838426420,-16795374
1651004048,196756,true,2853794611,28,2838142606,-15652005
1651004082,196758,true,2853223938,28,2837575062,-15648876
1651004172,196761,true,2852368142,28,2836440316,-15927826
1651004262,196762,true,2852082933,28,2835306024,-16776909
1651004346,196766,true,2850942385,28,2833888796,-17053589
1651004461,196768,true,2850372282,28,2832189057,-18183225
1651004780,196771,true,2849517342,28,2825117781,-24399561
1651004878,196772,true,2849232419,28,2823140989,-26091430
1651005062,196776,true,2848093010,28,2818909664,-29183346
1651005064,196777,true,2847808230,28,2818909664,-28898566
1651005090,196779,true,2847238753,28,2818627801,-28610952
1651005175,196780,true,2846954058,28,2816937216,-30016842
1651005204,196783,true,2846100143,28,2816373913,-29726230
1651005281,196784,true,2845815561,28,2814966149,-30849412
1651005353,196786,true,2845246483,28,2813840444,-31406039
1651005506,196785,true,2845531008,28,2812996460,-32534548
1651005681,196788,true,2844677519,28,2812996460,-31681059
1651006709,196789,true,2844393080,28,2821165581,-23227499
1651007306,196789,true,2844393080,28,2824270415,-20122665
1651007390,196789,true,2844393080,28,2824552842,-19840238
1651008027,196791,true,2843824287,28,2829358425,-14465862
1651008999,196791,true,2843824287,28,2837007633,-6816654
1651009291,196791,true,2843824287,28,2838142606,-5681681
1651009590,196790,true,2844108669,28,2838142606,-5966063
1651009711,196792,true,2843539933,28,2838142606,-5397327
1651010025,196793,true,2843255607,28,2838142606,-5113001
1651011361,196793,true,2843255607,28,2837858820,-5396787
1651011516,196793,true,2843255607,28,2837858820,-5396787
1651012550,196795,true,2842687041,28,2837858820,-4828221
1651012601,196795,true,2842687041,28,2837858820,-4828221
1651012825,196796,true,2842402801,28,2837291333,-5111468
1651013068,196796,true,2842402801,28,2836723960,-5678841
1651013829,196799,true,2841550251,28,2833888796,-7661455
1651013917,196799,true,2841550251,28,2833605435,-7944816
1651013985,196801,true,2840982026,28,2833322103,-7659923
1651014117,196801,true,2840982026,28,2832755524,-8226502
1651014394,196805,true,2839845917,28,2831339571,-8506346
1651014523,196805,true,2839845917,28,2830773388,-9072529
1651014653,196807,true,2839278033,28,2830207318,-9070715
1651014673,196807,true,2839278033,28,2830207318,-9070715
1651014689,196810,true,2838426420,28,2829924325,-8502095
1651014713,196811,true,2838142606,28,2829641361,-8501245
1651014720,196813,true,2837575062,28,2829641361,-7933701
1651014734,196813,true,2837575062,28,2829641361,-7933701
1651014740,196817,true,2836440316,28,2829641361,-6798955
1651014780,196818,true,2836156700,28,2829075518,-7081182
1651014809,196820,true,2835589554,28,2828792639,-6796915
1651014871,196821,true,2835306024,28,2827944171,-7361853
1651015062,196825,true,2834172185,28,2825400293,-8771892
1651015081,196826,true,2833888796,28,2825117781,-8771015
1651015093,196828,true,2833322103,28,2825117781,-8204322
1651015125,196829,true,2833038799,28,2824270415,-8768384
1651015148,196833,true,2831905867,28,2823705646,-8200221
1651015200,196835,true,2831339571,28,2822576446,-8763125
1651015612,196838,true,2830490339,28,2811590384,-18899955
1651015785,196838,true,2830490339,28,2807095661,-23394678
1651015984,196842,true,2829358425,28,2802047685,-27310740
1651016048,196844,true,2828792639,28,2800927147,-27865492
1651016203,196847,true,2827944171,28,2798127759,-29816412
1651017202,196846,true,2828226965,28,2793654558,-34572407
1651017417,196850,true,2827095957,28,2795331170,-31764787
1651017833,196852,true,2826530623,28,2799527103,-27003520
1651017858,196854,true,2825965401,28,2799527103,-26438298
1651017993,196853,true,2826247998,28,2800367045,-25880953
1651018010,196856,true,2825400293,28,2800367045,-25033248
1651018263,196858,true,2824835298,28,2801767509,-23067789
1651018689,196860,true,2824270415,28,2805692534,-18577881
1651018754,196859,true,2824552842,28,2806253700,-18299142
1651020155,196862,true,2823705646,28,2814121828,-9583818
1651020273,196864,true,2823140989,28,2814121828,-9019161
1651020333,196865,true,2822858704,28,2814121828,-8736876
1651020341,196864,true,2823140989,28,2813840444,-9300545
1651020396,196868,true,2822012015,28,2813840444,-8171571
1651020601,196870,true,2821447698,28,2812715189,-8732509
1651020614,196871,true,2821165581,28,2812715189,-8450392
1651021320,196870,true,2821447698,28,2811028150,-10419548
1651021600,196872,true,2820883493,28,2810747075,-10136418
1651021664,196873,true,2820601433,28,2810747075,-9854358
1651022174,196875,true,2820037397,28,2810747075,-9290322
1651022841,196872,true,2820883493,28,2814403240,-6480253
1651022925,196874,true,2820319401,28,2815247645,-5071756
1651023672,196875,true,2820037397,28,2822012015,1974618
1651024352,196875,true,2820037397,28,2827095957,7058560
1651024396,196873,true,2820601433,28,2827378667,6777234
1651026127,196874,true,2820319401,28,2831622705,11303304
1651026483,196874,true,2820319401,28,2831339571,11020170
1651027880,196875,true,2820037397,28,2831339571,11302174
1651028117,196871,true,2821165581,28,2831622705,10457124
1651028373,196873,true,2820601433,28,2831905867,11304434
1651029131,196873,true,2820601433,28,2832189057,11587624
1651029214,196874,true,2820319401,28,2832189057,11869656
1651029226,196871,true,2821165581,28,2832189057,11023476
1651030591,196873,true,2820601433,28,2834739047,14137614
1651031742,196873,true,2820601433,28,2835873113,15271680
1651032697,196874,true,2820319401,28,2836156700,15837299
1651032958,196873,true,2820601433,28,2836723960,16122527
1651034139,196874,true,2820319401,28,2837858820,17539419
1651036201,196874,true,2820319401,28,2838426420,18107019
1651036303,196875,true,2820037397,28,2838426420,18389023
1651036346,196874,true,2820319401,28,2838710263,18390862
1651036575,196875,true,2820037397,28,2838710263,18672866
1651036590,196875,true,2820037397,28,2838710263,18672866
1651036701,196876,true,2819755421,28,2838994134,19238713
1651037214,196874,true,2820319401,28,2840413915,20094514
1651037528,196874,true,2820319401,28,2840982026,20662625
1651037827,196874,true,2820319401,28,2841834406,21515005
1651038069,196874,true,2820319401,28,2842687041,22367640
1651040242,196872,true,2820883493,28,2845246483,24362990
1651040572,196872,true,2820883493,28,2845246483,24362990
1651040700,196871,true,2821165581,28,2845246483,24080902
1651040795,196871,true,2821165581,28,2844961987,23796406
1651040855,196868,true,2822012015,28,2844961987,22949972
1651040867,196869,true,2821729842,28,2844961987,23232145
1651040898,196868,true,2822012015,28,2844961987,22949972
1651041016,196867,true,2822294217,28,2844961987,22667770
1651041097,196864,true,2823140989,28,2844961987,21820998
1651041189,196864,true,2823140989,28,2845246483,22105494
1651041239,196863,true,2823423304,28,2845531008,22107704
1651041249,196862,true,2823705646,28,2845531008,21825362
1651041282,196858,true,2824835298,28,2845531008,20695710
1651041488,196859,true,2824552842,28,2846384753,21831911
1651041995,196857,true,2825117781,28,2848947524,23829743
1651042004,196856,true,2825400293,28,2848947524,23547231
1651042022,196853,true,2826247998,28,2848947524,22699526
1651042137,196853,true,2826247998,28,2849802294,23554296
1651042211,196851,true,2826813276,28,2850372282,23559006
1651042370,196850,true,2827095957,28,2852082933,24986976
1651042958,196847,true,2827944171,28,2859221704,31277533
1651043054,196847,true,2827944171,28,2860365564,32421393
1651044624,196846,true,2828226965,28,2869246011,41019046
1651045179,196844,true,2828792639,28,2869246011,40453372
1651045553,196841,true,2829641361,28,2870393881,40752520
1651046121,196842,true,2829358425,28,2872116548,42758123
1651046401,196841,true,2829641361,28,2873265567,43624206
1651046552,196840,true,2829924325,28,2874415046,44490721
1651046688,196837,true,2830773388,28,2875564984,44791596
1651047354,196836,true,2831056465,28,2880745403,49688938
1651047413,196835,true,2831339571,28,2881609713,50270142
1651048283,196833,true,2831905867,28,2893737318,61831451
1651048345,196829,true,2833038799,28,2894316094,61277295
1651048359,196829,true,2833038799,28,2894316094,61277295
1651048433,196827,true,2833605435,28,2894605526,61000091
1651048460,196825,true,2834172185,28,2894894986,60722801
1651048486,196823,true,2834739047,28,2894894986,60155939
1651048629,196822,true,2835022521,28,2894316094,59293573
1651048925,196821,true,2835306024,28,2892869370,57563346
1651049416,196819,true,2835873113,28,2889111271,53238158
1651050038,196817,true,2836440316,28,2880745403,44305087
1651050079,196816,true,2836723960,28,2880457357,43733397
1651050097,196815,true,2837007633,28,2880169341,43161708
1651050161,196813,true,2837575062,28,2879593393,42018331
1651050217,196810,true,2838426420,28,2879305463,40879043
1651050310,196809,true,2838710263,28,2879017561,40307298
1651050347,196807,true,2839278033,28,2879305463,40027430
1651050781,196805,true,2839845917,28,2881321581,41475664
1651050885,196801,true,2840982026,28,2881609713,40627687
1651051305,196800,true,2841266124,28,2883339111,42072987
1651051525,196798,true,2841834406,28,2884492620,42658214
1651051583,196796,true,2842402801,28,2885069547,42666746
1651051632,196792,true,2843539933,28,2885646590,42106657
1651051777,196790,true,2844108669,28,2887089702,42981033
1651051798,196788,true,2844677519,28,2887378411,42700892
1651054073,196785,true,2845531008,28,2896922021,51391013
1651055424,196780,true,2846954058,28,2896922021,49967963
1651057564,196778,true,2847523477,28,2896922021,49398544
1651057630,196774,true,2848662658,28,2896922021,48259363
1651058197,196771,true,2849517342,28,2894605526,45088184
1651058220,196766,true,2850942385,28,2894605526,43663141
1651058234,196764,true,2851512602,28,2894605526,43092924
1651058456,196761,true,2852368142,28,2892869370,40501228
1651058519,196758,true,2853223938,28,2892580112,39356174
1651058535,196755,true,2854079991,28,2892290883,38210892
1651058672,196754,true,2854365399,28,2890267089,35901690
1651058751,196752,true,2854936300,28,2889400182,34463882
1651059015,196750,true,2855507316,28,2885069547,29562231
1651059059,196747,true,2856364054,28,2884204200,27840146
1651059083,196746,true,2856649690,28,2883915808,27266118
1651059284,196744,true,2857221049,28,2881033478,23812429
1651059472,196742,true,2857792522,28,2878441844,20649322
1651059504,196740,true,2858364109,28,2878154028,19789919
1651059798,196738,true,2858935810,28,2875277457,16341647
1651059820,196737,true,2859221704,28,2874989958,15768254
1651060664,196734,true,2860079556,28,2874127633,14048077
1651061063,196732,true,2860651600,28,2877290755,16639155
1651061093,196730,true,2861223759,28,2877578484,16354725
1651061116,196728,true,2861796033,28,2877578484,15782451
1651062931,196724,true,2862940923,28,2887089702,24148779
1651062955,196722,true,2863513540,28,2887089702,23576162
1651063128,196720,true,2864086271,28,2886801022,22714751
1651063145,196718,true,2864659117,28,2886801022,22141905
1651063445,196715,true,2865518601,28,2885646590,20127989
1651063531,196713,true,2866091733,28,2885358054,19266321
1651063712,196712,true,2866378342,28,2885069547,18691205
1651063735,196710,true,2866951646,28,2885069547,18117901
1651063920,196708,true,2867525065,28,2884204200,16679135
1651064001,196707,true,2867811818,28,2883627445,15815627
1651064353,196706,true,2868098599,28,2881609713,13511114
1651064725,196705,true,2868385409,28,2878729688,10344279
1651064900,196703,true,2868959115,28,2877578484,8619369
1651066220,196702,true,2869246011,28,2867238342,-2007669
1651066254,196701,true,2869532935,28,2867238342,-2294593
1651066257,196701,true,2869532935,28,2867238342,-2294593
1651066270,196699,true,2870106871,28,2867238342,-2868529
1651066284,196697,true,2870680921,28,2867525065,-3155856
1651067069,196695,true,2871255086,28,2876427740,5172654
1651067098,196694,true,2871542211,28,2876715383,5173172
1651067107,196692,true,2872116548,28,2877003054,4886506
1651067233,196690,true,2872691000,28,2879017561,6326561
1651067313,196687,true,2873552894,28,2880457357,6904463
1651067399,196686,true,2873840249,28,2882186064,8345815
1651067467,196685,true,2874127633,28,2883627445,9499812
1651067497,196682,true,2874989958,28,2884204200,9214242
1651067842,196678,true,2876140126,28,2893447973,17307847
1651067868,196677,true,2876427740,28,2894026692,17598952
1651068114,196676,true,2876715383,28,2899530294,22814911
1651068136,196673,true,2877578484,28,2899530294,21951810
1651068153,196670,true,2878441844,28,2899820247,21378403
1651068180,196669,true,2878729688,28,2899820247,21090559
1651068201,196669,true,2878729688,28,2899820247,21090559
1651068222,196668,true,2879017561,28,2899530294,20512733
1651068243,196665,true,2879881352,28,2899530294,19648942
1651068324,196665,true,2879881352,28,2898950475,19069123
1651068371,196665,true,2879881352,28,2898660609,18779257
1651068384,196664,true,2880169341,28,2898370772,18201431
1651068528,196661,true,2881033478,28,2897211713,16178235
1651068590,196661,true,2881033478,28,2896632358,15598880
1651068671,196662,true,2880745403,28,2895763542,15018139
1651068717,196661,true,2881033478,28,2894894986,13861508
1651068748,196659,true,2881609713,28,2894605526,12995813
1651068772,196659,true,2881609713,28,2894026692,12416979
1651068845,196661,true,2881033478,28,2892580112,11546634
1651068869,196660,true,2881321581,28,2892290883,10969302
1651068898,196658,true,2881897874,28,2891712512,9814638
1651068919,196659,true,2881609713,28,2891134256,9524543
1651069065,196662,true,2880745403,28,2886512371,5766968
1651069305,196662,true,2880745403,28,2877578484,-3166919
1651069748,196660,true,2881321581,28,2860651600,-20669981
1651069770,196662,true,2880745403,28,2859793577,-20951826
1651069785,196665,true,2879881352,28,2859221704,-20659648
1651069879,196665,true,2879881352,28,2855507316,-24374036
1651069924,196664,true,2880169341,28,2853509260,-26660081
1651069989,196666,true,2879593393,28,2851227480,-28365913
1651070146,196669,true,2878729688,28,2847238753,-31490935
1651070408,196669,true,2878729688,28,2842402801,-36326887
1651070471,196668,true,2879017561,28,2841550251,-37467310
1651070775,196670,true,2878441844,28,2839561961,-38879883
1651070806,196673,true,2877578484,28,2839845917,-37732567
1651071017,196673,true,2877578484,28,2841550251,-36028233
1651071401,196672,true,2877866242,28,2843824287,-34041955
1651072206,196674,true,2877290755,28,2849517342,-27773413
1651072238,196678,true,2876140126,28,2849517342,-26622784
1651072281,196678,true,2876140126,28,2849802294,-26337832
1651073479,196679,true,2875852541,28,2846384753,-29467788
1651073499,196681,true,2875277457,28,2846384753,-28892704
1651073519,196685,true,2874127633,28,2846384753,-27742880
1651073541,196684,true,2874415046,28,2846384753,-28030293
1651073587,196683,true,2874702487,28,2846384753,-28317734
1651073620,196684,true,2874415046,28,2846669391,-27745655
1651073624,196688,true,2873265567,28,2846669391,-26596176
1651073685,196686,true,2873840249,28,2847238753,-26601496
1651073726,196684,true,2874415046,28,2847523477,-26891569
1651074824,196686,true,2873840249,28,2860079556,-13760693
1651075968,196689,true,2872978269,28,2866091733,-6886536
1651076055,196688,true,2873265567,28,2866091733,-7173834
1651076227,196686,true,2873840249,28,2866378342,-7461907
1651076512,196688,true,2873265567,28,2867238342,-6027225
1651076635,196691,true,2872403760,28,2867811818,-4591942
1651076785,196690,true,2872691000,28,2868959115,-3731885
1651077026,196688,true,2873265567,28,2870967989,-2297578
1651077036,196689,true,2872978269,28,2870967989,-2010280
1651077435,196691,true,2872403760,28,2875564984,3161224
1651077782,196690,true,2872691000,28,2879305463,6614463
1651077948,196689,true,2872978269,28,2881033478,8055209
1651078264,196690,true,2872691000,28,2883915808,11224808
1651078403,196693,true,2871829365,28,2885069547,13240182
1651078583,196691,true,2872403760,28,2885935155,13531395
1651078813,196690,true,2872691000,28,2886512371,13821371
1651078874,196691,true,2872403760,28,2886512371,14108611
1651078906,196694,true,2871542211,28,2886512371,14970160
1651079129,196693,true,2871829365,28,2885358054,13528689
1651079160,196691,true,2872403760,28,2885069547,12665787
1651079672,196692,true,2872116548,28,2883339111,11222563
1651079758,196695,true,2871255086,28,2882762530,11507444
1651079924,196694,true,2871542211,28,2881321581,9779370
1651080247,196692,true,2872116548,28,2878154028,6037480
1651080490,196693,true,2871829365,28,2875852541,4023176
1651080896,196695,true,2871255086,28,2872978269,1723183
1651081081,196694,true,2871542211,28,2871829365,287154
1651082305,196692,true,2872116548,28,2869246011,-2870537
1651083137,196693,true,2871829365,28,2869819889,-2009476
1651084046,196695,true,2871255086,28,2869819889,-1435197
1651084313,196694,true,2871542211,28,2869532935,-2009276
1651084686,196692,true,2872116548,28,2868959115,-3157433
1651085760,196693,true,2871829365,28,2864945583,-6883782
1651085936,196696,true,2870967989,28,2864086271,-6881718
1651085976,196696,true,2870967989,28,2863513540,-7454449
1651087250,196695,true,2871255086,28,2856078446,-15176640
1651087323,196696,true,2870967989,28,2855507316,-15460673
1651087363,196700,true,2869819889,28,2855221794,-14598095
1651087711,196700,true,2869819889,28,2852938644,-16881245
1651088774,196699,true,2870106871,28,2850087274,-20019597
1651088833,196701,true,2869532935,28,2850087274,-19445661
1651089923,196704,true,2868672248,28,2850942385,-17729863
1651089938,196704,true,2868672248,28,2850942385,-17729863
1651089958,196703,true,2868959115,28,2850942385,-18016730
1651089969,196705,true,2868385409,28,2850942385,-17443024
1651091094,196706,true,2868098599,28,2861223759,-6874840
1651091907,196705,true,2868385409,28,2868959115,573706
1651091982,196704,true,2868672248,28,2869246011,573763
1651092604,196706,true,2868098599,28,2870967989,2869390
1651093094,196706,true,2868098599,28,2872403760,4305161
1651094092,196705,true,2868385409,28,2872403760,4018351
1651095232,196704,true,2868672248,28,2871829365,3157117
1651095256,196705,true,2868385409,28,2872116548,3731139
1651095361,196706,true,2868098599,28,2872403760,4305161
1651095397,196706,true,2868098599,28,2872691000,4592401
1651095685,196705,true,2868385409,28,2874415046,6029637
1651095695,196706,true,2868098599,28,2874415046,6316447
1651095697,196706,true,2868098599,28,2874415046,6316447
1651095716,196706,true,2868098599,28,2874702487,6603888
1651095771,196705,true,2868385409,28,2874989958,6604549
1651097379,196707,true,2867811818,28,2890267089,22455271
1651097486,196707,true,2867811818,28,2890556116,22744298
1651098986,196708,true,2867525065,28,2890845171,23320106
1651099011,196708,true,2867525065,28,2890845171,23320106
1651099224,196709,true,2867238342,28,2890556116,23317774
1651099245,196710,true,2866951646,28,2890267089,23315443
1651101403,196711,true,2866664980,28,2881033478,14368498
1651101776,196711,true,2866664980,28,2881033478,14368498
1651102203,196713,true,2866091733,28,2881033478,14941745
1651102389,196712,true,2866378342,28,2881033478,14655136
1651102407,196712,true,2866378342,28,2881321581,14943239
1651103815,196711,true,2866664980,28,2886512371,19847391
1651104099,196712,true,2866378342,28,2887378411,21000069
1651105480,196711,true,2866664980,28,2887378411,20713431
1651106088,196711,true,2866664980,28,2887378411,20713431
1651106108,196710,true,2866951646,28,2887378411,20426765
1651106720,196710,true,2866951646,28,2888822389,21870743
1651107977,196708,true,2867525065,28,2891423369,23898304
1651107994,196708,true,2867525065,28,2891712512,24187447
1651108017,196706,true,2868098599,28,2891712512,23613913
1651108044,196706,true,2868098599,28,2891712512,23613913
1651108214,196703,true,2868959115,28,2892869370,23910255
1651108621,196702,true,2869246011,28,2896342723,27096712
1651108643,196700,true,2869819889,28,2896632358,26812469
1651108671,196700,true,2869819889,28,2896632358,26812469
1651109858,196696,true,2870967989,28,2899530294,28562305
1651110622,196695,true,2871255086,28,2896342723,25087637
1651110685,196693,true,2871829365,28,2896342723,24513358
1651110802,196693,true,2871829365,28,2896342723,24513358
1651110808,196689,true,2872978269,28,2896342723,23364454
1651110861,196689,true,2872978269,28,2896053118,23074849
1651110891,196687,true,2873552894,28,2895763542,22210648
1651110897,196687,true,2873552894,28,2895763542,22210648
1651111609,196683,true,2874702487,28,2889111271,14408784
1651112587,196683,true,2874702487,28,2880169341,5466854
1651112956,196681,true,2875277457,28,2879881352,4603895
1651113017,196682,true,2874989958,28,2879881352,4891394
1651113038,196679,true,2875852541,28,2879881352,4028811
1651113172,196679,true,2875852541,28,2880457357,4604816
1651113687,196677,true,2876427740,28,2882474283,6046543
1651113725,196677,true,2876427740,28,2882474283,6046543
1651113925,196674,true,2877290755,28,2883339111,6048356
1651113960,196674,true,2877290755,28,2883627445,6336690
1651114070,196672,true,2877866242,28,2884204200,6337958
1651114197,196672,true,2877866242,28,2884781069,6914827
1651114386,196669,true,2878729688,28,2885935155,7205467
1651114667,196669,true,2878729688,28,2887667149,8937461
1651117138,196667,true,2879305463,28,2891134256,11828793
1651118684,196667,true,2879305463,28,2891134256,11828793
1651118707,196664,true,2880169341,28,2891134256,10964915
1651120297,196665,true,2879881352,28,2890556116,10674764
1651121073,196664,true,2880169341,28,2889978091,9808750
1651122623,196664,true,2880169341,28,2889111271,8941930
1651123459,196661,true,2881033478,28,2889111271,8077793
1651123513,196662,true,2880745403,28,2889111271,8365868
1651123559,196661,true,2881033478,28,2889111271,8077793
1651123974,196662,true,2880745403,28,2889111271,8365868
1651124074,196659,true,2881609713,28,2889111271,7501558
1651124113,196660,true,2881321581,28,2889111271,7789690
1651124208,196659,true,2881609713,28,2889111271,7501558
1651124477,196661,true,2881033478,28,2889111271,8077793
1651126112,196659,true,2881609713,28,2885069547,3459834
1651126386,196660,true,2881321581,28,2884492620,3171039
1651127005,196659,true,2881609713,28,2884492620,2882907
1651127016,196661,true,2881033478,28,2884492620,3459142
1651127209,196659,true,2881609713,28,2883915808,2306095
1651127718,196661,true,2881033478,28,2883339111,2305633
1651128360,196660,true,2881321581,28,2882474283,1152702
1651129271,196661,true,2881033478,28,2881897874,864396
1651129570,196660,true,2881321581,28,2881897874,576293
1651129714,196661,true,2881033478,28,2881897874,864396
1651129953,196659,true,2881609713,28,2881897874,288161
1651129973,196661,true,2881033478,28,2882186064,1152586
1651130302,196659,true,2881609713,28,2882762530,1152817
1651130313,196660,true,2881321581,28,2882762530,1440949
1651130351,196658,true,2881897874,28,2882762530,864656
1651130718,196659,true,2881609713,28,2884204200,2594487
1651130750,196657,true,2882186064,28,2884204200,2018136
1651131720,196657,true,2882186064,28,2888822389,6636325
1651131738,196656,true,2882474283,28,2888822389,6348106
1651131860,196656,true,2882474283,28,2889111271,6636988
1651132000,196654,true,2883050806,28,2889689122,6638316
1651132067,196655,true,2882762530,28,2889689122,6926592
1651132075,196653,true,2883339111,28,2889689122,6350011
1651132090,196653,true,2883339111,28,2889978091,6638980
1651132102,196651,true,2883915808,28,2889978091,6062283
1651132129,196650,true,2884204200,28,2890267089,6062889
1651132166,196647,true,2885069547,28,2890845171,5775624
1651132176,196647,true,2885069547,28,2890845171,5775624
1651132300,196644,true,2885935155,28,2892290883,6355728
1651132639,196643,true,2886223748,28,2896053118,9829370
1651133752,196640,true,2887089702,28,2907659948,20570246
1651133883,196639,true,2887378411,28,2908823187,21444776
1651133968,196636,true,2888244711,28,2909114069,20869358
1651134374,196636,true,2888244711,28,2909695921,21451210
1651134402,196632,true,2889400182,28,2909695921,20295739
1651134446,196632,true,2889400182,28,2909986891,20586709
1651134491,196631,true,2889689122,28,2910568917,20879795
1651134656,196628,true,2890556116,28,2912606927,22050811
1651134658,196625,true,2891423369,28,2912606927,21183558
1651134764,196624,true,2891712512,28,2914063521,22351009
1651134786,196623,true,2892001683,28,2914354928,22353245
1651136428,196621,true,2892580112,28,2933065674,40485562
1651136950,196617,true,2893737318,28,2934532501,40795183
1651137131,196617,true,2893737318,28,2935119436,41382118
1651139959,196615,true,2894316094,28,2937468354,43152260
1651141192,196613,true,2894894986,28,2937468354,42573368
1651141214,196610,true,2895763542,28,2937468354,41704812
1651143953,196610,true,2895763542,28,2933652317,37888775
1651145092,196609,true,2896053118,28,2933652317,37599199
1651146359,196607,true,2896632358,28,2933945682,37313324
1651148033,196605,true,2897211713,28,2933065674,35853961
1651148068,196605,true,2897211713,28,2933065674,35853961
1651148093,196604,true,2897501434,28,2932772397,35270963
1651148153,196601,true,2898370772,28,2932479149,34108377
1651148698,196601,true,2898370772,28,2929255357,30884585
1651148906,196601,true,2898370772,28,2927791168,29420396
1651149151,196600,true,2898660609,28,2926327712,27667103
1651149238,196597,true,2899530294,28,2926035108,26504814
1651149322,196596,true,2899820247,28,2925742534,25922287
1651149454,196595,true,2900110229,28,2925157473,25047244
1651149740,196594,true,2900400240,28,2923987703,23587463
1651149929,196591,true,2901270447,28,2923695333,22424886
1651150150,196591,true,2901270447,28,2923987703,22717256
1651150233,196591,true,2901270447,28,2924280102,23009655
1651150320,196590,true,2901560574,28,2924280102,22719528
1651150528,196587,true,2902431129,28,2924572530,22141401
1651150562,196586,true,2902721372,28,2924572530,21851158
1651150598,196586,true,2902721372,28,2924572530,21851158
1651150681,196586,true,2902721372,28,2924572530,21851158
1651151368,196583,true,2903592276,28,2922233924,18641648
1651151428,196583,true,2903592276,28,2921941730,18349454
1651151439,196583,true,2903592276,28,2921941730,18349454
1651151946,196584,true,2903301946,28,2917562322,14260376
1651152602,196583,true,2903592276,28,2909695921,6103645
1651152663,196583,true,2903592276,28,2909114069,5521793
1651152716,196583,true,2903592276,28,2908823187,5230911
1651152761,196584,true,2903301946,28,2908532334,5230388
1651153423,196582,true,2903882635,28,2905044362,1161727
1651153456,196582,true,2903882635,28,2904753887,871252
1651153537,196582,true,2903882635,28,2904173023,290388
1651153631,196583,true,2903592276,28,2903011645,-580631
1651153649,196582,true,2903882635,28,2903011645,-870990
1651153691,196582,true,2903882635,28,2902431129,-1451506
1651153734,196582,true,2903882635,28,2901850730,-2031905
1651153892,196582,true,2903882635,28,2900400240,-3482395
1651153918,196581,true,2904173023,28,2900110229,-4062794
1651154037,196582,true,2903882635,28,2898660609,-5222026
1651154085,196582,true,2903882635,28,2897791184,-6091451
1651154242,196583,true,2903592276,28,2895763542,-7828734
1651154442,196582,true,2903882635,28,2892869370,-11013265
1651154444,196583,true,2903592276,28,2892869370,-10722906
1651154475,196583,true,2903592276,28,2892290883,-11301393
1651154592,196584,true,2903301946,28,2889689122,-13612824
1651155275,196585,true,2903011645,28,2873840249,-29171396
1651155693,196586,true,2902721372,28,2867811818,-34909554
1651155792,196586,true,2902721372,28,2866951646,-35769726
1651155843,196588,true,2902140915,28,2866664980,-35475935
1651156640,196588,true,2902140915,28,2865518601,-36622314
1651157049,196589,true,2901850730,28,2866378342,-35472388
1651157751,196589,true,2901850730,28,2867238342,-34612388
1651157939,196591,true,2901270447,28,2867238342,-34032105
1651157949,196591,true,2901270447,28,2867238342,-34032105
1651158174,196591,true,2901270447,28,2868672248,-32598199
1651158256,196591,true,2901270447,28,2869532935,-31737512
1651158276,196592,true,2900980349,28,2869819889,-31160460
1651158376,196591,true,2901270447,28,2871255086,-30015361
1651158406,196591,true,2901270447,28,2871829365,-29441082
1651158414,196590,true,2901560574,28,2872116548,-29444026
1651158433,196590,true,2901560574,28,2872691000,-28869574
1651158544,196587,true,2902431129,28,2876140126,-26291003
1651158927,196585,true,2903011645,28,2890556116,-12455529
1651158962,196584,true,2903301946,28,2892001683,-11300263
1651158973,196584,true,2903301946,28,2892290883,-11011063
1651159218,196582,true,2903882635,28,2899240370,-4642265
1651159240,196581,true,2904173023,28,2899820247,-4352776
1651159252,196580,true,2904463441,28,2900400240,-4063201
1651159259,196580,true,2904463441,28,2900400240,-4063201
1651159542,196580,true,2904463441,28,2905915963,1452522
1651160136,196578,true,2905044362,28,2915229322,10184960
1651160386,196577,true,2905334867,28,2913189477,7854610
1651160425,196577,true,2905334867,28,2912606927,7272060
1651160664,196577,true,2905334867,28,2907950714,2615847
1651160719,196576,true,2905625400,28,2906787825,1162425
1651160732,196575,true,2905915963,28,2906497175,581212
1651160755,196575,true,2905915963,28,2905915963,0
1651160763,196576,true,2905625400,28,2905625400,0
1651161148,196577,true,2905334867,28,2897791184,-7543683
1651161260,196576,true,2905625400,28,2897501434,-8123966
1651161453,196576,true,2905625400,28,2896342723,-9282677
1651162199,196576,true,2905625400,28,2889689122,-15936278
1651162287,196577,true,2905334867,28,2889111271,-16223596
1651162477,196576,true,2905625400,28,2887378411,-18246989
1651162611,196576,true,2905625400,28,2887378411,-18246989
1651162740,196577,true,2905334867,28,2887955916,-17378951
1651162743,196577,true,2905334867,28,2887955916,-17378951
1651162893,196576,true,2905625400,28,2889400182,-16225218
1651162962,196577,true,2905334867,28,2889978091,-15356776
1651163137,196578,true,2905044362,28,2890556116,-14488246
1651163156,196578,true,2905044362,28,2890556116,-14488246
1651163202,196577,true,2905334867,28,2890845171,-14489696
1651163391,196577,true,2905334867,28,2892290883,-13043984
1651163414,196578,true,2905044362,28,2892290883,-12753479
1651164134,196579,true,2904753887,28,2899820247,-4933640
1651164187,196577,true,2905334867,28,2900690280,-4644587
1651164204,196578,true,2905044362,28,2900690280,-4354082
1651164230,196578,true,2905044362,28,2901270447,-3773915
1651164259,196578,true,2905044362,28,2901850730,-3193632
1651164264,196577,true,2905334867,28,2901850730,-3484137
1651164330,196576,true,2905625400,28,2903301946,-2323454
1651164451,196579,true,2904753887,28,2906206555,1452668
1651165234,196578,true,2905044362,28,2920189178,15144816
1651165934,196577,true,2905334867,28,2929548282,24213415
1651166409,196577,true,2905334867,28,2931892741,26557874
1651166579,196579,true,2904753887,28,2932479149,27725262
1651166914,196578,true,2905044362,28,2933945682,28901320
1651166978,196577,true,2905334867,28,2934532501,29197634
1651167198,196576,true,2905625400,28,2936293660,30668260
1651167222,196578,true,2905044362,28,2936587290,31542928
1651167544,196577,true,2905334867,28,2939819151,34484284
1651167679,196575,true,2905915963,28,2940995255,35079292
1651168123,196574,true,2906206555,28,2945409838,39203283
1651168167,196576,true,2905625400,28,2945704379,40078979
1651168523,196575,true,2905915963,28,2949241169,43325206
1651168726,196573,true,2906497175,28,2951306257,44809082
1651168781,196572,true,2906787825,28,2951896548,45108723
1651168798,196573,true,2906497175,28,2951896548,45399373
1651169103,196570,true,2907369212,28,2955440772,48071560
1651169729,196567,true,2908241509,28,2962838248,54596739
1651171291,196566,true,2908532334,28,2969363340,60831006
1651171357,196568,true,2907950714,28,2969066434,61115720
1651172529,196564,true,2909114069,28,2968769557,59655488
1651172599,196561,true,2909986891,28,2968769557,58782666
1651172602,196561,true,2909986891,28,2968769557,58782666
1651172689,196562,true,2909695921,28,2968472710,58776789
1651172959,196559,true,2910568917,28,2967879104,57310187
1651174193,196556,true,2911442175,28,2966988918,55546743
1651174639,196556,true,2911442175,28,2967285617,55843442
1651174806,196557,true,2911151060,28,2967582346,56431286
1651174841,196554,true,2912024493,28,2967582346,55557853
1651174869,196551,true,2912898187,28,2967285617,54387430
1651174944,196550,true,2913189477,28,2967285617,54096140
1651175047,196552,true,2912606927,28,2966988918,54381991
1651175057,196549,true,2913480796,28,2966988918,53508122
1651175098,196546,true,2914354928,28,2966988918,52633990
1651175153,196545,true,2914646363,28,2966692249,52045886
1651175305,196545,true,2914646363,28,2966099000,51452637
1651175412,196542,true,2915520845,28,2965505869,49985024
1651175457,196539,true,2916395588,28,2965209348,48813760
1651175466,196538,true,2916687228,28,2965209348,48522120
1651175506,196539,true,2916395588,28,2964912857,48517269
1651175537,196536,true,2917270595,28,2964616395,47345800
1651176081,196533,true,2918145863,28,2959877038,41731175
1651176116,196532,true,2918437678,28,2959285152,40847474
1651176296,196532,true,2918437678,28,2956623126,38185448
1651176619,196529,true,2919313297,28,2951896548,32583251
1651176665,196527,true,2919897189,28,2951306257,31409068
1651177767,196525,true,2920481197,28,2938937382,18456185
1651177792,196526,true,2920189178,28,2938643518,18454340
1651177820,196523,true,2921065323,28,2938643518,17578195
1651177848,196520,true,2921941730,28,2938643518,16701788
1651178217,196516,true,2923110682,28,2941583484,18472802
1651179089,196516,true,2923110682,28,2951601388,28490706
1651179095,196513,true,2923987703,28,2951601388,27613685
1651179151,196510,true,2924864987,28,2952191737,27326750
1651179700,196505,true,2926327712,28,2957510202,31182490
1651179877,196504,true,2926620345,28,2957510202,30889857
1651179935,196501,true,2927498419,28,2957510202,30011783
1651180075,196499,true,2928083947,28,2957510202,29426255
1651181107,196494,true,2929548282,28,2955736317,26188035
1651181154,196494,true,2929548282,28,2955736317,26188035
1651181171,196491,true,2930427235,28,2955736317,25309082
1651181174,196488,true,2931306451,28,2955736317,24429866
1651181208,196484,true,2932479149,28,2955440772,22961623
1651181317,196485,true,2932185931,28,2954258892,22072961
1651182109,196483,true,2932772397,28,2943937574,11165177
1651184519,196481,true,2933358981,28,2931306451,-2052530
1651184560,196478,true,2934239077,28,2931306451,-2932626
1651184770,196479,true,2933945682,28,2931306451,-2639231
1651184778,196478,true,2934239077,28,2931306451,-2932626
1651184847,196477,true,2934532501,28,2931013349,-3519152
1651184887,196475,true,2935119436,28,2931013349,-4106087
1651185155,196479,true,2933945682,28,2929841237,-4104445
1651185460,196479,true,2933945682,28,2928376756,-5568926
1651186850,196479,true,2933945682,28,2922818400,-11127282
1651187178,196476,true,2934825954,28,2922526147,-12299807
1651187195,196479,true,2933945682,28,2922526147,-11419535
1651187198,196479,true,2933945682,28,2922526147,-11419535
1651187279,196478,true,2934239077,28,2922233924,-12005153
1651187345,196476,true,2934825954,28,2922233924,-12592030
1651187353,196477,true,2934532501,28,2922233924,-12298577
1651187425,196477,true,2934532501,28,2922233924,-12298577
1651187523,196476,true,2934825954,28,2922233924,-12592030
1651187588,196473,true,2935706490,28,2922233924,-13472566
1651187688,196475,true,2935119436,28,2922526147,-12593289
1651188555,196473,true,2935706490,28,2927791168,-7915322
1651189067,196472,true,2936000060,28,2932479149,-3520911
1651189596,196469,true,2936880948,28,2936000060,-880888
1651189686,196469,true,2936880948,28,2936000060,-880888
1651191248,196466,true,2937762101,28,2936587290,-1174811
1651191435,196465,true,2938055877,28,2936587290,-1468587
1651191454,196462,true,2938937382,28,2936587290,-2350092
1651191480,196463,true,2938643518,28,2936587290,-2056228
1651192943,196460,true,2939525199,28,2938055877,-1469322
1651193009,196459,true,2939819151,28,2938349683,-1469468
1651193673,196457,true,2940407145,28,2936587290,-3819855
1651194074,196457,true,2940407145,28,2935706490,-4700655
1651194108,196454,true,2941289355,28,2935706490,-5582865
1651194243,196453,true,2941583484,28,2935412948,-6170536
1651196099,196451,true,2942171830,28,2934825954,-7345876
1651196707,196452,true,2941877642,28,2934825954,-7051688
1651196960,196450,true,2942466047,28,2935119436,-7346611
1651197314,196449,true,2942760294,28,2935119436,-7640858
1651197344,196447,true,2943348875,28,2935119436,-8229439
1651197395,196448,true,2943054570,28,2935119436,-7935134
1651197854,196446,true,2943643210,28,2934532501,-9110709
1651198553,196446,true,2943643210,28,2933652317,-9990893
1651198610,196444,true,2944231968,28,2933652317,-10579651
1651198876,196446,true,2943643210,28,2932772397,-10870813
1651198913,196444,true,2944231968,28,2932772397,-11459571
1651199184,196444,true,2944231968,28,2931892741,-12339227
1651199208,196443,true,2944526391,28,2931892741,-12633650
1651199471,196445,true,2943937574,28,2930720277,-13217297
1651199486,196444,true,2944231968,28,2930720277,-13511691
1651200105,196445,true,2943937574,28,2927498419,-16439155
1651200898,196444,true,2944231968,28,2924280102,-19951866
1651200920,196446,true,2943643210,28,2924280102,-19363108
1651200997,196446,true,2943643210,28,2923987703,-19655507
1651201077,196447,true,2943348875,28,2923402993,-19945882
1651201102,196447,true,2943348875,28,2923402993,-19945882
1651201733,196449,true,2942760294,28,2920481197,-22279097
1651202192,196450,true,2942466047,28,2918145863,-24320184
1651202354,196451,true,2942171830,28,2917270595,-24901235
1651203534,196451,true,2942171830,28,2913480796,-28691034
1651203567,196454,true,2941289355,28,2913189477,-28099878
1651203602,196454,true,2941289355,28,2913189477,-28099878
1651203966,196456,true,2940701185,28,2913772144,-26929041
1651204094,196456,true,2940701185,28,2914063521,-26637664
1651205435,196459,true,2939819151,28,2918145863,-21673288
1651205538,196460,true,2939525199,28,2918145863,-21379336
1651205555,196462,true,2938937382,28,2918145863,-20791519
1651206227,196462,true,2938937382,28,2918145863,-20791519
1651207246,196465,true,2938055877,28,2917270595,-20785282
1651207257,196466,true,2937762101,28,2917270595,-20491506
1651208278,196468,true,2937174636,28,2916687228,-20487408
1651208743,196468,true,2937174636,28,2916687228,-20487408
1651208820,196471,true,2936293660,28,2916978897,-19314763
1651208845,196472,true,2936000060,28,2916978897,-19021163
1651209367,196474,true,2935412948,28,2917562322,-17850626
1651209448,196474,true,2935412948,28,2917854078,-17558870
1651209672,196477,true,2934532501,28,2918145863,-16386638
1651209694,196478,true,2934239077,28,2918145863,-16093214
1651209701,196480,true,2933652317,28,2918145863,-15506454
1651210696,196479,true,2933945682,28,2922526147,-11419535
1651210844,196482,true,2933065674,28,2923110682,-9954992
1651212646,196482,true,2933065674,28,2926620345,-6445329
1651213443,196484,true,2932479149,28,2923402993,-9076156
1651213468,196484,true,2932479149,28,2923402993,-9076156
1651214246,196486,true,2931892741,28,2919021395,-12871346
1651216023,196487,true,2931599581,28,2919021395,-12578186
1651216414,196489,true,2931013349,28,2919021395,-11991954
1651217712,196489,true,2931013349,28,2919021395,-11991954
1651217925,196491,true,2930427235,28,2919021395,-11405840
1651217966,196492,true,2930134221,28,2919313297,-10820924
1651219534,196493,true,2929841237,28,2921357429,-8483808
1651221383,196492,true,2930134221,28,2921357429,-8776792
1651221449,196494,true,2929548282,28,2921357429,-8190853
1651221470,196495,true,2929255357,28,2921357429,-7897928
1651221842,196496,true,2928962461,28,2921357429,-7605032
1651221998,196494,true,2929548282,28,2921065323,-8482959
1651222095,196496,true,2928962461,28,2921065323,-7897138
1651222436,196497,true,2928669594,28,2920481197,-8188397
1651222651,196498,true,2928376756,28,2920189178,-8187578
1651222675,196499,true,2928083947,28,2920189178,-7894769
1651222799,196501,true,2927498419,28,2919605228,-7893191
1651222830,196502,true,2927205698,28,2919313297,-7892401
1651223009,196504,true,2926620345,28,2917562322,-9058023
1651223173,196505,true,2926327712,28,2916103978,-10223734
1651223190,196508,true,2925449989,28,2915812397,-9637592
1651223244,196509,true,2925157473,28,2915229322,-9928151
1651223267,196510,true,2924864987,28,2914937828,-9927159
1651223572,196512,true,2924280102,28,2910277889,-14002213
1651223800,196515,true,2923402993,28,2907078504,-16324489
1651223850,196516,true,2923110682,28,2906206555,-16904127
1651224807,196518,true,2922526147,28,2893447973,-29078174
1651225747,196519,true,2922233924,28,2890845171,-31388753
1651225911,196521,true,2921649565,28,2890845171,-30804394
1651225926,196521,true,2921649565,28,2890845171,-30804394
1651226302,196523,true,2921065323,28,2890556116,-30509207
1651226339,196525,true,2920481197,28,2890267089,-30214108
1651226982,196527,true,2919897189,28,2889111271,-30785918
1651227237,196527,true,2919897189,28,2888533536,-31363653
1651227483,196529,true,2919313297,28,2887955916,-31357381
1651227893,196530,true,2919021395,28,2887089702,-31931693
1651228165,196531,true,2918729522,28,2886801022,-31928500
1651228688,196531,true,2918729522,28,2886512371,-32217151
1651228917,196533,true,2918145863,28,2885935155,-32210708
1651228958,196534,true,2917854078,28,2885935155,-31918923
1651229113,196536,true,2917270595,28,2885069547,-32201048
1651229139,196536,true,2917270595,28,2884781069,-32489526
1651229259,196539,true,2916395588,28,2883627445,-32768143
1651229313,196540,true,2916103978,28,2883050806,-33053172
1651229755,196543,true,2915229322,28,2875564984,-39664338
1651229883,196544,true,2914937828,28,2873552894,-41384934
1651230226,196547,true,2914063521,28,2867811818,-46251703
1651230651,196548,true,2913772144,28,2861223759,-52548385
1651230849,196551,true,2912898187,28,2859221704,-53676483
1651231153,196553,true,2912315695,28,2857792522,-54523173
1651231173,196556,true,2911442175,28,2857792522,-53649653
1651231203,196558,true,2910859974,28,2857792522,-53067452
1651231322,196561,true,2909986891,28,2858078301,-51908590
1651231496,196563,true,2909404981,28,2858364109,-51040872
1651231971,196566,true,2908532334,28,2858935810,-49596524
1651232354,196567,true,2908241509,28,2859507626,-48733883
1651232378,196570,true,2907369212,28,2859507626,-47861586
1651232401,196572,true,2906787825,28,2859221704,-47566121
1651232404,196575,true,2905915963,28,2859221704,-46694259
1651233324,196579,true,2904753887,28,2851512602,-53241285
1651233584,196582,true,2903882635,28,2848377820,-55504815
1651234372,196584,true,2903301946,28,2840697956,-62603990
1651234407,196587,true,2902431129,28,2840697956,-61733173
1651234533,196590,true,2901560574,28,2840697956,-60862618
1651234563,196594,true,2900400240,28,2840697956,-59702284
1651234624,196595,true,2900110229,28,2840697956,-59412273
1651234667,196598,true,2899240370,28,2840982026,-58258344
1651234797,196601,true,2898370772,28,2841266124,-57104648
1651234923,196604,true,2897501434,28,2842118589,-55382845
1651235072,196605,true,2897211713,28,2842687041,-54524672
1651235152,196608,true,2896342723,28,2843255607,-53087116
1651235180,196611,true,2895473994,28,2843539933,-51934061
1651235259,196614,true,2894605526,28,2844393080,-50212446
1651235323,196614,true,2894605526,28,2845246483,-49359043
1651235982,196616,true,2894026692,28,2853794611,-40232081
1651236246,196619,true,2893158657,28,2856649690,-36508967
1651236272,196622,true,2892290883,28,2856935355,-35355528
1651237290,196622,true,2892290883,28,2864086271,-28204612
1651237578,196624,true,2891712512,28,2864945583,-26766929
1651237587,196626,true,2891134256,28,2864945583,-26188673
1651237637,196629,true,2890267089,28,2864945583,-25321506
1651237677,196630,true,2889978091,28,2864945583,-25032508
1651237812,196632,true,2889400182,28,2864659117,-24741065
1651237814,196634,true,2888822389,28,2864659117,-24163272
1651238277,196637,true,2887955916,28,2861509882,-26446034
1651238289,196637,true,2887955916,28,2861223759,-26732157
1651238558,196639,true,2887378411,28,2860079556,-27298855
1651238575,196641,true,2886801022,28,2860079556,-26721466
1651238667,196643,true,2886223748,28,2860079556,-26144192
1651239063,196643,true,2886223748,28,2860365564,-25858184
1651239165,196645,true,2885646590,28,2860365564,-25281026
1651239256,196648,true,2884781069,28,2860365564,-24415505
1651239829,196649,true,2884492620,28,2865518601,-18974019
1651239876,196649,true,2884492620,28,2866091733,-18400887
1651239888,196651,true,2883915808,28,2866378342,-17537466
1651240305,196653,true,2883339111,28,2868672248,-14666863
1651240500,196656,true,2882474283,28,2868672248,-13802035
1651240525,196656,true,2882474283,28,2868672248,-13802035
1651240631,196657,true,2882186064,28,2868959115,-13226949
1651240691,196659,true,2881609713,28,2868959115,-12650598
1651240771,196661,true,2881033478,28,2869246011,-11787467
1651240777,196661,true,2881033478,28,2869246011,-11787467
1651240873,196663,true,2880457357,28,2869819889,-10637468
1651241203,196665,true,2879881352,28,2870967989,-8913363
1651241742,196667,true,2879305463,28,2872691000,-6614463
1651241940,196666,true,2879593393,28,2873265567,-6327826
1651242179,196668,true,2879017561,28,2873552894,-5464667
1651242253,196671,true,2878154028,28,2873552894,-4601134
1651242273,196674,true,2877290755,28,2873552894,-3737861
1651242430,196674,true,2877290755,28,2872691000,-4599755
1651242515,196676,true,2876715383,28,2872116548,-4598835
1651242629,196679,true,2875852541,28,2870967989,-4884552
1651242958,196682,true,2874989958,28,2867238342,-7751616
1651243987,196682,true,2874989958,28,2856364054,-18625904
1651244719,196684,true,2874415046,28,2853794611,-20620435
1651244741,196687,true,2873552894,28,2853794611,-19758283
1651245035,196690,true,2872691000,28,2854650835,-18040165
1651245058,196690,true,2872691000,28,2854650835,-18040165
1651245298,196692,true,2872116548,28,2854650835,-17465713
1651245825,196695,true,2871255086,28,2854936300,-16318786
1651246045,196698,true,2870393881,28,2855221794,-15172087
1651246070,196698,true,2870393881,28,2855221794,-15172087
1651246142,196700,true,2869819889,28,2855221794,-14598095
1651246897,196703,true,2868959115,28,2855792867,-13166248
1651247385,196706,true,2868098599,28,2856078446,-12020153
1651247581,196706,true,2868098599,28,2856364054,-11734545
1651248189,196707,true,2867811818,28,2857792522,-10019296
1651248421,196711,true,2866664980,28,2857792522,-8872458
1651248437,196713,true,2866091733,28,2857792522,-8299211
1651250356,196713,true,2866091733,28,2853223938,-12867795
1651250369,196714,true,2865805152,28,2853223938,-12581214
1651250431,196717,true,2864945583,28,2853223938,-11721645
1651250485,196719,true,2864372680,28,2852653379,-11719301
1651250504,196721,true,2863799891,28,2852368142,-11431749
1651250692,196723,true,2863227217,28,2849517342,-13709875
1651251392,196726,true,2862368421,28,2837575062,-24793359
1651251432,196728,true,2861796033,28,2837007633,-24788400
1651251693,196730,true,2861223759,28,2831905867,-29317892
1651251922,196732,true,2860651600,28,2827378667,-33272933
1651251923,196735,true,2859793577,28,2827378667,-32414910
1651252194,196737,true,2859221704,28,2822576446,-36645258
1651252416,196739,true,2858649945,28,2821165581,-37484364
1651253141,196741,true,2858078301,28,2820601433,-37476868
1651253146,196744,true,2857221049,28,2820601433,-36619616
1651253839,196745,true,2856935355,28,2823423304,-33512051
1651254458,196747,true,2856364054,28,2825965401,-30398653
1651254494,196748,true,2856078446,28,2825965401,-30113045
1651254713,196751,true,2855221794,28,2825117781,-30104013
1651254785,196753,true,2854650835,28,2825117781,-29533054
1651254961,196755,true,2854079991,28,2824835298,-29244693
1651255257,196756,true,2853794611,28,2824270415,-29524196
1651255618,196759,true,2852938644,28,2822576446,-30362198
1651256186,196761,true,2852368142,28,2819755421,-32612721
1651256614,196763,true,2851797754,28,2819473474,-32324280
1651256643,196763,true,2851797754,28,2819473474,-32324280
1651256684,196766,true,2850942385,28,2819473474,-31468911
1651256927,196766,true,2850942385,28,2818345966,-32596419
1651257007,196769,true,2850087274,28,2818064160,-32023114
1651257171,196769,true,2850087274,28,2817782382,-32304892
1651257230,196771,true,2849517342,28,2817782382,-31734960
1651257398,196771,true,2849517342,28,2817782382,-31734960
1651257645,196774,true,2848662658,28,2818064160,-30598498
1651258063,196774,true,2848662658,28,2818064160,-30598498
1651258107,196776,true,2848093010,28,2818064160,-30028850
1651258198,196777,true,2847808230,28,2817500632,-30307598
1651258209,196779,true,2847238753,28,2817500632,-29738121
1651258718,196780,true,2846954058,28,2814403240,-32550818
1651258761,196783,true,2846100143,28,2814403240,-31696903
1651258967,196783,true,2846100143,28,2813277760,-32822383
1651259444,196785,true,2845531008,28,2811590384,-33940624
1651259562,196786,true,2845246483,28,2810747075,-34499408
1651259614,196787,true,2844961987,28,2810466029,-34495958
1651259764,196787,true,2844961987,28,2809342123,-35619864
1651260459,196789,true,2844393080,28,2808780339,-35612741
1651260498,196790,true,2844108669,28,2808780339,-35328330
1651260525,196791,true,2843824287,28,2808499489,-35324798
1651260603,196792,true,2843539933,28,2808218667,-35321266
1651260630,196795,true,2842687041,28,2807937874,-34749167
1651260645,196797,true,2842118589,28,2807937874,-34180715
1651260852,196798,true,2841834406,28,2805973103,-35861303
1651260943,196799,true,2841550251,28,2804850994,-36699257
1651261036,196803,true,2840413915,28,2804009707,-36404208
1651261064,196804,true,2840129902,28,2803729334,-36400568
1651261191,196806,true,2839561961,28,2802327890,-37234071
1651261643,196807,true,2839278033,28,2797847974,-41430059
1651261650,196811,true,2838142606,28,2797847974,-40294632
1651261977,196813,true,2837575062,28,2793933923,-43641139
1651262550,196815,true,2837007633,28,2788909617,-48098016
1651262563,196816,true,2836723960,28,2788909617,-47814343
1651263099,196821,true,2835306024,28,2788073111,-47232913
1651263253,196823,true,2834739047,28,2788073111,-46665936
1651263354,196825,true,2834172185,28,2788073111,-46099074
1651263477,196826,true,2833888796,28,2788351919,-45536877
1651263542,196830,true,2832755524,28,2788351919,-44403605
1651263567,196831,true,2832472276,28,2788630754,-43841522
1651263590,196833,true,2831905867,28,2788630754,-43275113
1651263607,196834,true,2831622705,28,2788630754,-42991951
1651263691,196837,true,2830773388,28,2789467427,-41305961
1651263733,196838,true,2830490339,28,2789746373,-40743966
1651263867,196840,true,2829924325,28,2790862439,-39061886
1651264982,196841,true,2829641361,28,2801487360,-28154001
1651266398,196844,true,2828792639,28,2805411993,-23380646
1651266843,196846,true,2828226965,28,2805411993,-22814972
1651266902,196848,true,2827661404,28,2805411993,-22249411
1651267020,196849,true,2827378667,28,2805411993,-21966674
1651267084,196853,true,2826247998,28,2805692534,-20555464
1651267585,196854,true,2825965401,28,2807376370,-18589031
1651267754,196855,true,2825682833,28,2807937874,-17744959
1651268699,196856,true,2825400293,28,2811590384,-13809909
1651269046,196859,true,2824552842,28,2811871543,-12681299
1651269191,196861,true,2823988016,28,2811871543,-12116473
1651270544,196863,true,2823423304,28,2810747075,-12676229
1651270575,196863,true,2823423304,28,2810466029,-12957275
1651270885,196867,true,2822294217,28,2809342123,-12952094
1651270967,196869,true,2821729842,28,2809061217,-12668625
1651271435,196871,true,2821165581,28,2808218667,-12946914
1651271489,196872,true,2820883493,28,2808218667,-12664826
1651271508,196876,true,2819755421,28,2808218667,-11536754
1651271511,196878,true,2819191555,28,2808218667,-10972888
1651272000,196879,true,2818909664,28,2809061217,-9848447
1651274019,196879,true,2818909664,28,2814121828,-4787836
1651274094,196882,true,2818064160,28,2814403240,-3660920
1651274590,196883,true,2817782382,28,2814684680,-3097702
1651277198,196884,true,2817500632,28,2815247645,-2252987
1651277955,196884,true,2817500632,28,2815810723,-1689909
1651278054,196887,true,2816655551,28,2815810723,-844828
1651278161,196888,true,2816373913,28,2816092304,-281609
1651278455,196889,true,2816092304,28,2817218910,1126606
1651278828,196888,true,2816373913,28,2818909664,2535751
1651279116,196891,true,2815529170,28,2820037397,4508227
1651280606,196893,true,2814966149,28,2821447698,6481549
1651280826,196893,true,2814966149,28,2821165581,6199432
1651280914,196893,true,2814966149,28,2821165581,6199432
1651282359,196895,true,2814403240,28,2821729842,7326602
1651282416,196897,true,2813840444,28,2821729842,7889398
1651282916,196898,true,2813559088,28,2822012015,8452927
1651283255,196897,true,2813840444,28,2822294217,8453773
1651283274,196900,true,2812996460,28,2822294217,9297757
1651283284,196901,true,2812715189,28,2822294217,9579028
1651283376,196902,true,2812433945,28,2822294217,9860272
1651283561,196901,true,2812715189,28,2822576446,9861257
1651283583,196904,true,2811871543,28,2822576446,10704903
1651283668,196905,true,2811590384,28,2822858704,11268320
1651284433,196906,true,2811309253,28,2824270415,12961162
1651284459,196905,true,2811590384,28,2824270415,12680031
1651284536,196905,true,2811590384,28,2824552842,12962458
1651284553,196906,true,2811309253,28,2824552842,13243589
1651284581,196905,true,2811590384,28,2824835298,13244914
1651284819,196904,true,2811871543,28,2825965401,14093858
1651286155,196904,true,2811871543,28,2831056465,19184922
1651286584,196904,true,2811871543,28,2831339571,19468028
1651287100,196903,true,2812152730,28,2831339571,19186841
1651287384,196902,true,2812433945,28,2831339571,18905626
1651287925,196903,true,2812152730,28,2830490339,18337609
1651288067,196903,true,2812152730,28,2830207318,18054588
1651288198,196903,true,2812152730,28,2829924325,17771595
1651288225,196902,true,2812433945,28,2829924325,17490380
1651288595,196903,true,2812152730,28,2828509788,16357058
1651288672,196904,true,2811871543,28,2828226965,16355422
1651289271,196903,true,2812152730,28,2824835298,12682568
1651289291,196902,true,2812433945,28,2824835298,12401353
1651289507,196902,true,2812433945,28,2823988016,11554071
1651289509,196903,true,2812152730,28,2823988016,11835286
1651289553,196903,true,2812152730,28,2823705646,11552916
1651289931,196902,true,2812433945,28,2821165581,8731636
1651290762,196903,true,2812152730,28,2815810723,3657993
1651291495,196904,true,2811871543,28,2812996460,1124917
1651291611,196904,true,2811871543,28,2812996460,1124917
1651291777,196903,true,2812152730,28,2812996460,843730
1651293256,196903,true,2812152730,28,2815247645,3094915
1651294400,196904,true,2811871543,28,2814403240,2531697
1651294982,196904,true,2811871543,28,2813840444,1968901
1651295091,196903,true,2812152730,28,2813840444,1687714
1651295167,196904,true,2811871543,28,2814121828,2250285
1651295229,196905,true,2811590384,28,2814121828,2531444
1651295461,196904,true,2811871543,28,2814684680,2813137
1651295475,196903,true,2812152730,28,2814966149,2813419
1651295542,196904,true,2811871543,28,2814966149,3094606
1651295572,196903,true,2812152730,28,2815247645,3094915
1651296261,196902,true,2812433945,28,2817782382,5348437
1651297285,196901,true,2812715189,28,2820601433,7886244
1651297355,196902,true,2812433945,28,2820883493,8449548
1651297438,196902,true,2812433945,28,2820883493,8449548
1651297601,196901,true,2812715189,28,2821447698,8732509
1651297622,196900,true,2812996460,28,2821447698,8451238
1651298109,196899,true,2813277760,28,2824552842,11275082
1651299551,196899,true,2813277760,28,2833038799,19761039
1651299850,196897,true,2813840444,28,2833038799,19198355
1651300880,196896,true,2814121828,28,2833038799,18916971
1651302041,196895,true,2814403240,28,2832755524,18352284
1651303276,196895,true,2814403240,28,2829924325,15521085
1651304424,196893,true,2814966149,28,2828226965,13260816
1651304526,196892,true,2815247645,28,2828509788,13262143
1651305257,196891,true,2815529170,28,2829075518,13546348
1651305743,196890,true,2815810723,28,2829641361,13830638
1651306047,196888,true,2816373913,28,2829924325,13550412
1651306077,196887,true,2816655551,28,2829924325,13268774
1651307063,196886,true,2816937216,28,2830207318,13270102
1651307091,196885,true,2817218910,28,2830207318,12988408
1651307239,196883,true,2817782382,28,2830490339,12707957
1651307592,196881,true,2818345966,28,2831056465,12710499
1651307824,196880,true,2818627801,28,2831056465,12428664
1651308292,196879,true,2818909664,28,2831339571,12429907
1651308317,196877,true,2819473474,28,2831339571,11866097
1651308320,196876,true,2819755421,28,2831339571,11584150
1651308458,196875,true,2820037397,28,2831339571,11302174
1651309355,196874,true,2820319401,28,2830490339,10170938
1651309537,196873,true,2820601433,28,2829924325,9322892
1651310479,196871,true,2821165581,28,2828226965,7061384
1651310819,196871,true,2821165581,28,2827661404,6495823
1651311007,196871,true,2821165581,28,2827378667,6213086
1651311414,196869,true,2821729842,28,2827095957,5366115
1651312429,196868,true,2822012015,28,2827944171,5932156
1651312608,196868,true,2822012015,28,2828226965,6214950
1651312651,196868,true,2822012015,28,2828792639,6780624
1651312656,196866,true,2822576446,28,2828792639,6216193
1651312851,196864,true,2823140989,28,2830490339,7349350
1651313238,196863,true,2823423304,28,2833605435,10182131
1651313242,196863,true,2823423304,28,2833888796,10465492
1651313251,196862,true,2823705646,28,2833888796,10183150
1651313300,196860,true,2824270415,28,2834172185,9901770
1651313320,196859,true,2824552842,28,2834455602,9902760
1651313363,196859,true,2824552842,28,2834739047,10186205
1651313372,196858,true,2824835298,28,2835022521,10187223
1651313510,196856,true,2825400293,28,2835873113,10472820
1651313518,196855,true,2825682833,28,2836156700,10473867
1651313943,196855,true,2825682833,28,2839278033,13595200
1651314206,196853,true,2826247998,28,2840982026,14734028
1651314266,196851,true,2826813276,28,2841550251,14736975
1651314291,196851,true,2826813276,28,2841550251,14736975
1651314378,196851,true,2826813276,28,2841834406,15021130
1651314530,196850,true,2827095957,28,2841266124,14170167
1651315188,196849,true,2827378667,28,2838142606,10763939
1651316620,196848,true,2827661404,28,2834739047,7077643
1651317168,196849,true,2827378667,28,2834739047,7360380
1651317710,196848,true,2827661404,28,2835022521,7361117
1651319057,196846,true,2828226965,28,2835022521,6795556
1651319260,196845,true,2828509788,28,2835022521,6512733
1651319365,196846,true,2828226965,28,2835306024,7079059
1651320404,196846,true,2828226965,28,2835306024,7079059
1651320939,196845,true,2828509788,28,2835306024,6796236
1651321468,196844,true,2828792639,28,2835306024,6513385
1651321651,196844,true,2828792639,28,2835306024,6513385
1651322247,196844,true,2828792639,28,2835306024,6513385
1651322311,196843,true,2829075518,28,2835306024,6230506
1651322415,196842,true,2829358425,28,2835306024,5947599
1651323276,196843,true,2829075518,28,2834455602,5380084
1651324342,196843,true,2829075518,28,2833038799,3963281
1651324493,196842,true,2829358425,28,2832472276,3113851
1651324678,196841,true,2829641361,28,2831056465,1415104
1651324742,196842,true,2829358425,28,2830773388,1414963
1651324768,196843,true,2829075518,28,2830490339,1414821
1651325080,196842,true,2829358425,28,2828792639,-565786
1651326227,196841,true,2829641361,28,2822576446,-7064915
1651327276,196842,true,2829358425,28,2821447698,-7910727
1651327395,196843,true,2829075518,28,2821447698,-7627820
1651327415,196842,true,2829358425,28,2821165581,-8192844
1651327448,196842,true,2829358425,28,2820883493,-8474932
1651327457,196843,true,2829075518,28,2820883493,-8192025
1651327496,196846,true,2828226965,28,2820601433,-7625532
1651327581,196845,true,2828509788,28,2820037397,-8472391
1651327620,196845,true,2828509788,28,2819755421,-8754367
1651327672,196846,true,2828226965,28,2819473474,-8753491
1651328245,196848,true,2827661404,28,2818064160,-9597244
1651328286,196847,true,2827944171,28,2817782382,-10161789
1651328392,196846,true,2828226965,28,2817500632,-10726333
1651328422,196848,true,2827661404,28,2817500632,-10160772
1651328517,196850,true,2827095957,28,2816937216,-10158741
1651328527,196849,true,2827378667,28,2816937216,-10441451
1651328576,196848,true,2827661404,28,2816655551,-11005853
1651329353,196850,true,2827095957,28,2810747075,-16348882
1651329800,196852,true,2826530623,28,2807657108,-18873515
1651330162,196851,true,2826813276,28,2805131479,-21681797
1651330228,196850,true,2827095957,28,2804850994,-22244963
1651330237,196852,true,2826530623,28,2804850994,-21679629
1651330681,196855,true,2825682833,28,2802047685,-23635148
1651330731,196854,true,2825965401,28,2801767509,-24197892
1651330799,196853,true,2826247998,28,2801207239,-25040759
1651330824,196855,true,2825682833,28,2800927147,-24755686
1651330961,196858,true,2824835298,28,2800087036,-24748262
1651330986,196857,true,2825117781,28,2799807056,-25310725
1651331001,196856,true,2825400293,28,2799527103,-25873190
1651331257,196858,true,2824835298,28,2796169853,-28665445
1651331377,196862,true,2823705646,28,2795051665,-28653981
1651331404,196861,true,2823988016,28,2794772187,-29215829
1651331427,196860,true,2824270415,28,2794492738,-29777677
1651331450,196862,true,2823705646,28,2794213317,-29492329
1651331504,196865,true,2822858704,28,2793933923,-28924781
1651331711,196864,true,2823140989,28,2793375220,-29765769
1651331793,196863,true,2823423304,28,2793095911,-30327393
1651332525,196865,true,2822858704,28,2792537375,-30321329
1651332793,196868,true,2822012015,28,2793933923,-28078092
1651333004,196866,true,2822576446,28,2797288489,-25287957
1651333979,196865,true,2822858704,28,2806253700,-16605004
1651333997,196866,true,2822576446,28,2806534326,-16042120
1651334028,196869,true,2821729842,28,2806534326,-15195516
1651334080,196868,true,2822012015,28,2807095661,-14916354
1651334115,196867,true,2822294217,28,2807376370,-14917847
1651335235,196869,true,2821729842,28,2812715189,-9014653
1651335676,196872,true,2820883493,28,2813559088,-7324405
1651336159,196871,true,2821165581,28,2813840444,-7325137
1651336299,196869,true,2821729842,28,2813840444,-7889398
1651337316,196871,true,2821165581,28,2813840444,-7325137
1651337857,196874,true,2820319401,28,2813559088,-6760313
1651337918,196873,true,2820601433,28,2813559088,-7042345
1651338136,196871,true,2821165581,28,2812715189,-8450392
1651338142,196873,true,2820601433,28,2812715189,-7886244
1651338217,196877,true,2819473474,28,2812152730,-7320744
1651338959,196876,true,2819755421,28,2806534326,-13221095
1651340071,196876,true,2819755421,28,2797847974,-21907447
1651340502,196877,true,2819473474,28,2797008788,-22464686
1651340910,196881,true,2818345966,28,2796449470,-21896496
1651341088,196881,true,2818345966,28,2796449470,-21896496
1651342669,196881,true,2818345966,28,2790025348,-28320618
1651344253,196883,true,2817782382,28,2789188508,-28593874
1651344597,196886,true,2816937216,28,2789188508,-27748708
1651344783,196886,true,2816937216,28,2788909617,-28027599
1651345106,196886,true,2816937216,28,2788073111,-28864105
1651345122,196888,true,2816373913,28,2788073111,-28300802
1651345305,196892,true,2815247645,28,2787794332,-27453313
1651345316,196891,true,2815529170,28,2787794332,-27734838
1651346099,196891,true,2815529170,28,2786958161,-28571009
1651348256,196893,true,2814966149,28,2787236857,-27729292
1651348282,196897,true,2813840444,28,2787515580,-26324864
1651348410,196897,true,2813840444,28,2787794332,-26046112
1651348430,196896,true,2814121828,28,2787794332,-26327496
1651348458,196898,true,2813559088,28,2788073111,-25485977
1651348474,196902,true,2812433945,28,2788073111,-24360834
1651348580,196901,true,2812715189,28,2788909617,-23805572
1651348653,196902,true,2812433945,28,2789746373,-22687572
1651348976,196903,true,2812152730,28,2792816629,-19336101
1651349551,196906,true,2811309253,28,2798127759,-13181494
1651349921,196906,true,2811309253,28,2801767509,-9541744
1651350125,196907,true,2811028150,28,2803729334,-7298816
1651350507,196908,true,2810747075,28,2804570537,-6176538
1651350669,196912,true,2809623058,28,2804009707,-5613351
1651351368,196912,true,2809623058,28,2801487360,-8135698
1651352069,196912,true,2809623058,28,2797847974,-11775084
1651352531,196913,true,2809342123,28,2796169853,-13172270
1651352856,196917,true,2808218667,28,2795890264,-12328403
1651353888,196917,true,2808218667,28,2795051665,-13167002
1651353956,196918,true,2807937874,28,2795051665,-12886209
1651354162,196919,true,2807657108,28,2794772187,-12884921
1651355691,196923,true,2806534326,28,2793933923,-12600403
1651355768,196923,true,2806534326,28,2793654558,-12879768
1651356305,196923,true,2806534326,28,2794213317,-12321009
1651356482,196924,true,2806253700,28,2793933923,-12319777
1651356506,196928,true,2805131479,28,2793933923,-11197556
1651356584,196928,true,2805131479,28,2793654558,-11476921
1651357340,196929,true,2804850994,28,2791699782,-13151212
1651357916,196930,true,2804570537,28,2789467427,-15103110
1651357989,196934,true,2803448990,28,2789188508,-14260482
1651358106,196934,true,2803448990,28,2788630754,-14818236
1651359704,196935,true,2803168673,28,2788630754,-14537919
1651359830,196936,true,2802888384,28,2787515580,-15372804
1651359870,196940,true,2801767509,28,2786958161,-14809348
1651359884,196940,true,2801767509,28,2786679493,-15088016
1651359896,196944,true,2800647082,28,2786679493,-13967589
1651359901,196945,true,2800367045,28,2786400853,-13966192
1651359916,196950,true,2798967282,28,2786122241,-12845041
1651359962,196950,true,2798967282,28,2785286571,-13680711
1651359986,196954,true,2797847974,28,2784729597,-13118377
1651360037,196956,true,2797288489,28,2783615984,-13672505
1651360051,196959,true,2796449470,28,2783337650,-13111820
1651360058,196960,true,2796169853,28,2783059344,-13110509
1651360082,196964,true,2795051665,28,2782502816,-12548849
1651360125,196966,true,2794492738,28,2781111982,-13380756
1651360232,196970,true,2793375220,28,2777776815,-15598405
1651360271,196971,true,2793095911,28,2776388344,-16707567
1651360416,196975,true,2791978952,28,2771395589,-20583363
1651360561,196977,true,2791420640,28,2766965123,-24455517
1651360662,196980,true,2790583381,28,2763923287,-26660094
1651361637,196980,true,2790583381,28,2737244168,-53339213
1651361688,196985,true,2789188508,28,2736423159,-52765349
1651361756,196987,true,2788630754,28,2735602396,-53028358
1651361795,196990,true,2787794332,28,2735328863,-52465469
1651361824,196991,true,2787515580,28,2735055357,-52460223
1651362038,196996,true,2786122241,28,2734508428,-51613813
1651362331,196998,true,2785565100,28,2734508428,-51056672
1651363592,197001,true,2784729597,28,2729318054,-55411543
1651363662,197002,true,2784451152,28,2729045150,-55406002
1651363713,197006,true,2783337650,28,2729045150,-54292500
1651363783,197008,true,2782781066,28,2729318054,-53463012
1651364289,197010,true,2782224593,28,2730956055,-51268538
1651364310,197011,true,2781946399,28,2730956055,-50990344
1651364354,197015,true,2780833898,28,2731229150,-49604748
1651364470,197017,true,2780277815,28,2731502273,-48775542
1651365012,197019,true,2779721843,28,2733141584,-46580259
1651365026,197019,true,2779721843,28,2733414898,-46306945
1651365059,197023,true,2778610232,28,2733414898,-45195334
1651365128,197025,true,2778054593,28,2733414898,-44639695
1651365168,197027,true,2777499066,28,2733414898,-44084168
1651365380,197027,true,2777499066,28,2733414898,-44084168
1651365392,197031,true,2776388344,28,2733141584,-43246760
1651365409,197032,true,2776110733,28,2733414898,-42695835
1651365511,197033,true,2775833149,28,2733414898,-42418251
1651365535,197033,true,2775833149,28,2733414898,-42418251
1651365562,197038,true,2774445649,28,2733414898,-41030751
1651365565,197039,true,2774168232,28,2733414898,-40753334
1651369377,197040,true,2773890843,28,2737517892,-36372951
1651369412,197041,true,2773613482,28,2737791644,-35821838
1651370505,197044,true,2772781564,28,2752890226,-19891338
1651375412,197044,true,2772781564,28,2763370585,-9410979
1651375810,197045,true,2772504314,28,2763094276,-9410038
1651377733,197045,true,2772504314,28,2774445649,1941335
1651377768,197049,true,2771395589,28,2774723093,3327504
1651377802,197049,true,2771395589,28,2774723093,3327504
1651377831,197049,true,2771395589,28,2774723093,3327504
1651377838,197050,true,2771118477,28,2774723093,3604616
1651377851,197054,true,2770010307,28,2774723093,4712786
1651377869,197054,true,2770010307,28,2774723093,4712786
1651377904,197054,true,2770010307,28,2774723093,4712786
1651378447,197054,true,2770010307,28,2776388344,6378037
1651378463,197058,true,2768902580,28,2776388344,7485764
1651378543,197058,true,2768902580,28,2776665982,7763402
1651379205,197058,true,2768902580,28,2778054593,9152013
1651379567,197058,true,2768902580,28,2778610232,9707652
1651379597,197063,true,2767518544,28,2778610232,11091688
1651379927,197062,true,2767795296,28,2778332399,10537103
1651381897,197062,true,2767795296,28,2774723093,6927797
1651382079,197062,true,2767795296,28,2775278066,7482770
1651382092,197065,true,2766965123,28,2775278066,8312943
1651382099,197065,true,2766965123,28,2775278066,8312943
1651384357,197064,true,2767241819,28,2786958161,19716342
1651384756,197063,true,2767518544,28,2785008070,17489526
1651385103,197066,true,2766688454,28,2783059344,16370890
1651385213,197066,true,2766688454,28,2782502816,15814362
1651385457,197065,true,2766965123,28,2781668232,14703109
1651386287,197064,true,2767241819,28,2779999815,12757996
1651386316,197067,true,2766411813,28,2779999815,13588002
1651389921,197067,true,2766411813,28,2779165982,12754169
1651390245,197066,true,2766688454,28,2779165982,12477528
1651390670,197065,true,2766965123,28,2778888093,11922970
1651390880,197068,true,2766135199,28,2778888093,12752894
1651391084,197068,true,2766135199,28,2778610232,12475033
1651391114,197067,true,2766411813,28,2778610232,12198419
1651391589,197067,true,2766411813,28,2776943649,10531836
1651392165,197070,true,2765582055,28,2773613482,8031427
1651392856,197071,true,2765305525,28,2769733334,4427809
1651392989,197070,true,2765582055,28,2769456388,3874333
1651393076,197071,true,2765305525,28,2769179470,3873945
1651393111,197075,true,2764199679,28,2769179470,4979791
1651393374,197075,true,2764199679,28,2768902580,4702901
1651394937,197074,true,2764476099,28,2771672729,7196630
1651395031,197075,true,2764199679,28,2771672729,7473050
1651395156,197079,true,2763094276,28,2771672729,8578453
1651395945,197079,true,2763094276,28,2772781564,9687288
1651396212,197078,true,2763370585,28,2773058842,9688257
1651396424,197078,true,2763370585,28,2773336148,9965563
1651397702,197082,true,2762265513,28,2773890843,11625330
1651397847,197082,true,2762265513,28,2773890843,11625330
1651397907,197081,true,2762541740,28,2773890843,11349103
1651397937,197081,true,2762541740,28,2773890843,11349103
1651397946,197085,true,2761436999,28,2773890843,12453844
1651398123,197086,true,2761160883,28,2773058842,11897959
1651399123,197085,true,2761436999,28,2767518544,6081545
1651400186,197085,true,2761436999,28,2763923287,2486288
1651400357,197089,true,2760332700,28,2763923287,3590587
1651400677,197090,true,2760056695,28,2764476099,4419404
1651402233,197088,true,2760608734,28,2767518544,6909810
1651403793,197088,true,2760608734,28,2768072075,7463341
1651403803,197091,true,2759780717,28,2768072075,8291358
1651405053,197092,true,2759504766,28,2766411813,6907047
1651405080,197091,true,2759780717,28,2766135199,6354482
1651405282,197091,true,2759780717,28,2765858614,6077897
1651405296,197094,true,2758952948,28,2765858614,6905666
1651405546,197095,true,2758677080,28,2765305525,6628445
1651405889,197094,true,2758952948,28,2765029022,6076074
1651405943,197094,true,2758952948,28,2765029022,6076074
1651405950,197095,true,2758677080,28,2765029022,6351942
1651406020,197095,true,2758677080,28,2764752547,6075467
1651406105,197094,true,2758952948,28,2764476099,5523151
1651406647,197093,true,2759228843,28,2762541740,3312897
1651408533,197094,true,2758952948,28,2762265513,3312565
1651408894,197094,true,2758952948,28,2762265513,3312565
1651410252,197092,true,2759504766,28,2761160883,1656117
1651412141,197092,true,2759504766,28,2760608734,1103968
1651412154,197092,true,2759504766,28,2760884795,1380029
1651415686,197091,true,2759780717,28,2762817994,3037277
1651418249,197088,true,2760608734,28,2762817994,2209260
1651418572,197088,true,2760608734,28,2763094276,2485542
1651418582,197087,true,2760884795,28,2763094276,2209481
1651418628,197087,true,2760884795,28,2763370585,2485790
1651418753,197084,true,2761713143,28,2764199679,2486536
1651418777,197083,true,2761989314,28,2764476099,2486785
1651418837,197082,true,2762265513,28,2765029022,2763509
1651418838,197081,true,2762541740,28,2765029022,2487282
1651418881,197078,true,2763370585,28,2765305525,1934940
1651418935,197077,true,2763646922,28,2765858614,2211692
1651418987,197076,true,2763923287,28,2766688454,2765167
1651419061,197074,true,2764476099,28,2767518544,3042445
1651419068,197071,true,2765305525,28,2767795296,2489771
1651420424,197069,true,2765858614,28,2788909617,23051003
1651420469,197068,true,2766135199,28,2789467427,23332228
1651421368,197065,true,2766965123,28,2799527103,32561980
1651421493,197063,true,2767518544,28,2800647082,33128538
1651421525,197059,true,2768625717,28,2800927147,32301430
1651421555,197058,true,2768902580,28,2801207239,32304659
1651422210,197055,true,2769733334,28,2812433945,42700611
1651422318,197052,true,2770564337,28,2813559088,42994751
1651422865,197048,true,2771672729,28,2818064160,46391431
1651424247,197047,true,2771949896,28,2821447698,49497802
1651424616,197043,true,2773058842,28,2820319401,47260559
1651425592,197040,true,2773890843,28,2814684680,40793837
1651425687,197037,true,2774723093,28,2814121828,39398735
1651428161,197036,true,2775000566,28,2810747075,35746509
1651428403,197033,true,2775833149,28,2810466029,34632880
1651428460,197030,true,2776665982,28,2810185010,33519028
1651429236,197027,true,2777499066,28,2808780339,31281273
1651429334,197027,true,2777499066,28,2808218667,30719601
1651429593,197024,true,2778332399,28,2806814979,28482580
1651429963,197021,true,2779165982,28,2804290108,25124126
1651430032,197019,true,2779721843,28,2803729334,24007491
1651430540,197020,true,2779443898,28,2800927147,21483249
1651430547,197018,true,2779999815,28,2800927147,20927332
1651430991,197017,true,2780277815,28,2798127759,17849944
1651431063,197015,true,2780833898,28,2797568218,16734320
1651431081,197016,true,2780555843,28,2797288489,16732646
1651431242,197015,true,2780833898,28,2795890264,15056366
1651431262,197015,true,2780833898,28,2795610703,14776805
1651431447,197014,true,2781111982,28,2794213317,13101335
1651431593,197015,true,2780833898,28,2792816629,11982731
1651431747,197015,true,2780833898,28,2791420640,10586742
1651431782,197015,true,2780833898,28,2790862439,10028541
1651431943,197014,true,2781111982,28,2788630754,7518772
1651432009,197016,true,2780555843,28,2787794332,7238489
1651432571,197016,true,2780555843,28,2779165982,-1389861
1651433418,197016,true,2780555843,28,2769733334,-10822509
1651433514,197015,true,2780833898,28,2768902580,-11931318
1651434233,197017,true,2780277815,28,2766411813,-13866002
1651434334,197017,true,2780277815,28,2766411813,-13866002
1651434656,197018,true,2779999815,28,2765858614,-14141201
1651434682,197017,true,2780277815,28,2765858614,-14419201
1651435488,197018,true,2779999815,28,2765858614,-14141201
1651435591,197019,true,2779721843,28,2765858614,-13863229
1651436843,197020,true,2779443898,28,2765582055,-13861843
1651436887,197019,true,2779721843,28,2765582055,-14139788
1651436913,197021,true,2779165982,28,2765582055,-13583927
1651437739,197021,true,2779165982,28,2766965123,-12200859
1651438462,197022,true,2778888093,28,2768348882,-10539211
1651438470,197021,true,2779165982,28,2768348882,-10817100
1651438483,197023,true,2778610232,28,2768625717,-9984515
1651438545,197022,true,2778888093,28,2769179470,-9708623
1651438680,197021,true,2779165982,28,2770564337,-8601645
1651438713,197020,true,2779443898,28,2770841393,-8602505
1651438734,197022,true,2778888093,28,2771118477,-7769616
1651438771,197021,true,2779165982,28,2771949896,-7216086
1651438790,197019,true,2779721843,28,2772227091,-7494752
1651438955,197017,true,2780277815,28,2775555594,-4722221
1651439001,197018,true,2779999815,28,2776388344,-3611471
1651439347,197016,true,2780555843,28,2783894345,3338502
1651439410,197014,true,2781111982,28,2785286571,4174589
1651439575,197012,true,2781668232,28,2788630754,6962522
1651440177,197013,true,2781390093,28,2800367045,18976952
1651441020,197012,true,2781668232,28,2804290108,22621876
1651442384,197010,true,2782224593,28,2802608123,20383530
1651442505,197008,true,2782781066,28,2802608123,19827057
1651442593,197009,true,2782502816,28,2802888384,20385568
1651442623,197008,true,2782781066,28,2802888384,20107318
1651442716,197006,true,2783337650,28,2803168673,19831023
1651442998,197003,true,2784172735,28,2804290108,20117373
1651443103,197004,true,2783894345,28,2804850994,20956649
1651443295,197003,true,2784172735,28,2806253700,22080965
1651443342,197001,true,2784729597,28,2806534326,21804729
1651443387,196998,true,2785565100,28,2806814979,21249879
1651443814,196999,true,2785286571,28,2810185010,24898439
1651443828,196997,true,2785843656,28,2810185010,24341354
1651444414,196995,true,2786400853,28,2811309253,24908400
1651445731,196992,true,2787236857,28,2804009707,16772850
1651445774,196994,true,2786679493,28,2803729334,17049841
1651445816,196992,true,2787236857,28,2803729334,16492477
1651446221,196990,true,2787794332,28,2803729334,15935002
1651446248,196988,true,2788351919,28,2803729334,15377415
1651446473,196989,true,2788073111,28,2804570537,16497426
1651446782,196986,true,2788909617,28,2805692534,16782917
1651447127,196984,true,2789467427,28,2807657108,18189681
1651447293,196982,true,2790025348,28,2808499489,18474141
1651447317,196983,true,2789746373,28,2808780339,19033966
1651447357,196980,true,2790583381,28,2809342123,18758742
1651447379,196978,true,2791141526,28,2809623058,18481532
1651447565,196974,true,2792258150,28,2812433945,20175795
1651447596,196974,true,2792258150,28,2812715189,20457039
1651447680,196971,true,2793095911,28,2814121828,21025917
1651448324,196968,true,2793933923,28,2825400293,31466370
1651448606,196964,true,2795051665,28,2829358425,34306760
1651448708,196965,true,2794772187,28,2830773388,36001201
1651449987,196962,true,2795610703,28,2830773388,35162685
1651450006,196959,true,2796449470,28,2830773388,34323918
1651450525,196955,true,2797568218,28,2829075518,31507300
1651450551,196956,true,2797288489,28,2829358425,32069936
1651450581,196953,true,2798127759,28,2829358425,31230666
1651450595,196950,true,2798967282,28,2829641361,30674079
1651450916,196945,true,2800367045,28,2831622705,31255660
1651453532,196946,true,2800087036,28,2840129902,40042866
1651456236,196944,true,2800647082,28,2840982026,40334944
1651456863,196941,true,2801487360,28,2840982026,39494666
1651457474,196937,true,2802608123,28,2840129902,37521779
1651457889,196938,true,2802327890,28,2839561961,37234071
1651460515,196936,true,2802888384,28,2838426420,35538036
1651462364,196934,true,2803448990,28,2838426420,34977430
1651465825,196929,true,2804850994,28,2838426420,33575426
1651466229,196931,true,2804290108,28,2838426420,34136312
1651467073,196929,true,2804850994,28,2837575062,32724068
1651467111,196927,true,2805411993,28,2837858820,32446827
1651467168,196924,true,2806253700,28,2838142606,31888906
1651467258,196925,true,2805973103,28,2838426420,32453317
1651467281,196923,true,2806534326,28,2838710263,32175937
1651468543,196920,true,2807376370,28,2848947524,41571154
1651469214,196918,true,2807937874,28,2852082933,44145059
1651470367,196919,true,2807657108,28,2852082933,44425825
1651470447,196918,true,2807937874,28,2852368142,44430268
1651470795,196916,true,2808499489,28,2852653379,44153890
1651470808,196914,true,2809061217,28,2852653379,43592162
1651471208,196915,true,2808780339,28,2853794611,45014272
1651471504,196914,true,2809061217,28,2854936300,45875083
1651471646,196911,true,2809904020,28,2855507316,45603296
1651471806,196909,true,2810466029,28,2856649690,46183661
1651474399,196908,true,2810747075,28,2865518601,54771526
1651476679,196907,true,2811028150,28,2865518601,54490451
1651477013,196904,true,2811871543,28,2865232077,53360534
1651477046,196902,true,2812433945,28,2864945583,52511638
1651477715,196901,true,2812715189,28,2863799891,51084702
1651477804,196900,true,2812996460,28,2863513540,50517080
1651477832,196897,true,2813840444,28,2863513540,49673096
1651477890,196894,true,2814684680,28,2863227217,48542537
1651478264,196893,true,2814966149,28,2861796033,46829884
1651478282,196892,true,2815247645,28,2861509882,46262237
1651478283,196889,true,2816092304,28,2861509882,45417578
1651478434,196886,true,2816937216,28,2860365564,43428348
1651480027,196886,true,2816937216,28,2850657320,33720104
1651480117,196885,true,2817218910,28,2850372282,33153372
1651480211,196881,true,2818345966,28,2850372282,32026316
1651480265,196878,true,2819191555,28,2850087274,30895719
1651480370,196878,true,2819191555,28,2849802294,30610739
1651480619,196877,true,2819473474,28,2848947524,29474050
1651482216,196873,true,2820601433,28,2842971310,22369877
1651482515,196869,true,2821729842,28,2842687041,20957199
1651482569,196869,true,2821729842,28,2842687041,20957199
1651483344,196868,true,2822012015,28,2842687041,20675026
1651484291,196864,true,2823140989,28,2842687041,19546052
1651484760,196860,true,2824270415,28,2842687041,18416626
1651484802,196860,true,2824270415,28,2842687041,18416626
1651484825,196858,true,2824835298,28,2842687041,17851743
1651484874,196854,true,2825965401,28,2842402801,16437400
1651484923,196851,true,2826813276,28,2842118589,15305313
1651485420,196852,true,2826530623,28,2837007633,10477010
1651485504,196850,true,2827095957,28,2836156700,9060743
1651485588,196847,true,2827944171,28,2835022521,7078350
1651485608,196844,true,2828792639,28,2834739047,5946408
1651486734,196846,true,2828226965,28,2818627801,-9599164
1651486753,196844,true,2828792639,28,2818627801,-10164838
1651488767,196841,true,2829641361,28,2813277760,-16363601
1651488919,196838,true,2830490339,28,2813277760,-17212579
1651489955,196840,true,2829924325,28,2811590384,-18333941
1651490134,196839,true,2830207318,28,2811028150,-19179168
1651490233,196837,true,2830773388,28,2810747075,-20026313
1651490275,196835,true,2831339571,28,2810466029,-20873542
1651491745,196838,true,2830490339,28,2804570537,-25919802
1651491951,196837,true,2830773388,28,2804009707,-26763681
1651494193,196837,true,2830773388,28,2798687413,-32085975
1651494208,196835,true,2831339571,28,2798967282,-32372289
1651494731,196838,true,2830490339,28,2799527103,-30963236
1651495228,196838,true,2830490339,28,2800367045,-30123294
1651497045,196837,true,2830773388,28,2800367045,-30406343
1651497075,196836,true,2831056465,28,2800647082,-30409383
1651497082,196839,true,2830207318,28,2800647082,-29560236
1651497088,196838,true,2830490339,28,2800647082,-29843257
1651497100,196838,true,2830490339,28,2800647082,-29843257
1651497116,196835,true,2831339571,28,2800647082,-30692489
1651497144,196838,true,2830490339,28,2800647082,-29843257
1651497163,196837,true,2830773388,28,2800927147,-29846241
1651497662,196837,true,2830773388,28,2804290108,-26483280
1651497924,196835,true,2831339571,28,2806253700,-25085871
1651498142,196838,true,2830490339,28,2807937874,-22552465
1651498450,196837,true,2830773388,28,2810466029,-20307359
1651498470,196837,true,2830773388,28,2810466029,-20307359
1651498485,196835,true,2831339571,28,2810747075,-20592496
1651498529,196838,true,2830490339,28,2810747075,-19743264
1651498538,196838,true,2830490339,28,2810747075,-19743264
1651498562,196838,true,2830490339,28,2810747075,-19743264
1651498582,196836,true,2831056465,28,2810466029,-20590436
1651498590,196839,true,2830207318,28,2810466029,-19741289
1651498732,196840,true,2829924325,28,2809342123,-20582202
1651498762,196840,true,2829924325,28,2809342123,-20582202
1651498941,196837,true,2830773388,28,2809623058,-21150330
1651498956,196841,true,2829641361,28,2809623058,-20018303
1651498961,196841,true,2829641361,28,2809623058,-20018303
1651498997,196840,true,2829924325,28,2809623058,-20301267
1651499021,196837,true,2830773388,28,2809623058,-21150330
1651499052,196840,true,2829924325,28,2809904020,-20020305
1651499155,196840,true,2829924325,28,2810747075,-19177250
1651499311,196839,true,2830207318,28,2811871543,-18335775
1651500193,196836,true,2831056465,28,2819473474,-11582991
1651500301,196840,true,2829924325,28,2820319401,-9604924
1651500529,196840,true,2829924325,28,2825117781,-4806544
1651500552,196840,true,2829924325,28,2825400293,-4524032
1651500816,196838,true,2830490339,28,2827944171,-2546168
1651500845,196841,true,2829641361,28,2827944171,-1697190
1651500865,196841,true,2829641361,28,2827944171,-1697190
1651500937,196841,true,2829641361,28,2827661404,-1979957
1651500940,196839,true,2830207318,28,2827661404,-2545914
1651501015,196842,true,2829358425,28,2827378667,-1979758
1651501039,196842,true,2829358425,28,2827378667,-1979758
1651501548,196843,true,2829075518,28,2823140989,-5934529
1651501583,196842,true,2829358425,28,2822858704,-6499721
1651501706,196845,true,2828509788,28,2822294217,-6215571
1651501720,196845,true,2828509788,28,2822294217,-6215571
1651501727,196845,true,2828509788,28,2822294217,-6215571
1651501785,196844,true,2828792639,28,2822012015,-6780624
1651501850,196847,true,2827944171,28,2822012015,-5932156
1651501884,196847,true,2827944171,28,2822012015,-5932156
1651501891,196846,true,2828226965,28,2822012015,-6214950
1651501893,196845,true,2828509788,28,2822012015,-6497773
1651502043,196847,true,2827944171,28,2822858704,-5085467
1651502772,196847,true,2827944171,28,2829075518,1131347
1651502816,196846,true,2828226965,28,2829358425,1131460
1651503088,196845,true,2828509788,28,2833038799,4529011
1651503295,196847,true,2827944171,28,2835873113,7928942
1651503420,196848,true,2827661404,28,2837007633,9346229
1651503792,196848,true,2827661404,28,2837575062,9913658
1651503864,196847,true,2827944171,28,2837007633,9063462
1651504338,196850,true,2827095957,28,2833888796,6792839
1651506118,196851,true,2826813276,28,2827661404,848128
1651506131,196851,true,2826813276,28,2827661404,848128
1651506181,196850,true,2827095957,28,2827378667,282710
1651506596,196854,true,2825965401,28,2826530623,565222
1651508472,196855,true,2825682833,28,2823705646,-1977187
1651508599,196856,true,2825400293,28,2823988016,-1412277
1651510315,196855,true,2825682833,28,2826247998,565165
1651510348,196859,true,2824552842,28,2826247998,1695156
1651510396,196860,true,2824270415,28,2826247998,1977583
1651510495,196861,true,2823988016,28,2825965401,1977385
1651510632,196860,true,2824270415,28,2825400293,1129878
1651511025,196865,true,2822858704,28,2821447698,-1411006
1651511052,196866,true,2822576446,28,2821165581,-1410865
1651511061,196867,true,2822294217,28,2820883493,-1410724
1651511118,196867,true,2822294217,28,2820319401,-1974816
1651513449,196872,true,2820883493,28,2802888384,-17995109
1651513531,196873,true,2820601433,28,2802888384,-17713049
1651513596,196874,true,2820319401,28,2802608123,-17711278
1651513684,196874,true,2820319401,28,2802327890,-17991511
1651513699,196879,true,2818909664,28,2802327890,-16581774
1651514565,196880,true,2818627801,28,2797847974,-20779827
1651515181,196881,true,2818345966,28,2794492738,-23853228
1651515462,196881,true,2818345966,28,2792816629,-25529337
1651516396,196886,true,2816937216,28,2790304351,-26632865
1651516489,196887,true,2816655551,28,2790025348,-26630203
1651517143,196888,true,2816373913,28,2789188508,-27185405
1651517363,196888,true,2816373913,28,2789746373,-26627540
1651517557,196892,true,2815247645,28,2790304351,-24943294
1651517624,196894,true,2814684680,28,2790583381,-24101299
1651517664,196894,true,2814684680,28,2790862439,-23822241
1651517732,196894,true,2814684680,28,2791141526,-23543154
1651517788,196898,true,2813559088,28,2791420640,-22138448
1651518575,196899,true,2813277760,28,2796729115,-16548645
1651518751,196899,true,2813277760,28,2798127759,-15150001
1651518791,196898,true,2813559088,28,2798407572,-15151516
1651518808,196901,true,2812715189,28,2798687413,-14027776
1651518908,196902,true,2812433945,28,2799527103,-12906842
1651519219,196901,true,2812715189,28,2802327890,-10387299
1651519249,196900,true,2812996460,28,2802608123,-10388337
1651519265,196902,true,2812433945,28,2802888384,-9545561
1651519469,196902,true,2812433945,28,2805131479,-7302466
1651519484,196901,true,2812715189,28,2805411993,-7303196
1651519495,196900,true,2812996460,28,2805411993,-7584467
1651519973,196901,true,2812715189,28,2812433945,-281244
1651520065,196900,true,2812996460,28,2813840444,843984
1651520094,196899,true,2813277760,28,2814403240,1125480
1651520190,196897,true,2813840444,28,2816092304,2251860
1651520686,196897,true,2813840444,28,2825117781,11277337
1651520970,196896,true,2814121828,28,2829641361,15519533
1651520992,196894,true,2814684680,28,2829924325,15239645
1651521452,196893,true,2814966149,28,2835022521,20056372
1651521682,196892,true,2815247645,28,2837007633,21759988
1651524426,196891,true,2815529170,28,2842118589,26589419
1651524509,196889,true,2816092304,28,2842118589,26026285
1651526217,196888,true,2816373913,28,2833038799,16664886
1651526327,196887,true,2816655551,28,2832755524,16099973
1651526462,196887,true,2816655551,28,2833038799,16383248
1651526473,196885,true,2817218910,28,2833038799,15819889
1651526528,196884,true,2817500632,28,2833322103,15821471
1651526629,196883,true,2817782382,28,2833888796,16106414
1651526782,196882,true,2818064160,28,2835022521,16958361
1651527058,196881,true,2818345966,28,2836723960,18377994
1651527096,196880,true,2818627801,28,2837007633,18379832
1651527115,196879,true,2818909664,28,2837291333,18381669
1651527500,196878,true,2819191555,28,2842118589,22927034
1651528486,196876,true,2819755421,28,2854650835,34895414
1651528553,196874,true,2820319401,28,2855221794,34902393
1651528854,196873,true,2820601433,28,2858364109,37762676
1651528889,196871,true,2821165581,28,2858649945,37484364
1651529699,196868,true,2822012015,28,2863227217,41215202
1651529716,196866,true,2822576446,28,2863513540,40937094
1651529800,196864,true,2823140989,28,2864086271,40945282
1651530741,196860,true,2824270415,28,2872116548,47846133
1651530849,196857,true,2825117781,28,2872691000,47573219
1651531039,196856,true,2825400293,28,2873265567,47865274
1651531391,196854,true,2825965401,28,2873840249,47874848
1651531403,196852,true,2826530623,28,2873840249,47309626
1651531690,196849,true,2827378667,28,2873840249,46461582
1651533241,196849,true,2827378667,28,2870106871,42728204
1651534995,196848,true,2827661404,28,2869819889,42158485
1651535078,196846,true,2828226965,28,2869819889,41592924
1651535299,196844,true,2828792639,28,2869532935,40740296
1651535344,196844,true,2828792639,28,2869246011,40453372
1651537169,196843,true,2829075518,28,2862940923,33865405
1651537234,196842,true,2829358425,28,2862940923,33582498
1651537313,196839,true,2830207318,28,2862368421,32161103
1651537361,196839,true,2830207318,28,2862082212,31874894
1651537703,196840,true,2829924325,28,2858364109,28439784
1651537753,196839,true,2830207318,28,2857792522,27585204
1651537769,196837,true,2830773388,28,2857506771,26733383
1651538561,196837,true,2830773388,28,2847808230,17034842
1651538746,196838,true,2830490339,28,2845246483,14756144
1651538897,196837,true,2830773388,28,2842971310,12197922
1651538943,196834,true,2831622705,28,2841834406,10211701
1651538970,196834,true,2831622705,28,2841550251,9927546
1651539068,196836,true,2831056465,28,2840413915,9357450
1651541295,196835,true,2831339571,28,2832189057,849486
1651542493,196832,true,2832189057,28,2832189057,0
1651542644,196833,true,2831905867,28,2832472276,566409
1651542796,196835,true,2831339571,28,2832472276,1132705
1651542830,196834,true,2831622705,28,2832472276,849571
1651542846,196832,true,2832189057,28,2832755524,566467
1651542930,196833,true,2831905867,28,2832755524,849657
1651543375,196835,true,2831339571,28,2833888796,2549225
1651543448,196834,true,2831622705,28,2834172185,2549480
1651543474,196832,true,2832189057,28,2834172185,1983128
1651543535,196833,true,2831905867,28,2834455602,2549735
1651543726,196835,true,2831339571,28,2835306024,3966453
1651545645,196834,true,2831622705,28,2840982026,9359321
1651547313,196832,true,2832189057,28,2837575062,5386005
1651547328,196832,true,2832189057,28,2837575062,5386005
1651548178,196834,true,2831622705,28,2840129902,8507197
1651548495,196832,true,2832189057,28,2841266124,9077067
1651549622,196830,true,2832755524,28,2843824287,11068763
1651550828,196830,true,2832755524,28,2843824287,11068763
1651551800,196832,true,2832189057,28,2843824287,11635230
1651552178,196830,true,2832755524,28,2843824287,11068763
1651552440,196827,true,2833605435,28,2843824287,10218852
1651554456,196828,true,2833322103,28,2843824287,10502184
1651554463,196829,true,2833038799,28,2843824287,10785488
1651554744,196828,true,2833322103,28,2843255607,9933504
1651554814,196825,true,2834172185,28,2843255607,9083422
1651555683,196826,true,2833888796,28,2840413915,6525119
1651559990,196826,true,2833888796,28,2838426420,4537624
1651564378,196824,true,2834455602,28,2838710263,4254661
1651565014,196821,true,2835306024,28,2838710263,3404239
1651565418,196822,true,2835022521,28,2838710263,3687742
1651565893,196822,true,2835022521,28,2838710263,3687742
1651566059,196820,true,2835589554,28,2838710263,3120709
1651566381,196817,true,2836440316,28,2838710263,2269947
1651566400,196817,true,2836440316,28,2838710263,2269947
1651566953,196816,true,2836723960,28,2839278033,2554073
1651567400,196814,true,2837291333,28,2840697956,3406623
1651567469,196811,true,2838142606,28,2840982026,2839420
1651570794,196810,true,2838426420,28,2844961987,6535567
1651570935,196809,true,2838710263,28,2844961987,6251724
1651571791,196807,true,2839278033,28,2843824287,4546254
1651571883,196804,true,2840129902,28,2843824287,3694385
1651572082,196804,true,2840129902,28,2843255607,3125705
1651572409,196803,true,2840413915,28,2842402801,1988886
1651573452,196801,true,2840982026,28,2838142606,-2839420
1651573668,196798,true,2841834406,28,2837007633,-4826773
1651575724,196799,true,2841550251,28,2831056465,-10493786
1651576834,196799,true,2841550251,28,2831056465,-10493786
1651577469,196797,true,2842118589,28,2831056465,-11062124
1651578082,196794,true,2842971310,28,2831905867,-11065443
1651578813,196795,true,2842687041,28,2832755524,-9931517
1651578825,196795,true,2842687041,28,2833038799,-9648242
1651578946,196794,true,2842971310,28,2833322103,-9649207
1651580355,196791,true,2843824287,28,2839278033,-4546254
1651581630,196791,true,2843824287,28,2840697956,-3126331
1651582807,196791,true,2843824287,28,2839845917,-3978370
1651583007,196790,true,2844108669,28,2839845917,-4262752
1651583042,196788,true,2844677519,28,2839845917,-4831602
1651584484,196788,true,2844677519,28,2839278033,-5399486
1651584675,196789,true,2844393080,28,2839278033,-5115047
1651584710,196789,true,2844393080,28,2839278033,-5115047
1651585244,196786,true,2845246483,28,2837007633,-8238850
1651585743,196788,true,2844677519,28,2835022521,-9654998
1651586399,196790,true,2844108669,28,2829924325,-14184344
1651586421,196789,true,2844393080,28,2829924325,-14468755
1651586434,196787,true,2844961987,28,2829641361,-15320626
1651586445,196789,true,2844393080,28,2829641361,-14751719
1651586565,196791,true,2843824287,28,2829358425,-14465862
1651586742,196791,true,2843824287,28,2829358425,-14465862
1651587364,196788,true,2844677519,28,2830490339,-14187180
1651589035,196790,true,2844108669,28,2832755524,-11353145
1651589252,196792,true,2843539933,28,2832189057,-11350876
1651590081,196791,true,2843824287,28,2829641361,-14182926
1651590504,196789,true,2844393080,28,2827661404,-16731676
1651590598,196791,true,2843824287,28,2827095957,-16728330
1651593944,196793,true,2843255607,28,2827095957,-16159650
1651593954,196793,true,2843255607,28,2827095957,-16159650
1651594014,196791,true,2843824287,28,2827095957,-16728330
1651594025,196793,true,2843255607,28,2827095957,-16159650
1651594074,196797,true,2842118589,28,2826530623,-15587966
1651594096,196797,true,2842118589,28,2826530623,-15587966
1651594293,196796,true,2842402801,28,2824552842,-17849959
1651594655,196799,true,2841550251,28,2821447698,-20102553
1651595129,196803,true,2840413915,28,2817218910,-23195005
1651595716,196803,true,2840413915,28,2811871543,-28542372
1651595755,196803,true,2840413915,28,2811590384,-28823531
1651595788,196806,true,2839561961,28,2811309253,-28252708
1651597435,196810,true,2838426420,28,2810466029,-27960391
1651597729,196811,true,2838142606,28,2810185010,-27957596
1651598282,196811,true,2838142606,28,2810466029,-27676577
1651598302,196814,true,2837291333,28,2810466029,-26825304
1651598831,196818,true,2836156700,28,2811871543,-24285157
1651599141,196818,true,2836156700,28,2812996460,-23160240
1651599981,196818,true,2836156700,28,2815247645,-20909055
1651600600,196821,true,2835306024,28,2815810723,-19495301
1651600658,196824,true,2834455602,28,2815810723,-18644879
1651600739,196825,true,2834172185,28,2815810723,-18361462
1651600791,196825,true,2834172185,28,2815529170,-18643015
1651600858,196828,true,2833322103,28,2815247645,-18074458
1651600878,196831,true,2832472276,28,2815247645,-17224631
1651601106,196833,true,2831905867,28,2813559088,-18346779
1651601226,196833,true,2831905867,28,2812433945,-19471922
1651601239,196836,true,2831056465,28,2812152730,-18903735
1651601591,196837,true,2830773388,28,2808218667,-22554721
1651601660,196839,true,2830207318,28,2807376370,-22830948
1651601666,196839,true,2830207318,28,2807376370,-22830948
1651601818,196842,true,2829358425,28,2805411993,-23946432
1651603210,196843,true,2829075518,28,2791699782,-37375736
1651603247,196845,true,2828509788,28,2791699782,-36810006
1651603289,196845,true,2828509788,28,2791420640,-37089148
1651603315,196848,true,2827661404,28,2791141526,-36519878
1651603432,196850,true,2827095957,28,2790304351,-36791606
1651603440,196852,true,2826530623,28,2790025348,-36505275
1651603832,196852,true,2826530623,28,2786958161,-39572462
1651604085,196855,true,2825682833,28,2785008070,-40674763
1651604496,196857,true,2825117781,28,2781946399,-43171382
1651605516,196859,true,2824552842,28,2777499066,-47053776
1651605589,196859,true,2824552842,28,2777499066,-47053776
1651605990,196862,true,2823705646,28,2777499066,-46206580
1651606757,196865,true,2822858704,28,2777221343,-45637361
1651606832,196866,true,2822576446,28,2776943649,-45632797
1651606935,196867,true,2822294217,28,2776665982,-45628235
1651607036,196870,true,2821447698,28,2776110733,-45336965
1651607814,196873,true,2820601433,28,2773058842,-47542591
1651608562,196875,true,2820037397,28,2770287308,-49750089
1651608617,196876,true,2819755421,28,2770287308,-49468113
1651608902,196879,true,2818909664,28,2770287308,-48622356
1651608950,196882,true,2818064160,28,2770287308,-47776852
1651609061,196884,true,2817500632,28,2770010307,-47490325
1651609063,196885,true,2817218910,28,2770010307,-47208603
1651609227,196888,true,2816373913,28,2770010307,-46363606
1651609242,196892,true,2815247645,28,2770010307,-45237338
1651609301,196894,true,2814684680,28,2770010307,-44674373
1651609324,196895,true,2814403240,28,2770010307,-44392933
1651609617,196898,true,2813559088,28,2769179470,-44379618
1651611567,196902,true,2812433945,28,2765029022,-47404923
1651611595,196904,true,2811871543,28,2765305525,-46566018
1651611617,196905,true,2811590384,28,2765305525,-46284859
1651611764,196907,true,2811028150,28,2766411813,-44616337
1651612298,196910,true,2810185010,28,2770010307,-40174703
1651612977,196911,true,2809904020,28,2774723093,-35180927
1651612998,196912,true,2809623058,28,2774723093,-34899965
1651613028,196915,true,2808780339,28,2775000566,-33779773
1651613125,196917,true,2808218667,28,2776110733,-32107934
1651613286,196918,true,2807937874,28,2778054593,-29883281
1651613480,196919,true,2807657108,28,2779721843,-27935265
1651616475,196922,true,2806814979,28,2787515580,-19299399
1651617046,196924,true,2806253700,28,2788351919,-17901781
1651619305,196925,true,2805973103,28,2789746373,-16226730
1651619346,196926,true,2805692534,28,2789746373,-15946161
1651619397,196929,true,2804850994,28,2789746373,-15104621
1651620622,196931,true,2804290108,28,2786400853,-17889255
1651622667,196933,true,2803729334,28,2784729597,-18999737
1651623130,196934,true,2803448990,28,2783894345,-19554645
1651624443,196936,true,2802888384,28,2781668232,-21220152
1651624797,196939,true,2802047685,28,2781390093,-20657592
1651624837,196940,true,2801767509,28,2781668232,-20099277
1651625429,196940,true,2801767509,28,2783337650,-18429859
1651626593,196942,true,2801207239,28,2786679493,-14527746
1651626634,196944,true,2800647082,28,2786958161,-13688921
1651627092,196945,true,2800367045,28,2787515580,-12851465
1651628333,196946,true,2800087036,28,2788909617,-11177419
1651628649,196948,true,2799527103,28,2788909617,-10617486
1651629875,196950,true,2798967282,28,2788909617,-10057665
1651630969,196951,true,2798687413,28,2788909617,-9777796
1651631024,196952,true,2798407572,28,2789188508,-9219064
1651631063,196954,true,2797847974,28,2789188508,-8659466
1651631089,196956,true,2797288489,28,2789467427,-7821062
1651631117,196957,true,2797008788,28,2789467427,-7541361
1651632715,196957,true,2797008788,28,2799527103,2518315
1651632916,196959,true,2796449470,28,2800087036,3637566
1651633162,196961,true,2795890264,28,2800087036,4196772
1651634888,196962,true,2795610703,28,2799247178,3636475
1651634903,196962,true,2795610703,28,2799247178,3636475
1651635144,196963,true,2795331170,28,2798967282,3636112
1651635987,196965,true,2794772187,28,2798967282,4195095
1651637016,196966,true,2794492738,28,2799247178,4754440
1651638369,196966,true,2794492738,28,2803168673,8675935
1651638620,196966,true,2794492738,28,2804009707,9516969
1651638694,196969,true,2793654558,28,2804009707,10355149
1651638750,196969,true,2793654558,28,2804290108,10635550
1651639481,196969,true,2793654558,28,2803729334,10074776
1651639807,196970,true,2793375220,28,2803448990,10073770
1651639825,196973,true,2792537375,28,2803448990,10911615
1651640007,196973,true,2792537375,28,2803168673,10631298
1651640471,196973,true,2792537375,28,2802608123,10070748
1651641484,196973,true,2792537375,28,2802047685,9510310
1651641586,196976,true,2791699782,28,2801767509,10067727
1651644389,196976,true,2791699782,28,2797288489,5588707
1651644534,196977,true,2791420640,28,2797288489,5867849
1651644611,196977,true,2791420640,28,2797568218,6147578
1651645113,196978,true,2791141526,28,2798687413,7545887
1651645522,196978,true,2791141526,28,2799807056,8665530
1651646401,196978,true,2791141526,28,2801487360,10345834
1651646462,196978,true,2791141526,28,2801487360,10345834
1651646502,196980,true,2790583381,28,2801487360,10903979
1651647061,196979,true,2790862439,28,2802327890,11465451
1651647403,196979,true,2790862439,28,2802888384,12025945
1651647597,196979,true,2790862439,28,2803729334,12866895
1651647634,196980,true,2790583381,28,2804009707,13426326
1651648706,196980,true,2790583381,28,2809342123,18758742
1651650335,196979,true,2790862439,28,2811309253,20446814
1651650417,196979,true,2790862439,28,2811590384,20727945
1651650442,196980,true,2790583381,28,2811590384,21007003
1651650453,196980,true,2790583381,28,2811590384,21007003
1651650614,196978,true,2791141526,28,2812152730,21011204
1651651102,196978,true,2791141526,28,2814684680,23543154
1651651156,196980,true,2790583381,28,2814966149,24382768
1651651257,196979,true,2790862439,28,2815529170,24666731
1651651264,196978,true,2791141526,28,2815529170,24387644
1651651323,196977,true,2791420640,28,2815810723,24390083
1651652853,196977,true,2791420640,28,2831339571,39918931
1651652988,196976,true,2791699782,28,2832189057,40489275
1651652996,196974,true,2792258150,28,2832472276,40214126
1651653079,196973,true,2792537375,28,2833038799,40501424
1651653112,196973,true,2792537375,28,2833038799,40501424
1651654396,196971,true,2793095911,28,2835306024,42210113
1651654612,196969,true,2793654558,28,2835589554,41934996
1651654666,196968,true,2793933923,28,2835589554,41655631
1651654833,196967,true,2794213317,28,2835873113,41659796
1651655105,196965,true,2794772187,28,2836723960,41951773
1651655799,196963,true,2795331170,28,2838994134,43662964
1651656186,196962,true,2795610703,28,2840129902,44519199
1651656509,196959,true,2796449470,28,2840982026,44532556
1651657890,196957,true,2797008788,28,2839845917,42837129
1651657937,196955,true,2797568218,28,2839845917,42277699
1651658051,196954,true,2797847974,28,2839561961,41713987
1651659070,196952,true,2798407572,28,2837575062,39167490
1651659332,196950,true,2798967282,28,2837575062,38607780
1651659430,196947,true,2799807056,28,2837575062,37768006
1651659835,196946,true,2800087036,28,2837575062,37488026
1651659907,196944,true,2800647082,28,2837858820,37211738
1651659990,196942,true,2801207239,28,2838142606,36935367
1651660069,196939,true,2802047685,28,2838426420,36378735
1651660094,196938,true,2802327890,28,2838710263,36382373
1651660153,196934,true,2803448990,28,2838994134,35545144
1651660426,196932,true,2804009707,28,2840697956,36688249
1651660459,196929,true,2804850994,28,2840982026,36131032
1651660867,196927,true,2805411993,28,2844393080,38981087
1651660990,196924,true,2806253700,28,2845531008,39277308
1651661014,196921,true,2807095661,28,2845815561,38719900
1651661094,196918,true,2807937874,28,2846669391,38731517
1651661122,196916,true,2808499489,28,2846954058,38454569
1651661908,196912,true,2809623058,28,2855792867,46169809
1651662555,196910,true,2810185010,28,2860079556,49894546
1651662920,196907,true,2811028150,28,2860937666,49909516
1651663190,196904,true,2811871543,28,2860937666,49066123
1651663252,196900,true,2812996460,28,2860937666,47941206
1651663530,196897,true,2813840444,28,2861509882,47669438
1651663579,196894,true,2814684680,28,2861796033,47111353
1651663593,196892,true,2815247645,28,2861796033,46548388
1651663632,196889,true,2816092304,28,2862082212,45989908
1651663837,196885,true,2817218910,28,2864086271,46867361
1651664499,196882,true,2818064160,28,2869246011,51181851
1651665261,196879,true,2818909664,28,2874989958,56080294
1651665587,196877,true,2819473474,28,2875564984,56091510
1651666375,196873,true,2820601433,28,2875277457,54676024
1651666431,196871,true,2821165581,28,2874989958,53824377
1651666588,196868,true,2822012015,28,2874702487,52690472
1651666770,196866,true,2822576446,28,2874415046,51838600
1651667226,196863,true,2823423304,28,2872691000,49267696
1651667267,196860,true,2824270415,28,2872691000,48420585
1651667335,196858,true,2824835298,28,2872116548,47281250
1651667355,196856,true,2825400293,28,2872116548,46716255
1651667550,196853,true,2826247998,28,2870680921,44432923
1651667963,196851,true,2826813276,28,2867525065,40711789
1651667977,196848,true,2827661404,28,2867238342,39576938
1651667985,196846,true,2828226965,28,2867238342,39011377
1651668094,196843,true,2829075518,28,2866091733,37016215
1651668916,196841,true,2829641361,28,2859221704,29580343
1651669309,196840,true,2829924325,28,2856935355,27011030
1651669386,196837,true,2830773388,28,2856935355,26161967
1651669844,196834,true,2831622705,28,2856649690,25026985
1651669867,196833,true,2831905867,28,2856649690,24743823
1651669913,196831,true,2832472276,28,2856649690,24177414
1651670082,196828,true,2833322103,28,2856649690,23327587
1651670210,196826,true,2833888796,28,2856649690,22760894
1651670730,196824,true,2834455602,28,2856935355,22479753
1651670756,196822,true,2835022521,28,2856935355,21912834
1651670924,196820,true,2835589554,28,2857506771,21917217
1651672328,196818,true,2836156700,28,2859221704,23065004
1651672351,196817,true,2836440316,28,2859221704,22781388
1651672624,196815,true,2837007633,28,2858649945,21642312
1651672644,196812,true,2837858820,28,2858649945,20791125
1651672654,196811,true,2838142606,28,2858649945,20507339
1651672655,196810,true,2838426420,28,2858649945,20223525
1651672665,196808,true,2838994134,28,2858649945,19655811
1651672719,196806,true,2839561961,28,2858078301,18516340
1651672783,196805,true,2839845917,28,2857792522,17946605
1651672806,196804,true,2840129902,28,2857506771,17376869
1651673195,196803,true,2840413915,28,2854365399,13951484
1651673823,196801,true,2840982026,28,2848947524,7965498
1651676544,196800,true,2841266124,28,2844108669,2842545
1651676789,196799,true,2841550251,28,2843824287,2274036
1651677259,196798,true,2841834406,28,2841550251,-284155
1651678822,196796,true,2842402801,28,2835873113,-6529688
1651678844,196796,true,2842402801,28,2836156700,-6246101
1651680628,196794,true,2842971310,28,2840413915,-2557395
1651681201,196793,true,2843255607,28,2840413915,-2841692
1651681252,196791,true,2843824287,28,2840697956,-3126331
1651681260,196790,true,2844108669,28,2840697956,-3410713
1651681345,196789,true,2844393080,28,2840982026,-3411054
1651681372,196787,true,2844961987,28,2841266124,-3695863
1651681474,196784,true,2845815561,28,2842687041,-3128520
1651682156,196782,true,2846384753,28,2852082933,5698180
1651682731,196781,true,2846669391,28,2860079556,13410165
1651682801,196779,true,2847238753,28,2860651600,13412847
1651682817,196776,true,2848093010,28,2860937666,12844656
1651684266,196775,true,2848377820,28,2856935355,8557535
1651684290,196774,true,2848662658,28,2856935355,8272697
1651684340,196772,true,2849232419,28,2856364054,7131635
1651684726,196770,true,2849802294,28,2853223938,3421644
1651686991,196771,true,2849517342,28,2846100143,-3417199
1651687034,196770,true,2849802294,28,2846384753,-3417541
1651687089,196768,true,2850372282,28,2846384753,-3987529
1651687193,196765,true,2851227480,28,2846669391,-4558089
1651687226,196766,true,2850942385,28,2846954058,-3988327
1651687244,196765,true,2851227480,28,2846954058,-4273422
1651687663,196763,true,2851797754,28,2850657320,-1140434
1651687701,196760,true,2852653379,28,2850657320,-1996059
1651687763,196761,true,2852368142,28,2850942385,-1425757
1651687854,196760,true,2852653379,28,2851227480,-1425899
1651687882,196759,true,2852938644,28,2851227480,-1711164
1651688347,196758,true,2853223938,28,2852082933,-1141005
1651688408,196759,true,2852938644,28,2852082933,-855711
1651688428,196758,true,2853223938,28,2852082933,-1141005
1651688460,196757,true,2853509260,28,2851797754,-1711506
1651688479,196757,true,2853509260,28,2851797754,-1711506
1651688804,196758,true,2853223938,28,2850087274,-3136664
1651688814,196758,true,2853223938,28,2850087274,-3136664
1651688851,196757,true,2853509260,28,2850087274,-3421986
1651688862,196756,true,2853794611,28,2850087274,-3707337
1651688872,196758,true,2853223938,28,2850087274,-3136664
1651688892,196758,true,2853223938,28,2850087274,-3136664
1651689041,196756,true,2853794611,28,2849802294,-3992317
1651689182,196755,true,2854079991,28,2848662658,-5417333
1651689208,196757,true,2853509260,28,2848662658,-4846602
1651689223,196756,true,2853794611,28,2848377820,-5416791
1651689267,196755,true,2854079991,28,2848093010,-5986981
1651689393,196755,true,2854079991,28,2846384753,-7695238
1651689687,196756,true,2853794611,28,2843824287,-9970324
1651689792,196756,true,2853794611,28,2843539933,-10254678
1651689869,196754,true,2854365399,28,2843824287,-10541112
1651689877,196755,true,2854079991,28,2843824287,-10255704
1651689913,196755,true,2854079991,28,2843824287,-10255704
1651689981,196754,true,2854365399,28,2844393080,-9972319
1651689997,196752,true,2854936300,28,2844677519,-10258781
1651690010,196752,true,2854936300,28,2844677519,-10258781
1651690026,196753,true,2854650835,28,2844961987,-9688848
1651690040,196751,true,2855221794,28,2845246483,-9975311
1651690078,196749,true,2855792867,28,2845815561,-9977306
1651690097,196749,true,2855792867,28,2846100143,-9692724
1651690138,196749,true,2855792867,28,2846954058,-8838809
1651690147,196747,true,2856364054,28,2847238753,-9125301
1651690152,196745,true,2856935355,28,2847238753,-9696602
1651690207,196745,true,2856935355,28,2848947524,-7987831
1651690211,196744,true,2857221049,28,2849232419,-7988630
1651690228,196742,true,2857792522,28,2849802294,-7990228
1651690319,196740,true,2858364109,28,2853223938,-5140171
1651690364,196739,true,2858649945,28,2854936300,-3713645
1651690371,196738,true,2858935810,28,2855221794,-3714016
1651690381,196737,true,2859221704,28,2855507316,-3714388
1651690418,196734,true,2860079556,28,2857221049,-2858507
1651690447,196733,true,2860365564,28,2858364109,-2001455
1651690487,196733,true,2860365564,28,2860651600,286036
1651690532,196731,true,2860937666,28,2862940923,2003257
1651690541,196728,true,2861796033,28,2863227217,1431184
1651690543,196726,true,2862368421,28,2863513540,1145119
1651690575,196726,true,2862368421,28,2865232077,2863656
1651690771,196723,true,2863227217,28,2874989958,11762741
1651690878,196720,true,2864086271,28,2880169341,16083070
1651691180,196718,true,2864659117,28,2896053118,31394001
1651691195,196718,true,2864659117,28,2896922021,32262904
1651691279,196715,true,2865518601,28,2901850730,36332129
1651691293,196711,true,2866664980,28,2902721372,36056392
1651691385,196709,true,2867238342,28,2908532334,41293992
1651691426,196707,true,2867811818,28,2911151060,43339242
1651691445,196704,true,2868672248,28,2912315695,43643447
1651691515,196700,true,2869819889,28,2916687228,46867339
1651691641,196697,true,2870680921,28,2924280102,53599181
1651691664,196696,true,2870967989,28,2925742534,54774545
1651691858,196691,true,2872403760,28,2935706490,63302730
1651691972,196688,true,2873265567,28,2940113133,66847566
1651692091,196685,true,2874127633,28,2943643210,69515577
1651692181,196683,true,2874702487,28,2945998949,71296462
1651692225,196679,true,2875852541,28,2947177525,71324984
1651692261,196675,true,2877003054,28,2947766990,70763936
1651692405,196673,true,2877578484,28,2949536093,71957609
1651692425,196671,true,2878154028,28,2949536093,71382065
1651692476,196667,true,2879305463,28,2949831046,70525583
1651692678,196664,true,2880169341,28,2951011156,70841815
1651692704,196662,true,2880745403,28,2951011156,70265753
1651692778,196660,true,2881321581,28,2951601388,70279807
1651693307,196656,true,2882474283,28,2953963495,71489212
1651693484,196652,true,2883627445,28,2953963495,70336050
1651693526,196650,true,2884204200,28,2953963495,69759295
1651693563,196648,true,2884781069,28,2953668128,68887059
1651693966,196643,true,2886223748,28,2952782205,66558457
1651695129,196640,true,2887089702,28,2953372791,66283089
1651695579,196637,true,2887955916,28,2953077483,65121567
1651695777,196635,true,2888533536,28,2952782205,64248669
1651696574,196630,true,2889978091,28,2952782205,62804114
1651697265,196626,true,2891134256,28,2952782205,61647949
1651698529,196624,true,2891712512,28,2952486957,60774445
1651698564,196621,true,2892580112,28,2952486957,59906845
1651698730,196617,true,2893737318,28,2952486957,58749639
1651699299,196613,true,2894894986,28,2952191737,57296751
1651699645,196610,true,2895763542,28,2951896548,56133006
1651700577,196607,true,2896632358,28,2951011156,54378798
1651700582,196603,true,2897791184,28,2951011156,53219972
1651700789,196599,true,2898950475,28,2950421042,51470567
1651701112,196597,true,2899530294,28,2949241169,49710875
1651701137,196594,true,2900400240,28,2949241169,48840929
1651701325,196590,true,2901560574,28,2948061767,46501193
1651701342,196588,true,2902140915,28,2948061767,45920852
1651701876,196586,true,2902721372,28,2945115326,42393954
1651702364,196585,true,2903011645,28,2942171830,39160185
1651702672,196581,true,2904173023,28,2941289355,37116332
1651703218,196578,true,2905044362,28,2939525199,34480837
1651703336,196577,true,2905334867,28,2939231276,33896409
1651703349,196575,true,2905915963,28,2938937382,33021419
1651703943,196571,true,2907078504,28,2937174636,30096132
1651704096,196569,true,2907659948,28,2936880948,29221000
1651704837,196567,true,2908241509,28,2934825954,26584445
1651705202,196564,true,2909114069,28,2934239077,25125008
1651707908,196561,true,2909986891,28,2930134221,20147330
1651708085,196558,true,2910859974,28,2930427235,19567261
1651708108,196557,true,2911151060,28,2930720277,19569217
1651708972,196554,true,2912024493,28,2933358981,21334488
1651709035,196550,true,2913189477,28,2933652317,20462840
1651709076,196549,true,2913480796,28,2933945682,20464886
1651709105,196548,true,2913772144,28,2933945682,20173538
1651709129,196544,true,2914937828,28,2934239077,19301249
1651711331,196540,true,2916103978,28,2944231968,28127990
1651713549,196537,true,2916978897,28,2944526391,27547494
1651717224,196536,true,2917270595,28,2944526391,27255796
1651717600,196533,true,2918145863,28,2944526391,26380528
1651717882,196528,true,2919605228,28,2944820844,25215616
1651718506,196525,true,2920481197,28,2944820844,24339647
1651718595,196524,true,2920773245,28,2944820844,24047599
1651722409,196519,true,2922233924,28,2944820844,22586920
1651722901,196515,true,2923402993,28,2944820844,21417851
1651725859,196512,true,2924280102,28,2944526391,20246289
1651726327,196510,true,2924864987,28,2944820844,19955857
1651727224,196507,true,2925742534,28,2945115326,19372792
1651727312,196503,true,2926913007,28,2945115326,18202319
1651727549,196500,true,2927791168,28,2945409838,17618670
1651727741,196499,true,2928083947,28,2945409838,17325891
1651727985,196495,true,2929255357,28,2945409838,16154481
1651728434,196491,true,2930427235,28,2945409838,14982603
1651728832,196488,true,2931306451,28,2945409838,14103387
1651728964,196486,true,2931892741,28,2945409838,13517097
1651729130,196482,true,2933065674,28,2945409838,12344164
1651729208,196478,true,2934239077,28,2945409838,11170761
1651729260,196476,true,2934825954,28,2945409838,10583884
1651730092,196474,true,2935412948,28,2942466047,7053099
1651730120,196471,true,2936293660,28,2942466047,6172387
1651732924,196468,true,2937174636,28,2935412948,-1761688
1651733877,196467,true,2937468354,28,2935412948,-2055406
1651734248,196465,true,2938055877,28,2935412948,-2642929
1651734948,196462,true,2938937382,28,2935412948,-3524434
1651735046,196460,true,2939525199,28,2935412948,-4112251
1651735123,196459,true,2939819151,28,2935412948,-4406203
1651736230,196457,true,2940407145,28,2934239077,-6168068
1651737789,196456,true,2940701185,28,2933358981,-7342204
1651737877,196454,true,2941289355,28,2933358981,-7930374
1651738831,196453,true,2941583484,28,2929841237,-11742247
1651740459,196453,true,2941583484,28,2926620345,-14963139
1651740965,196453,true,2941583484,28,2926620345,-14963139
1651741385,196451,true,2942171830,28,2926620345,-15551485
1651743056,196451,true,2942171830,28,2926620345,-15551485
1651743145,196451,true,2942171830,28,2926620345,-15551485
1651743702,196450,true,2942466047,28,2926327712,-16138335
1651744287,196449,true,2942760294,28,2926035108,-16725186
1651745601,196449,true,2942760294,28,2925742534,-17017760
1651746072,196450,true,2942466047,28,2925742534,-16723513
1651747211,196450,true,2942466047,28,2925742534,-16723513
1651749458,196448,true,2943054570,28,2929548282,-13506288
1651750409,196449,true,2942760294,28,2929548282,-13212012
1651750442,196450,true,2942466047,28,2929548282,-12917765
1651750684,196450,true,2942466047,28,2929548282,-12917765
1651751098,196449,true,2942760294,28,2929548282,-13212012
1651752609,196450,true,2942466047,28,2929548282,-12917765
1651754495,196451,true,2942171830,28,2929548282,-12623548
1651755012,196451,true,2942171830,28,2929255357,-12916473
1651757117,196450,true,2942466047,28,2927791168,-14674879
1651757131,196451,true,2942171830,28,2927791168,-14380662
1651757484,196453,true,2941583484,28,2927791168,-13792316
1651757960,196453,true,2941583484,28,2926913007,-14670477
1651758284,196454,true,2941289355,28,2925449989,-15839366
1651758335,196455,true,2940995255,28,2925449989,-15545266
1651758450,196457,true,2940407145,28,2924572530,-15834615
1651758567,196458,true,2940113133,28,2923987703,-16125430
1651758586,196459,true,2939819151,28,2923695333,-16123818
1651758713,196460,true,2939525199,28,2922526147,-16999052
1651758885,196463,true,2938643518,28,2921065323,-17578195
1651758930,196464,true,2938349683,28,2920481197,-17868486
1651758952,196464,true,2938349683,28,2920189178,-18160505
1651758981,196465,true,2938055877,28,2919897189,-18158688
1651759053,196469,true,2936880948,28,2919021395,-17859553
1651759092,196470,true,2936587290,28,2918437678,-18149612
1651759224,196470,true,2936587290,28,2916687228,-19900062
1651759448,196471,true,2936293660,28,2913772144,-22521516
1651759458,196474,true,2935412948,28,2913480796,-21932152
1651759504,196475,true,2935119436,28,2912606927,-22512509
1651759513,196477,true,2934532501,28,2912606927,-21925574
1651759644,196479,true,2933945682,28,2909986891,-23958791
1651759683,196482,true,2933065674,28,2909114069,-23951605
1651759737,196484,true,2932479149,28,2907950714,-24528435
1651760461,196485,true,2932185931,28,2893158657,-39027274
1651760616,196488,true,2931306451,28,2889978091,-41328360
1651760636,196491,true,2930427235,28,2889689122,-40738113
1651760650,196493,true,2929841237,28,2889400182,-40441055
1651760678,196495,true,2929255357,28,2888533536,-40721821
1651760911,196498,true,2928376756,28,2883915808,-44460948
1651761230,196501,true,2927498419,28,2878441844,-49056575
1651761280,196503,true,2926913007,28,2877578484,-49334523
1651761293,196505,true,2926327712,28,2877578484,-48749228
1651761329,196508,true,2925449989,28,2877003054,-48446935
1651761492,196512,true,2924280102,28,2874702487,-49577615
1651761628,196514,true,2923695333,28,2872978269,-50717064
1651761699,196516,true,2923110682,28,2871829365,-51281317
1651761779,196519,true,2922233924,28,2870680921,-51553003
1651761996,196523,true,2921065323,28,2866664980,-54400343
1651762106,196525,true,2920481197,28,2864659117,-55822080
1651762158,196528,true,2919605228,28,2863513540,-56091688
1651762176,196531,true,2918729522,28,2863227217,-55502305
1651762304,196535,true,2917562322,28,2860651600,-56910722
1651762583,196537,true,2916978897,28,2856078446,-60900451
1651762617,196540,true,2916103978,28,2855507316,-60596662
1651762678,196543,true,2915229322,28,2854365399,-60863923
1651762901,196547,true,2914063521,28,2850372282,-63691239
1651762918,196550,true,2913189477,28,2850087274,-63102203
1651762948,196552,true,2912606927,28,2849232419,-63374508
1651762994,196555,true,2911733319,28,2848377820,-63355499
1651763017,196561,true,2909986891,28,2847808230,-62178661
1651763074,196563,true,2909404981,28,2846384753,-63020228
1651763136,196566,true,2908532334,28,2844677519,-63854815
1651763192,196569,true,2907659948,28,2843255607,-64404341
1651763228,196574,true,2906206555,28,2842402801,-63803754
1651763302,196578,true,2905044362,28,2840129902,-64914460
1651763310,196581,true,2904173023,28,2839845917,-64327106
1651763669,196587,true,2902431129,28,2825682833,-76748296
1651763782,196593,true,2900690280,28,2821729842,-78960438
1651763789,196597,true,2899530294,28,2821447698,-78082596
1651764153,196601,true,2898370772,28,2807376370,-90994402
1651764234,196608,true,2896342723,28,2804570537,-91772186
1651764310,196614,true,2894605526,28,2801487360,-93118166
1651764411,196618,true,2893447973,28,2797288489,-96159484
1651764608,196623,true,2892001683,28,2789467427,-102534256
1651764636,196630,true,2889978091,28,2788351919,-101626172
1651764744,196636,true,2888244711,28,2784172735,-104071976
1651764752,196641,true,2886801022,28,2783894345,-102906677
1651765027,196646,true,2885358054,28,2775555594,-109802460
1651765126,196653,true,2883339111,28,2773613482,-109725629
1651765431,196658,true,2881897874,28,2771395589,-110502285
1651765441,196663,true,2880457357,28,2771395589,-109061768
1651765505,196668,true,2879017561,28,2770841393,-108176168
1651765535,196675,true,2877003054,28,2770564337,-106438717
1651765576,196681,true,2875277457,28,2770287308,-104990149
1651765589,196685,true,2874127633,28,2770010307,-104117326
1651765616,196690,true,2872691000,28,2770010307,-102680693
1651765651,196697,true,2870680921,28,2769733334,-100947587
1651765676,196703,true,2868959115,28,2769456388,-99502727
1651765684,196708,true,2867525065,28,2769456388,-98068677
1651765755,196712,true,2866378342,28,2768902580,-97475762
1651765808,196720,true,2864086271,28,2768625717,-95460554
1651765829,196725,true,2862654657,28,2768348882,-94305775
1651765909,196730,true,2861223759,28,2767241819,-93981940
1651765965,196735,true,2859793577,28,2766411813,-93381764
1651765997,196743,true,2857506771,28,2765858614,-91648157
1651766061,196749,true,2855792867,28,2764752547,-91040320
1651766088,196754,true,2854365399,28,2764199679,-90165720
1651766439,196760,true,2852653379,28,2758952948,-93700431
1651766586,196768,true,2850372282,28,2756195512,-94176770
1651766614,196774,true,2848662658,28,2755919920,-92742738
1651766662,196779,true,2847238753,28,2755093309,-92145444
1651766847,196784,true,2845815561,28,2753440832,-92374729
1651766901,196791,true,2843824287,28,2752890226,-90934061
1651766928,196797,true,2842118589,28,2752614965,-89503624
1651766954,196801,true,2840982026,28,2752064524,-88917502
1651767103,196807,true,2839278033,28,2749863863,-89414170
1651767184,196814,true,2837291333,28,2748489343,-88801990
1651767437,196820,true,2835589554,28,2744644343,-90945211
1651767477,196825,true,2834172185,28,2744095496,-90076689
1651767599,196830,true,2832755524,28,2742723860,-90031664
1651767646,196837,true,2830773388,28,2742449615,-88323773
1651768456,196841,true,2829641361,28,2750413863,-79227498
1651768520,196846,true,2828226965,28,2750688905,-77538060
1651768570,196852,true,2826530623,28,2750688905,-75841718
1651768638,196859,true,2824552842,28,2750688905,-73863937
1651768701,196864,true,2823140989,28,2750688905,-72452084
1651768765,196869,true,2821729842,28,2750963973,-70765869
1651768992,196874,true,2820319401,28,2752064524,-68254877
1651768996,196881,true,2818345966,28,2752064524,-66281442
1651769596,196886,true,2816937216,28,2752890226,-64046990
1651769704,196891,true,2815529170,28,2752339731,-63189439
1651769757,196897,true,2813840444,28,2752064524,-61775920
1651769760,196904,true,2811871543,28,2751789345,-60082198
1651769773,196909,true,2810466029,28,2751789345,-58676684
1651769876,196914,true,2809061217,28,2751514194,-57547023
1651769889,196919,true,2807657108,28,2751514194,-56142914
1651770015,196926,true,2805692534,28,2751239070,-54453464
1651770147,196930,true,2804570537,28,2750963973,-53606564
1651770174,196934,true,2803448990,28,2750963973,-52485017
1651770468,196939,true,2802047685,28,2751789345,-50258340
1651770500,196945,true,2800367045,28,2752064524,-48302521
1651770526,196949,true,2799247178,28,2752064524,-47182654
1651770609,196953,true,2798127759,28,2752890226,-45237533
1651770788,196957,true,2797008788,28,2754266946,-42741842
1651770945,196964,true,2795051665,28,2755919920,-39131745
1651770967,196967,true,2794213317,28,2755919920,-38293397
1651771224,196971,true,2793095911,28,2757849643,-35246268
1651771307,196975,true,2791978952,28,2758401240,-33577712
1651771381,196982,true,2790025348,28,2758677080,-31348268
1651771468,196985,true,2789188508,28,2759228843,-29959665
1651771580,196989,true,2788073111,28,2759780717,-28292394
1651771634,196993,true,2786958161,28,2759780717,-27177444
1651771839,196999,true,2785286571,28,2759780717,-25505854
1651772252,197002,true,2784451152,28,2758677080,-25774072
1651772735,197006,true,2783337650,28,2755644355,-27693295
1651773393,197009,true,2782502816,28,2753440832,-29061984
1651773488,197015,true,2780833898,28,2753165515,-27668383
1651773645,197018,true,2779999815,28,2752890226,-27109589
1651773733,197022,true,2778888093,28,2752614965,-26273128
1651773810,197025,true,2778054593,28,2752614965,-25439628
1651773841,197030,true,2776665982,28,2752339731,-24326251
1651773973,197034,true,2775555594,28,2751789345,-23766249
1651774051,197038,true,2774445649,28,2751239070,-23206579
1651774160,197041,true,2773613482,28,2750688905,-22924577
1651774294,197046,true,2772227091,28,2750138849,-22088242
1651774632,197049,true,2771395589,28,2748489343,-22906246
1651775046,197053,true,2770287308,28,2746016939,-24270369
1651775079,197056,true,2769456388,28,2745742365,-23714023
1651775098,197061,true,2768072075,28,2745467818,-22604257
1651775103,197064,true,2767241819,28,2745193299,-22048520
1651775385,197069,true,2765858614,28,2740530668,-25327946
1651775530,197072,true,2765029022,28,2738339230,-26689792
1651776016,197077,true,2763646922,28,2732595038,-31051884
1651776026,197079,true,2763094276,28,2732595038,-30499238
1651776260,197085,true,2761436999,28,2729863945,-31573054
1651776348,197088,true,2760608734,28,2728772273,-31836461
1651776428,197092,true,2759504766,28,2727953805,-31550961
1651776497,197094,true,2758952948,28,2727135582,-31817366
1651776619,197099,true,2757573885,28,2726045001,-31528884
1651776650,197102,true,2756746778,28,2725772423,-30974355
1651776774,197106,true,2755644355,28,2725227351,-30417004
1651777185,197107,true,2755368819,28,2726317605,-29051214
1651777444,197112,true,2753991547,28,2727408296,-26583251
1651777651,197114,true,2753440832,28,2727408296,-26032536
1651777716,197118,true,2752339731,28,2727135582,-25204149
1651777861,197119,true,2752064524,28,2726317605,-25746919
1651778092,197124,true,2750688905,28,2725227351,-25461554
1651778262,197127,true,2749863863,28,2724409946,-25453917
1651778278,197128,true,2749588904,28,2724409946,-25178958
1651778293,197129,true,2749313973,28,2724137532,-25176441
1651778384,197134,true,2747939728,28,2722775872,-25163856
1651778419,197137,true,2747115511,28,2722231398,-24884113
1651778429,197138,true,2746840827,28,2722231398,-24609429
1651778463,197138,true,2746840827,28,2721687034,-25153793
1651778550,197143,true,2745467818,28,2720598631,-24869187
1651778691,197145,true,2744918807,28,2718694974,-26223833
1651778867,197145,true,2744918807,28,2716520996,-28397811
1651778992,197146,true,2744644343,28,2715163143,-29481200
1651779020,197150,true,2743546759,28,2714620192,-28926567
1651779050,197153,true,2742723860,28,2714348757,-28375103
1651779071,197153,true,2742723860,28,2714077349,-28646511
1651779188,197154,true,2742449615,28,2712449472,-30000143
1651779222,197158,true,2741352909,28,2712178255,-29174654
1651779370,197161,true,2740530668,28,2710822572,-29708096
1651779375,197161,true,2740530668,28,2710551517,-29979151
1651779392,197162,true,2740256642,28,2710551517,-29705125
1651779457,197166,true,2739160814,28,2710280489,-28880325
1651780204,197168,true,2738613064,28,2708113240,-30499824
1651780206,197169,true,2738339230,28,2708113240,-30225990
1651780239,197169,true,2738339230,28,2708384051,-29955179
1651780256,197173,true,2737244168,28,2708384051,-28860117
1651780702,197174,true,2736970471,28,2711907064,-25063407
1651780767,197174,true,2736970471,28,2712449472,-24520999
1651781083,197174,true,2736970471,28,2715434659,-21535812
1651781094,197178,true,2735875956,28,2715434659,-20441297
1651781208,197178,true,2735875956,28,2716249371,-19626585
1651781264,197178,true,2735875956,28,2716520996,-19354960
1651781668,197178,true,2735875956,28,2720054593,-15821363
1651781759,197181,true,2735055357,28,2720870691,-14184666
1651781814,197180,true,2735328863,28,2721414892,-13913971
1651781885,197180,true,2735328863,28,2722231398,-13097465
1651781935,197179,true,2735602396,28,2722775872,-12826524
1651781999,197182,true,2734781879,28,2723865146,-10916733
1651782119,197181,true,2735055357,28,2724954855,-10100502
1651782266,197181,true,2735055357,28,2726317605,-8737752
1651782349,197180,true,2735328863,28,2727135582,-8193281
1651782379,197183,true,2734508428,28,2727408296,-7100132
1651782392,197182,true,2734781879,28,2727681036,-7100843
1651782429,197181,true,2735055357,28,2728226600,-6828757
1651782470,197180,true,2735328863,28,2728499423,-6829440
1651782504,197183,true,2734508428,28,2729045150,-5463278
1651782516,197181,true,2735055357,28,2729318054,-5737303
1651782547,197181,true,2735055357,28,2729590986,-5464371
1651782554,197181,true,2735055357,28,2729590986,-5464371
1651782567,197184,true,2734235005,28,2729863945,-4371060
1651782591,197183,true,2734508428,28,2730136932,-4371496
1651782606,197182,true,2734781879,28,2730409945,-4371934
1651782643,197182,true,2734781879,28,2730956055,-3825824
1651782796,197184,true,2734235005,28,2732595038,-1639967
1651782860,197183,true,2734508428,28,2733414898,-1093530
1651782873,197182,true,2734781879,28,2733688240,-1093639
1651782909,197182,true,2734781879,28,2734235005,-546874
1651782981,197184,true,2734235005,28,2735602396,1367391
1651782984,197182,true,2734781879,28,2735602396,820517
1651783119,197181,true,2735055357,28,2738065423,3010066
1651783147,197181,true,2735055357,28,2738613064,3557707
1651783158,197183,true,2734508428,28,2738613064,4104636
1651783172,197182,true,2734781879,28,2738886925,4105046
1651783213,197181,true,2735055357,28,2739708673,4653316
1651783241,197182,true,2734781879,28,2739982644,5200765
1651783345,197184,true,2734235005,28,2741352909,7117904
1651783691,197183,true,2734508428,28,2745742365,11233937
1651783843,197183,true,2734508428,28,2747115511,12607083
1651784044,197183,true,2734508428,28,2748214522,13706094
1651787253,197185,true,2733961609,28,2751239070,17277461
1651787664,197185,true,2733961609,28,2751239070,17277461
1651787777,197185,true,2733961609,28,2751239070,17277461
1651787822,197185,true,2733961609,28,2751239070,17277461
1651787867,197187,true,2733414898,28,2751239070,17824172
1651787869,197186,true,2733688240,28,2751239070,17550830
1651787902,197186,true,2733688240,28,2751239070,17550830
1651787922,197186,true,2733688240,28,2751239070,17550830
1651788348,197189,true,2732868297,28,2749313973,16445676
1651788485,197188,true,2733141584,28,2748764192,15622608
1651789135,197188,true,2733141584,28,2746016939,12875355
1651789852,197188,true,2733141584,28,2743546759,10405175
1651791375,197190,true,2732595038,28,2743546759,10951721
1651791544,197189,true,2732868297,28,2743546759,10678462
1651793829,197189,true,2732868297,28,2742998132,10129835
1651794439,197189,true,2732868297,28,2742998132,10129835
1651794824,197191,true,2732321806,28,2742998132,10676326
1651794958,197190,true,2732595038,28,2743272432,10677394
1651796664,197189,true,2732868297,28,2744369906,11501609
1651796844,197189,true,2732868297,28,2744369906,11501609
1651797068,197191,true,2732321806,28,2744369906,12048100
1651797215,197190,true,2732595038,28,2744369906,11774868
1651797330,197190,true,2732595038,28,2744095496,11500458
1651797807,197189,true,2732868297,28,2743546759,10678462
1651797941,197191,true,2732321806,28,2743272432,10950626
1651798120,197190,true,2732595038,28,2742998132,10403094
1651798142,197190,true,2732595038,28,2742998132,10403094
1651798325,197190,true,2732595038,28,2742449615,9854577
1651798380,197189,true,2732868297,28,2742175397,9307100
1651798394,197188,true,2733141584,28,2742175397,9033813
1651798480,197188,true,2733141584,28,2741627045,8485461
1651798507,197188,true,2733141584,28,2741627045,8485461
1651799196,197188,true,2733141584,28,2737791644,4650060
1651800469,197187,true,2733414898,28,2733414898,0
1651800817,197186,true,2733688240,28,2733414898,-273342
1651801200,197186,true,2733688240,28,2734508428,820188
1651801896,197187,true,2733414898,28,2736423159,3008261
1651801944,197185,true,2733961609,28,2736423159,2461550
1651802333,197185,true,2733961609,28,2737517892,3556283
1651802414,197185,true,2733961609,28,2737791644,3830035
1651803138,197186,true,2733688240,28,2738339230,4650990
1651803276,197184,true,2734235005,28,2738339230,4104225
1651803558,197184,true,2734235005,28,2739160814,4925809
1651803630,197183,true,2734508428,28,2739160814,4652386
1651803771,197183,true,2734508428,28,2739434730,4926302
1651803862,197181,true,2735055357,28,2739982644,4927287
1651804058,197180,true,2735328863,28,2741078801,5749938
1651804158,197179,true,2735602396,28,2741627045,6024649
1651804209,197178,true,2735875956,28,2741901207,6025251
1651804248,197174,true,2736970471,28,2741901207,4930736
1651804806,197173,true,2737244168,28,2746291541,9047373
1651804977,197173,true,2737244168,28,2747664961,10420793
1651806777,197172,true,2737517892,28,2752064524,14546632
1651806798,197169,true,2738339230,28,2752064524,13725294
1651806832,197167,true,2738886925,28,2752064524,13177599
1651807673,197167,true,2738886925,28,2749313973,10427048
1651807827,197167,true,2738886925,28,2749039069,10152144
1651808678,197164,true,2739708673,28,2746291541,6582868
1651808751,197162,true,2740256642,28,2746291541,6034899
1651809644,197162,true,2740256642,28,2746291541,6034899
1651810266,197161,true,2740530668,28,2746291541,5760873
1651810322,197159,true,2741078801,28,2746291541,5212740
1651810401,197157,true,2741627045,28,2746291541,4664496
1651810424,197157,true,2741627045,28,2746291541,4664496
1651810508,197157,true,2741627045,28,2746016939,4389894
1651810516,197154,true,2742449615,28,2746016939,3567324
1651810896,197153,true,2742723860,28,2745467818,2743958
1651811065,197152,true,2742998132,28,2745193299,2195167
1651812181,197152,true,2742998132,28,2743546759,548627
1651812349,197151,true,2743272432,28,2743546759,274327
1651812405,197150,true,2743546759,28,2743546759,0
1651812420,197150,true,2743546759,28,2743546759,0
1651812511,197150,true,2743546759,28,2743546759,0
1651812723,197149,true,2743821114,28,2743272432,-548682
1651812744,197147,true,2744369906,28,2743272432,-1097474
1651813417,197147,true,2744369906,28,2743272432,-1097474
1651813962,197147,true,2744369906,28,2743272432,-1097474
1651814137,197146,true,2744644343,28,2743272432,-1371911
1651814148,197145,true,2744918807,28,2743272432,-1646375
1651814481,197145,true,2744918807,28,2743272432,-1646375
1651814587,197145,true,2744918807,28,2743272432,-1646375
1651814617,197145,true,2744918807,28,2743272432,-1646375
1651814671,197144,true,2745193299,28,2743272432,-1920867
1651814864,197144,true,2745193299,28,2743272432,-1920867
1651814881,197145,true,2744918807,28,2743272432,-1646375
1651815415,197144,true,2745193299,28,2743272432,-1920867
1651815615,197144,true,2745193299,28,2743546759,-1646540
1651815635,197144,true,2745193299,28,2743546759,-1646540
1651815680,197145,true,2744918807,28,2743546759,-1372048
1651815893,197144,true,2745193299,28,2743821114,-1372185
1651815929,197144,true,2745193299,28,2743821114,-1372185
1651815935,197145,true,2744918807,28,2743821114,-1097693
1651816241,197145,true,2744918807,28,2744095496,-823311
1651816476,197145,true,2744918807,28,2744095496,-823311
1651816624,197144,true,2745193299,28,2744369906,-823393
1651816757,197145,true,2744918807,28,2744369906,-548901
1651816807,197145,true,2744918807,28,2744644343,-274464
1651817210,197145,true,2744918807,28,2744918807,0
1651817377,197144,true,2745193299,28,2745193299,0
1651817464,197145,true,2744918807,28,2745467818,549011
1651817624,197146,true,2744644343,28,2745742365,1098022
1651817642,197146,true,2744644343,28,2745742365,1098022
1651817882,197145,true,2744918807,28,2746016939,1098132
1651817979,197146,true,2744644343,28,2746291541,1647198
1651818184,197147,true,2744369906,28,2746566170,2196264
1651818425,197147,true,2744369906,28,2747115511,2745605
1651818492,197146,true,2744644343,28,2747115511,2471168
1651818498,197146,true,2744644343,28,2747115511,2471168
1651818516,197147,true,2744369906,28,2747115511,2745605
1651818708,197147,true,2744369906,28,2747390222,3020316
1651818797,197146,true,2744644343,28,2747664961,3020618
1651818921,197146,true,2744644343,28,2747664961,3020618
1651818981,197148,true,2744095496,28,2747939728,3844232
1651819140,197147,true,2744369906,28,2747939728,3569822
1651819350,197146,true,2744644343,28,2747939728,3295385
1651819599,197147,true,2744369906,28,2747939728,3569822
1651819707,197148,true,2744095496,28,2747939728,3844232
1651819945,197148,true,2744095496,28,2747939728,3844232
1651819963,197147,true,2744369906,28,2747939728,3569822
1651820019,197147,true,2744369906,28,2747939728,3569822
1651820088,197148,true,2744095496,28,2747939728,3844232
1651820164,197147,true,2744369906,28,2747939728,3569822
1651820281,197146,true,2744644343,28,2747664961,3020618
1651820304,197146,true,2744644343,28,2747664961,3020618
1651820456,197147,true,2744369906,28,2747664961,3295055
1651820499,197147,true,2744369906,28,2747664961,3295055
1651820556,197146,true,2744644343,28,2747664961,3020618
1651820704,197146,true,2744644343,28,2747664961,3020618
1651820717,197146,true,2744644343,28,2747664961,3020618
1651820843,197146,true,2744644343,28,2747664961,3020618
1651820861,197145,true,2744918807,28,2747664961,2746154
1651820950,197146,true,2744644343,28,2747664961,3020618
1651821002,197146,true,2744644343,28,2747664961,3020618
1651821068,197146,true,2744644343,28,2747664961,3020618
1651821118,197145,true,2744918807,28,2747390222,2471415
1651821137,197145,true,2744918807,28,2747390222,2471415
1651821265,197146,true,2744644343,28,2747390222,2745879
1651821385,197145,true,2744918807,28,2747390222,2471415
1651821869,197144,true,2745193299,28,2747115511,1922212
1651821933,197144,true,2745193299,28,2747115511,1922212
1651821953,197145,true,2744918807,28,2747115511,2196704
1651821992,197144,true,2745193299,28,2746840827,1647528
1651822160,197143,true,2745467818,28,2746840827,1373009
1651822296,197143,true,2745467818,28,2746566170,1098352
1651822376,197143,true,2745467818,28,2746566170,1098352
1651822497,197143,true,2745467818,28,2746566170,1098352
1651822576,197142,true,2745742365,28,2746291541,549176
1651822585,197142,true,2745742365,28,2746291541,549176
1651822678,197142,true,2745742365,28,2745467818,-274547
1651822738,197143,true,2745467818,28,2745193299,-274519
1651822769,197142,true,2745742365,28,2744918807,-823558
1651822789,197143,true,2745467818,28,2744644343,-823475
1651822823,197144,true,2745193299,28,2744095496,-1097803
1651822834,197144,true,2745193299,28,2744095496,-1097803
1651822885,197145,true,2744918807,28,2743272432,-1646375
1651822893,197145,true,2744918807,28,2742998132,-1920675
1651822899,197146,true,2744644343,28,2742998132,-1646211
1651822911,197147,true,2744369906,28,2742723860,-1646046
1651822927,197148,true,2744095496,28,2742449615,-1645881
1651822992,197149,true,2743821114,28,2741352909,-2468205
1651823029,197151,true,2743272432,28,2740530668,-2741764
1651823040,197152,true,2742998132,28,2740530668,-2467464
1651823083,197153,true,2742723860,28,2739708673,-3015187
1651823129,197154,true,2742449615,28,2738613064,-3836551
1651823206,197156,true,2741901207,28,2736970471,-4930736
1651823332,197158,true,2741352909,28,2734235005,-7117904
1651823403,197159,true,2741078801,28,2732595038,-8483763
1651823436,197160,true,2740804721,28,2731775423,-9029298
1651823454,197162,true,2740256642,28,2731502273,-8754369
1651823472,197163,true,2739982644,28,2730956055,-9026589
1651823562,197164,true,2739708673,28,2729318054,-10390619
1651823593,197165,true,2739434730,28,2728772273,-10662457
1651823627,197166,true,2739160814,28,2727953805,-11207009
1651823632,197167,true,2738886925,28,2727953805,-10933120
1651823644,197168,true,2738613064,28,2727681036,-10932028
1651823721,197168,true,2738613064,28,2726862896,-11750168
1651823737,197169,true,2738339230,28,2726590237,-11748993
1651824162,197169,true,2738339230,28,2722503621,-15835609
1651824189,197170,true,2738065423,28,2722231398,-15834025
1651824224,197170,true,2738065423,28,2721959202,-16106221
1651824246,197171,true,2737791644,28,2721687034,-16104610
1651824397,197172,true,2737517892,28,2720326598,-17191294
1651824437,197172,true,2737517892,28,2720054593,-17463299
1651824572,197172,true,2737517892,28,2720326598,-17191294
1651824717,197172,true,2737517892,28,2721687034,-15830858
1651824803,197173,true,2737244168,28,2722775872,-14468296
1651824854,197173,true,2737244168,28,2723320454,-13923714
1651824947,197173,true,2737244168,28,2724409946,-12834222
1651824990,197174,true,2736970471,28,2724954855,-12015616
1651825065,197174,true,2736970471,28,2726045001,-10925470
1651825437,197175,true,2736696801,28,2730136932,-6559869
1651825469,197175,true,2736696801,28,2730136932,-6559869
1651825591,197176,true,2736423159,28,2730409945,-6013214
1651825661,197176,true,2736423159,28,2730409945,-6013214
1651825751,197177,true,2736149544,28,2730409945,-5739599
1651825764,197177,true,2736149544,28,2730409945,-5739599
1651825838,197177,true,2736149544,28,2730409945,-5739599
1651825894,197178,true,2735875956,28,2730409945,-5466011
1651825938,197179,true,2735602396,28,2730409945,-5192451
1651825946,197178,true,2735875956,28,2730409945,-5466011
1651825983,197179,true,2735602396,28,2730409945,-5192451
1651826411,197180,true,2735328863,28,2730136932,-5191931
1651826446,197181,true,2735055357,28,2729863945,-5191412
1651826477,197181,true,2735055357,28,2729863945,-5191412
1651826513,197181,true,2735055357,28,2729590986,-5464371
1651826538,197182,true,2734781879,28,2729590986,-5190893
1651826576,197183,true,2734508428,28,2729318054,-5190374
1651826591,197183,true,2734508428,28,2729318054,-5190374
1651826716,197184,true,2734235005,28,2729045150,-5189855
1651826746,197184,true,2734235005,28,2728772273,-5462732
1651826863,197185,true,2733961609,28,2728772273,-5189336
1651827043,197185,true,2733961609,28,2728499423,-5462186
1651827094,197186,true,2733688240,28,2728499423,-5188817
1651827134,197187,true,2733414898,28,2728499423,-4915475
1651827153,197188,true,2733141584,28,2728499423,-4642161
1651827252,197188,true,2733141584,28,2728226600,-4914984
1651827260,197189,true,2732868297,28,2728226600,-4641697
1651827296,197190,true,2732595038,28,2728226600,-4368438
1651827381,197191,true,2732321806,28,2727953805,-4368001
1651827465,197191,true,2732321806,28,2727953805,-4368001
1651827500,197192,true,2732048601,28,2727681036,-4367565
1651827653,197193,true,2731775423,28,2727408296,-4367127
1651827729,197194,true,2731502273,28,2727135582,-4366691
1651827819,197194,true,2731502273,28,2727135582,-4366691
1651827887,197195,true,2731229150,28,2726862896,-4366254
1651827900,197196,true,2730956055,28,2726862896,-4093159
1651827901,197197,true,2730682986,28,2726862896,-3820090
1651827904,197197,true,2730682986,28,2726862896,-3820090
1651827977,197198,true,2730409945,28,2726590237,-3819708
1651828126,197199,true,2730136932,28,2726317605,-3819327
1651828141,197200,true,2729863945,28,2726317605,-3546340
1651828207,197200,true,2729863945,28,2726045001,-3818944
1651828379,197201,true,2729590986,28,2725772423,-3818563
1651828555,197202,true,2729318054,28,2725499873,-3818181
1651828603,197203,true,2729045150,28,2725499873,-3545277
1651828697,197203,true,2729045150,28,2725227351,-3817799
1651828714,197204,true,2728772273,28,2725227351,-3544922
1651828755,197205,true,2728499423,28,2725227351,-3272072
1651828804,197206,true,2728226600,28,2725227351,-2999249
1651828939,197206,true,2728226600,28,2724954855,-3271745
1651828982,197207,true,2727953805,28,2724954855,-2998950
1651829036,197208,true,2727681036,28,2724954855,-2726181
1651829039,197209,true,2727408296,28,2724954855,-2453441
1651829158,197209,true,2727408296,28,2724682387,-2725909
1651829286,197210,true,2727135582,28,2724682387,-2453195
1651829297,197211,true,2726862896,28,2724682387,-2180509
1651829311,197212,true,2726590237,28,2724682387,-1907850
1651829319,197212,true,2726590237,28,2724682387,-1907850
1651829380,197213,true,2726317605,28,2724682387,-1635218
1651829434,197214,true,2726045001,28,2724682387,-1362614
1651829460,197215,true,2725772423,28,2724682387,-1090036
1651829477,197214,true,2726045001,28,2724682387,-1362614
1651829503,197215,true,2725772423,28,2724682387,-1090036
1651829533,197216,true,2725499873,28,2724954855,-545018
1651829555,197217,true,2725227351,28,2724954855,-272496
1651829599,197217,true,2725227351,28,2724954855,-272496
1651829615,197218,true,2724954855,28,2724954855,0
1651829759,197219,true,2724682387,28,2724954855,272468
1651829922,197220,true,2724409946,28,2724954855,544909
1651830079,197219,true,2724682387,28,2725227351,544964
1651830140,197220,true,2724409946,28,2725227351,817405
1651830167,197220,true,2724409946,28,2725227351,817405
1651830230,197221,true,2724137532,28,2725499873,1362341
1651830264,197220,true,2724409946,28,2725499873,1089927
1651830401,197220,true,2724409946,28,2725772423,1362477
1651830535,197220,true,2724409946,28,2725772423,1362477
1651830581,197220,true,2724409946,28,2725772423,1362477
1651830788,197219,true,2724682387,28,2726317605,1635218
1651830801,197219,true,2724682387,28,2726317605,1635218
1651831098,197219,true,2724682387,28,2726590237,1907850
1651831402,197219,true,2724682387,28,2726862896,2180509
1651831431,197218,true,2724954855,28,2727135582,2180727
1651831680,197218,true,2724954855,28,2727135582,2180727
1651831971,197217,true,2725227351,28,2727135582,1908231
1651832498,197217,true,2725227351,28,2727135582,1908231
1651832699,197216,true,2725499873,28,2727135582,1635709
1651832710,197215,true,2725772423,28,2727135582,1363159
1651832839,197215,true,2725772423,28,2727135582,1363159
1651832920,197214,true,2726045001,28,2727135582,1090581
1651832960,197213,true,2726317605,28,2727135582,817977
1651833011,197213,true,2726317605,28,2727135582,817977
1651833042,197212,true,2726590237,28,2727135582,545345
1651833271,197212,true,2726590237,28,2726590237,0
1651833333,197211,true,2726862896,28,2726590237,-272659
1651833361,197211,true,2726862896,28,2726590237,-272659
1651833458,197211,true,2726862896,28,2726045001,-817895
1651833585,197211,true,2726862896,28,2725772423,-1090473
1651833603,197211,true,2726862896,28,2725499873,-1363023
1651833620,197211,true,2726862896,28,2725499873,-1363023
1651833669,197212,true,2726590237,28,2725227351,-1362886
1651833695,197212,true,2726590237,28,2725227351,-1362886
1651833706,197212,true,2726590237,28,2725227351,-1362886
1651833794,197213,true,2726317605,28,2724137532,-2180073
1651833925,197214,true,2726045001,28,2722775872,-3269129
1651833998,197215,true,2725772423,28,2721959202,-3813221
1651834082,197215,true,2725772423,28,2721142778,-4629645
1651834196,197216,true,2725499873,28,2720054593,-5445280
1651834230,197218,true,2724954855,28,2719510664,-5444191
1651834245,197218,true,2724954855,28,2719510664,-5444191
1651834264,197219,true,2724682387,28,2719238740,-5443647
1651834330,197220,true,2724409946,28,2718423131,-5986815
1651834518,197221,true,2724137532,28,2715977773,-8159759
1651834589,197222,true,2723865146,28,2715163143,-8702003
1651834604,197222,true,2723865146,28,2714891654,-8973492
1651834666,197224,true,2723320454,28,2713805968,-9514486
1651834748,197225,true,2723048149,28,2711907064,-11141085
1651834851,197227,true,2722503621,28,2709738514,-12765107
1651834948,197227,true,2722503621,28,2707842456,-14661165
1651834991,197229,true,2721959202,28,2707030265,-14928937
1651835133,197230,true,2721687034,28,2704865615,-16821419
1651835172,197232,true,2721142778,28,2704324723,-16818055
1651835223,197232,true,2721142778,28,2703513588,-17629190
1651835229,197233,true,2720870691,28,2703513588,-17357103
1651835295,197235,true,2720326598,28,2702702696,-17623902
1651835367,197236,true,2720054593,28,2701621886,-18432707
1651835405,197236,true,2720054593,28,2701081642,-18972951
1651835410,197238,true,2719510664,28,2701081642,-18429022
1651835418,197239,true,2719238740,28,2701081642,-18157098
1651835468,197241,true,2718694974,28,2700001480,-18693494
1651835481,197241,true,2718694974,28,2700001480,-18693494
1651835482,197243,true,2718151316,28,2700001480,-18149836
1651835511,197244,true,2717879528,28,2699461560,-18417968
1651835528,197246,true,2717336034,28,2699191641,-18144393
1651835568,197247,true,2717064327,28,2698382046,-18682281
1651835609,197249,true,2716520996,28,2697842450,-18678546
1651835696,197250,true,2716249371,28,2696493933,-19755438
1651835827,197252,true,2715706203,28,2694337709,-21368494
1651835922,197253,true,2715434659,28,2692990944,-22443715
1651835946,197255,true,2714891654,28,2692452426,-22439228
1651836192,197257,true,2714348757,28,2688954687,-25394070
1651836217,197259,true,2713805968,28,2688416977,-25388991
1651836325,197259,true,2713805968,28,2687073172,-26732796
1651836372,197261,true,2713263289,28,2686267211,-26996078
1651836399,197263,true,2712720717,28,2685998611,-26722106
1651836413,197265,true,2712178255,28,2685730038,-26448217
1651836432,197266,true,2711907064,28,2685461492,-26445572
1651836446,197267,true,2711635900,28,2685461492,-26174408
1651836561,197270,true,2710822572,28,2684387576,-26434996
1651836712,197272,true,2710280489,28,2683045785,-27234704
1651836725,197273,true,2710009488,28,2682777507,-27231981
1651836843,197274,true,2709738514,28,2681436520,-28301994
1651836867,197277,true,2708925755,28,2681168404,-27757351
1651837011,197279,true,2708384051,28,2679024434,-29359617
1651837073,197280,true,2708113240,28,2678220887,-29892353
1651837081,197282,true,2707571699,28,2677953092,-29618607
1651837278,197284,true,2707030265,28,2675811693,-31218572
1651837584,197286,true,2706488941,28,2675009110,-31479831
1651837639,197286,true,2706488941,28,2674741636,-31747305
1651837685,197288,true,2705947724,28,2674741636,-31206088
1651837784,197290,true,2705406616,28,2674474188,-30932428
1651837816,197292,true,2704865615,28,2674206768,-30658847
1651837923,197293,true,2704595156,28,2673939374,-30655782
1651837977,197295,true,2704054318,28,2673939374,-30114944
1651838036,197297,true,2703513588,28,2673672007,-29841581
1651838066,197299,true,2702972967,28,2673672007,-29300960
1651838121,197300,true,2702702696,28,2673404666,-29298030
1651838142,197302,true,2702162237,28,2673404666,-28757571
1651838243,197304,true,2701621886,28,2673404666,-28217220
1651838288,197305,true,2701351750,28,2673404666,-27947084
1651838313,197306,true,2701081642,28,2673404666,-27676976
1651838350,197308,true,2700541507,28,2673404666,-27136841
1651838418,197310,true,2700001480,28,2673672007,-26329473
1651838455,197312,true,2699461560,28,2673672007,-25789553
1651838563,197313,true,2699191641,28,2674206768,-24984873
1651838575,197315,true,2698651884,28,2674206768,-24445116
1651838635,197316,true,2698382046,28,2674741636,-23640410
1651838696,197318,true,2697842450,28,2675009110,-22833340
1651838722,197318,true,2697842450,28,2675276611,-22565839
1651839173,197320,true,2697302962,28,2678220887,-19082075
1651839186,197322,true,2696763583,28,2678220887,-18542696
1651839288,197323,true,2696493933,28,2678756558,-17737375
1651839330,197324,true,2696224311,28,2678756558,-17467753
1651839408,197326,true,2695685147,28,2679024434,-16660713
1651839434,197328,true,2695146091,28,2679292336,-15853755
1651839500,197330,true,2694607142,28,2679292336,-15314806
1651839595,197330,true,2694607142,28,2679560265,-15046877
1651839637,197332,true,2694068302,28,2679560265,-14508037
1651839657,197334,true,2693529569,28,2679560265,-13969304
1651839661,197336,true,2692990944,28,2679560265,-13430679
1651839777,197337,true,2692721672,28,2679560265,-13161407
1651839969,197339,true,2692183208,28,2679560265,-12622943
1651840011,197341,true,2691644852,28,2679560265,-12084587
1651840053,197343,true,2691106604,28,2679828221,-11278383
1651840068,197344,true,2690837520,28,2679828221,-11009299
1651840098,197346,true,2690299433,28,2679828221,-10471212
1651840104,197348,true,2689761454,28,2679828221,-9933233
1651840107,197350,true,2689223583,28,2679828221,-9395362
1651840115,197350,true,2689223583,28,2679828221,-9395362
1651840152,197351,true,2688954687,28,2680096204,-8858483
1651840194,197353,true,2688416977,28,2680364214,-8052763
1651840217,197355,true,2687879374,28,2680632250,-7247124
1651840297,197355,true,2687879374,28,2681168404,-6710970
1651840303,197356,true,2687610613,28,2681436520,-6174093
1651840339,197357,true,2687341879,28,2681704664,-5637215
1651840417,197359,true,2686804491,28,2682509256,-4295235
1651840418,197358,true,2687073172,28,2682509256,-4563916
1651840505,197359,true,2686804491,28,2683314089,-3490402
1651840514,197360,true,2686535838,28,2683582421,-2953417
1651840553,197361,true,2686267211,28,2683850779,-2416432
1651840590,197361,true,2686267211,28,2684387576,-1879635
1651840620,197361,true,2686267211,28,2684656015,-1611196
1651840658,197362,true,2685998611,28,2685461492,-537119
1651840689,197363,true,2685730038,28,2685730038,0
1651840712,197362,true,2685998611,28,2686267211,268600
1651840746,197361,true,2686267211,28,2686804491,537280
1651840884,197361,true,2686267211,28,2689223583,2956372
1651840896,197362,true,2685998611,28,2689223583,3224972
1651840904,197361,true,2686267211,28,2689492505,3225294
1651840906,197360,true,2686535838,28,2689492505,2956667
1651840936,197361,true,2686267211,28,2689761454,3494243
1651840988,197361,true,2686267211,28,2690568463,4301252
1651840993,197361,true,2686267211,28,2690568463,4301252
1651841144,197360,true,2686535838,28,2692721672,6185834
1651841179,197361,true,2686267211,28,2693260243,6993032
1651841213,197361,true,2686267211,28,2693798922,7531711
1651841280,197360,true,2686535838,28,2694607142,8071304
1651841308,197360,true,2686535838,28,2695146091,8610253
1651841351,197360,true,2686535838,28,2695685147,9149309
1651841353,197359,true,2686804491,28,2695685147,8880656
1651841442,197359,true,2686804491,28,2696493933,9689442
1651841618,197359,true,2686804491,28,2698112234,11307743
1651841662,197359,true,2686804491,28,2698382046,11577555
1651841687,197360,true,2686535838,28,2698651884,12116046
1651841722,197360,true,2686535838,28,2698921749,12385911
1651841756,197360,true,2686535838,28,2698921749,12385911
1651841822,197361,true,2686267211,28,2699191641,12924430
1651841831,197361,true,2686267211,28,2699461560,13194349
1651841908,197362,true,2685998611,28,2699731506,13732895
1651841929,197362,true,2685998611,28,2699731506,13732895
1651841989,197362,true,2685998611,28,2699461560,13462949
1651842225,197362,true,2685998611,28,2698112234,12113623
1651842238,197362,true,2685998611,28,2698112234,12113623
1651842274,197363,true,2685730038,28,2697842450,12112412
1651842350,197363,true,2685730038,28,2697033259,11303221
1651842385,197362,true,2685998611,28,2696493933,10495322
1651842441,197362,true,2685998611,28,2695685147,9686536
1651842535,197362,true,2685998611,28,2694068302,8069691
1651842605,197362,true,2685998611,28,2692990944,6992333
1651842607,197362,true,2685998611,28,2692990944,6992333
1651842687,197361,true,2686267211,28,2691644852,5377641
1651842738,197362,true,2685998611,28,2690837520,4838909
1651842777,197362,true,2685998611,28,2690299433,4300822
1651842902,197361,true,2686267211,28,2688685819,2418608
1651842949,197360,true,2686535838,28,2688148162,1612324
1651843026,197361,true,2686267211,28,2687341879,1074668
1651843045,197361,true,2686267211,28,2687341879,1074668
1651843091,197360,true,2686535838,28,2686804491,268653
1651843100,197359,true,2686804491,28,2686804491,0
1651843112,197359,true,2686804491,28,2686804491,0
1651843182,197359,true,2686804491,28,2686267211,-537280
1651843211,197358,true,2687073172,28,2686267211,-805961
1651843701,197357,true,2687341879,28,2685998611,-1343268
1651843760,197357,true,2687341879,28,2686267211,-1074668
1651843762,197356,true,2687610613,28,2686267211,-1343402
1651843776,197355,true,2687879374,28,2686267211,-1612163
1651843812,197355,true,2687879374,28,2686267211,-1612163
1651843817,197355,true,2687879374,28,2686267211,-1612163
1651843937,197354,true,2688148162,28,2686804491,-1343671
1651843987,197353,true,2688416977,28,2687073172,-1343805
1651843997,197352,true,2688685819,28,2687073172,-1612647
1651844009,197352,true,2688685819,28,2686804491,-1881328
1651844012,197352,true,2688685819,28,2686804491,-1881328
1651844081,197353,true,2688416977,28,2686535838,-1881139
1651844118,197352,true,2688685819,28,2686267211,-2418608
1651844132,197353,true,2688416977,28,2685998611,-2418366
1651844155,197353,true,2688416977,28,2685730038,-2686939
1651844173,197354,true,2688148162,28,2685461492,-2686670
1651844193,197355,true,2687879374,28,2685192973,-2686401
1651844237,197356,true,2687610613,28,2684119164,-3491449
1651844388,197357,true,2687341879,28,2680632250,-6709629
1651844460,197358,true,2687073172,28,2679024434,-8048738
1651844480,197359,true,2686804491,28,2678756558,-8047933
1651844606,197359,true,2686804491,28,2677149866,-9654625
1651844648,197359,true,2686804491,28,2676346882,-10457609
1651844652,197360,true,2686535838,28,2676346882,-10188956
1651844715,197361,true,2686267211,28,2675009110,-11258101
1651844722,197362,true,2685998611,28,2674741636,-11256975
1651844751,197363,true,2685730038,28,2674206768,-11523270
1651844798,197364,true,2685461492,28,2673137352,-12324140
1651844903,197366,true,2684924480,28,2670465685,-14458795
1651844987,197367,true,2684656015,28,2668597106,-16058909
1651844998,197368,true,2684387576,28,2668330273,-16057303
1651845077,197370,true,2683850779,28,2666729835,-17120944
1651845121,197371,true,2683582421,28,2665929976,-17652445
1651845161,197371,true,2683582421,28,2665130357,-18452064
1651845174,197372,true,2683314089,28,2664863871,-18450218
1651845193,197373,true,2683045785,28,2664597411,-18448374
1651845286,197375,true,2682509256,28,2662466692,-20042564
1651845336,197375,true,2682509256,28,2661668112,-20841144
1651845383,197376,true,2682241032,28,2660603711,-21637321
1651845423,197377,true,2681972834,28,2659805689,-22167145
1651845466,197378,true,2681704664,28,2659007907,-22696757
1651845572,197378,true,2681704664,28,2656881658,-24823006
1651845587,197379,true,2681436520,28,2656615996,-24820524
1651845593,197380,true,2681168404,28,2656615996,-24552408
1651845678,197381,true,2680900313,28,2655022584,-25877729
1651845896,197380,true,2681168404,28,2653164812,-28003592
1651846196,197380,true,2681168404,28,2657678802,-23489602
1651846242,197380,true,2681168404,28,2658476185,-22692219
1651846259,197381,true,2680900313,28,2658742033,-22158280
1651846432,197381,true,2680900313,28,2659805689,-21094624
1651846519,197382,true,2680632250,28,2660869771,-19762479
1651846539,197383,true,2680364214,28,2661135858,-19228356
1651846563,197384,true,2680096204,28,2661668112,-18428092
1651846625,197383,true,2680364214,28,2662732939,-17631275
1651846721,197383,true,2680364214,28,2664863871,-15500343
1651846736,197384,true,2680096204,28,2665130357,-14965847
1651846740,197386,true,2679560265,28,2665396870,-14163395
1651846789,197385,true,2679828221,28,2666729835,-13098386
1651846809,197384,true,2680096204,28,2667263208,-12832996
1651846878,197385,true,2679828221,28,2668863966,-10964255
1651846890,197387,true,2679292336,28,2668863966,-10428370
1651846952,197387,true,2679292336,28,2669931672,-9360664
1651847025,197387,true,2679292336,28,2671534031,-7758305
1651847130,197389,true,2678756558,28,2673137352,-5619206
1651847154,197391,true,2678220887,28,2673404666,-4816221
1651847166,197391,true,2678220887,28,2673404666,-4816221
1651847177,197392,true,2677953092,28,2673672007,-4281085
1651847202,197394,true,2677417581,28,2674206768,-3210813
1651847240,197397,true,2676614517,28,2674474188,-2140329
1651847261,197396,true,2676882178,28,2674741636,-2140542
1651847321,197397,true,2676614517,28,2675276611,-1337906
1651847340,197399,true,2676079274,28,2675544139,-535135
1651847517,197403,true,2675009110,28,2675544139,535029
1651847533,197403,true,2675009110,28,2675544139,535029
1651847615,197403,true,2675009110,28,2675276611,267501
1651847682,197406,true,2674206768,28,2675009110,802342
1651847859,197409,true,2673404666,28,2672602805,-801861
1651847917,197409,true,2673404666,28,2671801185,-1603481
1651847939,197410,true,2673137352,28,2671534031,-1603321
1651847974,197412,true,2672602805,28,2670999805,-1603000
1651848006,197415,true,2671801185,28,2670732731,-1068454
1651848056,197414,true,2672068365,28,2670465685,-1602680
1651848207,197414,true,2672068365,28,2670198665,-1869700
1651848336,197416,true,2671534031,28,2669397765,-2136266
1651848351,197418,true,2670999805,28,2669397765,-1602040
1651848354,197416,true,2671534031,28,2669397765,-2136266
1651848378,197416,true,2671534031,28,2669397765,-2136266
1651848485,197417,true,2671266905,28,2669130852,-2136053
1651848506,197419,true,2670732731,28,2669130852,-1601879
1651848601,197417,true,2671266905,28,2668597106,-2669799
1651848957,197416,true,2671534031,28,2669130852,-2403179
1651848981,197417,true,2671266905,28,2669397765,-1869140
1651849064,197419,true,2670732731,28,2669931672,-801059
1651849113,197417,true,2671266905,28,2670465685,-801220
1651849343,197415,true,2671801185,28,2675276611,3475426
1651849584,197415,true,2671801185,28,2680632250,8831065
1651849692,197417,true,2671266905,28,2683582421,12315516
1651849742,197415,true,2671801185,28,2684656015,12854830
1651849796,197413,true,2672335572,28,2685998611,13663039
1651849854,197413,true,2672335572,28,2687341879,15006307
1651849994,197415,true,2671801185,28,2690030430,18229245
1651850134,197413,true,2672335572,28,2692721672,20386100
1651850291,197410,true,2673137352,28,2695146091,22008739
1651850372,197411,true,2672870065,28,2696224311,23354246
1651850455,197413,true,2672335572,28,2697033259,24697687
1651850478,197410,true,2673137352,28,2697302962,24165610
1651850621,197408,true,2673672007,28,2699191641,25519634
1651850630,197408,true,2673672007,28,2699461560,25789553
1651850673,197410,true,2673137352,28,2700001480,26864128
1651851182,197407,true,2673939374,28,2706759589,32820215
1651851286,197404,true,2674741636,28,2707842456,33100820
1651851348,197404,true,2674741636,28,2708384051,33642415
1651851508,197406,true,2674206768,28,2709467567,35260799
1651851523,197403,true,2675009110,28,2709467567,34458457
1651851921,197401,true,2675544139,28,2710009488,34465349
1651851936,197402,true,2675276611,28,2710009488,34732877
1651851944,197404,true,2674741636,28,2710009488,35267852
1651851971,197401,true,2675544139,28,2710009488,34465349
1651852156,197400,true,2675811693,28,2709467567,33655874
1651852160,197401,true,2675544139,28,2709467567,33923428
1651852259,197403,true,2675009110,28,2709196648,34187538
1651852387,197400,true,2675811693,28,2708384051,32572358
1651852408,197399,true,2676079274,28,2708384051,32304777
1651852592,197398,true,2676346882,28,2706218319,29871437
1651852693,197400,true,2675811693,28,2704865615,29053922
1651852776,197397,true,2676614517,28,2703783940,27169423
1651852823,197396,true,2676882178,28,2703243264,26361086
1651852864,197394,true,2677417581,28,2702702696,25285115
1651853155,197395,true,2677149866,28,2699191641,22041775
1651853164,197392,true,2677953092,28,2699191641,21238549
1651853195,197389,true,2678756558,28,2698921749,20165191
1651853283,197387,true,2679292336,28,2698651884,19359548
1651853436,197388,true,2679024434,28,2698382046,19357612
1651853598,197385,true,2679828221,28,2698112234,18284013
1651853632,197383,true,2680364214,28,2698112234,17748020
1651854332,197382,true,2680632250,28,2695954716,15322466
1651854418,197382,true,2680632250,28,2695954716,15322466
1651854533,197379,true,2681436520,28,2695954716,14518196
1651854789,197377,true,2681972834,28,2696224311,14251477
1651854835,197376,true,2682241032,28,2696493933,14252901
1651854895,197375,true,2682509256,28,2696763583,14254327
1651855024,197372,true,2683314089,28,2697302962,13988873
1651855025,197369,true,2684119164,28,2697302962,13183798
1651855328,197368,true,2684387576,28,2697842450,13454874
1651855464,197368,true,2684387576,28,2698112234,13724658
1651855475,197365,true,2685192973,28,2698112234,12919261
1651855497,197362,true,2685998611,28,2698382046,12383435
1651855650,197361,true,2686267211,28,2699191641,12924430
1651855820,197361,true,2686267211,28,2700271480,14004269
1651855956,197358,true,2687073172,28,2700811561,13738389
1651856179,197355,true,2687879374,28,2701621886,13742512
1651856908,197354,true,2688148162,28,2703513588,15365426
1651857151,197354,true,2688148162,28,2703513588,15365426
1651857483,197351,true,2688954687,28,2703783940,14829253
1651857500,197348,true,2689761454,28,2703783940,14022486
1651857609,197348,true,2689761454,28,2703513588,13752134
1651857657,197348,true,2689761454,28,2703513588,13752134
1651857719,197346,true,2690299433,28,2703243264,12943831
1651858087,197345,true,2690568463,28,2702432453,11863990
1651858627,197344,true,2690837520,28,2700271480,9433960
1651858691,197345,true,2690568463,28,2700001480,9433017
1651858725,197343,true,2691106604,28,2699731506,8624902
1651858754,197341,true,2691644852,28,2699731506,8086654
1651859014,197341,true,2691644852,28,2698382046,6737194
1651859126,197342,true,2691375715,28,2697572693,6196978
1651859198,197341,true,2691644852,28,2697302962,5658110
1651859209,197340,true,2691914017,28,2697302962,5388945
1651859355,197340,true,2691914017,28,2696493933,4579916
1651859431,197340,true,2691914017,28,2696224311,4310294
1651859446,197340,true,2691914017,28,2696224311,4310294
1651859451,197340,true,2691914017,28,2696224311,4310294
1651859563,197340,true,2691914017,28,2695685147,3771130
1651859589,197340,true,2691914017,28,2695685147,3771130
1651859601,197340,true,2691914017,28,2695685147,3771130
1651859690,197339,true,2692183208,28,2695146091,2962883
1651859719,197339,true,2692183208,28,2694876603,2693395
1651859970,197340,true,2691914017,28,2693529569,1615552
1651860001,197339,true,2692183208,28,2693260243,1077035
1651860176,197338,true,2692452426,28,2692452426,0
1651860217,197338,true,2692452426,28,2692183208,-269218
1651860284,197338,true,2692452426,28,2691644852,-807574
1651860306,197337,true,2692721672,28,2691644852,-1076820
1651860353,197336,true,2692990944,28,2691375715,-1615229
1651860416,197336,true,2692990944,28,2690837520,-2153424
1651860570,197335,true,2693260243,28,2689761454,-3498789
1651860589,197335,true,2693260243,28,2689761454,-3498789
1651860630,197333,true,2693798922,28,2689492505,-4306417
1651860659,197333,true,2693798922,28,2689223583,-4575339
1651860727,197332,true,2694068302,28,2688685819,-5382483
1651860819,197331,true,2694337709,28,2688148162,-6189547
1651861007,197329,true,2694876603,28,2686804491,-8072112
1651861053,197329,true,2694876603,28,2686535838,-8340765
1651861323,197328,true,2695146091,28,2684924480,-10221611
1651861410,197328,true,2695146091,28,2684387576,-10758515
1651861413,197327,true,2695415605,28,2684387576,-11028029
1651861531,197326,true,2695685147,28,2684119164,-11565983
1651862053,197326,true,2695685147,28,2682509256,-13175891
1651862124,197326,true,2695685147,28,2682509256,-13175891
1651862217,197325,true,2695954716,28,2682241032,-13713684
1651862545,197325,true,2695954716,28,2681972834,-13981882
1651862935,197325,true,2695954716,28,2681704664,-14250052
1651863009,197326,true,2695685147,28,2681704664,-13980483
1651863165,197325,true,2695954716,28,2681972834,-13981882
1651863169,197326,true,2695685147,28,2681972834,-13712313
1651863432,197326,true,2695685147,28,2682509256,-13175891
1651864599,197326,true,2695685147,28,2684924480,-10760667
1651864616,197326,true,2695685147,28,2684924480,-10760667
1651864702,197327,true,2695415605,28,2684924480,-10491125
1651864727,197327,true,2695415605,28,2684924480,-10491125
1651864768,197328,true,2695146091,28,2684924480,-10221611
1651864867,197329,true,2694876603,28,2684656015,-10220588
1651864934,197330,true,2694607142,28,2684656015,-9951127
1651864986,197330,true,2694607142,28,2684387576,-10219566
1651865125,197331,true,2694337709,28,2683850779,-10486930
1651865173,197332,true,2694068302,28,2683582421,-10485881
1651865461,197333,true,2693798922,28,2682509256,-11289666
1651865483,197333,true,2693798922,28,2682241032,-11557890
1651865658,197334,true,2693529569,28,2681704664,-11824905
1651865687,197336,true,2692990944,28,2681704664,-11286280
1651865733,197337,true,2692721672,28,2681704664,-11017008
1651865754,197337,true,2692721672,28,2681704664,-11017008
1651865880,197339,true,2692183208,28,2681436520,-10746688
1651865915,197340,true,2691914017,28,2681704664,-10209353
1651866244,197341,true,2691644852,28,2682777507,-8867345
1651866392,197341,true,2691644852,28,2683314089,-8330763
1651867024,197341,true,2691644852,28,2688416977,-3227875
1651867232,197341,true,2691644852,28,2690030430,-1614422
1651867397,197342,true,2691375715,28,2691375715,0
1651867455,197342,true,2691375715,28,2691644852,269137
1651867499,197342,true,2691375715,28,2691914017,538302
1651867588,197343,true,2691106604,28,2692183208,1076604
1651867617,197343,true,2691106604,28,2692183208,1076604
1651867741,197344,true,2690837520,28,2692183208,1345688
1651868053,197344,true,2690837520,28,2691375715,538195
1651868227,197344,true,2690837520,28,2690837520,0
1651868239,197345,true,2690568463,28,2690837520,269057
1651868458,197345,true,2690568463,28,2687879374,-2689089
1651868506,197346,true,2690299433,28,2688416977,-1882456
1651868663,197346,true,2690299433,28,2687341879,-2957554
1651868768,197347,true,2690030430,28,2686535838,-3494592
1651869856,197347,true,2690030430,28,2680364214,-9666216
1651869970,197348,true,2689761454,28,2679828221,-9933233
1651869980,197348,true,2689761454,28,2679828221,-9933233
1651870111,197349,true,2689492505,28,2680364214,-9128291
1651870163,197350,true,2689223583,28,2680632250,-8591333
1651870206,197350,true,2689223583,28,2681168404,-8055179
1651870216,197350,true,2689223583,28,2681168404,-8055179
1651870241,197350,true,2689223583,28,2681436520,-7787063
1651870274,197351,true,2688954687,28,2681168404,-7786283
1651870396,197351,true,2688954687,28,2681436520,-7518167
1651870404,197351,true,2688954687,28,2681436520,-7518167
1651870469,197351,true,2688954687,28,2681972834,-6981853
1651870549,197352,true,2688685819,28,2682777507,-5908312
1651870610,197351,true,2688954687,28,2683314089,-5640598
1651871026,197352,true,2688685819,28,2687341879,-1343940
1651871057,197352,true,2688685819,28,2687610613,-1075206
1651871234,197352,true,2688685819,28,2689492505,806686
1651871362,197352,true,2688685819,28,2690568463,1882644
1651871848,197353,true,2688416977,28,2695415605,6998628
1651871949,197353,true,2688416977,28,2696224311,7807334
1651872157,197353,true,2688416977,28,2697302962,8885985
1651873317,197353,true,2688416977,28,2697572693,9155716
1651873485,197353,true,2688416977,28,2697572693,9155716
1651873519,197354,true,2688148162,28,2697572693,9424531
1651873550,197354,true,2688148162,28,2697572693,9424531
1651873630,197354,true,2688148162,28,2697572693,9424531
1651873669,197354,true,2688148162,28,2697572693,9424531
1651873707,197355,true,2687879374,28,2697572693,9693319
1651873889,197355,true,2687879374,28,2697033259,9153885
1651873930,197354,true,2688148162,28,2697033259,8885097
1651873942,197355,true,2687879374,28,2697033259,9153885
1651874020,197355,true,2687879374,28,2696763583,8884209
1651874257,197356,true,2687610613,28,2695954716,8344103
1651874277,197355,true,2687879374,28,2695685147,7805773
1651874295,197356,true,2687610613,28,2695685147,8074534
1651874471,197356,true,2687610613,28,2694876603,7265990
1651874727,197356,true,2687610613,28,2693798922,6188309
1651875374,197356,true,2687610613,28,2691106604,3495991
1651875439,197356,true,2687610613,28,2690837520,3226907
1651875559,197356,true,2687610613,28,2690568463,2957850
1651875589,197357,true,2687341879,28,2690568463,3226584
1651875664,197356,true,2687610613,28,2690568463,2957850
1651875843,197357,true,2687341879,28,2690299433,2957554
1651876066,197357,true,2687341879,28,2690030430,2688551
1651876121,197357,true,2687341879,28,2690030430,2688551
1651876636,197356,true,2687610613,28,2690030430,2419817
1651876686,197357,true,2687341879,28,2690030430,2688551
1651876717,197356,true,2687610613,28,2690030430,2419817
1651877229,197357,true,2687341879,28,2690030430,2688551
1651877306,197356,true,2687610613,28,2690030430,2419817
1651877363,197357,true,2687341879,28,2690030430,2688551
1651877383,197356,true,2687610613,28,2690030430,2419817
1651877413,197356,true,2687610613,28,2690030430,2419817
1651877565,197356,true,2687610613,28,2690030430,2419817
1651877648,197356,true,2687610613,28,2690299433,2688820
1651878417,197355,true,2687879374,28,2691644852,3765478
1651878454,197355,true,2687879374,28,2691644852,3765478
1651878469,197354,true,2688148162,28,2691914017,3765855
1651878626,197355,true,2687879374,28,2692183208,4303834
1651879141,197354,true,2688148162,28,2692990944,4842782
1651879168,197354,true,2688148162,28,2693260243,5112081
1651879231,197353,true,2688416977,28,2693260243,4843266
1651879271,197353,true,2688416977,28,2693260243,4843266
1651879411,197352,true,2688685819,28,2693529569,4843750
1651879427,197352,true,2688685819,28,2693798922,5113103
1651879588,197351,true,2688954687,28,2694068302,5113615
1651879618,197351,true,2688954687,28,2694068302,5113615
1651879799,197350,true,2689223583,28,2694607142,5383559
1651879869,197350,true,2689223583,28,2694876603,5653020
1651879992,197349,true,2689492505,28,2695146091,5653586
1651880077,197349,true,2689492505,28,2695415605,5923100
1651880162,197348,true,2689761454,28,2695415605,5654151
1651880282,197348,true,2689761454,28,2695954716,6193262
1651880394,197347,true,2690030430,28,2696224311,6193881
1651880446,197347,true,2690030430,28,2696224311,6193881
1651880691,197346,true,2690299433,28,2696763583,6464150
1651880763,197346,true,2690299433,28,2697033259,6733826
1651880936,197345,true,2690568463,28,2697572693,7004230
1651880946,197345,true,2690568463,28,2697572693,7004230
1651881103,197344,true,2690837520,28,2697842450,7004930
1651881127,197344,true,2690837520,28,2697842450,7004930
1651881176,197343,true,2691106604,28,2697842450,6735846
1651881317,197343,true,2691106604,28,2697842450,6735846
1651881388,197342,true,2691375715,28,2697842450,6466735
1651881444,197342,true,2691375715,28,2697842450,6466735
1651881519,197340,true,2691914017,28,2697842450,5928433
1651881539,197341,true,2691644852,28,2697842450,6197598
1651881669,197339,true,2692183208,28,2697842450,5659242
1651881872,197339,true,2692183208,28,2697842450,5659242
1651881879,197338,true,2692452426,28,2697842450,5390024
1651881895,197338,true,2692452426,28,2697842450,5390024
1651882040,197337,true,2692721672,28,2697842450,5120778
1651882069,197337,true,2692721672,28,2697842450,5120778
1651882239,197336,true,2692990944,28,2697842450,4851506
1651882243,197336,true,2692990944,28,2697842450,4851506
1651882399,197336,true,2692990944,28,2697572693,4581749
1651882617,197336,true,2692990944,28,2697302962,4312018
1651882713,197336,true,2692990944,28,2697302962,4312018
1651882854,197336,true,2692990944,28,2697033259,4042315
1651882879,197336,true,2692990944,28,2697033259,4042315
1651882915,197336,true,2692990944,28,2697033259,4042315
1651883020,197335,true,2693260243,28,2696763583,3503340
1651883137,197335,true,2693260243,28,2696763583,3503340
1651883197,197335,true,2693260243,28,2696493933,3233690
1651883233,197335,true,2693260243,28,2696493933,3233690
1651883260,197334,true,2693529569,28,2696493933,2964364
1651883483,197334,true,2693529569,28,2695954716,2425147
1651883506,197334,true,2693529569,28,2695954716,2425147
1651883563,197333,true,2693798922,28,2695954716,2155794
1651883600,197332,true,2694068302,28,2695685147,1616845
1651883664,197332,true,2694068302,28,2695685147,1616845
1651883696,197332,true,2694068302,28,2695685147,1616845
1651883872,197332,true,2694068302,28,2695146091,1077789
1651883878,197331,true,2694337709,28,2694876603,538894
1651883906,197331,true,2694337709,28,2694876603,538894
1651883978,197330,true,2694607142,28,2694607142,0
1651884041,197331,true,2694337709,28,2694337709,0
1651884043,197330,true,2694607142,28,2694337709,-269433
1651884078,197330,true,2694607142,28,2694337709,-269433
1651884109,197330,true,2694607142,28,2694337709,-269433
1651884328,197330,true,2694607142,28,2693798922,-808220
1651884486,197330,true,2694607142,28,2693260243,-1346899
1651884532,197330,true,2694607142,28,2693260243,-1346899
1651884778,197330,true,2694607142,28,2692452426,-2154716
1651884952,197330,true,2694607142,28,2692183208,-2423934
1651885055,197330,true,2694607142,28,2691914017,-2693125
1651885157,197331,true,2694337709,28,2691644852,-2692857
1651885281,197331,true,2694337709,28,2691375715,-2961994
1651885283,197331,true,2694337709,28,2691375715,-2961994
1651885311,197331,true,2694337709,28,2691375715,-2961994
1651885347,197332,true,2694068302,28,2691375715,-2692587
1651885355,197332,true,2694068302,28,2691375715,-2692587
1651885359,197332,true,2694068302,28,2691375715,-2692587
1651885505,197332,true,2694068302,28,2691106604,-2961698
1651885571,197332,true,2694068302,28,2691106604,-2961698
1651885768,197332,true,2694068302,28,2690837520,-3230782
1651885850,197333,true,2693798922,28,2690837520,-2961402
1651885865,197333,true,2693798922,28,2690837520,-2961402
1651885902,197333,true,2693798922,28,2690837520,-2961402
1651885924,197333,true,2693798922,28,2690837520,-2961402
1651885927,197334,true,2693529569,28,2690837520,-2692049
1651885986,197333,true,2693798922,28,2690837520,-2961402
1651885991,197334,true,2693529569,28,2690837520,-2692049
1651886020,197333,true,2693798922,28,2690837520,-2961402
1651886033,197334,true,2693529569,28,2690837520,-2692049
1651886119,197333,true,2693798922,28,2690837520,-2961402
1651886177,197334,true,2693529569,28,2690837520,-2692049
1651886235,197333,true,2693798922,28,2690837520,-2961402
1651886263,197334,true,2693529569,28,2690837520,-2692049
1651886268,197333,true,2693798922,28,2690837520,-2961402
1651886300,197333,true,2693798922,28,2690837520,-2961402
1651886324,197333,true,2693798922,28,2690837520,-2961402
1651886375,197333,true,2693798922,28,2690837520,-2961402
1651886432,197333,true,2693798922,28,2690837520,-2961402
1651886440,197333,true,2693798922,28,2690837520,-2961402
1651886496,197333,true,2693798922,28,2690837520,-2961402
1651886671,197333,true,2693798922,28,2690837520,-2961402
1651886700,197333,true,2693798922,28,2690837520,-2961402
1651886768,197333,true,2693798922,28,2690837520,-2961402
1651886804,197333,true,2693798922,28,2690837520,-2961402
1651886910,197333,true,2693798922,28,2690837520,-2961402
1651886934,197333,true,2693798922,28,2690837520,-2961402
1651887010,197333,true,2693798922,28,2690837520,-2961402
1651887066,197333,true,2693798922,28,2690837520,-2961402
1651887078,197333,true,2693798922,28,2690837520,-2961402
1651887154,197333,true,2693798922,28,2690837520,-2961402
1651887165,197333,true,2693798922,28,2690837520,-2961402
1651887198,197333,true,2693798922,28,2690837520,-2961402
1651887235,197333,true,2693798922,28,2690837520,-2961402
1651887298,197333,true,2693798922,28,2690837520,-2961402
1651887334,197334,true,2693529569,28,2690837520,-2692049
1651887498,197334,true,2693529569,28,2690568463,-2961106
1651887507,197334,true,2693529569,28,2690568463,-2961106
1651887515,197334,true,2693529569,28,2690568463,-2961106
1651887559,197334,true,2693529569,28,2690568463,-2961106
1651887631,197335,true,2693260243,28,2690568463,-2691780
1651887645,197335,true,2693260243,28,2690568463,-2691780
1651887692,197335,true,2693260243,28,2690568463,-2691780
1651887752,197335,true,2693260243,28,2690299433,-2960810
1651887790,197336,true,2692990944,28,2690299433,-2691511
1651887796,197336,true,2692990944,28,2690299433,-2691511
1651887808,197336,true,2692990944,28,2690299433,-2691511
1651887825,197337,true,2692721672,28,2690299433,-2422239
1651887842,197337,true,2692721672,28,2690299433,-2422239
1651887848,197337,true,2692721672,28,2690299433,-2422239
1651887982,197338,true,2692452426,28,2690030430,-2421996
1651888046,197338,true,2692452426,28,2689761454,-2690972
1651888050,197339,true,2692183208,28,2689761454,-2421754
1651888111,197339,true,2692183208,28,2689492505,-2690703
1651888215,197339,true,2692183208,28,2689223583,-2959625
1651888228,197340,true,2691914017,28,2689223583,-2690434
1651888259,197340,true,2691914017,28,2689223583,-2690434
1651888264,197340,true,2691914017,28,2689223583,-2690434
1651888335,197341,true,2691644852,28,2688954687,-2690165
1651888399,197341,true,2691644852,28,2688685819,-2959033
1651888417,197342,true,2691375715,28,2688685819,-2689896
1651888476,197342,true,2691375715,28,2688685819,-2689896
1651888487,197343,true,2691106604,28,2688416977,-2689627
1651888543,197343,true,2691106604,28,2688416977,-2689627
1651888579,197343,true,2691106604,28,2688148162,-2958442
1651888616,197344,true,2690837520,28,2688148162,-2689358
1651888690,197344,true,2690837520,28,2687879374,-2958146
1651888756,197345,true,2690568463,28,2687879374,-2689089
1651888777,197345,true,2690568463,28,2687610613,-2957850
1651888843,197345,true,2690568463,28,2687610613,-2957850
1651888979,197346,true,2690299433,28,2687073172,-3226261
1651889011,197346,true,2690299433,28,2687073172,-3226261
1651889107,197346,true,2690299433,28,2686804491,-3494942
1651889118,197347,true,2690030430,28,2686804491,-3225939
1651889175,197347,true,2690030430,28,2686804491,-3225939
1651889223,197347,true,2690030430,28,2686535838,-3494592
1651889294,197348,true,2689761454,28,2686535838,-3225616
1651889351,197348,true,2689761454,28,2686535838,-3225616
1651889404,197348,true,2689761454,28,2686267211,-3494243
1651889440,197349,true,2689492505,28,2686267211,-3225294
1651889467,197349,true,2689492505,28,2686267211,-3225294
1651889507,197349,true,2689492505,28,2686267211,-3225294
1651889586,197350,true,2689223583,28,2685998611,-3224972
1651889597,197350,true,2689223583,28,2685998611,-3224972
1651889615,197350,true,2689223583,28,2685998611,-3224972
1651889655,197350,true,2689223583,28,2685998611,-3224972
1651889694,197351,true,2688954687,28,2685998611,-2956076
1651889729,197351,true,2688954687,28,2685998611,-2956076
1651889751,197351,true,2688954687,28,2685998611,-2956076
1651889793,197351,true,2688954687,28,2685730038,-3224649
1651889807,197352,true,2688685819,28,2685730038,-2955781
1651889890,197352,true,2688685819,28,2685730038,-2955781
1651889907,197352,true,2688685819,28,2685730038,-2955781
1651890024,197352,true,2688685819,28,2685730038,-2955781
1651890098,197352,true,2688685819,28,2685730038,-2955781
1651890105,197352,true,2688685819,28,2685730038,-2955781
1651890115,197353,true,2688416977,28,2685730038,-2686939
1651890157,197353,true,2688416977,28,2685730038,-2686939
1651890161,197353,true,2688416977,28,2685730038,-2686939
1651890210,197353,true,2688416977,28,2685730038,-2686939
1651890272,197353,true,2688416977,28,2685730038,-2686939
1651890410,197353,true,2688416977,28,2685730038,-2686939
1651890429,197354,true,2688148162,28,2685730038,-2418124
1651890450,197354,true,2688148162,28,2685730038,-2418124
1651890461,197354,true,2688148162,28,2685730038,-2418124
1651890562,197354,true,2688148162,28,2685730038,-2418124
1651890576,197354,true,2688148162,28,2685730038,-2418124
1651890699,197355,true,2687879374,28,2685730038,-2149336
1651890760,197355,true,2687879374,28,2685730038,-2149336
1651890769,197355,true,2687879374,28,2685730038,-2149336
1651890781,197355,true,2687879374,28,2685730038,-2149336
1651890886,197355,true,2687879374,28,2685730038,-2149336
1651891022,197355,true,2687879374,28,2685730038,-2149336
1651891090,197355,true,2687879374,28,2685730038,-2149336
1651891094,197356,true,2687610613,28,2685730038,-1880575
1651891148,197356,true,2687610613,28,2685730038,-1880575
1651891200,197356,true,2687610613,28,2685730038,-1880575
1651891213,197356,true,2687610613,28,2685730038,-1880575
1651891243,197356,true,2687610613,28,2685730038,-1880575
1651891295,197357,true,2687341879,28,2685730038,-1611841
1651891304,197357,true,2687341879,28,2685730038,-1611841
1651891353,197357,true,2687341879,28,2685730038,-1611841
1651891364,197357,true,2687341879,28,2685730038,-1611841
1651891378,197357,true,2687341879,28,2685730038,-1611841
1651891384,197357,true,2687341879,28,2685730038,-1611841
1651891399,197357,true,2687341879,28,2685730038,-1611841
1651891441,197358,true,2687073172,28,2685730038,-1343134
1651891510,197358,true,2687073172,28,2685730038,-1343134
1651891525,197358,true,2687073172,28,2685730038,-1343134
1651891606,197358,true,2687073172,28,2685730038,-1343134
1651891684,197358,true,2687073172,28,2685730038,-1343134
1651891713,197359,true,2686804491,28,2685730038,-1074453
1651891748,197359,true,2686804491,28,2685730038,-1074453
1651891875,197359,true,2686804491,28,2685730038,-1074453
1651891979,197359,true,2686804491,28,2685730038,-1074453
1651892004,197359,true,2686804491,28,2685730038,-1074453
1651892105,197359,true,2686804491,28,2685730038,-1074453
1651892133,197359,true,2686804491,28,2685730038,-1074453
1651892234,197360,true,2686535838,28,2685730038,-805800
1651892237,197360,true,2686535838,28,2685730038,-805800
1651892248,197360,true,2686535838,28,2685730038,-805800
1651892260,197360,true,2686535838,28,2685730038,-805800
1651892290,197360,true,2686535838,28,2685730038,-805800
1651892305,197361,true,2686267211,28,2685730038,-537173
1651892329,197361,true,2686267211,28,2685730038,-537173
1651892331,197361,true,2686267211,28,2685730038,-537173
1651892333,197361,true,2686267211,28,2685730038,-537173
1651892344,197361,true,2686267211,28,2685730038,-537173
1651892349,197361,true,2686267211,28,2685730038,-537173
1651892369,197361,true,2686267211,28,2685730038,-537173
1651892371,197362,true,2685998611,28,2685730038,-268573
1651892441,197362,true,2685998611,28,2685730038,-268573
1651892454,197362,true,2685998611,28,2685730038,-268573
1651892547,197362,true,2685998611,28,2685730038,-268573
1651892579,197362,true,2685998611,28,2685730038,-268573
1651892633,197362,true,2685998611,28,2685730038,-268573
1651892713,197362,true,2685998611,28,2685730038,-268573
1651892747,197362,true,2685998611,28,2685730038,-268573
1651892807,197362,true,2685998611,28,2685730038,-268573
1651892837,197362,true,2685998611,28,2685730038,-268573
1651892857,197362,true,2685998611,28,2685730038,-268573
1651892930,197362,true,2685998611,28,2685730038,-268573
1651892962,197363,true,2685730038,28,2685730038,0
1651893011,197363,true,2685730038,28,2685730038,0
1651893092,197363,true,2685730038,28,2685730038,0
1651893099,197363,true,2685730038,28,2685730038,0
1651893134,197363,true,2685730038,28,2685730038,0
1651893169,197363,true,2685730038,28,2685730038,0
1651893253,197363,true,2685730038,28,2685730038,0
1651893297,197363,true,2685730038,28,2685730038,0
1651893316,197363,true,2685730038,28,2685730038,0
1651893339,197363,true,2685730038,28,2685730038,0
1651893430,197363,true,2685730038,28,2685730038,0
1651893521,197363,true,2685730038,28,2685730038,0
1651893542,197363,true,2685730038,28,2685730038,0
1651893572,197363,true,2685730038,28,2685730038,0
1651893620,197363,true,2685730038,28,2685730038,0
1651893647,197363,true,2685730038,28,2685730038,0
1651893706,197363,true,2685730038,28,2685730038,0
1651893806,197363,true,2685730038,28,2685730038,0
1651893923,197363,true,2685730038,28,2685461492,-268546
1651894008,197363,true,2685730038,28,2685461492,-268546
1651894015,197363,true,2685730038,28,2685461492,-268546
1651894031,197363,true,2685730038,28,2685192973,-537065
1651894094,197364,true,2685461492,28,2684656015,-805477
1651894137,197365,true,2685192973,28,2684387576,-805397
1651894168,197365,true,2685192973,28,2684119164,-1073809
1651894198,197365,true,2685192973,28,2683850779,-1342194
1651894228,197366,true,2684924480,28,2683314089,-1610391
1651894264,197367,true,2684656015,28,2683045785,-1610230
1651894321,197367,true,2684656015,28,2682509256,-2146759
1651894383,197368,true,2684387576,28,2681972834,-2414742
1651894426,197368,true,2684387576,28,2681704664,-2682912
1651894432,197370,true,2683850779,28,2681436520,-2414259
1651894494,197370,true,2683850779,28,2680900313,-2950466
1651894524,197370,true,2683850779,28,2680632250,-3218529
1651894552,197371,true,2683582421,28,2680364214,-3218207
1651894622,197372,true,2683314089,28,2679828221,-3485868
1651894630,197372,true,2683314089,28,2679560265,-3753824
1651894635,197372,true,2683314089,28,2679560265,-3753824
1651894737,197373,true,2683045785,28,2678756558,-4289227
1651894771,197374,true,2682777507,28,2678220887,-4556620
1651894835,197374,true,2682777507,28,2677685323,-5092184
1651894865,197374,true,2682777507,28,2677417581,-5359926
1651894934,197375,true,2682509256,28,2676882178,-5627078
1651895021,197376,true,2682241032,28,2676079274,-6161758
1651895031,197376,true,2682241032,28,2675811693,-6429339
1651895092,197377,true,2681972834,28,2675276611,-6696223
1651895100,197377,true,2681972834,28,2675276611,-6696223
1651895160,197379,true,2681436520,28,2674741636,-6694884
1651895216,197379,true,2681436520,28,2674206768,-7229752
1651895223,197379,true,2681436520,28,2674206768,-7229752
1651895298,197380,true,2681168404,28,2673404666,-7763738
1651895351,197381,true,2680900313,28,2673137352,-7762961
1651895389,197381,true,2680900313,28,2672602805,-8297508
1651895401,197381,true,2680900313,28,2672602805,-8297508
1651895429,197382,true,2680632250,28,2672335572,-8296678
1651895468,197383,true,2680364214,28,2672068365,-8295849
1651895476,197383,true,2680364214,28,2671801185,-8563029
1651895508,197383,true,2680364214,28,2671534031,-8830183
1651895564,197384,true,2680096204,28,2671266905,-8829299
1651895569,197385,true,2679828221,28,2670999805,-8828416
1651895613,197385,true,2679828221,28,2670732731,-9095490
1651895671,197386,true,2679560265,28,2670198665,-9361600
1651895679,197386,true,2679560265,28,2670198665,-9361600
1651895692,197388,true,2679024434,28,2669931672,-9092762
1651895776,197388,true,2679024434,28,2669130852,-9893582
1651895878,197388,true,2679024434,28,2668863966,-10160468
1651895901,197389,true,2678756558,28,2668863966,-9892592
1651896107,197390,true,2678488709,28,2668863966,-9624743
1651896234,197390,true,2678488709,28,2668863966,-9624743
1651896297,197390,true,2678488709,28,2668863966,-9624743
1651896333,197391,true,2678220887,28,2668863966,-9356921
1651896404,197392,true,2677953092,28,2668863966,-9089126
1651896425,197392,true,2677953092,28,2669130852,-8822240
1651896461,197392,true,2677953092,28,2669130852,-8822240
1651896554,197393,true,2677685323,28,2669130852,-8554471
1651896649,197394,true,2677417581,28,2669130852,-8286729
1651896696,197394,true,2677417581,28,2669130852,-8286729
1651896763,197395,true,2677149866,28,2669130852,-8019014
1651896839,197395,true,2677149866,28,2669130852,-8019014
1651896853,197397,true,2676614517,28,2669130852,-7483665
1651896917,197397,true,2676614517,28,2669130852,-7483665
1651896932,197397,true,2676614517,28,2669130852,-7483665
1651896942,197398,true,2676346882,28,2669130852,-7216030
1651896951,197399,true,2676079274,28,2669130852,-6948422
1651897000,197399,true,2676079274,28,2669130852,-6948422
1651897023,197399,true,2676079274,28,2669130852,-6948422
1651897049,197400,true,2675811693,28,2669130852,-6680841
1651897069,197401,true,2675544139,28,2669130852,-6413287
1651897144,197401,true,2675544139,28,2669130852,-6413287
1651897235,197401,true,2675544139,28,2669130852,-6413287
1651897280,197402,true,2675276611,28,2668863966,-6412645
1651897318,197403,true,2675009110,28,2668863966,-6145144
1651897354,197403,true,2675009110,28,2668863966,-6145144
1651897405,197404,true,2674741636,28,2668863966,-5877670
1651897649,197405,true,2674474188,28,2668597106,-5877082
1651897781,197406,true,2674206768,28,2668330273,-5876495
1651897811,197406,true,2674206768,28,2668330273,-5876495
1651897830,197406,true,2674206768,28,2668330273,-5876495
1651897994,197407,true,2673939374,28,2668330273,-5609101
1651898046,197408,true,2673672007,28,2668063467,-5608540
1651898165,197408,true,2673672007,28,2668063467,-5608540
1651898293,197409,true,2673404666,28,2667796687,-5607979
1651898303,197410,true,2673137352,28,2667796687,-5340665
1651898357,197411,true,2672870065,28,2667796687,-5073378
1651898386,197411,true,2672870065,28,2667796687,-5073378
1651898427,197411,true,2672870065,28,2667796687,-5073378
1651898481,197412,true,2672602805,28,2667796687,-4806118
1651898490,197413,true,2672335572,28,2667796687,-4538885
1651898517,197413,true,2672335572,28,2667796687,-4538885
1651898605,197414,true,2672068365,28,2667529934,-4538431
1651898611,197415,true,2671801185,28,2667529934,-4271251
1651898680,197416,true,2671534031,28,2667529934,-4004097
1651898705,197416,true,2671534031,28,2667529934,-4004097
1651898736,197416,true,2671534031,28,2667529934,-4004097
1651898759,197417,true,2671266905,28,2667529934,-3736971
1651898857,197418,true,2670999805,28,2667263208,-3736597
1651898886,197418,true,2670999805,28,2667263208,-3736597
1651898942,197419,true,2670732731,28,2667263208,-3469523
1651899002,197420,true,2670465685,28,2667263208,-3202477
1651899027,197421,true,2670198665,28,2667263208,-2935457
1651899046,197421,true,2670198665,28,2667263208,-2935457
1651899052,197421,true,2670198665,28,2667263208,-2935457
1651899124,197422,true,2669931672,28,2667263208,-2668464
1651899215,197423,true,2669664705,28,2667263208,-2401497
1651899302,197423,true,2669664705,28,2667263208,-2401497
1651899323,197423,true,2669664705,28,2667263208,-2401497
1651899327,197424,true,2669397765,28,2667263208,-2134557
1651899354,197426,true,2668863966,28,2667263208,-1600758
1651899388,197426,true,2668863966,28,2667263208,-1600758
1651899523,197426,true,2668863966,28,2667263208,-1600758
1651899596,197427,true,2668597106,28,2666996508,-1600598
1651899620,197428,true,2668330273,28,2666996508,-1333765
1651899634,197428,true,2668330273,28,2666996508,-1333765
1651899933,197429,true,2668063467,28,2666196569,-1866898
1651899977,197429,true,2668063467,28,2665929976,-2133491
1651900187,197429,true,2668063467,28,2665396870,-2666597
1651900212,197429,true,2668063467,28,2665396870,-2666597
1651900252,197430,true,2667796687,28,2665130357,-2666330
1651900296,197430,true,2667796687,28,2665130357,-2666330
1651900304,197430,true,2667796687,28,2665130357,-2666330
1651900354,197430,true,2667796687,28,2664863871,-2932816
1651900450,197431,true,2667529934,28,2664597411,-2932523
1651900501,197431,true,2667529934,28,2664597411,-2932523
1651900515,197431,true,2667529934,28,2664597411,-2932523
1651900556,197431,true,2667529934,28,2664330978,-3198956
1651900590,197431,true,2667529934,28,2664330978,-3198956
1651900671,197432,true,2667263208,28,2664064572,-3198636
1651900682,197432,true,2667263208,28,2664064572,-3198636
1651900889,197432,true,2667263208,28,2663531839,-3731369
1651900922,197432,true,2667263208,28,2663265512,-3997696
1651900993,197432,true,2667263208,28,2663265512,-3997696
1651901004,197433,true,2666996508,28,2663265512,-3730996
1651901064,197433,true,2666996508,28,2662999212,-3997296
1651901091,197433,true,2666996508,28,2662999212,-3997296
1651901118,197433,true,2666996508,28,2662999212,-3997296
1651901145,197433,true,2666996508,28,2662999212,-3997296
1651901158,197433,true,2666996508,28,2662732939,-4263569
1651901193,197434,true,2666729835,28,2662732939,-3996896
1651901216,197434,true,2666729835,28,2662732939,-3996896
1651901275,197434,true,2666729835,28,2662999212,-3730623
1651901333,197434,true,2666729835,28,2662999212,-3730623
1651901360,197434,true,2666729835,28,2662999212,-3730623
1651901387,197434,true,2666729835,28,2662999212,-3730623
1651901388,197434,true,2666729835,28,2662999212,-3730623
1651901580,197434,true,2666729835,28,2663265512,-3464323
1651901627,197434,true,2666729835,28,2663265512,-3464323
1651901662,197434,true,2666729835,28,2663531839,-3197996
1651901708,197435,true,2666463189,28,2663531839,-2931350
1651901725,197434,true,2666729835,28,2663531839,-3197996
1651901742,197435,true,2666463189,28,2663531839,-2931350
1651901750,197435,true,2666463189,28,2663531839,-2931350
1651901799,197435,true,2666463189,28,2663798192,-2664997
1651901853,197435,true,2666463189,28,2663798192,-2664997
1651901895,197435,true,2666463189,28,2663798192,-2664997
1651902021,197435,true,2666463189,28,2664064572,-2398617
1651902037,197435,true,2666463189,28,2664064572,-2398617
1651902057,197435,true,2666463189,28,2664330978,-2132211
1651902090,197436,true,2666196569,28,2664330978,-1865591
1651902123,197436,true,2666196569,28,2664330978,-1865591
1651902151,197436,true,2666196569,28,2664330978,-1865591
1651902236,197436,true,2666196569,28,2664597411,-1599158
1651902264,197436,true,2666196569,28,2664597411,-1599158
1651902348,197436,true,2666196569,28,2664863871,-1332698
1651902469,197436,true,2666196569,28,2665130357,-1066212
1651902485,197436,true,2666196569,28,2665396870,-799699
1651902559,197436,true,2666196569,28,2665396870,-799699
1651902650,197436,true,2666196569,28,2665663410,-533159
1651902725,197436,true,2666196569,28,2665929976,-266593
1651902760,197436,true,2666196569,28,2666196569,0
1651902809,197437,true,2665929976,28,2666196569,266593
1651902831,197436,true,2666196569,28,2666196569,0
1651902854,197437,true,2665929976,28,2666463189,533213
1651902865,197436,true,2666196569,28,2666463189,266620
1651902893,197437,true,2665929976,28,2666463189,533213
1651902934,197437,true,2665929976,28,2666463189,533213
1651902955,197437,true,2665929976,28,2666463189,533213
1651903033,197437,true,2665929976,28,2666463189,533213
1651903072,197437,true,2665929976,28,2666729835,799859
1651903104,197437,true,2665929976,28,2666729835,799859
1651903135,197437,true,2665929976,28,2666729835,799859
1651903186,197437,true,2665929976,28,2666729835,799859
1651903220,197437,true,2665929976,28,2666729835,799859
1651903264,197437,true,2665929976,28,2666729835,799859
1651903289,197437,true,2665929976,28,2666729835,799859
1651903447,197437,true,2665929976,28,2666996508,1066532
1651903452,197437,true,2665929976,28,2666996508,1066532
1651903498,197437,true,2665929976,28,2666996508,1066532
1651903708,197437,true,2665929976,28,2667263208,1333232
1651903778,197437,true,2665929976,28,2667529934,1599958
1651903783,197437,true,2665929976,28,2667529934,1599958
1651903799,197437,true,2665929976,28,2667529934,1599958
1651903869,197437,true,2665929976,28,2667529934,1599958
1651903908,197437,true,2665929976,28,2667529934,1599958
1651904044,197437,true,2665929976,28,2667796687,1866711
1651904101,197437,true,2665929976,28,2667796687,1866711
1651904147,197437,true,2665929976,28,2667796687,1866711
1651904154,197436,true,2666196569,28,2667796687,1600118
1651904219,197437,true,2665929976,28,2667796687,1866711
1651904304,197437,true,2665929976,28,2667796687,1866711
1651904314,197437,true,2665929976,28,2667796687,1866711
1651904344,197436,true,2666196569,28,2667796687,1600118
1651904349,197437,true,2665929976,28,2667796687,1866711
1651904391,197436,true,2666196569,28,2667796687,1600118
1651904421,197436,true,2666196569,28,2667796687,1600118
1651904442,197436,true,2666196569,28,2667796687,1600118
1651904445,197437,true,2665929976,28,2667796687,1866711
1651904467,197436,true,2666196569,28,2667796687,1600118
1651904497,197436,true,2666196569,28,2667796687,1600118
1651904501,197436,true,2666196569,28,2667796687,1600118
1651904568,197437,true,2665929976,28,2667796687,1866711
1651904600,197436,true,2666196569,28,2667796687,1600118
1651904609,197436,true,2666196569,28,2667796687,1600118
1651904626,197436,true,2666196569,28,2667796687,1600118
1651904678,197436,true,2666196569,28,2667796687,1600118
1651904685,197436,true,2666196569,28,2667796687,1600118
1651904862,197436,true,2666196569,28,2667796687,1600118
1651904868,197436,true,2666196569,28,2667796687,1600118
1651904877,197436,true,2666196569,28,2667796687,1600118
1651904913,197436,true,2666196569,28,2667796687,1600118
1651904937,197437,true,2665929976,28,2667529934,1599958
1651904959,197437,true,2665929976,28,2667529934,1599958
1651904995,197437,true,2665929976,28,2667529934,1599958
1651905005,197437,true,2665929976,28,2667529934,1599958
1651905028,197437,true,2665929976,28,2667263208,1333232
1651905038,197437,true,2665929976,28,2667263208,1333232
1651905056,197437,true,2665929976,28,2667263208,1333232
1651905070,197437,true,2665929976,28,2667263208,1333232
1651905095,197437,true,2665929976,28,2667263208,1333232
1651905125,197437,true,2665929976,28,2666996508,1066532
1651905156,197437,true,2665929976,28,2666996508,1066532
1651905286,197437,true,2665929976,28,2666463189,533213
1651905297,197437,true,2665929976,28,2666463189,533213
1651905336,197437,true,2665929976,28,2666463189,533213
1651905355,197437,true,2665929976,28,2666463189,533213
1651905410,197437,true,2665929976,28,2666196569,266593
1651905476,197437,true,2665929976,28,2665929976,0
1651905483,197437,true,2665929976,28,2665929976,0
1651905504,197437,true,2665929976,28,2665929976,0
1651905523,197437,true,2665929976,28,2665663410,-266566
1651905536,197437,true,2665929976,28,2665663410,-266566
1651905547,197437,true,2665929976,28,2665663410,-266566
1651905587,197437,true,2665929976,28,2665663410,-266566
1651905598,197437,true,2665929976,28,2665663410,-266566
1651905601,197437,true,2665929976,28,2665663410,-266566
1651905616,197437,true,2665929976,28,2665396870,-533106
1651905646,197437,true,2665929976,28,2665396870,-533106
1651905655,197437,true,2665929976,28,2665396870,-533106
1651905700,197438,true,2665663410,28,2665130357,-533053
1651905703,197438,true,2665663410,28,2665130357,-533053
1651905706,197438,true,2665663410,28,2665130357,-533053
1651905806,197438,true,2665663410,28,2664863871,-799539
1651905921,197438,true,2665663410,28,2664597411,-1065999
1651905969,197438,true,2665663410,28,2664330978,-1332432
1651906020,197438,true,2665663410,28,2664064572,-1598838
1651906055,197438,true,2665663410,28,2664064572,-1598838
1651906079,197439,true,2665396870,28,2664064572,-1332298
1651906092,197439,true,2665396870,28,2664064572,-1332298
1651906125,197439,true,2665396870,28,2663798192,-1598678
1651906190,197439,true,2665396870,28,2663531839,-1865031
1651906242,197439,true,2665396870,28,2663531839,-1865031
1651906267,197439,true,2665396870,28,2663265512,-2131358
1651906274,197439,true,2665396870,28,2663265512,-2131358
1651906283,197439,true,2665396870,28,2663265512,-2131358
1651906346,197440,true,2665130357,28,2662999212,-2131145
1651906382,197440,true,2665130357,28,2662999212,-2131145
1651906435,197440,true,2665130357,28,2662732939,-2397418
1651906447,197440,true,2665130357,28,2662732939,-2397418
1651906458,197440,true,2665130357,28,2662732939,-2397418
1651906481,197440,true,2665130357,28,2662732939,-2397418
1651906500,197440,true,2665130357,28,2662732939,-2397418
1651906539,197440,true,2665130357,28,2662466692,-2663665
1651906577,197441,true,2664863871,28,2662466692,-2397179
1651906605,197441,true,2664863871,28,2662200472,-2663399
1651906608,197441,true,2664863871,28,2662200472,-2663399
1651906628,197441,true,2664863871,28,2662200472,-2663399
1651906633,197441,true,2664863871,28,2662200472,-2663399
1651906667,197441,true,2664863871,28,2662200472,-2663399
1651906676,197441,true,2664863871,28,2662200472,-2663399
1651906714,197442,true,2664597411,28,2661934279,-2663132
1651906754,197442,true,2664597411,28,2661934279,-2663132
1651906760,197442,true,2664597411,28,2661934279,-2663132
1651906775,197442,true,2664597411,28,2661934279,-2663132
1651906837,197442,true,2664597411,28,2661934279,-2663132
1651906871,197443,true,2664330978,28,2661934279,-2396699
1651906894,197443,true,2664330978,28,2661934279,-2396699
1651906936,197443,true,2664330978,28,2661934279,-2396699
1651906945,197443,true,2664330978,28,2661934279,-2396699
1651906979,197444,true,2664064572,28,2661934279,-2130293
1651906993,197444,true,2664064572,28,2661934279,-2130293
1651907090,197444,true,2664064572,28,2661934279,-2130293
1651907098,197444,true,2664064572,28,2661934279,-2130293
1651907111,197444,true,2664064572,28,2661934279,-2130293
1651907133,197444,true,2664064572,28,2661934279,-2130293
1651907247,197444,true,2664064572,28,2661934279,-2130293
1651907303,197445,true,2663798192,28,2661934279,-1863913
1651907349,197445,true,2663798192,28,2661934279,-1863913
1651907426,197445,true,2663798192,28,2661934279,-1863913
1651907464,197445,true,2663798192,28,2661934279,-1863913
1651907494,197445,true,2663798192,28,2661934279,-1863913
1651907530,197446,true,2663531839,28,2661934279,-1597560
1651907544,197446,true,2663531839,28,2661934279,-1597560
1651907556,197446,true,2663531839,28,2661934279,-1597560
1651907578,197446,true,2663531839,28,2661934279,-1597560
1651907596,197447,true,2663265512,28,2661934279,-1331233
1651907611,197447,true,2663265512,28,2661934279,-1331233
1651907722,197447,true,2663265512,28,2661934279,-1331233
1651907749,197447,true,2663265512,28,2661934279,-1331233
1651907772,197448,true,2662999212,28,2661934279,-1064933
1651907786,197448,true,2662999212,28,2661934279,-1064933
1651907806,197448,true,2662999212,28,2661934279,-1064933
1651907838,197448,true,2662999212,28,2661934279,-1064933
1651907846,197448,true,2662999212,28,2661934279,-1064933
1651907880,197448,true,2662999212,28,2661934279,-1064933
1651907929,197448,true,2662999212,28,2661934279,-1064933
1651907955,197449,true,2662732939,28,2661934279,-798660
1651907989,197449,true,2662732939,28,2661934279,-798660
1651908018,197449,true,2662732939,28,2661934279,-798660
1651908044,197449,true,2662732939,28,2661934279,-798660
1651908097,197449,true,2662732939,28,2661934279,-798660
1651908100,197450,true,2662466692,28,2661934279,-532413
1651908143,197450,true,2662466692,28,2661934279,-532413
1651908151,197450,true,2662466692,28,2661934279,-532413
1651908196,197450,true,2662466692,28,2661934279,-532413
1651908339,197451,true,2662200472,28,2661934279,-266193
1651908405,197451,true,2662200472,28,2661934279,-266193
1651908430,197451,true,2662200472,28,2661934279,-266193
1651908439,197451,true,2662200472,28,2661934279,-266193
1651908442,197451,true,2662200472,28,2661934279,-266193
1651908467,197451,true,2662200472,28,2661934279,-266193
1651908500,197452,true,2661934279,28,2661934279,0
1651908544,197452,true,2661934279,28,2661934279,0
1651908561,197452,true,2661934279,28,2661934279,0
1651908619,197452,true,2661934279,28,2661934279,0
1651908779,197452,true,2661934279,28,2661934279,0
1651908996,197452,true,2661934279,28,2661934279,0
1651909001,197452,true,2661934279,28,2661934279,0
1651909061,197452,true,2661934279,28,2661934279,0
1651909171,197452,true,2661934279,28,2661934279,0
1651909243,197452,true,2661934279,28,2661934279,0
1651909287,197452,true,2661934279,28,2661934279,0
1651909310,197452,true,2661934279,28,2661934279,0
1651909351,197451,true,2662200472,28,2662200472,0
1651909372,197451,true,2662200472,28,2662200472,0
1651909390,197451,true,2662200472,28,2662200472,0
1651909476,197451,true,2662200472,28,2662200472,0
1651909480,197451,true,2662200472,28,2662200472,0
1651909517,197451,true,2662200472,28,2662200472,0
1651909527,197451,true,2662200472,28,2662200472,0
1651909613,197451,true,2662200472,28,2662200472,0
1651909649,197451,true,2662200472,28,2662200472,0
1651909732,197451,true,2662200472,28,2662200472,0
1651909770,197451,true,2662200472,28,2662200472,0
1651909840,197451,true,2662200472,28,2662200472,0
1651909865,197451,true,2662200472,28,2662200472,0
1651909946,197451,true,2662200472,28,2662466692,266220
1651910010,197451,true,2662200472,28,2662466692,266220
1651910011,197451,true,2662200472,28,2662466692,266220
1651910017,197451,true,2662200472,28,2662466692,266220
1651910040,197451,true,2662200472,28,2662466692,266220
1651910062,197451,true,2662200472,28,2662466692,266220
1651910079,197451,true,2662200472,28,2662466692,266220
1651910103,197451,true,2662200472,28,2662466692,266220
1651910114,197450,true,2662466692,28,2662732939,266247
1651910206,197450,true,2662466692,28,2662732939,266247
1651910320,197450,true,2662466692,28,2662999212,532520
1651910357,197450,true,2662466692,28,2662999212,532520
1651910366,197450,true,2662466692,28,2662999212,532520
1651910383,197450,true,2662466692,28,2663265512,798820
1651910415,197450,true,2662466692,28,2663265512,798820
1651910443,197450,true,2662466692,28,2663265512,798820
1651910454,197449,true,2662732939,28,2663265512,532573
1651910469,197449,true,2662732939,28,2663265512,532573
1651910474,197449,true,2662732939,28,2663265512,532573
1651910512,197449,true,2662732939,28,2663531839,798900
1651910520,197449,true,2662732939,28,2663531839,798900
1651910581,197449,true,2662732939,28,2663531839,798900
1651910606,197448,true,2662999212,28,2663798192,798980
1651910670,197448,true,2662999212,28,2663798192,798980
1651910705,197448,true,2662999212,28,2664064572,1065360
1651910734,197448,true,2662999212,28,2664064572,1065360
1651910759,197448,true,2662999212,28,2664064572,1065360
1651910791,197448,true,2662999212,28,2664330978,1331766
1651910813,197447,true,2663265512,28,2664330978,1065466
1651910836,197447,true,2663265512,28,2664330978,1065466
1651910862,197447,true,2663265512,28,2664330978,1065466
1651910969,197447,true,2663265512,28,2664863871,1598359
1651910997,197447,true,2663265512,28,2664863871,1598359
1651911027,197446,true,2663531839,28,2664863871,1332032
1651911044,197446,true,2663531839,28,2664863871,1332032
1651911066,197446,true,2663531839,28,2665130357,1598518
1651911107,197446,true,2663531839,28,2665130357,1598518
1651911130,197446,true,2663531839,28,2665130357,1598518
1651911157,197446,true,2663531839,28,2665396870,1865031
1651911169,197445,true,2663798192,28,2665396870,1598678
1651911192,197445,true,2663798192,28,2665396870,1598678
1651911248,197445,true,2663798192,28,2665663410,1865218
1651911254,197445,true,2663798192,28,2665663410,1865218
1651911304,197445,true,2663798192,28,2665663410,1865218
1651911308,197444,true,2664064572,28,2665663410,1598838
1651911315,197444,true,2664064572,28,2665663410,1598838
1651911356,197444,true,2664064572,28,2665929976,1865404
1651911412,197443,true,2664330978,28,2666463189,2132211
1651911421,197443,true,2664330978,28,2666463189,2132211
1651911482,197442,true,2664597411,28,2666996508,2399097
1651911487,197442,true,2664597411,28,2666996508,2399097
1651911590,197441,true,2664863871,28,2667529934,2666063
1651911641,197441,true,2664863871,28,2668063467,3199596
1651911670,197441,true,2664863871,28,2668063467,3199596
1651911757,197440,true,2665130357,28,2668597106,3466749
1651911791,197440,true,2665130357,28,2668863966,3733609
1651911818,197439,true,2665396870,28,2669130852,3733982
1651911832,197439,true,2665396870,28,2669130852,3733982
1651911938,197438,true,2665663410,28,2669664705,4001295
1651911979,197438,true,2665663410,28,2669931672,4268262
1651911985,197438,true,2665663410,28,2669931672,4268262
1651912002,197437,true,2665929976,28,2669931672,4001696
1651912037,197437,true,2665929976,28,2670198665,4268689
1651912050,197436,true,2666196569,28,2670198665,4002096
1651912051,197436,true,2666196569,28,2670198665,4002096
1651912083,197436,true,2666196569,28,2670465685,4269116
1651912122,197435,true,2666463189,28,2670732731,4269542
1651912151,197434,true,2666729835,28,2670732731,4002896
1651912164,197434,true,2666729835,28,2670732731,4002896
1651912205,197434,true,2666729835,28,2670999805,4269970
1651912286,197433,true,2666996508,28,2671534031,4537523
1651912298,197433,true,2666996508,28,2671534031,4537523
1651912363,197432,true,2667263208,28,2671801185,4537977
1651912417,197432,true,2667263208,28,2672068365,4805157
1651912453,197432,true,2667263208,28,2672068365,4805157
1651912479,197431,true,2667529934,28,2672335572,4805638
1651912511,197431,true,2667529934,28,2672335572,4805638
1651912602,197430,true,2667796687,28,2672870065,5073378
1651912648,197430,true,2667796687,28,2672870065,5073378
1651912710,197429,true,2668063467,28,2673137352,5073885
1651912744,197429,true,2668063467,28,2673404666,5341199
1651912808,197429,true,2668063467,28,2673672007,5608540
1651912851,197428,true,2668330273,28,2673939374,5609101
1651912865,197428,true,2668330273,28,2673939374,5609101
1651912884,197427,true,2668597106,28,2673939374,5342268
1651912949,197427,true,2668597106,28,2674206768,5609662
1651912955,197426,true,2668863966,28,2674206768,5342802
1651912974,197426,true,2668863966,28,2674474188,5610222
1651912996,197426,true,2668863966,28,2674474188,5610222
1651912998,197425,true,2669130852,28,2674474188,5343336
1651913012,197425,true,2669130852,28,2674474188,5343336
1651913050,197424,true,2669397765,28,2674741636,5343871
1651913059,197424,true,2669397765,28,2674741636,5343871
1651913137,197424,true,2669397765,28,2674741636,5343871
1651913141,197423,true,2669664705,28,2674741636,5076931
1651913169,197422,true,2669931672,28,2674741636,4809964
1651913173,197422,true,2669931672,28,2674741636,4809964
1651913186,197422,true,2669931672,28,2674741636,4809964
1651913207,197421,true,2670198665,28,2675009110,4810445
1651913214,197421,true,2670198665,28,2675009110,4810445
1651913217,197420,true,2670465685,28,2675009110,4543425
1651913224,197420,true,2670465685,28,2675009110,4543425
1651913230,197419,true,2670732731,28,2675009110,4276379
1651913249,197418,true,2670999805,28,2675009110,4009305
1651913260,197418,true,2670999805,28,2675009110,4009305
1651913266,197417,true,2671266905,28,2675009110,3742205
1651913276,197417,true,2671266905,28,2675009110,3742205
1651913292,197416,true,2671534031,28,2675276611,3742580
1651913398,197415,true,2671801185,28,2675544139,3742954
1651913418,197415,true,2671801185,28,2675811693,4010508
1651913438,197414,true,2672068365,28,2675811693,3743328
1651913534,197413,true,2672335572,28,2676346882,4011310
1651913615,197413,true,2672335572,28,2676614517,4278945
1651913632,197412,true,2672602805,28,2676614517,4011712
1651913682,197411,true,2672870065,28,2676882178,4012113
1651913691,197410,true,2673137352,28,2676882178,3744826
1651913723,197410,true,2673137352,28,2677149866,4012514
1651913734,197410,true,2673137352,28,2677149866,4012514
1651913798,197409,true,2673404666,28,2677417581,4012915
1651913822,197408,true,2673672007,28,2677417581,3745574
1651913843,197408,true,2673672007,28,2677685323,4013316
1651913863,197407,true,2673939374,28,2677685323,3745949
1651913884,197407,true,2673939374,28,2677685323,3745949
1651913934,197406,true,2674206768,28,2677953092,3746324
1651913943,197406,true,2674206768,28,2677953092,3746324
1651913952,197405,true,2674474188,28,2677953092,3478904
1651914001,197405,true,2674474188,28,2678220887,3746699
1651914004,197404,true,2674741636,28,2678220887,3479251
1651914020,197403,true,2675009110,28,2678220887,3211777
1651914117,197403,true,2675009110,28,2678756558,3747448
1651914128,197402,true,2675276611,28,2678756558,3479947
1651914182,197401,true,2675544139,28,2679024434,3480295
1651914193,197401,true,2675544139,28,2679024434,3480295
1651914229,197401,true,2675544139,28,2679292336,3748197
1651914241,197400,true,2675811693,28,2679292336,3480643
1651914263,197399,true,2676079274,28,2679292336,3213062
1651914268,197399,true,2676079274,28,2679292336,3213062
1651914272,197399,true,2676079274,28,2679292336,3213062
1651914300,197398,true,2676346882,28,2679560265,3213383
1651914322,197397,true,2676614517,28,2679560265,2945748
1651914342,197397,true,2676614517,28,2679828221,3213704
1651914375,197397,true,2676614517,28,2679828221,3213704
1651914381,197396,true,2676882178,28,2679828221,2946043
1651914406,197395,true,2677149866,28,2680096204,2946338
1651914441,197395,true,2677149866,28,2680096204,2946338
1651914447,197395,true,2677149866,28,2680096204,2946338
1651914469,197394,true,2677417581,28,2680364214,2946633
1651914483,197393,true,2677685323,28,2680364214,2678891
1651914490,197393,true,2677685323,28,2680364214,2678891
1651914525,197393,true,2677685323,28,2680632250,2946927
1651914540,197392,true,2677953092,28,2680632250,2679158
1651914554,197391,true,2678220887,28,2680632250,2411363
1651914595,197391,true,2678220887,28,2680900313,2679426
1651914655,197391,true,2678220887,28,2681168404,2947517
1651914662,197390,true,2678488709,28,2681168404,2679695
1651914682,197389,true,2678756558,28,2681168404,2411846
1651914687,197389,true,2678756558,28,2681168404,2411846
1651914762,197389,true,2678756558,28,2681436520,2679962
1651914784,197389,true,2678756558,28,2681704664,2948106
1651914798,197388,true,2679024434,28,2681704664,2680230
1651914817,197388,true,2679024434,28,2681704664,2680230
1651914823,197388,true,2679024434,28,2681704664,2680230
1651914838,197388,true,2679024434,28,2681972834,2948400
1651914872,197387,true,2679292336,28,2681972834,2680498
1651914891,197387,true,2679292336,28,2681972834,2680498
1651914982,197387,true,2679292336,28,2682509256,3216920
1651915007,197386,true,2679560265,28,2682509256,2948991
1651915012,197386,true,2679560265,28,2682509256,2948991
1651915016,197386,true,2679560265,28,2682509256,2948991
1651915036,197386,true,2679560265,28,2682777507,3217242
1651915055,197385,true,2679828221,28,2682777507,2949286
1651915058,197385,true,2679828221,28,2682777507,2949286
1651915066,197385,true,2679828221,28,2682777507,2949286
1651915081,197384,true,2680096204,28,2682777507,2681303
1651915108,197384,true,2680096204,28,2682777507,2681303
1651915130,197384,true,2680096204,28,2682777507,2681303
1651915147,197383,true,2680364214,28,2682777507,2413293
1651915169,197383,true,2680364214,28,2682777507,2413293
1651915201,197383,true,2680364214,28,2682777507,2413293
1651915259,197382,true,2680632250,28,2682777507,2145257
1651915285,197382,true,2680632250,28,2683045785,2413535
1651915318,197382,true,2680632250,28,2683045785,2413535
1651915330,197381,true,2680900313,28,2683045785,2145472
1651915379,197381,true,2680900313,28,2683045785,2145472
1651915382,197381,true,2680900313,28,2683045785,2145472
1651915422,197380,true,2681168404,28,2683045785,1877381
1651915455,197380,true,2681168404,28,2683045785,1877381
1651915463,197380,true,2681168404,28,2683045785,1877381
1651915473,197379,true,2681436520,28,2683045785,1609265
1651915500,197379,true,2681436520,28,2683045785,1609265
1651915502,197379,true,2681436520,28,2683045785,1609265
1651915516,197378,true,2681704664,28,2683314089,1609425
1651915517,197378,true,2681704664,28,2683314089,1609425
1651915519,197378,true,2681704664,28,2683314089,1609425
1651915571,197378,true,2681704664,28,2683314089,1609425
1651915607,197377,true,2681972834,28,2683314089,1341255
1651915624,197377,true,2681972834,28,2683314089,1341255
1651915654,197377,true,2681972834,28,2683314089,1341255
1651915667,197376,true,2682241032,28,2683314089,1073057
1651915697,197376,true,2682241032,28,2683314089,1073057
1651915700,197376,true,2682241032,28,2683314089,1073057
1651915720,197375,true,2682509256,28,2683314089,804833
1651915738,197375,true,2682509256,28,2683314089,804833
1651915769,197375,true,2682509256,28,2683582421,1073165
1651915784,197374,true,2682777507,28,2683582421,804914
1651915825,197374,true,2682777507,28,2683582421,804914
1651915886,197374,true,2682777507,28,2683582421,804914
1651915921,197373,true,2683045785,28,2683582421,536636
1651915949,197373,true,2683045785,28,2683582421,536636
1651916067,197373,true,2683045785,28,2683850779,804994
1651916105,197372,true,2683314089,28,2683850779,536690
1651916124,197372,true,2683314089,28,2683850779,536690
1651916131,197372,true,2683314089,28,2683850779,536690
1651916151,197372,true,2683314089,28,2683850779,536690
1651916189,197372,true,2683314089,28,2683850779,536690
1651916214,197372,true,2683314089,28,2683850779,536690
1651916226,197372,true,2683314089,28,2683850779,536690
1651916251,197371,true,2683582421,28,2683850779,268358
1651916281,197371,true,2683582421,28,2684119164,536743
1651916286,197371,true,2683582421,28,2684119164,536743
1651916341,197371,true,2683582421,28,2684119164,536743
1651916350,197371,true,2683582421,28,2684119164,536743
1651916360,197371,true,2683582421,28,2684119164,536743
1651916376,197371,true,2683582421,28,2684119164,536743
1651916427,197371,true,2683582421,28,2684119164,536743
1651916460,197371,true,2683582421,28,2684119164,536743
1651916476,197371,true,2683582421,28,2684119164,536743
1651916523,197371,true,2683582421,28,2684119164,536743
1651916589,197371,true,2683582421,28,2684387576,805155
1651916614,197371,true,2683582421,28,2684387576,805155
1651916669,197371,true,2683582421,28,2684387576,805155
1651916692,197371,true,2683582421,28,2684387576,805155
1651916740,197371,true,2683582421,28,2684387576,805155
1651916806,197370,true,2683850779,28,2684656015,805236
1651916866,197370,true,2683850779,28,2684656015,805236
1651916948,197370,true,2683850779,28,2684656015,805236
1651916980,197370,true,2683850779,28,2684656015,805236
1651916984,197370,true,2683850779,28,2684656015,805236
1651916994,197370,true,2683850779,28,2684656015,805236
1651917038,197370,true,2683850779,28,2684656015,805236
1651917132,197370,true,2683850779,28,2684387576,536797
1651917180,197370,true,2683850779,28,2684387576,536797
1651917204,197370,true,2683850779,28,2684387576,536797
1651917241,197370,true,2683850779,28,2684387576,536797
1651917249,197370,true,2683850779,28,2684387576,536797
1651917312,197370,true,2683850779,28,2684387576,536797
1651917325,197370,true,2683850779,28,2684387576,536797
1651917339,197370,true,2683850779,28,2684387576,536797
1651917354,197370,true,2683850779,28,2684387576,536797
1651917365,197369,true,2684119164,28,2684387576,268412
1651917454,197369,true,2684119164,28,2684387576,268412
1651917538,197369,true,2684119164,28,2684387576,268412
1651917567,197369,true,2684119164,28,2684387576,268412
1651917608,197369,true,2684119164,28,2684387576,268412
1651917698,197369,true,2684119164,28,2684387576,268412
1651917709,197369,true,2684119164,28,2684387576,268412
1651917712,197369,true,2684119164,28,2684387576,268412
1651917749,197369,true,2684119164,28,2684387576,268412
1651917795,197369,true,2684119164,28,2684387576,268412
1651917830,197369,true,2684119164,28,2684387576,268412
1651917844,197369,true,2684119164,28,2684387576,268412
1651917849,197369,true,2684119164,28,2684387576,268412
1651917852,197369,true,2684119164,28,2684387576,268412
1651917858,197369,true,2684119164,28,2684387576,268412
1651917885,197369,true,2684119164,28,2684387576,268412
1651917908,197368,true,2684387576,28,2684387576,0
1651917942,197368,true,2684387576,28,2684387576,0
1651917964,197368,true,2684387576,28,2684387576,0
1651917984,197368,true,2684387576,28,2684387576,0
1651917997,197368,true,2684387576,28,2684387576,0
1651918022,197368,true,2684387576,28,2684387576,0
1651918052,197368,true,2684387576,28,2684387576,0
1651918086,197368,true,2684387576,28,2684387576,0
1651918098,197368,true,2684387576,28,2684387576,0
1651918195,197368,true,2684387576,28,2684387576,0
1651918199,197368,true,2684387576,28,2684387576,0
1651918239,197368,true,2684387576,28,2684387576,0
1651918273,197368,true,2684387576,28,2684387576,0
1651918329,197368,true,2684387576,28,2684387576,0
1651918337,197368,true,2684387576,28,2684387576,0
1651918387,197368,true,2684387576,28,2684387576,0
1651918404,197368,true,2684387576,28,2684387576,0
1651918423,197367,true,2684656015,28,2684387576,-268439
1651918478,197367,true,2684656015,28,2684387576,-268439
1651918490,197367,true,2684656015,28,2684387576,-268439
1651918515,197367,true,2684656015,28,2684387576,-268439
1651918529,197367,true,2684656015,28,2684387576,-268439
1651918538,197367,true,2684656015,28,2684387576,-268439
1651918544,197367,true,2684656015,28,2684387576,-268439
1651918572,197367,true,2684656015,28,2684387576,-268439
1651918588,197367,true,2684656015,28,2684387576,-268439
1651918647,197367,true,2684656015,28,2684387576,-268439
1651918700,197367,true,2684656015,28,2684656015,0
1651918708,197367,true,2684656015,28,2684656015,0
1651918724,197367,true,2684656015,28,2684656015,0
1651918799,197367,true,2684656015,28,2684656015,0
1651918873,197367,true,2684656015,28,2684924480,268465
1651918881,197367,true,2684656015,28,2684924480,268465
1651918909,197367,true,2684656015,28,2684924480,268465
1651918915,197367,true,2684656015,28,2684924480,268465
1651918934,197367,true,2684656015,28,2684924480,268465
1651918951,197367,true,2684656015,28,2684924480,268465
1651918962,197367,true,2684656015,28,2684924480,268465
1651918970,197366,true,2684924480,28,2684924480,0
1651919022,197366,true,2684924480,28,2685192973,268493
1651919060,197366,true,2684924480,28,2685192973,268493
1651919089,197366,true,2684924480,28,2685192973,268493
1651919128,197366,true,2684924480,28,2685192973,268493
1651919132,197366,true,2684924480,28,2685192973,268493
1651919188,197366,true,2684924480,28,2685461492,537012
1651919205,197366,true,2684924480,28,2685461492,537012
1651919233,197366,true,2684924480,28,2685461492,537012
1651919238,197366,true,2684924480,28,2685461492,537012
1651919252,197366,true,2684924480,28,2685461492,537012
1651919264,197366,true,2684924480,28,2685461492,537012
1651919305,197365,true,2685192973,28,2685461492,268519
1651919465,197365,true,2685192973,28,2685730038,537065
1651919506,197365,true,2685192973,28,2685730038,537065
1651919535,197365,true,2685192973,28,2685730038,537065
1651919542,197365,true,2685192973,28,2685730038,537065
1651919575,197365,true,2685192973,28,2685998611,805638
1651919603,197365,true,2685192973,28,2685998611,805638
1651919630,197365,true,2685192973,28,2685998611,805638
1651919651,197365,true,2685192973,28,2685998611,805638
1651919762,197365,true,2685192973,28,2686267211,1074238
1651919785,197364,true,2685461492,28,2686267211,805719
1651919827,197364,true,2685461492,28,2686267211,805719
1651919871,197364,true,2685461492,28,2686267211,805719
1651919934,197364,true,2685461492,28,2686535838,1074346
1651919983,197364,true,2685461492,28,2686535838,1074346
1651920046,197364,true,2685461492,28,2686535838,1074346
1651920062,197364,true,2685461492,28,2686535838,1074346
1651920153,197364,true,2685461492,28,2686804491,1342999
1651920244,197364,true,2685461492,28,2686804491,1342999
1651920292,197364,true,2685461492,28,2687073172,1611680
1651920301,197364,true,2685461492,28,2687073172,1611680
1651920334,197363,true,2685730038,28,2687073172,1343134
1651920345,197363,true,2685730038,28,2687073172,1343134
1651920367,197363,true,2685730038,28,2687073172,1343134
1651920386,197363,true,2685730038,28,2687073172,1343134
1651920425,197363,true,2685730038,28,2687073172,1343134
1651920461,197363,true,2685730038,28,2687073172,1343134
1651920464,197363,true,2685730038,28,2687073172,1343134
1651920480,197363,true,2685730038,28,2687073172,1343134
1651920497,197363,true,2685730038,28,2687073172,1343134
1651920556,197363,true,2685730038,28,2687073172,1343134
1651920603,197363,true,2685730038,28,2687073172,1343134
1651920613,197363,true,2685730038,28,2687073172,1343134
1651920647,197362,true,2685998611,28,2687073172,1074561
1651920657,197362,true,2685998611,28,2687073172,1074561
1651920672,197362,true,2685998611,28,2687073172,1074561
1651920702,197362,true,2685998611,28,2687073172,1074561
1651920726,197362,true,2685998611,28,2687073172,1074561
1651920748,197362,true,2685998611,28,2687073172,1074561
1651920787,197362,true,2685998611,28,2687073172,1074561
1651920804,197362,true,2685998611,28,2687073172,1074561
1651920810,197362,true,2685998611,28,2687073172,1074561
1651920855,197362,true,2685998611,28,2687073172,1074561
1651920897,197362,true,2685998611,28,2687073172,1074561
1651920940,197361,true,2686267211,28,2687073172,805961
1651921048,197361,true,2686267211,28,2687073172,805961
1651921061,197361,true,2686267211,28,2687073172,805961
1651921117,197361,true,2686267211,28,2687073172,805961
1651921121,197361,true,2686267211,28,2687073172,805961
1651921217,197361,true,2686267211,28,2687073172,805961
1651921309,197361,true,2686267211,28,2687073172,805961
1651921357,197361,true,2686267211,28,2687073172,805961
1651921397,197361,true,2686267211,28,2687073172,805961
1651921426,197361,true,2686267211,28,2687073172,805961
1651921521,197361,true,2686267211,28,2687073172,805961
1651921578,197361,true,2686267211,28,2687073172,805961
1651921599,197360,true,2686535838,28,2687073172,537334
1651921667,197360,true,2686535838,28,2687073172,537334
1651921739,197360,true,2686535838,28,2687073172,537334
1651921763,197360,true,2686535838,28,2687073172,537334
1651921792,197360,true,2686535838,28,2687073172,537334
1651921797,197360,true,2686535838,28,2687073172,537334
1651921831,197360,true,2686535838,28,2687073172,537334
1651921848,197360,true,2686535838,28,2687073172,537334
1651921868,197360,true,2686535838,28,2687073172,537334
1651921882,197360,true,2686535838,28,2687073172,537334
1651921900,197359,true,2686804491,28,2687073172,268681
1651921909,197359,true,2686804491,28,2687073172,268681
1651921924,197359,true,2686804491,28,2687073172,268681
1651921934,197359,true,2686804491,28,2687073172,268681
1651921937,197359,true,2686804491,28,2687073172,268681
1651921949,197359,true,2686804491,28,2687073172,268681
1651921955,197359,true,2686804491,28,2687073172,268681
1651921957,197359,true,2686804491,28,2687073172,268681
1651921959,197359,true,2686804491,28,2687073172,268681
1651922000,197359,true,2686804491,28,2687073172,268681
1651922006,197359,true,2686804491,28,2687073172,268681
1651922029,197358,true,2687073172,28,2687073172,0
1651922066,197358,true,2687073172,28,2687073172,0
1651922073,197358,true,2687073172,28,2687073172,0
1651922090,197358,true,2687073172,28,2687073172,0
1651922194,197358,true,2687073172,28,2687073172,0
1651922241,197358,true,2687073172,28,2687073172,0
1651922261,197358,true,2687073172,28,2687073172,0
1651922293,197358,true,2687073172,28,2687073172,0
1651922296,197358,true,2687073172,28,2687073172,0
1651922342,197358,true,2687073172,28,2687341879,268707
1651922438,197358,true,2687073172,28,2687341879,268707
1651922442,197357,true,2687341879,28,2687341879,0
1651922453,197357,true,2687341879,28,2687341879,0
1651922474,197357,true,2687341879,28,2687341879,0
1651922573,197357,true,2687341879,28,2687341879,0
1651922617,197357,true,2687341879,28,2687610613,268734
1651922753,197357,true,2687341879,28,2687610613,268734
1651922788,197357,true,2687341879,28,2687610613,268734
1651922792,197357,true,2687341879,28,2687610613,268734
1651922827,197357,true,2687341879,28,2687879374,537495
1651922872,197357,true,2687341879,28,2687879374,537495
1651922896,197357,true,2687341879,28,2687879374,537495
1651922945,197356,true,2687610613,28,2687879374,268761
1651922947,197356,true,2687610613,28,2687879374,268761
1651922954,197356,true,2687610613,28,2687879374,268761
1651922962,197356,true,2687610613,28,2687879374,268761
1651922984,197356,true,2687610613,28,2687879374,268761
1651923021,197356,true,2687610613,28,2688148162,537549
1651923024,197356,true,2687610613,28,2688148162,537549
1651923032,197356,true,2687610613,28,2688148162,537549
1651923080,197356,true,2687610613,28,2688148162,537549
1651923088,197356,true,2687610613,28,2688148162,537549
1651923112,197356,true,2687610613,28,2688148162,537549
1651923117,197356,true,2687610613,28,2688148162,537549
1651923136,197356,true,2687610613,28,2688148162,537549
1651923172,197356,true,2687610613,28,2688148162,537549
1651923220,197355,true,2687879374,28,2688416977,537603
1651923226,197355,true,2687879374,28,2688416977,537603
1651923236,197355,true,2687879374,28,2688416977,537603
1651923283,197355,true,2687879374,28,2688416977,537603
1651923294,197355,true,2687879374,28,2688416977,537603
1651923303,197355,true,2687879374,28,2688416977,537603
1651923323,197355,true,2687879374,28,2688416977,537603
1651923328,197355,true,2687879374,28,2688416977,537603
1651923368,197355,true,2687879374,28,2688416977,537603
1651923402,197355,true,2687879374,28,2688416977,537603
1651923458,197355,true,2687879374,28,2688685819,806445
1651923537,197355,true,2687879374,28,2688685819,806445
1651923545,197354,true,2688148162,28,2688685819,537657
1651923563,197354,true,2688148162,28,2688685819,537657
1651923616,197354,true,2688148162,28,2688685819,537657
1651923635,197354,true,2688148162,28,2688954687,806525
1651923660,197354,true,2688148162,28,2688954687,806525
1651923683,197354,true,2688148162,28,2688954687,806525
1651923744,197354,true,2688148162,28,2688954687,806525
1651923781,197354,true,2688148162,28,2688954687,806525
1651923889,197354,true,2688148162,28,2689223583,1075421
1651923903,197354,true,2688148162,28,2689223583,1075421
1651923936,197354,true,2688148162,28,2689223583,1075421
1651923975,197354,true,2688148162,28,2689223583,1075421
1651923983,197354,true,2688148162,28,2689223583,1075421
1651923998,197353,true,2688416977,28,2689223583,806606
1651924036,197353,true,2688416977,28,2689492505,1075528
1651924050,197353,true,2688416977,28,2689492505,1075528
1651924071,197353,true,2688416977,28,2689492505,1075528
1651924099,197353,true,2688416977,28,2689492505,1075528
1651924138,197353,true,2688416977,28,2689492505,1075528
1651924177,197353,true,2688416977,28,2689492505,1075528
1651924219,197353,true,2688416977,28,2689492505,1075528
1651924276,197353,true,2688416977,28,2689492505,1075528
1651924347,197353,true,2688416977,28,2689492505,1075528
1651924394,197353,true,2688416977,28,2689492505,1075528
1651924401,197353,true,2688416977,28,2689492505,1075528
1651924415,197352,true,2688685819,28,2689492505,806686
1651924442,197352,true,2688685819,28,2689492505,806686
1651924494,197352,true,2688685819,28,2689492505,806686
1651924513,197352,true,2688685819,28,2689492505,806686
1651924521,197352,true,2688685819,28,2689492505,806686
1651924530,197352,true,2688685819,28,2689492505,806686
1651924533,197352,true,2688685819,28,2689492505,806686
1651924568,197352,true,2688685819,28,2689492505,806686
1651924585,197352,true,2688685819,28,2689492505,806686
1651924655,197352,true,2688685819,28,2689492505,806686
1651924663,197352,true,2688685819,28,2689492505,806686
1651924686,197352,true,2688685819,28,2689492505,806686
1651924713,197351,true,2688954687,28,2689492505,537818
1651924714,197351,true,2688954687,28,2689492505,537818
1651924769,197351,true,2688954687,28,2689492505,537818
1651924871,197351,true,2688954687,28,2689492505,537818
1651924891,197351,true,2688954687,28,2689492505,537818
1651924902,197351,true,2688954687,28,2689492505,537818
1651924904,197351,true,2688954687,28,2689492505,537818
1651924907,197351,true,2688954687,28,2689492505,537818
1651924919,197351,true,2688954687,28,2689492505,537818
1651924948,197351,true,2688954687,28,2689492505,537818
1651924978,197351,true,2688954687,28,2689492505,537818
1651925004,197351,true,2688954687,28,2689492505,537818
1651925034,197351,true,2688954687,28,2689492505,537818
1651925039,197350,true,2689223583,28,2689492505,268922
1651925051,197350,true,2689223583,28,2689492505,268922
1651925059,197350,true,2689223583,28,2689492505,268922
1651925068,197350,true,2689223583,28,2689492505,268922
1651925099,197350,true,2689223583,28,2689492505,268922
1651925116,197350,true,2689223583,28,2689492505,268922
1651925135,197350,true,2689223583,28,2689492505,268922
1651925158,197350,true,2689223583,28,2689492505,268922
1651925172,197350,true,2689223583,28,2689492505,268922
1651925225,197350,true,2689223583,28,2689492505,268922
1651925235,197350,true,2689223583,28,2689492505,268922
1651925256,197350,true,2689223583,28,2689761454,537871
1651925309,197349,true,2689492505,28,2689761454,268949
1651925371,197349,true,2689492505,28,2689761454,268949
1651925392,197349,true,2689492505,28,2689761454,268949
1651925400,197349,true,2689492505,28,2689761454,268949
1651925434,197349,true,2689492505,28,2689761454,268949
1651925459,197349,true,2689492505,28,2689761454,268949
1651925506,197349,true,2689492505,28,2689761454,268949
1651925539,197349,true,2689492505,28,2689761454,268949
1651925550,197348,true,2689761454,28,2689761454,0
1651925616,197348,true,2689761454,28,2689761454,0
1651925635,197348,true,2689761454,28,2689761454,0
1651925658,197348,true,2689761454,28,2689761454,0
1651925721,197348,true,2689761454,28,2689761454,0
1651925820,197348,true,2689761454,28,2689761454,0
1651925849,197348,true,2689761454,28,2690030430,268976
1651925915,197348,true,2689761454,28,2690030430,268976
1651925942,197348,true,2689761454,28,2690030430,268976
1651926055,197348,true,2689761454,28,2690030430,268976
1651926076,197348,true,2689761454,28,2690030430,268976
1651926234,197348,true,2689761454,28,2690030430,268976
1651926316,197348,true,2689761454,28,2690030430,268976
1651926340,197348,true,2689761454,28,2690030430,268976
1651926359,197348,true,2689761454,28,2690030430,268976
1651926379,197348,true,2689761454,28,2690030430,268976
1651926382,197348,true,2689761454,28,2690030430,268976
1651926386,197348,true,2689761454,28,2690030430,268976
1651926392,197348,true,2689761454,28,2690030430,268976
1651926410,197348,true,2689761454,28,2690030430,268976
1651926448,197348,true,2689761454,28,2690299433,537979
1651926459,197348,true,2689761454,28,2690299433,537979
1651926486,197348,true,2689761454,28,2690299433,537979
1651926498,197348,true,2689761454,28,2690299433,537979
1651926515,197348,true,2689761454,28,2690299433,537979
1651926532,197348,true,2689761454,28,2690299433,537979
1651926549,197348,true,2689761454,28,2690299433,537979
1651926569,197348,true,2689761454,28,2690299433,537979
1651926595,197347,true,2690030430,28,2690299433,269003
1651926616,197347,true,2690030430,28,2690299433,269003
1651926629,197347,true,2690030430,28,2690299433,269003
1651926659,197347,true,2690030430,28,2690299433,269003
1651926674,197347,true,2690030430,28,2690299433,269003
1651926803,197347,true,2690030430,28,2690299433,269003
1651926809,197347,true,2690030430,28,2690299433,269003
1651926813,197347,true,2690030430,28,2690299433,269003
1651926823,197347,true,2690030430,28,2690299433,269003
1651926840,197347,true,2690030430,28,2690299433,269003
1651926860,197347,true,2690030430,28,2690299433,269003
1651926885,197347,true,2690030430,28,2690299433,269003
1651926889,197347,true,2690030430,28,2690299433,269003
1651926896,197347,true,2690030430,28,2690299433,269003
1651926919,197347,true,2690030430,28,2690299433,269003
1651926955,197347,true,2690030430,28,2690299433,269003
1651927066,197347,true,2690030430,28,2690299433,269003
1651927079,197347,true,2690030430,28,2690299433,269003
1651927097,197347,true,2690030430,28,2690299433,269003
1651927119,197347,true,2690030430,28,2690299433,269003
1651927171,197347,true,2690030430,28,2690299433,269003
1651927213,197347,true,2690030430,28,2690299433,269003
1651927263,197347,true,2690030430,28,2690299433,269003
1651927339,197347,true,2690030430,28,2690299433,269003
1651927357,197347,true,2690030430,28,2690299433,269003
1651927409,197347,true,2690030430,28,2690299433,269003
1651927438,197347,true,2690030430,28,2690299433,269003
1651927451,197347,true,2690030430,28,2690299433,269003
1651927456,197347,true,2690030430,28,2690299433,269003
1651927473,197347,true,2690030430,28,2690299433,269003
1651927474,197347,true,2690030430,28,2690299433,269003
1651927490,197347,true,2690030430,28,2690299433,269003
1651927503,197347,true,2690030430,28,2690299433,269003
1651927618,197347,true,2690030430,28,2690299433,269003
1651927631,197347,true,2690030430,28,2690299433,269003
1651927719,197347,true,2690030430,28,2690030430,0
1651927794,197347,true,2690030430,28,2690030430,0
1651927800,197347,true,2690030430,28,2690030430,0
1651927808,197347,true,2690030430,28,2690030430,0
1651927835,197347,true,2690030430,28,2690030430,0
1651927849,197347,true,2690030430,28,2690030430,0
1651927867,197347,true,2690030430,28,2690030430,0
1651927891,197347,true,2690030430,28,2690030430,0
1651927905,197347,true,2690030430,28,2690030430,0
1651927906,197347,true,2690030430,28,2690030430,0
1651927931,197347,true,2690030430,28,2690030430,0
1651927944,197347,true,2690030430,28,2690030430,0
1651927966,197347,true,2690030430,28,2690030430,0
1651928054,197347,true,2690030430,28,2689761454,-268976
1651928154,197347,true,2690030430,28,2689761454,-268976
1651928194,197348,true,2689761454,28,2689761454,0
1651928211,197348,true,2689761454,28,2689761454,0
1651928235,197348,true,2689761454,28,2689492505,-268949
1651928301,197348,true,2689761454,28,2689492505,-268949
1651928317,197348,true,2689761454,28,2689492505,-268949
1651928416,197348,true,2689761454,28,2689492505,-268949
1651928456,197348,true,2689761454,28,2689492505,-268949
1651928522,197348,true,2689761454,28,2689223583,-537871
1651928693,197348,true,2689761454,28,2689223583,-537871
1651928743,197348,true,2689761454,28,2688954687,-806767
1651928767,197348,true,2689761454,28,2688954687,-806767
1651928805,197348,true,2689761454,28,2688954687,-806767
1651928848,197348,true,2689761454,28,2688954687,-806767
1651928888,197348,true,2689761454,28,2688954687,-806767
1651928926,197348,true,2689761454,28,2688954687,-806767
1651929020,197348,true,2689761454,28,2688685819,-1075635
1651929090,197348,true,2689761454,28,2688685819,-1075635
1651929098,197348,true,2689761454,28,2688685819,-1075635
1651929200,197348,true,2689761454,28,2688685819,-1075635
1651929274,197348,true,2689761454,28,2688416977,-1344477
1651929284,197348,true,2689761454,28,2688416977,-1344477
1651929309,197348,true,2689761454,28,2688416977,-1344477
1651929320,197348,true,2689761454,28,2688416977,-1344477
1651929353,197349,true,2689492505,28,2688416977,-1075528
1651929360,197349,true,2689492505,28,2688416977,-1075528
1651929494,197349,true,2689492505,28,2687879374,-1613131
1651929547,197350,true,2689223583,28,2687610613,-1612970
1651929601,197350,true,2689223583,28,2687341879,-1881704
1651929628,197350,true,2689223583,28,2687341879,-1881704
1651929655,197351,true,2688954687,28,2687073172,-1881515
1651929761,197351,true,2688954687,28,2686804491,-2150196
1651929789,197351,true,2688954687,28,2686535838,-2418849
1651929813,197351,true,2688954687,28,2686535838,-2418849
1651929823,197352,true,2688685819,28,2686535838,-2149981
1651929845,197352,true,2688685819,28,2686535838,-2149981
1651929941,197352,true,2688685819,28,2685998611,-2687208
1651929955,197353,true,2688416977,28,2685998611,-2418366
1651929986,197353,true,2688416977,28,2685730038,-2686939
1651930056,197353,true,2688416977,28,2685461492,-2955485
1651930082,197354,true,2688148162,28,2685461492,-2686670
1651930107,197354,true,2688148162,28,2685461492,-2686670
1651930140,197354,true,2688148162,28,2685192973,-2955189
1651930152,197354,true,2688148162,28,2685192973,-2955189
1651930194,197355,true,2687879374,28,2684924480,-2954894
1651930245,197355,true,2687879374,28,2684924480,-2954894
1651930348,197356,true,2687610613,28,2684387576,-3223037
1651930386,197356,true,2687610613,28,2684119164,-3491449
1651930406,197356,true,2687610613,28,2683850779,-3759834
1651930438,197356,true,2687610613,28,2683850779,-3759834
1651930587,197357,true,2687341879,28,2683045785,-4296094
1651930597,197357,true,2687341879,28,2683045785,-4296094
1651930714,197358,true,2687073172,28,2682241032,-4832140
1651930755,197358,true,2687073172,28,2682241032,-4832140
1651930803,197359,true,2686804491,28,2681972834,-4831657
1651930809,197359,true,2686804491,28,2681972834,-4831657
1651930846,197359,true,2686804491,28,2681704664,-5099827
1651930850,197359,true,2686804491,28,2681704664,-5099827
1651931020,197360,true,2686535838,28,2680900313,-5635525
1651931036,197360,true,2686535838,28,2680632250,-5903588
1651931045,197361,true,2686267211,28,2680632250,-5634961
1651931047,197361,true,2686267211,28,2680632250,-5634961
1651931062,197362,true,2685998611,28,2680632250,-5366361
1651931123,197362,true,2685998611,28,2680364214,-5634397
1651931161,197362,true,2685998611,28,2680096204,-5902407
1651931182,197362,true,2685998611,28,2680096204,-5902407
1651931204,197363,true,2685730038,28,2680096204,-5633834
1651931286,197363,true,2685730038,28,2680096204,-5633834
1651931306,197364,true,2685461492,28,2680096204,-5365288
1651931332,197364,true,2685461492,28,2680096204,-5365288
1651931358,197365,true,2685192973,28,2680096204,-5096769
1651931363,197365,true,2685192973,28,2680096204,-5096769
1651931377,197365,true,2685192973,28,2679828221,-5364752
1651931501,197365,true,2685192973,28,2679828221,-5364752
1651931566,197366,true,2684924480,28,2679828221,-5096259
1651931577,197366,true,2684924480,28,2679828221,-5096259
1651931602,197367,true,2684656015,28,2679560265,-5095750
1651931678,197367,true,2684656015,28,2679560265,-5095750
1651931679,197368,true,2684387576,28,2679560265,-4827311
1651931710,197368,true,2684387576,28,2679560265,-4827311
1651931738,197368,true,2684387576,28,2679560265,-4827311
1651931772,197368,true,2684387576,28,2679560265,-4827311
1651931783,197369,true,2684119164,28,2679560265,-4558899
1651931804,197369,true,2684119164,28,2679560265,-4558899
1651931811,197370,true,2683850779,28,2679560265,-4290514
1651931854,197370,true,2683850779,28,2679292336,-4558443
1651931862,197371,true,2683582421,28,2679292336,-4290085
1651931903,197371,true,2683582421,28,2679292336,-4290085
1651931926,197371,true,2683582421,28,2679292336,-4290085
1651931944,197371,true,2683582421,28,2679292336,-4290085
1651931980,197372,true,2683314089,28,2679292336,-4021753
1651932099,197372,true,2683314089,28,2679024434,-4289655
1651932275,197373,true,2683045785,28,2679024434,-4021351
1651932582,197373,true,2683045785,28,2679292336,-3753449
1651932723,197373,true,2683045785,28,2679292336,-3753449
1651932837,197373,true,2683045785,28,2679292336,-3753449
1651932883,197374,true,2682777507,28,2679292336,-3485171
1651933260,197374,true,2682777507,28,2679292336,-3485171
1651933349,197374,true,2682777507,28,2679292336,-3485171
1651933472,197375,true,2682509256,28,2679292336,-3216920
1651933557,197375,true,2682509256,28,2679292336,-3216920
1651933609,197375,true,2682509256,28,2679292336,-3216920
1651933667,197376,true,2682241032,28,2679292336,-2948696
1651933843,197376,true,2682241032,28,2679292336,-2948696
1651933906,197376,true,2682241032,28,2679292336,-2948696
1651933938,197376,true,2682241032,28,2679292336,-2948696
1651934070,197377,true,2681972834,28,2679292336,-2680498
1651934082,197377,true,2681972834,28,2679292336,-2680498
1651934175,197378,true,2681704664,28,2679292336,-2412328
1651934188,197378,true,2681704664,28,2679292336,-2412328
1651934265,197378,true,2681704664,28,2679292336,-2412328
1651934686,197378,true,2681704664,28,2679292336,-2412328
1651934720,197379,true,2681436520,28,2679292336,-2144184
1651934893,197379,true,2681436520,28,2679292336,-2144184
1651934995,197379,true,2681436520,28,2679292336,-2144184
1651935032,197380,true,2681168404,28,2679292336,-1876068
1651935103,197380,true,2681168404,28,2679292336,-1876068
1651935126,197380,true,2681168404,28,2679292336,-1876068
1651935176,197380,true,2681168404,28,2679560265,-1608139
1651935270,197380,true,2681168404,28,2679560265,-1608139
1651935397,197381,true,2680900313,28,2679828221,-1072092
1651935532,197381,true,2680900313,28,2680096204,-804109
1651935579,197381,true,2680900313,28,2680096204,-804109
1651935755,197381,true,2680900313,28,2680364214,-536099
1651935760,197382,true,2680632250,28,2680364214,-268036
1651935824,197382,true,2680632250,28,2680632250,0
1651935826,197382,true,2680632250,28,2680632250,0
1651935844,197382,true,2680632250,28,2680632250,0
1651935886,197382,true,2680632250,28,2680632250,0
1651936089,197383,true,2680364214,28,2680900313,536099
1651936217,197383,true,2680364214,28,2681168404,804190
1651936274,197383,true,2680364214,28,2681436520,1072306
1651936294,197383,true,2680364214,28,2681436520,1072306
1651936548,197383,true,2680364214,28,2681704664,1340450
1651936585,197384,true,2680096204,28,2681704664,1608460
1651936687,197384,true,2680096204,28,2681972834,1876630
1651936802,197384,true,2680096204,28,2682241032,2144828
1651936834,197384,true,2680096204,28,2682241032,2144828
1651936959,197383,true,2680364214,28,2682509256,2145042
1651937010,197383,true,2680364214,28,2682777507,2413293
1651937069,197383,true,2680364214,28,2683045785,2681571
1651937112,197383,true,2680364214,28,2683314089,2949875
1651937175,197382,true,2680632250,28,2683850779,3218529
1651937330,197381,true,2680900313,28,2684924480,4024167
1651937650,197381,true,2680900313,28,2687341879,6441566
1651937697,197381,true,2680900313,28,2687610613,6710300
1651937922,197380,true,2681168404,28,2689223583,8055179
1651938009,197380,true,2681168404,28,2690030430,8862026
1651938069,197379,true,2681436520,28,2690299433,8862913
1651938071,197379,true,2681436520,28,2690299433,8862913
1651938093,197378,true,2681704664,28,2690568463,8863799
1651938185,197378,true,2681704664,28,2691106604,9401940
1651938244,197377,true,2681972834,28,2691375715,9402881
1651938323,197377,true,2681972834,28,2691914017,9941183
1651938398,197377,true,2681972834,28,2692452426,10479592
1651938511,197376,true,2682241032,28,2693260243,11019211
1651938538,197376,true,2682241032,28,2693260243,11019211
1651938627,197375,true,2682509256,28,2693798922,11289666
1651938652,197375,true,2682509256,28,2694068302,11559046
1651938731,197374,true,2682777507,28,2694337709,11560202
1651938942,197374,true,2682777507,28,2694607142,11829635
1651939039,197374,true,2682777507,28,2694607142,11829635
1651939050,197373,true,2683045785,28,2694607142,11561357
1651939076,197372,true,2683314089,28,2694337709,11023620
1651939078,197372,true,2683314089,28,2694337709,11023620
1651939135,197372,true,2683314089,28,2694337709,11023620
1651939328,197371,true,2683582421,28,2694337709,10755288
1651939344,197371,true,2683582421,28,2694068302,10485881
1651939388,197370,true,2683850779,28,2694068302,10217523
1651939454,197370,true,2683850779,28,2694068302,10217523
1651939478,197369,true,2684119164,28,2694068302,9949138
1651939718,197369,true,2684119164,28,2693798922,9679758
1651939745,197368,true,2684387576,28,2693798922,9411346
1651939747,197368,true,2684387576,28,2693798922,9411346
1651939795,197367,true,2684656015,28,2693798922,9142907
1651939821,197367,true,2684656015,28,2693798922,9142907
1651939835,197366,true,2684924480,28,2693798922,8874442
1651939885,197366,true,2684924480,28,2693798922,8874442
1651939919,197365,true,2685192973,28,2693529569,8336596
1651940007,197365,true,2685192973,28,2693529569,8336596
1651940070,197364,true,2685461492,28,2693529569,8068077
1651940085,197364,true,2685461492,28,2693529569,8068077
1651940106,197363,true,2685730038,28,2693529569,7799531
1651940157,197363,true,2685730038,28,2693529569,7799531
1651940249,197362,true,2685998611,28,2693529569,7530958
1651940301,197362,true,2685998611,28,2693529569,7530958
1651940335,197361,true,2686267211,28,2693529569,7262358
1651940582,197361,true,2686267211,28,2693529569,7262358
1651940886,197360,true,2686535838,28,2693529569,6993731
1651940966,197360,true,2686535838,28,2693529569,6993731
1651941150,197359,true,2686804491,28,2693529569,6725078
1651941310,197359,true,2686804491,28,2693529569,6725078
1651941392,197358,true,2687073172,28,2693529569,6456397
1651941481,197358,true,2687073172,28,2693529569,6456397
1651941494,197357,true,2687341879,28,2693529569,6187690
1651941622,197357,true,2687341879,28,2693529569,6187690
1651941714,197357,true,2687341879,28,2693529569,6187690
1651941839,197356,true,2687610613,28,2693529569,5918956
1651941956,197356,true,2687610613,28,2693529569,5918956
1651942021,197355,true,2687879374,28,2693529569,5650195
1651942052,197355,true,2687879374,28,2693529569,5650195
1651942107,197354,true,2688148162,28,2693529569,5381407
1651942157,197354,true,2688148162,28,2693529569,5381407
1651942177,197353,true,2688416977,28,2693529569,5112592
1651942227,197353,true,2688416977,28,2693529569,5112592
1651942234,197352,true,2688685819,28,2693529569,4843750
1651942250,197352,true,2688685819,28,2693529569,4843750
1651942273,197351,true,2688954687,28,2693529569,4574882
1651942293,197351,true,2688954687,28,2693529569,4574882
1651942380,197351,true,2688954687,28,2693529569,4574882
1651942432,197350,true,2689223583,28,2693260243,4036660
1651942448,197350,true,2689223583,28,2693260243,4036660
1651942524,197350,true,2689223583,28,2692990944,3767361
1651942618,197349,true,2689492505,28,2692990944,3498439
1651942648,197349,true,2689492505,28,2692721672,3229167
1651942670,197349,true,2689492505,28,2692721672,3229167
1651942706,197348,true,2689761454,28,2692721672,2960218
1651942836,197348,true,2689761454,28,2692452426,2690972
1651942967,197348,true,2689761454,28,2692183208,2421754
1651942996,197347,true,2690030430,28,2691914017,1883587
1651943024,197347,true,2690030430,28,2691914017,1883587
1651943033,197347,true,2690030430,28,2691914017,1883587
1651943072,197346,true,2690299433,28,2691914017,1614584
1651943142,197346,true,2690299433,28,2691644852,1345419
1651943206,197345,true,2690568463,28,2691644852,1076389
1651943265,197345,true,2690568463,28,2691375715,807252
1651943416,197345,true,2690568463,28,2691106604,538141
1651943438,197344,true,2690837520,28,2691106604,269084
1651943461,197344,true,2690837520,28,2691106604,269084
1651943591,197344,true,2690837520,28,2690837520,0
1651943639,197344,true,2690837520,28,2690568463,-269057
1651943736,197343,true,2691106604,28,2690299433,-807171
1651943831,197343,true,2691106604,28,2690299433,-807171
1651943905,197343,true,2691106604,28,2690030430,-1076174
1651943920,197343,true,2691106604,28,2690030430,-1076174
1651943975,197342,true,2691375715,28,2689761454,-1614261
1651944001,197342,true,2691375715,28,2689761454,-1614261
1651944084,197342,true,2691375715,28,2689761454,-1614261
1651944091,197342,true,2691375715,28,2689761454,-1614261
1651944254,197341,true,2691644852,28,2689492505,-2152347
1651944259,197341,true,2691644852,28,2689492505,-2152347
1651944286,197341,true,2691644852,28,2689492505,-2152347
1651944451,197341,true,2691644852,28,2689492505,-2152347
1651944487,197340,true,2691914017,28,2689492505,-2421512
1651944641,197340,true,2691914017,28,2689492505,-2421512
1651944657,197340,true,2691914017,28,2689492505,-2421512
1651944747,197340,true,2691914017,28,2689492505,-2421512
1651944846,197340,true,2691914017,28,2689492505,-2421512
1651944905,197339,true,2692183208,28,2689492505,-2690703
1651944987,197339,true,2692183208,28,2689492505,-2690703
1651945067,197339,true,2692183208,28,2689492505,-2690703
1651945089,197339,true,2692183208,28,2689492505,-2690703
1651945162,197339,true,2692183208,28,2689492505,-2690703
1651945169,197339,true,2692183208,28,2689492505,-2690703
1651945199,197339,true,2692183208,28,2689492505,-2690703
1651945205,197340,true,2691914017,28,2689492505,-2421512
1651945234,197340,true,2691914017,28,2689492505,-2421512
1651945293,197340,true,2691914017,28,2689492505,-2421512
1651945373,197341,true,2691644852,28,2688954687,-2690165
1651945503,197341,true,2691644852,28,2688148162,-3496690
1651945522,197342,true,2691375715,28,2688148162,-3227553
1651945627,197343,true,2691106604,28,2687610613,-3495991
1651945750,197343,true,2691106604,28,2686804491,-4302113
1651945812,197343,true,2691106604,28,2686535838,-4570766
1651945820,197344,true,2690837520,28,2686535838,-4301682
1651945902,197344,true,2690837520,28,2685998611,-4838909
1651946280,197345,true,2690568463,28,2684119164,-6449299
1651946368,197345,true,2690568463,28,2683582421,-6986042
1651946527,197345,true,2690568463,28,2682777507,-7790956
1651946794,197346,true,2690299433,28,2681436520,-8862913
1651946805,197347,true,2690030430,28,2681168404,-8862026
1651946811,197347,true,2690030430,28,2681168404,-8862026
1651946825,197347,true,2690030430,28,2681168404,-8862026
1651946988,197348,true,2689761454,28,2680364214,-9397240
1651947096,197349,true,2689492505,28,2679828221,-9664284
1651947326,197349,true,2689492505,28,2679828221,-9664284
1651947337,197349,true,2689492505,28,2680096204,-9396301
1651947404,197350,true,2689223583,28,2680096204,-9127379
1651947411,197350,true,2689223583,28,2680096204,-9127379
1651947493,197350,true,2689223583,28,2680364214,-8859369
1651947585,197350,true,2689223583,28,2680900313,-8323270
1651947597,197351,true,2688954687,28,2680900313,-8054374
1651947626,197351,true,2688954687,28,2680900313,-8054374
1651947684,197351,true,2688954687,28,2681436520,-7518167
1651947745,197350,true,2689223583,28,2681704664,-7518919
1651947898,197351,true,2688954687,28,2682777507,-6177180
1651947977,197351,true,2688954687,28,2683314089,-5640598
1651948087,197351,true,2688954687,28,2683850779,-5103908
1651948321,197351,true,2688954687,28,2685461492,-3493195
1651948499,197351,true,2688954687,28,2686535838,-2418849
1651948684,197352,true,2688685819,28,2687879374,-806445
1651948707,197351,true,2688954687,28,2687879374,-1075313
1651948790,197351,true,2688954687,28,2688416977,-537710
1651948984,197351,true,2688954687,28,2689761454,806767
1651948991,197352,true,2688685819,28,2689761454,1075635
1651949018,197351,true,2688954687,28,2690030430,1075743
1651949556,197351,true,2688954687,28,2691375715,2421028
1651950302,197352,true,2688685819,28,2691375715,2689896
1651950369,197352,true,2688685819,28,2691375715,2689896
1651950401,197352,true,2688685819,28,2691375715,2689896
1651950484,197352,true,2688685819,28,2691375715,2689896
1651950524,197352,true,2688685819,28,2691375715,2689896
1651950576,197352,true,2688685819,28,2691375715,2689896
1651950633,197352,true,2688685819,28,2691375715,2689896
1651950974,197352,true,2688685819,28,2691375715,2689896
1651951379,197352,true,2688685819,28,2691375715,2689896
1651951450,197353,true,2688416977,28,2691375715,2958738
1651951689,197352,true,2688685819,28,2691375715,2689896
1651951786,197352,true,2688685819,28,2691375715,2689896
1651951968,197353,true,2688416977,28,2691375715,2958738
1651952158,197353,true,2688416977,28,2691375715,2958738
1651952334,197353,true,2688416977,28,2691375715,2958738
1651952341,197352,true,2688685819,28,2691375715,2689896
1651952399,197353,true,2688416977,28,2691375715,2958738
1651952458,197353,true,2688416977,28,2691375715,2958738
1651952531,197353,true,2688416977,28,2691375715,2958738
1651952556,197353,true,2688416977,28,2691375715,2958738
1651952595,197353,true,2688416977,28,2691375715,2958738
1651952626,197354,true,2688148162,28,2691375715,3227553
1651952711,197353,true,2688416977,28,2691375715,2958738
1651952745,197353,true,2688416977,28,2691375715,2958738
1651952771,197353,true,2688416977,28,2691375715,2958738
1651952895,197353,true,2688416977,28,2691375715,2958738
1651952927,197353,true,2688416977,28,2691375715,2958738
1651953207,197353,true,2688416977,28,2691375715,2958738
1651953276,197353,true,2688416977,28,2691375715,2958738
1651953479,197353,true,2688416977,28,2691375715,2958738
1651953488,197353,true,2688416977,28,2691375715,2958738
1651953527,197352,true,2688685819,28,2691375715,2689896
1651953582,197353,true,2688416977,28,2691375715,2958738
1651953603,197353,true,2688416977,28,2691375715,2958738
1651953640,197353,true,2688416977,28,2691375715,2958738
1651953683,197352,true,2688685819,28,2691106604,2420785
1651953721,197353,true,2688416977,28,2691106604,2689627
1651953759,197353,true,2688416977,28,2691106604,2689627
1651953766,197353,true,2688416977,28,2691106604,2689627
1651953815,197353,true,2688416977,28,2690837520,2420543
1651953837,197353,true,2688416977,28,2690837520,2420543
1651953882,197354,true,2688148162,28,2690568463,2420301
1651954155,197353,true,2688416977,28,2689761454,1344477
1651954266,197353,true,2688416977,28,2689223583,806606
1651954419,197354,true,2688148162,28,2688685819,537657
1651954554,197355,true,2687879374,28,2688148162,268788
1651954685,197354,true,2688148162,28,2687610613,-537549
1651954740,197354,true,2688148162,28,2687341879,-806283
1651954790,197354,true,2688148162,28,2687341879,-806283
1651954859,197355,true,2687879374,28,2686804491,-1074883
1651954865,197355,true,2687879374,28,2686804491,-1074883
1651954913,197355,true,2687879374,28,2686804491,-1074883
1651954920,197355,true,2687879374,28,2686804491,-1074883
1651954936,197356,true,2687610613,28,2686535838,-1074775
1651954968,197355,true,2687879374,28,2686535838,-1343536
1651955018,197355,true,2687879374,28,2686267211,-1612163
1651955029,197356,true,2687610613,28,2686267211,-1343402
1651955133,197357,true,2687341879,28,2685730038,-1611841
1651955258,197356,true,2687610613,28,2685192973,-2417640
1651955533,197356,true,2687610613,28,2684387576,-3223037
1651955571,197357,true,2687341879,28,2684387576,-2954303
1651955588,197357,true,2687341879,28,2684387576,-2954303
1651955639,197357,true,2687341879,28,2684119164,-3222715
1651955707,197357,true,2687341879,28,2683850779,-3491100
1651955855,197358,true,2687073172,28,2683582421,-3490751
1651956379,197359,true,2686804491,28,2681972834,-4831657
1651956456,197358,true,2687073172,28,2681704664,-5368508
1651956495,197359,true,2686804491,28,2681436520,-5367971
1651956618,197360,true,2686535838,28,2680900313,-5635525
1651956718,197361,true,2686267211,28,2680364214,-5902997
1651956781,197360,true,2686535838,28,2680096204,-6439634
1651957705,197361,true,2686267211,28,2676882178,-9385033
1651957821,197361,true,2686267211,28,2676614517,-9652694
1651957882,197361,true,2686267211,28,2676614517,-9652694
1651957906,197361,true,2686267211,28,2676614517,-9652694
1651957926,197361,true,2686267211,28,2676614517,-9652694
1651957949,197361,true,2686267211,28,2676614517,-9652694
1651957977,197362,true,2685998611,28,2676346882,-9651729
1651957996,197362,true,2685998611,28,2676346882,-9651729
1651958006,197362,true,2685998611,28,2676346882,-9651729
1651958153,197363,true,2685730038,28,2675009110,-10720928
1651958221,197364,true,2685461492,28,2674474188,-10987304
1651958252,197364,true,2685461492,28,2674206768,-11254724
1651958307,197364,true,2685461492,28,2673672007,-11789485
1651958474,197366,true,2684924480,28,2672068365,-12856115
1651958567,197367,true,2684656015,28,2671266905,-13389110
1651958622,197367,true,2684656015,28,2670732731,-13923284
1651958700,197367,true,2684656015,28,2670198665,-14457350
1651958827,197368,true,2684387576,28,2668863966,-15523610
1651958882,197369,true,2684119164,28,2668330273,-15788891
1651959037,197369,true,2684119164,28,2666729835,-17389329
1651959046,197370,true,2683850779,28,2666729835,-17120944
1651959068,197372,true,2683314089,28,2666463189,-16850900
1651959533,197373,true,2683045785,28,2660603711,-22442074
1651959587,197373,true,2683045785,28,2659805689,-23240096
1651959943,197374,true,2682777507,28,2656350361,-26427146
1651960130,197376,true,2682241032,28,2655553615,-26687417
1651960175,197378,true,2681704664,28,2655288086,-26416578
1651960197,197378,true,2681704664,28,2655022584,-26682080
1651960213,197379,true,2681436520,28,2655022584,-26413936
1651960253,197382,true,2680632250,28,2654757108,-25875142
1651960304,197383,true,2680364214,28,2654491659,-25872555
1651960321,197384,true,2680096204,28,2654491659,-25604545
1651960379,197385,true,2679828221,28,2653960841,-25867380
1651960455,197388,true,2679024434,28,2653430128,-25594306
1651960468,197389,true,2678756558,28,2653164812,-25591746
1651960743,197390,true,2678488709,28,2651043235,-27445474
1651960756,197392,true,2677953092,28,2651043235,-26909857
1651960766,197394,true,2677417581,28,2651043235,-26374346
1651960793,197396,true,2676882178,28,2650513105,-26369073
1651961263,197399,true,2676079274,28,2643102419,-32976855
1651961367,197400,true,2675811693,28,2641517112,-34294581
1651961821,197403,true,2675009110,28,2634394992,-40614118
1651961841,197405,true,2674474188,28,2634131578,-40342610
1651962276,197408,true,2673672007,28,2628343148,-45328859
1651962309,197409,true,2673404666,28,2628080340,-45324326
1651962341,197412,true,2672602805,28,2627554803,-45048002
1651962465,197414,true,2672068365,28,2626241419,-45826946
1651962510,197417,true,2671266905,28,2625716250,-45550655
1651962655,197418,true,2670999805,28,2625191185,-45808620
1651962709,197421,true,2670198665,28,2625191185,-45007480
1651962877,197423,true,2669664705,28,2625191185,-44473520
1651962968,197426,true,2668863966,28,2624928692,-43935274
1651963285,197427,true,2668597106,28,2624928692,-43668414
1651963327,197430,true,2667796687,28,2624928692,-42867995
1651963454,197432,true,2667263208,28,2624928692,-42334516
1651963510,197435,true,2666463189,28,2624666226,-41796963
1651963649,197436,true,2666196569,28,2624666226,-41530343
1651963710,197439,true,2665396870,28,2624666226,-40730644
1651963861,197441,true,2664863871,28,2624141371,-40722500
1651963869,197444,true,2664064572,28,2624141371,-39923201
1651963881,197446,true,2663531839,28,2623878983,-39652856
1651963884,197448,true,2662999212,28,2623878983,-39120229
1651963895,197451,true,2662200472,28,2623878983,-38321489
1651963908,197455,true,2661135858,28,2623878983,-37256875
1651964024,197457,true,2660603711,28,2622829694,-37774017
1651964136,197460,true,2659805689,28,2620994448,-38811241
1651964151,197463,true,2659007907,28,2620470327,-38537580
1651964166,197467,true,2657944570,28,2620208306,-37736264
1651964168,197470,true,2657147346,28,2620208306,-36939040
1651964172,197474,true,2656084753,28,2620208306,-35876447
1651964228,197476,true,2655553615,28,2619422401,-36131214
1651964469,197480,true,2654491659,28,2616019535,-38472124
1651964537,197482,true,2653960841,28,2615234886,-38725955
1651964538,197487,true,2652634258,28,2615234886,-37399372
1651964577,197488,true,2652369021,28,2614711917,-37657104
1651964634,197491,true,2651573470,28,2614189053,-37384417
1651964658,197494,true,2650778157,28,2613927660,-36850497
1651964684,197498,true,2649718110,28,2613666294,-36051816
1651964713,197499,true,2649453165,28,2613404953,-36048212
1651964747,197502,true,2648658488,28,2613143639,-35514849
1651964771,197504,true,2648128836,28,2612882351,-35246485
1651964779,197508,true,2647069849,28,2612882351,-34187498
1651964844,197508,true,2647069849,28,2612882351,-34187498
1651964945,197511,true,2646275887,28,2612621088,-33654799
1651965104,197513,true,2645746711,28,2612098643,-33648068
1651965115,197516,true,2644953146,28,2612098643,-32854503
1651965304,197517,true,2644688677,28,2612359853,-32328824
1651965450,197519,true,2644159819,28,2612621088,-31538731
1651965605,197521,true,2643631066,28,2612882351,-30748715
1651965661,197524,true,2642838135,28,2613143639,-29694496
1651965940,197524,true,2642838135,28,2616804419,-26033716
1651965956,197527,true,2642045442,28,2617066099,-24979343
1651966024,197528,true,2641781264,28,2618113083,-23668181
1651966059,197532,true,2640724816,28,2618898595,-21826221
1651966066,197532,true,2640724816,28,2618898595,-21826221
1651966083,197534,true,2640196750,28,2619160485,-21036265
1651966128,197535,true,2639932757,28,2619946312,-19986445
1651966276,197538,true,2639140935,28,2623616622,-15524313
1651966348,197538,true,2639140935,28,2625191185,-13949750
1651966393,197540,true,2638613186,28,2626241419,-12371767
1651966499,197541,true,2638349351,28,2628343148,-10006203
1651966561,197543,true,2637821761,28,2629394643,-8427118
1651966645,197543,true,2637821761,28,2630446559,-7375202
1651966799,197545,true,2637294275,28,2632025221,-5269054
1651966970,197546,true,2637030572,28,2633868192,-3162380
1651967057,197549,true,2636239621,28,2634658431,-1581190
1651967069,197549,true,2636239621,28,2634921897,-1317724
1651967226,197550,true,2635976024,28,2636239621,263597
1651967577,197551,true,2635712453,28,2638877048,3164595
1651967697,197554,true,2634921897,28,2639932757,5010860
1651967985,197553,true,2635185389,28,2641517112,6331723
1651968095,197555,true,2634658431,28,2641252987,6594556
1651968156,197556,true,2634394992,28,2641252987,6857995
1651968185,197558,true,2633868192,28,2641252987,7384795
1651968245,197558,true,2633868192,28,2641252987,7384795
1651968300,197560,true,2633341497,28,2640988888,7647391
1651968331,197561,true,2633078189,28,2640988888,7910699
1651968488,197563,true,2632551652,28,2640988888,8437236
1651968495,197563,true,2632551652,28,2640988888,8437236
1651968715,197565,true,2632025221,28,2640724816,8699595
1651968772,197565,true,2632025221,28,2640724816,8699595
1651968807,197567,true,2631498895,28,2640724816,9225921
1651968894,197566,true,2631762045,28,2640724816,8962771
1651969075,197568,true,2631235771,28,2640460770,9224999
1651969140,197568,true,2631235771,28,2640460770,9224999
1651969154,197570,true,2630709603,28,2640460770,9751167
1651969250,197569,true,2630972674,28,2640196750,9224076
1651969278,197571,true,2630446559,28,2639932757,9486198
1651969303,197572,true,2630183540,28,2639932757,9749217
1651969317,197573,true,2629920548,28,2639932757,10012209
1651969360,197573,true,2629920548,28,2639668790,9748242
1651969436,197574,true,2629657582,28,2639404849,9747267
1651969529,197575,true,2629394643,28,2638877048,9482405
1651969545,197576,true,2629131730,28,2638877048,9745318
1651969585,197575,true,2629394643,28,2638613186,9218543
1651969628,197577,true,2628868843,28,2638349351,9480508
1651969660,197578,true,2628605982,28,2638349351,9743369
1651969671,197579,true,2628343148,28,2638349351,10006203
1651969703,197578,true,2628605982,28,2638085543,9479561
1651969735,197580,true,2628080340,28,2638085543,10005203
1651969749,197581,true,2627817558,28,2637821761,10004203
1651969776,197581,true,2627817558,28,2637821761,10004203
1651969833,197581,true,2627817558,28,2637558005,9740447
1651969849,197582,true,2627554803,28,2637294275,9739472
1651969859,197583,true,2627292073,28,2637294275,10002202
1651969934,197583,true,2627292073,28,2637030572,9738499
1651970041,197582,true,2627554803,28,2636503245,8948442
1651970089,197584,true,2627029371,28,2636239621,9210250
1651970149,197584,true,2627029371,28,2635976024,8946653
1651970191,197585,true,2626766694,28,2635976024,9209330
1651970258,197584,true,2627029371,28,2635712453,8683082
1651970320,197583,true,2627292073,28,2635185389,7893316
1651970383,197584,true,2627029371,28,2634921897,7892526
1651970623,197584,true,2627029371,28,2633868192,6838821
1651970774,197583,true,2627292073,28,2633341497,6049424
1651970845,197582,true,2627554803,28,2632814908,5260105
1651970921,197583,true,2627292073,28,2632551652,5259579
1651970941,197583,true,2627292073,28,2632551652,5259579
1651970952,197582,true,2627554803,28,2632551652,4996849
1651971007,197581,true,2627817558,28,2632288424,4470866
1651971014,197582,true,2627554803,28,2632288424,4733621
1651971030,197582,true,2627554803,28,2632288424,4733621
1651971041,197581,true,2627817558,28,2632288424,4470866
1651971071,197580,true,2628080340,28,2632288424,4208084
1651971091,197581,true,2627817558,28,2632025221,4207663
1651971140,197581,true,2627817558,28,2632025221,4207663
1651971160,197580,true,2628080340,28,2632025221,3944881
1651971231,197580,true,2628080340,28,2631762045,3681705
1651971275,197580,true,2628080340,28,2631762045,3681705
1651971311,197581,true,2627817558,28,2631498895,3681337
1651971393,197580,true,2628080340,28,2631235771,3155431
1651971413,197579,true,2628343148,28,2631235771,2892623
1651971431,197579,true,2628343148,28,2630972674,2629526
1651971489,197580,true,2628080340,28,2630709603,2629263
1651971553,197578,true,2628605982,28,2630446559,1840577
1651971561,197577,true,2628868843,28,2630446559,1577716
1651971672,197577,true,2628868843,28,2629920548,1051705
1651971690,197577,true,2628868843,28,2629920548,1051705
1651971784,197575,true,2629394643,28,2629394643,0
1651971851,197574,true,2629657582,28,2629131730,-525852
1651971861,197573,true,2629920548,28,2629131730,-788818
1651971899,197572,true,2630183540,28,2628868843,-1314697
1651971943,197572,true,2630183540,28,2628605982,-1577558
1651971998,197571,true,2630446559,28,2628343148,-2103411
1651972129,197570,true,2630709603,28,2627817558,-2892045
1651972216,197569,true,2630972674,28,2627292073,-3680601
1651972413,197568,true,2631235771,28,2626504043,-4731728
1651972433,197568,true,2631235771,28,2626241419,-4994352
1651972451,197568,true,2631235771,28,2626241419,-4994352
1651972465,197567,true,2631498895,28,2626241419,-5257476
1651972487,197566,true,2631762045,28,2626241419,-5520626
1651972527,197566,true,2631762045,28,2625978821,-5783224
1651972535,197566,true,2631762045,28,2625978821,-5783224
1651972582,197565,true,2632025221,28,2625716250,-6308971
1651972638,197566,true,2631762045,28,2625453704,-6308341
1651972654,197566,true,2631762045,28,2625453704,-6308341
1651972673,197566,true,2631762045,28,2625191185,-6570860
1651972707,197565,true,2632025221,28,2625191185,-6834036
1651972749,197566,true,2631762045,28,2624928692,-6833353
1651972769,197566,true,2631762045,28,2624666226,-7095819
1651972798,197566,true,2631762045,28,2624403785,-7358260
1651972801,197566,true,2631762045,28,2624403785,-7358260
1651972821,197567,true,2631498895,28,2624403785,-7095110
1651972876,197567,true,2631498895,28,2623878983,-7619912
1651972916,197567,true,2631498895,28,2623616622,-7882273
1651972963,197567,true,2631498895,28,2623354286,-8144609
1651973011,197568,true,2631235771,28,2622829694,-8406077
1651973159,197569,true,2630972674,28,2621780825,-9191849
1651973167,197570,true,2630709603,28,2621780825,-8928778
1651973192,197571,true,2630446559,28,2621518673,-8927886
1651973255,197572,true,2630183540,28,2621256547,-8926993
1651973372,197573,true,2629920548,28,2620470327,-9450221
1651973425,197574,true,2629657582,28,2620208306,-9449276
1651973560,197574,true,2629657582,28,2619684343,-9973239
1651973566,197576,true,2629131730,28,2619422401,-9709329
1651973614,197577,true,2628868843,28,2619160485,-9708358
1651973668,197577,true,2628868843,28,2618898595,-9970248
1651973713,197578,true,2628605982,28,2618636732,-9969250
1651973762,197579,true,2628343148,28,2618636732,-9706416
1651973888,197580,true,2628080340,28,2617851298,-10229042
1651973989,197581,true,2627817558,28,2617327806,-10489752
1651974011,197582,true,2627554803,28,2617327806,-10226997
1651974088,197583,true,2627292073,28,2616804419,-10487654
1651974140,197584,true,2627029371,28,2616542765,-10486606
1651974146,197585,true,2626766694,28,2616542765,-10223929
1651974195,197585,true,2626766694,28,2616281136,-10485558
1651974286,197587,true,2626241419,28,2615757959,-10483460
1651974304,197588,true,2625978821,28,2615757959,-10220862
1651974414,197588,true,2625978821,28,2614973388,-11005433
1651974427,197589,true,2625716250,28,2614973388,-10742862
1651974438,197590,true,2625453704,28,2614973388,-10480316
1651974473,197591,true,2625191185,28,2614711917,-10479268
1651974480,197592,true,2624928692,28,2614711917,-10216775
1651974577,197593,true,2624666226,28,2614450472,-10215754
1651974585,197594,true,2624403785,28,2614450472,-9953313
1651974596,197595,true,2624141371,28,2614189053,-9952318
1651974627,197596,true,2623878983,28,2613927660,-9951323
1651974633,197597,true,2623616622,28,2613927660,-9688962
1651974655,197598,true,2623354286,28,2613666294,-9687992
1651974688,197599,true,2623091977,28,2613404953,-9687024
1651974773,197600,true,2622829694,28,2612882351,-9947343
1651974830,197602,true,2622305207,28,2612621088,-9684119
1651974889,197603,true,2622043003,28,2612098643,-9944360
1651974970,197604,true,2621780825,28,2611576301,-10204524
1651975050,197605,true,2621518673,28,2611054064,-10464609
1651975116,197606,true,2621256547,28,2610531932,-10724615
1651975178,197607,true,2620994448,28,2609748929,-11245519
1651975202,197608,true,2620732374,28,2609487980,-11244394
1651975250,197609,true,2620470327,28,2608966161,-11504166
1651975261,197611,true,2619946312,28,2608966161,-10980151
1651975295,197612,true,2619684343,28,2608705290,-10979053
1651975315,197613,true,2619422401,28,2608444446,-10977955
1651975338,197614,true,2619160485,28,2608183627,-10976858
1651975345,197616,true,2618636732,28,2608183627,-10453105
1651975380,197617,true,2618374894,28,2607662069,-10712825
1651975397,197618,true,2618113083,28,2607662069,-10451014
1651975409,197620,true,2617589539,28,2607401329,-10188210
1651975453,197621,true,2617327806,28,2606879927,-10447879
1651975490,197622,true,2617066099,28,2606619265,-10446834
1651975510,197623,true,2616804419,28,2606358629,-10445790
1651975517,197625,true,2616281136,28,2606358629,-9922507
1651975590,197628,true,2615496409,28,2604534907,-10961502
1651975832,197630,true,2614973388,28,2599071396,-15901992
1651975877,197631,true,2614711917,28,2598291831,-16420086
1651975938,197633,true,2614189053,28,2596733401,-17455652
1651975943,197636,true,2613404953,28,2596733401,-16671552
1651976020,197638,true,2612882351,28,2594916414,-17965937
1651976032,197639,true,2612621088,28,2594656949,-17964139
1651976043,197641,true,2612098643,28,2594397509,-17701134
1651976064,197644,true,2611315170,28,2593878707,-17436463
1651976089,197646,true,2610792985,28,2593360009,-17432976
1651976100,197647,true,2610531932,28,2593100699,-17431233
1651976129,197649,true,2610009904,28,2592582157,-17427747
1651976152,197652,true,2609227057,28,2591804538,-17422519
1651976164,197655,true,2608444446,28,2591545383,-16899063
1651976209,197656,true,2608183627,28,2590249999,-17933628
1651976263,197658,true,2607662069,28,2588696393,-18965676
1651976270,197662,true,2606619265,28,2588437549,-18181716
1651976291,197664,true,2606098019,28,2587919939,-18178080
1651976303,197666,true,2605576878,28,2587661173,-17915705
1651976324,197667,true,2605316346,28,2586885030,-18431316
1651976327,197671,true,2604274480,28,2586885030,-17389450
1651976338,197673,true,2603753703,28,2586626368,-17127335
1651976359,197674,true,2603493354,28,2586109120,-17384234
1651976429,197675,true,2603233031,28,2584557997,-18675034
1651976511,197679,true,2602191998,28,2583007805,-19184193
1651976758,197681,true,2601671637,28,2578362805,-23308832
1651976856,197682,true,2601411496,28,2576558673,-24852823
1651976860,197683,true,2601151381,28,2576301043,-24850338
1651976861,197686,true,2600371192,28,2576301043,-24070149
1651976878,197688,true,2599851195,28,2576043438,-23807757
1651976913,197689,true,2599591236,28,2575270780,-24320456
1651976949,197691,true,2599071396,28,2574755803,-24315593
1651976981,197694,true,2598291831,28,2574240929,-24050902
1651977015,197696,true,2597772250,28,2573726158,-24046092
1651977031,197697,true,2597512499,28,2573468811,-24043688
1651977083,197698,true,2597252774,28,2572696925,-24555849
1651977104,197702,true,2596214132,28,2572439681,-23774451
1651977155,197704,true,2595694967,28,2571153847,-24541120
1651977183,197706,true,2595175906,28,2570639693,-24536213
1651977207,197708,true,2594656949,28,2570125642,-24531307
1651977223,197711,true,2593878707,28,2569611694,-24267013
1651977310,197714,true,2593100699,28,2567556930,-25543769
1651977504,197716,true,2592582157,28,2565503808,-27078349
1651977542,197717,true,2592322925,28,2564990784,-27332141
1651977558,197721,true,2591286255,28,2564734311,-26551944
1651977573,197724,true,2590509024,28,2564734311,-25774713
1651977687,197725,true,2590249999,28,2563452328,-26797671
1651977832,197728,true,2589473080,28,2560634222,-28838858
1651977845,197732,true,2588437549,28,2560378184,-28059365
1651977864,197734,true,2587919939,28,2560122172,-27797767
1651977888,197737,true,2587143719,28,2559610224,-27533495
1651977906,197739,true,2586626368,28,2559098379,-27527989
1651977935,197743,true,2585591976,28,2558842495,-26749481
1651977953,197745,true,2585074935,28,2558586636,-26488299
1651977980,197747,true,2584557997,28,2558330803,-26227194
1651977990,197750,true,2583782785,28,2558074996,-25707789
1651978042,197753,true,2583007805,28,2557563457,-25444348
1651978195,197755,true,2582491281,28,2556285059,-26206222
1651978251,197757,true,2581974860,28,2555518327,-26456533
1651978268,197759,true,2581458543,28,2555262801,-26195742
1651978330,197762,true,2580684260,28,2554751825,-25932435
1651978357,197764,true,2580168201,28,2554240951,-25927250
1651978487,197766,true,2579652244,28,2552964214,-26688030
1651978530,197768,true,2579136391,28,2552198478,-26937913
1651978540,197772,true,2578104995,28,2551943283,-26161712
1651978545,197774,true,2577589451,28,2551688114,-25901337
1651978556,197777,true,2576816329,28,2551432971,-25383358
1651978760,197779,true,2576301043,28,2548373241,-27927802
1651978819,197782,true,2575528307,28,2547608882,-27919425
1651978828,197784,true,2575013279,28,2547608882,-27404397
1651978860,197787,true,2574240929,28,2547099436,-27141493
1651978869,197789,true,2573726158,28,2546844752,-26881406
1651978942,197792,true,2572954195,28,2546080851,-26873344
1651978951,197794,true,2572439681,28,2546080851,-26358830
1651979017,197797,true,2571668103,28,2545826269,-25841834
1651979038,197798,true,2571410962,28,2545571711,-25839251
1651979121,197801,true,2570639693,28,2545317180,-25322513
1651979165,197804,true,2569868656,28,2545062673,-24805983
1651979196,197807,true,2569097849,28,2545062673,-24035176
1651979230,197808,true,2568840965,28,2544808193,-24032772
1651979265,197811,true,2568070467,28,2544553737,-23516730
1651979274,197813,true,2567556930,28,2544553737,-23003193
1651979316,197816,true,2566786817,28,2544299307,-22487510
1651979395,197818,true,2566273536,28,2543536170,-22737366
1651979403,197821,true,2565503808,28,2543536170,-21967638
1651979447,197824,true,2564734311,28,2542773262,-21961049
1651979540,197828,true,2563708674,28,2541756407,-21952267
1651979557,197830,true,2563196009,28,2541502257,-21693752
1651979568,197832,true,2562683447,28,2541502257,-21181190
1651979598,197835,true,2561914795,28,2541248132,-20666663
1651979615,197839,true,2560890286,28,2541248132,-19642154
1651979668,197841,true,2560378184,28,2540739958,-19638226
1651979685,197843,true,2559866185,28,2540739958,-19126227
1651979706,197846,true,2559098379,28,2540485910,-18612469
1651979728,197849,true,2558330803,28,2540485910,-17844893
1651979756,197851,true,2557819214,28,2540231887,-17587327
1651979769,197853,true,2557307727,28,2539977889,-17329838
1651979780,197856,true,2556540688,28,2539977889,-16562799
1651979803,197859,true,2555773879,28,2539723916,-16049963
1651979844,197860,true,2555518327,28,2539469969,-16048358
1651979858,197862,true,2555007300,28,2539216048,-15791252
1651979872,197864,true,2554496375,28,2539216048,-15280327
1651979989,197868,true,2553474832,28,2538454435,-15020397
1651980152,197869,true,2553219510,28,2537185589,-16033921
1651980379,197871,true,2552708943,28,2536424585,-16284358
1651980391,197873,true,2552198478,28,2536170968,-16027510
1651980434,197876,true,2551432971,28,2536170968,-15262003
1651980553,197877,true,2551177853,28,2535663810,-15514043
1651980634,197879,true,2550667694,28,2535410269,-15257425
1651980688,197881,true,2550157637,28,2535156753,-15000884
1651980708,197885,true,2549137829,28,2535156753,-13981076
1651980726,197886,true,2548882941,28,2535156753,-13726188
1651980795,197886,true,2548882941,28,2534649798,-14233143
1651980802,197887,true,2548628078,28,2534649798,-13978280
1651980834,197890,true,2547863643,28,2534649798,-13213845
1651980921,197891,true,2547608882,28,2534142944,-13465938
1651981018,197891,true,2547608882,28,2533636192,-13972690
1651981027,197892,true,2547354146,28,2533636192,-13717954
1651981075,197895,true,2546590093,28,2533382853,-13207240
1651981105,197896,true,2546335459,28,2533129540,-13205919
1651981187,197897,true,2546080851,28,2532876253,-13204598
1651981214,197898,true,2545826269,28,2532876253,-12950016
1651981219,197901,true,2545062673,28,2532876253,-12186420
1651981224,197902,true,2544808193,28,2532876253,-11931940
1651981258,197902,true,2544808193,28,2532876253,-11931940
1651981598,197903,true,2544553737,28,2533636192,-10917545
1651981675,197906,true,2543790524,28,2533636192,-10154332
1651981709,197907,true,2543536170,28,2533636192,-9899978
1651981823,197907,true,2543536170,28,2533636192,-9899978
1651981848,197907,true,2543536170,28,2533636192,-9899978
1651981879,197910,true,2542773262,28,2533636192,-9137070
1651981937,197910,true,2542773262,28,2533636192,-9137070
1651981962,197910,true,2542773262,28,2533889555,-8883707
1651982011,197911,true,2542519010,28,2533889555,-8629455
1651982046,197914,true,2541756407,28,2533889555,-7866852
1651982065,197914,true,2541756407,28,2533889555,-7866852
1651982089,197914,true,2541756407,28,2534142944,-7613463
1651982115,197914,true,2541756407,28,2534396358,-7360049
1651982138,197917,true,2540994032,28,2534396358,-6597674
1651982169,197917,true,2540994032,28,2534649798,-6344234
1651982280,197917,true,2540994032,28,2535410269,-5583763
1651982286,197917,true,2540994032,28,2535410269,-5583763
1651982391,197920,true,2540231887,28,2536170968,-4060919
1651982474,197920,true,2540231887,28,2536678228,-3553659
1651982581,197920,true,2540231887,28,2537439307,-2792580
1651982605,197920,true,2540231887,28,2537693051,-2538836
1651982618,197923,true,2539469969,28,2537693051,-1776918
1651982689,197923,true,2539469969,28,2538200615,-1269354
1651982792,197923,true,2539469969,28,2538962152,-507817
1651982877,197922,true,2539723916,28,2539723916,0
1651982881,197924,true,2539216048,28,2539723916,507868
1651982912,197924,true,2539216048,28,2539977889,761841
1651982996,197923,true,2539469969,28,2540739958,1269989
1651983007,197923,true,2539469969,28,2540994032,1524063
1651983104,197925,true,2538962152,28,2542010582,3048430
1651983217,197924,true,2539216048,28,2543281842,4065794
1651983299,197924,true,2539216048,28,2544299307,5083259
1651983385,197923,true,2539469969,28,2545571711,6101742
1651983429,197925,true,2538962152,28,2546080851,7118699
1651983471,197923,true,2539469969,28,2546590093,7120124
1651983523,197922,true,2539723916,28,2547099436,7375520
1651983661,197922,true,2539723916,28,2548373241,8649325
1651983758,197923,true,2539469969,28,2549392743,9922774
1651983872,197922,true,2539723916,28,2550157637,10433721
1651983897,197921,true,2539977889,28,2550412653,10434764
1651983903,197920,true,2540231887,28,2550412653,10180766
1651983948,197921,true,2539977889,28,2550412653,10434764
1651984031,197920,true,2540231887,28,2550667694,10435807
1651984049,197919,true,2540485910,28,2550922761,10436851
1651984286,197919,true,2540485910,28,2551688114,11202204
1651984300,197920,true,2540231887,28,2551688114,11456227
1651984339,197919,true,2540485910,28,2551943283,11457373
1651984417,197919,true,2540485910,28,2552198478,11712568
1651984440,197918,true,2540739958,28,2552198478,11458520
1651984492,197920,true,2540231887,28,2552198478,11966591
1651984515,197918,true,2540739958,28,2552453697,11713739
1651984546,197917,true,2540994032,28,2552453697,11459665
1651984570,197917,true,2540994032,28,2552453697,11459665
1651984583,197917,true,2540994032,28,2552453697,11459665
1651984604,197916,true,2541248132,28,2552708943,11460811
1651984666,197916,true,2541248132,28,2552708943,11460811
1651984755,197915,true,2541502257,28,2552964214,11461957
1651984806,197915,true,2541502257,28,2552708943,11206686
1651984998,197915,true,2541502257,28,2552198478,10696221
1651985046,197915,true,2541502257,28,2551943283,10441026
1651985053,197915,true,2541502257,28,2551943283,10441026
1651985157,197915,true,2541502257,28,2551432971,9930714
1651985166,197915,true,2541502257,28,2551432971,9930714
1651985183,197915,true,2541502257,28,2551177853,9675596
1651985213,197915,true,2541502257,28,2551177853,9675596
1651985257,197915,true,2541502257,28,2550922761,9420504
1651985316,197915,true,2541502257,28,2550667694,9165437
1651985332,197915,true,2541502257,28,2550412653,8910396
1651985380,197915,true,2541502257,28,2550157637,8655380
1651985408,197915,true,2541502257,28,2550157637,8655380
1651985447,197915,true,2541502257,28,2549902647,8400390
1651985490,197914,true,2541756407,28,2549647682,7891275
1651985530,197914,true,2541756407,28,2549392743,7636336
1651985571,197913,true,2542010582,28,2549392743,7382161
1651985632,197912,true,2542264783,28,2548882941,6618158
1651985657,197912,true,2542264783,28,2548882941,6618158
1651985680,197911,true,2542519010,28,2548882941,6363931
1651985686,197910,true,2542773262,28,2548628078,5854816
1651985765,197909,true,2543027539,28,2548373241,5345702
1651985808,197909,true,2543027539,28,2548118429,5090890
1651985873,197909,true,2543027539,28,2547608882,4581343
1651985902,197908,true,2543281842,28,2547354146,4072304
1651985939,197907,true,2543536170,28,2547099436,3563266
1651985951,197907,true,2543536170,28,2547099436,3563266
1651986009,197907,true,2543536170,28,2546590093,3053923
1651986020,197906,true,2543790524,28,2546590093,2799569
1651986061,197906,true,2543790524,28,2546080851,2290327
1651986100,197906,true,2543790524,28,2545826269,2035745
1651986170,197906,true,2543790524,28,2545317180,1526656
1651986201,197906,true,2543790524,28,2545062673,1272149
1651986217,197906,true,2543790524,28,2545062673,1272149
1651986261,197906,true,2543790524,28,2544553737,763213
1651986556,197905,true,2544044903,28,2542264783,-1780120
1651986566,197905,true,2544044903,28,2542264783,-1780120
1651986628,197905,true,2544044903,28,2542010582,-2034321
1651986716,197905,true,2544044903,28,2541756407,-2288496
1651986729,197905,true,2544044903,28,2541756407,-2288496
1651986732,197904,true,2544299307,28,2541756407,-2542900
1651986779,197905,true,2544044903,28,2541502257,-2542646
1651986796,197905,true,2544044903,28,2541502257,-2542646
1651986845,197904,true,2544299307,28,2541502257,-2797050
1651986865,197904,true,2544299307,28,2541248132,-3051175
1651986899,197904,true,2544299307,28,2541248132,-3051175
1651986915,197904,true,2544299307,28,2541248132,-3051175
1651986950,197904,true,2544299307,28,2540994032,-3305275
1651986958,197903,true,2544553737,28,2540994032,-3559705
1651986993,197903,true,2544553737,28,2540994032,-3559705
1651986995,197903,true,2544553737,28,2540994032,-3559705
1651987063,197903,true,2544553737,28,2540739958,-3813779
1651987073,197902,true,2544808193,28,2540739958,-4068235
1651987185,197902,true,2544808193,28,2540485910,-4322283
1651987204,197902,true,2544808193,28,2540231887,-4576306
1651987276,197902,true,2544808193,28,2540231887,-4576306
1651987298,197901,true,2545062673,28,2539977889,-5084784
1651987320,197901,true,2545062673,28,2539977889,-5084784
1651987349,197901,true,2545062673,28,2539977889,-5084784
1651987385,197901,true,2545062673,28,2539723916,-5338757
1651987490,197901,true,2545062673,28,2539469969,-5592704
1651987506,197901,true,2545062673,28,2539469969,-5592704
1651987555,197901,true,2545062673,28,2539216048,-5846625
1651987567,197901,true,2545062673,28,2539216048,-5846625
1651987599,197901,true,2545062673,28,2539216048,-5846625
1651987642,197901,true,2545062673,28,2539216048,-5846625
1651987678,197901,true,2545062673,28,2539216048,-5846625
1651987707,197901,true,2545062673,28,2538962152,-6100521
1651987734,197901,true,2545062673,28,2538962152,-6100521
1651987747,197902,true,2544808193,28,2538962152,-5846041
1651987780,197902,true,2544808193,28,2538962152,-5846041
1651987863,197902,true,2544808193,28,2538962152,-5846041
1651987911,197903,true,2544553737,28,2538962152,-5591585
1651987974,197903,true,2544553737,28,2538962152,-5591585
1651987987,197903,true,2544553737,28,2538962152,-5591585
1651988025,197904,true,2544299307,28,2538962152,-5337155
1651988027,197904,true,2544299307,28,2538962152,-5337155
1651988052,197905,true,2544044903,28,2538708281,-5336622
1651988069,197905,true,2544044903,28,2538708281,-5336622
1651988105,197906,true,2543790524,28,2538708281,-5082243
1651988134,197906,true,2543790524,28,2538708281,-5082243
1651988162,197907,true,2543536170,28,2538454435,-5081735
1651988228,197907,true,2543536170,28,2538454435,-5081735
1651988268,197908,true,2543281842,28,2538454435,-4827407
1651988342,197908,true,2543281842,28,2538200615,-5081227
1651988349,197909,true,2543027539,28,2538200615,-4826924
1651988393,197909,true,2543027539,28,2537946821,-5080718
1651988429,197910,true,2542773262,28,2537946821,-4826441
1651988444,197911,true,2542519010,28,2537946821,-4572189
1651988533,197911,true,2542519010,28,2537693051,-4825959
1651988559,197912,true,2542264783,28,2537693051,-4571732
1651988573,197913,true,2542010582,28,2537693051,-4317531
1651988584,197913,true,2542010582,28,2537693051,-4317531
1651988604,197914,true,2541756407,28,2537693051,-4063356
1651988631,197914,true,2541756407,28,2537439307,-4317100
1651988654,197915,true,2541502257,28,2537439307,-4062950
1651988657,197916,true,2541248132,28,2537439307,-3808825
1651988663,197917,true,2540994032,28,2537439307,-3554725
1651988675,197917,true,2540994032,28,2537439307,-3554725
1651988686,197918,true,2540739958,28,2537439307,-3300651
1651988698,197918,true,2540739958,28,2537439307,-3300651
1651988713,197919,true,2540485910,28,2537439307,-3046603
1651988753,197919,true,2540485910,28,2537185589,-3300321
1651988824,197920,true,2540231887,28,2537185589,-3046298
1651988833,197921,true,2539977889,28,2537185589,-2792300
1651988851,197922,true,2539723916,28,2537185589,-2538327
1651988886,197922,true,2539723916,28,2536931896,-2792020
1651988905,197923,true,2539469969,28,2536931896,-2538073
1651988911,197923,true,2539469969,28,2536931896,-2538073
1651988919,197924,true,2539216048,28,2536931896,-2284152
1651988943,197925,true,2538962152,28,2536931896,-2030256
1651989004,197925,true,2538962152,28,2536678228,-2283924
1651989048,197926,true,2538708281,28,2536678228,-2030053
1651989072,197926,true,2538708281,28,2536678228,-2030053
1651989078,197926,true,2538708281,28,2536678228,-2030053
1651989089,197927,true,2538454435,28,2536678228,-1776207
1651989099,197927,true,2538454435,28,2536424585,-2029850
1651989130,197927,true,2538454435,28,2536424585,-2029850
1651989168,197927,true,2538454435,28,2536424585,-2029850
1651989193,197928,true,2538200615,28,2536424585,-1776030
1651989204,197928,true,2538200615,28,2536424585,-1776030
1651989208,197928,true,2538200615,28,2536424585,-1776030
1651989230,197929,true,2537946821,28,2536170968,-1775853
1651989253,197929,true,2537946821,28,2536170968,-1775853
1651989257,197929,true,2537946821,28,2536170968,-1775853
1651989280,197930,true,2537693051,28,2536170968,-1522083
1651989290,197930,true,2537693051,28,2536170968,-1522083
1651989315,197931,true,2537439307,28,2536170968,-1268339
1651989321,197931,true,2537439307,28,2536170968,-1268339
1651989564,197931,true,2537439307,28,2535663810,-1775497
1651989640,197931,true,2537439307,28,2535410269,-2029038
1651989749,197932,true,2537185589,28,2535410269,-1775320
1651989772,197932,true,2537185589,28,2535156753,-2028836
1651989801,197932,true,2537185589,28,2535156753,-2028836
1651989818,197933,true,2536931896,28,2535156753,-1775143
1651989877,197933,true,2536931896,28,2535410269,-1521627
1651989916,197933,true,2536931896,28,2535410269,-1521627
1651990002,197933,true,2536931896,28,2535663810,-1268086
1651990046,197933,true,2536931896,28,2535663810,-1268086
1651990120,197933,true,2536931896,28,2535917376,-1014520
1651990171,197933,true,2536931896,28,2535917376,-1014520
1651990279,197933,true,2536931896,28,2536170968,-760928
1651990300,197933,true,2536931896,28,2536170968,-760928
1651990321,197933,true,2536931896,28,2536170968,-760928
1651990355,197933,true,2536931896,28,2536170968,-760928
1651990372,197933,true,2536931896,28,2536424585,-507311
1651990375,197933,true,2536931896,28,2536424585,-507311
1651990445,197933,true,2536931896,28,2536678228,-253668
1651990605,197932,true,2537185589,28,2537185589,0
1651990639,197932,true,2537185589,28,2537185589,0
1651990653,197932,true,2537185589,28,2537185589,0
1651990736,197932,true,2537185589,28,2537693051,507462
1651990742,197932,true,2537185589,28,2537693051,507462
1651990766,197932,true,2537185589,28,2537693051,507462
1651990862,197932,true,2537185589,28,2537946821,761232
1651990910,197932,true,2537185589,28,2538200615,1015026
1651990950,197932,true,2537185589,28,2538454435,1268846
1651991071,197932,true,2537185589,28,2538708281,1522692
1651991078,197932,true,2537185589,28,2538708281,1522692
1651991132,197932,true,2537185589,28,2538962152,1776563
1651991146,197931,true,2537439307,28,2538962152,1522845
1651991176,197931,true,2537439307,28,2539216048,1776741
1651991199,197931,true,2537439307,28,2539216048,1776741
1651991201,197931,true,2537439307,28,2539216048,1776741
1651991221,197931,true,2537439307,28,2539216048,1776741
1651991249,197931,true,2537439307,28,2539469969,2030662
1651991313,197931,true,2537439307,28,2539723916,2284609
1651991382,197931,true,2537439307,28,2539977889,2538582
1651991385,197930,true,2537693051,28,2539977889,2284838
1651991459,197930,true,2537693051,28,2540485910,2792859
1651991485,197930,true,2537693051,28,2540485910,2792859
1651991526,197930,true,2537693051,28,2540739958,3046907
1651991555,197930,true,2537693051,28,2540739958,3046907
1651991617,197930,true,2537693051,28,2540994032,3300981
1651991655,197930,true,2537693051,28,2541248132,3555081
1651991675,197929,true,2537946821,28,2541248132,3301311
1651991697,197929,true,2537946821,28,2541248132,3301311
1651991715,197929,true,2537946821,28,2541248132,3301311
1651991737,197929,true,2537946821,28,2541502257,3555436
1651991744,197929,true,2537946821,28,2541502257,3555436
1651991766,197928,true,2538200615,28,2541502257,3301642
1651991822,197928,true,2538200615,28,2541756407,3555792
1651991980,197928,true,2538200615,28,2542264783,4064168
1651991991,197928,true,2538200615,28,2542519010,4318395
1651992064,197927,true,2538454435,28,2542773262,4318827
1651992069,197927,true,2538454435,28,2542773262,4318827
1651992082,197927,true,2538454435,28,2542773262,4318827
1651992133,197926,true,2538708281,28,2543027539,4319258
1651992148,197926,true,2538708281,28,2543027539,4319258
1651992159,197926,true,2538708281,28,2543281842,4573561
1651992285,197925,true,2538962152,28,2543536170,4574018
1651992350,197925,true,2538962152,28,2543790524,4828372
1651992448,197924,true,2539216048,28,2544044903,4828855
1651992466,197924,true,2539216048,28,2544299307,5083259
1651992631,197923,true,2539469969,28,2545317180,5847211
1651992669,197922,true,2539723916,28,2545826269,6102353
1651992755,197921,true,2539977889,28,2546335459,6357570
1651992760,197921,true,2539977889,28,2546335459,6357570
1651992780,197920,true,2540231887,28,2546590093,6358206
1651992795,197919,true,2540485910,28,2546844752,6358842
1651992821,197918,true,2540739958,28,2547099436,6359478
1651992918,197917,true,2540994032,28,2548118429,7124397
1651992978,197916,true,2541248132,28,2548628078,7379946
1651993003,197916,true,2541248132,28,2548882941,7634809
1651993006,197914,true,2541756407,28,2548882941,7126534
1651993060,197914,true,2541756407,28,2549392743,7636336
1651993082,197913,true,2542010582,28,2549647682,7637100
1651993088,197912,true,2542264783,28,2549647682,7382899
1651993137,197911,true,2542519010,28,2550157637,7638627
1651993165,197910,true,2542773262,28,2550412653,7639391
1651993166,197909,true,2543027539,28,2550412653,7385114
1651993183,197909,true,2543027539,28,2550667694,7640155
1651993188,197907,true,2543536170,28,2550667694,7131524
1651993193,197907,true,2543536170,28,2550667694,7131524
1651993249,197906,true,2543790524,28,2551177853,7387329
1651993265,197905,true,2544044903,28,2551432971,7388068
1651993324,197904,true,2544299307,28,2551943283,7643976
1651993348,197903,true,2544553737,28,2552198478,7644741
1651993390,197902,true,2544808193,28,2552708943,7900750
1651993425,197901,true,2545062673,28,2552964214,7901541
1651993498,197900,true,2545317180,28,2553730180,8413000
1651993524,197900,true,2545317180,28,2553985553,8668373
1651993583,197899,true,2545571711,28,2554496375,8924664
1651993754,197898,true,2545826269,28,2555773879,9947610
1651993801,197897,true,2546080851,28,2556285059,10204208
1651993813,197896,true,2546335459,28,2556285059,9949600
1651993816,197895,true,2546590093,28,2556285059,9694966
1651993838,197894,true,2546844752,28,2556540688,9695936
1651993893,197893,true,2547099436,28,2556796342,9696906
1651993899,197893,true,2547099436,28,2557052021,9952585
1651993932,197892,true,2547354146,28,2557307727,9953581
1651993977,197891,true,2547608882,28,2557563457,9954575
1651994057,197890,true,2547863643,28,2558074996,10211353
1651994068,197889,true,2548118429,28,2558074996,9956567
1651994126,197888,true,2548373241,28,2558586636,10213395
1651994130,197887,true,2548628078,28,2558586636,9958558
1651994213,197886,true,2548882941,28,2559354289,10471348
1651994251,197886,true,2548882941,28,2559610224,10727283
1651994288,197885,true,2549137829,28,2559610224,10472395
1651994352,197884,true,2549392743,28,2559866185,10473442
1651994391,197883,true,2549647682,28,2560122172,10474490
1651994492,197882,true,2549902647,28,2560378184,10475537
1651994556,197881,true,2550157637,28,2560378184,10220547
1651994573,197880,true,2550412653,28,2560378184,9965531
1651994734,197879,true,2550667694,28,2560378184,9710490
1651994775,197879,true,2550667694,28,2560378184,9710490
1651994819,197878,true,2550922761,28,2560378184,9455423
1651994869,197877,true,2551177853,28,2560378184,9200331
1651994873,197876,true,2551432971,28,2560378184,8945213
1651994946,197875,true,2551688114,28,2560378184,8690070
1651994994,197874,true,2551943283,28,2560378184,8434901
1651995031,197874,true,2551943283,28,2560378184,8434901
1651995061,197873,true,2552198478,28,2560378184,8179706
1651995091,197872,true,2552453697,28,2560378184,7924487
1651995138,197871,true,2552708943,28,2560378184,7669241
1651995149,197871,true,2552708943,28,2560378184,7669241
1651995202,197870,true,2552964214,28,2560378184,7413970
1651995476,197869,true,2553219510,28,2560378184,7158674
1651995545,197868,true,2553474832,28,2560378184,6903352
1651995588,197868,true,2553474832,28,2560378184,6903352
1651995621,197867,true,2553730180,28,2560378184,6648004
1651995738,197867,true,2553730180,28,2560378184,6648004
1651995747,197866,true,2553985553,28,2560378184,6392631
1651995765,197865,true,2554240951,28,2560378184,6137233
1651995777,197865,true,2554240951,28,2560378184,6137233
1651995800,197864,true,2554496375,28,2560378184,5881809
1651995806,197863,true,2554751825,28,2560378184,5626359
1651995845,197863,true,2554751825,28,2560378184,5626359
1651995909,197862,true,2555007300,28,2560378184,5370884
1651995960,197861,true,2555262801,28,2560378184,5115383
1651995977,197861,true,2555262801,28,2560378184,5115383
1651996016,197860,true,2555518327,28,2560378184,4859857
1651996033,197859,true,2555773879,28,2560378184,4604305
1651996160,197859,true,2555773879,28,2560378184,4604305
1651996210,197858,true,2556029456,28,2560378184,4348728
1651996216,197857,true,2556285059,28,2560378184,4093125
1651996245,197857,true,2556285059,28,2560378184,4093125
1651996250,197856,true,2556540688,28,2560378184,3837496
1651996283,197855,true,2556796342,28,2560378184,3581842
1651996372,197855,true,2556796342,28,2560378184,3581842
1651996382,197854,true,2557052021,28,2560378184,3326163
1651996402,197854,true,2557052021,28,2560378184,3326163
1651996539,197853,true,2557307727,28,2560378184,3070457
1651996619,197853,true,2557307727,28,2560378184,3070457
1651996637,197852,true,2557563457,28,2560378184,2814727
1651996660,197851,true,2557819214,28,2560378184,2558970
1651996711,197851,true,2557819214,28,2560378184,2558970
1651996734,197850,true,2558074996,28,2560378184,2303188
1651996787,197849,true,2558330803,28,2560378184,2047381
1651996818,197849,true,2558330803,28,2560378184,2047381
1651996853,197848,true,2558586636,28,2560378184,1791548
1651996892,197848,true,2558586636,28,2560378184,1791548
1651996936,197847,true,2558842495,28,2560378184,1535689
1651997030,197847,true,2558842495,28,2560378184,1535689
1651997090,197846,true,2559098379,28,2560378184,1279805
1651997247,197846,true,2559098379,28,2560378184,1279805
1651997271,197845,true,2559354289,28,2560378184,1023895
1651997374,197845,true,2559354289,28,2560378184,1023895
1651997455,197844,true,2559610224,28,2560378184,767960
1651997487,197844,true,2559610224,28,2560378184,767960
1651997515,197843,true,2559866185,28,2560378184,511999
1651997523,197843,true,2559866185,28,2560378184,511999
1651997557,197842,true,2560122172,28,2560378184,256012
1651997571,197842,true,2560122172,28,2560378184,256012
1651997607,197841,true,2560378184,28,2560378184,0
1651997617,197841,true,2560378184,28,2560378184,0
1651997670,197841,true,2560378184,28,2560378184,0
1651997743,197841,true,2560378184,28,2560378184,0
1651997811,197841,true,2560378184,28,2560378184,0
1651997838,197841,true,2560378184,28,2560378184,0
1651997840,197841,true,2560378184,28,2560378184,0
1651997847,197841,true,2560378184,28,2560378184,0
1651997861,197841,true,2560378184,28,2560378184,0
1651997903,197841,true,2560378184,28,2560378184,0
1651997923,197841,true,2560378184,28,2560378184,0
1651998002,197841,true,2560378184,28,2560378184,0
1651998054,197841,true,2560378184,28,2560378184,0
1651998086,197841,true,2560378184,28,2560378184,0
1651998092,197841,true,2560378184,28,2560378184,0
1651998132,197841,true,2560378184,28,2560378184,0
1651998143,197841,true,2560378184,28,2560378184,0
1651998163,197841,true,2560378184,28,2560378184,0
1651998176,197841,true,2560378184,28,2560378184,0
1651998198,197841,true,2560378184,28,2560378184,0
1651998230,197841,true,2560378184,28,2560378184,0
1651998260,197841,true,2560378184,28,2560378184,0
1651998294,197841,true,2560378184,28,2560378184,0
1651998313,197841,true,2560378184,28,2560378184,0
1651998361,197841,true,2560378184,28,2560378184,0
1651998371,197841,true,2560378184,28,2560378184,0
1651998374,197841,true,2560378184,28,2560378184,0
1651998423,197841,true,2560378184,28,2560378184,0
1651998457,197841,true,2560378184,28,2560378184,0
1651998461,197841,true,2560378184,28,2560378184,0
1651998483,197841,true,2560378184,28,2560378184,0
1651998500,197841,true,2560378184,28,2560378184,0
1651998503,197841,true,2560378184,28,2560378184,0
1651998505,197841,true,2560378184,28,2560378184,0
1651998537,197841,true,2560378184,28,2560378184,0
1651998552,197841,true,2560378184,28,2560378184,0
1651998574,197841,true,2560378184,28,2560378184,0
1651998581,197841,true,2560378184,28,2560378184,0
1651998592,197841,true,2560378184,28,2560378184,0
1651998596,197841,true,2560378184,28,2560378184,0
1651998614,197841,true,2560378184,28,2560378184,0
1651998627,197841,true,2560378184,28,2560378184,0
1651998669,197841,true,2560378184,28,2560378184,0
1651998678,197841,true,2560378184,28,2560378184,0
1651998716,197841,true,2560378184,28,2560122172,-256012
1651998813,197841,true,2560378184,28,2560122172,-256012
1651998831,197842,true,2560122172,28,2559866185,-255987
1651999023,197842,true,2560122172,28,2559610224,-511948
1651999056,197842,true,2560122172,28,2559354289,-767883
1651999065,197842,true,2560122172,28,2559354289,-767883
1651999086,197842,true,2560122172,28,2559354289,-767883
1651999135,197842,true,2560122172,28,2559354289,-767883
1651999138,197843,true,2559866185,28,2559354289,-511896
1651999164,197843,true,2559866185,28,2559098379,-767806
1651999225,197843,true,2559866185,28,2559098379,-767806
1651999334,197843,true,2559866185,28,2558842495,-1023690
1651999372,197843,true,2559866185,28,2558586636,-1279549
1651999529,197843,true,2559866185,28,2558330803,-1535382
1651999571,197843,true,2559866185,28,2558074996,-1791189
1651999660,197844,true,2559610224,28,2558074996,-1535228
1651999676,197844,true,2559610224,28,2557819214,-1791010
1651999693,197844,true,2559610224,28,2557819214,-1791010
1651999707,197844,true,2559610224,28,2557819214,-1791010
1651999733,197844,true,2559610224,28,2557819214,-1791010
1651999752,197844,true,2559610224,28,2557819214,-1791010
1651999765,197845,true,2559354289,28,2557819214,-1535075
1651999796,197845,true,2559354289,28,2557563457,-1790832
1651999817,197845,true,2559354289,28,2557563457,-1790832
1651999856,197845,true,2559354289,28,2557563457,-1790832
1651999866,197845,true,2559354289,28,2557563457,-1790832
1651999929,197845,true,2559354289,28,2557563457,-1790832
1651999961,197845,true,2559354289,28,2557307727,-2046562
1651999975,197845,true,2559354289,28,2557307727,-2046562
1652000067,197845,true,2559354289,28,2557307727,-2046562
1652000072,197845,true,2559354289,28,2557307727,-2046562
1652000091,197845,true,2559354289,28,2557307727,-2046562
1652000117,197846,true,2559098379,28,2557307727,-1790652
1652000128,197846,true,2559098379,28,2557052021,-2046358
1652000151,197846,true,2559098379,28,2557052021,-2046358
1652000188,197846,true,2559098379,28,2557052021,-2046358
1652000312,197846,true,2559098379,28,2556796342,-2302037
1652000344,197846,true,2559098379,28,2556796342,-2302037
1652000405,197846,true,2559098379,28,2556796342,-2302037
1652000440,197846,true,2559098379,28,2556796342,-2302037
1652000459,197846,true,2559098379,28,2556796342,-2302037
1652000477,197846,true,2559098379,28,2556796342,-2302037
1652000531,197846,true,2559098379,28,2556796342,-2302037
1652000538,197847,true,2558842495,28,2556796342,-2046153
1652000555,197847,true,2558842495,28,2556796342,-2046153
1652000654,197847,true,2558842495,28,2557052021,-1790474
1652000666,197847,true,2558842495,28,2557052021,-1790474
1652000679,197847,true,2558842495,28,2557052021,-1790474
1652000746,197847,true,2558842495,28,2557052021,-1790474
1652000768,197847,true,2558842495,28,2557052021,-1790474
1652000810,197847,true,2558842495,28,2557052021,-1790474
1652000840,197847,true,2558842495,28,2557307727,-1534768
1652000896,197847,true,2558842495,28,2557307727,-1534768
1652000927,197847,true,2558842495,28,2557307727,-1534768
1652000975,197848,true,2558586636,28,2557307727,-1278909
1652001056,197848,true,2558586636,28,2557307727,-1278909
1652001124,197848,true,2558586636,28,2557563457,-1023179
1652001175,197848,true,2558586636,28,2557563457,-1023179
1652001200,197848,true,2558586636,28,2557563457,-1023179
1652001222,197848,true,2558586636,28,2557563457,-1023179
1652001226,197848,true,2558586636,28,2557563457,-1023179
1652001266,197848,true,2558586636,28,2557563457,-1023179
1652001279,197848,true,2558586636,28,2557563457,-1023179
1652001316,197848,true,2558586636,28,2557563457,-1023179
1652001375,197848,true,2558586636,28,2557819214,-767422
1652001389,197849,true,2558330803,28,2557819214,-511589
1652001406,197849,true,2558330803,28,2557819214,-511589
1652001416,197849,true,2558330803,28,2557819214,-511589
1652001442,197849,true,2558330803,28,2557819214,-511589
1652001472,197849,true,2558330803,28,2557819214,-511589
1652001502,197849,true,2558330803,28,2557819214,-511589
1652001529,197849,true,2558330803,28,2557819214,-511589
1652001537,197849,true,2558330803,28,2557819214,-511589
1652001547,197849,true,2558330803,28,2557819214,-511589
1652001550,197849,true,2558330803,28,2557819214,-511589
1652001607,197849,true,2558330803,28,2557819214,-511589
1652001625,197849,true,2558330803,28,2557819214,-511589
1652001661,197850,true,2558074996,28,2557819214,-255782
1652001665,197850,true,2558074996,28,2557819214,-255782
1652001689,197850,true,2558074996,28,2557819214,-255782
1652001694,197850,true,2558074996,28,2557819214,-255782
1652001720,197850,true,2558074996,28,2557819214,-255782
1652001721,197850,true,2558074996,28,2557819214,-255782
1652001767,197850,true,2558074996,28,2557819214,-255782
1652001768,197850,true,2558074996,28,2557819214,-255782
1652001796,197850,true,2558074996,28,2557819214,-255782
1652001801,197850,true,2558074996,28,2557819214,-255782
1652001846,197850,true,2558074996,28,2557819214,-255782
1652001854,197851,true,2557819214,28,2557819214,0
1652001921,197851,true,2557819214,28,2557819214,0
1652001928,197851,true,2557819214,28,2557819214,0
1652001976,197851,true,2557819214,28,2557819214,0
1652001989,197851,true,2557819214,28,2557819214,0
1652001996,197851,true,2557819214,28,2557819214,0
1652002009,197851,true,2557819214,28,2557819214,0
1652002022,197851,true,2557819214,28,2557819214,0
1652002072,197851,true,2557819214,28,2557819214,0
1652002090,197851,true,2557819214,28,2557819214,0
1652002164,197851,true,2557819214,28,2557819214,0
1652002165,197852,true,2557563457,28,2557819214,255757
1652002207,197852,true,2557563457,28,2557819214,255757
1652002247,197852,true,2557563457,28,2557819214,255757
1652002259,197852,true,2557563457,28,2557819214,255757
1652002281,197852,true,2557563457,28,2557819214,255757
1652002298,197852,true,2557563457,28,2557819214,255757
1652002305,197852,true,2557563457,28,2557819214,255757
1652002318,197852,true,2557563457,28,2557819214,255757
1652002327,197852,true,2557563457,28,2557819214,255757
1652002376,197852,true,2557563457,28,2557819214,255757
1652002409,197852,true,2557563457,28,2557819214,255757
1652002453,197852,true,2557563457,28,2557819214,255757
1652002523,197852,true,2557563457,28,2557819214,255757
1652002614,197852,true,2557563457,28,2557819214,255757
1652002639,197852,true,2557563457,28,2557819214,255757
1652002677,197852,true,2557563457,28,2557819214,255757
1652002783,197852,true,2557563457,28,2557819214,255757
1652002810,197852,true,2557563457,28,2557819214,255757
1652002896,197852,true,2557563457,28,2557819214,255757
1652002905,197852,true,2557563457,28,2557819214,255757
1652003001,197852,true,2557563457,28,2557819214,255757
1652003021,197852,true,2557563457,28,2557819214,255757
1652003079,197852,true,2557563457,28,2557563457,0
1652003084,197852,true,2557563457,28,2557563457,0
1652003128,197852,true,2557563457,28,2557563457,0
1652003136,197852,true,2557563457,28,2557563457,0
1652003161,197852,true,2557563457,28,2557563457,0
1652003181,197852,true,2557563457,28,2557563457,0
1652003223,197852,true,2557563457,28,2557563457,0
1652003271,197852,true,2557563457,28,2557307727,-255730
1652003290,197852,true,2557563457,28,2557307727,-255730
1652003317,197852,true,2557563457,28,2557307727,-255730
1652003329,197852,true,2557563457,28,2557307727,-255730
1652003352,197852,true,2557563457,28,2557307727,-255730
1652003386,197852,true,2557563457,28,2557307727,-255730
1652003398,197852,true,2557563457,28,2557052021,-511436
1652003435,197852,true,2557563457,28,2557052021,-511436
1652003465,197852,true,2557563457,28,2557052021,-511436
1652003476,197852,true,2557563457,28,2557052021,-511436
1652003481,197852,true,2557563457,28,2557052021,-511436
1652003502,197853,true,2557307727,28,2557052021,-255706
1652003518,197853,true,2557307727,28,2557052021,-255706
1652003589,197853,true,2557307727,28,2556796342,-511385
1652003666,197853,true,2557307727,28,2556796342,-511385
1652003672,197853,true,2557307727,28,2556796342,-511385
1652003684,197853,true,2557307727,28,2556796342,-511385
1652003722,197853,true,2557307727,28,2556540688,-767039
1652003750,197853,true,2557307727,28,2556540688,-767039
1652003762,197853,true,2557307727,28,2556540688,-767039
1652003787,197854,true,2557052021,28,2556540688,-511333
1652003835,197854,true,2557052021,28,2556540688,-511333
1652003873,197854,true,2557052021,28,2556285059,-766962
1652003878,197854,true,2557052021,28,2556285059,-766962
1652003899,197854,true,2557052021,28,2556285059,-766962
1652003940,197854,true,2557052021,28,2556285059,-766962
1652003954,197854,true,2557052021,28,2556285059,-766962
1652003965,197854,true,2557052021,28,2556285059,-766962
1652004006,197854,true,2557052021,28,2556029456,-1022565
1652004030,197855,true,2556796342,28,2556029456,-766886
1652004056,197855,true,2556796342,28,2556029456,-766886
1652004188,197855,true,2556796342,28,2555773879,-1022463
1652004197,197855,true,2556796342,28,2555773879,-1022463
1652004221,197855,true,2556796342,28,2555773879,-1022463
1652004235,197855,true,2556796342,28,2555773879,-1022463
1652004266,197855,true,2556796342,28,2555773879,-1022463
1652004291,197855,true,2556796342,28,2555773879,-1022463
1652004347,197855,true,2556796342,28,2555518327,-1278015
1652004370,197856,true,2556540688,28,2555518327,-1022361
1652004389,197856,true,2556540688,28,2555518327,-1022361
1652004437,197856,true,2556540688,28,2555262801,-1277887
1652004479,197856,true,2556540688,28,2555262801,-1277887
1652004488,197856,true,2556540688,28,2555262801,-1277887
1652004493,197856,true,2556540688,28,2555262801,-1277887
1652004547,197856,true,2556540688,28,2555007300,-1533388
1652004576,197857,true,2556285059,28,2555007300,-1277759
1652004592,197857,true,2556285059,28,2555007300,-1277759
1652004615,197857,true,2556285059,28,2555007300,-1277759
1652004626,197857,true,2556285059,28,2555007300,-1277759
1652004691,197857,true,2556285059,28,2554751825,-1533234
1652004704,197857,true,2556285059,28,2554751825,-1533234
1652004711,197857,true,2556285059,28,2554751825,-1533234
1652004768,197858,true,2556029456,28,2554751825,-1277631
1652004801,197858,true,2556029456,28,2554751825,-1277631
1652004830,197858,true,2556029456,28,2554751825,-1277631
1652004851,197858,true,2556029456,28,2554496375,-1533081
1652004858,197858,true,2556029456,28,2554496375,-1533081
1652004885,197858,true,2556029456,28,2554496375,-1533081
1652004972,197858,true,2556029456,28,2554496375,-1533081
1652005097,197859,true,2555773879,28,2554496375,-1277504
1652005123,197859,true,2555773879,28,2554496375,-1277504
1652005154,197859,true,2555773879,28,2554496375,-1277504
1652005182,197859,true,2555773879,28,2554496375,-1277504
1652005225,197859,true,2555773879,28,2554240951,-1532928
1652005257,197859,true,2555773879,28,2554240951,-1532928
1652005359,197859,true,2555773879,28,2554240951,-1532928
1652005498,197860,true,2555518327,28,2554240951,-1277376
1652005505,197860,true,2555518327,28,2554240951,-1277376
1652005534,197860,true,2555518327,28,2554240951,-1277376
1652005565,197860,true,2555518327,28,2554240951,-1277376
1652005587,197860,true,2555518327,28,2554240951,-1277376
1652005659,197860,true,2555518327,28,2553985553,-1532774
1652005661,197860,true,2555518327,28,2553985553,-1532774
1652005669,197861,true,2555262801,28,2553985553,-1277248
1652005697,197861,true,2555262801,28,2553985553,-1277248
1652005714,197861,true,2555262801,28,2553985553,-1277248
1652005771,197861,true,2555262801,28,2553985553,-1277248
1652005773,197861,true,2555262801,28,2553985553,-1277248
1652005791,197861,true,2555262801,28,2553985553,-1277248
1652005811,197861,true,2555262801,28,2553985553,-1277248
1652005830,197862,true,2555007300,28,2553985553,-1021747
1652005838,197862,true,2555007300,28,2553985553,-1021747
1652005855,197862,true,2555007300,28,2553985553,-1021747
1652005862,197862,true,2555007300,28,2553985553,-1021747
1652005874,197862,true,2555007300,28,2553985553,-1021747
1652005880,197862,true,2555007300,28,2553985553,-1021747
1652005921,197862,true,2555007300,28,2553985553,-1021747
1652005929,197863,true,2554751825,28,2553985553,-766272
1652005969,197863,true,2554751825,28,2553985553,-766272
1652006001,197863,true,2554751825,28,2553985553,-766272
1652006009,197863,true,2554751825,28,2553985553,-766272
1652006052,197863,true,2554751825,28,2553985553,-766272
1652006139,197863,true,2554751825,28,2553730180,-1021645
1652006219,197863,true,2554751825,28,2553985553,-766272
1652006229,197863,true,2554751825,28,2553985553,-766272
1652006243,197864,true,2554496375,28,2553985553,-510822
1652006262,197864,true,2554496375,28,2553985553,-510822
1652006291,197864,true,2554496375,28,2553985553,-510822
1652006303,197864,true,2554496375,28,2553985553,-510822
1652006309,197864,true,2554496375,28,2553985553,-510822
1652006312,197864,true,2554496375,28,2553985553,-510822
1652006328,197864,true,2554496375,28,2553985553,-510822
1652006362,197864,true,2554496375,28,2553985553,-510822
1652006381,197864,true,2554496375,28,2553985553,-510822
1652006430,197864,true,2554496375,28,2553985553,-510822
1652006485,197864,true,2554496375,28,2553985553,-510822
1652006615,197864,true,2554496375,28,2553985553,-510822
1652006649,197865,true,2554240951,28,2553985553,-255398
1652006661,197865,true,2554240951,28,2553985553,-255398
1652006709,197865,true,2554240951,28,2553985553,-255398
1652006780,197865,true,2554240951,28,2554240951,0
1652006806,197865,true,2554240951,28,2554240951,0
1652006809,197865,true,2554240951,28,2554240951,0
1652006850,197864,true,2554496375,28,2554240951,-255424
1652006852,197864,true,2554496375,28,2554240951,-255424
1652006877,197864,true,2554496375,28,2554496375,0
1652006890,197864,true,2554496375,28,2554496375,0
1652006914,197863,true,2554751825,28,2554751825,0
1652006934,197863,true,2554751825,28,2554751825,0
1652006950,197862,true,2555007300,28,2555007300,0
1652006957,197862,true,2555007300,28,2555007300,0
1652006975,197861,true,2555262801,28,2555007300,-255501
1652007005,197861,true,2555262801,28,2555262801,0
1652007050,197861,true,2555262801,28,2555518327,255526
1652007095,197861,true,2555262801,28,2555773879,511078
1652007153,197860,true,2555518327,28,2556285059,766732
1652007166,197860,true,2555518327,28,2556285059,766732
1652007202,197859,true,2555773879,28,2556540688,766809
1652007211,197859,true,2555773879,28,2556540688,766809
1652007219,197858,true,2556029456,28,2556796342,766886
1652007250,197858,true,2556029456,28,2556796342,766886
1652007274,197858,true,2556029456,28,2557052021,1022565
1652007294,197858,true,2556029456,28,2557307727,1278271
1652007348,197857,true,2556285059,28,2557563457,1278398
1652007378,197857,true,2556285059,28,2557819214,1534155
1652007457,197856,true,2556540688,28,2558330803,1790115
1652007520,197856,true,2556540688,28,2558586636,2045948
1652007526,197855,true,2556796342,28,2558842495,2046153
1652007540,197855,true,2556796342,28,2558842495,2046153
1652007577,197855,true,2556796342,28,2559098379,2302037
1652007631,197855,true,2556796342,28,2559354289,2557947
1652007651,197854,true,2557052021,28,2559610224,2558203
1652007691,197854,true,2557052021,28,2559866185,2814164
1652007706,197853,true,2557307727,28,2559866185,2558458
1652007713,197853,true,2557307727,28,2559866185,2558458
1652007758,197852,true,2557563457,28,2560122172,2558715
1652007812,197852,true,2557563457,28,2560634222,3070765
1652007814,197852,true,2557563457,28,2560634222,3070765
1652007832,197852,true,2557563457,28,2560634222,3070765
1652007835,197851,true,2557819214,28,2560634222,2815008
1652007933,197851,true,2557819214,28,2561402489,3583275
1652008014,197850,true,2558074996,28,2561914795,3839799
1652008052,197850,true,2558074996,28,2562170987,4095991
1652008085,197849,true,2558330803,28,2562427204,4096401
1652008133,197849,true,2558330803,28,2562683447,4352644
1652008188,197848,true,2558586636,28,2562939715,4353079
1652008192,197848,true,2558586636,28,2562939715,4353079
1652008201,197848,true,2558586636,28,2562939715,4353079
1652008222,197847,true,2558842495,28,2563196009,4353514
1652008299,197847,true,2558842495,28,2563708674,4866179
1652008324,197846,true,2559098379,28,2563965045,4866666
1652008373,197846,true,2559098379,28,2564221441,5123062
1652008388,197845,true,2559354289,28,2564221441,4867152
1652008441,197845,true,2559354289,28,2564734311,5380022
1652008524,197845,true,2559354289,28,2565247284,5892995
1652008552,197844,true,2559610224,28,2565503808,5893584
1652008559,197844,true,2559610224,28,2565503808,5893584
1652008563,197843,true,2559866185,28,2565503808,5637623
1652008675,197843,true,2559866185,28,2566016935,6150750
1652008693,197842,true,2560122172,28,2566016935,5894763
1652008725,197842,true,2560122172,28,2566016935,5894763
1652008773,197841,true,2560378184,28,2566016935,5638751
1652008779,197841,true,2560378184,28,2566016935,5638751
1652008806,197840,true,2560634222,28,2566016935,5382713
1652008820,197840,true,2560634222,28,2566016935,5382713
1652008834,197839,true,2560890286,28,2566016935,5126649
1652008871,197839,true,2560890286,28,2566016935,5126649
1652008897,197838,true,2561146375,28,2566016935,4870560
1652008907,197838,true,2561146375,28,2566016935,4870560
1652008916,197837,true,2561402489,28,2566016935,4614446
1652008931,197837,true,2561402489,28,2566273536,4871047
1652008962,197837,true,2561402489,28,2566273536,4871047
1652008977,197836,true,2561658629,28,2566273536,4614907
1652008987,197836,true,2561658629,28,2566273536,4614907
1652008995,197836,true,2561658629,28,2566273536,4614907
1652009008,197835,true,2561914795,28,2566273536,4358741
1652009020,197834,true,2562170987,28,2566273536,4102549
1652009053,197834,true,2562170987,28,2566273536,4102549
1652009072,197834,true,2562170987,28,2566273536,4102549
1652009083,197833,true,2562427204,28,2566273536,3846332
1652009109,197833,true,2562427204,28,2566273536,3846332
1652009154,197832,true,2562683447,28,2566273536,3590089
1652009172,197832,true,2562683447,28,2566273536,3590089
1652009182,197831,true,2562939715,28,2566273536,3333821
1652009207,197831,true,2562939715,28,2566273536,3333821
1652009214,197830,true,2563196009,28,2566273536,3077527
1652009222,197830,true,2563196009,28,2566273536,3077527
1652009289,197829,true,2563452328,28,2566530164,3077836
1652009320,197829,true,2563452328,28,2566530164,3077836
1652009340,197828,true,2563708674,28,2566530164,2821490
1652009359,197828,true,2563708674,28,2566530164,2821490
1652009370,197827,true,2563965045,28,2566530164,2565119
1652009407,197827,true,2563965045,28,2566530164,2565119
1652009502,197826,true,2564221441,28,2566786817,2565376
1652009577,197826,true,2564221441,28,2566786817,2565376
1652009626,197825,true,2564477863,28,2567043495,2565632
1652009641,197825,true,2564477863,28,2567043495,2565632
1652009649,197824,true,2564734311,28,2567043495,2309184
1652009740,197824,true,2564734311,28,2567300200,2565889
1652009814,197823,true,2564990784,28,2567300200,2309416
1652009840,197823,true,2564990784,28,2567300200,2309416
1652009956,197822,true,2565247284,28,2567556930,2309646
1652009967,197822,true,2565247284,28,2567556930,2309646
1652009985,197821,true,2565503808,28,2567556930,2053122
1652010017,197821,true,2565503808,28,2567813685,2309877
1652010036,197820,true,2565760359,28,2567813685,2053326
1652010050,197820,true,2565760359,28,2567813685,2053326
1652010068,197819,true,2566016935,28,2567813685,1796750
1652010090,197819,true,2566016935,28,2567813685,1796750
1652010212,197818,true,2566273536,28,2567813685,1540149
1652010308,197818,true,2566273536,28,2568070467,1796931
1652010352,197817,true,2566530164,28,2568070467,1540303
1652010369,197817,true,2566530164,28,2568070467,1540303
1652010398,197816,true,2566786817,28,2568070467,1283650
1652010422,197816,true,2566786817,28,2568070467,1283650
1652010439,197816,true,2566786817,28,2568070467,1283650
1652010468,197815,true,2567043495,28,2568327274,1283779
1652010498,197815,true,2567043495,28,2568327274,1283779
1652010526,197815,true,2567043495,28,2568327274,1283779
1652010557,197815,true,2567043495,28,2568327274,1283779
1652010574,197815,true,2567043495,28,2568327274,1283779
1652010586,197815,true,2567043495,28,2568327274,1283779
1652010629,197815,true,2567043495,28,2568327274,1283779
1652010636,197815,true,2567043495,28,2568327274,1283779
1652010660,197814,true,2567300200,28,2568327274,1027074
1652010675,197814,true,2567300200,28,2568584107,1283907
1652010716,197814,true,2567300200,28,2568584107,1283907
1652010747,197814,true,2567300200,28,2568584107,1283907
1652010752,197814,true,2567300200,28,2568584107,1283907
1652010783,197814,true,2567300200,28,2568584107,1283907
1652010799,197814,true,2567300200,28,2568584107,1283907
1652010826,197814,true,2567300200,28,2568584107,1283907
1652010860,197814,true,2567300200,28,2568584107,1283907
1652010865,197813,true,2567556930,28,2568584107,1027177
1652010893,197813,true,2567556930,28,2568584107,1027177
1652010925,197813,true,2567556930,28,2568840965,1284035
1652011086,197813,true,2567556930,28,2568840965,1284035
1652011127,197813,true,2567556930,28,2568840965,1284035
1652011138,197813,true,2567556930,28,2568840965,1284035
1652011151,197813,true,2567556930,28,2568840965,1284035
1652011216,197813,true,2567556930,28,2568840965,1284035
1652011251,197812,true,2567813685,28,2568840965,1027280
1652011277,197812,true,2567813685,28,2568840965,1027280
1652011301,197812,true,2567813685,28,2568840965,1027280
1652011334,197812,true,2567813685,28,2568840965,1027280
1652011451,197812,true,2567813685,28,2568840965,1027280
1652011656,197812,true,2567813685,28,2568840965,1027280
1652011686,197812,true,2567813685,28,2568840965,1027280
1652011762,197812,true,2567813685,28,2568840965,1027280
1652011840,197812,true,2567813685,28,2568840965,1027280
1652011872,197811,true,2568070467,28,2568840965,770498
1652011997,197811,true,2568070467,28,2568840965,770498
1652012072,197811,true,2568070467,28,2568840965,770498
1652012137,197811,true,2568070467,28,2568840965,770498
1652012156,197811,true,2568070467,28,2569097849,1027382
1652012251,197811,true,2568070467,28,2569097849,1027382
1652012286,197811,true,2568070467,28,2569097849,1027382
1652012299,197810,true,2568327274,28,2569097849,770575
1652012303,197810,true,2568327274,28,2569097849,770575
1652012326,197810,true,2568327274,28,2569097849,770575
1652012369,197810,true,2568327274,28,2569097849,770575
1652012438,197810,true,2568327274,28,2569354759,1027485
1652012452,197810,true,2568327274,28,2569354759,1027485
1652012502,197810,true,2568327274,28,2569354759,1027485
1652012507,197809,true,2568584107,28,2569354759,770652
1652012545,197809,true,2568584107,28,2569354759,770652
1652012579,197809,true,2568584107,28,2569354759,770652
1652012651,197809,true,2568584107,28,2569354759,770652
1652012670,197809,true,2568584107,28,2569354759,770652
1652012871,197809,true,2568584107,28,2569611694,1027587
1652012882,197809,true,2568584107,28,2569611694,1027587
1652012920,197809,true,2568584107,28,2569611694,1027587
1652012924,197808,true,2568840965,28,2569611694,770729
1652012938,197808,true,2568840965,28,2569611694,770729
1652012942,197808,true,2568840965,28,2569611694,770729
1652013005,197808,true,2568840965,28,2569611694,770729
1652013022,197808,true,2568840965,28,2569611694,770729
1652013045,197808,true,2568840965,28,2569611694,770729
1652013053,197808,true,2568840965,28,2569611694,770729
1652013094,197808,true,2568840965,28,2569611694,770729
1652013128,197808,true,2568840965,28,2569611694,770729
1652013180,197808,true,2568840965,28,2569354759,513794
1652013192,197808,true,2568840965,28,2569354759,513794
1652013229,197808,true,2568840965,28,2569354759,513794
1652013242,197808,true,2568840965,28,2569354759,513794
1652013271,197808,true,2568840965,28,2569354759,513794
1652013291,197808,true,2568840965,28,2569354759,513794
1652013382,197808,true,2568840965,28,2569097849,256884
1652013413,197808,true,2568840965,28,2569097849,256884
1652013436,197808,true,2568840965,28,2569097849,256884
1652013467,197808,true,2568840965,28,2569097849,256884
1652013527,197808,true,2568840965,28,2568840965,0
1652013561,197808,true,2568840965,28,2568840965,0
1652013570,197808,true,2568840965,28,2568840965,0
1652013571,197808,true,2568840965,28,2568840965,0
1652013603,197809,true,2568584107,28,2568840965,256858
1652013642,197809,true,2568584107,28,2568840965,256858
1652013659,197809,true,2568584107,28,2568840965,256858
1652013692,197808,true,2568840965,28,2568584107,-256858
1652013697,197809,true,2568584107,28,2568584107,0
1652013770,197809,true,2568584107,28,2568584107,0
1652013780,197809,true,2568584107,28,2568584107,0
1652013792,197809,true,2568584107,28,2568584107,0
1652013809,197809,true,2568584107,28,2568584107,0
1652013885,197809,true,2568584107,28,2568327274,-256833
1652013931,197809,true,2568584107,28,2568327274,-256833
1652013980,197809,true,2568584107,28,2568070467,-513640
1652013986,197810,true,2568327274,28,2568070467,-256807
1652014034,197810,true,2568327274,28,2567813685,-513589
1652014153,197810,true,2568327274,28,2567556930,-770344
1652014168,197810,true,2568327274,28,2567556930,-770344
1652014189,197810,true,2568327274,28,2567300200,-1027074
1652014218,197810,true,2568327274,28,2567300200,-1027074
1652014222,197810,true,2568327274,28,2567300200,-1027074
1652014262,197810,true,2568327274,28,2567043495,-1283779
1652014288,197811,true,2568070467,28,2567043495,-1026972
1652014292,197811,true,2568070467,28,2567043495,-1026972
1652014330,197811,true,2568070467,28,2566786817,-1283650
1652014352,197811,true,2568070467,28,2566786817,-1283650
1652014411,197812,true,2567813685,28,2566273536,-1540149
1652014429,197812,true,2567813685,28,2566273536,-1540149
1652014439,197813,true,2567556930,28,2566273536,-1283394
1652014482,197813,true,2567556930,28,2566016935,-1539995
1652014500,197813,true,2567556930,28,2565760359,-1796571
1652014518,197813,true,2567556930,28,2565760359,-1796571
1652014522,197814,true,2567300200,28,2565760359,-1539841
1652014542,197814,true,2567300200,28,2565503808,-1796392
1652014572,197815,true,2567043495,28,2565503808,-1539687
1652014597,197815,true,2567043495,28,2565247284,-1796211
1652014623,197815,true,2567043495,28,2564990784,-2052711
1652014646,197815,true,2567043495,28,2564990784,-2052711
1652014728,197816,true,2566786817,28,2564477863,-2308954
1652014752,197816,true,2566786817,28,2564221441,-2565376
1652014825,197816,true,2566786817,28,2563965045,-2821772
1652014881,197817,true,2566530164,28,2563708674,-2821490
1652014907,197817,true,2566530164,28,2563708674,-2821490
1652014915,197817,true,2566530164,28,2563708674,-2821490
1652014928,197818,true,2566273536,28,2563452328,-2821208
1652014941,197818,true,2566273536,28,2563452328,-2821208
1652014983,197818,true,2566273536,28,2563452328,-2821208
1652015014,197819,true,2566016935,28,2563196009,-2820926
1652015057,197819,true,2566016935,28,2562939715,-3077220
1652015080,197819,true,2566016935,28,2562939715,-3077220
1652015099,197820,true,2565760359,28,2562939715,-2820644
1652015108,197820,true,2565760359,28,2562939715,-2820644
1652015134,197820,true,2565760359,28,2562683447,-3076912
1652015194,197820,true,2565760359,28,2562427204,-3333155
1652015250,197821,true,2565503808,28,2562170987,-3332821
1652015297,197821,true,2565503808,28,2562170987,-3332821
1652015325,197822,true,2565247284,28,2561914795,-3332489
1652015412,197822,true,2565247284,28,2561658629,-3588655
1652015489,197823,true,2564990784,28,2561402489,-3588295
1652015522,197823,true,2564990784,28,2561146375,-3844409
1652015534,197823,true,2564990784,28,2561146375,-3844409
1652015571,197824,true,2564734311,28,2560890286,-3844025
1652015592,197824,true,2564734311,28,2560634222,-4100089
1652015597,197825,true,2564477863,28,2560634222,-3843641
1652015690,197825,true,2564477863,28,2560122172,-4355691
1652015706,197826,true,2564221441,28,2560122172,-4099269
1652015730,197826,true,2564221441,28,2559866185,-4355256
1652015771,197827,true,2563965045,28,2559866185,-4098860
1652015807,197827,true,2563965045,28,2559610224,-4354821
1652015883,197828,true,2563708674,28,2559098379,-4610295
1652015902,197828,true,2563708674,28,2558842495,-4866179
1652015940,197829,true,2563452328,28,2558586636,-4865692
1652015947,197829,true,2563452328,28,2558586636,-4865692
1652015955,197830,true,2563196009,28,2558330803,-4865206
1652015969,197831,true,2562939715,28,2558330803,-4608912
1652015987,197832,true,2562683447,28,2558074996,-4608451
1652016041,197832,true,2562683447,28,2557819214,-4864233
1652016060,197833,true,2562427204,28,2557563457,-4863747
1652016086,197834,true,2562170987,28,2557307727,-4863260
1652016098,197835,true,2561914795,28,2557307727,-4607068
1652016191,197835,true,2561914795,28,2556796342,-5118453
1652016214,197836,true,2561658629,28,2556540688,-5117941
1652016229,197837,true,2561402489,28,2556540688,-4861801
1652016325,197838,true,2561146375,28,2556029456,-5116919
1652016348,197838,true,2561146375,28,2555773879,-5372496
1652016376,197839,true,2560890286,28,2555518327,-5371959
1652016400,197840,true,2560634222,28,2555518327,-5115895
1652016459,197841,true,2560378184,28,2555262801,-5115383
1652016466,197841,true,2560378184,28,2555007300,-5370884
1652016503,197842,true,2560122172,28,2555007300,-5114872
1652016596,197843,true,2559866185,28,2554240951,-5625234
1652016647,197844,true,2559610224,28,2553985553,-5624671
1652016681,197844,true,2559610224,28,2553730180,-5880044
1652016707,197845,true,2559354289,28,2553730180,-5624109
1652016718,197846,true,2559098379,28,2553730180,-5368199
1652016781,197846,true,2559098379,28,2553219510,-5878869
1652016822,197847,true,2558842495,28,2552964214,-5878281
1652016829,197848,true,2558586636,28,2552964214,-5622422
1652016857,197848,true,2558586636,28,2552708943,-5877693
1652016895,197849,true,2558330803,28,2552708943,-5621860
1652016938,197849,true,2558330803,28,2552453697,-5877106
1652016998,197850,true,2558074996,28,2551943283,-6131713
1652017074,197851,true,2557819214,28,2551688114,-6131100
1652017089,197851,true,2557819214,28,2551432971,-6386243
1652017157,197852,true,2557563457,28,2551177853,-6385604
1652017173,197853,true,2557307727,28,2551177853,-6129874
1652017194,197853,true,2557307727,28,2550922761,-6384966
1652017214,197854,true,2557052021,28,2550922761,-6129260
1652017267,197854,true,2557052021,28,2550667694,-6384327
1652017306,197855,true,2556796342,28,2550412653,-6383689
1652017393,197856,true,2556540688,28,2550157637,-6383051
1652017450,197856,true,2556540688,28,2549902647,-6638041
1652017487,197857,true,2556285059,28,2549902647,-6382412
1652017523,197857,true,2556285059,28,2549647682,-6637377
1652017540,197858,true,2556029456,28,2549647682,-6381774
1652017548,197858,true,2556029456,28,2549647682,-6381774
1652017568,197859,true,2555773879,28,2549647682,-6126197
1652017584,197860,true,2555518327,28,2549647682,-5870645
1652017702,197860,true,2555518327,28,2549392743,-6125584
1652017706,197861,true,2555262801,28,2549392743,-5870058
1652017727,197861,true,2555262801,28,2549392743,-5870058
1652017756,197862,true,2555007300,28,2549137829,-5869471
1652017767,197863,true,2554751825,28,2549137829,-5613996
1652017791,197863,true,2554751825,28,2549137829,-5613996
1652017828,197863,true,2554751825,28,2549137829,-5613996
1652017843,197864,true,2554496375,28,2549137829,-5358546
1652017878,197865,true,2554240951,28,2549137829,-5103122
1652017936,197865,true,2554240951,28,2549137829,-5103122
1652017952,197866,true,2553985553,28,2549137829,-4847724
1652018065,197866,true,2553985553,28,2549137829,-4847724
1652018080,197867,true,2553730180,28,2549392743,-4337437
1652018134,197867,true,2553730180,28,2549392743,-4337437
1652018267,197869,true,2553219510,28,2548118429,-5101081
1652018348,197870,true,2552964214,28,2547354146,-5610068
1652018363,197871,true,2552708943,28,2547354146,-5354797
1652018418,197872,true,2552453697,28,2546590093,-5863604
1652018510,197873,true,2552198478,28,2545571711,-6626767
1652018603,197874,true,2551943283,28,2544808193,-7135090
1652018668,197875,true,2551688114,28,2544299307,-7388807
1652018715,197876,true,2551432971,28,2544044903,-7388068
1652018743,197877,true,2551177853,28,2543790524,-7387329
1652018918,197878,true,2550922761,28,2542264783,-8657978
1652019086,197878,true,2550922761,28,2540994032,-9928729
1652019096,197879,true,2550667694,28,2540994032,-9673662
1652019244,197880,true,2550412653,28,2539469969,-10942684
1652019304,197882,true,2549902647,28,2538708281,-11194366
1652019326,197882,true,2549902647,28,2538454435,-11448212
1652019553,197883,true,2549647682,28,2536170968,-13476714
1652019584,197884,true,2549392743,28,2535663810,-13728933
1652019593,197886,true,2548882941,28,2535663810,-13219131
1652019605,197886,true,2548882941,28,2535410269,-13472672
1652019650,197888,true,2548373241,28,2534903263,-13469978
1652019676,197889,true,2548118429,28,2534649798,-13468631
1652019745,197890,true,2547863643,28,2533889555,-13974088
1652019788,197891,true,2547608882,28,2533129540,-14479342
1652020199,197893,true,2547099436,28,2529585817,-17513619
1652020201,197894,true,2546844752,28,2529585817,-17258935
1652020268,197896,true,2546335459,28,2529332884,-17002575
1652020273,197896,true,2546335459,28,2529332884,-17002575
1652020440,197898,true,2545826269,28,2528068597,-17757672
1652020463,197899,true,2545571711,28,2528068597,-17503114
1652020524,197901,true,2545062673,28,2527563059,-17499614
1652020541,197901,true,2545062673,28,2527563059,-17499614
1652020575,197903,true,2544553737,28,2527563059,-16990678
1652020606,197904,true,2544299307,28,2527310328,-16988979
1652020635,197905,true,2544044903,28,2527310328,-16734575
1652020674,197906,true,2543790524,28,2527057622,-16732902
1652020843,197907,true,2543536170,28,2526552286,-16983884
1652020894,197908,true,2543281842,28,2526299657,-16982185
1652020909,197909,true,2543027539,28,2526299657,-16727882
1652021009,197910,true,2542773262,28,2526299657,-16473605
1652021026,197911,true,2542519010,28,2526299657,-16219353
1652021041,197912,true,2542264783,28,2526299657,-15965126
1652021059,197913,true,2542010582,28,2526047052,-15963530
1652021086,197914,true,2541756407,28,2526047052,-15709355
1652021167,197915,true,2541502257,28,2525794472,-15707785
1652021172,197917,true,2540994032,28,2525794472,-15199560
1652021186,197918,true,2540739958,28,2525794472,-14945486
1652021205,197918,true,2540739958,28,2525541918,-15198040
1652021404,197920,true,2540231887,28,2525036886,-15195001
1652021413,197921,true,2539977889,28,2525036886,-14941003
1652021466,197922,true,2539723916,28,2524784407,-14939509
1652021517,197923,true,2539469969,28,2524784407,-14685562
1652021612,197924,true,2539216048,28,2524784407,-14431641
1652021779,197925,true,2538962152,28,2524784407,-14177745
1652021931,197926,true,2538708281,28,2525036886,-13671395
1652021952,197926,true,2538708281,28,2525036886,-13671395
1652022001,197927,true,2538454435,28,2525036886,-13417549
1652022092,197929,true,2537946821,28,2525036886,-12909935
1652022136,197929,true,2537946821,28,2525036886,-12909935
1652022192,197930,true,2537693051,28,2525289389,-12403662
1652022253,197931,true,2537439307,28,2525289389,-12149918
1652022334,197932,true,2537185589,28,2525289389,-11896200
1652022377,197933,true,2536931896,28,2525289389,-11642507
1652022412,197933,true,2536931896,28,2525289389,-11642507
1652022452,197934,true,2536678228,28,2525289389,-11388839
1652022459,197935,true,2536424585,28,2525289389,-11135196
1652022597,197936,true,2536170968,28,2525036886,-11134082
1652022649,197936,true,2536170968,28,2525036886,-11134082
1652022706,197937,true,2535917376,28,2524784407,-11132969
1652022784,197938,true,2535663810,28,2524784407,-10879403
1652022899,197939,true,2535410269,28,2524784407,-10625862
1652022906,197940,true,2535156753,28,2524784407,-10372346
1652022943,197941,true,2534903263,28,2524784407,-10118856
1652022983,197942,true,2534649798,28,2525036886,-9612912
1652023010,197942,true,2534649798,28,2525036886,-9612912
1652023166,197943,true,2534396358,28,2525289389,-9106969
1652023329,197944,true,2534142944,28,2525794472,-8348472
1652023501,197944,true,2534142944,28,2526299657,-7843287
1652023514,197945,true,2533889555,28,2526299657,-7589898
1652023522,197945,true,2533889555,28,2526299657,-7589898
1652023560,197946,true,2533636192,28,2526552286,-7083906
1652023606,197947,true,2533382853,28,2526804942,-6577911
1652023628,197947,true,2533382853,28,2527057622,-6325231
1652023740,197947,true,2533382853,28,2527815815,-5567038
1652023853,197948,true,2533129540,28,2528574236,-4555304
1652023866,197949,true,2532876253,28,2528574236,-4302017
1652023890,197949,true,2532876253,28,2528827093,-4049160
1652023935,197949,true,2532876253,28,2529079976,-3796277
1652024012,197950,true,2532622990,28,2529585817,-3037173
1652024185,197950,true,2532622990,28,2530850863,-1772127
1652024302,197951,true,2532369753,28,2531357059,-1012694
1652024349,197951,true,2532369753,28,2531610194,-759559
1652024398,197952,true,2532116542,28,2531863355,-253187
1652024434,197952,true,2532116542,28,2532116542,0
1652024567,197952,true,2532116542,28,2532876253,759711
1652024799,197953,true,2531863355,28,2534142944,2279589
1652024903,197954,true,2531610194,28,2534649798,3039604
1652025042,197954,true,2531610194,28,2534903263,3293069
1652025103,197954,true,2531610194,28,2535156753,3546559
1652025169,197955,true,2531357059,28,2535410269,4053210
1652025187,197956,true,2531103948,28,2535410269,4306321
1652025192,197956,true,2531103948,28,2535410269,4306321
1652025231,197957,true,2530850863,28,2535410269,4559406
1652025308,197957,true,2530850863,28,2535410269,4559406
1652025376,197958,true,2530597803,28,2535410269,4812466
1652025383,197959,true,2530344769,28,2535410269,5065500
1652025542,197959,true,2530344769,28,2534903263,4558494
1652025591,197960,true,2530091760,28,2534649798,4558038
1652025631,197961,true,2529838776,28,2534396358,4557582
1652025700,197962,true,2529585817,28,2533889555,4303738
1652025712,197963,true,2529332884,28,2533889555,4556671
1652025731,197964,true,2529079976,28,2533636192,4556216
1652025752,197965,true,2528827093,28,2533636192,4809099
1652025791,197964,true,2529079976,28,2533129540,4049564
1652025844,197965,true,2528827093,28,2532876253,4049160
1652025943,197965,true,2528827093,28,2532116542,3289449
1652025967,197966,true,2528574236,28,2531863355,3289119
1652026118,197965,true,2528827093,28,2530850863,2023770
1652026137,197966,true,2528574236,28,2530850863,2276627
1652026169,197967,true,2528321404,28,2530597803,2276399
1652026214,197967,true,2528321404,28,2530091760,1770356
1652026290,197967,true,2528321404,28,2529585817,1264413
1652026299,197967,true,2528321404,28,2529585817,1264413
1652026375,197968,true,2528068597,28,2529079976,1011379
1652026398,197969,true,2527815815,28,2528827093,1011278
1652026410,197968,true,2528068597,28,2528827093,758496
1652026551,197969,true,2527815815,28,2527815815,0
1652026659,197969,true,2527815815,28,2527057622,-758193
1652026729,197970,true,2527563059,28,2526804942,-758117
1652026736,197969,true,2527815815,28,2526804942,-1010873
1652026810,197969,true,2527815815,28,2526299657,-1516158
1652026825,197970,true,2527563059,28,2526299657,-1263402
1652026903,197970,true,2527563059,28,2525794472,-1768587
1652026912,197970,true,2527563059,28,2525794472,-1768587
1652026937,197970,true,2527563059,28,2525541918,-2021141
1652027031,197970,true,2527563059,28,2525036886,-2526173
1652027060,197970,true,2527563059,28,2525036886,-2526173
1652027099,197970,true,2527563059,28,2524784407,-2778652
1652027103,197970,true,2527563059,28,2524784407,-2778652
1652027171,197970,true,2527563059,28,2524531954,-3031105
1652027346,197970,true,2527563059,28,2524027123,-3535936
1652027360,197969,true,2527815815,28,2524027123,-3788692
1652027416,197970,true,2527563059,28,2523774746,-3788313
1652027439,197970,true,2527563059,28,2523774746,-3788313
1652027482,197970,true,2527563059,28,2524027123,-3535936
1652027484,197970,true,2527563059,28,2524027123,-3535936
1652027613,197970,true,2527563059,28,2524279526,-3283533
1652027677,197970,true,2527563059,28,2524279526,-3283533
1652027721,197970,true,2527563059,28,2524279526,-3283533
1652027773,197970,true,2527563059,28,2524531954,-3031105
1652027840,197970,true,2527563059,28,2524531954,-3031105
1652027881,197971,true,2527310328,28,2524531954,-2778374
1652027935,197971,true,2527310328,28,2524784407,-2525921
1652028023,197970,true,2527563059,28,2524784407,-2778652
1652028076,197970,true,2527563059,28,2524784407,-2778652
1652028099,197971,true,2527310328,28,2525036886,-2273442
1652028108,197970,true,2527563059,28,2525036886,-2526173
1652028160,197970,true,2527563059,28,2525036886,-2526173
1652028164,197970,true,2527563059,28,2525036886,-2526173
1652028193,197970,true,2527563059,28,2525036886,-2526173
1652028221,197970,true,2527563059,28,2525036886,-2526173
1652028243,197969,true,2527815815,28,2525289389,-2526426
1652028368,197969,true,2527815815,28,2525541918,-2273897
1652028384,197970,true,2527563059,28,2525541918,-2021141
1652028516,197969,true,2527815815,28,2525794472,-2021343
1652028663,197969,true,2527815815,28,2526047052,-1768763
1652028676,197969,true,2527815815,28,2526047052,-1768763
1652028746,197969,true,2527815815,28,2526299657,-1516158
1652028770,197969,true,2527815815,28,2526299657,-1516158
1652028879,197968,true,2528068597,28,2526552286,-1516311
1652028914,197968,true,2528068597,28,2526804942,-1263655
1652028949,197968,true,2528068597,28,2526804942,-1263655
1652028974,197968,true,2528068597,28,2526804942,-1263655
1652029015,197968,true,2528068597,28,2527057622,-1010975
1652029074,197968,true,2528068597,28,2527057622,-1010975
1652029094,197968,true,2528068597,28,2527057622,-1010975
1652029137,197968,true,2528068597,28,2527310328,-758269
1652029212,197967,true,2528321404,28,2527310328,-1011076
1652029223,197968,true,2528068597,28,2527310328,-758269
1652029284,197968,true,2528068597,28,2527310328,-758269
1652029295,197968,true,2528068597,28,2527310328,-758269
1652029322,197968,true,2528068597,28,2527057622,-1010975
1652029363,197969,true,2527815815,28,2526552286,-1263529
1652029374,197970,true,2527563059,28,2526552286,-1010773
1652029479,197971,true,2527310328,28,2525289389,-2020939
1652029670,197971,true,2527310328,28,2523270067,-4040261
1652029686,197972,true,2527057622,28,2523017765,-4039857
1652029705,197973,true,2526804942,28,2522765488,-4039454
1652029719,197974,true,2526552286,28,2522513237,-4039049
1652029803,197976,true,2526047052,28,2521000259,-5046793
1652029909,197977,true,2525794472,28,2519236264,-6558208
1652029932,197978,true,2525541918,28,2518984366,-6557552
1652029937,197979,true,2525289389,28,2518732492,-6556897
1652029939,197981,true,2524784407,28,2518732492,-6051915
1652029960,197980,true,2525036886,28,2518732492,-6304394
1652030029,197981,true,2524784407,28,2518228821,-6555586
1652030167,197981,true,2524784407,28,2517725251,-7059156
1652030402,197983,true,2524279526,28,2516970085,-7309441
1652030409,197982,true,2524531954,28,2516970085,-7561869
1652030494,197983,true,2524279526,28,2516466766,-7812760
1652030640,197983,true,2524279526,28,2515711977,-8567549
1652030722,197985,true,2523774746,28,2515208910,-8565836
1652030771,197985,true,2523774746,28,2514957414,-8817332
1652030846,197985,true,2523774746,28,2514705944,-9068802
1652030945,197986,true,2523522394,28,2514203078,-9319316
1652031112,197988,true,2523017765,28,2513700313,-9317452
1652031268,197987,true,2523270067,28,2514705944,-8564123
1652031442,197988,true,2523017765,28,2515711977,-7305788
1652031481,197988,true,2523017765,28,2515963548,-7054217
1652031577,197990,true,2522513237,28,2516970085,-5543152
1652031671,197990,true,2522513237,28,2517977024,-4536213
1652031691,197991,true,2522261011,28,2518228821,-4032190
1652031710,197991,true,2522261011,28,2518480644,-3780367
1652031790,197993,true,2521756634,28,2518228821,-3527813
1652031831,197993,true,2521756634,28,2518228821,-3527813
1652031905,197994,true,2521504484,28,2517725251,-3779233
1652032193,197994,true,2521504484,28,2515963548,-5540936
1652032196,197996,true,2521000259,28,2515963548,-5036711
1652032311,197996,true,2521000259,28,2515460431,-5539828
1652032327,197996,true,2521000259,28,2515460431,-5539828
1652032342,197996,true,2521000259,28,2515460431,-5539828
1652032540,197998,true,2520496134,28,2514957414,-5538720
1652032564,197997,true,2520748184,28,2514957414,-5790770
1652032581,197997,true,2520748184,28,2514957414,-5790770
1652032592,197997,true,2520748184,28,2514957414,-5790770
1652032706,197999,true,2520244110,28,2514957414,-5286696
1652032731,197998,true,2520496134,28,2514957414,-5538720
1652032771,197998,true,2520496134,28,2514957414,-5538720
1652032878,197998,true,2520496134,28,2515208910,-5287224
1652032941,197999,true,2520244110,28,2515460431,-4783679
1652033063,197998,true,2520496134,28,2515963548,-4532586
1652033401,197998,true,2520496134,28,2517725251,-2770883
1652033475,197998,true,2520496134,28,2517977024,-2519110
1652033524,197999,true,2520244110,28,2518480644,-1763466
1652033563,197998,true,2520496134,28,2518732492,-1763642
1652033577,197998,true,2520496134,28,2518732492,-1763642
1652033597,197998,true,2520496134,28,2518984366,-1511768
1652033656,197999,true,2520244110,28,2519488188,-755922
1652033998,197998,true,2520496134,28,2521504484,1008350
1652034022,197998,true,2520496134,28,2521504484,1008350
1652034051,197998,true,2520496134,28,2521756634,1260500
1652034113,197999,true,2520244110,28,2522513237,2269127
1652034220,197997,true,2520748184,28,2523774746,3026562
1652034322,197996,true,2521000259,28,2525036886,4036627
1652034391,197996,true,2521000259,28,2525794472,4794213
1652034769,197997,true,2520748184,28,2529838776,9090592
1652034813,197995,true,2521252359,28,2530091760,8839401
1652034854,197994,true,2521504484,28,2530344769,8840285
1652034894,197994,true,2521504484,28,2530850863,9346379
1652034926,197994,true,2521504484,28,2531357059,9852575
1652034938,197991,true,2522261011,28,2531610194,9349183
1652034971,197990,true,2522513237,28,2532116542,9603305
1652034975,197989,true,2522765488,28,2532116542,9351054
1652034981,197989,true,2522765488,28,2532369753,9604265
1652035108,197986,true,2523522394,28,2534903263,11380869
1652035117,197985,true,2523774746,28,2534903263,11128517
1652035352,197984,true,2524027123,28,2539723916,15696793
1652035542,197984,true,2524027123,28,2544044903,20017780
1652035607,197981,true,2524784407,28,2545571711,20787304
1652035787,197980,true,2525036886,28,2549647682,24610796
1652035959,197979,true,2525289389,28,2552708943,27419554
1652035990,197979,true,2525289389,28,2552964214,27674825
1652036003,197976,true,2526047052,28,2553219510,27172458
1652036057,197975,true,2526299657,28,2553985553,27685896
1652036077,197974,true,2526552286,28,2554240951,27688665
1652036320,197974,true,2526552286,28,2557307727,30755441
1652036539,197971,true,2527310328,28,2560122172,32811844
1652036643,197970,true,2527563059,28,2561146375,33583316
1652036658,197969,true,2527815815,28,2561402489,33586674
1652036706,197969,true,2527815815,28,2561914795,34098980
1652036909,197966,true,2528574236,28,2561914795,33340559
1652037052,197965,true,2528827093,28,2561914795,33087702
1652037170,197964,true,2529079976,28,2561914795,32834819
1652038029,197964,true,2529079976,28,2562683447,33603471
1652038390,197961,true,2529838776,28,2562939715,33100939
1652038433,197960,true,2530091760,28,2562939715,32847955
1652038471,197959,true,2530344769,28,2562939715,32594946
1652038746,197959,true,2530344769,28,2563196009,32851240
1652038807,197956,true,2531103948,28,2563196009,32092061
1652039006,197955,true,2531357059,28,2563196009,31838950
1652039055,197954,true,2531610194,28,2563196009,31585815
1652039402,197954,true,2531610194,28,2563196009,31585815
1652039732,197951,true,2532369753,28,2563196009,30826256
1652039769,197950,true,2532622990,28,2563196009,30573019
1652039940,197950,true,2532622990,28,2563196009,30573019
1652040277,197949,true,2532876253,28,2563196009,30319756
1652040322,197946,true,2533636192,28,2563196009,29559817
1652040458,197945,true,2533889555,28,2563196009,29306454
1652040935,197945,true,2533889555,28,2563196009,29306454
1652040986,197944,true,2534142944,28,2563196009,29053065
1652041057,197941,true,2534903263,28,2563196009,28292746
1652041437,197940,true,2535156753,28,2563196009,28039256
1652041559,197939,true,2535410269,28,2563196009,27785740
1652041578,197938,true,2535663810,28,2563196009,27532199
1652041597,197935,true,2536424585,28,2563196009,26771424
1652041618,197933,true,2536931896,28,2562939715,26007819
1652041723,197932,true,2537185589,28,2562683447,25497858
1652041732,197931,true,2537439307,28,2562683447,25244140
1652041791,197928,true,2538200615,28,2562427204,24226589
1652041835,197926,true,2538708281,28,2562427204,23718923
1652041891,197925,true,2538962152,28,2561914795,22952643
1652041979,197923,true,2539469969,28,2561402489,21932520
1652042023,197920,true,2540231887,28,2561146375,20914488
1652042120,197918,true,2540739958,28,2560634222,19894264
1652042389,197917,true,2540994032,28,2559098379,18104347
1652042404,197915,true,2541502257,28,2558842495,17340238
1652042461,197914,true,2541756407,28,2558586636,16830229
1652042620,197913,true,2542010582,28,2557563457,15552875
1652042672,197912,true,2542264783,28,2557307727,15042944
1652042924,197911,true,2542519010,28,2554751825,12232815
1652043012,197910,true,2542773262,28,2553985553,11212291
1652044050,197909,true,2543027539,28,2547099436,4071897
1652044560,197909,true,2543027539,28,2545317180,2289641
1652044645,197908,true,2543281842,28,2545317180,2035338
1652045107,197906,true,2543790524,28,2545317180,1526656
1652045281,197905,true,2544044903,28,2545317180,1272277
1652045575,197905,true,2544044903,28,2545317180,1272277
1652045874,197904,true,2544299307,28,2545317180,1017873
1652045937,197902,true,2544808193,28,2545571711,763518
1652045952,197902,true,2544808193,28,2545571711,763518
1652045980,197901,true,2545062673,28,2545571711,509038
1652046093,197900,true,2545317180,28,2545571711,254531
1652046133,197898,true,2545826269,28,2545571711,-254558
1652046223,197897,true,2546080851,28,2545826269,-254582
1652046325,197897,true,2546080851,28,2545826269,-254582
1652046441,197895,true,2546590093,28,2546080851,-509242
1652046601,197893,true,2547099436,28,2546335459,-763977
1652046672,197892,true,2547354146,28,2546335459,-1018687
1652046704,197891,true,2547608882,28,2546590093,-1018789
1652047012,197889,true,2548118429,28,2547099436,-1018993
1652047213,197887,true,2548628078,28,2547354146,-1273932
1652047233,197886,true,2548882941,28,2547354146,-1528795
1652047332,197886,true,2548882941,28,2547608882,-1274059
1652047356,197885,true,2549137829,28,2547608882,-1528947
1652047445,197883,true,2549647682,28,2547099436,-2548246
1652047991,197883,true,2549647682,28,2544299307,-5348375
1652048046,197883,true,2549647682,28,2544044903,-5602779
1652048062,197882,true,2549902647,28,2543790524,-6112123
1652048281,197880,true,2550412653,28,2542519010,-7893643
1652048375,197881,true,2550157637,28,2542010582,-8147055
1652049022,197881,true,2550157637,28,2537693051,-12464586
1652049033,197880,true,2550412653,28,2537693051,-12719602
1652049167,197879,true,2550667694,28,2536931896,-13735798
1652049201,197879,true,2550667694,28,2536931896,-13735798
1652049447,197880,true,2550412653,28,2536170968,-14241685
1652049712,197879,true,2550667694,28,2535663810,-15003884
1652049778,197878,true,2550922761,28,2535410269,-15512492
1652049956,197878,true,2550922761,28,2535156753,-15766008
1652050352,197878,true,2550922761,28,2534142944,-16779817
1652050537,197877,true,2551177853,28,2533636192,-17541661
1652050586,197876,true,2551432971,28,2533382853,-18050118
1652050630,197876,true,2551432971,28,2533382853,-18050118
1652050638,197877,true,2551177853,28,2533382853,-17795000
1652050742,197876,true,2551432971,28,2533382853,-18050118
1652050891,197876,true,2551432971,28,2533129540,-18303431
1652050960,197876,true,2551432971,28,2533129540,-18303431
1652051543,197877,true,2551177853,28,2533889555,-17288298
1652051599,197876,true,2551432971,28,2534142944,-17290027
1652051725,197876,true,2551432971,28,2534142944,-17290027
1652051812,197877,true,2551177853,28,2534396358,-16781495
1652051893,197878,true,2550922761,28,2534396358,-16526403
1652051956,197878,true,2550922761,28,2534649798,-16272963
1652051985,197878,true,2550922761,28,2534649798,-16272963
1652052068,197879,true,2550667694,28,2534903263,-15764431
1652052225,197881,true,2550157637,28,2534903263,-15254374
1652052254,197881,true,2550157637,28,2535156753,-15000884
1652052427,197882,true,2549902647,28,2535156753,-14745894
1652052454,197883,true,2549647682,28,2535156753,-14490929
1652052464,197884,true,2549392743,28,2535156753,-14235990
1652052495,197885,true,2549137829,28,2535156753,-13981076
1652052547,197886,true,2548882941,28,2535156753,-13726188
1652052598,197887,true,2548628078,28,2534903263,-13724815
1652052755,197889,true,2548118429,28,2533889555,-14228874
1652052847,197890,true,2547863643,28,2533129540,-14734103
1652052916,197891,true,2547608882,28,2532622990,-14985892
1652052921,197893,true,2547099436,28,2532622990,-14476446
1652052943,197895,true,2546590093,28,2532369753,-14220340
1652053041,197896,true,2546335459,28,2531610194,-14725265
1652053049,197897,true,2546080851,28,2531610194,-14470657
1652053246,197899,true,2545571711,28,2529838776,-15732935
1652053531,197901,true,2545062673,28,2527563059,-17499614
1652053636,197902,true,2544808193,28,2526804942,-18003251
1652053831,197903,true,2544553737,28,2525289389,-19264348
1652053879,197905,true,2544044903,28,2524784407,-19260496
1652053947,197907,true,2543536170,28,2524027123,-19509047
1652053967,197908,true,2543281842,28,2523774746,-19507096
1652054042,197909,true,2543027539,28,2523017765,-20009774
1652054066,197911,true,2542519010,28,2522765488,-19753522
1652054081,197913,true,2542010582,28,2522765488,-19245094
1652054101,197914,true,2541756407,28,2522513237,-19243170
1652054235,197916,true,2541248132,28,2521000259,-20247873
1652054284,197918,true,2540739958,28,2520496134,-20243824
1652054321,197920,true,2540231887,28,2519992110,-20239777
1652054505,197921,true,2539977889,28,2518984366,-20993523
1652054652,197923,true,2539469969,28,2518480644,-20989325
1652054839,197925,true,2538962152,28,2517977024,-20985128
1652055039,197927,true,2538454435,28,2517221782,-21232653
1652055084,197928,true,2538200615,28,2517221782,-20978833
1652055124,197930,true,2537693051,28,2517221782,-20471269
1652055173,197931,true,2537439307,28,2516970085,-20469222
1652055389,197933,true,2536931896,28,2516466766,-20465130
1652055461,197934,true,2536678228,28,2516215145,-20463083
1652055739,197936,true,2536170968,28,2515460431,-20710537
1652055814,197938,true,2535663810,28,2515460431,-20203379
1652056103,197940,true,2535156753,28,2515208910,-19947843
1652056131,197941,true,2534903263,28,2515208910,-19694353
1652056156,197943,true,2534396358,28,2515208910,-19187448
1652056229,197945,true,2533889555,28,2515208910,-18680645
1652056320,197947,true,2533382853,28,2515208910,-18173943
1652056398,197947,true,2533382853,28,2515208910,-18173943
1652056457,197949,true,2532876253,28,2514957414,-17918839
1652056514,197951,true,2532369753,28,2514957414,-17412339
1652056633,197952,true,2532116542,28,2514957414,-17159128
1652056648,197953,true,2531863355,28,2514957414,-16905941
1652056707,197955,true,2531357059,28,2514957414,-16399645
1652056776,197956,true,2531103948,28,2514957414,-16146534
1652056802,197957,true,2530850863,28,2515208910,-15641953
1652056806,197958,true,2530597803,28,2515208910,-15388893
1652056891,197959,true,2530344769,28,2515208910,-15135859
1652057024,197961,true,2529838776,28,2515460431,-14378345
1652057053,197962,true,2529585817,28,2515460431,-14125386
1652057094,197962,true,2529585817,28,2515460431,-14125386
1652057156,197964,true,2529079976,28,2515711977,-13367999
1652057216,197964,true,2529079976,28,2515711977,-13367999
1652057316,197966,true,2528574236,28,2516215145,-12359091
1652057400,197966,true,2528574236,28,2516466766,-12107470
1652057689,197967,true,2528321404,28,2517725251,-10596153
1652057770,197968,true,2528068597,28,2517977024,-10091573
1652057784,197969,true,2527815815,28,2517977024,-9838791
1652057942,197969,true,2527815815,28,2518732492,-9083323
1652058225,197970,true,2527563059,28,2519740136,-7822923
1652058324,197971,true,2527310328,28,2519992110,-7318218
1652058424,197972,true,2527057622,28,2520496134,-6561488
1652058489,197973,true,2526804942,28,2520496134,-6308808
1652058661,197974,true,2526552286,28,2521000259,-5552027
1652058704,197975,true,2526299657,28,2521000259,-5299398
1652058735,197976,true,2526047052,28,2521252359,-4794693
1652058777,197976,true,2526047052,28,2521252359,-4794693
1652058874,197978,true,2525541918,28,2521252359,-4289559
1652058876,197979,true,2525289389,28,2521252359,-4037030
1652058941,197980,true,2525036886,28,2521252359,-3784527
1652059021,197980,true,2525036886,28,2521252359,-3784527
1652059036,197982,true,2524531954,28,2521504484,-3027470
1652059174,197982,true,2524531954,28,2521504484,-3027470
1652059264,197984,true,2524027123,28,2521504484,-2522639
1652059297,197984,true,2524027123,28,2521504484,-2522639
1652059515,197985,true,2523774746,28,2521504484,-2270262
1652059617,197985,true,2523774746,28,2521504484,-2270262
1652059770,197986,true,2523522394,28,2521504484,-2017910
1652059796,197986,true,2523522394,28,2521756634,-1765760
1652059861,197987,true,2523270067,28,2521756634,-1513433
1652059921,197987,true,2523270067,28,2521756634,-1513433
1652060146,197988,true,2523017765,28,2521756634,-1261131
1652060294,197988,true,2523017765,28,2521756634,-1261131
1652060302,197989,true,2522765488,28,2521756634,-1008854
1652060394,197989,true,2522765488,28,2521756634,-1008854
1652060411,197990,true,2522513237,28,2521756634,-756603
1652060496,197990,true,2522513237,28,2521504484,-1008753
1652060564,197991,true,2522261011,28,2521504484,-756527
1652060582,197991,true,2522261011,28,2521252359,-1008652
1652060637,197992,true,2522008810,28,2521252359,-756451
1652060709,197992,true,2522008810,28,2521252359,-756451
1652060764,197993,true,2521756634,28,2521000259,-756375
1652060782,197993,true,2521756634,28,2521000259,-756375
1652060829,197994,true,2521504484,28,2520748184,-756300
1652060854,197995,true,2521252359,28,2520748184,-504175
1652061023,197996,true,2521000259,28,2519992110,-1008149
1652061102,197996,true,2521000259,28,2519740136,-1260123
1652061127,197997,true,2520748184,28,2519740136,-1008048
1652061257,197998,true,2520496134,28,2518732492,-1763642
1652061345,197999,true,2520244110,28,2518228821,-2015289
1652061702,198000,true,2519992110,28,2515963548,-4028562
1652061737,198001,true,2519740136,28,2515711977,-4028159
1652061853,198002,true,2519488188,28,2514957414,-4530774
1652061873,198003,true,2519236264,28,2514705944,-4530320
1652061887,198003,true,2519236264,28,2514705944,-4530320
1652062088,198005,true,2518732492,28,2512443840,-6288652
1652062117,198006,true,2518480644,28,2512192620,-6288024
1652062144,198007,true,2518228821,28,2511941426,-6287395
1652062210,198008,true,2517977024,28,2511187994,-6789030
1652062226,198010,true,2517473504,28,2511187994,-6285510
1652062289,198011,true,2517221782,28,2510434789,-6786993
1652062362,198012,true,2516970085,28,2509681809,-7288276
1652062376,198013,true,2516718413,28,2509430866,-7287547
1652062393,198014,true,2516466766,28,2509179948,-7286818
1652062401,198015,true,2516215145,28,2509179948,-7035197
1652062421,198016,true,2515963548,28,2508929055,-7034493
1652062466,198016,true,2515963548,28,2508176527,-7787021
1652062497,198018,true,2515460431,28,2507925734,-7534697
1652062601,198019,true,2515208910,28,2506672147,-8536763
1652062624,198020,true,2514957414,28,2506421505,-8535909
1652062742,198020,true,2514957414,28,2505168670,-9788744
1652062807,198021,true,2514705944,28,2504417270,-10288674
1652062825,198022,true,2514454498,28,2504166853,-10287645
1652062851,198023,true,2514203078,28,2503916462,-10286616
1652062884,198024,true,2513951683,28,2503415753,-10535930
1652062900,198025,true,2513700313,28,2503415753,-10284560
1652062948,198026,true,2513448968,28,2502915145,-10533823
1652062954,198027,true,2513197648,28,2502664879,-10532769
1652062993,198027,true,2513197648,28,2502414637,-10783011
1652063001,198028,true,2512946354,28,2502164421,-10781933
1652063027,198030,true,2512443840,28,2501914230,-10529610
1652063043,198030,true,2512443840,28,2501664063,-10779777
1652063088,198031,true,2512192620,28,2501163805,-11028815
1652063115,198032,true,2511941426,28,2500913714,-11027712
1652063144,198033,true,2511690257,28,2500663648,-11026609
1652063156,198034,true,2511439113,28,2500413606,-11025507
1652063167,198034,true,2511439113,28,2500413606,-11025507
1652063169,198035,true,2511187994,28,2500413606,-10774388
1652063184,198037,true,2510685832,28,2500163590,-10522242
1652063212,198039,true,2510183770,28,2499663632,-10520138
1652063228,198040,true,2509932777,28,2499163775,-10769002
1652063255,198041,true,2509681809,28,2498664017,-11017792
1652063276,198043,true,2509179948,28,2498164359,-11015589
1652063344,198045,true,2508678187,28,2496416343,-12261844
1652063540,198047,true,2508176527,28,2491677892,-16498635
1652063688,198048,true,2507925734,28,2487943363,-19982371
1652063777,198050,true,2507424224,28,2486202499,-21221725
1652063782,198052,true,2506922815,28,2485953904,-20968911
1652063843,198054,true,2506421505,28,2484462854,-21958651
1652063888,198056,true,2505920296,28,2483220995,-22699301
1652063911,198059,true,2505168670,28,2482476177,-22692493
1652063925,198061,true,2504667712,28,2481979757,-22687955
1652064152,198064,true,2503916462,28,2474792801,-29123661
1652064258,198066,true,2503415753,28,2471577821,-31837932
1652064311,198069,true,2502664879,28,2470095393,-32569486
1652064500,198072,true,2501914230,28,2464913895,-37000335
1652064617,198074,true,2501413922,28,2461465602,-39948320
1652064714,198077,true,2500663648,28,2458759614,-41904034
1652064748,198080,true,2499913599,28,2457776356,-42137243
1652064781,198083,true,2499163775,28,2456793491,-42370284
1652064812,198086,true,2498414175,28,2455811019,-42603156
1652064865,198088,true,2497914567,28,2454092639,-43821928
1652065098,198092,true,2496915651,28,2447965376,-48950275
1652065183,198095,true,2496166726,28,2446497110,-49669616
1652065295,198098,true,2495418026,28,2444540793,-50877233
1652065423,198101,true,2494669550,28,2442341806,-52327744
1652065435,198105,true,2493671932,28,2442097596,-51574336
1652065484,198107,true,2493173272,28,2441365114,-51808158
1652065493,198111,true,2492176252,28,2441121001,-51055251
1652065510,198113,true,2491677892,28,2440876914,-50800978
1652065586,198117,true,2490681470,28,2439656841,-51024629
1652065602,198120,true,2489934415,28,2439412900,-50521515
1652065634,198123,true,2489187584,28,2439168983,-50018601
1652065650,198126,true,2488440977,28,2438925091,-49515886
1652065662,198129,true,2487694594,28,2438925091,-48769503
1652065664,198132,true,2486948435,28,2438925091,-48023344
1652065700,198134,true,2486451120,28,2438925091,-47526029
1652065807,198136,true,2485953904,28,2439168983,-46784921
1652065820,198140,true,2484959771,28,2439168983,-45790788
1652065859,198142,true,2484462854,28,2439412900,-45049954
1652065865,198145,true,2483717664,28,2439412900,-44304764
1652065932,198147,true,2483220995,28,2439900807,-43320188
1652065974,198150,true,2482476177,28,2440144797,-42331380
1652066050,198152,true,2481979757,28,2440876914,-41102843
1652066054,198154,true,2481483435,28,2440876914,-40606521
1652066134,198156,true,2480987213,28,2441609250,-39377963
1652066144,198159,true,2480243066,28,2441609250,-38633816
1652066157,198161,true,2479747091,28,2441609250,-38137841
1652066171,198163,true,2479251216,28,2441853411,-37397805
1652066204,198165,true,2478755440,28,2442097596,-36657844
1652066273,198167,true,2478259764,28,2442830299,-35429465
1652066298,198169,true,2477764186,28,2443074582,-34689604
1652066500,198172,true,2477021006,28,2445274229,-31746777
1652066561,198173,true,2476773328,28,2446007884,-30765444
1652066575,198176,true,2476030445,28,2446252485,-29777960
1652066808,198178,true,2475535313,28,2449679466,-25855847
1652066889,198180,true,2475040280,28,2451149641,-23890639
1652066965,198182,true,2474545346,28,2452375461,-22169885
1652067077,198184,true,2474050511,28,2454092639,-19957872
1652067204,198186,true,2473555776,28,2456056600,-17499176
1652067289,198188,true,2473061139,28,2457284874,-15776265
1652067298,198190,true,2472566601,28,2457530603,-15035998
1652067305,198192,true,2472072161,28,2457530603,-14541558
1652067321,198194,true,2471577821,28,2457776356,-13801465
1652067491,198196,true,2471083580,28,2460235238,-10848342
1652067501,198197,true,2470836496,28,2460481262,-10355234
1652067624,198199,true,2470342403,28,2461465602,-8876801
1652067750,198201,true,2469848409,28,2462450336,-7398073
1652067895,198203,true,2469354513,28,2462942851,-6411662
1652068029,198204,true,2469107602,28,2463435464,-5672138
1652068125,198206,true,2468613855,28,2463435464,-5178391
1652068353,198208,true,2468120206,28,2463681807,-4438399
1652068522,198210,true,2467626656,28,2463928175,-3698481
1652068734,198211,true,2467379918,28,2464174568,-3205350
1652068815,198213,true,2466886516,28,2464174568,-2711948
1652068841,198215,true,2466393213,28,2464174568,-2218645
1652068875,198216,true,2466146598,28,2464174568,-1972030
1652068942,198217,true,2465900008,28,2464420986,-1479022
1652069002,198219,true,2465406902,28,2464420986,-985916
1652069024,198220,true,2465160386,28,2464420986,-739400
1652069070,198222,true,2464667428,28,2464174568,-492860
1652069132,198223,true,2464420986,28,2464174568,-246418
1652069242,198224,true,2464174568,28,2463681807,-492761
1652069352,198226,true,2463681807,28,2463435464,-246343
1652069482,198227,true,2463435464,28,2462942851,-492613
1652069551,198228,true,2463189145,28,2462696581,-492564
1652069611,198230,true,2462696581,28,2462696581,0
1652069630,198231,true,2462450336,28,2462450336,0
1652069644,198233,true,2461957920,28,2462450336,492416
1652069653,198233,true,2461957920,28,2462450336,492416
1652069688,198235,true,2461465602,28,2462450336,984734
1652069788,198236,true,2461219480,28,2462696581,1477101
1652069853,198237,true,2460973383,28,2462696581,1723198
1652069912,198237,true,2460973383,28,2462942851,1969468
1652070057,198238,true,2460727310,28,2463435464,2708154
1652070100,198239,true,2460481262,28,2463681807,3200545
1652070340,198240,true,2460235238,28,2464420986,4185748
1652070479,198241,true,2459989239,28,2464913895,4924656
1652070518,198242,true,2459743265,28,2465160386,5417121
1652070629,198242,true,2459743265,28,2465653443,5910178
1652070682,198243,true,2459497315,28,2465653443,6156128
1652070687,198244,true,2459251390,28,2465900008,6648618
1652070725,198245,true,2459005490,28,2465900008,6894518
1652070865,198245,true,2459005490,28,2466639852,7634362
1652070883,198246,true,2458759614,28,2466639852,7880238
1652070968,198247,true,2458513762,28,2467379918,8866156
1652070979,198247,true,2458513762,28,2467379918,8866156
1652071042,198248,true,2458267935,28,2467873419,9605484
1652071065,198249,true,2458022133,28,2467873419,9851286
1652071175,198249,true,2458022133,28,2468613855,10591722
1652071213,198250,true,2457776356,28,2469107602,11331246
1652071293,198249,true,2458022133,28,2469601448,11579315
1652071325,198250,true,2457776356,28,2469848409,12072053
1652071360,198250,true,2457776356,28,2470095393,12319037
1652071540,198250,true,2457776356,28,2470836496,13060140
1652071683,198249,true,2458022133,28,2471083580,13061447
1652071692,198249,true,2458022133,28,2471083580,13061447
1652071706,198250,true,2457776356,28,2471083580,13307224
1652071746,198249,true,2458022133,28,2471083580,13061447
1652071974,198248,true,2458267935,28,2471083580,12815645
1652071985,198248,true,2458267935,28,2471083580,12815645
1652072069,198248,true,2458267935,28,2470836496,12568561
1652072096,198247,true,2458513762,28,2470836496,12322734
1652072178,198246,true,2458759614,28,2470836496,12076882
1652072302,198245,true,2459005490,28,2470589437,11583947
1652072338,198244,true,2459251390,28,2470342403,11091013
1652072363,198243,true,2459497315,28,2470342403,10845088
1652072492,198242,true,2459743265,28,2470095393,10352128
1652072565,198241,true,2459989239,28,2470095393,10106154
1652072603,198241,true,2459989239,28,2469848409,9859170
1652072638,198240,true,2460235238,28,2469848409,9613171
1652072789,198239,true,2460481262,28,2469601448,9120186
1652072904,198237,true,2460973383,28,2469107602,8134219
1652072997,198236,true,2461219480,28,2468860716,7641236
1652073005,198235,true,2461465602,28,2468860716,7395114
1652073076,198234,true,2461711748,28,2468860716,7148968
1652073114,198233,true,2461957920,28,2468613855,6655935
1652073173,198232,true,2462204115,28,2468367018,6162903
1652073203,198231,true,2462450336,28,2468367018,5916682
1652073323,198230,true,2462696581,28,2467626656,4930075
1652073332,198228,true,2463189145,28,2467626656,4437511
1652073373,198228,true,2463189145,28,2467626656,4437511
1652073437,198226,true,2463681807,28,2467133205,3451398
1652073684,198226,true,2463681807,28,2466146598,2464791
1652073727,198225,true,2463928175,28,2465900008,1971833
1652073757,198224,true,2464174568,28,2465653443,1478875
1652073785,198223,true,2464420986,28,2465653443,1232457
1652073804,198222,true,2464667428,28,2465406902,739474
1652073825,198222,true,2464667428,28,2465406902,739474
1652073855,198222,true,2464667428,28,2465160386,492958
1652073923,198222,true,2464667428,28,2464667428,0
1652073940,198221,true,2464913895,28,2464667428,-246467
1652073954,198221,true,2464913895,28,2464420986,-492909
1652074198,198222,true,2464667428,28,2462450336,-2217092
1652074380,198221,true,2464913895,28,2461219480,-3694415
1652074454,198222,true,2464667428,28,2460481262,-4186166
1652074549,198222,true,2464667428,28,2459743265,-4924163
1652074575,198222,true,2464667428,28,2459497315,-5170113
1652074600,198222,true,2464667428,28,2459251390,-5416038
1652074717,198222,true,2464667428,28,2458513762,-6153666
1652074736,198222,true,2464667428,28,2458267935,-6399493
1652074755,198223,true,2464420986,28,2458022133,-6398853
1652074763,198224,true,2464174568,28,2458022133,-6152435
1652074850,198224,true,2464174568,28,2457284874,-6889694
1652074902,198224,true,2464174568,28,2456793491,-7381077
1652074912,198225,true,2463928175,28,2456793491,-7134684
1652074938,198225,true,2463928175,28,2456547836,-7380339
1652075049,198226,true,2463681807,28,2455565462,-8116345
1652075253,198226,true,2463681807,28,2453847254,-9834553
1652075256,198227,true,2463435464,28,2453847254,-9588210
1652075389,198227,true,2463435464,28,2452620698,-10814766
1652075395,198228,true,2463189145,28,2452620698,-10568447
1652075506,198229,true,2462942851,28,2451639895,-11302956
1652075634,198230,true,2462696581,28,2450659484,-12037097
1652076070,198230,true,2462696581,28,2448699839,-13996742
1652076198,198231,true,2462450336,28,2447965376,-14484960
1652076224,198231,true,2462450336,28,2447965376,-14484960
1652076228,198232,true,2462204115,28,2447965376,-14238739
1652076306,198233,true,2461957920,28,2447720604,-14237316
1652076391,198233,true,2461957920,28,2447475856,-14482064
1652076397,198234,true,2461711748,28,2447475856,-14235892
1652076454,198235,true,2461465602,28,2447231133,-14234469
1652076494,198235,true,2461465602,28,2446986434,-14479168
1652076527,198236,true,2461219480,28,2446986434,-14233046
1652076555,198237,true,2460973383,28,2446741760,-14231623
1652076591,198238,true,2460727310,28,2446741760,-13985550
1652076607,198238,true,2460727310,28,2446497110,-14230200
1652076630,198239,true,2460481262,28,2446497110,-13984152
1652076641,198240,true,2460235238,28,2446497110,-13738128
1652076695,198242,true,2459743265,28,2446007884,-13735381
1652076700,198242,true,2459743265,28,2446007884,-13735381
1652076734,198243,true,2459497315,28,2445763308,-13734007
1652076796,198244,true,2459251390,28,2445029726,-14221664
1652076946,198246,true,2458759614,28,2443807578,-14952036
1652077039,198246,true,2458759614,28,2443074582,-15685032
1652077079,198247,true,2458513762,28,2442586040,-15927722
1652077130,198248,true,2458267935,28,2442341806,-15926129
1652077139,198250,true,2457776356,28,2442097596,-15678760
1652077153,198250,true,2457776356,28,2442097596,-15678760
1652077170,198251,true,2457530603,28,2441853411,-15677192
1652077239,198252,true,2457284874,28,2441121001,-16163873
1652077376,198254,true,2456793491,28,2440144797,-16648694
1652077459,198254,true,2456793491,28,2439412900,-17380591
1652077489,198256,true,2456302206,28,2439168983,-17133223
1652077512,198257,true,2456056600,28,2438925091,-17131509
1652077547,198259,true,2455565462,28,2438681223,-16884239
1652077718,198260,true,2455319930,28,2437705994,-17613936
1652077805,198261,true,2455074423,28,2437218526,-17855897
1652077841,198263,true,2454583482,28,2436974828,-17608654
1652077859,198264,true,2454338048,28,2436731155,-17606893
1652077880,198265,true,2454092639,28,2436731155,-17361484
1652077888,198266,true,2453847254,28,2436731155,-17116099
1652077916,198267,true,2453601894,28,2436487506,-17114388
1652077924,198269,true,2453111247,28,2436487506,-16623741
1652077966,198269,true,2453111247,28,2436487506,-16623741
1652078001,198271,true,2452620698,28,2436487506,-16133192
1652078077,198272,true,2452375461,28,2436243882,-16131579
1652078265,198273,true,2452130248,28,2435756706,-16373542
1652078472,198274,true,2451885059,28,2435756706,-16128353
1652078485,198275,true,2451639895,28,2435756706,-15883189
1652078504,198276,true,2451394756,28,2436000282,-15394474
1652078580,198277,true,2451149641,28,2436487506,-14662135
1652078709,198278,true,2450904550,28,2437218526,-13686024
1652078786,198279,true,2450659484,28,2437462248,-13197236
1652078863,198280,true,2450414443,28,2437949764,-12464679
1652078885,198281,true,2450169426,28,2438193559,-11975867
1652078924,198282,true,2449924434,28,2438437379,-11487055
1652078949,198283,true,2449679466,28,2438681223,-10998243
1652078973,198284,true,2449434522,28,2438925091,-10509431
1652078977,198285,true,2449189603,28,2438925091,-10264512
1652079090,198285,true,2449189603,28,2439900807,-9288796
1652079210,198287,true,2448699839,28,2440876914,-7822925
1652079226,198287,true,2448699839,28,2440876914,-7822925
1652079433,198289,true,2448210172,28,2442341806,-5868366
1652079470,198289,true,2448210172,28,2442830299,-5379873
1652079524,198290,true,2447965376,28,2443074582,-4890794
1652079640,198290,true,2447965376,28,2444051958,-3913418
1652079688,198292,true,2447475856,28,2444296364,-3179492
1652079711,198292,true,2447475856,28,2444540793,-2935063
1652079782,198292,true,2447475856,28,2445029726,-2446130
1652079824,198293,true,2447231133,28,2445274229,-1956904
1652079827,198294,true,2446986434,28,2445274229,-1712205
1652079841,198294,true,2446986434,28,2445274229,-1712205
1652079900,198294,true,2446986434,28,2445763308,-1223126
1652079916,198294,true,2446986434,28,2446007884,-978550
1652080216,198295,true,2446741760,28,2448210172,1468412
1652080335,198295,true,2446741760,28,2449189603,2447843
1652080415,198296,true,2446497110,28,2449679466,3182356
1652080505,198296,true,2446497110,28,2450414443,3917333
1652080760,198296,true,2446497110,28,2452620698,6123588
1652080843,198296,true,2446497110,28,2453111247,6614137
1652081058,198296,true,2446497110,28,2454338048,7840938
1652081107,198297,true,2446252485,28,2454828940,8576455
1652081210,198297,true,2446252485,28,2455319930,9067445
1652081280,198297,true,2446252485,28,2455811019,9558534
1652081334,198297,true,2446252485,28,2455811019,9558534
1652081373,198297,true,2446252485,28,2456056600,9804115
1652081428,198298,true,2446007884,28,2456302206,10294322
1652081463,198298,true,2446007884,28,2456302206,10294322
1652081622,198298,true,2446007884,28,2456547836,10539952
1652081703,198298,true,2446007884,28,2456302206,10294322
1652081853,198299,true,2445763308,28,2456302206,10538898
1652081870,198298,true,2446007884,28,2456302206,10294322
1652082139,198299,true,2445763308,28,2455811019,10047711
1652082173,198299,true,2445763308,28,2455811019,10047711
1652082204,198299,true,2445763308,28,2455811019,10047711
1652082339,198298,true,2446007884,28,2455565462,9557578
1652082451,198299,true,2445763308,28,2455319930,9556622
1652082609,198299,true,2445763308,28,2454828940,9065632
1652082674,198299,true,2445763308,28,2454828940,9065632
1652082741,198298,true,2446007884,28,2454583482,8575598
1652082793,198298,true,2446007884,28,2454583482,8575598
1652083046,198298,true,2446007884,28,2454338048,8330164
1652083165,198298,true,2446007884,28,2454338048,8330164
1652083202,198298,true,2446007884,28,2454338048,8330164
1652083217,198298,true,2446007884,28,2454338048,8330164
1652083231,198297,true,2446252485,28,2454338048,8085563
1652083235,198297,true,2446252485,28,2454338048,8085563
1652083248,198297,true,2446252485,28,2454338048,8085563
1652083278,198297,true,2446252485,28,2454338048,8085563
1652083297,198297,true,2446252485,28,2454338048,8085563
1652083307,198297,true,2446252485,28,2454338048,8085563
1652083376,198296,true,2446497110,28,2454338048,7840938
1652083403,198296,true,2446497110,28,2454338048,7840938
1652083423,198296,true,2446497110,28,2454338048,7840938
1652083586,198296,true,2446497110,28,2453847254,7350144
1652083634,198295,true,2446741760,28,2453847254,7105494
1652083637,198295,true,2446741760,28,2453847254,7105494
1652083692,198295,true,2446741760,28,2453601894,6860134
1652084151,198295,true,2446741760,28,2452375461,5633701
1652084177,198295,true,2446741760,28,2452130248,5388488
1652084178,198295,true,2446741760,28,2452130248,5388488
1652084249,198295,true,2446741760,28,2451885059,5143299
1652084388,198295,true,2446741760,28,2451394756,4652996
1652084429,198295,true,2446741760,28,2451149641,4407881
1652084479,198295,true,2446741760,28,2450904550,4162790
1652084522,198295,true,2446741760,28,2450904550,4162790
1652084528,198295,true,2446741760,28,2450659484,3917724
1652084606,198295,true,2446741760,28,2450169426,3427666
1652084622,198295,true,2446741760,28,2450169426,3427666
1652084633,198295,true,2446741760,28,2450169426,3427666
1652084653,198294,true,2446986434,28,2449924434,2938000
1652084670,198294,true,2446986434,28,2449924434,2938000
1652084688,198294,true,2446986434,28,2449679466,2693032
1652084715,198293,true,2447231133,28,2449434522,2203389
1652084796,198293,true,2447231133,28,2448944709,1713576
1652084912,198293,true,2447231133,28,2447965376,734243
1652084989,198292,true,2447475856,28,2447231133,-244723
1652085040,198292,true,2447475856,28,2446741760,-734096
1652085117,198292,true,2447475856,28,2446252485,-1223371
1652085130,198292,true,2447475856,28,2446007884,-1467972
1652085141,198291,true,2447720604,28,2446007884,-1712720
1652085303,198291,true,2447720604,28,2444540793,-3179811
1652085382,198291,true,2447720604,28,2443807578,-3913026
1652085878,198291,true,2447720604,28,2440632851,-7087753
1652086122,198290,true,2447965376,28,2439412900,-8552476
1652086198,198290,true,2447965376,28,2439168983,-8796393
1652086219,198291,true,2447720604,28,2439168983,-8551621
1652086234,198290,true,2447965376,28,2439168983,-8796393
1652086299,198289,true,2448210172,28,2438925091,-9285081
1652086319,198289,true,2448210172,28,2438925091,-9285081
1652086371,198289,true,2448210172,28,2438925091,-9285081
1652086404,198289,true,2448210172,28,2439168983,-9041189
1652086454,198288,true,2448454993,28,2439168983,-9286010
1652086479,198287,true,2448699839,28,2439412900,-9286939
1652086538,198287,true,2448699839,28,2439656841,-9042998
1652086567,198287,true,2448699839,28,2439900807,-8799032
1652086591,198286,true,2448944709,28,2440144797,-8799912
1652086646,198286,true,2448944709,28,2440632851,-8311858
1652086736,198285,true,2449189603,28,2441609250,-7580353
1652086800,198285,true,2449189603,28,2442097596,-7092007
1652086862,198284,true,2449434522,28,2442830299,-6604223
1652087080,198283,true,2449679466,28,2445763308,-3916158
1652087109,198283,true,2449679466,28,2446252485,-3426981
1652087284,198282,true,2449924434,28,2448699839,-1224595
1652087307,198281,true,2450169426,28,2448944709,-1224717
1652087380,198281,true,2450169426,28,2449679466,-489960
1652087418,198280,true,2450414443,28,2450169426,-245017
1652087587,198280,true,2450414443,28,2452375461,1961018
1652087767,198278,true,2450904550,28,2454583482,3678932
1652087886,198278,true,2450904550,28,2456302206,5397656
1652087946,198278,true,2450904550,28,2457039170,6134620
1652088340,198277,true,2451149641,28,2460235238,9085597
1652088360,198276,true,2451394756,28,2460481262,9086506
1652088392,198276,true,2451394756,28,2460481262,9086506
1652088482,198276,true,2451394756,28,2460481262,9086506
1652088510,198275,true,2451639895,28,2460727310,9087415
1652088628,198275,true,2451639895,28,2460481262,8841367
1652088684,198274,true,2451885059,28,2460481262,8596203
1652088722,198275,true,2451639895,28,2460235238,8595343
1652088746,198274,true,2451885059,28,2460235238,8350179
1652088898,198274,true,2451885059,28,2459497315,7612256
1652089007,198274,true,2451885059,28,2458759614,6874555
1652089191,198275,true,2451639895,28,2457776356,6136461
1652089228,198275,true,2451639895,28,2457776356,6136461
1652089258,198275,true,2451639895,28,2457530603,5890708
1652089266,198275,true,2451639895,28,2457530603,5890708
1652089467,198276,true,2451394756,28,2456056600,4661844
1652089630,198276,true,2451394756,28,2454828940,3434184
1652089656,198276,true,2451394756,28,2454583482,3188726
1652089706,198276,true,2451394756,28,2454338048,2943292
1652089764,198277,true,2451149641,28,2453847254,2697613
1652089825,198277,true,2451149641,28,2453356558,2206917
1652090145,198277,true,2451149641,28,2451149641,0
1652090850,198278,true,2450904550,28,2448454993,-2449557
1652090925,198279,true,2450659484,28,2448454993,-2204491
1652090938,198279,true,2450659484,28,2448454993,-2204491
1652090964,198279,true,2450659484,28,2448454993,-2204491
1652090966,198279,true,2450659484,28,2448210172,-2449312
1652091001,198280,true,2450414443,28,2448210172,-2204271
1652091043,198280,true,2450414443,28,2447965376,-2449067
1652091160,198280,true,2450414443,28,2447720604,-2693839
1652091221,198281,true,2450169426,28,2447475856,-2693570
1652091235,198282,true,2449924434,28,2447475856,-2448578
1652091299,198282,true,2449924434,28,2447231133,-2693301
1652091304,198282,true,2449924434,28,2447231133,-2693301
1652091384,198282,true,2449924434,28,2446741760,-3182674
1652091582,198284,true,2449434522,28,2446007884,-3426638
1652091603,198284,true,2449434522,28,2446007884,-3426638
1652091674,198284,true,2449434522,28,2445518756,-3915766
1652091767,198284,true,2449434522,28,2445029726,-4404796
1652091783,198286,true,2448944709,28,2445029726,-3914983
1652091800,198286,true,2448944709,28,2445029726,-3914983
1652091822,198286,true,2448944709,28,2444785247,-4159462
1652091885,198287,true,2448699839,28,2444540793,-4159046
1652091995,198288,true,2448454993,28,2443807578,-4647415
1652092059,198289,true,2448210172,28,2443563221,-4646951
1652092067,198288,true,2448454993,28,2443318889,-5136104
1652092103,198289,true,2448210172,28,2443074582,-5135590
1652092184,198292,true,2447475856,28,2441853411,-5622445
1652092351,198293,true,2447231133,28,2439168983,-8062150
1652092376,198293,true,2447231133,28,2438681223,-8549910
1652092515,198295,true,2446741760,28,2435756706,-10985054
1652092792,198298,true,2446007884,28,2430161183,-15846701
1652092905,198300,true,2445518756,28,2428217929,-17300827
1652093054,198300,true,2445518756,28,2425305960,-20212796
1652093101,198301,true,2445274229,28,2424578514,-20695715
1652093142,198304,true,2444540793,28,2423608925,-20931868
1652093158,198306,true,2444051958,28,2423366588,-20685370
1652093168,198306,true,2444051958,28,2423124276,-20927682
1652093194,198308,true,2443563221,28,2422639724,-20923497
1652093265,198311,true,2442830299,28,2420944554,-21885745
1652093272,198313,true,2442341806,28,2420702484,-21639322
1652093421,198315,true,2441853411,28,2416107745,-25745666
1652093430,198317,true,2441365114,28,2415866159,-25498955
1652093687,198320,true,2440632851,28,2408629782,-32003069
1652093732,198322,true,2440144797,28,2407425828,-32718969
1652093867,198324,true,2439656841,28,2403096576,-36560265
1652093878,198325,true,2439412900,28,2402856290,-36556610
1652093950,198330,true,2438193559,28,2400934870,-37258689
1652094000,198332,true,2437705994,28,2399494813,-38211181
1652094271,198334,true,2437218526,28,2393264541,-43953985
1652094282,198336,true,2436731155,28,2393025238,-43705917
1652094298,198340,true,2435756706,28,2392785960,-42970746
1652094304,198342,true,2435269628,28,2392546705,-42722923
1652094496,198343,true,2435026125,28,2389677514,-45348611
1652094575,198344,true,2434782647,28,2388483034,-46299613
1652094897,198349,true,2433565621,28,2383711080,-49854541
1652095098,198351,true,2433078981,28,2381804969,-51274012
1652095181,198351,true,2433078981,28,2381804969,-51274012
1652095337,198353,true,2432592438,28,2380852485,-51739953
1652095415,198358,true,2431376507,28,2380138372,-51238135
1652095432,198360,true,2430890304,28,2379900382,-50989922
1652095482,198361,true,2430647240,28,2379424473,-51222767
1652095501,198363,true,2430161183,28,2379186555,-50974628
1652095511,198367,true,2429189362,28,2379186555,-50002807
1652095631,198369,true,2428703597,28,2378710789,-49992808
1652096079,198370,true,2428460750,28,2379424473,-49036277
1652096140,198372,true,2427975131,28,2379424473,-48550658
1652096184,198376,true,2427004184,28,2379186555,-47817629
1652096469,198378,true,2426518856,28,2378948660,-47570196
1652096489,198379,true,2426276228,28,2378948660,-47327568
1652096520,198381,true,2425791046,28,2378948660,-46842386
1652096597,198385,true,2424820972,28,2378948660,-45872312
1652096650,198388,true,2424093671,28,2378710789,-45382882
1652096702,198389,true,2423851286,28,2378948660,-44902626
1652096776,198391,true,2423366588,28,2378948660,-44417928
1652096797,198395,true,2422397484,28,2378948660,-43448824
1652096831,198398,true,2421670910,28,2378948660,-42722250
1652096884,198399,true,2421428767,28,2378948660,-42480107
1652096951,198401,true,2420944554,28,2379186555,-41757999
1652097156,198406,true,2419734445,28,2380376386,-39358059
1652097175,198408,true,2419250571,28,2380376386,-38874185
1652097259,198409,true,2419008670,28,2381328679,-37679991
1652097273,198411,true,2418524940,28,2381566812,-36958128
1652097295,198416,true,2417316041,28,2381804969,-35511072
1652097343,198418,true,2416832650,28,2382519582,-34313068
1652097357,198419,true,2416590991,28,2382519582,-34071409
1652097552,198420,true,2416349356,28,2385380178,-30969178
1652098277,198425,true,2415141544,28,2393982592,-21158952
1652098308,198427,true,2414658588,28,2394461412,-20197176
1652098356,198427,true,2414658588,28,2394940329,-19718259
1652098367,198429,true,2414175729,28,2394940329,-19235400
1652098840,198434,true,2412969003,28,2398535255,-14433748
1652098957,198436,true,2412486481,28,2399254887,-13231594
1652099032,198437,true,2412245257,28,2399734762,-12510495
1652099055,198438,true,2412004056,28,2399734762,-12269294
1652099082,198443,true,2410798416,28,2399974736,-10823680
1652099131,198445,true,2410316329,28,2399974736,-10341593
1652099806,198445,true,2410316329,28,2399974736,-10341593
1652099811,198447,true,2409834338,28,2399974736,-9859602
1652099843,198451,true,2408870645,28,2399974736,-8895909
1652099886,198453,true,2408388943,28,2399734762,-8654181
1652099945,198453,true,2408388943,28,2399734762,-8654181
1652100014,198454,true,2408148128,28,2399734762,-8413366
1652100032,198459,true,2406944415,28,2399974736,-6969679
1652100119,198459,true,2406944415,28,2400454755,-6489660
1652100669,198459,true,2406944415,28,2405019726,-1924689
1652100890,198460,true,2406703745,28,2406703745,0
1652100904,198464,true,2405741304,28,2406944415,1203111
1652100918,198464,true,2405741304,28,2406944415,1203111
1652100937,198464,true,2405741304,28,2406944415,1203111
1652100975,198466,true,2405260228,28,2407185110,1924882
1652101019,198470,true,2404298364,28,2407185110,2886746
1652101115,198471,true,2404057959,28,2407425828,3367869
1652101154,198470,true,2404298364,28,2407425828,3127464
1652101174,198472,true,2403817577,28,2407425828,3608251
1652101236,198477,true,2402616028,28,2407425828,4809800
1652101246,198478,true,2402375791,28,2407425828,5050037
1652101253,198477,true,2402616028,28,2407425828,4809800
1652101275,198479,true,2402135577,28,2407425828,5290251
1652101297,198483,true,2401174963,28,2407425828,6250865
1652101315,198484,true,2400934870,28,2407185110,6250240
1652101334,198484,true,2400934870,28,2407185110,6250240
1652101640,198486,true,2400454755,28,2406222476,5767721
1652101842,198491,true,2399254887,28,2405019726,5764839
1652101898,198492,true,2399014986,28,2404298364,5283378
1652102076,198492,true,2399014986,28,2401895388,2880402
1652102097,198494,true,2398535255,28,2401655222,3119967
1652102221,198498,true,2397576081,28,2400214733,2638652
1652102457,198499,true,2397336347,28,2397336347,0
1652102498,198499,true,2397336347,28,2396856952,-479395
1652102549,198501,true,2396856952,28,2396138038,-718914
1652102739,198506,true,2395658883,28,2393503867,-2155016
1652102915,198507,true,2395419341,28,2392068267,-3351074
1652103063,198506,true,2395658883,28,2391111679,-4547204
1652103086,198508,true,2395179823,28,2391111679,-4068144
1652103130,198512,true,2394221990,28,2391350790,-2871200
1652103144,198513,true,2393982592,28,2391350790,-2631802
1652103200,198512,true,2394221990,28,2391829085,-2392905
1652103286,198513,true,2393982592,28,2392068267,-1914325
1652103354,198516,true,2393264541,28,2392546705,-717836
1652103384,198516,true,2393264541,28,2392785960,-478581
1652103395,198514,true,2393743218,28,2392785960,-957258
1652103407,198515,true,2393503867,28,2393025238,-478629
1652103415,198516,true,2393264541,28,2393025238,-239303
1652103420,198515,true,2393503867,28,2393025238,-478629
1652103481,198513,true,2393982592,28,2393982592,0
1652103546,198513,true,2393982592,28,2395179823,1197231
1652103558,198515,true,2393503867,28,2395419341,1915474
1652103643,198513,true,2393982592,28,2397336347,3353755
1652103691,198510,true,2394700859,28,2398535255,3834396
1652103738,198509,true,2394940329,28,2399734762,4794433
1652103761,198510,true,2394700859,28,2400214733,5513874
1652103948,198508,true,2395179823,28,2404057959,8878136
1652103952,198504,true,2396138038,28,2404057959,7919921
1652103969,198503,true,2396377652,28,2404538794,8161142
1652103993,198504,true,2396138038,28,2404779248,8641210
1652104003,198503,true,2396377652,28,2405019726,8642074
1652104031,198499,true,2397336347,28,2405500754,8164407
1652104079,198499,true,2397336347,28,2405981878,8645531
1652104303,198500,true,2397096637,28,2408388943,11292306
1652104411,198498,true,2397576081,28,2409593378,12017297
1652104723,198493,true,2398775108,28,2413692966,14917858
1652104775,198493,true,2398775108,28,2414417146,15642038
1652105343,198494,true,2398535255,28,2416349356,17814101
1652105351,198492,true,2399014986,28,2416349356,17334370
1652105389,198489,true,2399734762,28,2415624596,15889834
1652105406,198489,true,2399734762,28,2415383058,15648296
1652105573,198491,true,2399254887,28,2412486481,13231594
1652105743,198490,true,2399494813,28,2409834338,10339525
1652106026,198486,true,2400454755,28,2408148128,7693373
1652106227,198486,true,2400454755,28,2406944415,6489660
1652106285,198488,true,2399974736,28,2406463099,6488363
1652106300,198486,true,2400454755,28,2406463099,6008344
1652106349,198483,true,2401174963,28,2405741304,4566341
1652106372,198483,true,2401174963,28,2405500754,4325791
1652106869,198485,true,2400694800,28,2399014986,-1679814
1652106886,198484,true,2400934870,28,2398775108,-2159762
1652107180,198481,true,2401655222,28,2394940329,-6714893
1652107194,198481,true,2401655222,28,2394700859,-6954363
1652107219,198484,true,2400934870,28,2394461412,-6473458
1652107309,198483,true,2401174963,28,2393743218,-7431745
1652107652,198479,true,2402135577,28,2392785960,-9349617
1652107657,198479,true,2402135577,28,2392785960,-9349617
1652107764,198482,true,2401415081,28,2392068267,-9346814
1652107898,198481,true,2401655222,28,2391829085,-9826137
1652108069,198477,true,2402616028,28,2391589926,-11026102
1652108091,198477,true,2402616028,28,2391589926,-11026102
1652108120,198480,true,2401895388,28,2391350790,-10544598
1652108127,198479,true,2402135577,28,2391350790,-10784787
1652108162,198476,true,2402856290,28,2391589926,-11266364
1652108223,198476,true,2402856290,28,2391350790,-11505500
1652108230,198479,true,2402135577,28,2391350790,-10784787
1652108259,198479,true,2402135577,28,2391350790,-10784787
1652108463,198476,true,2402856290,28,2390872592,-11983698
1652108618,198477,true,2402616028,28,2390394489,-12221539
1652108683,198480,true,2401895388,28,2390155474,-11739914
1652108867,198480,true,2401895388,28,2390155474,-11739914
1652109004,198478,true,2402375791,28,2390394489,-11981302
1652109014,198479,true,2402135577,28,2390394489,-11741088
1652109578,198482,true,2401415081,28,2390872592,-10542489
1652109640,198481,true,2401655222,28,2390633529,-11021693
1652109682,198479,true,2402135577,28,2390394489,-11741088
1652109713,198480,true,2401895388,28,2390155474,-11739914
1652109815,198483,true,2401174963,28,2389677514,-11497449
1652109974,198482,true,2401415081,28,2389199650,-12215431
1652109986,198480,true,2401895388,28,2389199650,-12695738
1652110000,198482,true,2401415081,28,2389199650,-12215431
1652110079,198485,true,2400694800,28,2388960754,-11734046
1652110089,198485,true,2400694800,28,2388960754,-11734046
1652110207,198483,true,2401174963,28,2388721882,-12453081
1652110260,198485,true,2400694800,28,2388244209,-12450591
1652110285,198489,true,2399734762,28,2388005409,-11729353
1652110293,198489,true,2399734762,28,2388005409,-11729353
1652110314,198488,true,2399974736,28,2387766632,-12208104
1652110351,198490,true,2399494813,28,2387289151,-12205662
1652110405,198495,true,2398295425,28,2386573107,-11722318
1652110434,198496,true,2398055620,28,2386095864,-11959756
1652110451,198496,true,2398055620,28,2385618716,-12436904
1652110465,198499,true,2397336347,28,2385380178,-11956169
1652110616,198504,true,2396138038,28,2382757834,-13380204
1652110619,198505,true,2395898448,28,2382757834,-13140614
1652110678,198505,true,2395898448,28,2381566812,-14331636
1652110719,198507,true,2395419341,28,2380852485,-14566856
1652110738,198511,true,2394461412,28,2380614424,-13846988
1652110758,198512,true,2394221990,28,2380376386,-13845604
1652110809,198511,true,2394461412,28,2379900382,-14561030
1652111012,198511,true,2394461412,28,2377759542,-16701870
1652111219,198515,true,2393503867,28,2375620628,-17883239
1652111282,198516,true,2393264541,28,2374908085,-18356456
1652111379,198514,true,2393743218,28,2373958359,-19784859
1652111500,198515,true,2393503867,28,2373009013,-20494854
1652111539,198519,true,2392546705,28,2372771736,-19774969
1652111609,198519,true,2392546705,28,2372534482,-20012223
1652112056,198517,true,2393025238,28,2371348571,-21676667
1652112097,198518,true,2392785960,28,2371585706,-21200254
1652112137,198521,true,2392068267,28,2371822864,-20245403
1652112230,198521,true,2392068267,28,2372771736,-19296531
1652112256,198520,true,2392307474,28,2373246314,-19061160
1652112284,198520,true,2392307474,28,2373483638,-18823836
1652112326,198524,true,2391350790,28,2373958359,-17392431
1652112391,198524,true,2391350790,28,2374433174,-16917616
1652112430,198522,true,2391829085,28,2374908085,-16921000
1652112435,198523,true,2391589926,28,2374908085,-16681841
1652112439,198526,true,2390872592,28,2375145575,-15727017
1652112473,198526,true,2390872592,28,2375620628,-15251964
1652112507,198523,true,2391589926,28,2376095776,-15494150
1652112630,198523,true,2391589926,28,2377284062,-14305864
1652112796,198527,true,2390633529,28,2378235118,-12398411
1652112844,198527,true,2390633529,28,2378472942,-12160587
1652112878,198526,true,2390872592,28,2378710789,-12161803
1652112925,198526,true,2390872592,28,2378948660,-11923932
1652112947,198530,true,2389916482,28,2379186555,-10729927
1652112958,198529,true,2390155474,28,2379186555,-10968919
1652112966,198528,true,2390394489,28,2379186555,-11207934
1652113014,198528,true,2390394489,28,2379900382,-10494107
1652113340,198532,true,2389438570,28,2383711080,-5727490
1652113359,198532,true,2389438570,28,2383949451,-5489119
1652113389,198531,true,2389677514,28,2384187846,-5489668
1652113582,198532,true,2389438570,28,2385618716,-3819854
1652113610,198536,true,2388483034,28,2385857278,-2625756
1652113647,198537,true,2388244209,28,2386095864,-2148345
1652113664,198537,true,2388244209,28,2386095864,-2148345
1652113895,198539,true,2387766632,28,2386811764,-954868
1652113914,198543,true,2386811764,28,2386811764,0
1652114061,198544,true,2386573107,28,2387527879,954772
1652114124,198543,true,2386811764,28,2387766632,954868
1652114169,198546,true,2386095864,28,2388244209,2148345
1652114227,198550,true,2385141664,28,2388483034,3341370
1652114233,198550,true,2385141664,28,2388483034,3341370
1652114242,198549,true,2385380178,28,2388483034,3102856
1652114262,198551,true,2384903174,28,2388244209,3341035
1652114275,198556,true,2383711080,28,2388244209,4533129
1652114303,198555,true,2383949451,28,2388005409,4055958
1652114438,198556,true,2383711080,28,2386095864,2384784
1652114496,198558,true,2383234409,28,2385380178,2145769
1652114551,198563,true,2382043149,28,2384664707,2621558
1652114582,198563,true,2382043149,28,2384187846,2144697
1652114675,198564,true,2381804969,28,2382757834,952865
1652114689,198566,true,2381328679,28,2382519582,1190903
1652114718,198570,true,2380376386,28,2382043149,1666763
1652114740,198570,true,2380376386,28,2381566812,1190426
1652114865,198571,true,2380138372,28,2378235118,-1903254
1652114953,198573,true,2379662416,28,2376095776,-3566640
1652114997,198577,true,2378710789,28,2374670618,-4040171
1652115013,198578,true,2378472942,28,2374195755,-4277187
1652115042,198579,true,2378235118,28,2373246314,-4988804
1652115060,198582,true,2377521790,28,2372534482,-4987308
1652115111,198585,true,2376808676,28,2370874372,-5934304
1652115118,198585,true,2376808676,28,2370637308,-6171368
1652115142,198587,true,2376333386,28,2369926260,-6407126
1652115213,198590,true,2375620628,28,2367320904,-8299724
1652115282,198594,true,2374670618,28,2364718413,-9952205
1652115343,198594,true,2374670618,28,2362591230,-12079388
1652115470,198597,true,2373958359,28,2358578437,-15379922
1652115514,198600,true,2373246314,28,2357399502,-15846812
1652115540,198603,true,2372534482,28,2356456778,-16077704
1652115661,198604,true,2372297253,28,2352689650,-19607603
1652115786,198607,true,2371585706,28,2348458829,-23126877
1652115870,198611,true,2370637308,28,2345642509,-24994799
1652115873,198614,true,2369926260,28,2345407968,-24518292
1652115930,198616,true,2369452345,28,2343063850,-26388495
1652115931,198619,true,2368741652,28,2343063850,-25677802
1652115955,198624,true,2367557636,28,2341658503,-25899133
1652115975,198629,true,2366374212,28,2340488025,-25886187
1652115986,198633,true,2365427899,28,2339786019,-25641880
1652116017,198636,true,2364718413,28,2337915033,-26803380
1652116067,198641,true,2363536408,28,2335111357,-28425051
1652116072,198646,true,2362354995,28,2334877870,-27477125
1652116082,198650,true,2361410289,28,2334410964,-26999325
1652116114,198653,true,2360702007,28,2333010808,-27691199
1652116122,198657,true,2359757963,28,2332544275,-27213688
1652116133,198662,true,2358578437,28,2332077836,-26500601
1652116159,198667,true,2357399502,28,2330912147,-26487355
1652116218,198669,true,2356928093,28,2328349682,-28578411
1652116226,198673,true,2355985557,28,2328116870,-27868687
1652116277,198677,true,2355043398,28,2326255214,-28788184
1652116378,198681,true,2354101617,28,2322536368,-31565249
1652116426,198682,true,2353866230,28,2321143334,-32722896
1652116443,198687,true,2352689650,28,2320679174,-32010476
1652116474,198690,true,2351983984,28,2319751135,-32232849
1652116478,198693,true,2351278530,28,2319519183,-31759347
1652116593,198695,true,2350808345,28,2316042686,-34765659
1652116650,198699,true,2349868256,28,2314422104,-35446152
1652116702,198702,true,2349163437,28,2313033937,-36129500
1652116733,198705,true,2348458829,28,2312340166,-36118663
1652116745,198705,true,2348458829,28,2312108955,-36349874
1652116749,198708,true,2347754432,28,2311877767,-35876665
1652116767,198710,true,2347284952,28,2311646602,-35638350
1652116779,198712,true,2346815565,28,2311415461,-35400104
1652116787,198712,true,2346815565,28,2311415461,-35400104
1652116899,198714,true,2346346272,28,2310260100,-36086172
1652117260,198715,true,2346111661,28,2308874429,-37237232
1652117298,198717,true,2345642509,28,2308643564,-36998945
1652117325,198717,true,2345642509,28,2308643564,-36998945
1652117392,198719,true,2345173451,28,2308412723,-36760728
1652117479,198720,true,2344938957,28,2308412723,-36526234
1652117494,198722,true,2344470040,28,2308412723,-36057317
1652117508,198723,true,2344235616,28,2308643564,-35592052
1652117626,198725,true,2343766839,28,2309567160,-34199679
1652117731,198726,true,2343532486,28,2310953247,-32579239
1652117763,198728,true,2343063850,28,2311877767,-31186083
1652117814,198729,true,2342829567,28,2313496567,-29333000
1652118150,198732,true,2342126859,28,2321607585,-20519274
1652118157,198733,true,2341892669,28,2321839746,-20052923
1652118341,198734,true,2341658503,28,2326022612,-15635891
1652118420,198736,true,2341190242,28,2327884082,-13306160
1652118487,198738,true,2340722074,28,2329281161,-11440913
1652118502,198738,true,2340722074,28,2329747041,-10975033
1652118550,198740,true,2340254000,28,2330679079,-9574921
1652118666,198741,true,2340019998,28,2331844652,-8175346
1652118697,198743,true,2339552064,28,2332311044,-7241020
1652118745,198744,true,2339318132,28,2332544275,-6773857
1652118818,198746,true,2338850339,28,2332777530,-6072809
1652118821,198747,true,2338616477,28,2332777530,-5838947
1652118830,198749,true,2338148824,28,2332777530,-5371294
1652118841,198751,true,2337681265,28,2332777530,-4903735
1652118887,198755,true,2336746426,28,2332544275,-4202151
1652118915,198758,true,2336045542,28,2332311044,-3734498
1652118966,198761,true,2335344868,28,2331844652,-3500216
1652119012,198763,true,2334877870,28,2331378353,-3499517
1652119105,198766,true,2334177546,28,2330912147,-3265399
1652119147,198769,true,2333477433,28,2330679079,-2798354
1652119155,198772,true,2332777530,28,2330679079,-2098451
1652119201,198773,true,2332544275,28,2330213013,-2331262
1652119246,198779,true,2331145238,28,2329514089,-1631149
1652119251,198782,true,2330446035,28,2329514089,-931946
1652119312,198786,true,2329514089,28,2328349682,-1164407
1652119327,198789,true,2328815375,28,2328116870,-698505
1652119413,198793,true,2327884082,28,2326487840,-1396242
1652119721,198796,true,2327185856,28,2321375448,-5810408
1652119803,198800,true,2326255214,28,2320215108,-6040106
1652119816,198802,true,2325790033,28,2319983110,-5806923
1652119831,198807,true,2324627487,28,2319519183,-5108304
1652119849,198810,true,2323930238,28,2319287254,-4642984
1652119852,198814,true,2323000898,28,2319055349,-3945549
1652119966,198816,true,2322536368,28,2316274290,-6262078
1652120093,198821,true,2321375448,28,2312340166,-9035282
1652120221,198825,true,2320447130,28,2308412723,-12034407
1652120247,198828,true,2319751135,28,2307720338,-12030797
1652120259,198831,true,2319055349,28,2307489589,-11565760
1652120311,198836,true,2317896169,28,2305874992,-12021177
1652120322,198839,true,2317200939,28,2305644427,-11556512
1652120359,198841,true,2316737568,28,2304952872,-11784696
1652120455,198842,true,2316505918,28,2303109740,-13396178
1652120465,198846,true,2315579547,28,2302879452,-12700095
1652120495,198849,true,2314885012,28,2302418945,-12466067
1652120523,198851,true,2314422104,28,2301728357,-12693747
1652120542,198853,true,2313959289,28,2301268081,-12691208
1652120548,198857,true,2313033937,28,2301037977,-11995960
1652120591,198860,true,2312340166,28,2300117792,-12222374
1652120596,198862,true,2311877767,28,2299887803,-11989964
1652120619,198865,true,2311184342,28,2299197975,-11986367
1652120633,198869,true,2310260100,28,2298738204,-11521896
1652120652,198872,true,2309567160,28,2298508353,-11058807
1652120678,198874,true,2309105316,28,2297818939,-11286377
1652120758,198875,true,2308874429,28,2296670374,-12204055
1652120778,198879,true,2307951110,28,2296440730,-11510380
1652120786,198881,true,2307489589,28,2296440730,-11048859
1652120802,198882,true,2307258863,28,2296211108,-11047755
1652120884,198883,true,2307028160,28,2295063347,-11964813
1652120958,198887,true,2306105579,28,2293916160,-12189419
1652121122,198888,true,2305874992,28,2293228123,-12646869
1652121152,198889,true,2305644427,28,2292998823,-12645604
1652121153,198889,true,2305644427,28,2292998823,-12645604
1652121169,198892,true,2304952872,28,2292769546,-12183326
1652121191,198895,true,2304261525,28,2292540292,-11721233
1652121199,198896,true,2304031122,28,2292311061,-11720061
1652121221,198897,true,2303800742,28,2292081852,-11718890
1652121269,198901,true,2302879452,28,2291394365,-11485087
1652121274,198903,true,2302418945,28,2291165249,-11253696
1652121332,198903,true,2302418945,28,2290707084,-11711861
1652121348,198903,true,2302418945,28,2290478037,-11940908
1652121376,198906,true,2301728357,28,2290020010,-11708347
1652121391,198908,true,2301268081,28,2289791031,-11477050
1652121396,198906,true,2301728357,28,2289791031,-11937326
1652121402,198906,true,2301728357,28,2289791031,-11937326
1652121429,198907,true,2301498207,28,2289104231,-12393976
1652121444,198909,true,2301037977,28,2288875343,-12162634
1652121480,198907,true,2301498207,28,2287960022,-13538185
1652121536,198906,true,2301728357,28,2287045067,-14683290
1652121591,198907,true,2301498207,28,2286130477,-15367730
1652121627,198910,true,2300807896,28,2285673320,-15134576
1652121658,198909,true,2301037977,28,2285216254,-15821723
1652121673,198909,true,2301037977,28,2284987755,-16050222
1652121735,198911,true,2300577838,28,2284073988,-16503850
1652121810,198914,true,2299887803,28,2282704023,-17183780
1652121852,198914,true,2299887803,28,2282019349,-17868454
1652121855,198914,true,2299887803,28,2282019349,-17868454
1652121877,198917,true,2299197975,28,2281563014,-17634961
1652121928,198921,true,2298278525,28,2280650617,-17627908
1652121947,198921,true,2298278525,28,2280194555,-18083970
1652122009,198921,true,2298278525,28,2279054800,-19223725
1652122010,198925,true,2297359444,28,2279054800,-18304644
1652122040,198928,true,2296670374,28,2278826917,-17843457
1652122090,198927,true,2296900041,28,2278143405,-18756636
1652122101,198926,true,2297129731,28,2278143405,-18986326
1652122117,198929,true,2296440730,28,2278143405,-18297325
1652122122,198932,true,2295751935,28,2277915614,-17836321
1652122140,198930,true,2296211108,28,2277915614,-18295494
1652122239,198929,true,2296440730,28,2277004675,-19436055
1652122263,198933,true,2295522383,28,2276776998,-18745385
1652122305,198937,true,2294604403,28,2276321711,-18282692
1652122314,198935,true,2295063347,28,2276321711,-18741636
1652122321,198935,true,2295063347,28,2276321711,-18741636
1652122330,198939,true,2294145551,28,2276094101,-18051450
1652122334,198943,true,2293228123,28,2276094101,-17134022
1652122351,198941,true,2293686791,28,2276321711,-17365080
1652122547,198940,true,2293916160,28,2277687845,-16228315
1652122732,198943,true,2293228123,28,2279054800,-14173323
1652122758,198947,true,2292311061,28,2279054800,-13256261
1652122768,198946,true,2292540292,28,2279054800,-13485492
1652122816,198946,true,2292540292,28,2278826917,-13713375
1652122823,198951,true,2291394365,28,2278599057,-12795308
1652122847,198955,true,2290478037,28,2278599057,-11878980
1652122866,198954,true,2290707084,28,2278371220,-12335864
1652122897,198954,true,2290707084,28,2278371220,-12335864
1652123011,198959,true,2289562074,28,2278143405,-11418669
1652123082,198964,true,2288417637,28,2278143405,-10274232
1652123176,198963,true,2288646479,28,2277915614,-10730865
1652123189,198964,true,2288417637,28,2277915614,-10502023
1652123209,198969,true,2287273771,28,2277915614,-9358157
1652123220,198973,true,2286359090,28,2277915614,-8443476
1652123242,198973,true,2286359090,28,2278143405,-8215685
1652123271,198973,true,2286359090,28,2278143405,-8215685
1652123291,198978,true,2285216254,28,2278371220,-6845034
1652123391,198982,true,2284302396,28,2278599057,-5703339
1652123462,198981,true,2284530826,28,2278826917,-5703909
1652123480,198981,true,2284530826,28,2279054800,-5476026
1652123510,198984,true,2283845604,28,2279282705,-4562899
1652123540,198988,true,2282932294,28,2279510633,-3421661
1652123594,198987,true,2283160587,28,2279966558,-3194029
1652123611,198986,true,2283388903,28,2280194555,-3194348
1652123715,198990,true,2282475776,28,2281791170,-684606
1652123736,198993,true,2281791170,28,2282247551,456381
1652123790,198992,true,2282019349,28,2283160587,1141238
1652123808,198991,true,2282247551,28,2283388903,1141352
1652123822,198993,true,2281791170,28,2283617242,1826072
1652124035,198996,true,2281106769,28,2284073988,2967219
1652124053,198995,true,2281334880,28,2284073988,2739108
1652124065,198993,true,2281791170,28,2283845604,2054434
1652124076,198996,true,2281106769,28,2283845604,2738835
1652124105,199000,true,2280194555,28,2283845604,3651049
1652124132,198999,true,2280422574,28,2283617242,3194668
1652124175,198998,true,2280650617,28,2283160587,2509970
1652124206,199001,true,2279966558,28,2282704023,2737465
1652124368,199005,true,2279054800,28,2279966558,911758
1652124423,199004,true,2279282705,28,2279054800,-227905
1652124440,199002,true,2279738584,28,2278826917,-911667
1652124464,199004,true,2279282705,28,2278371220,-911485
1652124551,199008,true,2278371220,28,2276776998,-1594222
1652124590,199007,true,2278599057,28,2276549343,-2049714
1652124619,199005,true,2279054800,28,2276094101,-2960699
1652124620,199007,true,2278599057,28,2276094101,-2504956
1652124751,199013,true,2277232376,28,2274728923,-2503453
1652124769,199012,true,2277460099,28,2274501472,-2958627
1652124942,199011,true,2277687845,28,2272228221,-5459624
1652124956,199014,true,2277004675,28,2272228221,-4776454
1652124970,199020,true,2275638951,28,2272001021,-3637930
1652124976,199019,true,2275866515,28,2271773844,-4092671
1652125007,199018,true,2276094101,28,2271319557,-4774544
1652125024,199021,true,2275411409,28,2271092448,-4318961
1652125033,199025,true,2274501472,28,2271092448,-3409024
1652125169,199023,true,2274956395,28,2269957242,-4999153
1652125212,199021,true,2275411409,28,2269730269,-5681140
1652125246,199024,true,2274728923,28,2269503319,-5225604
1652125342,199027,true,2274046640,28,2268822604,-5224036
1652125395,199025,true,2274501472,28,2268368908,-6132564
1652125404,199024,true,2274728923,28,2268142094,-6586829
1652125428,199027,true,2274046640,28,2267688533,-6358107
1652125464,199032,true,2272909958,28,2267235063,-5674895
1652125493,199031,true,2273137249,28,2266555029,-6582220
1652125519,199031,true,2273137249,28,2266101786,-7035463
1652125558,199034,true,2272455444,28,2265195572,-7259872
1652125592,199039,true,2271319557,28,2264516149,-6803408
1652125596,199038,true,2271546689,28,2264516149,-7030540
1652125645,199038,true,2271546689,28,2263384231,-8162458
1652125684,199041,true,2270865362,28,2262252878,-8612484
1652125706,199046,true,2269730269,28,2261800495,-7929774
1652125709,199044,true,2270184238,28,2261800495,-8383743
1652125731,199044,true,2270184238,28,2261122091,-9062147
1652125810,199048,true,2269276391,28,2258862212,-10414179
1652126014,199053,true,2268142094,28,2254349227,-13792867
1652126104,199051,true,2268595745,28,2252997091,-15598654
1652126122,199052,true,2268368908,28,2252771814,-15597094
1652126136,199056,true,2267461787,28,2252546559,-14915228
1652126155,199059,true,2266781684,28,2252546559,-14235125
1652126196,199056,true,2267461787,28,2252321327,-15140460
1652126206,199055,true,2267688533,28,2252321327,-15367206
1652126225,199057,true,2267235063,28,2252096118,-15138945
1652126243,199060,true,2266555029,28,2252096118,-14458911
1652126244,199057,true,2267235063,28,2252096118,-15138945
1652126306,199056,true,2267461787,28,2252096118,-15365669
1652126308,199058,true,2267008363,28,2252096118,-14912245
1652126339,199061,true,2266328396,28,2252096118,-14232278
1652126403,199057,true,2267235063,28,2252321327,-14913736
1652126444,199056,true,2267461787,28,2252321327,-15140460
1652126451,199057,true,2267235063,28,2252321327,-14913736
1652126471,199059,true,2266781684,28,2252546559,-14235125
1652126487,199055,true,2267688533,28,2252771814,-14916719
1652126517,199052,true,2268368908,28,2253222391,-15146517
1652126546,199053,true,2268142094,28,2253673058,-14469036
1652126569,199054,true,2267915302,28,2253898425,-14016877
1652126607,199049,true,2269049486,28,2254800120,-14249366
1652126661,199046,true,2269730269,28,2255702175,-14028094
1652126686,199047,true,2269503319,28,2256153338,-13349981
1652126691,199048,true,2269276391,28,2256153338,-13123053
1652126766,199045,true,2269957242,28,2257733119,-12224123
1652126825,199043,true,2270411257,28,2259088098,-11323159
1652126983,199043,true,2270411257,28,2261800495,-8610762
1652127015,199045,true,2269957242,28,2262479103,-7478139
1652127076,199042,true,2270638298,28,2263610569,-7027729
1652127082,199041,true,2270865362,28,2263836930,-7028432
1652127083,199041,true,2270865362,28,2263836930,-7028432
1652127117,199043,true,2270411257,28,2264516149,-5895108
1652127169,199040,true,2271092448,28,2265648634,-5443814
1652127258,199036,true,2272001021,28,2269276391,-2724630
1652127315,199036,true,2272001021,28,2271773844,-227177
1652127341,199038,true,2271546689,28,2272909958,1363269
1652127353,199034,true,2272455444,28,2273364563,909119
1652127379,199031,true,2273137249,28,2274501472,1364223
1652127542,199032,true,2272909958,28,2281791170,8881212
1652127575,199034,true,2272455444,28,2283388903,10933459
1652127620,199030,true,2273364563,28,2285673320,12308757
1652127839,199027,true,2274046640,28,2295981510,21934870
1652127861,199027,true,2274046640,28,2296900041,22853401
1652127895,199028,true,2273819258,28,2298278525,24459267
1652127931,199025,true,2274501472,28,2299887803,25386331
1652127945,199022,true,2275183891,28,2300347804,25163913
1652127964,199021,true,2275411409,28,2301037977,25626568
1652127971,199022,true,2275183891,28,2301268081,26084190
1652128219,199018,true,2276094101,28,2309105316,33011215
1652128257,199015,true,2276776998,28,2310260100,33483102
1652128261,199014,true,2277004675,28,2310260100,33255425
1652128297,199015,true,2276776998,28,2310953247,34176249
1652128309,199012,true,2277460099,28,2310953247,33493148
1652128522,199011,true,2277687845,28,2312571400,34883555
1652128578,199010,true,2277915614,28,2313033937,35118323
1652128643,199011,true,2277687845,28,2313265240,35577395
1652128654,199008,true,2278371220,28,2313265240,34894020
1652128681,199007,true,2278599057,28,2313265240,34666183
1652128711,199006,true,2278826917,28,2313265240,34438323
1652128719,199008,true,2278371220,28,2313265240,34894020
1652128772,199005,true,2279054800,28,2313033937,33979137
1652128781,199005,true,2279054800,28,2313033937,33979137
1652128841,199005,true,2279054800,28,2312571400,33516600
1652128907,199007,true,2278599057,28,2311877767,33278710
1652128936,199005,true,2279054800,28,2311415461,32360661
1652128974,199005,true,2279054800,28,2310722175,31667375
1652128995,199006,true,2278826917,28,2310260100,31433183
1652129014,199008,true,2278371220,28,2309798117,31426897
1652129056,199006,true,2278826917,28,2308874429,30047512
1652129094,199006,true,2278826917,28,2307720338,28893421
1652129123,199007,true,2278599057,28,2307028160,28429103
1652129293,199009,true,2278143405,28,2302188726,24045321
1652129343,199006,true,2278826917,28,2301037977,22211060
1652129477,199006,true,2278826917,28,2297589180,18762263
1652129498,199007,true,2278599057,28,2297129731,18530674
1652129548,199007,true,2278599057,28,2296440730,17841673
1652129611,199004,true,2279282705,28,2295292854,16010149
1652129618,199002,true,2279738584,28,2295292854,15554270
1652129652,199003,true,2279510633,28,2294833864,15323231
1652129811,199002,true,2279738584,28,2293457445,13718861
1652129818,198999,true,2280422574,28,2293457445,13034871
1652129893,198997,true,2280878682,28,2292540292,11661610
1652129970,198997,true,2280878682,28,2291623505,10744823
1652130056,198996,true,2281106769,28,2290478037,9371268
1652130148,198993,true,2281791170,28,2289791031,7999861
1652130202,198991,true,2282247551,28,2289562074,7314523
1652130229,198991,true,2282247551,28,2289333141,7085590
1652130289,198991,true,2282247551,28,2288875343,6627792
1652130470,198988,true,2282932294,28,2287502499,4570205
1652130494,198985,true,2283617242,28,2287502499,3885257
1652130532,198985,true,2283617242,28,2287502499,3885257
1652130575,198984,true,2283845604,28,2287731249,3885645
1652130587,198982,true,2284302396,28,2287960022,3657626
1652130589,198979,true,2284987755,28,2287960022,2972267
1652130646,198978,true,2285216254,28,2288875343,3659089
1652131196,198977,true,2285444775,28,2300117792,14673017
1652131224,198974,true,2286130477,28,2300807896,14677419
1652131437,198972,true,2286587726,28,2303340051,16752325
1652131453,198970,true,2287045067,28,2303340051,16294984
1652131753,198968,true,2287502499,28,2303800742,16298243
1652132031,198965,true,2288188818,28,2305644427,17455609
1652132462,198962,true,2288875343,28,2308412723,19537380
1652132563,198961,true,2289104231,28,2307951110,18846879
1652132669,198959,true,2289562074,28,2307720338,18158264
1652132780,198955,true,2290478037,28,2307720338,17242301
1652132836,198952,true,2291165249,28,2307720338,16555089
1652132870,198950,true,2291623505,28,2307720338,16096833
1652133004,198948,true,2292081852,28,2307489589,15407737
1652133164,198944,true,2292998823,28,2308181905,15183082
1652133191,198940,true,2293916160,28,2308412723,14496563
1652133240,198938,true,2294374966,28,2308412723,14037757
1652133292,198935,true,2295063347,28,2308412723,13349376
1652133369,198933,true,2295522383,28,2308181905,12659522
1652133397,198930,true,2296211108,28,2307951110,11740002
1652133413,198928,true,2296670374,28,2307951110,11280736
1652133427,198927,true,2296900041,28,2307720338,10820297
1652133435,198927,true,2296900041,28,2307720338,10820297
1652133465,198925,true,2297359444,28,2307258863,9899419
1652133612,198924,true,2297589180,28,2305183368,7594188
1652133622,198923,true,2297818939,28,2304952872,7133933
1652133682,198923,true,2297818939,28,2304031122,6212183
1652133748,198923,true,2297818939,28,2303109740,5290801
1652133823,198923,true,2297818939,28,2301498207,3679268
1652133828,198922,true,2298048720,28,2301498207,3449487
1652133883,198922,true,2298048720,28,2300807896,2759176
1652133909,198921,true,2298278525,28,2300347804,2069279
1652133934,198921,true,2298278525,28,2299887803,1609278
1652133954,198920,true,2298508353,28,2299657837,1149484
1652133981,198921,true,2298278525,28,2299427894,1149369
1652134047,198920,true,2298508353,28,2298968078,459725
1652134088,198920,true,2298508353,28,2298738204,229851
1652134211,198920,true,2298508353,28,2297818939,-689414
1652134458,198920,true,2298508353,28,2295522383,-2985970
1652134807,198920,true,2298508353,28,2292311061,-6197292
1652134869,198920,true,2298508353,28,2291623505,-6884848
1652135025,198919,true,2298738204,28,2289791031,-8947173
1652135265,198920,true,2298508353,28,2289333141,-9175212
1652135288,198920,true,2298508353,28,2289562074,-8946279
1652135415,198920,true,2298508353,28,2290478037,-8030316
1652135474,198919,true,2298738204,28,2290707084,-8031120
1652135528,198920,true,2298508353,28,2291394365,-7113988
1652135597,198920,true,2298508353,28,2292311061,-6197292
1652135656,198920,true,2298508353,28,2292998823,-5509530
1652135826,198920,true,2298508353,28,2294374966,-4133387
1652135839,198921,true,2298278525,28,2294374966,-3903559
1652135873,198922,true,2298048720,28,2294604403,-3444317
1652136299,198922,true,2298048720,28,2297359444,-689276
1652136348,198922,true,2298048720,28,2297589180,-459540
1652136385,198924,true,2297589180,28,2297589180,0
1652136401,198926,true,2297129731,28,2297818939,689208
1652136629,198925,true,2297359444,28,2298738204,1378760
1652136722,198925,true,2297359444,28,2299427894,2068450
1652136767,198927,true,2296900041,28,2299657837,2757796
1652136975,198928,true,2296670374,28,2300807896,4137522
1652136995,198927,true,2296900041,28,2301037977,4137936
1652137058,198927,true,2296900041,28,2301268081,4368040
1652137074,198929,true,2296440730,28,2301268081,4827351
1652137276,198931,true,2295981510,28,2301958530,5977020
1652137428,198930,true,2296211108,28,2302188726,5977618
1652137474,198930,true,2296211108,28,2302188726,5977618
1652137488,198933,true,2295522383,28,2302188726,6666343
1652137708,198934,true,2295292854,28,2302188726,6895872
1652137728,198934,true,2295292854,28,2302188726,6895872
1652137748,198933,true,2295522383,28,2302188726,6666343
1652137754,198935,true,2295063347,28,2302188726,7125379
1652137873,198934,true,2295292854,28,2302188726,6895872
1652137934,198934,true,2295292854,28,2301958530,6665676
1652137949,198934,true,2295292854,28,2301958530,6665676
1652138035,198935,true,2295063347,28,2301268081,6204734
1652138050,198935,true,2295063347,28,2301268081,6204734
1652138073,198935,true,2295063347,28,2301037977,5974630
1652138078,198934,true,2295292854,28,2301037977,5745123
1652138159,198935,true,2295063347,28,2300577838,5514491
1652138179,198935,true,2295063347,28,2300347804,5284457
1652138225,198934,true,2295292854,28,2299887803,4594949
1652138235,198933,true,2295522383,28,2299887803,4365420
1652138362,198935,true,2295063347,28,2298508353,3445006
1652138395,198935,true,2295063347,28,2298278525,3215178
1652138462,198933,true,2295522383,28,2297359444,1837061
1652138490,198932,true,2295751935,28,2297129731,1377796
1652138631,198934,true,2295292854,28,2295063347,-229507
1652138684,198934,true,2295292854,28,2294145551,-1147303
1652138774,198933,true,2295522383,28,2292769546,-2752837
1652138794,198932,true,2295751935,28,2292769546,-2982389
1652138808,198933,true,2295522383,28,2292540292,-2982091
1652138870,198933,true,2295522383,28,2291852667,-3669716
1652138906,198932,true,2295751935,28,2291623505,-4128430
1652138925,198931,true,2295981510,28,2291394365,-4587145
1652138957,198934,true,2295292854,28,2290707084,-4585770
1652139028,198935,true,2295063347,28,2289791031,-5272316
1652139147,198935,true,2295063347,28,2287960022,-7103325
1652139349,198936,true,2294833864,28,2284759279,-10074585
1652139402,198939,true,2294145551,28,2283845604,-10299947
1652139609,198940,true,2293916160,28,2280422574,-13493586
1652139610,198940,true,2293916160,28,2280422574,-13493586
1652139765,198940,true,2293916160,28,2277460099,-16456061
1652139825,198943,true,2293228123,28,2276321711,-16906412
1652139830,198945,true,2292769546,28,2276321711,-16447835
1652139865,198945,true,2292769546,28,2275638951,-17130595
1652139895,198946,true,2292540292,28,2274956395,-17583897
1652139933,198949,true,2291852667,28,2274046640,-17806027
1652139959,198951,true,2291394365,28,2273364563,-18029802
1652140152,198951,true,2291394365,28,2269957242,-21437123
1652140164,198952,true,2291165249,28,2269957242,-21208007
1652140198,198956,true,2290249012,28,2269276391,-20972621
1652140328,198958,true,2289791031,28,2267008363,-22782668
1652140363,198960,true,2289333141,28,2266328396,-23004745
1652140371,198962,true,2288875343,28,2266328396,-22546947
1652140436,198966,true,2287960022,28,2265195572,-22764450
1652140465,198968,true,2287502499,28,2264742601,-22759898
1652140662,198969,true,2287273771,28,2261122091,-26151680
1652140717,198971,true,2286816385,28,2259991869,-26824516
1652140737,198975,true,2285901887,28,2259765892,-26135995
1652140900,198978,true,2285216254,28,2256604591,-28611663
1652140935,198980,true,2284759279,28,2255702175,-29057104
1652140948,198982,true,2284302396,28,2255476627,-28825769
1652140966,198986,true,2283388903,28,2255476627,-27912276
1652140985,198988,true,2282932294,28,2255251102,-27681192
1652141038,198990,true,2282475776,28,2254574662,-27901114
1652141059,198992,true,2282019349,28,2254349227,-27670122
1652141087,198997,true,2280878682,28,2253898425,-26980257
1652141147,198999,true,2280422574,28,2252771814,-27650760
1652141162,199001,true,2279966558,28,2252546559,-27419999
1652141187,199003,true,2279510633,28,2252096118,-27414515
1652141191,199007,true,2278599057,28,2252096118,-26502939
1652141230,199010,true,2277915614,28,2251195504,-26720110
1652141243,199011,true,2277687845,28,2250970407,-26717438
1652141250,199013,true,2277232376,28,2250745333,-26487043
1652141276,199016,true,2276549343,28,2250295251,-26254092
1652141278,199018,true,2276094101,28,2250295251,-25798850
1652141315,199019,true,2275866515,28,2249395358,-26471157
1652141345,199021,true,2275411409,28,2248495825,-26915584
1652141397,199025,true,2274501472,28,2247147199,-27354273
1652141422,199027,true,2274046640,28,2246473190,-27573450
1652141437,199028,true,2273819258,28,2246023963,-27795295
1652141439,199030,true,2273364563,28,2245799383,-27565180
1652141488,199035,true,2272228221,28,2244452375,-27775846
1652141562,199037,true,2271773844,28,2242433377,-29340467
1652141575,199038,true,2271546689,28,2241984958,-29561731
1652141604,199040,true,2271092448,28,2241312497,-29779951
1652141665,199045,true,2269957242,28,2240192177,-29765065
1652141716,199047,true,2269503319,28,2239744205,-29759114
1652141790,199048,true,2269276391,28,2239520253,-29756138
1652141815,199049,true,2269049486,28,2239296324,-29753162
1652141825,199053,true,2268142094,28,2239072417,-29069677
1652141848,199055,true,2267688533,28,2238848532,-28840001
1652141854,199057,true,2267235063,28,2238848532,-28386531
1652141880,199059,true,2266781684,28,2238400829,-28380855
1652141905,199063,true,2265875198,28,2238177011,-27698187
1652141947,199066,true,2265195572,28,2237505693,-27689879
1652141967,199067,true,2264969075,28,2237281964,-27687111
1652141970,199069,true,2264516149,28,2237281964,-27234185
1652141977,199074,true,2263384231,28,2237058259,-26325972
1652142134,199078,true,2262479103,28,2234152118,-28326985
1652142146,199080,true,2262026675,28,2233928725,-28097950
1652142165,199082,true,2261574338,28,2233258680,-28315658
1652142216,199087,true,2260443890,28,2232142386,-28301504
1652142238,199092,true,2259314007,28,2231696024,-27617983
1652142268,199094,true,2258862212,28,2231249752,-27612460
1652142287,199097,true,2258184689,28,2231026649,-27158040
1652142298,199101,true,2257281640,28,2230803569,-26478071
1652142358,199106,true,2256153338,28,2229688502,-26464836
1652142448,199108,true,2255702175,28,2227905553,-27796622
1652142473,199111,true,2255025600,28,2227460039,-27565561
1652142484,199115,true,2254123815,28,2227237315,-26886500
1652142495,199120,true,2252997091,28,2227014614,-25982477
1652142501,199123,true,2252321327,28,2227014614,-25306713
1652142543,199126,true,2251645766,28,2226124031,-25521735
1652142573,199130,true,2250745333,28,2225678872,-25066461
1652142593,199135,true,2249620298,28,2225456327,-24163971
1652142610,199137,true,2249170441,28,2225011302,-24159139
1652142612,199140,true,2248495825,28,2225011302,-23484523
1652142669,199145,true,2247371914,28,2224121520,-23250394
1652142709,199149,true,2246473190,28,2223676763,-22796427
1652142749,199152,true,2245799383,28,2222787514,-23011869
1652142901,199155,true,2245125778,28,2219455999,-25669779
1652142913,199160,true,2244003552,28,2219455999,-24547553
1652142962,199164,true,2243106174,28,2218568438,-24537736
1652142991,199167,true,2242433377,28,2218346604,-24086773
1652143000,199168,true,2242209156,28,2218346604,-23862552
1652143030,199172,true,2241312497,28,2218124791,-23187706
1652143094,199175,true,2240640237,28,2218124791,-22515446
1652143185,199177,true,2240192177,28,2218346604,-21845573
1652143193,199178,true,2239968180,28,2218346604,-21621576
1652143221,199181,true,2239296324,28,2218568438,-20727886
1652143229,199184,true,2238624669,28,2218790295,-19834374
1652143332,199183,true,2238848532,28,2220788005,-18060527
1652143350,199185,true,2238400829,28,2221232185,-17168644
1652143361,199187,true,2237953216,28,2221454308,-16498908
1652143375,199189,true,2237505693,28,2221898622,-15607071
1652143422,199187,true,2237953216,28,2223009793,-14943423
1652143543,199187,true,2237953216,28,2225901440,-12051776
1652143592,199188,true,2237729443,28,2226791935,-10937508
1652143594,199190,true,2237281964,28,2226791935,-10490029
1652143643,199187,true,2237953216,28,2228351157,-9602059
1652143653,199186,true,2238177011,28,2228573992,-9603019
1652143687,199187,true,2237953216,28,2229688502,-8264714
1652143749,199190,true,2237281964,28,2231472877,-5809087
1652143773,199187,true,2237953216,28,2232142386,-5810830
1652143784,199186,true,2238177011,28,2232365600,-5811411
1652143999,199188,true,2237729443,28,2239296324,1566881
1652144228,199190,true,2237281964,28,2246023963,8741999
1652144259,199187,true,2237953216,28,2246922507,8969291
1652144369,199186,true,2238177011,28,2250745333,12568322
1652144584,199187,true,2237953216,28,2259539938,21586722
1652144610,199190,true,2237281964,28,2260443890,23161926
1652144636,199186,true,2238177011,28,2261800495,23623484
1652144667,199184,true,2238624669,28,2263384231,24759562
1652144697,199184,true,2238624669,28,2264742601,26117932
1652144710,199184,true,2238624669,28,2265422091,26797422
1652144813,199179,true,2239744205,28,2270865362,31121157
1652144816,199176,true,2240416196,28,2271092448,30676252
1652144871,199174,true,2240864302,28,2273819258,32954956
1652144914,199174,true,2240864302,28,2275866515,35002213
1652144929,199169,true,2241984958,28,2276776998,34792040
1652144971,199166,true,2242657621,28,2278826917,36169296
1652144975,199163,true,2243330485,28,2279054800,35724315
1652145036,199163,true,2243330485,28,2282019349,38688864
1652145150,199157,true,2244676820,28,2286587726,41910906
1652145188,199154,true,2245350290,28,2287731249,42380959
1652145225,199152,true,2245799383,28,2288875343,43075960
1652145451,199152,true,2245799383,28,2293916160,48116777
1652145513,199146,true,2247147199,28,2295063347,47916148
1652145530,199143,true,2247821411,28,2295522383,47700972
1652145547,199141,true,2248270998,28,2295751935,47480937
1652145568,199141,true,2248270998,28,2296211108,47940110
1652145606,199135,true,2249620298,28,2296900041,47279743
1652145624,199132,true,2250295251,28,2297129731,46834480
1652145653,199130,true,2250745333,28,2297818939,47073606
1652145800,199131,true,2250520281,28,2300577838,50057557
1652145918,199126,true,2251645766,28,2303570385,51924619
1652145937,199122,true,2252546559,28,2304031122,51484563
1652145985,199120,true,2252997091,28,2305413886,52416795
1652146008,199120,true,2252997091,28,2306105579,53108488
1652146145,199113,true,2254574662,28,2310491126,55916464
1652146166,199109,true,2255476627,28,2311184342,55707715
1652146199,199106,true,2256153338,28,2312108955,55955617
1652146213,199106,true,2256153338,28,2312571400,56418062
1652146262,199098,true,2257958893,28,2313959289,56000396
1652146333,199094,true,2258862212,28,2316042686,57180474
1652146355,199091,true,2259539938,28,2316737568,57197630
1652146387,199090,true,2259765892,28,2317432659,57666767
1652146417,199083,true,2261348203,28,2318127958,56779755
1652146534,199080,true,2262026675,28,2319287254,57260579
1652146557,199076,true,2262931622,28,2319519183,56587561
1652146647,199075,true,2263157915,28,2319519183,56361268
1652146723,199067,true,2264969075,28,2319287254,54318179
1652146749,199064,true,2265648634,28,2319287254,53638620
1652146795,199060,true,2266555029,28,2319055349,52500320
1652146806,199060,true,2266555029,28,2318823466,52268437
1652146895,199052,true,2268368908,28,2318127958,49759050
1652147053,199049,true,2269049486,28,2317200939,48151453
1652147117,199046,true,2269730269,28,2316505918,46775649
1652147122,199047,true,2269503319,28,2316505918,47002599
1652147132,199040,true,2271092448,28,2316505918,45413470
1652147175,199038,true,2271546689,28,2316042686,44495997
1652147215,199035,true,2272228221,28,2315811105,43582884
1652147275,199036,true,2272001021,28,2315579547,43578526
1652147306,199029,true,2273591899,28,2315348012,41756113
1652147376,199026,true,2274274045,28,2315348012,41073967
1652147443,199023,true,2274956395,28,2315348012,40391617
1652147503,199024,true,2274728923,28,2315348012,40619089
1652147534,199016,true,2276549343,28,2315348012,38798669
1652147598,199014,true,2277004675,28,2315579547,38574872
1652147629,199009,true,2278143405,28,2315579547,37436142
1652147651,199009,true,2278143405,28,2315811105,37667700
1652147707,199001,true,2279966558,28,2315811105,35844547
1652147729,198998,true,2280650617,28,2315811105,35160488
1652148108,198993,true,2281791170,28,2313496567,31705397
1652148141,198991,true,2282247551,28,2313265240,31017689
1652148165,198984,true,2283845604,28,2313033937,29188333
1652148392,198982,true,2284302396,28,2311415461,27113065
1652148453,198979,true,2284987755,28,2311184342,26196587
1652149009,198977,true,2285444775,28,2311415461,25970686
1652149035,198969,true,2287273771,28,2311415461,24141690
1652149121,198967,true,2287731249,28,2311415461,23684212
1652149140,198963,true,2288646479,28,2311646602,23000123
1652149187,198961,true,2289104231,28,2311877767,22773536
1652149345,198952,true,2291165249,28,2313265240,22099991
1652149546,198950,true,2291623505,28,2313727917,22104412
1652149566,198946,true,2292540292,28,2313727917,21187625
1652149625,198943,true,2293228123,28,2313727917,20499794
1652149641,198935,true,2295063347,28,2313727917,18664570
1652149657,198932,true,2295751935,28,2313959289,18207354
1652149676,198928,true,2296670374,28,2313959289,17288915
1652149723,198924,true,2297589180,28,2314422104,16832924
1652149798,198915,true,2299657837,28,2315116500,15458663
1652149838,198912,true,2300347804,28,2315348012,15000208
1652149878,198908,true,2301268081,28,2315579547,14311466
1652150009,198905,true,2301958530,28,2316737568,14779038
1652150025,198897,true,2303800742,28,2316737568,12936826
1652150269,198894,true,2304491951,28,2319983110,15491159
1652150474,198891,true,2305183368,28,2322304137,17120769
1652150495,198889,true,2305644427,28,2322536368,16891941
1652150528,198881,true,2307489589,28,2323000898,15511309
1652150567,198879,true,2307951110,28,2323465522,15514412
1652150593,198875,true,2308874429,28,2323930238,15055809
1652150865,198873,true,2309336227,28,2327884082,18547855
1652151023,198867,true,2310722175,28,2329747041,19024866
1652151085,198865,true,2311184342,28,2330213013,19028671
1652151110,198861,true,2312108955,28,2330446035,18337080
1652151153,198860,true,2312340166,28,2330679079,18338913
1652151192,198856,true,2313265240,28,2330912147,17646907
1652151462,198855,true,2313496567,28,2332777530,19280963
1652151489,198852,true,2314190685,28,2332777530,18586845
1652151495,198851,true,2314422104,28,2332777530,18355426
1652151554,198848,true,2315116500,28,2332544275,17427775
1652151593,198848,true,2315116500,28,2332544275,17427775
1652151967,198847,true,2315348012,28,2331378353,16030341
1652151991,198844,true,2316042686,28,2331378353,15335667
1652152025,198841,true,2316737568,28,2331145238,14407670
1652152029,198842,true,2316505918,28,2331145238,14639320
1652152095,198839,true,2317200939,28,2330912147,13711208
1652152410,198835,true,2318127958,28,2330912147,12784189
1652152439,198831,true,2319055349,28,2330912147,11856798
1652152477,198832,true,2318823466,28,2330679079,11855613
1652152497,198830,true,2319287254,28,2330679079,11391825
1652152529,198827,true,2319983110,28,2330446035,10462925
1652152600,198824,true,2320679174,28,2329980015,9300841
1652152792,198825,true,2320447130,28,2328582517,8135387
1652152830,198825,true,2320447130,28,2328349682,7902552
1652152834,198823,true,2320911242,28,2328349682,7438440
1652153000,198821,true,2321375448,28,2327185856,5810408
1652153004,198823,true,2320911242,28,2327185856,6274614
1652153068,198823,true,2320911242,28,2326953161,6041919
1652153157,198822,true,2321143334,28,2326255214,5111880
1652153260,198821,true,2321375448,28,2325790033,4414585
1652153403,198823,true,2320911242,28,2325092436,4181194
1652153575,198823,true,2320911242,28,2324627487,3716245
1652153603,198822,true,2321143334,28,2324395047,3251713
1652153679,198822,true,2321143334,28,2323930238,2786904
1652153701,198824,true,2320679174,28,2323930238,3251064
1652153765,198824,true,2320679174,28,2323697868,3018694
1652153777,198823,true,2320911242,28,2323697868,2786626
1652153807,198822,true,2321143334,28,2323465522,2322188
1652153863,198825,true,2320447130,28,2323233198,2786068
1652153898,198825,true,2320447130,28,2323233198,2786068
1652153900,198823,true,2320911242,28,2323000898,2089656
1652154158,198822,true,2321143334,28,2320679174,-464160
1652154227,198824,true,2320679174,28,2319983110,-696064
1652154489,198824,true,2320679174,28,2318127958,-2551216
1652154553,198821,true,2321375448,28,2317664402,-3711046
1652154557,198821,true,2321375448,28,2317664402,-3711046
1652154603,198823,true,2320911242,28,2317200939,-3710303
1652154679,198823,true,2320911242,28,2316737568,-4173674
1652154750,198822,true,2321143334,28,2316042686,-5100648
1652154843,198823,true,2320911242,28,2315579547,-5331695
1652155165,198825,true,2320447130,28,2313727917,-6719213
1652155185,198826,true,2320215108,28,2313496567,-6718541
1652155200,198825,true,2320447130,28,2313496567,-6950563
1652155706,198827,true,2319983110,28,2310029097,-9954013
1652155717,198829,true,2319519183,28,2309798117,-9721066
1652155750,198830,true,2319287254,28,2309567160,-9720094
1652155760,198829,true,2319519183,28,2309567160,-9952023
1652155891,198830,true,2319287254,28,2309105316,-10181938
1652156081,198831,true,2319055349,28,2309105316,-9950033
1652156341,198832,true,2318823466,28,2308874429,-9949037
1652156394,198830,true,2319287254,28,2308874429,-10412825
1652156471,198831,true,2319055349,28,2309105316,-9950033
1652156473,198832,true,2318823466,28,2309105316,-9718150
1652156876,198831,true,2319055349,28,2311415461,-7639888
1652156915,198829,true,2319519183,28,2311646602,-7872581
1652156971,198829,true,2319519183,28,2312340166,-7179017
1652157046,198830,true,2319287254,28,2313033937,-6253317
1652157121,198829,true,2319519183,28,2313959289,-5559894
1652157432,198826,true,2320215108,28,2317664402,-2550706
1652157514,198826,true,2320215108,28,2318591607,-1623501
1652157660,198827,true,2319983110,28,2320215108,231998
1652157677,198826,true,2320215108,28,2320447130,232022
1652158109,198823,true,2320911242,28,2324859950,3948708
1652158227,198823,true,2320911242,28,2326022612,5111370
1652158305,198823,true,2320911242,28,2326720489,5809247
1652158487,198822,true,2321143334,28,2327884082,6740748
1652158634,198819,true,2321839746,28,2329048256,7208510
1652158682,198819,true,2321839746,28,2329747041,7907295
1652158904,198819,true,2321839746,28,2332077836,10238090
1652158932,198817,true,2322304137,28,2332544275,10240138
1652158954,198814,true,2323000898,28,2332777530,9776632
1652158965,198814,true,2323000898,28,2333010808,10009910
1652159018,198813,true,2323233198,28,2333710781,10477583
1652159117,198811,true,2323697868,28,2335578403,11880535
1652159172,198808,true,2324395047,28,2336512774,12117727
1652159193,198808,true,2324395047,28,2336980100,12585053
1652159236,198806,true,2324859950,28,2337915033,13055083
1652159239,198803,true,2325557477,28,2337915033,12357556
1652159263,198800,true,2326255214,28,2338382639,12127425
1652159266,198799,true,2326487840,28,2338382639,11894799
1652159349,198797,true,2326953161,28,2340488025,13534864
1652159418,198795,true,2327418575,28,2341892669,14474094
1652159735,198791,true,2328349682,28,2348693675,20343993
1652159760,198792,true,2328116870,28,2349398353,21281483
1652159830,198790,true,2328582517,28,2350808345,22225828
1652159833,198787,true,2329281161,28,2351043426,21762265
1652159963,198784,true,2329980015,28,2353866230,23886215
1652159971,198784,true,2329980015,28,2354101617,24121602
1652160008,198782,true,2330446035,28,2354807918,24361883
1652160080,198780,true,2330912147,28,2356221156,25309009
1652160107,198777,true,2331611491,28,2356928093,25316602
1652160216,198778,true,2331378353,28,2358814295,27435942
1652160255,198777,true,2331611491,28,2359522010,27910519
1652160319,198774,true,2332311044,28,2360702007,28390963
1652160341,198772,true,2332777530,28,2360938077,28160547
1652160459,198773,true,2332544275,28,2362591230,30046955
1652160716,198772,true,2332777530,28,2364954885,32177355
1652160721,198770,true,2333244109,28,2364954885,31710776
1652160832,198767,true,2333944152,28,2365664442,31720290
1652160856,198768,true,2333710781,28,2365901009,32190228
1652160886,198767,true,2333944152,28,2366137599,32193447
1652160900,198765,true,2334410964,28,2366137599,31726635
1652161015,198762,true,2335111357,28,2366847511,31736154
1652161085,198763,true,2334877870,28,2367320904,32443034
1652161149,198761,true,2335344868,28,2367557636,32212768
1652161285,198759,true,2335811961,28,2368267975,32456014
1652161451,198756,true,2336512774,28,2368978526,32465752
1652161485,198756,true,2336512774,28,2369215424,32702650
1652161531,198754,true,2336980100,28,2369452345,32472245
1652161553,198752,true,2337447520,28,2369689291,32241771
1652161587,198748,true,2338382639,28,2370163252,31780613
1652161606,198747,true,2338616477,28,2370400268,31783791
1652161694,198743,true,2339552064,28,2372060047,32507983
1652161716,198740,true,2340254000,28,2372534482,32280482
1652161731,198736,true,2341190242,28,2372771736,31581494
1652161746,198735,true,2341424361,28,2373009013,31584652
1652161788,198731,true,2342361071,28,2373958359,31597288
1652161825,198728,true,2343063850,28,2374670618,31606768
1652161924,198724,true,2344001216,28,2376808676,32807460
1652161999,198724,true,2344001216,28,2378710789,34709573
1652162094,198719,true,2345173451,28,2380614424,35440973
1652162320,198717,true,2345642509,28,2385380178,39737669
1652163145,198713,true,2346580907,28,2398775108,52194201
1652163148,198713,true,2346580907,28,2399014986,52434079
1652163187,198708,true,2347754432,28,2399494813,51740381
1652163248,198706,true,2348224006,28,2400214733,51990727
1652163267,198702,true,2349163437,28,2400454755,51291318
1652163271,198701,true,2349398353,28,2400454755,51056402
1652163300,198696,true,2350573287,28,2400934870,50361583
1652163314,198693,true,2351278530,28,2401174963,49896433
1652163327,198689,true,2352219182,28,2401415081,49195899
1652163351,198687,true,2352689650,28,2401655222,48965572
1652163376,198682,true,2353866230,28,2401895388,48029158
1652163396,198679,true,2354572460,28,2402135577,47563117
1652163401,198674,true,2355749982,28,2402375791,46625809
1652163563,198672,true,2356221156,28,2403817577,47596421
1652163635,198666,true,2357635242,28,2404538794,46903552
1652163676,198663,true,2358342603,28,2404779248,46436645
1652163916,198659,true,2359286082,28,2406222476,46936394
1652164006,198657,true,2359757963,28,2407185110,47427147
1652164030,198651,true,2361174171,28,2407425828,46251657
1652164151,198648,true,2361882594,28,2408870645,46988051
1652164317,198643,true,2363063772,28,2411280600,48216828
1652164345,198640,true,2363772762,28,2411762880,47990118
1652164613,198635,true,2364954885,28,2415383058,50428173
1652164642,198631,true,2365901009,28,2415866159,49965150
1652164679,198626,true,2367084196,28,2416590991,49506795
1652165357,198623,true,2367794392,28,2426276228,58481836
1652165447,198617,true,2369215424,28,2426518856,57303432
1652165495,198613,true,2370163252,28,2426518856,56355604
1652165531,198608,true,2371348571,28,2426518856,55170285
1652165553,198606,true,2371822864,28,2426518856,54695992
1652165694,198601,true,2373009013,28,2426518856,53509843
1652165703,198597,true,2373958359,28,2426518856,52560497
1652165743,198592,true,2375145575,28,2426518856,51373281
1652165753,198589,true,2375858190,28,2426518856,50660666
1652165764,198584,true,2377046357,28,2426518856,49472499
1652165790,198580,true,2377997318,28,2426276228,48278910
1652165880,198576,true,2378948660,28,2425791046,46842386
1652165888,198574,true,2379424473,28,2425791046,46366573
1652166021,198569,true,2380614424,28,2424336080,43721656
1652166084,198566,true,2381328679,28,2423608925,42280246
1652166238,198561,true,2382519582,28,2422155268,39635686
1652166369,198560,true,2382757834,28,2420702484,37944650
1652166394,198555,true,2383949451,28,2420460438,36510987
1652166552,198552,true,2384664707,28,2418524940,33860233
1652166655,198548,true,2385618716,28,2416590991,30972275
1652166685,198547,true,2385857278,28,2415866159,30008881
1652166742,198543,true,2386811764,28,2414658588,27846824
1652166906,198542,true,2387050445,28,2410798416,23747971
1652166917,198538,true,2388005409,28,2410557360,22551951
1652166939,198537,true,2388244209,28,2410075321,21831112
1652167288,198533,true,2389199650,28,2404057959,14858309
1652167312,198531,true,2389677514,28,2403577219,13899705
1652167350,198528,true,2390394489,28,2403336885,12942396
1652167812,198527,true,2390633529,28,2399974736,9341207
1652167854,198522,true,2391829085,28,2399734762,7905677
1652167947,198521,true,2392068267,28,2399254887,7186620
1652167969,198518,true,2392785960,28,2399254887,6468927
1652167991,198517,true,2393025238,28,2399014986,5989748
1652168061,198514,true,2393743218,28,2398535255,4792037
1652168086,198513,true,2393982592,28,2398295425,4312833
1652168757,198512,true,2394221990,28,2394461412,239422
1652168847,198511,true,2394461412,28,2393982592,-478820
1652168945,198508,true,2395179823,28,2393264541,-1915282
1652168978,198508,true,2395179823,28,2393025238,-2154585
1652169398,198507,true,2395419341,28,2390155474,-5263867
1652169501,198507,true,2395419341,28,2389438570,-5980771
1652169537,198504,true,2396138038,28,2389199650,-6938388
1652169597,198505,true,2395898448,28,2388483034,-7415414
1652169619,198504,true,2396138038,28,2388244209,-7893829
1652169657,198504,true,2396138038,28,2388005409,-8132629
1652169717,198503,true,2396377652,28,2387289151,-9088501
1652169917,198503,true,2396377652,28,2385618716,-10758936
1652170041,198503,true,2396377652,28,2384903174,-11474478
1652170198,198503,true,2396377652,28,2384187846,-12189806
1652170230,198501,true,2396856952,28,2384187846,-12669106
1652170413,198501,true,2396856952,28,2383949451,-12907501
1652170630,198500,true,2397096637,28,2383711080,-13385557
1652170810,198500,true,2397096637,28,2383711080,-13385557
1652170846,198498,true,2397576081,28,2383711080,-13865001
1652171246,198498,true,2397576081,28,2384903174,-12672907
1652171311,198497,true,2397815838,28,2385141664,-12674174
1652171419,198496,true,2398055620,28,2385618716,-12436904
1652171628,198495,true,2398295425,28,2387766632,-10528793
1652171709,198494,true,2398535255,28,2388483034,-10052221
1652172262,198493,true,2398775108,28,2391350790,-7424318
1652172353,198492,true,2399014986,28,2391829085,-7185901
1652172541,198490,true,2399494813,28,2392068267,-7426546
1652172805,198490,true,2399494813,28,2392307474,-7187339
1652172839,198489,true,2399734762,28,2392068267,-7666495
1652174154,198488,true,2399974736,28,2388005409,-11969327
1652174300,198487,true,2400214733,28,2387766632,-12448101
1652174543,198486,true,2400454755,28,2387766632,-12688123
1652174559,198486,true,2400454755,28,2387766632,-12688123
1652174675,198486,true,2400454755,28,2387527879,-12926876
1652174798,198485,true,2400694800,28,2387289151,-13405649
1652174886,198485,true,2400694800,28,2386811764,-13883036
1652174956,198485,true,2400694800,28,2386573107,-14121693
1652174985,198485,true,2400694800,28,2386334474,-14360326
1652175176,198485,true,2400694800,28,2385141664,-15553136
1652175448,198486,true,2400454755,28,2383234409,-17220346
1652175511,198487,true,2400214733,28,2382757834,-17456899
1652175534,198487,true,2400214733,28,2382757834,-17456899
1652175559,198488,true,2399974736,28,2382519582,-17455154
1652175595,198489,true,2399734762,28,2382519582,-17215180
1652175603,198491,true,2399254887,28,2382519582,-16735305
1652175939,198490,true,2399494813,28,2382519582,-16975231
1652175994,198491,true,2399254887,28,2382519582,-16735305
1652176440,198492,true,2399014986,28,2381804969,-17210017
1652176496,198494,true,2398535255,28,2381804969,-16730286
1652176650,198493,true,2398775108,28,2381804969,-16970139
1652176796,198495,true,2398295425,28,2382043149,-16252276
1652176888,198495,true,2398295425,28,2382281354,-16014071
1652177041,198497,true,2397815838,28,2382757834,-15058004
1652177053,198496,true,2398055620,28,2382757834,-15297786
1652177091,198498,true,2397576081,28,2382757834,-14818247
1652177277,198499,true,2397336347,28,2382757834,-14578513
1652177780,198501,true,2396856952,28,2379900382,-16956570
1652177869,198500,true,2397096637,28,2379424473,-17672164
1652177926,198502,true,2396617290,28,2378948660,-17668630
1652178195,198504,true,2396138038,28,2377046357,-19091681
1652178381,198506,true,2395658883,28,2376333386,-19325497
1652178605,198506,true,2395658883,28,2376095776,-19563107
1652178622,198507,true,2395419341,28,2376095776,-19323565
1652178912,198509,true,2394940329,28,2376571019,-18369310
1652179832,198511,true,2394461412,28,2379186555,-15274857
1652180074,198512,true,2394221990,28,2380138372,-14083618
1652180251,198513,true,2393982592,28,2380614424,-13368168
1652180263,198515,true,2393503867,28,2380614424,-12889443
1652180289,198517,true,2393025238,28,2380614424,-12410814
1652180301,198517,true,2393025238,28,2380614424,-12410814
1652180454,198520,true,2392307474,28,2380138372,-12169102
1652180470,198521,true,2392068267,28,2380138372,-11929895
1652180740,198524,true,2391350790,28,2378472942,-12877848
1652180822,198525,true,2391111679,28,2377997318,-13114361
1652181021,198528,true,2390394489,28,2377046357,-13348132
1652181108,198529,true,2390155474,28,2376571019,-13584455
1652181198,198532,true,2389438570,28,2376095776,-13342794
1652181320,198534,true,2388960754,28,2375620628,-13340126
1652181399,198537,true,2388244209,28,2375383090,-12861119
1652181436,198538,true,2388005409,28,2375145575,-12859834
1652181473,198541,true,2387289151,28,2374908085,-12381066
1652181508,198541,true,2387289151,28,2374908085,-12381066
1652181519,198543,true,2386811764,28,2374908085,-11903679
1652181530,198545,true,2386334474,28,2374908085,-11426389
1652181535,198547,true,2385857278,28,2374908085,-10949193
1652181744,198546,true,2386095864,28,2374908085,-11187779
1652182459,198547,true,2385857278,28,2380138372,-5718906
1652182466,198548,true,2385618716,28,2380376386,-5242330
1652182631,198550,true,2385141664,28,2382281354,-2860310
1652182645,198549,true,2385380178,28,2382281354,-3098824
1652182785,198549,true,2385380178,28,2384426265,-953913
1652182858,198550,true,2385141664,28,2385380178,238514
1652182887,198551,true,2384903174,28,2385857278,954104
1652182962,198550,true,2385141664,28,2387050445,1908781
1652183006,198550,true,2385141664,28,2387766632,2624968
1652183017,198551,true,2384903174,28,2388005409,3102235
1652183204,198552,true,2384664707,28,2391111679,6446972
1652183375,198550,true,2385141664,28,2393503867,8362203
1652183441,198550,true,2385141664,28,2394461412,9319748
1652183594,198550,true,2385141664,28,2395898448,10756784
1652183643,198551,true,2384903174,28,2396138038,11234864
1652183793,198549,true,2385380178,28,2397096637,11716459
1652183891,198549,true,2385380178,28,2397576081,12195903
1652183960,198550,true,2385141664,28,2398055620,12913956
1652184359,198550,true,2385141664,28,2400454755,15313091
1652184381,198549,true,2385380178,28,2400454755,15074577
1652184401,198549,true,2385380178,28,2400694800,15314622
1652184424,198549,true,2385380178,28,2400694800,15314622
1652184446,198550,true,2385141664,28,2400694800,15553136
1652184467,198549,true,2385380178,28,2400694800,15314622
1652184640,198549,true,2385380178,28,2400694800,15314622
1652184695,198549,true,2385380178,28,2400694800,15314622
1652185082,198549,true,2385380178,28,2400454755,15074577
1652185151,198547,true,2385857278,28,2400454755,14597477
1652185263,198547,true,2385857278,28,2400454755,14597477
1652185289,198547,true,2385857278,28,2400454755,14597477
1652185328,198546,true,2386095864,28,2400454755,14358891
1652185343,198545,true,2386334474,28,2400454755,14120281
1652185432,198545,true,2386334474,28,2400454755,14120281
1652185629,198544,true,2386573107,28,2400694800,14121693
1652185660,198543,true,2386811764,28,2400694800,13883036
1652185841,198541,true,2387289151,28,2401655222,14366071
1652185968,198541,true,2387289151,28,2402375791,15086640
1652186248,198539,true,2387766632,28,2404538794,16772162
1652186316,198538,true,2388005409,28,2405260228,17254819
1652186360,198536,true,2388483034,28,2405981878,17498844
1652186370,198535,true,2388721882,28,2405981878,17259996
1652186388,198534,true,2388960754,28,2406222476,17261722
1652186393,198533,true,2389199650,28,2406463099,17263449
1652186448,198530,true,2389916482,28,2407185110,17268628
1652186459,198529,true,2390155474,28,2407425828,17270354
1652186520,198528,true,2390394489,28,2408388943,17994454
1652186538,198527,true,2390633529,28,2408629782,17996253
1652186556,198524,true,2391350790,28,2408870645,17519855
1652186692,198524,true,2391350790,28,2411521728,20170938
1652186783,198522,true,2391829085,28,2412969003,21139918
1652186821,198521,true,2392068267,28,2413692966,21624699
1652186893,198519,true,2392546705,28,2414900054,22353349
1652186901,198518,true,2392785960,28,2415141544,22355584
1652187006,198517,true,2393025238,28,2416832650,23807412
1652187174,198516,true,2393264541,28,2419250571,25986030
1652187197,198512,true,2394221990,28,2419734445,25512455
1652187218,198512,true,2394221990,28,2419976418,25754428
1652187234,198510,true,2394700859,28,2420218416,25517557
1652187256,198508,true,2395179823,28,2420702484,25522661
1652187288,198505,true,2395898448,28,2421670910,25772462
1652187654,198503,true,2396377652,28,2429675224,33297572
1652187691,198501,true,2396856952,28,2430647240,33790288
1652187808,198499,true,2397336347,28,2432835697,35499350
1652187921,198495,true,2398295425,28,2435026125,36730700
1652187993,198492,true,2399014986,28,2436487506,37472520
1652188189,198490,true,2399494813,28,2440144797,40649984
1652188563,198488,true,2399974736,28,2444540793,44566057
1652188579,198484,true,2400934870,28,2444785247,43850377
1652188628,198481,true,2401655222,28,2445274229,43619007
1652188642,198479,true,2402135577,28,2445274229,43138652
1652188654,198478,true,2402375791,28,2445518756,43142965
1652188670,198475,true,2403096576,28,2445518756,42422180
1652188722,198473,true,2403577219,28,2445763308,42186089
1652188845,198472,true,2403817577,28,2446007884,42190307
1652188877,198470,true,2404298364,28,2446007884,41709520
1652188999,198468,true,2404779248,28,2446252485,41473237
1652189409,198466,true,2405260228,28,2442586040,37325812
1652189420,198464,true,2405741304,28,2442586040,36844736
1652189424,198463,true,2405981878,28,2442586040,36604162
1652189441,198460,true,2406703745,28,2442586040,35882295
1652189458,198457,true,2407425828,28,2442586040,35160212
1652189514,198455,true,2407907337,28,2442341806,34434469
1652189628,198453,true,2408388943,28,2442097596,33708653
1652189655,198450,true,2409111532,28,2442097596,32986064
1652189666,198447,true,2409834338,28,2441853411,32019073
1652189694,198445,true,2410316329,28,2441609250,31292921
1652189720,198444,true,2410557360,28,2441365114,30807754
1652189918,198443,true,2410798416,28,2437462248,26663832
1652189928,198440,true,2411521728,28,2437218526,25696798
1652189943,198439,true,2411762880,28,2436974828,25211948
1652189944,198439,true,2411762880,28,2436974828,25211948
1652189960,198437,true,2412245257,28,2436731155,24485898
1652190109,198434,true,2412969003,28,2434539193,21570190
1652190142,198432,true,2413451621,28,2434052358,20600737
1652190151,198432,true,2413451621,28,2433808978,20357357
1652190194,198431,true,2413692966,28,2433078981,19386015
1652190196,198427,true,2414658588,28,2433078981,18420393
1652190212,198426,true,2414900054,28,2432592438,17692384
1652190215,198425,true,2415141544,28,2432592438,17450894
1652190246,198424,true,2415383058,28,2432105993,16722935
1652190300,198420,true,2416349356,28,2430890304,14540948
1652190331,198419,true,2416590991,28,2430161183,13570192
1652190365,198419,true,2416590991,28,2429432280,12841289
1652190472,198418,true,2416832650,28,2427246884,10414234
1652190500,198415,true,2417557772,28,2426761508,9203736
1652190542,198414,true,2417799528,28,2426033625,8234097
1652190552,198413,true,2418041308,28,2426033625,7992317
1652190667,198413,true,2418041308,28,2424336080,6294772
1652190681,198410,true,2418766793,28,2424093671,5326878
1652190721,198409,true,2419008670,28,2423608925,4600255
1652190746,198408,true,2419250571,28,2423366588,4116017
1652190848,198409,true,2419008670,28,2422155268,3146598
1652190911,198406,true,2419734445,28,2421670910,1936465
1652190919,198405,true,2419976418,28,2421428767,1452349
1652191186,198405,true,2419976418,28,2419492496,-483922
1652191390,198405,true,2419976418,28,2416832650,-3143768
1652191433,198403,true,2420460438,28,2416349356,-4111082
1652191575,198402,true,2420702484,28,2416349356,-4353128
1652191613,198401,true,2420944554,28,2416590991,-4353563
1652191769,198400,true,2421186649,28,2418041308,-3145341
1652191838,198398,true,2421670910,28,2418283112,-3387798
1652191860,198397,true,2421913077,28,2418524940,-3388137
1652191862,198396,true,2422155268,28,2418524940,-3630328
1652191963,198396,true,2422155268,28,2418524940,-3630328
1652191977,198394,true,2422639724,28,2418524940,-4114784
1652192001,198393,true,2422881988,28,2418524940,-4357048
1652192543,198393,true,2422881988,28,2420702484,-2179504
1652192546,198394,true,2422639724,28,2420702484,-1937240
1652192617,198392,true,2423124276,28,2420702484,-2421792
1652192728,198391,true,2423366588,28,2420702484,-2664104
1652192799,198392,true,2423124276,28,2420702484,-2421792
1652192861,198392,true,2423124276,28,2420218416,-2905860
1652192877,198391,true,2423366588,28,2420218416,-3148172
1652192905,198390,true,2423608925,28,2420218416,-3390509
1652193136,198391,true,2423366588,28,2418766793,-4599795
1652193218,198391,true,2423366588,28,2418283112,-5083476
1652193224,198389,true,2423851286,28,2418041308,-5809978
1652193255,198389,true,2423851286,28,2417799528,-6051758
1652193409,198390,true,2423608925,28,2415141544,-8467381
1652193455,198391,true,2423366588,28,2414175729,-9190859
1652193483,198390,true,2423608925,28,2413692966,-9915959
1652193497,198389,true,2423851286,28,2413210300,-10640986
1652193521,198391,true,2423366588,28,2412727730,-10638858
1652193658,198393,true,2422881988,28,2409111532,-13770456
1652193694,198391,true,2423366588,28,2408388943,-14977645
1652193749,198391,true,2423366588,28,2407425828,-15940760
1652193775,198394,true,2422639724,28,2406703745,-15935979
1652193790,198396,true,2422155268,28,2406463099,-15692169
1652193871,198395,true,2422397484,28,2404779248,-17618236
1652193988,198396,true,2422155268,28,2401895388,-20259880
1652194041,198399,true,2421428767,28,2400694800,-20733967
1652194090,198402,true,2420702484,28,2399254887,-21447597
1652194193,198402,true,2420702484,28,2396138038,-24564446
1652194227,198404,true,2420218416,28,2395179823,-25038593
1652194246,198408,true,2419250571,28,2394461412,-24789159
1652194272,198411,true,2418524940,28,2393743218,-24781722
1652194333,198412,true,2418283112,28,2391350790,-26932322
1652194375,198415,true,2417557772,28,2389916482,-27641290
1652194421,198419,true,2416590991,28,2388244209,-28346782
1652194474,198423,true,2415624596,28,2386334474,-29290122
1652194512,198424,true,2415383058,28,2385141664,-30241394
1652194600,198427,true,2414658588,28,2382519582,-32139006
1652194611,198431,true,2413692966,28,2382043149,-31649817
1652194663,198434,true,2412969003,28,2380614424,-32354579
1652194788,198436,true,2412486481,28,2377046357,-35440124
1652194812,198438,true,2412004056,28,2376571019,-35433037
1652194882,198442,true,2411039496,28,2374670618,-36368878
1652194987,198445,true,2410316329,28,2371822864,-38493465
1652195097,198446,true,2410075321,28,2369215424,-40859897
1652195126,198449,true,2409352443,28,2368504801,-40847642
1652195149,198453,true,2408388943,28,2368031171,-40357772
1652195214,198458,true,2407185110,28,2366137599,-41047511
1652195366,198461,true,2406463099,28,2362118783,-44344316
1652195401,198464,true,2405741304,28,2361174171,-44567133
1652195420,198469,true,2404538794,28,2360702007,-43836787
1652195444,198473,true,2403577219,28,2359993938,-43583281
1652195718,198478,true,2402375791,28,2352924919,-49450872
1652195722,198481,true,2401655222,28,2352924919,-48730303
1652195736,198486,true,2400454755,28,2352689650,-47765105
1652195789,198491,true,2399254887,28,2351278530,-47976357
1652195809,198496,true,2398055620,28,2350573287,-47482333
1652195813,198499,true,2397336347,28,2350573287,-46763060
1652195835,198504,true,2396138038,28,2349868256,-46269782
1652195879,198509,true,2394940329,28,2348928544,-46011785
1652195916,198513,true,2393982592,28,2348224006,-45758586
1652195982,198515,true,2393503867,28,2347284952,-46218915
1652196019,198519,true,2392546705,28,2346815565,-45731140
1652196197,198523,true,2391589926,28,2345877073,-45712853
1652196273,198526,true,2390872592,28,2345642509,-45230083
1652196277,198528,true,2390394489,28,2345642509,-44751980
1652196294,198532,true,2389438570,28,2345407968,-44030602
1652196325,198536,true,2388483034,28,2345173451,-43309583
1652196666,198541,true,2387289151,28,2341658503,-45630648
1652196687,198544,true,2386573107,28,2341424361,-45148746
1652196854,198548,true,2385618716,28,2340254000,-45364716
1652196884,198551,true,2384903174,28,2340019998,-44883176
1652196903,198556,true,2383711080,28,2340019998,-43691082
1652196987,198557,true,2383472733,28,2340254000,-43218733
1652197009,198559,true,2382996110,28,2340254000,-42742110
1652197062,198561,true,2382519582,28,2340956146,-41563436
1652197144,198565,true,2381566812,28,2341658503,-39908309
1652197160,198566,true,2381328679,28,2341892669,-39436010
1652197323,198567,true,2381090570,28,2344704487,-36386083
1652197345,198568,true,2380852485,28,2345173451,-35679034
1652197398,198573,true,2379662416,28,2345642509,-34019907
1652197917,198575,true,2379186555,28,2353160211,-26026344
1652197922,198576,true,2378948660,28,2353395527,-25553133
1652198041,198578,true,2378472942,28,2354101617,-24371325
1652198300,198583,true,2377284062,28,2356692423,-20591639
1652198481,198584,true,2377046357,28,2359050177,-17996180
1652198537,198586,true,2376571019,28,2359522010,-17049009
1652198638,198586,true,2376571019,28,2360465961,-16105058
1652198680,198591,true,2375383090,28,2360938077,-14445013
1652198706,198592,true,2375145575,28,2361174171,-13971404
1652198928,198593,true,2374908085,28,2361882594,-13025491
1652198968,198593,true,2374908085,28,2361882594,-13025491
1652199030,198597,true,2373958359,28,2361410289,-12548070
1652199043,198598,true,2373720987,28,2361410289,-12310698
1652199048,198600,true,2373246314,28,2361410289,-11836025
1652199186,198601,true,2373009013,28,2360465961,-12543052
1652199203,198605,true,2372060047,28,2360465961,-11594086
1652199243,198606,true,2371822864,28,2360229938,-11592926
1652199337,198608,true,2371348571,28,2360229938,-11118633
1652199354,198609,true,2371111460,28,2360229938,-10881522
1652199502,198613,true,2370163252,28,2360465961,-9697291
1652199562,198614,true,2369926260,28,2360702007,-9224253
1652199593,198615,true,2369689291,28,2360702007,-8987284
1652199703,198617,true,2369215424,28,2360465961,-8749463
1652199756,198622,true,2368031171,28,2360465961,-7565210
1652200270,198623,true,2367794392,28,2359050177,-8744215
1652200272,198626,true,2367084196,28,2359050177,-8034019
1652200321,198628,true,2366610850,28,2358578437,-8032413
1652200390,198633,true,2365427899,28,2357871005,-7556894
1652200406,198637,true,2364481965,28,2357635242,-6846723
1652200419,198639,true,2364009139,28,2357399502,-6609637
1652200440,198642,true,2363300078,28,2357163786,-6136292
1652200878,198647,true,2362118783,28,2350338254,-11780529
1652200913,198650,true,2361410289,28,2350103243,-11307046
1652200949,198651,true,2361174171,28,2349868256,-11305915
1652201108,198654,true,2360465961,28,2348693675,-11772286
1652201129,198658,true,2359522010,28,2348458829,-11063181
1652201160,198661,true,2358814295,28,2348224006,-10590289
1652201388,198661,true,2358814295,28,2346580907,-12233388
1652201428,198663,true,2358342603,28,2346346272,-11996331
1652201494,198667,true,2357399502,28,2346346272,-11053230
1652201597,198670,true,2356692423,28,2345877073,-10815350
1652201862,198670,true,2356692423,28,2344938957,-11753466
1652202038,198672,true,2356221156,28,2344470040,-11751116
1652202069,198676,true,2355278903,28,2344470040,-10808863
1652202171,198678,true,2354807918,28,2344938957,-9868961
1652202203,198678,true,2354807918,28,2345173451,-9634467
1652202223,198678,true,2354807918,28,2345407968,-9399950
1652202452,198682,true,2353866230,28,2348224006,-5642224
1652203406,198684,true,2353395527,28,2355749982,2354455
1652203728,198683,true,2353630867,28,2357871005,4240138
1652203772,198683,true,2353630867,28,2358342603,4711736
1652203843,198686,true,2352924919,28,2359050177,6125258
1652203866,198688,true,2352454404,28,2359286082,6831678
1652203874,198686,true,2352924919,28,2359522010,6597091
1652203969,198685,true,2353160211,28,2360702007,7541796
1652204025,198687,true,2352689650,28,2361410289,8720639
1652204052,198688,true,2352454404,28,2361646430,9192026
1652204068,198686,true,2352924919,28,2361882594,8957675
1652204086,198684,true,2353395527,28,2362118783,8723256
1652204135,198686,true,2352924919,28,2362827489,9902570
1652204182,198685,true,2353160211,28,2363536408,10376197
1652204261,198682,true,2353866230,28,2365191380,11325150
1652204330,198680,true,2354337027,28,2366610850,12273823
1652204542,198679,true,2354572460,28,2371585706,17013246
1652204643,198678,true,2354807918,28,2374195755,19387837
1652204879,198674,true,2355749982,28,2379662416,23912434
1652205190,198672,true,2356221156,28,2387289151,31067995
1652205539,198671,true,2356456778,28,2395658883,39202105
1652205705,198671,true,2356456778,28,2398535255,42078477
1652205780,198667,true,2357399502,28,2399494813,42095311
1652205813,198665,true,2357871005,28,2399734762,41863757
1652205833,198665,true,2357871005,28,2399974736,42103731
1652205868,198665,true,2357871005,28,2400214733,42343728
1652205901,198662,true,2358578437,28,2400454755,41876318
1652205996,198660,true,2359050177,28,2400454755,41404578
1652206001,198660,true,2359050177,28,2400454755,41404578
1652206037,198660,true,2359050177,28,2400214733,41164556
1652206075,198657,true,2359757963,28,2399974736,40216773
1652206092,198655,true,2360229938,28,2399974736,39744798
1652206548,198655,true,2360229938,28,2394940329,34710391
1652206575,198655,true,2360229938,28,2394700859,34470921
1652206588,198652,true,2360938077,28,2394461412,33523335
1652206628,198650,true,2361410289,28,2393982592,32572303
1652206655,198649,true,2361646430,28,2393503867,31857437
1652206708,198649,true,2361646430,28,2392546705,30900275
1652206741,198646,true,2362354995,28,2392068267,29713272
1652206817,198644,true,2362827489,28,2390872592,28045103
1652207840,198641,true,2363536408,28,2378710789,15174381
1652207867,198642,true,2363300078,28,2378710789,15410711
1652207876,198638,true,2364245540,28,2378472942,14227402
1652208112,198636,true,2364718413,28,2377997318,13278905
1652208168,198634,true,2365191380,28,2377997318,12805938
1652208302,198634,true,2365191380,28,2377997318,12805938
1652208980,198631,true,2365901009,28,2381328679,15427670
1652209847,198629,true,2366374212,28,2383472733,17098521
1652209914,198627,true,2366847511,28,2383472733,16625222
1652209942,198628,true,2366610850,28,2383472733,16861883
1652209966,198625,true,2367320904,28,2383234409,15913505
1652210005,198624,true,2367557636,28,2382996110,15438474
1652210167,198622,true,2368031171,28,2381804969,13773798
1652210384,198623,true,2367794392,28,2379900382,12105990
1652210401,198620,true,2368504801,28,2379900382,11395581
1652210418,198620,true,2368504801,28,2379662416,11157615
1652210446,198619,true,2368741652,28,2379424473,10682821
1652210454,198620,true,2368504801,28,2379424473,10919672
1652210496,198619,true,2368741652,28,2378710789,9969137
1652210579,198619,true,2368741652,28,2377759542,9017890
1652210679,198618,true,2368978526,28,2376333386,7354860
1652210767,198621,true,2368267975,28,2374908085,6640110
1652210816,198620,true,2368504801,28,2374195755,5690954
1652211050,198620,true,2368504801,28,2370874372,2369571
1652211115,198620,true,2368504801,28,2369926260,1421459
1652211227,198622,true,2368031171,28,2368031171,0
1652211341,198621,true,2368267975,28,2366137599,-2130376
1652211438,198621,true,2368267975,28,2364718413,-3549562
1652211498,198621,true,2368267975,28,2363536408,-4731567
1652211540,198623,true,2367794392,28,2362827489,-4966903
1652212143,198622,true,2368031171,28,2353395527,-14635644
1652212174,198623,true,2367794392,28,2353160211,-14634181
1652212420,198623,true,2367794392,28,2350808345,-16986047
1652212423,198625,true,2367320904,28,2350808345,-16512559
1652212475,198625,true,2367320904,28,2350338254,-16982650
1652212488,198626,true,2367084196,28,2350338254,-16745942
1652212729,198625,true,2367320904,28,2349398353,-17922551
1652212751,198628,true,2366610850,28,2349398353,-17212497
1652213034,198626,true,2367084196,28,2349163437,-17920759
1652213046,198627,true,2366847511,28,2349163437,-17684074
1652213312,198626,true,2367084196,28,2349163437,-17920759
1652213668,198628,true,2366610850,28,2350103243,-16507607
1652214345,198627,true,2366847511,28,2351983984,-14863527
1652214716,198628,true,2366610850,28,2351748809,-14862041
1652214726,198627,true,2366847511,28,2351748809,-15098702
1652214735,198629,true,2366374212,28,2351513658,-14860554
1652214770,198629,true,2366374212,28,2351513658,-14860554
1652214884,198630,true,2366137599,28,2351043426,-15094173
1652214980,198630,true,2366137599,28,2350338254,-15799345
1652215001,198631,true,2365901009,28,2350103243,-15797766
1652215114,198631,true,2365901009,28,2348928544,-16972465
1652215280,198633,true,2365427899,28,2347519680,-17908219
1652215376,198632,true,2365664442,28,2346580907,-19083535
1652215443,198633,true,2365427899,28,2346111661,-19316238
1652215788,198633,true,2365427899,28,2343298156,-22129743
1652215813,198634,true,2365191380,28,2343063850,-22127530
1652215876,198632,true,2365664442,28,2342361071,-23303371
1652215883,198633,true,2365427899,28,2342361071,-23066828
1652216274,198633,true,2365427899,28,2337915033,-27512866
1652216295,198635,true,2364954885,28,2337681265,-27273620
1652216312,198634,true,2365191380,28,2337447520,-27743860
1652216380,198635,true,2364954885,28,2336512774,-28442111
1652216542,198636,true,2364718413,28,2334644405,-30074008
1652217032,198638,true,2364245540,28,2332777530,-31468010
1652217094,198637,true,2364481965,28,2332777530,-31704435
1652217115,198638,true,2364245540,28,2332544275,-31701265
1652217129,198639,true,2364009139,28,2332544275,-31464864
1652217142,198641,true,2363536408,28,2332311044,-31225364
1652217235,198641,true,2363536408,28,2331611491,-31924917
1652217241,198642,true,2363300078,28,2331611491,-31688587
1652217283,198643,true,2363063772,28,2331145238,-31918534
1652217358,198646,true,2362354995,28,2330213013,-32141982
1652217420,198647,true,2362118783,28,2329514089,-32604694
1652217453,198648,true,2361882594,28,2329048256,-32834338
1652217648,198650,true,2361410289,28,2327185856,-34224433
1652217670,198652,true,2360938077,28,2326953161,-33984916
1652217672,198653,true,2360702007,28,2326953161,-33748846
1652217797,198655,true,2360229938,28,2326255214,-33974724
1652217850,198657,true,2359757963,28,2325790033,-33967930
1652217865,198660,true,2359050177,28,2325790033,-33260144
1652217883,198662,true,2358578437,28,2325557477,-33020960
1652217910,198664,true,2358106792,28,2325324945,-32781847
1652217983,198667,true,2357399502,28,2324627487,-32772015
1652218033,198671,true,2356456778,28,2324162631,-32294147
1652218043,198673,true,2355985557,28,2323930238,-32055319
1652218095,198675,true,2355514431,28,2323233198,-32281233
1652218237,198679,true,2354572460,28,2321375448,-33197012
1652218323,198684,true,2353395527,28,2319983110,-33412417
1652218348,198687,true,2352689650,28,2319519183,-33170467
1652218356,198690,true,2351983984,28,2319287254,-32696730
1652218368,198695,true,2350808345,28,2319055349,-31752996
1652218369,198701,true,2349398353,28,2319055349,-30343004
1652218384,198704,true,2348693675,28,2318823466,-29870209
1652218399,198707,true,2347989208,28,2318359771,-29629437
1652218540,198712,true,2346815565,28,2315116500,-31699065
1652218543,198717,true,2345642509,28,2315116500,-30526009
1652218658,198721,true,2344704487,28,2312571400,-32133087
1652218708,198723,true,2344235616,28,2311415461,-32820155
1652218724,198727,true,2343298156,28,2310953247,-32344909
1652218745,198733,true,2341892669,28,2310491126,-31401543
1652218784,198737,true,2340956146,28,2309336227,-31619919
1652218812,198740,true,2340254000,28,2308643564,-31610436
1652219010,198744,true,2339318132,28,2302879452,-36438680
1652219046,198749,true,2338148824,28,2301958530,-36190294
1652219052,198753,true,2337213798,28,2301728357,-35485441
1652219061,198756,true,2336512774,28,2301498207,-35014567
1652219104,198762,true,2335111357,28,2300347804,-34763553
1652219133,198767,true,2333944152,28,2299657837,-34286315
1652219246,198769,true,2333477433,28,2297129731,-36347702
1652219471,198772,true,2332777530,28,2291623505,-41154025
1652219482,198777,true,2331611491,28,2291394365,-40217126
1652219567,198782,true,2330446035,28,2289104231,-41341804
1652219586,198785,true,2329747041,28,2288646479,-41100562
1652219628,198788,true,2329048256,28,2287502499,-41545757
1652219637,198793,true,2327884082,28,2287273771,-40610311
1652219939,198799,true,2326487840,28,2279966558,-46521282
1652219961,198802,true,2325790033,28,2279738584,-46051449
1652220024,198805,true,2325092436,28,2278599057,-46493379
1652220035,198811,true,2323697868,28,2278371220,-45326648
1652220094,198816,true,2322536368,28,2277232376,-45303992
1652220102,198819,true,2321839746,28,2277004675,-44835071
1652220115,198822,true,2321143334,28,2277004675,-44138659
1652220145,198827,true,2319983110,28,2276776998,-43206112
1652220158,198831,true,2319055349,28,2276549343,-42506006
1652220186,198833,true,2318591607,28,2276549343,-42042264
1652220231,198835,true,2318127958,28,2276549343,-41578615
1652220252,198840,true,2316969242,28,2276549343,-40419899
1652220259,198843,true,2316274290,28,2276549343,-39724947
1652220296,198845,true,2315811105,28,2276549343,-39261762
1652220304,198847,true,2315348012,28,2276549343,-38798669
1652220373,198852,true,2314190685,28,2276321711,-37868974
1652220437,198855,true,2313496567,28,2276321711,-37174856
1652220455,198857,true,2313033937,28,2276321711,-36712226
1652220474,198858,true,2312802657,28,2276321711,-36480946
1652220566,198862,true,2311877767,28,2276549343,-35328424
1652220613,198865,true,2311184342,28,2276776998,-34407344
1652220632,198866,true,2310953247,28,2277232376,-33720871
1652220779,198866,true,2310953247,28,2279966558,-30986689
1652220787,198870,true,2310029097,28,2279966558,-30062539
1652220848,198872,true,2309567160,28,2281106769,-28460391
1652220855,198873,true,2309336227,28,2281106769,-28229458
1652221099,198874,true,2309105316,28,2285216254,-23889062
1652221179,198876,true,2308643564,28,2286816385,-21827179
1652221181,198878,true,2308181905,28,2286816385,-21365520
1652221216,198879,true,2307951110,28,2287502499,-20448611
1652221397,198879,true,2307951110,28,2291852667,-16098443
1652221445,198881,true,2307489589,28,2292998823,-14490766
1652221467,198883,true,2307028160,28,2293457445,-13570715
1652221526,198885,true,2306566824,28,2295063347,-11503477
1652221565,198885,true,2306566824,28,2295981510,-10585314
1652221586,198888,true,2305874992,28,2296440730,-9434262
1652221677,198890,true,2305413886,28,2298278525,-7135361
1652221746,198892,true,2304952872,28,2299427894,-5524978
1652221838,198892,true,2304952872,28,2301037977,-3914895
1652221853,198895,true,2304261525,28,2301498207,-2763318
1652221859,198897,true,2303800742,28,2301498207,-2302535
1652221868,198900,true,2303109740,28,2301728357,-1381383
1652221902,198900,true,2303109740,28,2302188726,-921014
1652221922,198903,true,2302418945,28,2302418945,0
1652221984,198905,true,2301958530,28,2302649187,690657
1652222022,198907,true,2301498207,28,2302649187,1150980
1652222250,198908,true,2301268081,28,2303109740,1841659
1652222293,198911,true,2300577838,28,2303109740,2531902
1652222358,198912,true,2300347804,28,2303109740,2761936
1652222409,198914,true,2299887803,28,2302879452,2991649
1652222509,198915,true,2299657837,28,2301958530,2300693
1652222569,198918,true,2298968078,28,2301268081,2300003
1652222718,198919,true,2298738204,28,2300117792,1379588
1652222733,198921,true,2298278525,28,2299887803,1609278
1652222739,198922,true,2298048720,28,2299887803,1839083
1652222844,198924,true,2297589180,28,2299427894,1838714
1652222912,198925,true,2297359444,28,2299197975,1838531
1652222932,198927,true,2296900041,28,2298968078,2068037
1652222941,198928,true,2296670374,28,2298968078,2297704
1652222997,198929,true,2296440730,28,2298278525,1837795
1652223043,198931,true,2295981510,28,2297589180,1607670
1652223045,198933,true,2295522383,28,2297589180,2066797
1652223168,198934,true,2295292854,28,2295751935,459081
1652223178,198936,true,2294833864,28,2295751935,918071
1652223237,198937,true,2294604403,28,2295063347,458944
1652223335,198937,true,2294604403,28,2294604403,0
1652223436,198937,true,2294604403,28,2295292854,688451
1652223452,198938,true,2294374966,28,2295292854,917888
1652223457,198938,true,2294374966,28,2295292854,917888
1652223495,198937,true,2294604403,28,2295751935,1147532
1652223527,198936,true,2294833864,28,2295981510,1147646
1652223791,198937,true,2294604403,28,2299197975,4593572
1652223837,198937,true,2294604403,28,2300117792,5513389
1652223844,198937,true,2294604403,28,2300347804,5743401
1652223915,198935,true,2295063347,28,2301958530,6895183
1652224101,198935,true,2295063347,28,2306797480,11734133
1652224148,198935,true,2295063347,28,2308181905,13118558
1652224238,198933,true,2295522383,28,2310953247,15430864
1652224311,198931,true,2295981510,28,2313265240,17283730
1652224362,198930,true,2296211108,28,2314885012,18673904
1652224552,198929,true,2296440730,28,2321607585,25166855
1652224712,198927,true,2296900041,28,2327185856,30285815
1652224765,198925,true,2297359444,28,2329048256,31688812
1652224794,198922,true,2298048720,28,2329980015,31931295
1652224813,198921,true,2298278525,28,2330679079,32400554
1652224970,198920,true,2298508353,28,2336045542,37537189
1652225326,198917,true,2299197975,28,2343532486,44334511
1652225396,198915,true,2299657837,28,2344704487,45046650
1652225723,198912,true,2300347804,28,2349398353,49050549
1652225779,198911,true,2300577838,28,2349633293,49055455
1652225793,198908,true,2301268081,28,2349633293,48365212
1652225798,198906,true,2301728357,28,2349633293,47904936
1652225862,198903,true,2302418945,28,2350103243,47684298
1652225925,198902,true,2302649187,28,2350338254,47689067
1652225973,198899,true,2303340051,28,2350338254,46998203
1652225984,198897,true,2303800742,28,2350338254,46537512
1652226110,198895,true,2304261525,28,2350338254,46076729
1652226150,198893,true,2304722400,28,2350103243,45380843
1652226159,198890,true,2305413886,28,2350103243,44689357
1652226181,198887,true,2306105579,28,2349868256,43762677
1652226888,198885,true,2306566824,28,2344001216,37434392
1652226971,198883,true,2307028160,28,2343532486,36504326
1652227000,198880,true,2307720338,28,2343298156,35577818
1652227159,198876,true,2308643564,28,2342595307,33951743
1652227304,198874,true,2309105316,28,2341892669,32787353
1652227851,198873,true,2309336227,28,2339552064,30215837
1652227968,198870,true,2310029097,28,2339318132,29289035
1652227981,198866,true,2310953247,28,2339318132,28364885
1652228129,198864,true,2311415461,28,2339318132,27902671
1652228135,198863,true,2311646602,28,2339318132,27671530
1652228177,198860,true,2312340166,28,2339318132,26977966
1652228224,198856,true,2313265240,28,2339552064,26286824
1652228277,198852,true,2314190685,28,2339786019,25595334
1652228304,198851,true,2314422104,28,2340019998,25597894
1652228456,198847,true,2315348012,28,2341190242,25842230
1652228497,198843,true,2316274290,28,2341424361,25150071
1652228513,198839,true,2317200939,28,2341658503,24457564
1652228518,198838,true,2317432659,28,2341658503,24225844
1652228550,198834,true,2318359771,28,2342126859,23767088
1652228683,198828,true,2319751135,28,2344938957,25187822
1652228703,198826,true,2320215108,28,2345173451,24958343
1652228718,198825,true,2320447130,28,2345642509,25195379
1652228777,198820,true,2321607585,28,2346815565,25207980
1652228995,198814,true,2323000898,28,2351278530,28277632
1652229027,198812,true,2323465522,28,2351983984,28518462
1652229029,198811,true,2323697868,28,2351983984,28286116
1652229038,198807,true,2324627487,28,2352219182,27591695
1652229066,198801,true,2326022612,28,2352924919,26902307
1652229175,198798,true,2326720489,28,2355043398,28322909
1652229191,198798,true,2326720489,28,2355278903,28558414
1652229194,198793,true,2327884082,28,2355278903,27394821
1652229198,198788,true,2329048256,28,2355514431,26466175
1652229227,198786,true,2329514089,28,2355985557,26471468
1652229247,198785,true,2329747041,28,2356221156,26474115
1652229472,198782,true,2330446035,28,2360465961,30019926
1652229483,198777,true,2331611491,28,2360702007,29090516
1652229545,198776,true,2331844652,28,2361646430,29801778
1652229612,198775,true,2332077836,28,2362827489,30749653
1652229627,198772,true,2332777530,28,2363063772,30286242
1652229660,198767,true,2333944152,28,2363536408,29592256
1652230049,198766,true,2334177546,28,2369926260,35748714
1652230105,198766,true,2334177546,28,2370637308,36459762
1652230206,198763,true,2334877870,28,2370874372,35996502
1652230808,198760,true,2335578403,28,2366374212,30795809
1652231189,198759,true,2335811961,28,2362354995,26543034
1652231325,198759,true,2335811961,28,2360938077,25126116
1652231397,198757,true,2336279147,28,2359993938,23714791
1652231447,198753,true,2337213798,28,2359522010,22308212
1652231624,198752,true,2337447520,28,2357871005,20423485
1652231676,198752,true,2337447520,28,2357163786,19716266
1652232635,198750,true,2337915033,28,2348224006,10308973
1652232681,198746,true,2338850339,28,2347989208,9138869
1652233215,198746,true,2338850339,28,2345407968,6557629
1652233397,198746,true,2338850339,28,2344704487,5854148
1652233441,198743,true,2339552064,28,2344470040,4917976
1652233605,198739,true,2340488025,28,2344470040,3982015
1652233728,198738,true,2340722074,28,2344470040,3747966
1652233888,198738,true,2340722074,28,2344235616,3513542
1652234428,198735,true,2341424361,28,2343298156,1873795
1652234444,198731,true,2342361071,28,2343063850,702779
1652234509,198731,true,2342361071,28,2342829567,468496
1652234514,198731,true,2342361071,28,2342829567,468496
1652234557,198729,true,2342829567,28,2342361071,-468496
1652234610,198725,true,2343766839,28,2341892669,-1874170
1652234632,198724,true,2344001216,28,2341892669,-2108547
1652234722,198725,true,2343766839,28,2340956146,-2810693
1652234790,198723,true,2344235616,28,2340019998,-4215618
1652234970,198719,true,2345173451,28,2338148824,-7024627
1652235178,198720,true,2344938957,28,2336279147,-8659810
1652235245,198720,true,2344938957,28,2335578403,-9360554
1652235294,198718,true,2345407968,28,2335344868,-10063100
1652235354,198714,true,2346346272,28,2335111357,-11234915
1652235376,198713,true,2346580907,28,2335111357,-11469550
1652235668,198713,true,2346580907,28,2334410964,-12169943
1652235689,198710,true,2347284952,28,2334410964,-12873988
1652235742,198706,true,2348224006,28,2334410964,-13813042
1652235819,198705,true,2348458829,28,2335111357,-13347472
1652235858,198704,true,2348693675,28,2335344868,-13348807
1652235859,198703,true,2348928544,28,2335344868,-13583676
1652235860,198699,true,2349868256,28,2335344868,-14523388
1652235880,198698,true,2350103243,28,2335578403,-14524840
1652235910,198697,true,2350338254,28,2336045542,-14292712
1652235950,198697,true,2350338254,28,2336512774,-13825480
1652236002,198692,true,2351513658,28,2337447520,-14066138
1652236089,198691,true,2351748809,28,2339084224,-12664585
1652237103,198689,true,2352219182,28,2364009139,11789957
1652237138,198689,true,2352219182,28,2364718413,12499231
1652237154,198686,true,2352924919,28,2364954885,12029966
1652237179,198685,true,2353160211,28,2365427899,12267688
1652237352,198685,true,2353160211,28,2368267975,15107764
1652237627,198685,true,2353160211,28,2371585706,18425495
1652237735,198683,true,2353630867,28,2371822864,18191997
1652237824,198683,true,2353630867,28,2371822864,18191997
1652237882,198683,true,2353630867,28,2371585706,17954839
1652237909,198683,true,2353630867,28,2371585706,17954839
1652237927,198681,true,2354101617,28,2371348571,17246954
1652238102,198681,true,2354101617,28,2371111460,17009843
1652238125,198680,true,2354337027,28,2371111460,16774433
1652238140,198680,true,2354337027,28,2371111460,16774433
1652238146,198678,true,2354807918,28,2371111460,16303542
1652238618,198676,true,2355278903,28,2372771736,17492833
1652238689,198675,true,2355514431,28,2373009013,17494582
1652238699,198675,true,2355514431,28,2373009013,17494582
1652238706,198673,true,2355985557,28,2373009013,17023456
1652238802,198672,true,2356221156,28,2373246314,17025158
1652238846,198671,true,2356456778,28,2373246314,16789536
1652238901,198671,true,2356456778,28,2373246314,16789536
1652238926,198669,true,2356928093,28,2373246314,16318221
1652239173,198668,true,2357163786,28,2373720987,16557201
1652239234,198667,true,2357399502,28,2373720987,16321485
1652240030,198667,true,2357399502,28,2373483638,16084136
1652240673,198665,true,2357871005,28,2369452345,11581340
1652240698,198663,true,2358342603,28,2369452345,11109742
1652241070,198662,true,2358578437,28,2368504801,9926364
1652241250,198662,true,2358578437,28,2368267975,9689538
1652241261,198660,true,2359050177,28,2368267975,9217798
1652241312,198659,true,2359286082,28,2368031171,8745089
1652241371,198658,true,2359522010,28,2367794392,8272382
1652241554,198659,true,2359286082,28,2367320904,8034822
1652241991,198657,true,2359757963,28,2365664442,5906479
1652242627,198656,true,2359993938,28,2363772762,3778824
1652242736,198654,true,2360465961,28,2363536408,3070447
1652242737,198655,true,2360229938,28,2363536408,3306470
1652243172,198654,true,2360465961,28,2361882594,1416633
1652243315,198653,true,2360702007,28,2361646430,944423
1652243409,198652,true,2360938077,28,2361410289,472212
1652243739,198653,true,2360702007,28,2361410289,708282
1652244112,198652,true,2360938077,28,2361174171,236094
1652244281,198652,true,2360938077,28,2361174171,236094
1652244377,198651,true,2361174171,28,2361174171,0
1652244434,198653,true,2360702007,28,2360702007,0
1652244444,198654,true,2360465961,28,2360702007,236046
1652244489,198654,true,2360465961,28,2360465961,0
1652244853,198654,true,2360465961,28,2358814295,-1651666
1652244907,198657,true,2359757963,28,2358578437,-1179526
1652245014,198657,true,2359757963,28,2358342603,-1415360
1652245286,198658,true,2359522010,28,2357163786,-2358224
1652245555,198658,true,2359522010,28,2355985557,-3536453
1652245602,198660,true,2359050177,28,2355514431,-3535746
1652245870,198661,true,2358814295,28,2353630867,-5183428
1652245922,198662,true,2358578437,28,2354101617,-4476820
1652245949,198661,true,2358814295,28,2354572460,-4241835
1652246101,198662,true,2358578437,28,2356928093,-1650344
1652246265,198659,true,2359286082,28,2360229938,943856
1652246552,198659,true,2359286082,28,2366610850,7324768
1652246970,198658,true,2359522010,28,2375858190,16336180
1652247116,198659,true,2359286082,28,2378948660,19662578
1652247204,198657,true,2359757963,28,2380852485,21094522
1652247250,198656,true,2359993938,28,2382043149,22049211
1652247460,198655,true,2360229938,28,2387050445,26820507
1652247509,198656,true,2359993938,28,2388005409,28011471
1652247511,198653,true,2360702007,28,2388244209,27542202
1652247546,198653,true,2360702007,28,2388960754,28258747
1652247590,198652,true,2360938077,28,2389916482,28978405
1652247977,198653,true,2360702007,28,2390872592,30170585
1652248213,198650,true,2361410289,28,2390155474,28745185
1652248260,198648,true,2361882594,28,2389677514,27794920
1652248571,198648,true,2361882594,28,2386573107,24690513
1652248614,198649,true,2361646430,28,2386334474,24688044
1652249007,198646,true,2362354995,28,2382996110,20641115
1652249222,198645,true,2362591230,28,2380852485,18261255
1652249453,198644,true,2362827489,28,2379186555,16359066
1652249830,198644,true,2362827489,28,2377284062,14456573
1652249856,198642,true,2363300078,28,2377284062,13983984
1652249876,198640,true,2363772762,28,2377046357,13273595
1652249887,198639,true,2364009139,28,2377046357,13037218
1652249908,198640,true,2363772762,28,2377046357,13273595
1652249912,198637,true,2364481965,28,2377046357,12564392
1652249938,198636,true,2364718413,28,2376808676,12090263
1652249973,198635,true,2364954885,28,2376571019,11616134
1652249996,198635,true,2364954885,28,2376333386,11378501
1652250039,198633,true,2365427899,28,2376095776,10667877
1652250066,198631,true,2365901009,28,2376095776,10194767
1652250771,198630,true,2366137599,28,2373246314,7108715
1652250816,198630,true,2366137599,28,2373246314,7108715
1652251136,198627,true,2366847511,28,2371585706,4738195
1652251198,198625,true,2367320904,28,2371111460,3790556
1652251247,198625,true,2367320904,28,2370874372,3553468
1652251255,198624,true,2367557636,28,2370637308,3079672
1652251265,198621,true,2368267975,28,2370637308,2369333
1652251296,198620,true,2368504801,28,2370400268,1895467
1652251307,198619,true,2368741652,28,2370163252,1421600
1652251320,198619,true,2368741652,28,2370163252,1421600
1652251368,198617,true,2369215424,28,2369689291,473867
1652251388,198616,true,2369452345,28,2369215424,-236921
1652251482,198617,true,2369215424,28,2368031171,-1184253
1652251502,198617,true,2369215424,28,2367557636,-1657788
1652251527,198615,true,2369689291,28,2367320904,-2368387
1652251538,198615,true,2369689291,28,2367084196,-2605095
1652251540,198617,true,2369215424,28,2367084196,-2131228
1652251598,198618,true,2368978526,28,2365901009,-3077517
1652251638,198616,true,2369452345,28,2365191380,-4260965
1652251698,198617,true,2369215424,28,2364245540,-4969884
1652251711,198620,true,2368504801,28,2364009139,-4495662
1652251720,198621,true,2368267975,28,2363772762,-4495213
1652251727,198620,true,2368504801,28,2363772762,-4732039
1652251772,198621,true,2368267975,28,2363063772,-5204203
1652251801,198626,true,2367084196,28,2362354995,-4729201
1652251814,198627,true,2366847511,28,2361882594,-4964917
1652251961,198627,true,2366847511,28,2358342603,-8504908
1652252001,198628,true,2366610850,28,2357399502,-9211348
1652252038,198632,true,2365664442,28,2356221156,-9443286
1652252139,198634,true,2365191380,28,2353395527,-11795853
1652252158,198634,true,2365191380,28,2352689650,-12501730
1652252187,198636,true,2364718413,28,2351748809,-12969604
1652252229,198640,true,2363772762,28,2350338254,-13434508
1652252265,198642,true,2363300078,28,2349163437,-14136641
1652252285,198643,true,2363063772,28,2348458829,-14604943
1652252304,198646,true,2362354995,28,2347519680,-14835315
1652252442,198652,true,2360938077,28,2341658503,-19279574
1652252572,198655,true,2360229938,28,2336045542,-24184396
1652252630,198656,true,2359993938,28,2333477433,-26516505
1652252635,198660,true,2359050177,28,2333244109,-25806068
1652252690,198665,true,2357871005,28,2331378353,-26492652
1652252757,198667,true,2357399502,28,2329048256,-28351246
1652252810,198668,true,2357163786,28,2326953161,-30210625
1652252823,198672,true,2356221156,28,2326487840,-29733316
1652252836,198677,true,2355043398,28,2325790033,-29253365
1652252889,198680,true,2354337027,28,2323233198,-31103829
1652252974,198683,true,2353630867,28,2318823466,-34807401
1652253027,198686,true,2352924919,28,2316274290,-36650629
1652253248,198691,true,2351748809,28,2307720338,-44028471
1652253320,198693,true,2351278530,28,2305413886,-45864644
1652253341,198695,true,2350808345,28,2304952872,-45855473
1652253376,198698,true,2350103243,28,2304031122,-46072121
1652253392,198701,true,2349398353,28,2303800742,-45597611
1652253394,198704,true,2348693675,28,2303800742,-44892933
1652253437,198704,true,2348693675,28,2302879452,-45814223
1652253480,198706,true,2348224006,28,2302188726,-46035280
1652253668,198708,true,2347754432,28,2301498207,-46256225
1652253693,198710,true,2347284952,28,2301498207,-45786745
1652253742,198710,true,2347284952,28,2301268081,-46016871
1652253786,198712,true,2346815565,28,2301037977,-45777588
1652253847,198715,true,2346111661,28,2300807896,-45303765
1652254272,198717,true,2345642509,28,2303109740,-42532769
1652254308,198718,true,2345407968,28,2303340051,-42067917
1652254338,198720,true,2344938957,28,2303570385,-41368572
1652254351,198722,true,2344470040,28,2303570385,-40899655
1652254358,198726,true,2343532486,28,2303800742,-39731744
1652254554,198727,true,2343298156,28,2303800742,-39497414
1652254581,198729,true,2342829567,28,2303570385,-39259182
1652254607,198732,true,2342126859,28,2303570385,-38556474
1652254615,198736,true,2341190242,28,2303340051,-37850191
1652254640,198739,true,2340488025,28,2303340051,-37147974
1652254843,198742,true,2339786019,28,2302879452,-36906567
1652254863,198744,true,2339318132,28,2302879452,-36438680
1652254875,198747,true,2338616477,28,2302879452,-35737025
1652254930,198750,true,2337915033,28,2303109740,-34805293
1652254967,198751,true,2337681265,28,2303340051,-34341214
1652254974,198753,true,2337213798,28,2303340051,-33873747
1652255010,198756,true,2336512774,28,2303570385,-32942389
1652255061,198759,true,2335811961,28,2303340051,-32471910
1652255173,198761,true,2335344868,28,2302418945,-32925923
1652255201,198764,true,2334644405,28,2302188726,-32455679
1652255578,198769,true,2333477433,28,2294145551,-39331882
1652255586,198776,true,2331844652,28,2293916160,-37928492
1652255706,198778,true,2331378353,28,2291852667,-39525686
1652255787,198781,true,2330679079,28,2290478037,-40201042
1652255850,198786,true,2329514089,28,2289562074,-39952015
1652255882,198792,true,2328116870,28,2289104231,-39012639
1652255903,198794,true,2327651316,28,2288875343,-38775973
1652255963,198797,true,2326953161,28,2288188818,-38764343
1652255969,198802,true,2325790033,28,2288188818,-37601215
1652256028,198807,true,2324627487,28,2287960022,-36667465
1652256066,198809,true,2324162631,28,2287731249,-36431382
1652256107,198810,true,2323930238,28,2287731249,-36198989
1652256181,198814,true,2323000898,28,2287960022,-35040876
1652256205,198819,true,2321839746,28,2288188818,-33650928
1652256596,198821,true,2321375448,28,2291623505,-29751943
1652256610,198821,true,2321375448,28,2291852667,-29522781
1652256625,198825,true,2320447130,28,2292081852,-28365278
1652256718,198830,true,2319287254,28,2293457445,-25829809
1652256729,198831,true,2319055349,28,2293686791,-25368558
1652256822,198830,true,2319287254,28,2295292854,-23994400
1652256880,198834,true,2318359771,28,2296900041,-21459730
1652256892,198837,true,2317664402,28,2297129731,-20534671
1652256948,198838,true,2317432659,28,2298738204,-18694455
1652256956,198837,true,2317664402,28,2298968078,-18696324
1652257019,198840,true,2316969242,28,2300807896,-16161346
1652257039,198843,true,2316274290,28,2301498207,-14776083
1652257067,198843,true,2316274290,28,2302188726,-14085564
1652257125,198842,true,2316505918,28,2304261525,-12244393
1652257188,198844,true,2316042686,28,2306105579,-9937107
1652257201,198848,true,2315116500,28,2306566824,-8549676
1652257203,198848,true,2315116500,28,2306566824,-8549676
1652257366,198847,true,2315348012,28,2310953247,-4394765
1652257374,198850,true,2314653547,28,2311184342,-3469205
1652257390,198853,true,2313959289,28,2311646602,-2312687
1652257414,198853,true,2313959289,28,2312571400,-1387889
1652257432,198852,true,2314190685,28,2313033937,-1156748
1652257433,198855,true,2313496567,28,2313033937,-462630
1652257439,198857,true,2313033937,28,2313265240,231303
1652257496,198856,true,2313265240,28,2315348012,2082772
1652257612,198854,true,2313727917,28,2319519183,5791266
1652257668,198857,true,2313033937,28,2321375448,8341511
1652257745,198859,true,2312571400,28,2323697868,11126468
1652257756,198858,true,2312802657,28,2323930238,11127581
1652257793,198856,true,2313265240,28,2324627487,11362247
1652257893,198859,true,2312571400,28,2326487840,13916440
1652257954,198862,true,2311877767,28,2327185856,15308089
1652258157,198861,true,2312108955,28,2329980015,17871060
1652258387,198859,true,2312571400,28,2333010808,20439408
1652258450,198862,true,2311877767,28,2333710781,21833014
1652258454,198864,true,2311415461,28,2333710781,22295320
1652258515,198863,true,2311646602,28,2334644405,22997803
1652258701,198860,true,2312340166,28,2336279147,23938981
1652258725,198862,true,2311877767,28,2336279147,24401380
1652258979,198864,true,2311415461,28,2338148824,26733363
1652258987,198862,true,2311877767,28,2338148824,26271057
1652259173,198857,true,2313033937,28,2340488025,27454088
1652259236,198859,true,2312571400,28,2341190242,28618842
1652259335,198860,true,2312340166,28,2341892669,29552503
1652259521,198857,true,2313033937,28,2343063850,30029913
1652259529,198852,true,2314190685,28,2343063850,28873165
1652259572,198854,true,2313727917,28,2343532486,29804569
1652259573,198854,true,2313727917,28,2343532486,29804569
1652259606,198850,true,2314653547,28,2344001216,29347669
1652260028,198844,true,2316042686,28,2351983984,35941298
1652260306,198845,true,2315811105,28,2357635242,41824137
1652260473,198845,true,2315811105,28,2359993938,44182833
1652260525,198841,true,2316737568,28,2360465961,43728393
1652260806,198833,true,2318591607,28,2362827489,44235882
1652260958,198834,true,2318359771,28,2364009139,45649368
1652260975,198833,true,2318591607,28,2364245540,45653933
1652261004,198829,true,2319519183,28,2364481965,44962782
1652261015,198822,true,2321143334,28,2364481965,43338631
1652261103,198822,true,2321143334,28,2365427899,44284565
1652261132,198822,true,2321143334,28,2365901009,44757675
1652261155,198817,true,2322304137,28,2366137599,43833462
1652261257,198809,true,2324162631,28,2367557636,43395005
1652261298,198808,true,2324395047,28,2368267975,43872928
1652261548,198805,true,2325092436,28,2371822864,46730428
1652261562,198801,true,2326022612,28,2372060047,46037435
1652261581,198793,true,2327884082,28,2372297253,44413171
1652261588,198792,true,2328116870,28,2372534482,44417612
1652261612,198789,true,2328815375,28,2373009013,44193638
1652261647,198784,true,2329980015,28,2373720987,43740972
1652261673,198778,true,2331378353,28,2374195755,42817402
1652261684,198776,true,2331844652,28,2374433174,42588522
1652261758,198774,true,2332311044,28,2376333386,44022342
1652261851,198769,true,2333477433,28,2379186555,45709122
1652261903,198764,true,2334644405,28,2380376386,45731981
1652261904,198763,true,2334877870,28,2380376386,45498516
1652261912,198760,true,2335578403,28,2380852485,45274082
1652262139,198754,true,2336980100,28,2388721882,51741782
1652262165,198747,true,2338616477,28,2389438570,50822093
1652262931,198746,true,2338850339,28,2413210300,74359961
1652263100,198743,true,2339552064,28,2417074333,77522269
1652263118,198737,true,2340956146,28,2417316041,76359895
1652263200,198730,true,2342595307,28,2419250571,76655264
1652263243,198727,true,2343298156,28,2420218416,76920260
1652263253,198723,true,2344235616,28,2420460438,76224822
1652263346,198717,true,2345642509,28,2422881988,77239479
1652263430,198709,true,2347519680,28,2424578514,77058834
1652263474,198707,true,2347989208,28,2425063454,77074246
1652263512,198701,true,2349398353,28,2425548491,76150138
1652263586,198693,true,2351278530,28,2426276228,74997698
1652263648,198686,true,2352924919,28,2426518856,73593937
1652263857,198684,true,2353395527,28,2426518856,73123329
1652263932,198679,true,2354572460,28,2426761508,72189048
1652263977,198673,true,2355985557,28,2427004184,71018627
1652264010,198666,true,2357635242,28,2427489609,69854367
1652264023,198662,true,2358578437,28,2427732358,69153921
1652264104,198656,true,2359993938,28,2428217929,68223991
1652264145,198649,true,2361646430,28,2428460750,66814320
1652264227,198643,true,2363063772,28,2428946467,65882695
1652264337,198639,true,2364009139,28,2429675224,65666085
1652264557,198633,true,2365427899,28,2430404199,64976300
1652264737,198627,true,2366847511,28,2431133393,64285882
1652264873,198620,true,2368504801,28,2431619644,63114843
1652264878,198617,true,2369215424,28,2431619644,62404220
1652264946,198611,true,2370637308,28,2431862806,61225498
1652265111,198605,true,2372060047,28,2431619644,59559597
1652265300,198599,true,2373483638,28,2431376507,57892869
1652265350,198596,true,2374195755,28,2431376507,57180752
1652265478,198591,true,2375383090,28,2431619644,56236554
1652265804,198585,true,2376808676,28,2431376507,54567831
1652265806,198580,true,2377997318,28,2431376507,53379189
1652265870,198577,true,2378710789,28,2431133393,52422604
1652266076,198572,true,2379900382,28,2430890304,50989922
1652266099,198566,true,2381328679,28,2430890304,49561625
1652266117,198560,true,2382757834,28,2430890304,48132470
1652266491,198557,true,2383472733,28,2432592438,49119705
1652266759,198552,true,2384664707,28,2434295764,49631057
1652266788,198546,true,2386095864,28,2434539193,48443329
1652266816,198542,true,2387050445,28,2434539193,47488748
1652266888,198539,true,2387766632,28,2434539193,46772561
1652266892,198536,true,2388483034,28,2434539193,46056159
1652266930,198531,true,2389677514,28,2434539193,44861679
1652266987,198527,true,2390633529,28,2434539193,43905664
1652267050,198525,true,2391111679,28,2434539193,43427514
1652267073,198522,true,2391829085,28,2434539193,42710108
1652267113,198518,true,2392785960,28,2434295764,41509804
1652267351,198515,true,2393503867,28,2433078981,39575114
1652267498,198513,true,2393982592,28,2432349203,38366611
1652267520,198510,true,2394700859,28,2432349203,37648344
1652267551,198505,true,2395898448,28,2432349203,36450755
1652267555,198502,true,2396617290,28,2432349203,35731913
1652267582,198499,true,2397336347,28,2432349203,35012856
1652267623,198495,true,2398295425,28,2432592438,34297013
1652268301,198490,true,2399494813,28,2431376507,31881694
1652268347,198487,true,2400214733,28,2431133393,30918660
1652268413,198484,true,2400934870,28,2430890304,29955434
1652268499,198481,true,2401655222,28,2430161183,28505961
1652268512,198477,true,2402616028,28,2429918191,27302163
1652268569,198475,true,2403096576,28,2429432280,26335704
1652268696,198472,true,2403817577,28,2428460750,24643173
1652268850,198469,true,2404538794,28,2427975131,23436337
1652269136,198466,true,2405260228,28,2428460750,23200522
1652269488,198463,true,2405981878,28,2427489609,21507731
1652269707,198460,true,2406703745,28,2425791046,19087301
1652269793,198456,true,2407666571,28,2425063454,17396883
1652269871,198453,true,2408388943,28,2424093671,15704728
1652269890,198450,true,2409111532,28,2423851286,14739754
1652269987,198447,true,2409834338,28,2422397484,12563146
1652270100,198444,true,2410557360,28,2420944554,10387194
1652270148,198441,true,2411280600,28,2420218416,8937816
1652270244,198439,true,2411762880,28,2418766793,7003913
1652270639,198438,true,2412004056,28,2414175729,2171673
1652270668,198435,true,2412727730,28,2413934335,1206605
1652270809,198432,true,2413451621,28,2412969003,-482618
1652270851,198431,true,2413692966,28,2412727730,-965236
1652270941,198429,true,2414175729,28,2412245257,-1930472
1652270950,198427,true,2414658588,28,2412245257,-2413331
1652271434,198423,true,2415624596,28,2411521728,-4102868
1652271455,198422,true,2415866159,28,2411521728,-4344431
1652271457,198420,true,2416349356,28,2411521728,-4827628
1652271466,198418,true,2416832650,28,2411280600,-5552050
1652271494,198415,true,2417557772,28,2411280600,-6277172
1652271515,198415,true,2417557772,28,2411280600,-6277172
1652271520,198413,true,2418041308,28,2411280600,-6760708
1652271544,198411,true,2418524940,28,2411039496,-7485444
1652271560,198408,true,2419250571,28,2411039496,-8211075
1652271590,198409,true,2419008670,28,2410798416,-8210254
1652271633,198407,true,2419492496,28,2410557360,-8935136
1652271920,198406,true,2419734445,28,2408870645,-10863800
1652271928,198403,true,2420460438,28,2408870645,-11589793
1652271966,198404,true,2420218416,28,2408870645,-11347771
1652272032,198403,true,2420460438,28,2409111532,-11348906
1652272193,198400,true,2421186649,28,2410316329,-10870320
1652272219,198398,true,2421670910,28,2410316329,-11354581
1652272268,198400,true,2421186649,28,2409593378,-11593271
1652272298,198400,true,2421186649,28,2409111532,-12075117
1652272336,198402,true,2420702484,28,2408148128,-12554356
1652272359,198401,true,2420944554,28,2407666571,-13277983
1652272393,198405,true,2419976418,28,2406463099,-13513319
1652272415,198406,true,2419734445,28,2405741304,-13993141
1652272422,198409,true,2419008670,28,2405500754,-13507916
1652272463,198409,true,2419008670,28,2404298364,-14710306
1652272497,198413,true,2418041308,28,2402856290,-15185018
1652272514,198415,true,2417557772,28,2402375791,-15181981
1652272543,198419,true,2416590991,28,2400934870,-15656121
1652272572,198421,true,2416107745,28,2399734762,-16372983
1652272584,198426,true,2414900054,28,2399014986,-15885068
1652272601,198427,true,2414658588,28,2398295425,-16363163
1652272658,198432,true,2413451621,28,2395658883,-17792738
1652272687,198435,true,2412727730,28,2394221990,-18505740
1652272721,198441,true,2411280600,28,2392307474,-18973126
1652272736,198443,true,2410798416,28,2391350790,-19447626
1652272775,198449,true,2409352443,28,2388721882,-20630561
1652272816,198454,true,2408148128,28,2385857278,-22290850
1652272834,198461,true,2406463099,28,2384664707,-21798392
1652272871,198463,true,2405981878,28,2381804969,-24176909
1652272879,198470,true,2404298364,28,2381328679,-22969685
1652272891,198476,true,2402856290,28,2380376386,-22479904
1652272918,198483,true,2401174963,28,2378235118,-22939845
1652272932,198487,true,2400214733,28,2377046357,-23168376
1652272940,198494,true,2398535255,28,2376333386,-22201869
1652272955,198500,true,2397096637,28,2375145575,-21951062
1652272965,198507,true,2395419341,28,2374195755,-21223586
1652272972,198511,true,2394461412,28,2373483638,-20977774
1652273014,198519,true,2392546705,28,2369926260,-22620445
1652273090,198524,true,2391350790,28,2363536408,-27814382
1652273107,198532,true,2389438570,28,2362118783,-27319787
1652273122,198537,true,2388244209,28,2360702007,-27542202
1652273158,198545,true,2386334474,28,2357635242,-28699232
1652273175,198551,true,2384903174,28,2356221156,-28682018
1652273221,198559,true,2382996110,28,2351983984,-31012126
1652273224,198564,true,2381804969,28,2351513658,-30291311
1652273256,198573,true,2379662416,28,2348693675,-30968741
1652273272,198579,true,2378235118,28,2347050247,-31184871
1652273303,198588,true,2376095776,28,2344001216,-32094560
1652273324,198594,true,2374670618,28,2341658503,-33012115
1652273360,198604,true,2372297253,28,2337915033,-34382220
1652273390,198611,true,2370637308,28,2334644405,-35992903
1652273425,198621,true,2368267975,28,2330679079,-37588896
1652273457,198627,true,2366847511,28,2327185856,-39661655
1652273468,198638,true,2364245540,28,2326022612,-38222928
1652273485,198645,true,2362591230,28,2324162631,-38428599
1652273486,198656,true,2359993938,28,2323930238,-36063700
1652273514,198665,true,2357871005,28,2320447130,-37423875
1652273518,198677,true,2355043398,28,2319751135,-35292263
1652273528,198687,true,2352689650,28,2318359771,-34329879
1652273539,198698,true,2350103243,28,2316969242,-33134001
1652273569,198708,true,2347754432,28,2313033937,-34720495
1652273607,198720,true,2344938957,28,2308412723,-36526234
1652273611,198729,true,2342829567,28,2307951110,-34878457
1652273672,198737,true,2340956146,28,2301268081,-39688065
1652273673,198746,true,2338850339,28,2301268081,-37582258
1652273689,198755,true,2336746426,28,2299427894,-37318532
1652273700,198765,true,2334410964,28,2298048720,-36362244
1652273733,198775,true,2332077836,28,2294145551,-37932285
1652273767,198784,true,2329980015,28,2289791031,-40188984
1652273774,198793,true,2327884082,28,2288875343,-39008739
1652273818,198804,true,2325324945,28,2282704023,-42620922
1652273826,198814,true,2323000898,28,2281563014,-41437884
1652273849,198824,true,2320679174,28,2278371220,-42307954
1652273888,198834,true,2318359771,28,2272682690,-45677081
1652273907,198844,true,2316042686,28,2270184238,-45858448
1652273927,198855,true,2313496567,28,2267461787,-46034780
1652273942,198865,true,2311184342,28,2265422091,-45762251
1652273968,198874,true,2309105316,28,2262026675,-47078641
1652274003,198885,true,2306566824,28,2257507369,-49059455
1652274004,198895,true,2304261525,28,2257281640,-46979885
1652274019,198906,true,2301728357,28,2255476627,-46251730
1652274029,198915,true,2299657837,28,2254349227,-45308610
1652274043,198926,true,2297129731,28,2252546559,-44583172
1652274063,198937,true,2294604403,28,2250070244,-44534159
1652274076,198947,true,2292311061,28,2248495825,-43815236
1652274122,198957,true,2290020010,28,2243106174,-46913836
1652274140,198968,true,2287502499,28,2241312497,-46190002
1652274192,198977,true,2285444775,28,2236387275,-49057500
1652274237,198986,true,2283388903,28,2232588836,-50800067
1652274250,198994,true,2281563014,28,2231472877,-50090137
1652274364,199004,true,2279282705,28,2222343023,-56939682
1652274390,199012,true,2277460099,28,2220788005,-56672094
1652274474,199020,true,2275638951,28,2214800264,-60838687
1652274527,199028,true,2273819258,28,2211259594,-62559664
1652274554,199037,true,2271773844,28,2209491382,-62282462
1652274790,199045,true,2269957242,28,2198032419,-71924823
1652274804,199053,true,2268142094,28,2197373141,-70768953
1652274854,199061,true,2266328396,28,2195176976,-71151420
1652274888,199070,true,2264289720,28,2193202304,-71087416
1652275018,199081,true,2261800495,28,2187070233,-74730262
1652275039,199089,true,2259991869,28,2186195624,-73796245
1652275062,199098,true,2257958893,28,2185321364,-72637529
1652275098,199108,true,2255702175,28,2184447454,-71254721
1652275150,199116,true,2253898425,28,2183792251,-70106174
1652275182,199124,true,2252096118,28,2183573894,-68522224
1652275209,199132,true,2250295251,28,2183355558,-66939693
1652275220,199141,true,2248270998,28,2183355558,-64915440
1652275232,199148,true,2246697837,28,2183355558,-63342279
1652275242,199156,true,2244901288,28,2183573894,-61327394
1652275311,199158,true,2244452375,28,2186195624,-58256751
1652275342,199165,true,2242881886,28,2187945193,-54936693
1652275354,199172,true,2241312497,28,2188382804,-52929693
1652275365,199179,true,2239744205,28,2188820502,-50923703
1652275396,199180,true,2239520253,28,2190134123,-49386130
1652275429,199189,true,2237505693,28,2190791229,-46714464
1652275513,199197,true,2235716493,28,2192544475,-43172018
1652275621,199205,true,2233928725,28,2195835595,-38093130
1652275653,199209,true,2233035377,28,2196933733,-36101644
1652275697,199218,true,2231026649,28,2198472048,-32554601
1652275715,199225,true,2229465555,28,2199131655,-30333900
1652275716,199233,true,2227682785,28,2199131655,-28551130
1652275726,199232,true,2227905553,28,2199351568,-28553985
1652275763,199238,true,2226569278,28,2200891576,-25677702
1652275786,199243,true,2225456327,28,2201772065,-23684262
1652275823,199250,true,2223899130,28,2203093459,-20805671
1652275880,199249,true,2224121520,28,2205738625,-18382895
1652275907,199255,true,2222787514,28,2207062399,-15725115
1652275920,199260,true,2221676454,28,2207724584,-13951870
1652275944,199266,true,2220343914,28,2208607807,-11736107
1652276013,199264,true,2220788005,28,2210817409,-9970596
1652276038,199270,true,2219455999,28,2211480720,-7975279
1652276054,199274,true,2218568438,28,2211701868,-6866570
1652276067,199281,true,2217016061,28,2211923038,-5093023
1652276087,199281,true,2217016061,28,2212144231,-4871830
1652276110,199287,true,2215686317,28,2212365445,-3320872
1652276140,199291,true,2214800264,28,2212807940,-1992324
1652276153,199297,true,2213471849,28,2213029221,-442628
1652276165,199296,true,2213693196,28,2213250524,-442672
1652276180,199300,true,2212807940,28,2213471849,663909
1652276191,199304,true,2211923038,28,2213471849,1548811
1652276215,199310,true,2210596349,28,2213693196,3096847
1652276270,199308,true,2211038490,28,2213914566,2876076
1652276290,199312,true,2210154296,28,2214135957,3981661
1652276318,199315,true,2209491382,28,2214578806,5087424
1652276351,199319,true,2208607807,28,2215243246,6635439
1652276366,199317,true,2209049550,28,2215464771,6415221
1652276420,199320,true,2208386968,28,2216351090,7964122
1652276449,199323,true,2207724584,28,2216794382,9069798
1652276512,199326,true,2207062399,28,2218346604,11284205
1652276607,199322,true,2207945357,28,2220788005,12842648
1652276618,199326,true,2207062399,28,2221232185,14169786
1652276624,199327,true,2206841715,28,2221232185,14390470
1652276660,199330,true,2206179795,28,2222565258,16385463
1652276709,199325,true,2207283106,28,2224788823,17505717
1652276734,199327,true,2206841715,28,2226124031,19282316
1652276746,199328,true,2206621053,28,2226791935,20170882
1652276815,199328,true,2206621053,28,2230803569,24182516
1652276867,199321,true,2208166151,28,2233928725,25762574
1652276911,199322,true,2207945357,28,2236387275,28441918
1652276931,199321,true,2208166151,28,2237505693,29339542
1652276937,199320,true,2208386968,28,2237729443,29342475
1652276981,199310,true,2210596349,28,2240192177,29595828
1652277016,199308,true,2211038490,28,2242657621,31619131
1652277023,199306,true,2211480720,28,2243106174,31625454
1652277059,199304,true,2211923038,28,2244676820,32753782
1652277154,199291,true,2214800264,28,2248270998,33470734
1652277322,199289,true,2215243246,28,2256378953,41135707
1652277376,199286,true,2215907886,28,2259314007,43406121
1652277380,199281,true,2217016061,28,2259539938,42523877
1652277404,199268,true,2219899912,28,2260669934,40770022
1652277455,199265,true,2220565949,28,2263157915,42591966
1652277487,199261,true,2221454308,28,2264969075,43514767
1652277548,199255,true,2222787514,28,2268368908,45581394
1652277572,199243,true,2225456327,28,2269503319,44046992
1652277600,199240,true,2226124031,28,2270638298,44514267
1652277629,199239,true,2226346643,28,2272001021,45654378
1652277639,199235,true,2227237315,28,2272682690,45445375
1652277758,199223,true,2229911470,28,2278826917,48915447
1652277789,199219,true,2230803569,28,2280194555,49390986
1652277837,199216,true,2231472877,28,2282932294,51459417
1652277884,199212,true,2232365600,28,2285673320,53307720
1652277941,199200,true,2235045912,28,2289104231,54058319
1652277959,199195,true,2236163659,28,2290249012,54085353
1652277963,199192,true,2236834575,28,2290478037,53643462
1652278000,199186,true,2238177011,28,2292769546,54592535
1652278008,199174,true,2240864302,28,2293228123,52363821
1652278059,199168,true,2242209156,28,2296900041,54690885
1652278102,199164,true,2243106174,28,2299887803,56781629
1652278187,199158,true,2244452375,28,2305644427,61192052
1652278207,199147,true,2246922507,28,2306797480,59874973
1652278245,199142,true,2248046193,28,2309105316,61059123
1652278258,199139,true,2248720674,28,2309798117,61077443
1652278392,199136,true,2249395358,28,2315348012,65952654
1652278471,199125,true,2251870930,28,2317664402,65793472
1652278551,199119,true,2253222391,28,2319519183,66296792
1652278628,199116,true,2253898425,28,2321143334,67244909
1652278737,199111,true,2255025600,28,2323000898,67975298
1652278800,199100,true,2257507369,28,2323465522,65958153
1652278803,199094,true,2258862212,28,2323465522,64603310
1652278810,199091,true,2259539938,28,2323233198,63693260
1652278829,199088,true,2260217868,28,2323465522,63247654
1652278837,199077,true,2262705351,28,2323465522,60760171
1652278880,199072,true,2263836930,28,2323465522,59628592
1652278960,199069,true,2264516149,28,2323465522,58949373
1652278989,199066,true,2265195572,28,2323697868,58502296
1652279004,199055,true,2267688533,28,2323930238,56241705
1652279025,199050,true,2268822604,28,2324162631,55340027
1652279034,199046,true,2269730269,28,2324162631,54432362
1652279057,199042,true,2270638298,28,2324627487,53989189
1652279147,199032,true,2272909958,28,2325324945,52414987
1652279188,199026,true,2274274045,28,2325790033,51515988
1652279253,199020,true,2275638951,28,2326720489,51081538
1652279328,199016,true,2276549343,28,2327418575,50869232
1652279430,199005,true,2279054800,28,2328349682,49294882
1652279677,198999,true,2280422574,28,2329747041,49324467
1652279691,198996,true,2281106769,28,2329980015,48873246
1652279864,198992,true,2282019349,28,2331611491,49592142
1652279878,198982,true,2284302396,28,2331611491,47309095
1652279912,198977,true,2285444775,28,2331611491,46166716
1652279939,198973,true,2286359090,28,2331844652,45485562
1652279968,198970,true,2287045067,28,2332077836,45032769
1652280034,198964,true,2288417637,28,2333244109,44826472
1652280145,198960,true,2289333141,28,2336045542,46712401
1652280194,198957,true,2290020010,28,2337213798,47193788
1652280217,198954,true,2290707084,28,2337915033,47207949
1652280276,198948,true,2292081852,28,2340019998,47938146
1652280284,198942,true,2293457445,28,2340254000,46796555
1652280326,198939,true,2294145551,28,2341424361,47278810
1652280471,198934,true,2295292854,28,2345877073,50584219
1652280522,198927,true,2296900041,28,2347050247,50150206
1652280528,198921,true,2298278525,28,2347284952,49006427
1652280632,198917,true,2299197975,28,2349398353,50200378
1652280643,198912,true,2300347804,28,2349398353,49050549
1652280663,198906,true,2301728357,28,2349868256,48139899
1652280715,198902,true,2302649187,28,2350338254,47689067
1652280742,198900,true,2303109740,28,2350573287,47463547
1652280782,198896,true,2304031122,28,2350808345,46777223
1652280820,198890,true,2305413886,28,2350573287,45159401
1652280871,198886,true,2306336190,28,2350573287,44237097
1652280923,198884,true,2306797480,28,2350338254,43540774
1652280953,198880,true,2307720338,28,2350338254,42617916
1652281240,198875,true,2308874429,28,2349868256,40993827
1652281264,198871,true,2309798117,28,2349868256,40070139
1652281353,198868,true,2310491126,28,2349868256,39377130
1652281406,198864,true,2311415461,28,2349633293,38217832
1652281419,198857,true,2313033937,28,2349633293,36599356
1652281499,198852,true,2314190685,28,2349163437,34972752
1652281538,198850,true,2314653547,28,2349163437,34509890
1652281582,198845,true,2315811105,28,2348693675,32882570
1652281599,198838,true,2317432659,28,2348458829,31026170
1652281649,198834,true,2318359771,28,2347989208,29629437
1652281693,198832,true,2318823466,28,2347519680,28696214
1652281787,198828,true,2319751135,28,2345642509,25891374
1652281945,198821,true,2321375448,28,2342595307,21219859
1652281967,198817,true,2322304137,28,2342126859,19822722
1652281977,198815,true,2322768621,28,2341892669,19124048
1652281989,198812,true,2323465522,28,2341658503,18192981
1652282058,198806,true,2324859950,28,2340019998,15160048
1652282129,198802,true,2325790033,28,2338148824,12358791
1652282132,198801,true,2326022612,28,2338148824,12126212
1652282174,198798,true,2326720489,28,2336746426,10025937
1652282196,198793,true,2327884082,28,2336045542,8161460
1652282230,198790,true,2328582517,28,2334877870,6295353
1652282236,198789,true,2328815375,28,2334644405,5829030
1652282252,198787,true,2329281161,28,2333944152,4662991
1652282275,198784,true,2329980015,28,2333244109,3264094
1652282336,198783,true,2330213013,28,2330912147,699134
1652282371,198783,true,2330213013,28,2329747041,-465972
1652282474,198783,true,2330213013,28,2326255214,-3957799
1652282482,198781,true,2330679079,28,2326022612,-4656467
1652282529,198781,true,2330679079,28,2324859950,-5819129
1652282531,198781,true,2330679079,28,2324627487,-6051592
1652282537,198782,true,2330446035,28,2324627487,-5818548
1652282665,198781,true,2330679079,28,2322071930,-8607149
1652282698,198781,true,2330679079,28,2321375448,-9303631
1652282720,198782,true,2330446035,28,2321143334,-9302701
1652282743,198783,true,2330213013,28,2320679174,-9533839
1652282775,198784,true,2329980015,28,2319983110,-9996905
1652282832,198785,true,2329747041,28,2318591607,-11155434
1652282841,198786,true,2329514089,28,2318359771,-11154318
1652282886,198788,true,2329048256,28,2317200939,-11847317
1652282964,198789,true,2328815375,28,2315348012,-13467363
1652282977,198789,true,2328815375,28,2314885012,-13930363
1652283048,198789,true,2328815375,28,2313265240,-15550135
1652283139,198792,true,2328116870,28,2311184342,-16932528
1652283387,198793,true,2327884082,28,2306105579,-21778503
1652283418,198794,true,2327651316,28,2305413886,-22237430
1652283428,198794,true,2327651316,28,2305183368,-22467948
1652283439,198796,true,2327185856,28,2305183368,-22002488
1652283495,198797,true,2326953161,28,2304491951,-22461210
1652283742,198797,true,2326953161,28,2303109740,-23843421
1652283879,198797,true,2326953161,28,2302649187,-24303974
1652283952,198799,true,2326487840,28,2302418945,-24068895
1652283984,198800,true,2326255214,28,2302418945,-23836269
1652283989,198800,true,2326255214,28,2302188726,-24066488
1652284011,198801,true,2326022612,28,2302188726,-23833886
1652284093,198804,true,2325324945,28,2301728357,-23596588
1652284193,198805,true,2325092436,28,2301268081,-23824355
1652284263,198806,true,2324859950,28,2301268081,-23591869
1652284353,198808,true,2324395047,28,2300807896,-23587151
1652284376,198811,true,2323697868,28,2300577838,-23120030
1652284386,198813,true,2323233198,28,2300577838,-22655360
1652284394,198813,true,2323233198,28,2300347804,-22885394
1652284414,198815,true,2322768621,28,2300117792,-22650829
1652284451,198816,true,2322536368,28,2299887803,-22648565
1652284470,198816,true,2322536368,28,2299657837,-22878531
1652284477,198817,true,2322304137,28,2299427894,-22876243
1652284553,198819,true,2321839746,28,2298508353,-23331393
1652284574,198820,true,2321607585,28,2298278525,-23329060
1652284624,198822,true,2321143334,28,2297589180,-23554154
1652284688,198823,true,2320911242,28,2296670374,-24240868
1652284836,198826,true,2320215108,28,2294145551,-26069557
1652284960,198828,true,2319751135,28,2292081852,-27669283
1652285024,198831,true,2319055349,28,2291165249,-27890100
1652285187,198832,true,2318823466,28,2288875343,-29948123
1652285193,198836,true,2317896169,28,2288646479,-29249690
1652285225,198838,true,2317432659,28,2288188818,-29243841
1652285371,198841,true,2316737568,28,2284302396,-32435172
1652285393,198844,true,2316042686,28,2283617242,-32425444
1652285418,198848,true,2315116500,28,2282932294,-32184206
1652285444,198851,true,2314422104,28,2282019349,-32402755
1652285493,198854,true,2313727917,28,2280650617,-33077300
1652285520,198857,true,2313033937,28,2279738584,-33295353
1652285590,198862,true,2311877767,28,2277232376,-34645391
1652285617,198865,true,2311184342,28,2276321711,-34862631
1652285636,198869,true,2310260100,28,2275866515,-34393585
1652285638,198871,true,2309798117,28,2275638951,-34159166
1652285738,198877,true,2308412723,28,2272455444,-35957279
1652285825,198880,true,2307720338,28,2270184238,-37536100
1652285865,198883,true,2307028160,28,2269049486,-37978674
1652285959,198887,true,2306105579,28,2266555029,-39550550
1652286015,198893,true,2304722400,28,2264742601,-39979799
1652286227,198897,true,2303800742,28,2258862212,-44938530
1652286251,198901,true,2302879452,28,2258410507,-44468945
1652286433,198905,true,2301958530,28,2255702175,-46256355
1652286443,198910,true,2300807896,28,2255476627,-45331269
1652286555,198914,true,2299887803,28,2253898425,-45989378
1652286566,198918,true,2298968078,28,2253673058,-45295020
1652286691,198922,true,2298048720,28,2251870930,-46177790
1652286759,198929,true,2296440730,28,2250745333,-45695397
1652286848,198934,true,2295292854,28,2248945546,-46347308
1652286983,198939,true,2294145551,28,2245799383,-48346168
1652287045,198943,true,2293228123,28,2244901288,-48326835
1652287141,198949,true,2291852667,28,2243330485,-48522182
1652287257,198954,true,2290707084,28,2241760782,-48946302
1652287347,198958,true,2289791031,28,2240640237,-49150794
1652287420,198962,true,2288875343,28,2239744205,-49131138
1652287451,198967,true,2287731249,28,2239296324,-48434925
1652287523,198972,true,2286587726,28,2238400829,-48186897
1652287567,198977,true,2285444775,28,2237953216,-47491559
1652287736,198980,true,2284759279,28,2236387275,-48372004
1652287805,198985,true,2283617242,28,2235492944,-48124298
1652287818,198990,true,2282475776,28,2235492944,-46982832
1652287868,198994,true,2281563014,28,2235045912,-46517102
1652288009,198998,true,2280650617,28,2233705354,-46945263
1652288033,199003,true,2279510633,28,2233482006,-46028627
1652288045,199008,true,2278371220,28,2233258680,-45112540
1652288052,199012,true,2277460099,28,2233258680,-44201419
1652288078,199017,true,2276321711,28,2232588836,-43732875
1652288151,199022,true,2275183891,28,2231026649,-44157242
1652288194,199027,true,2274046640,28,2230134462,-43912178
1652288384,199032,true,2272909958,28,2226346643,-46563315
1652288473,199037,true,2271773844,28,2224566367,-47207477
1652288496,199041,true,2270865362,28,2224121520,-46743842
1652288500,199046,true,2269730269,28,2224121520,-45608749
1652288503,199050,true,2268822604,28,2224121520,-44701084
1652288511,199055,true,2267688533,28,2223899130,-43789403
1652288524,199060,true,2266555029,28,2223676763,-42878266
1652288566,199064,true,2265648634,28,2223009793,-42638841
1652288600,199068,true,2264742601,28,2222343023,-42399578
1652288625,199072,true,2263836930,28,2221898622,-41938308
1652288746,199077,true,2262705351,28,2220343914,-42361437
1652288790,199081,true,2261800495,28,2219677944,-42122551
1652288811,199085,true,2260896001,28,2219234075,-41661926
1652288827,199089,true,2259991869,28,2218790295,-41201574
1652288884,199094,true,2258862212,28,2217903001,-40959211
1652288901,199098,true,2257958893,28,2217681233,-40277660
1652288949,199101,true,2257281640,28,2217016061,-40265579
1652289030,199104,true,2256604591,28,2215686317,-40918274
1652289057,199109,true,2255476627,28,2215464771,-40011856
1652289109,199112,true,2254800120,28,2214800264,-39999856
1652289135,199115,true,2254123815,28,2214357371,-39766444
1652289148,199118,true,2253447713,28,2214135957,-39311756
1652289235,199123,true,2252321327,28,2213250524,-39070803
1652289327,199127,true,2251420624,28,2211923038,-39497586
1652289370,199131,true,2250520281,28,2211480720,-39039561
1652289401,199134,true,2249845260,28,2210817409,-39027851
1652289411,199139,true,2248720674,28,2210817409,-37903265
1652289442,199144,true,2247596651,28,2210375311,-37221340
1652289482,199147,true,2246922507,28,2209712331,-37210176
1652289672,199150,true,2246248565,28,2207503834,-38744731
1652289674,199154,true,2245350290,28,2207503834,-37846456
1652289783,199159,true,2244227952,28,2205959199,-38268753
1652289900,199163,true,2243330485,28,2204415645,-38914840
1652289911,199165,true,2242881886,28,2204415645,-38466241
1652289937,199170,true,2241760782,28,2203974828,-37785954
1652289975,199175,true,2240640237,28,2203754453,-36885784
1652289989,199179,true,2239744205,28,2203534099,-36210106
1652290003,199182,true,2239072417,28,2203313768,-35758649
1652290087,199188,true,2237729443,28,2201992242,-35737201
1652290089,199194,true,2236387275,28,2201992242,-34395033
1652290126,199198,true,2235492944,28,2201331777,-34161167
1652290143,199203,true,2234375533,28,2201111666,-33263867
1652290193,199210,true,2232812095,28,2200011440,-32800655
1652290208,199216,true,2231472877,28,2199791461,-31681416
1652290272,199221,true,2230357475,28,2198252222,-32105253
1652290310,199225,true,2229465555,28,2197592879,-31872676
1652290335,199231,true,2228128344,28,2197373141,-30755203
1652290349,199235,true,2227237315,28,2197153426,-30083889
1652290488,199238,true,2226569278,28,2195616034,-30953244
1652290492,199242,true,2225678872,28,2195396494,-30282378
1652290581,199248,true,2224343932,28,2194299125,-30044807
1652290610,199253,true,2223232094,28,2193860331,-29371763
1652290628,199256,true,2222565258,28,2193640967,-28924291
1652290658,199260,true,2221676454,28,2193202304,-28474150
1652290726,199267,true,2220121902,28,2191886843,-28235059
1652290808,199271,true,2219234075,28,2190134123,-29099952
1652290895,199275,true,2218346604,28,2187945193,-30401411
1652291047,199280,true,2217237763,28,2183355558,-33882205
1652291148,199287,true,2215686317,28,2180519182,-35167135
1652291196,199292,true,2214578806,28,2179211328,-35367478
1652291237,199295,true,2213914566,28,2178122049,-35792517
1652291251,199300,true,2212807940,28,2177686490,-35121450
1652291266,199306,true,2211480720,28,2177251018,-34229702
1652291379,199309,true,2210817409,28,2175074964,-35742445
1652291426,199312,true,2210154296,28,2174205152,-35949144
1652291455,199316,true,2209270455,28,2173553021,-35717434
1652291467,199322,true,2207945357,28,2173553021,-34392336
1652291527,199323,true,2207724584,28,2173335687,-34388897
1652291561,199324,true,2207503834,28,2173335687,-34168147
1652291602,199327,true,2206841715,28,2173335687,-33506028
1652291681,199334,true,2205297544,28,2172683817,-32613727
1652291712,199335,true,2205077036,28,2172466570,-32610466
1652291747,199335,true,2205077036,28,2172466570,-32610466
1652291757,199338,true,2204415645,28,2172466570,-31949075
1652291773,199344,true,2203093459,28,2172249345,-30844114
1652291828,199346,true,2202652906,28,2172032142,-30620764
1652291852,199347,true,2202432663,28,2172032142,-30400521
1652291990,199351,true,2201551910,28,2171814960,-29736950
1652292021,199357,true,2200231441,28,2171814960,-28416481
1652292075,199358,true,2200011440,28,2172249345,-27762095
1652292196,199359,true,2199791461,28,2172466570,-27324891
1652292297,199361,true,2199351568,28,2172466570,-26884998
1652292301,199367,true,2198032419,28,2172466570,-25565849
1652292368,199367,true,2198032419,28,2172466570,-25565849
1652292478,199368,true,2197812638,28,2172901085,-24911553
1652292520,199371,true,2197153426,28,2173335687,-23817739
1652292541,199376,true,2196055179,28,2173553021,-22502158
1652292691,199378,true,2195616034,28,2175074964,-20541070
1652292854,199378,true,2195616034,28,2177686490,-17929544
1652293027,199381,true,2194957480,28,2180519182,-14438298
1652293039,199386,true,2193860331,28,2180737234,-13123097
1652293124,199387,true,2193640967,28,2181609659,-12031308
1652293138,199387,true,2193640967,28,2181827820,-11813147
1652293171,199389,true,2193202304,28,2182046003,-11156301
1652293185,199394,true,2192106032,28,2182264208,-9841824
1652293288,199395,true,2191886843,28,2182700682,-9186161
1652293305,199395,true,2191886843,28,2182482434,-9404409
1652293346,199397,true,2191448532,28,2182264208,-9184324
1652293374,199402,true,2190353136,28,2182046003,-8307133
1652293375,199402,true,2190353136,28,2182046003,-8307133
1652293423,199402,true,2190353136,28,2181827820,-8525316
1652293445,199404,true,2189915131,28,2181827820,-8087311
1652293471,199408,true,2189039384,28,2182046003,-6993381
1652293521,199408,true,2189039384,28,2182264208,-6775176
1652293559,199407,true,2189258288,28,2182482434,-6775854
1652293626,199408,true,2189039384,28,2183137244,-5902140
1652293712,199413,true,2187945193,28,2184447454,-3497739
1652293820,199412,true,2188163987,28,2186195624,-1968363
1652293825,199411,true,2188382804,28,2186195624,-2187180
1652293848,199411,true,2188382804,28,2186414244,-1968560
1652293876,199415,true,2187507669,28,2186632885,-874784
1652293926,199415,true,2187507669,28,2186851548,-656121
1652293971,199414,true,2187726420,28,2187070233,-656187
1652293981,199414,true,2187726420,28,2187070233,-656187
1652294056,199418,true,2186851548,28,2187288940,437392
1652294075,199418,true,2186851548,28,2187288940,437392
1652294106,199417,true,2187070233,28,2187507669,437436
1652294179,199417,true,2187070233,28,2187726420,656187
1652294246,199420,true,2186414244,28,2187945193,1530949
1652294300,199420,true,2186414244,28,2188163987,1749743
1652294306,199419,true,2186632885,28,2188163987,1531102
1652294325,199419,true,2186632885,28,2188163987,1531102
1652294400,199422,true,2185977026,28,2188820502,2843476
1652294421,199422,true,2185977026,28,2188820502,2843476
1652294480,199421,true,2186195624,28,2189258288,3062664
1652294493,199421,true,2186195624,28,2189258288,3062664
1652294543,199424,true,2185539897,28,2189258288,3718391
1652294573,199424,true,2185539897,28,2189477214,3937317
1652294612,199424,true,2185539897,28,2189477214,3937317
1652294654,199424,true,2185539897,28,2189477214,3937317
1652294697,199427,true,2184884366,28,2189696162,4811796
1652294719,199427,true,2184884366,28,2189915131,5030765
1652294758,199426,true,2185102854,28,2190353136,5250282
1652294799,199426,true,2185102854,28,2190572172,5469318
1652294846,199430,true,2184229031,28,2190791229,6562198
1652294876,199429,true,2184447454,28,2190791229,6343775
1652294879,199429,true,2184447454,28,2190791229,6343775
1652294922,199429,true,2184447454,28,2190791229,6343775
1652295028,199433,true,2183573894,28,2190572172,6998278
1652295141,199433,true,2183573894,28,2190353136,6779242
1652295207,199432,true,2183792251,28,2190353136,6560885
1652295222,199433,true,2183573894,28,2190353136,6779242
1652295325,199437,true,2182700682,28,2189696162,6995480
1652295337,199436,true,2182918953,28,2189477214,6558261
1652295415,199435,true,2183137244,28,2188601642,5464398
1652295438,199436,true,2182918953,28,2188382804,5463851
1652295531,199441,true,2181827820,28,2186632885,4805065
1652295543,199440,true,2182046003,28,2186414244,4368241
1652295605,199439,true,2182264208,28,2185321364,3057156
1652295696,199440,true,2182046003,28,2183792251,1746248
1652295821,199444,true,2181173403,28,2182264208,1090805
1652295956,199442,true,2181609659,28,2180519182,-1090477
1652296030,199441,true,2181827820,28,2179865157,-1962663
1652296212,199441,true,2181827820,28,2177686490,-4141330
1652296277,199444,true,2181173403,28,2177251018,-3922385
1652296299,199442,true,2181609659,28,2177033315,-4576344
1652296353,199440,true,2182046003,28,2177033315,-5012688
1652296360,199440,true,2182046003,28,2176815633,-5230370
1652296435,199442,true,2181609659,28,2176815633,-4794026
1652296437,199441,true,2181827820,28,2176815633,-5012187
1652296461,199441,true,2181827820,28,2176597973,-5229847
1652296496,199441,true,2181827820,28,2176162719,-5665101
1652296504,199444,true,2181173403,28,2176162719,-5010684
1652296533,199442,true,2181609659,28,2175727552,-5882107
1652296657,199443,true,2181391520,28,2173987753,-7403767
1652296761,199443,true,2181391520,28,2173118375,-8273145
1652296826,199444,true,2181173403,28,2172901085,-8272318
1652296828,199442,true,2181609659,28,2172901085,-8708574
1652296885,199442,true,2181609659,28,2172466570,-9143089
1652296909,199441,true,2181827820,28,2172466570,-9361250
1652296917,199442,true,2181609659,28,2172466570,-9143089
1652296950,199440,true,2182046003,28,2172032142,-10013861
1652296963,199440,true,2182046003,28,2171814960,-10231043
1652297046,199440,true,2182046003,28,2170729379,-11316624
1652297121,199442,true,2181609659,28,2169644339,-11965320
1652297161,199441,true,2181827820,28,2169210476,-12617344
1652297190,199442,true,2181609659,28,2168776699,-12832960
1652297211,199442,true,2181609659,28,2168559843,-13049816
1652297265,199444,true,2181173403,28,2168126196,-13047207
1652297623,199446,true,2180737234,28,2165742687,-14994547
1652297693,199448,true,2180301152,28,2164876607,-15424545
1652297721,199449,true,2180083143,28,2164660141,-15423002
1652297736,199450,true,2179865157,28,2164443696,-15421461
1652297743,199452,true,2179429249,28,2164443696,-14985553
1652297763,199454,true,2178993429,28,2164227274,-14766155
1652297782,199455,true,2178775551,28,2163794493,-14981058
1652297855,199458,true,2178122049,28,2162064236,-16057813
1652297859,199460,true,2177686490,28,2162064236,-15622254
1652297939,199461,true,2177468743,28,2160335363,-17133380
1652297998,199462,true,2177251018,28,2159039615,-18211403
1652298024,199465,true,2176597973,28,2158392033,-18205940
1652298068,199467,true,2176162719,28,2157097451,-19065268
1652298098,199469,true,2175727552,28,2156234827,-19492725
1652298109,199471,true,2175292472,28,2156019225,-19273247
1652298128,199474,true,2174640014,28,2155372549,-19267465
1652298160,199477,true,2173987753,28,2154295186,-19692567
1652298163,199480,true,2173335687,28,2154295186,-19040501
1652298225,199483,true,2172683817,28,2151711711,-20972106
1652298276,199486,true,2172032142,28,2149991116,-22041026
1652298421,199489,true,2171380662,28,2145052066,-26328596
1652298473,199492,true,2170729379,28,2143551130,-27178249
1652298512,199495,true,2170078290,28,2142051244,-28027046
1652298622,199498,true,2169427397,28,2138413032,-31014365
1652298641,199501,true,2168776699,28,2137557881,-31218818
1652298703,199504,true,2168126196,28,2135421498,-32704698
1652298776,199507,true,2167475888,28,2133073943,-34401945
1652298859,199511,true,2166609114,28,2130728969,-35880145
1652298886,199514,true,2165959261,28,2130089878,-35869383
1652298894,199517,true,2165309604,28,2129876890,-35432714
1652298953,199520,true,2164660141,28,2128599412,-36060729
1652299028,199523,true,2164010872,28,2126897298,-37113574
1652299034,199526,true,2163361799,28,2126684630,-36677169
1652299053,199529,true,2162712920,28,2126259356,-36453564
1652299224,199531,true,2162280443,28,2122223501,-40056942
1652299230,199535,true,2161415747,28,2122011300,-39404447
1652299264,199538,true,2160767451,28,2121586961,-39180490
1652299302,199541,true,2160119351,28,2120950612,-39168739
1652299327,199542,true,2159903361,28,2120738538,-39164823
1652299474,199546,true,2159039615,28,2118830828,-40208787
1652299530,199549,true,2158392033,28,2118195305,-40196728
1652299568,199553,true,2157528892,28,2117559974,-39968918
1652299615,199555,true,2157097451,28,2117136525,-39960926
1652299692,199559,true,2156234827,28,2116501512,-39733315
1652299703,199562,true,2155588086,28,2116289883,-39298203
1652299725,199566,true,2154726067,28,2116078275,-38647792
1652299742,199568,true,2154295186,28,2115655123,-38640063
1652299773,199574,true,2153003061,28,2115232055,-37771006
1652299786,199576,true,2152572525,28,2115020553,-37551972
1652299874,199581,true,2151496562,28,2113540631,-37955931
1652299912,199583,true,2151066327,28,2112906695,-38159632
1652300034,199588,true,2149991116,28,2112061744,-37929372
1652300089,199591,true,2149346248,28,2111850559,-37495689
1652300096,199595,true,2148486724,28,2111850559,-36636165
1652300129,199598,true,2147842307,28,2111428252,-36414055
1652300145,199604,true,2146554053,28,2111428252,-35125801
1652300186,199607,true,2145910215,28,2111428252,-34481963
1652300256,199610,true,2145266571,28,2111428252,-33838319
1652300259,199612,true,2144837582,28,2111428252,-33409330
1652300314,199618,true,2143551130,28,2111428252,-32122878
1652300333,199620,true,2143122484,28,2111217130,-31905354
1652300348,199623,true,2142479676,28,2111217130,-31262546
1652300396,199625,true,2142051244,28,2111006030,-31045214
1652300548,199632,true,2140552408,28,2110794950,-29757458
1652300573,199635,true,2139910370,28,2110794950,-29115420
1652300612,199638,true,2139268526,28,2110794950,-28473576
1652300654,199641,true,2138626873,28,2110794950,-27831923
1652300720,199647,true,2137344146,28,2110161838,-27182308
1652300852,199650,true,2136703071,28,2108685316,-28017755
1652300898,199654,true,2135848604,28,2108263642,-27584962
1652300956,199656,true,2135421498,28,2107631289,-27790209
1652300966,199662,true,2134140693,28,2107631289,-26509404
1652300981,199665,true,2133500579,28,2107420547,-26080032
1652300988,199668,true,2132860657,28,2107420547,-25440110
1652301005,199670,true,2132434149,28,2107209826,-25224323
1652301102,199676,true,2131155136,28,2105945943,-25209193
1652301191,199678,true,2130728969,28,2104261944,-26467025
1652301259,199682,true,2129876890,28,2103210128,-26666762
1652301389,199683,true,2129663924,28,2100897985,-28765939
1652301415,199688,true,2128599412,28,2100687916,-27911496
1652301438,199691,true,2127960959,28,2100267841,-27693118
1652301553,199694,true,2127322699,28,2099847851,-27474848
1652301575,199694,true,2127322699,28,2099847851,-27474848
1652301676,199699,true,2126259356,28,2100267841,-25991515
1652301735,199702,true,2125621606,28,2100477868,-25143738
1652301782,199704,true,2125196546,28,2100477868,-24718678
1652301846,199705,true,2124984047,28,2100897985,-24086062
1652301871,199710,true,2123921874,28,2100897985,-23023889
1652302067,199713,true,2123284825,28,2101318185,-21966640
1652302170,199715,true,2122860231,28,2101528317,-21331914
1652302181,199717,true,2122435723,28,2101528317,-20907406
1652302229,199722,true,2121374823,28,2101528317,-19846506
1652302275,199725,true,2120738538,28,2101528317,-19210221
1652302386,199728,true,2120102444,28,2101318185,-18784259
1652302441,199729,true,2119890455,28,2101108075,-18782380
1652302450,199734,true,2118830828,28,2101108075,-17722753
1652302478,199738,true,2117983507,28,2100477868,-17505639
1652302487,199742,true,2117136525,28,2100477868,-16658657
1652302504,199747,true,2116078275,28,2100057836,-16020439
1652302515,199753,true,2114809072,28,2099637887,-15171185
1652302538,199758,true,2113751985,28,2099218022,-14533963
1652302543,199762,true,2112906695,28,2099008122,-13898573
1652302572,199768,true,2111639395,28,2098168728,-13470667
1652302624,199774,true,2110372854,28,2096700597,-13672257
1652302651,199779,true,2109317984,28,2095862127,-13455857
1652302669,199783,true,2108474468,28,2095443017,-13031451
1652302723,199789,true,2107209826,28,2093348726,-13861100
1652302749,199796,true,2105735369,28,2092093157,-13642212
1652302783,199801,true,2104682817,28,2090838340,-13844477
1652302813,199805,true,2103841154,28,2089584276,-14256878
1652302831,199812,true,2102369055,28,2088330964,-14038091
1652302836,199820,true,2100687916,28,2088122152,-12565764
1652302877,199825,true,2099637887,28,2086452405,-13185482
1652302900,199829,true,2098798242,28,2085409492,-13388750
1652302922,199834,true,2097749157,28,2084783994,-12965163
1652303001,199837,true,2097119959,28,2083741915,-13378044
1652303020,199840,true,2096490948,28,2083325229,-13165719
1652303025,199843,true,2095862127,28,2083325229,-12536898
1652303089,199846,true,2095233494,28,2082075671,-13157823
1652303115,199849,true,2094605050,28,2081867485,-12737565
1652303203,199851,true,2094186191,28,2080618801,-13567390
1652303217,199854,true,2093558061,28,2080410760,-13147301
1652303267,199858,true,2092720847,28,2079162950,-13557897
1652303279,199861,true,2092093157,28,2078955055,-13138102
1652303292,199864,true,2091465654,28,2078539326,-12926328
1652303299,199867,true,2090838340,28,2078331493,-12506847
1652303347,199871,true,2090002214,28,2076877243,-13124971
1652303374,199874,true,2089375338,28,2076046700,-13328638
1652303440,199877,true,2088748651,28,2073971794,-14776857
1652303485,199879,true,2088330964,28,2072520595,-15810369
1652303520,199882,true,2087704590,28,2071484645,-16219945
1652303532,199885,true,2087078404,28,2071070410,-16007994
1652303538,199888,true,2086452405,28,2070863324,-15589081
1652303572,199890,true,2086035178,28,2069621241,-16413937
1652303603,199893,true,2085409492,28,2068586741,-16822751
1652303611,199896,true,2084783994,28,2068173085,-16610909
1652303663,199899,true,2084158684,28,2066312660,-17846024
1652303703,199901,true,2083741915,28,2065073306,-18668609
1652303768,199904,true,2083116917,28,2063009368,-20107549
1652303821,199906,true,2082700357,28,2061153588,-21546769
1652303847,199908,true,2082283879,28,2060535365,-21748514
1652304050,199909,true,2082075671,28,2055596257,-26479414
1652304086,199912,true,2081451174,28,2054568767,-26882407
1652304108,199915,true,2080826863,28,2054157915,-26668948
1652304136,199918,true,2080202740,28,2053336457,-26866283
1652304221,199920,true,2079786762,28,2051079141,-28707621
1652304321,199924,true,2078955055,28,2049439016,-29516039
1652304357,199927,true,2078331493,28,2049029190,-29302303
1652304361,199930,true,2077708118,28,2049029190,-28678928
1652304382,199934,true,2076877243,28,2048619445,-28257798
1652304449,199943,true,2075008988,28,2047595443,-27413545
1652304456,199947,true,2074179191,28,2047390704,-26788487
1652304497,199951,true,2073349727,28,2046981287,-26368440
1652304499,199955,true,2072520595,28,2046776609,-25743986
1652304517,199964,true,2070656258,28,2046571952,-24084306
1652304587,199966,true,2070242189,28,2046162699,-24079490
1652304633,199969,true,2069621241,28,2046571952,-23049289
1652304648,199972,true,2069000479,28,2046367316,-22633163
1652304675,199980,true,2067346023,28,2046571952,-20774071
1652304685,199980,true,2067346023,28,2046571952,-20774071
1652304690,199981,true,2067139309,28,2046571952,-20567357
1652304721,199983,true,2066725943,28,2046571952,-20153991
1652304728,199991,true,2065073306,28,2046571952,-18501354
1652304742,199991,true,2065073306,28,2046162699,-18910607
1652304750,199993,true,2064660353,28,2045958103,-18702250
1652304784,199995,true,2064247483,28,2045139925,-19107558
1652304795,200003,true,2062596828,28,2044935431,-17661397
1652304863,200003,true,2062596828,28,2043300219,-19296609
1652304913,200005,true,2062184371,28,2042278875,-19905496
1652304927,200009,true,2061359703,28,2042074668,-19285035
1652305059,200017,true,2059711357,28,2039421828,-20289529
1652305080,200017,true,2059711357,28,2039014005,-20697352
1652305094,200019,true,2059299477,28,2038810124,-20489353
1652305120,200022,true,2058681810,28,2038606263,-20075547
1652305127,200030,true,2057035606,28,2038606263,-18429343
1652305128,200030,true,2057035606,28,2038606263,-18429343
1652305161,200031,true,2056829923,28,2038198603,-18631320
1652305162,200034,true,2056212997,28,2038198603,-18014394
1652305233,200041,true,2054774224,28,2037791024,-16983200
1652305265,200041,true,2054774224,28,2037587266,-17186958
1652305352,200041,true,2054774224,28,2037587266,-17186958
1652305466,200043,true,2054363330,28,2037587266,-16776064
1652305577,200049,true,2053131144,28,2037994804,-15136340
1652305615,200048,true,2053336457,28,2037994804,-15341653
1652305631,200048,true,2053336457,28,2037994804,-15341653
1652305653,200050,true,2052925851,28,2037994804,-14931047
1652305716,200057,true,2051489378,28,2037791024,-13698354
1652305907,200056,true,2051694527,28,2037587266,-14107261
1652305917,200055,true,2051899696,28,2037587266,-14312430
1652305934,200057,true,2051489378,28,2037587266,-13902112
1652305937,200063,true,2050258915,28,2037791024,-12467891
1652305967,200061,true,2050668987,28,2037994804,-12674183
1652305994,200059,true,2051079141,28,2038402423,-12676718
1652306017,200061,true,2050668987,28,2038810124,-11858863
1652306130,200068,true,2049234093,28,2041053937,-8180156
1652306231,200065,true,2049848924,28,2044322073,-5526851
1652306271,200064,true,2050053909,28,2045753528,-4300381
1652306341,200066,true,2049643960,28,2048414604,-1229356
1652306547,200073,true,2048209783,28,2054157915,5948132
1652306553,200071,true,2048619445,28,2054363330,5743885
1652306694,200070,true,2048824307,28,2058064329,9240022
1652306747,200072,true,2048414604,28,2059299477,10884873
1652306802,200079,true,2046981287,28,2060535365,13554078
1652306845,200077,true,2047390704,28,2061565839,14175135
1652306846,200076,true,2047595443,28,2061565839,13970396
1652306865,200077,true,2047390704,28,2062184371,14793667
1652306879,200083,true,2046162699,28,2062596828,16434129
1652307027,200080,true,2046776609,28,2066725943,19949334
1652307049,200077,true,2047390704,28,2067552757,20162053
1652307061,200076,true,2047595443,28,2067966289,20370846
1652307139,200079,true,2046981287,28,2070656258,23674971
1652307199,200072,true,2048414604,28,2072520595,24105991
1652307266,200069,true,2049029190,28,2074386609,25357419
1652307300,200069,true,2049029190,28,2075216489,26187299
1652307351,200070,true,2048824307,28,2076046700,27222393
1652307368,200063,true,2050258915,28,2076461930,26203015
1652307406,200061,true,2050668987,28,2077084931,26415944
1652307417,200060,true,2050874054,28,2077292639,26418585
1652307420,200061,true,2050668987,28,2077500368,26831381
1652307436,200054,true,2052104886,28,2077708118,25603232
1652307572,200051,true,2052720579,28,2079578804,26858225
1652307624,200050,true,2052925851,28,2080410760,27484909
1652307701,200050,true,2052925851,28,2081659319,28733468
1652307725,200042,true,2054568767,28,2081867485,27298718
1652307745,200039,true,2055185199,28,2082283879,27098680
1652307761,200037,true,2055596257,28,2082283879,26687622
1652307773,200039,true,2055185199,28,2082492107,27306908
1652307808,200035,true,2056007396,28,2082700357,26692961
1652307844,200034,true,2056212997,28,2083116917,26903920
1652308074,200033,true,2056418618,28,2085409492,28990874
1652308078,200035,true,2056007396,28,2085409492,29402096
1652308117,200031,true,2056829923,28,2085826595,28996672
1652308124,200029,true,2057241309,28,2085826595,28585286
1652308216,200029,true,2057241309,28,2086661051,29419742
1652308224,200031,true,2056829923,28,2086661051,29831128
1652308248,200026,true,2057858543,28,2086869717,29011174
1652308249,200024,true,2058270136,28,2086869717,28599581
1652308267,200024,true,2058270136,28,2086869717,28599581
1652308311,200026,true,2057858543,28,2086869717,29011174
1652308331,200022,true,2058681810,28,2086869717,28187907
1652308370,200020,true,2059093567,28,2086661051,27567484
1652308427,200021,true,2058887678,28,2086452405,27564727
1652308481,200023,true,2058475963,28,2086035178,27559215
1652308512,200019,true,2059299477,28,2085826595,26527118
1652308630,200018,true,2059505406,28,2084992473,25487067
1652308697,200018,true,2059505406,28,2084158684,24653278
1652308727,200021,true,2058887678,28,2083533562,24645884
1652308729,200017,true,2059711357,28,2083533562,23822205
1652308733,200016,true,2059917328,28,2083533562,23616234
1652308869,200018,true,2059505406,28,2079994740,20489334
1652308879,200021,true,2058887678,28,2079786762,20899084
1652308904,200017,true,2059711357,28,2078955055,19243698
1652308919,200016,true,2059917328,28,2078539326,18621998
1652308923,200020,true,2059093567,28,2078331493,19237926
1652308934,200023,true,2058475963,28,2077915889,19439926
1652309058,200018,true,2059505406,28,2074801507,15296101
1652309084,200017,true,2059711357,28,2074179191,14467834
1652309101,200020,true,2059093567,28,2073764418,14670851
1652309248,200022,true,2058681810,28,2070449213,11767403
1652309250,200017,true,2059711357,28,2070449213,10737856
1652309289,200016,true,2059917328,28,2069828203,9910875
1652309445,200018,true,2059505406,28,2066519291,7013885
1652309560,200017,true,2059711357,28,2064041079,4329722
1652309597,200012,true,2060741419,28,2063421991,2680572
1652309627,200010,true,2061153588,28,2062803088,1649500
1652309642,200010,true,2061153588,28,2062596828,1443240
1652309665,200008,true,2061565839,28,2062184371,618532
1652309703,200002,true,2062803088,28,2061565839,-1237249
1652309719,200000,true,2063215669,28,2061565839,-1649830
1652309995,199999,true,2063421991,28,2059299477,-4122514
1652310046,199997,true,2063834696,28,2059093567,-4741129
1652310150,199993,true,2064660353,28,2059299477,-5360876
1652310171,199992,true,2064866819,28,2059299477,-5567342
1652310177,199992,true,2064866819,28,2059299477,-5567342
1652310178,199991,true,2065073306,28,2059299477,-5773829
1652310202,199987,true,2065899459,28,2059299477,-6599982
1652310218,199986,true,2066106049,28,2059505406,-6600643
1652310242,199985,true,2066312660,28,2059711357,-6601303
1652310247,199983,true,2066725943,28,2059711357,-7014586
1652310276,199979,true,2067552757,28,2059917328,-7635429
1652310305,199977,true,2067966289,28,2060329332,-7636957
1652310328,199976,true,2068173085,28,2060535365,-7637720
1652310452,199975,true,2068379903,28,2061771996,-6607907
1652310453,199970,true,2069414299,28,2061771996,-7642303
1652310506,199969,true,2069621241,28,2062390589,-7230652
1652310518,199967,true,2070035186,28,2062803088,-7232098
1652310607,199964,true,2070656258,28,2064866819,-5789439
1652310625,199960,true,2071484645,28,2065486341,-5998304
1652310675,199959,true,2071691794,28,2066519291,-5172503
1652310714,199957,true,2072106153,28,2067346023,-4760130
1652310729,199955,true,2072520595,28,2067759513,-4761082
1652310784,199952,true,2073142413,28,2068586741,-4555672
1652310804,199951,true,2073349727,28,2068793599,-4556128
1652310826,199951,true,2073349727,28,2069207379,-4142348
1652310855,199950,true,2073557062,28,2069621241,-3935821
1652310884,199946,true,2074386609,28,2070035186,-4351423
1652310960,199946,true,2074386609,28,2071691794,-2694815
1652311043,199947,true,2074179191,28,2072727847,-1451344
1652311054,199946,true,2074386609,28,2072727847,-1658762
1652311075,199943,true,2075008988,28,2072935119,-2073869
1652311083,199944,true,2074801507,28,2072935119,-1866388
1652311149,199947,true,2074179191,28,2073557062,-622129
1652311156,199946,true,2074386609,28,2073557062,-829547
1652311216,199945,true,2074594048,28,2073764418,-829630
1652311218,199947,true,2074179191,28,2073764418,-414773
1652311301,199950,true,2073557062,28,2073971794,414732
1652311320,199950,true,2073557062,28,2074179191,622129
1652311380,199949,true,2073764418,28,2074386609,622191
1652311505,199950,true,2073557062,28,2074179191,622129
1652311536,199953,true,2072935119,28,2073764418,829299
1652311621,199953,true,2072935119,28,2072520595,-414524
1652312008,199952,true,2073142413,28,2067552757,-5589656
1652312027,199953,true,2072935119,28,2067552757,-5382362
1652312044,199956,true,2072313363,28,2067346023,-4967340
1652312197,199955,true,2072520595,28,2066519291,-6001304
1652312305,199954,true,2072727847,28,2065486341,-7241506
1652312352,199955,true,2072520595,28,2064453908,-8066687
1652312362,199958,true,2071898963,28,2064247483,-7651480
1652312375,199958,true,2071898963,28,2063834696,-8064267
1652312380,199959,true,2071691794,28,2063834696,-7857098
1652312389,199961,true,2071277517,28,2063628333,-7649184
1652312448,199964,true,2070656258,28,2062596828,-8059430
1652312454,199964,true,2070656258,28,2062390589,-8265669
1652312527,199966,true,2070242189,28,2061565839,-8676350
1652312532,199968,true,2069828203,28,2061359703,-8468500
1652312570,199970,true,2069414299,28,2061153588,-8260711
1652312675,199969,true,2069621241,28,2060741419,-8879822
1652312688,199970,true,2069414299,28,2060535365,-8878934
1652313003,199971,true,2069207379,28,2062184371,-7023008
1652313032,199972,true,2069000479,28,2062390589,-6609890
1652313184,199972,true,2069000479,28,2063628333,-5372146
1652313213,199972,true,2069000479,28,2063834696,-5165783
1652313285,199973,true,2068793599,28,2064453908,-4339691
1652313359,199974,true,2068586741,28,2065073306,-3513435
1652313389,199973,true,2068793599,28,2065486341,-3307258
1652313418,199974,true,2068586741,28,2065692890,-2893851
1652313427,199976,true,2068173085,28,2065692890,-2480195
1652313506,199977,true,2067966289,28,2066312660,-1653629
1652313592,199977,true,2067966289,28,2067139309,-826980
1652313618,199977,true,2067966289,28,2067346023,-620266
1652313637,199979,true,2067552757,28,2067552757,0
1652313674,199981,true,2067139309,28,2067966289,826980
1652313687,199980,true,2067346023,28,2068173085,827062
1652313768,199980,true,2067346023,28,2069621241,2275218
1652313779,199981,true,2067139309,28,2069828203,2688894
1652313802,199982,true,2066932616,28,2070242189,3309573
1652313875,199981,true,2067139309,28,2070863324,3724015
1652313939,199981,true,2067139309,28,2071070410,3931101
1652314048,199983,true,2066725943,28,2071898963,5173020
1652314143,199983,true,2066725943,28,2072727847,6001904
1652314255,199981,true,2067139309,28,2074386609,7247300
1652314324,199981,true,2067139309,28,2075216489,8077180
1652314334,199982,true,2066932616,28,2075216489,8283873
1652314348,199980,true,2067346023,28,2075424010,8077987
1652314411,199978,true,2067759513,28,2076046700,8287187
1652314472,199976,true,2068173085,28,2076877243,8704158
1652314480,199976,true,2068173085,28,2077084931,8911846
1652314493,199974,true,2068586741,28,2077084931,8498190
1652314503,199971,true,2069207379,28,2077292639,8085260
1652314530,199968,true,2069828203,28,2077708118,7879915
1652314580,199968,true,2069828203,28,2078539326,8711123
1652314590,199965,true,2070449213,28,2078747180,8297967
1652314605,199961,true,2071277517,28,2079162950,7885433
1652314636,199958,true,2071898963,28,2079786762,7887799
1652314660,199957,true,2072106153,28,2080202740,8096587
1652314695,199954,true,2072727847,28,2080826863,8099016
1652314700,199950,true,2073557062,28,2080826863,7269801
1652314722,199949,true,2073764418,28,2081034946,7270528
1652314734,199948,true,2073971794,28,2081243049,7271255
1652314768,199946,true,2074386609,28,2081451174,7064565
1652314803,199942,true,2075216489,28,2081867485,6650996
1652314881,199941,true,2075424010,28,2082908627,7484617
1652314943,199940,true,2075631553,28,2083950289,8318736
1652314958,199938,true,2076046700,28,2084158684,8111984
1652314986,199934,true,2076877243,28,2084783994,7906751
1652315018,199931,true,2077500368,28,2085200972,7700604
1652315098,199929,true,2077915889,28,2087287112,9371223
1652315150,199927,true,2078331493,28,2088748651,10417158
1652315191,199923,true,2079162950,28,2089793234,10630284
1652315205,199921,true,2079578804,28,2090420235,10841431
1652315369,199919,true,2079994740,28,2095862127,15867387
1652315438,199918,true,2080202740,28,2098168728,17965988
1652315554,199915,true,2080826863,28,2100897985,20071122
1652315560,199913,true,2081243049,28,2101108075,19865026
1652315626,199910,true,2081867485,28,2102789549,20922064
1652315763,199909,true,2082075671,28,2107209826,25134155
1652315766,199905,true,2082908627,28,2107209826,24301199
1652315774,199902,true,2083533562,28,2107420547,23886985
1652315993,199899,true,2084158684,28,2114809072,30650388
1652316023,199898,true,2084367100,28,2115866688,31499588
1652316078,199894,true,2085200972,28,2117559974,32359002
1652316219,199891,true,2085826595,28,2122011300,36184705
1652316224,199888,true,2086452405,28,2122223501,35771096
1652316240,199887,true,2086661051,28,2122647967,35986916
1652316260,199882,true,2087704590,28,2123284825,35580235
1652316296,199878,true,2088539797,28,2124346679,35806882
1652316307,199875,true,2089166422,28,2124771570,35605148
1652316373,199874,true,2089375338,28,2126684630,37309292
1652316418,199871,true,2090002214,28,2127748185,37745971
1652316456,199867,true,2090838340,28,2128812271,37973931
1652316532,199865,true,2091256528,28,2130728969,39472441
1652316618,199864,true,2091465654,28,2133500579,42034925
1652316660,199860,true,2092302366,28,2134994478,42692112
1652316670,199855,true,2093348726,28,2135207977,41859251
1652316720,199852,true,2093976794,28,2136916742,42939948
1652316952,199851,true,2094186191,28,2142693924,48507733
1652316959,199847,true,2095023991,28,2142908193,47884202
1652316989,199842,true,2096071713,28,2143336796,47265083
1652317025,199840,true,2096490948,28,2144194259,47703311
1652317047,199837,true,2097119959,28,2144408679,47288720
1652317095,199834,true,2097749157,28,2145052066,47302909
1652317227,199829,true,2098798242,28,2146554053,47755811
1652317272,199826,true,2099427944,28,2146983385,47555441
1652317280,199822,true,2100267841,28,2146983385,46715544
1652317289,199819,true,2100897985,28,2147198083,46300098
1652317352,199814,true,2101948644,28,2147627544,45678900
1652317389,199811,true,2102579291,28,2148057091,45477800
1652317671,199806,true,2103630791,28,2150206115,46575324
1652317797,199803,true,2104261944,28,2150851242,46589298
1652317852,199799,true,2105103775,28,2151066327,45962552
1652317943,199795,true,2105945943,28,2151281434,45335491
1652317964,199791,true,2106788447,28,2151281434,44492987
1652318003,199788,true,2107420547,28,2151281434,43860887
1652318024,199783,true,2108474468,28,2151281434,42806966
1652318061,199781,true,2108896184,28,2150851242,41955058
1652318313,199777,true,2109739869,28,2148271897,38532028
1652318335,199774,true,2110372854,28,2148057091,37684237
1652318426,199771,true,2111006030,28,2147198083,36192053
1652318438,199769,true,2111428252,28,2146983385,35555133
1652318550,199765,true,2112272950,28,2145052066,32779116
1652318621,199762,true,2112906695,28,2143979861,31073166
1652318639,199759,true,2113540631,28,2143551130,30010499
1652318644,199755,true,2114386174,28,2143336796,28950622
1652318677,199754,true,2114597612,28,2142693924,28096312
1652318734,199752,true,2115020553,28,2141194638,26174085
1652318748,199749,true,2115655123,28,2140980540,25325417
1652318783,199745,true,2116501512,28,2140124361,23622849
1652318882,199744,true,2116713162,28,2138199212,21486050
1652318889,199743,true,2116924833,28,2137985414,21060581
1652319087,199741,true,2117348239,28,2134781000,17432761
1652319249,199738,true,2117983507,28,2132647392,14663885
1652319291,199737,true,2118195305,28,2131794547,13599242
1652319392,199736,true,2118407125,28,2130089878,11682753
1652319659,199734,true,2118830828,28,2124984047,6153219
1652319727,199731,true,2119466540,28,2123921874,4455334
1652319782,199730,true,2119678487,28,2123072517,3394030
1652319888,199728,true,2120102444,28,2121799120,1696676
1652319917,199726,true,2120526486,28,2121586961,1060475
1652319996,199722,true,2121374823,28,2121162707,-212116
1652320078,199721,true,2121586961,28,2120738538,-848423
1652320144,199719,true,2122011300,28,2120526486,-1484814
1652320265,199716,true,2122647967,28,2120314454,-2333513
1652320280,199712,true,2123497153,28,2120314454,-3182699
1652320366,199711,true,2123709503,28,2120102444,-3607059
1652320415,199710,true,2123921874,28,2119678487,-4243387
1652320516,199710,true,2123921874,28,2119254615,-4667259
1652320534,199706,true,2124771570,28,2119254615,-5516955
1652320547,199706,true,2124771570,28,2119254615,-5516955
1652320611,199706,true,2124771570,28,2118618966,-6152604
1652320626,199705,true,2124984047,28,2118618966,-6365081
1652320721,199703,true,2125409065,28,2117136525,-8272540
1652320746,199703,true,2125409065,28,2116713162,-8695903
1652320815,199703,true,2125409065,28,2115866688,-9542377
1652320849,199703,true,2125409065,28,2115232055,-10177010
1652320891,199701,true,2125834168,28,2114597612,-11236556
1652320903,199701,true,2125834168,28,2114174756,-11659412
1652320949,199703,true,2125409065,28,2113329298,-12079767
1652321030,199704,true,2125196546,28,2111639395,-13557151
1652321040,199703,true,2125409065,28,2111428252,-13980813
1652321056,199703,true,2125409065,28,2111006030,-14403035
1652321085,199705,true,2124984047,28,2110583892,-14400155
1652321098,199707,true,2124559114,28,2110372854,-14186260
1652321121,199705,true,2124984047,28,2109950843,-15033204
1652321175,199706,true,2124771570,28,2109317984,-15453586
1652321211,199708,true,2124346679,28,2108896184,-15450495
1652321239,199710,true,2123921874,28,2108474468,-15447406
1652321269,199708,true,2124346679,28,2108263642,-16083037
1652321311,199708,true,2124346679,28,2107842052,-16504627
1652321402,199711,true,2123709503,28,2106577790,-17131713
1652321432,199712,true,2123497153,28,2106156537,-17340616
1652321465,199710,true,2123921874,28,2105524817,-18397057
1652321474,199710,true,2123921874,28,2105314285,-18607589
1652321575,199712,true,2123497153,28,2104051539,-19445614
1652321581,199713,true,2123284825,28,2103841154,-19443671
1652321637,199711,true,2123709503,28,2103210128,-20499375
1652321643,199711,true,2123709503,28,2102999828,-20709675
1652321688,199713,true,2123284825,28,2102369055,-20915770
1652321699,199715,true,2122860231,28,2102158839,-20701392
1652321710,199715,true,2122860231,28,2101948644,-20911587
1652321742,199714,true,2123072517,28,2101528317,-21544200
1652321744,199717,true,2122435723,28,2101528317,-20907406
1652321816,199718,true,2122223501,28,2100897985,-21325516
1652321834,199719,true,2122011300,28,2100687916,-21323384
1652321879,199718,true,2122223501,28,2100057836,-22165665
1652321925,199720,true,2121799120,28,2099427944,-22371176
1652321964,199722,true,2121374823,28,2099008122,-22366701
1652321977,199723,true,2121162707,28,2098798242,-22364465
1652322051,199723,true,2121162707,28,2097329670,-23833037
1652322191,199726,true,2120526486,28,2095652562,-24873924
1652322199,199728,true,2120102444,28,2095652562,-24449882
1652322208,199729,true,2119890455,28,2095443017,-24447438
1652322311,199730,true,2119678487,28,2094395610,-25282877
1652322390,199734,true,2118830828,28,2093558061,-25272767
1652322492,199736,true,2118407125,28,2093139412,-25267713
1652322585,199738,true,2117983507,28,2092930119,-25053388
1652322650,199739,true,2117771730,28,2092511596,-25260134
1652322681,199744,true,2116713162,28,2092511596,-24201566
1652322921,199748,true,2115866688,28,2091465654,-24401034
1652322930,199751,true,2115232055,28,2091256528,-23975527
1652322931,199753,true,2114809072,28,2091256528,-23552544
1652323010,199757,true,2113963360,28,2090838340,-23125020
1652323104,199763,true,2112695426,28,2089166422,-23529004
1652323150,199765,true,2112272950,28,2088539797,-23733153
1652323233,199767,true,2111850559,28,2087287112,-24563447
1652323310,199773,true,2110583892,28,2085826595,-24757297
1652323410,199779,true,2109317984,28,2083741915,-25576069
1652323458,199782,true,2108685316,28,2082700357,-25984959
1652323576,199785,true,2108052837,28,2079370867,-28681970
1652323709,199791,true,2106788447,28,2075008988,-31779459
1652323741,199797,true,2105524817,28,2073971794,-31553023
1652323879,199800,true,2104893285,28,2070242189,-34651096
1652323987,199804,true,2104051539,28,2067139309,-36912230
1652324044,199809,true,2102999828,28,2065692890,-37306938
1652324455,199816,true,2101528317,28,2055596257,-45932060
1652324499,199818,true,2101108075,28,2054568767,-46539308
1652324545,199822,true,2100267841,28,2053747145,-46520696
1652324687,199827,true,2099218022,28,2051694527,-47523495
1652324706,199832,true,2098168728,28,2051284249,-46884479
1652324726,199835,true,2097539403,28,2050874054,-46665349
1652324727,199839,true,2096700597,28,2050874054,-45826543
1652324789,199845,true,2095443017,28,2049439016,-46004001
1652324862,199851,true,2094186191,28,2048209783,-45976408
1652324940,199854,true,2093558061,28,2046981287,-46576774
1652324942,199858,true,2092720847,28,2046981287,-45739560
1652324971,199864,true,2091465654,28,2046367316,-45098338
1652325017,199870,true,2090211214,28,2045548973,-44662241
1652325075,199873,true,2089584276,28,2044730958,-44853318
1652325183,199876,true,2088957526,28,2043095909,-45861617
1652325214,199883,true,2087495840,28,2042483103,-45012737
1652325265,199889,true,2086243781,28,2041870481,-44373300
1652325283,199892,true,2085618033,28,2041666314,-43951719
1652325299,199894,true,2085200972,28,2041258042,-43942930
1652325340,199901,true,2083741915,28,2040645787,-43096128
1652325341,199907,true,2082492107,28,2040645787,-41846320
1652325351,199910,true,2081867485,28,2040645787,-41221698
1652325359,199912,true,2081451174,28,2040441743,-41009431
1652325406,199918,true,2080202740,28,2039625770,-40576970
1652325449,199924,true,2078955055,28,2039014005,-39941050
1652325514,199927,true,2078331493,28,2037994804,-40336689
1652325567,199929,true,2077915889,28,2037179809,-40736080
1652325575,199935,true,2076669576,28,2037179809,-39489767
1652325592,199940,true,2075631553,28,2036772434,-38859119
1652325618,199943,true,2075008988,28,2036365141,-38643847
1652325635,199946,true,2074386609,28,2036161525,-38225084
1652325684,199952,true,2073142413,28,2035143750,-37998663
1652325783,199958,true,2071898963,28,2033516367,-38382596
1652325819,199960,true,2071484645,28,2032906434,-38578211
1652325835,199963,true,2070863324,28,2032499914,-38363410
1652325858,199970,true,2069414299,28,2032093475,-37320824
1652325869,199976,true,2068173085,28,2031890286,-36282799
1652325900,199979,true,2067552757,28,2031280840,-36271917
1652325914,199983,true,2066725943,28,2031077733,-35648210
1652325922,199990,true,2065279813,28,2030874645,-34405168
1652325927,199997,true,2063834696,28,2030671578,-33163118
1652326107,200000,true,2063215669,28,2027019839,-36195830
1652326154,200004,true,2062390589,28,2026006633,-36383956
1652326165,200010,true,2061153588,28,2025601493,-35552095
1652326200,200016,true,2059917328,28,2024791455,-35125873
1652326243,200020,true,2059093567,28,2023577005,-35516562
1652326257,200024,true,2058270136,28,2023172350,-35097786
1652326276,200030,true,2057035606,28,2022767777,-34267829
1652326300,200035,true,2056007396,28,2022161068,-33846328
1652326336,200038,true,2055390717,28,2021352405,-34038312
1652326345,200041,true,2054774224,28,2021150290,-33623934
1652326368,200046,true,2053747145,28,2020544066,-33203079
1652326388,200050,true,2052925851,28,2020140018,-32785833
1652326426,200052,true,2052515327,28,2019534097,-32981230
1652326548,200054,true,2052104886,28,2017717425,-34387461
1652326552,200058,true,2051284249,28,2017717425,-33566824
1652326595,200062,true,2050463941,28,2017112231,-33351710
1652326608,200063,true,2050258915,28,2017112231,-33146684
1652326650,200065,true,2049848924,28,2016507218,-33341706
1652326672,200070,true,2048824307,28,2016305588,-32518719
1652326695,200074,true,2048004982,28,2015902387,-32102595
1652326967,200077,true,2047390704,28,2012277208,-35113496
1652327072,200080,true,2046776609,28,2011070264,-35706345
1652327110,200085,true,2045753528,28,2010869177,-34884351
1652327130,200090,true,2044730958,28,2010869177,-33861781
1652327280,200091,true,2044526505,28,2010467063,-34059442
1652327490,200094,true,2043913270,28,2009261205,-34652065
1652327495,200099,true,2042891620,28,2009261205,-33630415
1652327507,200103,true,2042074668,28,2009261205,-32813463
1652327533,200105,true,2041666314,28,2009060299,-32606015
1652327587,200109,true,2040849852,28,2008658547,-32191305
1652327599,200113,true,2040033716,28,2008658547,-31375169
1652327624,200118,true,2039014005,28,2008457702,-30556303
1652327689,200121,true,2038402423,28,2007654519,-30747904
1652327750,200126,true,2037383527,28,2007253049,-30130478
1652327826,200131,true,2036365141,28,2006249723,-30115418
1652327917,200137,true,2035143750,28,2005046395,-30097355
1652327930,200140,true,2034533329,28,2004845910,-29687419
1652327937,200146,true,2033313036,28,2004645445,-28667591
1652327986,200153,true,2031890286,28,2003643423,-28246863
1652327997,200160,true,2030468531,28,2003443079,-27025452
1652328041,200164,true,2029656547,28,2002842166,-26814381
1652328113,200170,true,2028439179,28,2001640882,-26798297
1652328144,200177,true,2027019839,28,2001040509,-25979330
1652328148,200185,true,2025398953,28,2000840425,-24558528
1652328154,200188,true,2024791455,28,2000640361,-24151094
1652328171,200194,true,2023577005,28,2000240293,-23336712
1652328196,200201,true,2022161068,28,1999640341,-22520727
1652328220,200211,true,2020140018,28,1998241153,-21898865
1652328238,200215,true,2019332164,28,1997641800,-21690364
1652328245,200221,true,2018120989,28,1997242332,-20878657
1652328282,200227,true,2016910540,28,1996044406,-20866134
1652328299,200235,true,2015297737,28,1995445712,-19852025
1652328336,200239,true,2014491820,28,1994049459,-20442361
1652328365,200244,true,2013484876,28,1993052733,-20432143
1652328390,200250,true,2012277208,28,1992255711,-20021497
1652328398,200258,true,2010668110,28,1992056505,-18611605
1652328428,200261,true,2010065030,28,1990861690,-19203340
1652328517,200267,true,2008859413,28,1987877785,-20981628
1652328593,200273,true,2007654519,28,1985493881,-22160638
1652328611,200279,true,2006450348,28,1984898352,-21551996
1652328613,200283,true,2005647969,28,1984699882,-20948087
1652328632,200288,true,2004645445,28,1984104591,-20540854
1652328647,200294,true,2003443079,28,1983509479,-19933600
1652328692,200300,true,2002241434,28,1981923385,-20318049
1652328696,200303,true,2001640882,28,1981725213,-19915669
1652328723,200309,true,2000440317,28,1980536594,-19903723
1652328724,200315,true,1999240473,28,1980536594,-18703879
1652328774,200321,true,1998041348,28,1978557146,-19484202
1652328850,200324,true,1997442056,28,1975394144,-22047912
1652328860,200329,true,1996443634,28,1974999124,-21444510
1652328867,200335,true,1995246187,28,1974801644,-20444543
1652328878,200342,true,1993850074,28,1974209322,-19640752
1652328911,200347,true,1992853448,28,1972433422,-20420026
1652328913,200353,true,1991658154,28,1972236198,-19421956
1652328930,200359,true,1990463577,28,1971250376,-19213201
1652328932,200366,true,1989070810,28,1971250376,-17820434
1652328964,200369,true,1988474208,28,1969674085,-18800123
1652328998,200374,true,1987480269,28,1968295864,-19184405
1652329043,200379,true,1986486827,28,1966132037,-20354790
1652329044,200385,true,1985295352,28,1965935444,-19359908
1652329068,200388,true,1984699882,28,1964756295,-19943587
1652329084,200394,true,1983509479,28,1963970589,-19538890
1652329089,200399,true,1982518022,28,1963774212,-18743810
1652329142,200405,true,1981328927,28,1961026989,-20301938
1652329195,200409,true,1980536594,28,1957892011,-22644583
1652329217,200415,true,1979348688,28,1956522035,-22826653
1652329251,200420,true,1978359310,28,1954566588,-23792722
1652329266,200427,true,1976975012,28,1953784957,-23190055
1652329277,200431,true,1976184420,28,1953003638,-23180782
1652329318,200438,true,1974801644,28,1950271483,-24530161
1652329346,200444,true,1973617178,28,1948517116,-25100062
1652329406,200452,true,1972038994,28,1944818633,-27220361
1652329420,200456,true,1971250376,28,1943846515,-27403861
1652329466,200465,true,1969477137,28,1939962901,-29514236
1652329494,200472,true,1968099054,28,1937830222,-30268832
1652329508,200482,true,1966132037,28,1936667931,-29464106
1652329557,200487,true,1965149266,28,1932798659,-32350607
1652329580,200498,true,1962988898,28,1930673855,-32315043
1652329606,200506,true,1961419214,28,1928551388,-32867826
1652329622,200516,true,1959458873,28,1927394662,-32064211
1652329638,200522,true,1958283609,28,1926238630,-32044979
1652329653,200530,true,1956717687,28,1925083291,-31634396
1652329672,200536,true,1955544067,28,1923928645,-31615422
1652329696,200549,true,1953003638,28,1921621431,-31382207
1652329704,200554,true,1952027429,28,1921045060,-30982369
1652329720,200560,true,1950856623,28,1920468861,-30387762
1652329722,200565,true,1949881487,28,1920276834,-29604653
1652329749,200569,true,1949101729,28,1919316983,-29784746
1652329864,200574,true,1948127471,28,1915099338,-33028133
1652329878,200579,true,1947153699,28,1914716375,-32437324
1652329917,200584,true,1946180414,28,1913567947,-32612467
1652329935,200588,true,1945402137,28,1912993992,-32408145
1652329980,200591,true,1944818633,28,1911846597,-32972036
1652330001,200596,true,1943846515,28,1911464285,-32382230
1652330054,200600,true,1943069171,28,1910890961,-32178210
1652330083,200603,true,1942486367,28,1910508840,-31977527
1652330086,200605,true,1942097928,28,1910317808,-31780120
1652330137,200610,true,1941127170,28,1909172018,-31955152
1652330142,200615,true,1940156898,28,1908981120,-31175778
1652330165,200616,true,1939962901,28,1909172018,-30790883
1652330168,200618,true,1939574967,28,1908981120,-30593847
1652330186,200620,true,1939187110,28,1908790241,-30396869
1652330211,200626,true,1938024005,28,1908599381,-29424624
1652330222,200630,true,1937248989,28,1908599381,-28649608
1652330234,200633,true,1936667931,28,1908408540,-28259391
1652330254,200636,true,1936087046,28,1908026916,-28060130
1652330316,200643,true,1934732327,28,1907263896,-27468431
1652330341,200646,true,1934152024,28,1906882500,-27269524
1652330370,200650,true,1933378556,28,1906310550,-27068006
1652330440,200654,true,1932605398,28,1904976666,-27628732
1652330483,200661,true,1931253115,28,1904405287,-26847828
1652330518,200665,true,1930480807,28,1904024463,-26456344
1652330528,200668,true,1929901779,28,1903834080,-26067699
1652330567,200670,true,1929515856,28,1903834080,-25681776
1652330597,200677,true,1928165735,28,1903643716,-24522019
1652330637,200680,true,1927587401,28,1903263044,-24324357
1652330638,200684,true,1926816559,28,1903263044,-23553515
1652330691,200688,true,1926046025,28,1903072737,-22973288
1652330715,200694,true,1924890802,28,1903072737,-21818065
1652330762,200697,true,1924313450,28,1903072737,-21240713
1652330783,200700,true,1923736271,28,1902882449,-20853822
1652330819,200703,true,1923159266,28,1902501929,-20657337
1652330853,200711,true,1921621431,28,1901741119,-19880312
1652330909,200715,true,1920852974,28,1900790533,-20062441
1652330926,200719,true,1920084825,28,1900600473,-19484352
1652330959,200722,true,1919508915,28,1900030407,-19478508
1652330980,200729,true,1918165796,28,1899840423,-18325373
1652331006,200735,true,1917015299,28,1899460512,-17554787
1652331016,200738,true,1916440310,28,1899270585,-17169725
1652331042,200741,true,1915865492,28,1899080677,-16784815
1652331126,200749,true,1914333489,28,1897562096,-16771393
1652331131,200753,true,1913567947,28,1897372358,-16195589
1652331144,200757,true,1912802712,28,1897372358,-15430354
1652331183,200759,true,1912420208,28,1896992941,-15427267
1652331191,200766,true,1911082050,28,1896992941,-14089109
1652331200,200770,true,1910317808,28,1896803261,-13514547
1652331220,200773,true,1909744827,28,1896803261,-12941566
1652331230,200776,true,1909172018,28,1896992941,-12179077
1652331278,200782,true,1908026916,28,1897941627,-10085289
1652331309,200783,true,1907836132,28,1898700918,-9135214
1652331320,200785,true,1907454622,28,1898890788,-8563834
1652331383,200786,true,1907263896,28,1900980612,-6283284
1652331398,200791,true,1906310550,28,1901550963,-4759587
1652331400,200793,true,1905929345,28,1901550963,-4378382
1652331501,200797,true,1905167164,28,1903834080,-1333084
1652331526,200799,true,1904786188,28,1903643716,-1142472
1652331564,200804,true,1903834080,28,1903263044,-571036
1652331612,200807,true,1903263044,28,1902692179,-570865
1652331635,200810,true,1902692179,28,1902501929,-190250
1652331727,200812,true,1902311698,28,1900980612,-1331086
1652331749,200817,true,1901360827,28,1900600473,-760354
1652331753,200819,true,1900980612,28,1900410432,-570180
1652331759,200823,true,1900220410,28,1900220410,0
1652331764,200825,true,1899840423,28,1900220410,379987
1652331796,200829,true,1899080677,28,1899460512,379835
1652331813,200831,true,1898700918,28,1899080677,379759
1652331844,200835,true,1897941627,28,1897941627,0
1652331864,200837,true,1897562096,28,1897372358,-189738
1652331882,200842,true,1896613599,28,1896803261,189662
1652331935,200843,true,1896423957,28,1895476029,-947928
1652331946,200848,true,1895476029,28,1895096991,-379038
1652331972,200850,true,1895096991,28,1893770953,-1326038
1652332040,200855,true,1894149727,28,1891121662,-3028065
1652332090,200858,true,1893581595,28,1889042675,-4538920
1652332115,200860,true,1893202936,28,1888098437,-5104499
1652332126,200861,true,1893013634,28,1887532121,-5481513
1652332178,200868,true,1891689055,28,1885457081,-6231974
1652332186,200870,true,1891310774,28,1885268554,-6042220
1652332228,200875,true,1890365402,28,1883572660,-6792742
1652332239,200878,true,1889798406,28,1883196002,-6602404
1652332252,200886,true,1888287247,28,1882631157,-5656090
1652332288,200889,true,1887720874,28,1880749560,-6971314
1652332328,200893,true,1886965975,28,1879433562,-7532413
1652332338,200895,true,1886588638,28,1878869845,-7718793
1652332357,200902,true,1885268554,28,1877930692,-7337862
1652332363,200903,true,1885080046,28,1877555162,-7524884
1652332434,200909,true,1883949394,28,1873616630,-10332764
1652332483,200912,true,1883384322,28,1870808452,-12575870
1652332496,200920,true,1881878292,28,1869873328,-12004964
1652332552,200921,true,1881690123,28,1866324119,-15366004
1652332611,200929,true,1880185448,28,1862409146,-17776302
1652332625,200930,true,1879997449,28,1861664369,-18333080
1652332651,200936,true,1878869845,28,1860919889,-17949956
1652332660,200936,true,1878869845,28,1860547761,-18322084
1652332680,200940,true,1878118485,28,1859989709,-18128776
1652332708,200939,true,1878306297,28,1859059993,-19246304
1652332765,200943,true,1877555162,28,1857201955,-20353207
1652332768,200940,true,1878118485,28,1857201955,-20916530
1652332827,200942,true,1877742917,28,1856273632,-21469285
1652332830,200939,true,1878306297,28,1856273632,-22032665
1652332836,200941,true,1877930692,28,1856088023,-21842669
1652332841,200938,true,1878494127,28,1856088023,-22406104
1652332847,200939,true,1878306297,28,1855902433,-22403864
1652332855,200939,true,1878306297,28,1855902433,-22403864
1652332913,200942,true,1877742917,28,1855531308,-22211609
1652332934,200937,true,1878681977,28,1855160258,-23521719
1652332939,200938,true,1878494127,28,1855160258,-23333869
1652332957,200941,true,1877930692,28,1854789281,-23141411
1652332980,200945,true,1877179707,28,1854232956,-22946751
1652332993,200948,true,1876616666,28,1853862165,-22754501
1652333042,200952,true,1875866207,28,1852564980,-23301227
1652333089,200953,true,1875678639,28,1851638976,-24039663
1652333123,200958,true,1874741081,28,1850713434,-24027647
1652333137,200962,true,1873991372,28,1850158331,-23833041
1652333139,200965,true,1873429287,28,1850158331,-23270956
1652333150,200967,true,1873054657,28,1849788355,-23266302
1652333162,200971,true,1872305623,28,1849603394,-22702229
1652333190,200976,true,1871369751,28,1848678870,-22690881
1652333211,200979,true,1870808452,28,1848309190,-22499262
1652333240,200980,true,1870621390,28,1847939583,-22681807
1652333268,200984,true,1869873328,28,1847385312,-22488016
1652333281,200990,true,1868751797,28,1846831207,-21920590
1652333300,200994,true,1868004483,28,1846461897,-21542586
1652333322,200999,true,1867070761,28,1846092660,-20978101
1652333328,201003,true,1866324119,28,1845908069,-20416050
1652333348,201006,true,1865764334,28,1845538943,-20225391
1652333364,201010,true,1865018215,28,1845169890,-19848325
1652333367,201014,true,1864272394,28,1845169890,-19102504
1652333399,201018,true,1863526871,28,1844616450,-18910421
1652333418,201021,true,1862967925,28,1844063176,-18904749
1652333423,201025,true,1862222924,28,1843878788,-18344136
1652333460,201028,true,1861664369,28,1843141421,-18522948
1652333533,201031,true,1861105981,28,1841851737,-19254244
1652333560,201034,true,1860547761,28,1841299292,-19248469
1652333586,201037,true,1859989709,28,1840931088,-19058621
1652333612,201042,true,1859059993,28,1840562957,-18497036
1652333621,201044,true,1858688236,28,1840562957,-18125279
1652333663,201048,true,1857944947,28,1840194899,-17750048
1652333702,201051,true,1857387675,28,1840010898,-17376777
1652333744,201053,true,1857016253,28,1840010898,-17005355
1652333798,201054,true,1856830570,28,1840562957,-16267613
1652333802,201057,true,1856273632,28,1840562957,-15710675
1652333830,201060,true,1855716862,28,1840562957,-15153905
1652333874,201063,true,1855160258,28,1840562957,-14597301
1652333932,201065,true,1854789281,28,1840747013,-14042268
1652333953,201066,true,1854603821,28,1840931088,-13672733
1652334018,201068,true,1854232956,28,1841299292,-12933664
1652334041,201070,true,1853862165,28,1841299292,-12562873
1652334060,201073,true,1853306117,28,1841483422,-11822695
1652334106,201073,true,1853306117,28,1841483422,-11822695
1652334119,201076,true,1852750237,28,1841299292,-11450945
1652334123,201079,true,1852194523,28,1841299292,-10895231
1652334138,201079,true,1852194523,28,1841115181,-11079342
1652334176,201080,true,1852009322,28,1841115181,-10894141
1652334197,201084,true,1851268703,28,1841115181,-10153522
1652334223,201087,true,1850713434,28,1841299292,-9414142
1652334238,201089,true,1850343347,28,1841299292,-9044055
1652334264,201091,true,1849973333,28,1841483422,-8489911
1652334290,201094,true,1849418452,28,1841667571,-7750881
1652334332,201095,true,1849233529,28,1842404348,-6829181
1652334368,201098,true,1848678870,28,1843141421,-5537449
1652334410,201100,true,1848309190,28,1844063176,-4246014
1652334421,201104,true,1847570051,28,1844063176,-3506875
1652334440,201107,true,1847015891,28,1843878788,-3137103
1652334476,201111,true,1846277269,28,1843878788,-2398481
1652334504,201113,true,1845908069,28,1843878788,-2029281
1652334525,201116,true,1845354407,28,1843694418,-1659989
1652334599,201120,true,1844616450,28,1842404348,-2212102
1652334636,201124,true,1843878788,28,1841483422,-2395366
1652334641,201127,true,1843325735,28,1841483422,-1842313
1652334677,201130,true,1842772848,28,1841115181,-1657667
1652334702,201132,true,1842404348,28,1840562957,-1841391
1652334722,201135,true,1841851737,28,1840378919,-1472818
1652334764,201138,true,1841299292,28,1839826916,-1472376
1652334802,201141,true,1840747013,28,1839642951,-1104062
1652334842,201144,true,1840194899,28,1839275078,-919821
1652334861,201147,true,1839642951,28,1838907278,-735673
1652334924,201151,true,1838907278,28,1837436814,-1470464
1652335004,201154,true,1838355716,28,1835233322,-3122394
1652335038,201157,true,1837804320,28,1834315981,-3488339
1652335064,201160,true,1837253089,28,1833399098,-3853991
1652335141,201166,true,1836151123,28,1831017347,-5133776
1652335166,201169,true,1835600387,28,1830285123,-5315264
1652335186,201171,true,1835233322,28,1829919121,-5314201
1652335217,201173,true,1834866331,28,1829370255,-5496076
1652335253,201174,true,1834682863,28,1829004436,-5678427
1652335271,201177,true,1834132568,28,1828638690,-5493878
1652335311,201180,true,1833582438,28,1827541890,-6040548
1652335399,201182,true,1833215777,28,1825350265,-7865512
1652335446,201183,true,1833032473,28,1824073031,-8959442
1652335489,201185,true,1832665922,28,1822978970,-9686952
1652335508,201187,true,1832299444,28,1822432185,-9867259
1652335523,201187,true,1832299444,28,1821885565,-10413879
1652335569,201187,true,1832299444,28,1820246688,-12052756
1652335592,201190,true,1831749864,28,1819518771,-12231093
1652335614,201192,true,1831383569,28,1818973025,-12410544
1652335673,201192,true,1831383569,28,1817882023,-13501546
1652335687,201192,true,1831383569,28,1817518501,-13865068
1652335701,201191,true,1831566707,28,1817336767,-14229940
1652335762,201191,true,1831566707,28,1816428371,-15138336
1652335867,201189,true,1831933039,28,1815883552,-16049487
1652335870,201189,true,1831933039,28,1815883552,-16049487
1652335916,201185,true,1832665922,28,1815883552,-16782370
1652335961,201185,true,1832665922,28,1815883552,-16782370
1652335976,201184,true,1832849188,28,1815701981,-17147207
1652335987,201185,true,1832665922,28,1815701981,-16963941
1652336031,201186,true,1832482673,28,1815520429,-16962244
1652336192,201189,true,1831933039,28,1813887278,-18045761
1652336210,201188,true,1832116232,28,1813524555,-18591677
1652336250,201189,true,1831933039,28,1813343220,-18589819
1652336264,201192,true,1831383569,28,1813343220,-18040349
1652336337,201195,true,1830834263,28,1812980606,-17853657
1652336378,201195,true,1830834263,28,1812980606,-17853657
1652336388,201196,true,1830651198,28,1813161904,-17489294
1652336396,201199,true,1830102113,28,1813161904,-16940209
1652336436,201201,true,1829736147,28,1813161904,-16574243
1652336451,201203,true,1829370255,28,1812980606,-16389649
1652336517,201201,true,1829736147,28,1813343220,-16392927
1652336599,201203,true,1829370255,28,1813524555,-15845700
1652336621,201205,true,1829004436,28,1813887278,-15117158
1652336640,201205,true,1829004436,28,1813887278,-15117158
1652336652,201203,true,1829370255,28,1814068666,-15301589
1652336689,201205,true,1829004436,28,1814431498,-14572938
1652336707,201208,true,1828455844,28,1814612941,-13842903
1652336716,201208,true,1828455844,28,1814612941,-13842903
1652336761,201209,true,1828273017,28,1814431498,-13841519
1652336855,201211,true,1827907417,28,1815520429,-12386988
1652336903,201213,true,1827541890,28,1816428371,-11113519
1652336913,201215,true,1827176437,28,1816610014,-10566423
1652336943,201214,true,1827359154,28,1817336767,-10022387
1652336988,201215,true,1827176437,28,1817882023,-9294414
1652336990,201218,true,1826628393,28,1817882023,-8746370
1652336993,201218,true,1826628393,28,1817882023,-8746370
1652337050,201218,true,1826628393,28,1818245617,-8382776
1652337055,201219,true,1826445749,28,1818427442,-8018307
1652337089,201221,true,1826080515,28,1818791145,-7289370
1652337110,201221,true,1826080515,28,1819154922,-6925593
1652337139,201220,true,1826263123,28,1819700723,-6562400
1652337163,201222,true,1825897925,28,1820246688,-5651237
1652337193,201223,true,1825715353,28,1820974896,-4740457
1652337247,201222,true,1825897925,28,1822249960,-3647965
1652337350,201220,true,1826263123,28,1824255438,-2007685
1652337463,201220,true,1826263123,28,1826628393,365270
1652337505,201221,true,1826080515,28,1827359154,1278639
1652337531,201221,true,1826080515,28,1827724645,1644130
1652337546,201219,true,1826445749,28,1827724645,1278896
1652337561,201220,true,1826263123,28,1827907417,1644294
1652337608,201223,true,1825715353,28,1827907417,2192064
1652337648,201224,true,1825532800,28,1827724645,2191845
1652337740,201223,true,1825715353,28,1827176437,1461084
1652337908,201226,true,1825167748,28,1826993737,1825989
1652338126,201230,true,1824437864,28,1827907417,3469553
1652338134,201233,true,1823890642,28,1827907417,4016775
1652338148,201233,true,1823890642,28,1828090208,4199566
1652338176,201235,true,1823525918,28,1828273017,4747099
1652338205,201238,true,1822978970,28,1828638690,5659720
1652338228,201238,true,1822978970,28,1828821554,5842584
1652338284,201239,true,1822796690,28,1828638690,5842000
1652338432,201242,true,1822249960,28,1827359154,5109194
1652338482,201245,true,1821703395,28,1826811056,5107661
1652338493,201245,true,1821703395,28,1826628393,4924998
1652338556,201246,true,1821521243,28,1826628393,5107150
1652338568,201249,true,1820974896,28,1826445749,5470853
1652338571,201252,true,1820428712,28,1826445749,6017037
1652338586,201252,true,1820428712,28,1826263123,5834411
1652338599,201254,true,1820064681,28,1826080515,6015834
1652338695,201256,true,1819700723,28,1824802769,5102046
1652338726,201258,true,1819336837,28,1824437864,5101027
1652338733,201258,true,1819336837,28,1824255438,4918601
1652338737,201259,true,1819154922,28,1824255438,5100516
1652338750,201268,true,1817518501,28,1822978970,5460469
1652338768,201280,true,1815338896,28,1821885565,6546669
1652338774,201283,true,1814794403,28,1821521243,6726840
1652338789,201283,true,1814794403,28,1820792816,5998413
1652338820,201285,true,1814431498,28,1819700723,5269225
1652338837,201294,true,1812799326,28,1819154922,6355596
1652338869,201297,true,1812255595,28,1817700253,5444658
1652338911,201297,true,1812255595,28,1815883552,3627957
1652338992,201300,true,1811712027,28,1811893198,181171
1652339002,201308,true,1810263310,28,1811349739,1086429
1652339143,201308,true,1810263310,28,1805201915,-5061395
1652339170,201306,true,1810625380,28,1803758403,-6866977
1652339185,201311,true,1809720339,28,1801955636,-7764703
1652339216,201322,true,1807730841,28,1799074956,-8655885
1652339367,201330,true,1806285307,28,1787419473,-18865834
1652339388,201330,true,1806285307,28,1786168780,-20116527
1652339432,201334,true,1805562973,28,1783135024,-22427949
1652339440,201344,true,1803758403,28,1782600190,-21158213
1652339485,201351,true,1802496277,28,1779928428,-22567849
1652339534,201349,true,1802856794,28,1777082962,-25773832
1652339568,201351,true,1802496277,28,1775129343,-27366934
1652339576,201361,true,1800694771,28,1774774370,-25920401
1652339611,201368,true,1799434789,28,1772823289,-26611500
1652339639,201366,true,1799794694,28,1771228546,-28566148
1652339648,201367,true,1799614733,28,1770697284,-28917449
1652339665,201377,true,1797816107,28,1769635237,-28180870
1652339678,201386,true,1796198881,28,1768927560,-27271321
1652339704,201387,true,1796019280,28,1767159605,-28859675
1652339751,201393,true,1794942045,28,1763276321,-31665724
1652339765,201403,true,1793148090,28,1762218725,-30929365
1652339811,201411,true,1791714217,28,1758697986,-33016231
1652339863,201413,true,1791355928,28,1754657830,-36698098
1652339935,201426,true,1789028794,28,1744510777,-44518017
1652339987,201437,true,1787062043,28,1739285348,-47776695
1652340025,201447,true,1785275963,28,1735984008,-49291955
1652340060,201450,true,1784740488,28,1733035490,-51704998
1652340072,201458,true,1783313337,28,1731996032,-51317305
1652340088,201467,true,1781709158,28,1730784120,-50925038
1652340153,201475,true,1780284431,28,1726117539,-54166892
1652340185,201478,true,1779750453,28,1724047544,-55702909
1652340230,201485,true,1778505126,28,1721291411,-57213715
1652340247,201494,true,1776905271,28,1720258997,-56646274
1652340268,201503,true,1775306856,28,1718883409,-56423447
1652340270,201506,true,1774774370,28,1718883409,-55890961
1652340294,201512,true,1773709878,28,1717680672,-56029206
1652340316,201519,true,1772468778,28,1716822089,-55646689
1652340345,201525,true,1771405669,28,1715620794,-55784875
1652340364,201527,true,1771051441,28,1714934718,-56116723
1652340414,201529,true,1770697284,28,1713563387,-57133897
1652340442,201533,true,1769989182,28,1713049421,-56939761
1652340494,201539,true,1768927560,28,1711679598,-57247962
1652340515,201539,true,1768927560,28,1711337313,-57590247
1652340547,201540,true,1768750685,28,1711508447,-57242238
1652340569,201544,true,1768043361,28,1712193153,-55850208
1652340580,201548,true,1767336321,28,1712364372,-54971949
1652340601,201549,true,1767159605,28,1712364372,-54795233
1652340616,201550,true,1766982906,28,1712535609,-54447297
1652340646,201552,true,1766629563,28,1712706862,-53922701
1652340723,201555,true,1766099680,28,1713734743,-52364937
1652340745,201557,true,1765746513,28,1714420340,-51326173
1652340771,201558,true,1765569956,28,1714934718,-50635238
1652340787,201560,true,1765216895,28,1715449250,-49767645
1652340813,201561,true,1765040391,28,1715792357,-49248034
1652340898,201565,true,1764334551,28,1716478776,-47855775
1652340901,201566,true,1764158135,28,1716478776,-47679359
1652340904,201568,true,1763805357,28,1716478776,-47326581
1652340910,201569,true,1763628994,28,1716650424,-46978570
1652340991,201567,true,1763981737,28,1719399126,-44582611
1652341019,201568,true,1763805357,28,1720947204,-42858153
1652341043,201571,true,1763276321,28,1721980031,-41296290
1652341099,201571,true,1763276321,28,1724737266,-38539055
1652341104,201571,true,1763276321,28,1725082231,-38194090
1652341122,201573,true,1762923719,28,1725944944,-36978775
1652341130,201575,true,1762571187,28,1726290151,-36281036
1652341222,201576,true,1762394947,28,1731130294,-31264653
1652341229,201575,true,1762571187,28,1731649685,-30921502
1652341238,201577,true,1762218725,28,1732169232,-30049493
1652341273,201579,true,1761866334,28,1733728808,-28137526
1652341373,201576,true,1762394947,28,1740155165,-22239782
1652341380,201576,true,1762394947,28,1740677264,-21717683
1652341390,201578,true,1762042521,28,1741199519,-20843002
1652341396,201580,true,1761690165,28,1741547776,-20142389
1652341426,201579,true,1761866334,28,1743464437,-18401897
1652341543,201579,true,1761866334,28,1752027948,-9838386
1652341601,201581,true,1761514014,28,1757115949,-4398065
1652341622,201584,true,1760985665,28,1759049743,-1935922
1652341697,201582,true,1761337880,28,1767866575,6528695
1652341765,201582,true,1761337880,28,1777082962,15745082
1652341836,201582,true,1761337880,28,1784740488,23402608
1652341873,201581,true,1761514014,28,1789565557,28051543
1652341875,201577,true,1762218725,28,1789744513,27525788
1652341937,201571,true,1763276321,28,1797276870,34000549
1652341940,201567,true,1763981737,28,1797636344,33654607
1652341957,201565,true,1764334551,28,1799614733,35280182
1652341959,201561,true,1765040391,28,1799974674,34934283
1652341976,201556,true,1765923088,28,1801775458,35852370
1652342006,201553,true,1766452918,28,1805201915,38748997
1652342015,201553,true,1766452918,28,1806104696,39651778
1652342031,201549,true,1767159605,28,1807911614,40752009
1652342046,201543,true,1768220166,28,1809720339,41500173
1652342066,201538,true,1769104452,28,1811893198,42788746
1652342194,201536,true,1769458291,28,1824255438,54797147
1652342245,201531,true,1770343197,28,1828455844,58112647
1652342269,201525,true,1771405669,28,1830468151,59062482
1652342335,201519,true,1772468778,28,1835600387,63131609
1652342343,201517,true,1772823289,28,1836151123,63327834
1652342389,201513,true,1773532525,28,1839275078,65742553
1652342458,201506,true,1774774370,28,1843694418,68920048
1652342466,201501,true,1775661935,28,1844247582,68585647
1652342481,201499,true,1776017085,28,1845169890,69152805
1652342515,201495,true,1776727598,28,1847200592,70472994
1652342563,201488,true,1777971681,28,1849603394,71631713
1652342581,201476,true,1780106421,28,1850528381,70421960
1652342674,201467,true,1781709158,28,1855531308,73822150
1652342739,201461,true,1782778450,28,1859059993,76281543
1652342798,201455,true,1783848385,28,1862036721,78188336
1652342802,201449,true,1784918962,28,1862222924,77303962
1652342809,201441,true,1786347397,28,1862595387,76247990
1652342810,201435,true,1787419473,28,1862595387,75175914
1652342842,201431,true,1788134548,28,1864085985,75951437
1652342944,201425,true,1789207697,28,1868378103,79170406
1652342976,201416,true,1790818628,28,1869686360,78867732
1652342999,201412,true,1791535063,28,1870621390,79086327
1652343078,201407,true,1792431010,28,1873991372,81560362
1652343086,201399,true,1793865457,28,1874178771,80313314
1652343105,201389,true,1795660130,28,1874741081,79080951
1652343149,201376,true,1797995889,28,1876429023,78433134
1652343215,201369,true,1799254864,28,1879245638,79990774
1652343226,201361,true,1800694771,28,1879621505,78926734
1652343268,201351,true,1802496277,28,1881313842,78817565
1652343370,201338,true,1804840928,28,1885645627,80804699
1652343398,201331,true,1806104696,28,1886588638,80483942
1652343442,201325,true,1807188630,28,1888098437,80909807
1652343486,201315,true,1808996632,28,1889609445,80612813
1652343491,201302,true,1811349739,28,1889798406,78448667
1652343511,201294,true,1812799326,28,1890365402,77566076
1652343531,201288,true,1813887278,28,1890743494,76856216
1652343551,201278,true,1815701981,28,1891499905,75797924
1652343582,201264,true,1818245617,28,1892256618,74011001
1652343610,201255,true,1819882693,28,1893013634,73130941
1652343642,201246,true,1821521243,28,1893770953,72249710
1652343669,201235,true,1823525918,28,1893770953,70245035
1652343819,201222,true,1825897925,28,1893013634,67115709
1652343822,201213,true,1827541890,28,1893013634,65471744
1652343916,201196,true,1830651198,28,1891689055,61037857
1652343976,201186,true,1832482673,28,1891121662,58638989
1652343981,201173,true,1834866331,28,1891121662,56255331
1652344037,201162,true,1836885693,28,1890554438,53668745
1652344077,201151,true,1838907278,28,1889987386,51080108
1652344157,201143,true,1840378919,28,1889231580,48852661
1652344228,201132,true,1842404348,28,1888853790,46449442
1652344268,201123,true,1844063176,28,1888664923,44601747
1652344330,201113,true,1845908069,28,1888476076,42568007
1652344355,201105,true,1847385312,28,1888287247,40901935
1652344427,201096,true,1849048624,28,1887532121,38483497
1652344435,201087,true,1850713434,28,1887343387,36629953
1652344490,201080,true,1852009322,28,1886777297,34767975
1652344602,201075,true,1852935512,28,1884891557,31956045
1652344620,201069,true,1854047551,28,1884514635,30467084
1652344674,201061,true,1855531308,28,1883949394,28418086
1652344718,201056,true,1856459260,28,1883196002,26736742
1652344790,201053,true,1857016253,28,1882254687,25238434
1652344813,201047,true,1858130741,28,1881878292,23747551
1652344824,201040,true,1859431823,28,1881690123,22258300
1652344922,201037,true,1859989709,28,1879809468,19819759
1652344991,201034,true,1860547761,28,1877930692,17382931
1652345006,201030,true,1861292092,28,1877555162,16263070
1652345019,201023,true,1862595387,28,1877179707,14584320
1652345091,201020,true,1863154222,28,1874928555,11774333
1652345152,201019,true,1863340537,28,1873054657,9714120
1652345229,201015,true,1864085985,28,1870995533,6909548
1652345240,201009,true,1865204717,28,1870621390,5416673
1652345293,201007,true,1865577776,28,1868938672,3360896
1652345318,201006,true,1865764334,28,1868191283,2426949
1652345398,201005,true,1865950910,28,1866324119,373209
1652345405,200997,true,1867444194,28,1866137505,-1306689
1652345415,200994,true,1868004483,28,1865764334,-2240149
1652345460,200992,true,1868378103,28,1864831732,-3546371
1652345492,200990,true,1868751797,28,1864272394,-4479403
1652345515,200985,true,1869686360,28,1864085985,-5600375
1652345532,200981,true,1870434346,28,1863899595,-6534751
1652345569,200979,true,1870808452,28,1863340537,-7467915
1652345689,200977,true,1871182632,28,1862409146,-8773486
1652345709,200972,true,1872118411,28,1862222924,-9895487
1652345820,200968,true,1872867371,28,1861664369,-11203002
1652345862,200966,true,1873241963,28,1861478221,-11763742
1652345885,200964,true,1873616630,28,1861664369,-11952261
1652345916,200959,true,1874553626,28,1861664369,-12889257
1652345961,200955,true,1875303559,28,1861664369,-13639190
1652345991,200952,true,1875866207,28,1861850535,-14015672
1652346162,200953,true,1875678639,28,1862409146,-13269493
1652346242,200948,true,1876616666,28,1863154222,-13462444
1652346273,200944,true,1877367425,28,1863526871,-13840554
1652346363,200943,true,1877555162,28,1864831732,-12723430
1652346393,200942,true,1877742917,28,1865204717,-12538200
1652346395,200937,true,1878681977,28,1865391237,-13290740
1652346761,200935,true,1879057732,28,1870434346,-8623386
1652346773,200934,true,1879245638,28,1870434346,-8811292
1652346781,200934,true,1879245638,28,1870621390,-8624248
1652346965,200931,true,1879809468,28,1872492853,-7316615
1652347131,200930,true,1879997449,28,1874741081,-5256368
1652347166,200931,true,1879809468,28,1874928555,-4880913
1652347188,200932,true,1879621505,28,1875303559,-4317946
1652347220,200932,true,1879621505,28,1875678639,-3942866
1652347251,200934,true,1879245638,28,1876241399,-3004239
1652347317,200933,true,1879433562,28,1877179707,-2253855
1652347329,200934,true,1879245638,28,1877367425,-1878213
1652347372,200933,true,1879433562,28,1878118485,-1315077
1652347381,200934,true,1879245638,28,1878306297,-939341
1652347399,200932,true,1879621505,28,1878681977,-939528
1652347430,200932,true,1879621505,28,1879433562,-187943
1652347452,200931,true,1879809468,28,1879997449,187981
1652347542,200933,true,1879433562,28,1881501973,2068411
1652347594,200932,true,1879621505,28,1882254687,2633182
1652347623,200932,true,1879621505,28,1882819420,3197915
1652347698,200931,true,1879809468,28,1883572660,3763192
1652347756,200933,true,1879433562,28,1884137789,4704227
1652347844,200932,true,1879621505,28,1884891557,5270052
1652347870,200932,true,1879621505,28,1885080046,5458541
1652347913,200930,true,1879997449,28,1885268554,5271105
1652348089,200932,true,1879621505,28,1886211377,6589872
1652348137,200931,true,1879809468,28,1886399998,6590530
1652348144,200931,true,1879809468,28,1886588638,6779170
1652348209,200929,true,1880185448,28,1886965975,6780527
1652348237,200930,true,1879997449,28,1887343387,7345938
1652348403,200928,true,1880373467,28,1889231580,8858113
1652348452,200928,true,1880373467,28,1889798406,9424939
1652348535,200926,true,1880749560,28,1890932568,10183008
1652348629,200927,true,1880561504,28,1892445844,11884340
1652348684,200925,true,1880937635,28,1893581595,12643960
1652348741,200925,true,1880937635,28,1894528575,13590940
1652348760,200921,true,1881690123,28,1894907500,13217377
1652348769,200923,true,1881313842,28,1894907500,13593658
1652348820,200921,true,1881690123,28,1895665577,13975454
1652349094,200922,true,1881501973,28,1898131421,16629448
1652349098,200919,true,1882066480,28,1898131421,16064941
1652349118,200921,true,1881690123,28,1898131421,16441298
1652349147,200920,true,1881878292,28,1897941627,16063335
1652349359,200923,true,1881313842,28,1896044729,14730887
1652349470,200922,true,1881501973,28,1894907500,13405527
1652349566,200924,true,1881125729,28,1893960331,12834602
1652349625,200924,true,1881125729,28,1893392256,12266527
1652349640,200927,true,1880561504,28,1893202936,12641432
1652349738,200927,true,1880561504,28,1892256618,11695114
1652349793,200929,true,1880185448,28,1891689055,11503607
1652349843,200929,true,1880185448,28,1891310774,11125326
1652350013,200931,true,1879809468,28,1890176384,10366916
1652350047,200931,true,1879809468,28,1889987386,10177918
1652350139,200932,true,1879621505,28,1889609445,9987940
1652350164,200931,true,1879809468,28,1889420503,9611035
1652350293,200933,true,1879433562,28,1888476076,9042514
1652350332,200932,true,1879621505,28,1888098437,8476932
1652350389,200935,true,1879057732,28,1887154671,8096939
1652350464,200934,true,1879245638,28,1886022775,6777137
1652350555,200936,true,1878869845,28,1884514635,5644790
1652350687,200935,true,1879057732,28,1883949394,4891662
1652350715,200936,true,1878869845,28,1883761018,4891173
1652350721,200934,true,1879245638,28,1883761018,4515380
1652350826,200935,true,1879057732,28,1883384322,4326590
1652350838,200933,true,1879433562,28,1883384322,3950760
1652350888,200934,true,1879245638,28,1883196002,3950364
1652351020,200932,true,1879621505,28,1883572660,3951155
1652351048,200932,true,1879621505,28,1883761018,4139513
1652351147,200930,true,1879997449,28,1884326202,4328753
1652351297,200930,true,1879997449,28,1886965975,6968526
1652351309,200927,true,1880561504,28,1887154671,6593167
1652351382,200926,true,1880749560,28,1888098437,7348877
1652351399,200923,true,1881313842,28,1888287247,6973405
1652351574,200922,true,1881501973,28,1891689055,10187082
1652351674,200918,true,1882254687,28,1893770953,11516266
1652351693,200916,true,1882631157,28,1894149727,11518570
1652351741,200913,true,1883196002,28,1894907500,11711498
1652351860,200911,true,1883572660,28,1896613599,13040939
1652352032,200907,true,1884326202,28,1898890788,14564586
1652352059,200905,true,1884703087,28,1899270585,14567498
1652352078,200901,true,1885457081,28,1899840423,14383342
1652352189,200898,true,1886022775,28,1902882449,16859674
1652352263,200892,true,1887154671,28,1905357681,18203010
1652352306,200890,true,1887532121,28,1906882500,19350379
1652352350,200886,true,1888287247,28,1908408540,20121293
1652352388,200882,true,1889042675,28,1909553872,20511197
1652352399,200876,true,1890176384,28,1909935802,19759418
1652352529,200873,true,1890743494,28,1914142075,23398581
1652352542,200869,true,1891499905,28,1914524923,23025018
1652352588,200865,true,1892256618,28,1916057079,23800461
1652352637,200858,true,1893581595,28,1917398721,23817126
1652352670,200856,true,1893960331,28,1918357612,24397281
1652352691,200852,true,1894718028,28,1918933177,24215149
1652352761,200848,true,1895476029,28,1920660908,25184879
1652352816,200842,true,1896613599,28,1922582434,25968835
1652352850,200839,true,1897182640,28,1923543917,26361277
1652352917,200835,true,1897941627,28,1925853440,27911813
1652352975,200831,true,1898700918,28,1927394662,28693744
1652352997,200825,true,1899840423,28,1927780160,27939737
1652353052,200823,true,1900220410,28,1928937117,28716707
1652353113,200819,true,1900980612,28,1930287778,29307166
1652353471,200816,true,1901550963,28,1937830222,36279259
1652353542,200810,true,1902692179,28,1939381029,36688850
1652353600,200809,true,1902882449,28,1940739003,37856554
1652353681,200805,true,1903643716,28,1942486367,38842651
1652353799,200802,true,1904214866,28,1945207616,40992750
1652353818,200796,true,1905357681,28,1945596677,40238996
1652353820,200795,true,1905548216,28,1945791237,40243021
1652353846,200791,true,1906310550,28,1946180414,39869864
1652354052,200789,true,1906691831,28,1948517116,41825285
1652354145,200783,true,1907836132,28,1949686518,41850386
1652354181,200782,true,1908026916,28,1950076475,42049559
1652354470,200778,true,1908790241,28,1952613096,43822855
1652354479,200775,true,1909362935,28,1952808358,43445423
1652354510,200769,true,1910508840,28,1953198939,42690099
1652354557,200767,true,1910890961,28,1953784957,42893996
1652354606,200761,true,1912037782,28,1954371151,42333369
1652354625,200757,true,1912802712,28,1954566588,41763876
1652354675,200750,true,1914142075,28,1955153017,41010942
1652354712,200747,true,1914716375,28,1955935195,41218820
1652354856,200741,true,1915865492,28,1958871153,43005661
1652355087,200737,true,1916631954,28,1963381516,46749562
1652355166,200731,true,1917782220,28,1964363403,46581183
1652355181,200729,true,1918165796,28,1964559839,46394043
1652355223,200724,true,1919125071,28,1964952771,45827700
1652355285,200723,true,1919316983,28,1965542316,46225333
1652355361,200719,true,1920084825,28,1966132037,46047212
1652355509,200719,true,1920084825,28,1966132037,46047212
1652355603,200715,true,1920852974,28,1965935444,45082470
1652355607,200714,true,1921045060,28,1965935444,44890384
1652355639,200710,true,1921813593,28,1965738870,43925277
1652355739,200710,true,1921813593,28,1965149266,43335673
1652355811,200707,true,1922390195,28,1964952771,42562576
1652355832,200705,true,1922774692,28,1964952771,42178079
1652355873,200701,true,1923543917,28,1964756295,41212378
1652355893,200701,true,1923543917,28,1964756295,41212378
1652355939,200698,true,1924121038,28,1964363403,40242365
1652355988,200696,true,1924505881,28,1963774212,39268331
1652356029,200692,true,1925275799,28,1963381516,38105717
1652356035,200692,true,1925275799,28,1963381516,38105717
1652356351,200691,true,1925468327,28,1957892011,32423684
1652356358,200690,true,1925660874,28,1957696241,32035367
1652356414,200687,true,1926238630,28,1956522035,30283405
1652356482,200686,true,1926431254,28,1955153017,28721763
1652356539,200683,true,1927009241,28,1953784957,26775716
1652356559,200683,true,1927009241,28,1953198939,26189698
1652356708,200680,true,1927587401,28,1948711967,21124566
1652356845,200680,true,1927587401,28,1944818633,17231232
1652356853,200677,true,1928165735,28,1944624170,16458435
1652356863,200676,true,1928358552,28,1944429727,16071175
1652356900,200673,true,1928937117,28,1943652150,14715033
1652356976,200671,true,1929322924,28,1942680615,13357691
1652357000,200667,true,1930094769,28,1942486367,12391598
1652357009,200666,true,1930287778,28,1942486367,12198589
1652357011,200663,true,1930866923,28,1942486367,11619444
1652357016,200659,true,1931639385,28,1942292138,10652753
1652357033,200656,true,1932218935,28,1942097928,9878993
1652357038,200655,true,1932412157,28,1942097928,9685771
1652357196,200654,true,1932605398,28,1939187110,6581712
1652357238,200650,true,1933378556,28,1938411629,5033073
1652357250,200647,true,1933958628,28,1938217807,4259179
1652357307,200646,true,1934152024,28,1937248989,3096965
1652357320,200645,true,1934345439,28,1936861597,2516158
1652357333,200642,true,1934925801,28,1936667931,1742130
1652357347,200639,true,1935506336,28,1936474283,967947
1652357387,200639,true,1935506336,28,1935699887,193551
1652357428,200639,true,1935506336,28,1935119293,-387043
1652357475,200636,true,1936087046,28,1934538873,-1548173
1652357498,200633,true,1936667931,28,1934345439,-2322492
1652357663,200633,true,1936667931,28,1931639385,-5028546
1652357682,200632,true,1936861597,28,1931446241,-5415356
1652357732,200628,true,1937636458,28,1930866923,-6769535
1652357890,200625,true,1938217807,28,1929901779,-8316028
1652357898,200625,true,1938217807,28,1929901779,-8316028
1652358197,200624,true,1938411629,28,1929901779,-8509850
1652358254,200620,true,1939187110,28,1929322924,-9864186
1652358280,200618,true,1939574967,28,1928937117,-10637850
1652358289,200617,true,1939768924,28,1928937117,-10831807
1652358404,200618,true,1939574967,28,1927780160,-11794807
1652358435,200615,true,1940156898,28,1927587401,-12569497
1652358462,200613,true,1940544948,28,1927394662,-13150286
1652358492,200614,true,1940350913,28,1927009241,-13341672
1652358502,200616,true,1939962901,28,1926816559,-13146342
1652358724,200614,true,1940350913,28,1922966969,-17383944
1652358739,200613,true,1940544948,28,1922774692,-17770256
1652358799,200614,true,1940350913,28,1921813593,-18537320
1652358831,200616,true,1939962901,28,1921237164,-18725737
1652358917,200613,true,1940544948,28,1921237164,-19307784
1652358927,200611,true,1940933077,28,1921045060,-19888017
1652358941,200612,true,1940739003,28,1921045060,-19693943
1652359041,200613,true,1940544948,28,1921237164,-19307784
1652359046,200610,true,1941127170,28,1921237164,-19890006
1652359097,200609,true,1941321283,28,1921621431,-19699852
1652359177,200609,true,1941321283,28,1922966969,-18354314
1652359194,200611,true,1940933077,28,1923159266,-17773811
1652359233,200607,true,1941709566,28,1923928645,-17780921
1652359464,200605,true,1942097928,28,1928165735,-13932193
1652359517,200606,true,1941903737,28,1928937117,-12966620
1652359545,200608,true,1941515415,28,1929322924,-12192491
1652359569,200606,true,1941903737,28,1929708808,-12194929
1652359588,200604,true,1942292138,28,1929901779,-12390359
1652359616,200605,true,1942097928,28,1930287778,-11810150
1652359649,200607,true,1941709566,28,1930673855,-11035711
1652359697,200605,true,1942097928,28,1931253115,-10844813
1652359732,200603,true,1942486367,28,1931639385,-10846982
1652359859,200603,true,1942486367,28,1933185238,-9301129
1652359872,200606,true,1941903737,28,1933185238,-8718499
1652359891,200604,true,1942292138,28,1933378556,-8913582
1652359983,200604,true,1942292138,28,1933765251,-8526887
1652360026,200606,true,1941903737,28,1933958628,-7945109
1652360042,200609,true,1941321283,28,1934152024,-7169259
1652360052,200607,true,1941709566,28,1934152024,-7557542
1652360071,200606,true,1941903737,28,1934538873,-7364864
1652360376,200607,true,1941709566,28,1939962901,-1746665
1652360421,200609,true,1941321283,28,1940933077,-388206
1652360488,200607,true,1941709566,28,1942292138,582572
1652360505,200606,true,1941903737,28,1942680615,776878
1652360510,200608,true,1941515415,28,1942874883,1359468
1652360520,200611,true,1940933077,28,1943069171,2136094
1652360616,200611,true,1940933077,28,1944040900,3107823
1652360741,200610,true,1941127170,28,1944624170,3497000
1652360790,200611,true,1940933077,28,1944624170,3691093
1652360796,200615,true,1940156898,28,1944624170,4467272
1652360842,200615,true,1940156898,28,1944818633,4661735
1652360852,200615,true,1940156898,28,1944624170,4467272
1652360869,200617,true,1939768924,28,1944624170,4855246
1652360903,200620,true,1939187110,28,1944624170,5437060
1652360965,200619,true,1939381029,28,1944235304,4854275
1652361070,200620,true,1939187110,28,1943263478,4076368
1652361079,200622,true,1938799331,28,1943263478,4464147
1652361091,200626,true,1938024005,28,1943263478,5239473
1652361128,200626,true,1938024005,28,1943263478,5239473
1652361139,200627,true,1937830222,28,1943263478,5433256
1652361179,200629,true,1937442714,28,1943069171,5626457
1652361204,200633,true,1936667931,28,1943069171,6401240
1652361210,200633,true,1936667931,28,1942874883,6206952
1652361236,200634,true,1936474283,28,1942680615,6206332
1652361239,200634,true,1936474283,28,1942680615,6206332
1652361272,200638,true,1935699887,28,1942486367,6786480
1652361358,200637,true,1935893457,28,1941709566,5816109
1652361471,200638,true,1935699887,28,1940933077,5233190
1652361495,200638,true,1935699887,28,1940739003,5039116
1652361671,200642,true,1934925801,28,1938799331,3873530
1652361826,200639,true,1935506336,28,1938799331,3292995
1652361847,200640,true,1935312805,28,1938799331,3486526
1652361903,200640,true,1935312805,28,1938605470,3292665
1652362216,200642,true,1934925801,28,1937830222,2904421
1652362258,200640,true,1935312805,28,1937830222,2517417
1652362281,200640,true,1935312805,28,1937830222,2517417
1652362298,200640,true,1935312805,28,1937830222,2517417
1652362318,200641,true,1935119293,28,1938024005,2904712
1652362337,200638,true,1935699887,28,1938217807,2517920
1652362365,200637,true,1935893457,28,1938217807,2324350
1652362397,200638,true,1935699887,28,1938024005,2324118
1652362419,200641,true,1935119293,28,1937636458,2517165
1652362430,200640,true,1935312805,28,1937636458,2323653
1652362489,200642,true,1934925801,28,1936667931,1742130
1652362544,200645,true,1934345439,28,1935506336,1160897
1652362635,200647,true,1933958628,28,1934345439,386811
1652362675,200646,true,1934152024,28,1933765251,-386773
1652362694,200648,true,1933765251,28,1933378556,-386695
1652362700,200650,true,1933378556,28,1933185238,-193318
1652362722,200655,true,1932412157,28,1932412157,0
1652362734,200656,true,1932218935,28,1932218935,0
1652362809,200660,true,1931446241,28,1929901779,-1544462
1652362826,200662,true,1931060009,28,1929515856,-1544153
1652362920,200667,true,1930094769,28,1926238630,-3856139
1652362972,200669,true,1929708808,28,1924313450,-5395358
1652362993,200672,true,1929130011,28,1923543917,-5586094
1652362996,200673,true,1928937117,28,1923543917,-5393200
1652363005,200676,true,1928358552,28,1923351582,-5006970
1652363060,200675,true,1928551388,28,1922197975,-6353413
1652363077,200677,true,1928165735,28,1921813593,-6352142
1652363126,200678,true,1927972938,28,1921045060,-6927878
1652363134,200679,true,1927780160,28,1920852974,-6927186
1652363156,200678,true,1927972938,28,1920468861,-7504077
1652363228,200680,true,1927587401,28,1919316983,-8270418
1652363285,200680,true,1927587401,28,1918741303,-8846098
1652363307,200681,true,1927394662,28,1918549448,-8845214
1652363350,200680,true,1927587401,28,1918357612,-9229789
1652363385,200680,true,1927587401,28,1918357612,-9229789
1652363387,200679,true,1927780160,28,1918357612,-9422548
1652363454,200680,true,1927587401,28,1917973998,-9613403
1652363487,200679,true,1927780160,28,1917590461,-10189699
1652363620,200681,true,1927394662,28,1915673925,-11720737
1652363631,200681,true,1927394662,28,1915482377,-11912285
1652363664,200683,true,1927009241,28,1914907847,-12101394
1652363747,200682,true,1927201942,28,1913376610,-13825332
1652363826,200685,true,1926623897,28,1911846597,-14777300
1652363901,200684,true,1926816559,28,1910508840,-16307719
1652363941,200686,true,1926431254,28,1909744827,-16686427
1652363991,200685,true,1926623897,28,1908599381,-18024516
1652364038,200688,true,1926046025,28,1907263896,-18782129
1652364066,200688,true,1926046025,28,1906691831,-19354194
1652364088,200689,true,1925853440,28,1905929345,-19924095
1652364112,200687,true,1926238630,28,1904976666,-21261964
1652364153,200691,true,1925468327,28,1903834080,-21634247
1652364160,200691,true,1925468327,28,1903643716,-21824611
1652364191,200693,true,1925083291,28,1903072737,-22010554
1652364204,200693,true,1925083291,28,1902882449,-22200842
1652364351,200696,true,1924505881,28,1901931293,-22574588
1652364366,200697,true,1924313450,28,1901741119,-22572331
1652364402,200699,true,1923928645,28,1901550963,-22377682
1652364417,200699,true,1923928645,28,1901550963,-22377682
1652364429,200703,true,1923159266,28,1901550963,-21608303
1652364451,200705,true,1922774692,28,1901360827,-21413865
1652364556,200706,true,1922582434,28,1902501929,-20080505
1652364588,200707,true,1922390195,28,1903072737,-19317458
1652364676,200710,true,1921813593,28,1904595728,-17217865
1652364717,200712,true,1921429288,28,1905548216,-15881072
1652364748,200713,true,1921237164,28,1906119938,-15117226
1652364757,200713,true,1921237164,28,1906310550,-14926614
1652364988,200714,true,1921045060,28,1910317808,-10727252
1652365024,200716,true,1920660908,28,1910699891,-9961017
1652365036,200716,true,1920660908,28,1910699891,-9961017
1652365074,200716,true,1920660908,28,1910890961,-9769947
1652365101,200719,true,1920084825,28,1911082050,-9002775
1652365109,200720,true,1919892836,28,1911082050,-8810786
1652365159,200720,true,1919892836,28,1911082050,-8810786
1652365202,200720,true,1919892836,28,1911273158,-8619678
1652365234,200721,true,1919700866,28,1911464285,-8236581
1652365375,200721,true,1919700866,28,1913185291,-6515575
1652365412,200721,true,1919700866,28,1913759304,-5941562
1652365452,200720,true,1919892836,28,1914524923,-5367913
1652365561,200721,true,1919700866,28,1916823617,-2877249
1652365575,200722,true,1919508915,28,1917015299,-2493616
1652365588,200721,true,1919700866,28,1917398721,-2302145
1652365674,200720,true,1919892836,28,1919700866,-191970
1652365727,200720,true,1919892836,28,1921045060,1152224
1652365737,200720,true,1919892836,28,1921237164,1344328
1652365811,200719,true,1920084825,28,1923159266,3074441
1652365893,200717,true,1920468861,28,1925660874,5192013
1652365998,200718,true,1920276834,28,1928744243,8467409
1652366033,200718,true,1920276834,28,1929708808,9431974
1652366104,200717,true,1920468861,28,1931832549,11363688
1652366350,200715,true,1920852974,28,1938024005,17171031
1652366370,200715,true,1920852974,28,1938411629,17558655
1652366427,200714,true,1921045060,28,1939768924,18723864
1652366583,200714,true,1921045060,28,1942486367,21441307
1652366667,200711,true,1921621431,28,1943652150,22030719
1652366725,200712,true,1921429288,28,1944429727,23000439
1652366740,200711,true,1921621431,28,1944429727,22808296
1652366815,200711,true,1921621431,28,1945402137,23780706
1652366845,200710,true,1921813593,28,1945791237,23977644
1652366857,200711,true,1921621431,28,1945985816,24364385
1652367015,200712,true,1921429288,28,1947543149,26113861
1652367090,200711,true,1921621431,28,1948127471,26506040
1652367107,200710,true,1921813593,28,1948322284,26508691
1652367129,200711,true,1921621431,28,1948517116,26895685
1652367138,200710,true,1921813593,28,1948711967,26898374
1652367276,200708,true,1922197975,28,1949881487,27683512
1652367281,200706,true,1922582434,28,1949881487,27299053
1652367358,200706,true,1922582434,28,1950856623,28274189
1652367370,200705,true,1922774692,28,1950856623,28081931
1652367374,200702,true,1923351582,28,1950856623,27505041
1652367475,200698,true,1924121038,28,1952222632,28101594
1652367501,200697,true,1924313450,28,1952808358,28494908
1652367560,200695,true,1924698332,28,1954566588,29868256
1652367584,200693,true,1925083291,28,1955348532,30265241
1652367591,200688,true,1926046025,28,1955544067,29498042
1652367729,200687,true,1926238630,28,1959262947,33024317
1652367805,200686,true,1926431254,28,1961615356,35184102
1652367853,200684,true,1926816559,28,1962988898,36172339
1652367904,200680,true,1927587401,28,1964559839,36972438
1652367909,200678,true,1927972938,28,1964559839,36586901
1652367927,200674,true,1928744243,28,1965149266,36405023
1652368062,200670,true,1929515856,28,1969674085,40158229
1652368069,200664,true,1930673855,28,1970068039,39394184
1652368202,200660,true,1931446241,28,1974801644,43355403
1652368225,200655,true,1932412157,28,1975591683,43179526
1652368247,200650,true,1933378556,28,1976579677,43201121
1652368257,200644,true,1934538873,28,1976777335,42238462
1652368284,200639,true,1935506336,28,1977765921,42259585
1652368312,200633,true,1936667931,28,1978952877,42284946
1652368362,200627,true,1937830222,28,1980734647,42904425
1652368406,200620,true,1939187110,28,1982319790,43132680
1652368443,200615,true,1940156898,28,1983509479,43352581
1652368463,200609,true,1941321283,28,1984104591,42783308
1652368509,200603,true,1942486367,28,1985692431,43206064
1652368522,200597,true,1943652150,28,1986089589,42437439
1652368545,200591,true,1944818633,28,1986884144,42065511
1652368688,200586,true,1945791237,28,1991658154,45866917
1652368764,200581,true,1946764327,28,1994248864,47484537
1652368822,200576,true,1947737904,28,1996244010,48506106
1652368884,200571,true,1948711967,28,1998640821,49928854
1652368962,200566,true,1949686518,28,2001040509,51353991
1652368980,200561,true,1950661557,28,2001640882,50979325
1652368991,200556,true,1951637082,28,2002041230,50404148
1652368997,200551,true,1952613096,28,2002041230,49428134
1652369038,200548,true,1953198939,28,2003242755,50043816
1652369104,200544,true,1953980335,28,2004645445,50665110
1652369109,200540,true,1954762045,28,2004645445,49883400
1652369116,200537,true,1955348532,28,2004845910,49497378
1652369187,200535,true,1955739621,28,2005848533,50108912
1652369285,200531,true,1956522035,28,2006650993,50128958
1652369448,200527,true,1957304761,28,2006049118,48744357
1652369737,200523,true,1958087800,28,2003843788,45755988
1652369785,200521,true,1958479437,28,2003443079,44963642
1652369975,200516,true,1959458873,28,2001640882,42182009
1652369989,200512,true,1960242774,28,2001440737,41197963
1652370258,200507,true,1961223091,28,1999040569,37817478
1652370260,200505,true,1961615356,28,1999040569,37425213
1652370342,200500,true,1962596360,28,1998440977,35844617
1652370361,200495,true,1963577854,28,1998241153,34663299
1652370465,200490,true,1964559839,28,1997641800,33081961
1652370484,200487,true,1965149266,28,1997442056,32292790
1652370534,200482,true,1966132037,28,1996842943,30710906
1652370662,200478,true,1966918608,28,1995246187,28327579
1652370698,200472,true,1968099054,28,1994647733,26548679
1652370716,200470,true,1968492694,28,1994448288,25955594
1652370989,200465,true,1969477137,28,1990861690,21384553
1652371002,200461,true,1970265046,28,1990662623,20397577
1652371052,200457,true,1971053270,28,1990264551,19211281
1652371062,200454,true,1971644645,28,1990065544,18420899
1652371091,200450,true,1972433422,28,1989667591,17234169
1652371108,200446,true,1973222513,28,1989468644,16246131
1652371185,200443,true,1973814539,28,1988474208,14659669
1652371191,200440,true,1974406743,28,1988474208,14067465
1652371201,200438,true,1974801644,28,1988275380,13473736
1652371225,200435,true,1975394144,28,1987877785,12483641
1652371282,200433,true,1975789242,28,1987082832,11293590
1652371473,200431,true,1976184420,28,1984501432,8317012
1652371514,200430,true,1976382038,28,1984104591,7722553
1652371536,200427,true,1976975012,28,1983906201,6931189
1652371543,200426,true,1977172710,28,1983707830,6535120
1652371565,200424,true,1977568164,28,1983509479,5941315
1652371577,200423,true,1977765921,28,1983311148,5545227
1652371649,200419,true,1978557146,28,1982518022,3960876
1652371698,200417,true,1978952877,28,1982121578,3168701
1652371727,200415,true,1979348688,28,1981923385,2574697
1652371731,200414,true,1979546622,28,1981725213,2178591
1652371757,200410,true,1980338560,28,1981527060,1188500
1652371780,200408,true,1980734647,28,1981527060,792413
1652371824,200405,true,1981328927,28,1981130814,-198113
1652371874,200404,true,1981527060,28,1980932721,-594339
1652371878,200400,true,1982319790,28,1980734647,-1585143
1652371930,200399,true,1982518022,28,1980536594,-1981428
1652372029,200398,true,1982716274,28,1979348688,-3367586
1652372046,200398,true,1982716274,28,1979150772,-3565502
1652372165,200395,true,1983311148,28,1978161494,-5149654
1652372256,200394,true,1983509479,28,1977765921,-5743558
1652372278,200392,true,1983906201,28,1977765921,-6140280
1652372314,200392,true,1983906201,28,1977568164,-6338037
1652372316,200388,true,1984699882,28,1977568164,-7131718
1652372416,200388,true,1984699882,28,1976777335,-7922547
1652372425,200387,true,1984898352,28,1976579677,-8318675
1652372442,200387,true,1984898352,28,1976579677,-8318675
1652372469,200383,true,1985692431,28,1976382038,-9310393
1652372478,200383,true,1985692431,28,1976382038,-9310393
1652372484,200381,true,1986089589,28,1976382038,-9707551
1652372489,200381,true,1986089589,28,1976382038,-9707551
1652372576,200377,true,1986884144,28,1976777335,-10106809
1652372626,200376,true,1987082832,28,1977172710,-9910122
1652372674,200374,true,1987480269,28,1977765921,-9714348
1652372768,200373,true,1987679017,28,1978952877,-8726140
1652372823,200367,true,1988871923,28,1979942552,-8929371
1652372901,200365,true,1989269717,28,1981725213,-7544504
1652373067,200363,true,1989667591,28,1985891000,-3776591
1652373089,200361,true,1990065544,28,1986486827,-3578717
1652373103,200355,true,1991259882,28,1986884144,-4375738
1652373154,200353,true,1991658154,28,1988474208,-3183946
1652373188,200351,true,1992056505,28,1989667591,-2388914
1652373202,200350,true,1992255711,28,1990065544,-2190167
1652373412,200344,true,1993451363,28,1996643279,3191916
1652373468,200343,true,1993650708,28,1998041348,4390640
1652373533,200340,true,1994248864,28,1999440397,5191533
1652373544,200340,true,1994248864,28,1999640341,5391477
1652373563,200336,true,1995046683,28,2000040289,4993606
1652373573,200336,true,1995046683,28,2000040289,4993606
1652373616,200336,true,1995046683,28,2000640361,5593678
1652373621,200337,true,1994847198,28,2000640361,5793163
1652373628,200334,true,1995445712,28,2000640361,5194649
1652373654,200335,true,1995246187,28,2000840425,5594238
1652373667,200335,true,1995246187,28,2001040509,5794322
1652373677,200336,true,1995046683,28,2001040509,5993826
1652373700,200334,true,1995445712,28,2001240613,5794901
1652373724,200335,true,1995246187,28,2001240613,5994426
1652373822,200335,true,1995246187,28,2002441658,7195471
1652373835,200337,true,1994847198,28,2002641902,7794704
1652373911,200335,true,1995246187,28,2003643423,8397236
1652373967,200336,true,1995046683,28,2004445001,9398318
1652374017,200335,true,1995246187,28,2005246899,10000712
1652374041,200338,true,1994647733,28,2005647969,11000236
1652374079,200335,true,1995246187,28,2006249723,11003536
1652374136,200336,true,1995046683,28,2007654519,12607836
1652374183,200336,true,1995046683,28,2008658547,13611864
1652374244,200338,true,1994647733,28,2010065030,15417297
1652374392,200336,true,1995046683,28,2012478435,17431752
1652374529,200337,true,1994847198,28,2013686224,18839026
1652374576,200336,true,1995046683,28,2013887593,18840910
1652374627,200338,true,1994647733,28,2014088982,19441249
1652374638,200335,true,1995246187,28,2014290391,19044204
1652374677,200335,true,1995246187,28,2014491820,19245633
1652374737,200334,true,1995445712,28,2014693269,19247557
1652374780,200335,true,1995246187,28,2014894738,19648551
1652374939,200332,true,1995844821,28,2015297737,19452916
1652375174,200334,true,1995445712,28,2015096228,19650516
1652375194,200332,true,1995844821,28,2015096228,19251407
1652375218,200334,true,1995445712,28,2014894738,19449026
1652375233,200332,true,1995844821,28,2014693269,18848448
1652375246,200334,true,1995445712,28,2014693269,19247557
1652375369,200333,true,1995645257,28,2013686224,18040967
1652375434,200335,true,1995246187,28,2013082239,17836052
1652375577,200332,true,1995844821,28,2012880951,17036130
1652375635,200334,true,1995445712,28,2012679683,17233971
1652375770,200333,true,1995645257,28,2012076000,16430743
1652375815,200334,true,1995445712,28,2011673645,16227933
1652375925,200332,true,1995844821,28,2010266037,14421216
1652375950,200333,true,1995645257,28,2009864044,14218787
1652376182,200333,true,1995645257,28,2005647969,10002712
1652376312,200335,true,1995246187,28,2003443079,8196892
1652376430,200333,true,1995645257,28,2001240613,5595356
1652376678,200336,true,1995046683,28,1996443634,1396951
1652376768,200336,true,1995046683,28,1994847198,-199485
1652377005,200338,true,1994647733,28,1990065544,-4582189
1652377078,200336,true,1995046683,28,1988871923,-6174760
1652377123,200338,true,1994647733,28,1987877785,-6769948
1652377436,200340,true,1994248864,28,1981527060,-12721804
1652377487,200343,true,1993650708,28,1980536594,-13114114
1652377637,200341,true,1994049459,28,1977568164,-16481295
1652377643,200343,true,1993650708,28,1977370427,-16280281
1652377688,200345,true,1993252038,28,1976579677,-16672361
1652377696,200347,true,1992853448,28,1976382038,-16471410
1652377715,200345,true,1993252038,28,1975986821,-17265217
1652377767,200348,true,1992654182,28,1974604184,-18049998
1652377848,200352,true,1991857320,28,1972630665,-19226655
1652377902,200353,true,1991658154,28,1971053270,-20604884
1652378000,200352,true,1991857320,28,1968295864,-23561456
1652378020,200355,true,1991259882,28,1967705494,-23554388
1652378177,200358,true,1990662623,28,1963774212,-26888411
1652378206,200359,true,1990463577,28,1962988898,-27474679
1652378311,200358,true,1990662623,28,1959850784,-30811839
1652378312,200360,true,1990264551,28,1959850784,-30413767
1652378360,200364,true,1989468644,28,1958283609,-31185035
1652378491,200365,true,1989269717,28,1953980335,-35289382
1652378495,200364,true,1989468644,28,1953980335,-35488309
1652378682,200366,true,1989070810,28,1948711967,-40358843
1652378868,200370,true,1988275380,28,1944235304,-44040076
1652378951,200371,true,1988076573,28,1943069171,-45007402
1652378965,200371,true,1988076573,28,1942874883,-45201690
1652378993,200373,true,1987679017,28,1942486367,-45192650
1652379019,200377,true,1986884144,28,1942097928,-44786216
1652379054,200378,true,1986685476,28,1941709566,-44975910
1652379553,200378,true,1986685476,28,1935699887,-50985589
1652379630,200380,true,1986288198,28,1935699887,-50588311
1652379759,200385,true,1985295352,28,1936087046,-49208306
1652379961,200387,true,1984898352,28,1936087046,-48811306
1652379984,200387,true,1984898352,28,1935893457,-49004895
1652380059,200390,true,1984303002,28,1935893457,-48409545
1652380227,200395,true,1983311148,28,1936087046,-47224102
1652380276,200397,true,1982914545,28,1936087046,-46827499
1652380299,200397,true,1982914545,28,1936087046,-46827499
1652380327,200399,true,1982518022,28,1936087046,-46430976
1652380343,200404,true,1981527060,28,1936087046,-45440014
1652380356,200406,true,1981130814,28,1935893457,-45237357
1652380383,200408,true,1980734647,28,1935699887,-45034760
1652380418,200410,true,1980338560,28,1935506336,-44832224
1652380609,200415,true,1979348688,28,1932991939,-46356749
1652380725,200417,true,1978952877,28,1931446241,-47506636
1652380831,200419,true,1978557146,28,1930094769,-48462377
1652380904,200422,true,1977963697,28,1929130011,-48833686
1652380983,200427,true,1976975012,28,1928165735,-48809277
1652381002,200429,true,1976579677,28,1927780160,-48799517
1652381040,200432,true,1975986821,28,1927201942,-48784879
1652381064,200436,true,1975196624,28,1926816559,-48380065
1652381129,200442,true,1974011921,28,1925853440,-48158481
1652381287,200445,true,1973419836,28,1923928645,-49491191
1652381305,200449,true,1972630665,28,1923543917,-49086748
1652381344,200453,true,1971841810,28,1922966969,-48874841
1652381465,200460,true,1970462073,28,1920852974,-49609099
1652381607,200464,true,1969674085,28,1918357612,-51316473
1652381723,200468,true,1968886412,28,1916631954,-52254458
1652381848,200472,true,1968099054,28,1914907847,-53191207
1652381897,200480,true,1966525283,28,1914333489,-52191794
1652381936,200484,true,1965738870,28,1913950680,-51788190
1652382242,200488,true,1964952771,28,1910699891,-54252880
1652382255,200493,true,1963970589,28,1910508840,-53461749
1652382285,200501,true,1962400120,28,1910508840,-51891280
1652382480,200504,true,1961811517,28,1910508840,-51302677
1652382537,200507,true,1961223091,28,1910508840,-50714251
1652382603,200512,true,1960242774,28,1910508840,-49733934
1652382654,200519,true,1958871153,28,1910508840,-48362313
1652382688,200522,true,1958283609,28,1910508840,-47774769
1652382691,200525,true,1957696241,28,1910508840,-47187401
1652382919,200529,true,1956913359,28,1910317808,-46595551
1652382955,200535,true,1955739621,28,1910317808,-45421813
1652383015,200538,true,1955153017,28,1910126795,-45026222
1652383080,200542,true,1954371151,28,1909935802,-44435349
1652383108,200545,true,1953784957,28,1909744827,-44040130
1652383124,200552,true,1952417854,28,1909744827,-42673027
1652383154,200555,true,1951832246,28,1909935802,-41896444
1652383181,200558,true,1951246814,28,1910126795,-41120019
1652383202,200562,true,1950466510,28,1910317808,-40148702
1652383235,200569,true,1949101729,28,1910508840,-38592889
1652383267,200571,true,1948711967,28,1910890961,-37821006
1652383323,200573,true,1948322284,28,1911846597,-36475687
1652383342,200577,true,1947543149,28,1912037782,-35505367
1652383401,200583,true,1946375032,28,1912993992,-33381040
1652383441,200585,true,1945985816,28,1913759304,-32226512
1652383451,200588,true,1945402137,28,1913950680,-31451457
1652383522,200591,true,1944818633,28,1915099338,-29719295
1652383566,200597,true,1943652150,28,1916057079,-27595071
1652383592,200599,true,1943263478,28,1916631954,-26631524
1652383680,200600,true,1943069171,28,1918933177,-24135994
1652383719,200603,true,1942486367,28,1919892836,-22593531
1652383727,200609,true,1941321283,28,1920084825,-21236458
1652383770,200611,true,1940933077,28,1921045060,-19888017
1652383804,200613,true,1940544948,28,1921621431,-18923517
1652383812,200616,true,1939962901,28,1921813593,-18149308
1652383847,200623,true,1938605470,28,1922390195,-16215275
1652383900,200625,true,1938217807,28,1923543917,-14673890
1652384217,200627,true,1937830222,28,1928551388,-9278834
1652384259,200629,true,1937442714,28,1929130011,-8312703
1652384261,200634,true,1936474283,28,1929130011,-7344272
1652384392,200636,true,1936087046,28,1930673855,-5413191
1652384623,200638,true,1935699887,28,1933571894,-2127993
1652384636,200641,true,1935119293,28,1933571894,-1547399
1652384693,200646,true,1934152024,28,1934152024,0
1652384727,200648,true,1933765251,28,1934538873,773622
1652384766,200650,true,1933378556,28,1935119293,1740737
1652384779,200652,true,1932991939,28,1935312805,2320866
1652384937,200656,true,1932218935,28,1937055284,4836349
1652384951,200658,true,1931832549,28,1937248989,5416440
1652385029,200660,true,1931446241,28,1937830222,6383981
1652385045,200662,true,1931060009,28,1937830222,6770213
1652385093,200665,true,1930480807,28,1938024005,7543198
1652385575,200666,true,1930287778,28,1937442714,7154936
1652385654,200668,true,1929901779,28,1937248989,7347210
1652385738,200669,true,1929708808,28,1937442714,7733906
1652385796,200671,true,1929322924,28,1937442714,8119790
1652386271,200671,true,1929322924,28,1938217807,8894883
1652386284,200672,true,1929130011,28,1938217807,9087796
1652386313,200673,true,1928937117,28,1938217807,9280690
1652386327,200675,true,1928551388,28,1938217807,9666419
1652386717,200677,true,1928165735,28,1936861597,8695862
1652387005,200677,true,1928165735,28,1935119293,6953558
1652387052,200678,true,1927972938,28,1934925801,6952863
1652387202,200677,true,1928165735,28,1934152024,5986289
1652387393,200678,true,1927972938,28,1933571894,5598956
1652387617,200677,true,1928165735,28,1933378556,5212821
1652387672,200677,true,1928165735,28,1933378556,5212821
1652387832,200677,true,1928165735,28,1932991939,4826204
1652387946,200678,true,1927972938,28,1932798659,4825721
1652388010,200677,true,1928165735,28,1932605398,4439663
1652388067,200677,true,1928165735,28,1932798659,4632924
1652388075,200676,true,1928358552,28,1932798659,4440107
1652388076,200676,true,1928358552,28,1932798659,4440107
1652388130,200674,true,1928744243,28,1933185238,4440995
1652388177,200674,true,1928744243,28,1933571894,4827651
1652388296,200674,true,1928744243,28,1934732327,5988084
1652388344,200675,true,1928551388,28,1935119293,6567905
1652388407,200674,true,1928744243,28,1935506336,6762093
1652388504,200674,true,1928744243,28,1936474283,7730040
1652388680,200674,true,1928744243,28,1937830222,9085979
1652388756,200675,true,1928551388,28,1938217807,9666419
1652388786,200673,true,1928937117,28,1938411629,9474512
1652388868,200674,true,1928744243,28,1938799331,10055088
1652388893,200674,true,1928744243,28,1938799331,10055088
1652388919,200675,true,1928551388,28,1938993211,10441823
1652388973,200673,true,1928937117,28,1938993211,10056094
1652389047,200674,true,1928744243,28,1938993211,10248968
1652389097,200673,true,1928937117,28,1938799331,9862214
1652389155,200674,true,1928744243,28,1938799331,10055088
1652389218,200673,true,1928937117,28,1938411629,9474512
1652389242,200674,true,1928744243,28,1938411629,9667386
1652389268,200674,true,1928744243,28,1938217807,9473564
1652389324,200675,true,1928551388,28,1937636458,9085070
1652389468,200673,true,1928937117,28,1936474283,7537166
1652389490,200673,true,1928937117,28,1936280655,7343538
1652389649,200672,true,1929130011,28,1934925801,5795790
1652389764,200673,true,1928937117,28,1933958628,5021511
1652389775,200672,true,1929130011,28,1933765251,4635240
1652390029,200672,true,1929130011,28,1930287778,1157767
1652390096,200671,true,1929322924,28,1929515856,192932
1652390142,200672,true,1929130011,28,1928937117,-192894
1652390160,200671,true,1929322924,28,1928744243,-578681
1652390298,200671,true,1929322924,28,1926816559,-2506365
1652390340,200670,true,1929515856,28,1926238630,-3277226
1652390353,200672,true,1929130011,28,1926046025,-3083986
1652390362,200670,true,1929515856,28,1925853440,-3662416
1652390384,200671,true,1929322924,28,1925468327,-3854597
1652390449,200671,true,1929322924,28,1924313450,-5009474
1652390725,200672,true,1929130011,28,1919316983,-9813028
1652390772,200671,true,1929322924,28,1918549448,-10773476
1652390865,200671,true,1929322924,28,1917015299,-12307625
1652390919,200671,true,1929322924,28,1916057079,-13265845
1652390935,200673,true,1928937117,28,1915865492,-13071625
1652391000,200672,true,1929130011,28,1914524923,-14605088
1652391080,200673,true,1928937117,28,1913185291,-15751826
1652391104,200673,true,1928937117,28,1912802712,-16134405
1652391142,200676,true,1928358552,28,1912037782,-16320770
1652391203,200675,true,1928551388,28,1911082050,-17469338
1652391228,200677,true,1928165735,28,1910508840,-17656895
1652391269,200678,true,1927972938,28,1909553872,-18419066
1652391277,200680,true,1927587401,28,1909553872,-18033529
1652391316,200681,true,1927394662,28,1908599381,-18795281
1652391324,200682,true,1927201942,28,1908408540,-18793402
1652391405,200684,true,1926816559,28,1906310550,-20506009
1652391485,200686,true,1926431254,28,1904405287,-22025967
1652391740,200688,true,1926046025,28,1897941627,-28104398
1652391754,200689,true,1925853440,28,1897562096,-28291344
1652391769,200691,true,1925468327,28,1897182640,-28285687
1652391777,200693,true,1925083291,28,1896992941,-28090350
1652391791,200694,true,1924890802,28,1896803261,-28087541
1652391888,200694,true,1924890802,28,1895476029,-29414773
1652391905,200696,true,1924505881,28,1895286501,-29219380
1652391993,200698,true,1924121038,28,1894528575,-29592463
1652392093,200700,true,1923736271,28,1893392256,-30344015
1652392259,200700,true,1923736271,28,1892067411,-31668860
1652392440,200702,true,1923351582,28,1891121662,-32229920
1652392573,200706,true,1922582434,28,1890554438,-32027996
1652392626,200708,true,1922197975,28,1890365402,-31832573
1652392632,200708,true,1922197975,28,1890365402,-31832573
1652392655,200711,true,1921621431,28,1890365402,-31256029
1652392907,200713,true,1921237164,28,1891878224,-29358940
1652393041,200715,true,1920852974,28,1893392256,-27460718
1652393102,200716,true,1920660908,28,1894149727,-26511181
1652393228,200719,true,1920084825,28,1896423957,-23660868
1652393263,200721,true,1919700866,28,1896803261,-22897605
1652393417,200723,true,1919316983,28,1899460512,-19856471
1652393435,200723,true,1919316983,28,1899840423,-19476560
1652393437,200726,true,1918741303,28,1899840423,-18900880
1652393550,200727,true,1918549448,28,1902692179,-15857269
1652393587,200727,true,1918549448,28,1903263044,-15286404
1652393672,200728,true,1918357612,28,1904595728,-13761884
1652393916,200730,true,1917973998,28,1907454622,-10519376
1652394168,200731,true,1917782220,28,1910508840,-7273380
1652394171,200730,true,1917973998,28,1910508840,-7465158
1652394199,200730,true,1917973998,28,1910699891,-7274107
1652394220,200733,true,1917398721,28,1910890961,-6507760
1652394249,200734,true,1917207001,28,1911273158,-5933843
1652394425,200734,true,1917207001,28,1912420208,-4786793
1652394606,200735,true,1917015299,28,1912228986,-4786313
1652394644,200738,true,1916440310,28,1912037782,-4402528
1652394673,200739,true,1916248685,28,1912037782,-4210903
1652394728,200739,true,1916248685,28,1911655432,-4593253
1652394814,200741,true,1915865492,28,1910890961,-4974531
1652394944,200744,true,1915290848,28,1910317808,-4973040
1652394962,200746,true,1914907847,28,1910317808,-4590039
1652395014,200747,true,1914716375,28,1910126795,-4589580
1652395419,200748,true,1914524923,28,1908790241,-5734682
1652395436,200751,true,1913950680,28,1908599381,-5351299
1652395565,200753,true,1913567947,28,1907836132,-5731815
1652395599,200753,true,1913567947,28,1907645368,-5922579
1652395603,200754,true,1913376610,28,1907645368,-5731242
1652395702,200757,true,1912802712,28,1907454622,-5348090
1652395732,200755,true,1913185291,28,1907454622,-5730669
1652395742,200755,true,1913185291,28,1907454622,-5730669
1652395904,200756,true,1912993992,28,1907263896,-5730096
1652396051,200759,true,1912420208,28,1907263896,-5156312
1652396066,200758,true,1912611450,28,1907454622,-5156828
1652396093,200759,true,1912420208,28,1907454622,-4965586
1652396121,200760,true,1912228986,28,1907454622,-4774364
1652396250,200764,true,1911464285,28,1907645368,-3818917
1652396354,200763,true,1911655432,28,1907645368,-4010064
1652396370,200764,true,1911464285,28,1907645368,-3818917
1652396378,200765,true,1911273158,28,1907836132,-3437026
1652396427,200769,true,1910508840,28,1908026916,-2481924
1652396497,200767,true,1910890961,28,1908790241,-2100720
1652396535,200769,true,1910508840,28,1909172018,-1336822
1652396537,200770,true,1910317808,28,1909172018,-1145790
1652396542,200773,true,1909744827,28,1909362935,-381892
1652396554,200771,true,1910126795,28,1909553872,-572923
1652396586,200771,true,1910126795,28,1910126795,0
1652396751,200771,true,1910126795,28,1912802712,2675917
1652396763,200775,true,1909362935,28,1912993992,3631057
1652396786,200772,true,1909935802,28,1913567947,3632145
1652396803,200773,true,1909744827,28,1913950680,4205853
1652396902,200771,true,1910126795,28,1916057079,5930284
1652396929,200774,true,1909553872,28,1916631954,7078082
1652397169,200772,true,1909935802,28,1921813593,11877791
1652397221,200772,true,1909935802,28,1922966969,13031167
1652397409,200770,true,1910317808,28,1926816559,16498751
1652397819,200772,true,1909935802,28,1933958628,24022826
1652397904,200769,true,1910508840,28,1935506336,24997496
1652398220,200769,true,1910508840,28,1943069171,32560331
1652398221,200766,true,1911082050,28,1943069171,31987121
1652398253,200768,true,1910699891,28,1943652150,32952259
1652398405,200765,true,1911273158,28,1945596677,34323519
1652398490,200764,true,1911464285,28,1946569670,35105385
1652398531,200762,true,1911846597,28,1947153699,35307102
1652398557,200763,true,1911655432,28,1947543149,35887717
1652398575,200759,true,1912420208,28,1947737904,35317696
1652398940,200757,true,1912802712,28,1951832246,39029534
1652398991,200754,true,1913376610,28,1952613096,39236486
1652399006,200755,true,1913185291,28,1952808358,39623067
1652399023,200751,true,1913950680,28,1953003638,39052958
1652399246,200747,true,1914716375,28,1955935195,41218820
1652399327,200744,true,1915290848,28,1957109050,41818202
1652399651,200745,true,1915099338,28,1961223091,46123753
1652399797,200741,true,1915865492,28,1962596360,46730868
1652399836,200737,true,1916631954,28,1962988898,46356944
1652399867,200734,true,1917207001,28,1963185197,45978196
1652399938,200734,true,1917207001,28,1963381516,46174515
1652399952,200730,true,1917973998,28,1963381516,45407518
1652400134,200728,true,1918357612,28,1963970589,45612977
1652400187,200724,true,1919125071,28,1964166986,45041915
1652400333,200725,true,1918933177,28,1964559839,45626662
1652400414,200721,true,1919700866,28,1964166986,44466120
1652400441,200718,true,1920276834,28,1963970589,43693755
1652400443,200714,true,1921045060,28,1963970589,42925529
1652400482,200715,true,1920852974,28,1963774212,42921238
1652400488,200710,true,1921813593,28,1963774212,41960619
1652400554,200707,true,1922390195,28,1963381516,40991321
1652400655,200703,true,1923159266,28,1962596360,39437094
1652400755,200703,true,1923159266,28,1962203899,39044633
1652400933,200698,true,1924121038,28,1960634842,36513804
1652400962,200695,true,1924698332,28,1960242774,35544442
1652400976,200690,true,1925660874,28,1960242774,34581900
1652401036,200689,true,1925853440,28,1959458873,33605433
1652401053,200685,true,1926623897,28,1959262947,32639050
1652401056,200681,true,1927394662,28,1959262947,31868285
1652401303,200677,true,1928165735,28,1955153017,26987282
1652401414,200677,true,1928165735,28,1953394259,25228524
1652401440,200672,true,1929130011,28,1953003638,23873627
1652401767,200669,true,1929708808,28,1948711967,19003159
1652401786,200667,true,1930094769,28,1948517116,18422347
1652401830,200668,true,1929901779,28,1948322284,18420505
1652401832,200664,true,1930673855,28,1948322284,17648429
1652401863,200660,true,1931446241,28,1948127471,16681230
1652401929,200658,true,1931832549,28,1947932678,16100129
1652401936,200658,true,1931832549,28,1947932678,16100129
1652401952,200654,true,1932605398,28,1947932678,15327280
1652401970,200650,true,1933378556,28,1948127471,14748915
1652401987,200646,true,1934152024,28,1948127471,13975447
1652401991,200646,true,1934152024,28,1948127471,13975447
1652402011,200643,true,1934732327,28,1948322284,13589957
1652402012,200639,true,1935506336,28,1948322284,12815948
1652402038,200634,true,1936474283,28,1948517116,12042833
1652402045,200634,true,1936474283,28,1948711967,12237684
1652402047,200630,true,1937248989,28,1948711967,11462978
1652402066,200627,true,1937830222,28,1948711967,10881745
1652402108,200621,true,1938993211,28,1949101729,10108518
1652402229,200620,true,1939187110,28,1951051708,11864598
1652402320,200618,true,1939574967,28,1952222632,12647665
1652402420,200615,true,1940156898,28,1953784957,13628059
1652402466,200610,true,1941127170,28,1954371151,13243981
1652402496,200609,true,1941321283,28,1955153017,13831734
1652402511,200606,true,1941903737,28,1955348532,13444795
1652402518,200603,true,1942486367,28,1955348532,12862165
1652402583,200598,true,1943457804,28,1956522035,13064231
1652402635,200597,true,1943652150,28,1957304761,13652611
1652402654,200594,true,1944235304,28,1957500491,13265187
1652402661,200590,true,1945013115,28,1957696241,12683126
1652402723,200583,true,1946375032,28,1959067040,12692008
1652402736,200582,true,1946569670,28,1959262947,12693277
1652402875,200578,true,1947348415,28,1962988898,15640483
1652402969,200573,true,1948322284,28,1965738870,17416586
1652403280,200566,true,1949686518,28,1975394144,25707626
1652403302,200564,true,1950076475,28,1975986821,25910346
1652403326,200560,true,1950856623,28,1976777335,25920712
1652403417,200555,true,1951832246,28,1979942552,28110306
1652403444,200548,true,1953198939,28,1980932721,27733782
1652403461,200546,true,1953589598,28,1981527060,27937462
1652403551,200541,true,1954566588,28,1985096842,30530254
1652403787,200536,true,1955544067,28,1993052733,37508666
1652403820,200529,true,1956913359,28,1993650708,36737349
1652403902,200528,true,1957109050,28,1995445712,38336662
1652403998,200523,true,1958087800,28,1997641800,39554000
1652404011,200518,true,1959067040,28,1997841564,38774524
1652404050,200510,true,1960634842,28,1998840685,38205843
1652404076,200509,true,1960830906,28,1999640341,38809435
1652404241,200503,true,1962007698,28,2004445001,42437303
1652404430,200498,true,1962988898,28,2009060299,46071401
1652404456,200490,true,1964559839,28,2009663078,45103239
1652404481,200487,true,1965149266,28,2010065030,44915764
1652404605,200482,true,1966132037,28,2012277208,46145171
1652404625,200476,true,1967312012,28,2012679683,45367671
1652404648,200469,true,1968689543,28,2012880951,44191408
1652404714,200467,true,1969083301,28,2013686224,44602923
1652405276,200464,true,1969674085,28,2018120989,48446904
1652405421,200459,true,1970659119,28,2018524633,47865514
1652405451,200452,true,1972038994,28,2018524633,46485639
1652405468,200450,true,1972433422,28,2018524633,46091211
1652405538,200448,true,1972827928,28,2018524633,45696705
1652405857,200445,true,1973419836,28,2016103977,42684141
1652406374,200439,true,1974604184,28,2008256876,33652692
1652406518,200437,true,1974999124,28,2006851658,31852534
1652406523,200435,true,1975394144,28,2006851658,31457514
1652406740,200433,true,1975789242,28,2004845910,29056668
1652406757,200428,true,1976777335,28,2004845910,28068575
1652406804,200427,true,1976975012,28,2004445001,27469989
1652406947,200425,true,1977370427,28,2003643423,26272996
1652406954,200422,true,1977963697,28,2003643423,25679726
1652406970,200417,true,1978952877,28,2003443079,24490202
1652407006,200416,true,1979150772,28,2003443079,24292307
1652407031,200414,true,1979546622,28,2003242755,23696133
1652407105,200411,true,1980140546,28,2003242755,23102209
1652407354,200406,true,1981130814,28,2003242755,22111941
1652407371,200406,true,1981130814,28,2003443079,22312265
1652407437,200403,true,1981725213,28,2003843788,22118575
1652407504,200400,true,1982319790,28,2004244577,21924787
1652407518,200395,true,1983311148,28,2004445001,21133853
1652407584,200394,true,1983509479,28,2004645445,21135966
1652407721,200392,true,1983906201,28,2005647969,21741768
1652407864,200391,true,1984104591,28,2006650993,22546402
1652408028,200386,true,1985096842,28,2007855285,22758443
1652408039,200385,true,1985295352,28,2008056070,22760718
1652408108,200383,true,1985692431,28,2009060299,23367868
1652408281,200381,true,1986089589,28,2011271371,25181782
1652408358,200376,true,1987082832,28,2012478435,25395603
1652408469,200375,true,1987281541,28,2013887593,26606052
1652408498,200373,true,1987679017,28,2014491820,26812803
1652408523,200371,true,1988076573,28,2014894738,26818165
1652408719,200365,true,1989269717,28,2018726486,29456769
1652408737,200363,true,1989667591,28,2019130251,29462660
1652408767,200360,true,1990264551,28,2019736051,29471500
1652408794,200357,true,1990861690,28,2020342032,29480342
1652408800,200349,true,1992454937,28,2020342032,27887095
1652408844,200346,true,1993052733,28,2021554541,28501808
1652408996,200342,true,1993850074,28,2025196433,31346359
1652409000,200339,true,1994448288,28,2025398953,30950665
1652409088,200331,true,1996044406,28,2027628006,31583600
1652409135,200328,true,1996643279,28,2028844887,32201608
1652409161,200323,true,1997641800,28,2029453601,31811801
1652409205,200320,true,1998241153,28,2030468531,32227378
1652409255,200313,true,1999640341,28,2031483969,31843628
1652409302,200310,true,2000240293,28,2032296684,32056391
1652409441,200306,true,2001040509,28,2034940256,33899747
1652409637,200303,true,2001640882,28,2038402423,36761541
1652409759,200296,true,2003042451,28,2040849852,37807401
1652409776,200293,true,2003643423,28,2041053937,37410514
1652409793,200289,true,2004445001,28,2041462168,37017167
1652409854,200285,true,2005246899,28,2042687351,37440452
1652410003,200277,true,2006851658,28,2044526505,37674847
1652410011,200274,true,2007453774,28,2044526505,37072731
1652410142,200269,true,2008457702,28,2046367316,37909614
1652410445,200266,true,2009060299,28,2049234093,40173794
1652410577,200258,true,2010668110,28,2049848924,39180814
1652410609,200254,true,2011472498,28,2049848924,38376426
1652410656,200250,true,2012277208,28,2049848924,37571716
1652410753,200247,true,2012880951,28,2049643960,36763009
1652410768,200239,true,2014491820,28,2049643960,35152140
1652410782,200236,true,2015096228,28,2049643960,34547732
1652410846,200232,true,2015902387,28,2049643960,33741573
1652410875,200229,true,2016507218,28,2049643960,33136742
1652411018,200222,true,2017919197,28,2049848924,31929727
1652411051,200219,true,2018524633,28,2050053909,31529276
1652411052,200215,true,2019332164,28,2050053909,30721745
1652411129,200212,true,2019938024,28,2050463941,30525917
1652411146,200207,true,2020948195,28,2050668987,29720792
1652411148,200204,true,2021554541,28,2050668987,29114446
1652411160,200200,true,2022363284,28,2050874054,28510770
1652411219,200195,true,2023374668,28,2051694527,28319859
1652411306,200189,true,2024588996,28,2053336457,28747461
1652411400,200187,true,2024993934,28,2054979701,29985767
1652411450,200183,true,2025804053,28,2055801816,29997763
1652411457,200178,true,2026817158,28,2055801816,28984658
1652411464,200172,true,2028033552,28,2056007396,27973844
1652411548,200169,true,2028642023,28,2057447033,28805010
1652411570,200165,true,2029453601,28,2057858543,28404942
1652411650,200160,true,2030468531,28,2059299477,28830946
1652411828,200154,true,2031687117,28,2062803088,31115971
1652411958,200151,true,2032296684,28,2065486341,33189657
1652412211,200147,true,2033109725,28,2071070410,37960685
1652412221,200142,true,2034126483,28,2071277517,37151034
1652412249,200137,true,2035143750,28,2072106153,36962403
1652412310,200134,true,2035754354,28,2073557062,37802708
1652412417,200129,true,2036772434,28,2076669576,39897142
1652412493,200124,true,2037791024,28,2078539326,40748302
1652412533,200119,true,2038810124,28,2079370867,40560743
1652412599,200116,true,2039421828,28,2080826863,41405035
1652412792,200112,true,2040237719,28,2084158684,43920965
1652412814,200108,true,2041053937,28,2084575537,43521600
1652412897,200104,true,2041870481,28,2085826595,43956114
1652412927,200101,true,2042483103,28,2086243781,43760678
1652412955,200099,true,2042891620,28,2086452405,43560785
1652413002,200095,true,2043708899,28,2086869717,43160818
1652413053,200091,true,2044526505,28,2087078404,42551899
1652413254,200088,true,2045139925,28,2088122152,42982227
1652413712,200086,true,2045548973,28,2088330964,42781991
1652413727,200083,true,2046162699,28,2088330964,42168265
1652413735,200079,true,2046981287,28,2088330964,41349677
1652413742,200077,true,2047390704,28,2088330964,40940260
1652413840,200076,true,2047595443,28,2088539797,40944354
1652413856,200072,true,2048414604,28,2088539797,40125193
1652414221,200068,true,2049234093,28,2088957526,39723433
1652414388,200066,true,2049643960,28,2089166422,39522462
1652414430,200064,true,2050053909,28,2089166422,39112513
1652414436,200060,true,2050874054,28,2089166422,38292368
1652414457,200056,true,2051694527,28,2089166422,37471895
1652414474,200054,true,2052104886,28,2089166422,37061536
1652414512,200051,true,2052720579,28,2089166422,36445843
1652415032,200048,true,2053336457,28,2088539797,35203340
1652415062,200044,true,2054157915,28,2088539797,34381882
1652415650,200042,true,2054568767,28,2087287112,32718345
1652415654,200038,true,2055390717,28,2087287112,31896395
1652415888,200034,true,2056212997,28,2085618033,29405036
1652416220,200030,true,2057035606,28,2082908627,25873021
1652416288,200028,true,2057447033,28,2082492107,25045074
1652416491,200025,true,2058064329,28,2081659319,23594990
1652416591,200021,true,2058887678,28,2081243049,22355371
1652416747,200016,true,2059917328,28,2080410760,20493432
1652416845,200014,true,2060329332,28,2079786762,19457430
1652417226,200012,true,2060741419,28,2077915889,17174470
1652417310,200008,true,2061565839,28,2077500368,15934529
1652417363,200004,true,2062390589,28,2077292639,14902050
1652417408,200002,true,2062803088,28,2077084931,14281843
1652417450,200000,true,2063215669,28,2077084931,13869262
1652417655,199996,true,2064041079,28,2076669576,12628497
1652417832,199992,true,2064866819,28,2076461930,11595111
1652417875,199990,true,2065279813,28,2076461930,11182117
1652417952,199988,true,2065692890,28,2076461930,10769040
1652418413,199985,true,2066312660,28,2076669576,10356916
1652418453,199981,true,2067139309,28,2076877243,9737934
1652418471,199979,true,2067552757,28,2077084931,9532174
1652418492,199977,true,2067966289,28,2077084931,9118642
1652418528,199972,true,2069000479,28,2077500368,8499889
1652418566,199967,true,2070035186,28,2077915889,7880703
1652418581,199965,true,2070449213,28,2078123681,7674468
1652418584,199963,true,2070863324,28,2078123681,7260357
1652418593,199959,true,2071691794,28,2078331493,6639699
1652418782,199954,true,2072727847,28,2081243049,8515202
1652418812,199952,true,2073142413,28,2081867485,8725072
1652418822,199950,true,2073557062,28,2082075671,8518609
1652418847,199945,true,2074594048,28,2082492107,7898059
1652418852,199942,true,2075216489,28,2082492107,7275618
1652418968,199940,true,2075631553,28,2084575537,8943984
1652418981,199938,true,2076046700,28,2084783994,8737294
1652418985,199934,true,2076877243,28,2084992473,8115230
1652419031,199930,true,2077708118,28,2086035178,8327060
1652419052,199928,true,2078123681,28,2086452405,8328724
1652419064,199927,true,2078331493,28,2086661051,8329558
1652419176,199924,true,2078955055,28,2089166422,10211367
1652419251,199920,true,2079786762,28,2090838340,11051578
1652419322,199918,true,2080202740,28,2092511596,12308856
1652419364,199917,true,2080410760,28,2093348726,12937966
1652419509,199913,true,2081243049,28,2096910267,15667218
1652419567,199909,true,2082075671,28,2098378545,16302874
1652419578,199907,true,2082492107,28,2098588383,16096276
1652419823,199905,true,2082908627,28,2104472370,21563743
1652419877,199900,true,2083950289,28,2105735369,21785080
1652419983,199896,true,2084783994,28,2108263642,23479648
1652420011,199894,true,2085200972,28,2108896184,23695212
1652420074,199893,true,2085409492,28,2109950843,24541351
1652420554,199889,true,2086243781,28,2116501512,30257731
1652420608,199885,true,2087078404,28,2116924833,29846429
1652420703,199883,true,2087495840,28,2117559974,30064134
1652420760,199881,true,2087913360,28,2117983507,30070147
1652420858,199877,true,2088748651,28,2118195305,29446654
1652420887,199873,true,2089584276,28,2118195305,28611029
1652420944,199870,true,2090211214,28,2118407125,28195911
1652420963,199869,true,2090420235,28,2118618966,28198731
1652421035,199864,true,2091465654,28,2119042711,27577057
1652421055,199860,true,2092302366,28,2119254615,26952249
1652421085,199857,true,2092930119,28,2119466540,26536421
1652421096,199856,true,2093139412,28,2119466540,26327128
1652421110,199852,true,2093976794,28,2119466540,25489746
1652421163,199849,true,2094605050,28,2119466540,24861490
1652421178,199847,true,2095023991,28,2119466540,24442549
1652421241,199846,true,2095233494,28,2119042711,23809217
1652421242,199843,true,2095862127,28,2119042711,23180584
1652421261,199840,true,2096490948,28,2119042711,22551763
1652421302,199838,true,2096910267,28,2118830828,21920561
1652421366,199838,true,2096910267,28,2118195305,21285038
1652421404,199836,true,2097329670,28,2117983507,20653837
1652421410,199834,true,2097749157,28,2117771730,20022573
1652421550,199833,true,2097958932,28,2116289883,18330951
1652421643,199834,true,2097749157,28,2115232055,17482898
1652421741,199832,true,2098168728,28,2114386174,16217446
1652421793,199830,true,2098588383,28,2113751985,15163602
1652421831,199829,true,2098798242,28,2113540631,14742389
1652422018,199829,true,2098798242,28,2113117986,14319744
1652422270,199827,true,2099218022,28,2112695426,13477404
1652422306,199825,true,2099637887,28,2112695426,13057539
1652422314,199825,true,2099637887,28,2112484177,12846290
1652422484,199825,true,2099637887,28,2112061744,12423857
1652422535,199823,true,2100057836,28,2111639395,11581559
1652422568,199822,true,2100267841,28,2111428252,11160411
1652422625,199822,true,2100267841,28,2111217130,10949289
1652422629,199823,true,2100057836,28,2111217130,11159294
1652422675,199822,true,2100267841,28,2110794950,10527109
1652422777,199821,true,2100477868,28,2109528916,9051048
1652422977,199821,true,2100477868,28,2106999126,6521258
1652423005,199822,true,2100267841,28,2106577790,6309949
1652423161,199820,true,2100687916,28,2105524817,4836901
1652423363,199819,true,2100897985,28,2105103775,4205790
1652423555,199819,true,2100897985,28,2104261944,3363959
1652423716,199820,true,2100687916,28,2103420449,2732533
1652423895,199818,true,2101108075,28,2102369055,1260980
1652424015,199817,true,2101318185,28,2101528317,210132
1652424242,199817,true,2101318185,28,2100267841,-1050344
1652424272,199817,true,2101318185,28,2100057836,-1260349
1652424484,199815,true,2101738470,28,2099427944,-2310526
1652424774,199814,true,2101948644,28,2099427944,-2520700
1652424845,199814,true,2101948644,28,2099218022,-2730622
1652424896,199815,true,2101738470,28,2099218022,-2520448
1652425256,199814,true,2101948644,28,2097749157,-4199487
1652425276,199814,true,2101948644,28,2097749157,-4199487
1652425386,199815,true,2101738470,28,2097119959,-4618511
1652425456,199816,true,2101528317,28,2096490948,-5037369
1652425540,199816,true,2101528317,28,2095862127,-5666190
1652425542,199816,true,2101528317,28,2095862127,-5666190
1652425668,199817,true,2101318185,28,2093976794,-7341391
1652425690,199818,true,2101108075,28,2093767417,-7340658
1652425835,199817,true,2101318185,28,2091883968,-9434217
1652425847,199818,true,2101108075,28,2091674801,-9433274
1652425889,199818,true,2101108075,28,2091256528,-9851547
1652426114,199818,true,2101108075,28,2088957526,-12150549
1652426171,199817,true,2101318185,28,2088539797,-12778388
1652426374,199817,true,2101318185,28,2086661051,-14657134
1652426503,199817,true,2101318185,28,2085409492,-15908693
1652426566,199818,true,2101108075,28,2084783994,-16324081
1652426750,199817,true,2101318185,28,2083533562,-17784623
1652426796,199816,true,2101528317,28,2083325229,-18203088
1652427119,199816,true,2101528317,28,2081451174,-20077143
1652427472,199817,true,2101318185,28,2080202740,-21115445
1652427587,199816,true,2101528317,28,2079994740,-21533577
1652427745,199816,true,2101528317,28,2079786762,-21741555
1652427853,199816,true,2101528317,28,2079370867,-22157450
1652427915,199817,true,2101318185,28,2078955055,-22363130
1652427932,199816,true,2101528317,28,2078747180,-22781137
1652427966,199817,true,2101318185,28,2078539326,-22778859
1652428014,199818,true,2101108075,28,2078123681,-22984394
1652428161,199819,true,2100897985,28,2076461930,-24436055
1652428299,199819,true,2100897985,28,2075008988,-25888997
1652428340,199819,true,2100897985,28,2074386609,-26511376
1652428413,199821,true,2100477868,28,2073557062,-26920806
1652428546,199822,true,2100267841,28,2071898963,-28368878
1652428563,199824,true,2099847851,28,2071691794,-28156057
1652428591,199825,true,2099637887,28,2071277517,-28360370
1652428726,199827,true,2099218022,28,2069207379,-30010643
1652428742,199829,true,2098798242,28,2069000479,-29797763
1652428778,199831,true,2098378545,28,2068379903,-29998642
1652428789,199833,true,2097958932,28,2068173085,-29785847
1652429069,199836,true,2097329670,28,2064041079,-33288591
1652429100,199838,true,2096910267,28,2063628333,-33281934
1652429105,199840,true,2096490948,28,2063628333,-32862615
1652429123,199842,true,2096071713,28,2063421991,-32649722
1652430082,199844,true,2095652562,28,2055185199,-40467363
1652430310,199847,true,2095023991,28,2054568767,-40455224
1652430522,199848,true,2094814510,28,2054979701,-39834809
1652430808,199851,true,2094186191,28,2056212997,-37973194
1652431120,199854,true,2093558061,28,2057035606,-36522455
1652431256,199856,true,2093139412,28,2057035606,-36103806
1652431290,199858,true,2092720847,28,2057035606,-35685241
1652431296,199861,true,2092093157,28,2057035606,-35057551
1652431314,199864,true,2091465654,28,2057241309,-34224345
1652431355,199866,true,2091047424,28,2057447033,-33600391
1652431573,199868,true,2090629277,28,2058475963,-32153314
1652431710,199870,true,2090211214,28,2059299477,-30911737
1652431746,199873,true,2089584276,28,2059505406,-30078870
1652431867,199875,true,2089166422,28,2060123320,-29043102
1652432404,199877,true,2088748651,28,2062390589,-26358062
1652432469,199880,true,2088122152,28,2062596828,-25525324
1652432705,199883,true,2087495840,28,2063628333,-23867507
1652432713,199885,true,2087078404,28,2063834696,-23243708
1652432813,199885,true,2087078404,28,2064660353,-22418051
1652432909,199888,true,2086452405,28,2065486341,-20966064
1652433082,199890,true,2086035178,28,2066932616,-19102562
1652433132,199892,true,2085618033,28,2067346023,-18272010
1652433140,199893,true,2085409492,28,2067346023,-18063469
1652433309,199895,true,2084992473,28,2068586741,-16405732
1652433332,199898,true,2084367100,28,2068586741,-15780359
1652433568,199899,true,2084158684,28,2070656258,-13502426
1652433677,199901,true,2083741915,28,2071691794,-12050121
1652433926,199903,true,2083325229,28,2074179191,-9146038
1652433990,199905,true,2082908627,28,2074801507,-8107120
1652434048,199906,true,2082700357,28,2075631553,-7068804
1652434054,199908,true,2082283879,28,2075631553,-6652326
1652434110,199908,true,2082283879,28,2076461930,-5821949
1652434123,199910,true,2081867485,28,2076669576,-5197909
1652434308,199911,true,2081659319,28,2078747180,-2912139
1652434315,199913,true,2081243049,28,2078747180,-2495869
1652434323,199913,true,2081243049,28,2078747180,-2495869
1652434347,199915,true,2080826863,28,2079162950,-1663913
1652434658,199916,true,2080618801,28,2081451174,832373
1652434728,199917,true,2080410760,28,2081867485,1456725
1652434796,199917,true,2080410760,28,2082075671,1664911
1652434865,199919,true,2079994740,28,2082492107,2497367
1652435235,199920,true,2079786762,28,2082492107,2705345
1652435384,199921,true,2079578804,28,2082075671,2496867
1652435789,199922,true,2079370867,28,2078955055,-415812
1652436301,199924,true,2078955055,28,2074594048,-4361007
1652436324,199926,true,2078539326,28,2074386609,-4152717
1652436396,199928,true,2078123681,28,2073764418,-4359263
1652436548,199929,true,2077915889,28,2072313363,-5602526
1652436578,199932,true,2077292639,28,2072106153,-5186486
1652436660,199934,true,2076877243,28,2071277517,-5599726
1652437424,199936,true,2076461930,28,2065899459,-10562471
1652438178,199937,true,2076254304,28,2063009368,-13244936
1652438223,199939,true,2075839116,28,2063009368,-12829748
1652438294,199941,true,2075424010,28,2063215669,-12208341
1652438324,199943,true,2075008988,28,2063215669,-11793319
1652438669,199943,true,2075008988,28,2065073306,-9935682
1652438706,199944,true,2074801507,28,2065279813,-9521694
1652438723,199946,true,2074386609,28,2065486341,-8900268
1652438744,199948,true,2073971794,28,2065692890,-8278904
1652438783,199947,true,2074179191,28,2065899459,-8279732
1652438804,199948,true,2073971794,28,2066106049,-7865745
1652438821,199950,true,2073557062,28,2066312660,-7244402
1652438872,199951,true,2073349727,28,2066725943,-6623784
1652438909,199950,true,2073557062,28,2067139309,-6417753
1652439023,199951,true,2073349727,28,2068793599,-4556128
1652439057,199953,true,2072935119,28,2069207379,-3727740
1652439167,199953,true,2072935119,28,2071277517,-1657602
1652439319,199952,true,2073142413,28,2073971794,829381
1652439403,199952,true,2073142413,28,2075216489,2074076
1652439491,199953,true,2072935119,28,2077084931,4149812
1652440043,199953,true,2072935119,28,2088330964,15395845
1652440474,199950,true,2073557062,28,2095023991,21466929
1652440479,199950,true,2073557062,28,2095233494,21676432
1652440512,199951,true,2073349727,28,2095652562,22302835
1652440544,199950,true,2073557062,28,2096071713,22514651
1652440551,199948,true,2073971794,28,2096071713,22099919
1652440585,199948,true,2073971794,28,2096281320,22309526
1652440859,199950,true,2073557062,28,2096490948,22933886
1652441104,199949,true,2073764418,28,2095023991,21259573
1652441171,199947,true,2074179191,28,2094605050,20425859
1652441226,199947,true,2074179191,28,2093976794,19797603
1652441400,199949,true,2073764418,28,2092093157,18328739
1652441406,199949,true,2073764418,28,2092093157,18328739
1652441427,199947,true,2074179191,28,2091883968,17704777
1652441542,199947,true,2074179191,28,2091047424,16868233
1652441753,199949,true,2073764418,28,2089375338,15610920
1652441783,199948,true,2073971794,28,2088957526,14985732
1652441953,199947,true,2074179191,28,2087704590,13525399
1652442283,199946,true,2074386609,28,2084992473,10605864
1652442449,199948,true,2073971794,28,2084783994,10812200
1652442538,199947,true,2074179191,28,2084783994,10604803
1652442551,199945,true,2074594048,28,2084783994,10189946
1652442611,199944,true,2074801507,28,2084992473,10190966
1652442621,199946,true,2074386609,28,2084992473,10605864
1652442667,199944,true,2074801507,28,2085200972,10399465
1652442762,199941,true,2075424010,28,2085826595,10402585
1652442779,199940,true,2075631553,28,2086035178,10403625
1652442793,199940,true,2075631553,28,2086243781,10612228
1652442858,199938,true,2076046700,28,2086869717,10823017
1652442869,199935,true,2076669576,28,2087078404,10408828
1652443112,199933,true,2077084931,28,2090002214,12917283
1652443123,199933,true,2077084931,28,2090211214,13126283
1652443642,199930,true,2077708118,28,2096910267,19202149
1652443694,199927,true,2078331493,28,2097539403,19207910
1652443729,199924,true,2078955055,28,2097958932,19003877
1652443863,199924,true,2078955055,28,2099218022,20262967
1652444103,199922,true,2079370867,28,2101318185,21947318
1652444186,199918,true,2080202740,28,2102158839,21956099
1652444274,199915,true,2080826863,28,2102999828,22172965
1652444611,199914,true,2081034946,28,2106788447,25753501
1652444691,199911,true,2081659319,28,2107209826,25550507
1652445018,199908,true,2082283879,28,2108474468,26190589
1652445059,199905,true,2082908627,28,2108685316,25776689
1652445090,199904,true,2083116917,28,2108685316,25568399
1652445186,199901,true,2083741915,28,2109317984,25576069
1652445274,199897,true,2084575537,28,2109950843,25375306
1652445278,199894,true,2085200972,28,2109950843,24749871
1652445289,199894,true,2085200972,28,2110161838,24960866
1652445569,199890,true,2086035178,28,2112906695,26871517
1652445590,199886,true,2086869717,28,2113117986,26248269
1652445598,199883,true,2087495840,28,2113117986,25622146
1652445616,199883,true,2087495840,28,2113329298,25833458
1652445662,199881,true,2087913360,28,2113540631,25627271
1652445669,199877,true,2088748651,28,2113751985,25003334
1652445683,199874,true,2089375338,28,2113751985,24376647
1652446176,199876,true,2088957526,28,2114809072,25851546
1652446464,199874,true,2089375338,28,2114174756,24799418
1652446614,199869,true,2090420235,28,2114174756,23754521
1652446672,199867,true,2090838340,28,2114174756,23336416
1652446725,199868,true,2090629277,28,2114386174,23756897
1652446828,199866,true,2091047424,28,2114386174,23338750
1652447026,199862,true,2091883968,28,2113963360,22079392
1652447170,199860,true,2092302366,28,2113540631,21238265
1652447181,199861,true,2092093157,28,2113540631,21447474
1652447263,199859,true,2092511596,28,2112695426,20183830
1652447439,199856,true,2093139412,28,2110794950,17655538
1652447550,199855,true,2093348726,28,2110161838,16813112
1652447557,199856,true,2093139412,28,2110161838,17022426
1652447610,199855,true,2093348726,28,2109739869,16391143
1652447690,199853,true,2093767417,28,2109317984,15550567
1652447809,199852,true,2093976794,28,2108263642,14286848
1652448180,199855,true,2093348726,28,2104893285,11544559
1652448220,199854,true,2093558061,28,2104682817,11124756
1652448646,199852,true,2093976794,28,2100057836,6081042
1652448656,199852,true,2093976794,28,2100057836,6081042
1652448676,199853,true,2093767417,28,2099847851,6080434
1652448713,199852,true,2093976794,28,2099847851,5871057
1652448755,199848,true,2094814510,28,2099637887,4823377
1652448780,199848,true,2094814510,28,2099427944,4613434
1652448800,199849,true,2094605050,28,2099427944,4822894
1652448805,199848,true,2094814510,28,2099427944,4613434
1652448860,199845,true,2095443017,28,2098798242,3355225
1652448865,199845,true,2095443017,28,2098798242,3355225
1652448882,199846,true,2095233494,28,2098378545,3145051
1652448927,199846,true,2095233494,28,2097749157,2515663
1652448955,199843,true,2095862127,28,2097119959,1257832
1652448969,199843,true,2095862127,28,2096910267,1048140
1652448986,199844,true,2095652562,28,2096700597,1048035
1652448994,199842,true,2096071713,28,2096700597,628884
1652449026,199839,true,2096700597,28,2096490948,-209649
1652449152,199837,true,2097119959,28,2096281320,-838639
1652449221,199838,true,2096910267,28,2096281320,-628947
1652449237,199836,true,2097329670,28,2096281320,-1048350
1652449250,199833,true,2097958932,28,2096281320,-1677612
1652449286,199831,true,2098378545,28,2096281320,-2097225
1652449319,199831,true,2098378545,28,2096281320,-2097225
1652449354,199829,true,2098798242,28,2096281320,-2516922
1652449376,199827,true,2099218022,28,2096490948,-2727074
1652449436,199825,true,2099637887,28,2096700597,-2937290
1652449566,199825,true,2099637887,28,2097539403,-2098484
1652449719,199823,true,2100057836,28,2099218022,-839814
1652449979,199821,true,2100477868,28,2101948644,1470776
1652450037,199819,true,2100897985,28,2102579291,1681306
1652450075,199819,true,2100897985,28,2102999828,2101843
1652450082,199817,true,2101318185,28,2103210128,1891943
1652450120,199815,true,2101738470,28,2103630791,1892321
1652450135,199813,true,2102158839,28,2104051539,1892700
1652450178,199813,true,2102158839,28,2104682817,2523978
1652450277,199812,true,2102369055,28,2106367153,3998098
1652450366,199809,true,2102999828,28,2107842052,4842224
1652450548,199807,true,2103420449,28,2110161838,6741389
1652450591,199808,true,2103210128,28,2110583892,7373764
1652450746,199807,true,2103420449,28,2114174756,10754307
1652451160,199804,true,2104051539,28,2121162707,17111168
1652451188,199802,true,2104472370,28,2121586961,17114591
1652451236,199803,true,2104261944,28,2122011300,17749356
1652451312,199802,true,2104472370,28,2122647967,18175597
1652451354,199799,true,2105103775,28,2123072517,17968742
1652451392,199797,true,2105524817,28,2123284825,17760008
1652451428,199797,true,2105524817,28,2123497153,17972336
1652451478,199795,true,2105945943,28,2123709503,17763560
1652451508,199793,true,2106367153,28,2123921874,17554721
1652451614,199791,true,2106788447,28,2124346679,17558232
1652451685,199790,true,2106999126,28,2124559114,17559988
1652451714,199789,true,2107209826,28,2124559114,17349288
1652451747,199787,true,2107631289,28,2124771570,17140281
1652451777,199785,true,2108052837,28,2124771570,16718733
1652451782,199785,true,2108052837,28,2124771570,16718733
1652451793,199783,true,2108474468,28,2124984047,16509579
1652451829,199780,true,2109107074,28,2125196546,16089472
1652451934,199778,true,2109528916,28,2125621606,16092690
1652451972,199778,true,2109528916,28,2125834168,16305252
1652452000,199776,true,2109950843,28,2125834168,15883325
1652452002,199773,true,2110583892,28,2125834168,15250276
1652452233,199770,true,2111217130,28,2127535431,16318301
1652452286,199769,true,2111428252,28,2127960959,16532707
1652452326,199769,true,2111428252,28,2128173755,16745503
1652452421,199766,true,2112061744,28,2128386573,16324829
1652452491,199763,true,2112695426,28,2128386573,15691147
1652452590,199763,true,2112695426,28,2128599412,15903986
1652452620,199762,true,2112906695,28,2128599412,15692717
1652452847,199760,true,2113329298,28,2129238055,15908757
1652453045,199758,true,2113751985,28,2130089878,16337893
1652453107,199758,true,2113751985,28,2130515917,16763932
1652453122,199758,true,2113751985,28,2130728969,16976984
1652453147,199756,true,2114174756,28,2130728969,16554213
1652453800,199754,true,2114597612,28,2134354108,19756496
1652454006,199753,true,2114809072,28,2133713929,18904857
1652454050,199753,true,2114809072,28,2133500579,18691507
1652454091,199751,true,2115232055,28,2133287251,18055196
1652454097,199749,true,2115655123,28,2133287251,17632128
1652454130,199750,true,2115443578,28,2133287251,17843673
1652454155,199750,true,2115443578,28,2133073943,17630365
1652454204,199748,true,2115866688,28,2132860657,16993969
1652454267,199747,true,2116078275,28,2132434149,16355874
1652454278,199748,true,2115866688,28,2132434149,16567461
1652454347,199749,true,2115655123,28,2131794547,16139424
1652454882,199748,true,2115866688,28,2126684630,10817942
1652454956,199747,true,2116078275,28,2126046752,9968477
1652454977,199749,true,2115655123,28,2125834168,10179045
1652455327,199750,true,2115443578,28,2121799120,6355542
1652455403,199750,true,2115443578,28,2120950612,5507034
1652455451,199750,true,2115443578,28,2120314454,4870876
1652455482,199751,true,2115232055,28,2120102444,4870389
1652455490,199751,true,2115232055,28,2119890455,4658400
1652455520,199751,true,2115232055,28,2119466540,4234485
1652455525,199751,true,2115232055,28,2119466540,4234485
1652455922,199751,true,2115232055,28,2113751985,-1480070
1652455936,199752,true,2115020553,28,2113540631,-1479922
1652455939,199752,true,2115020553,28,2113540631,-1479922
1652455972,199752,true,2115020553,28,2113117986,-1902567
1652456150,199754,true,2114597612,28,2110583892,-4013720
1652456203,199755,true,2114386174,28,2109950843,-4435331
1652456353,199755,true,2114386174,28,2108052837,-6333337
1652456496,199755,true,2114386174,28,2106367153,-8019021
1652456537,199757,true,2113963360,28,2105735369,-8227991
1652456709,199758,true,2113751985,28,2102999828,-10752157
1652456783,199758,true,2113751985,28,2101528317,-12223668
1652456808,199758,true,2113751985,28,2101108075,-12643910
1652456953,199760,true,2113329298,28,2099218022,-14111276
1652456977,199761,true,2113117986,28,2099008122,-14109864
1652457002,199760,true,2113329298,28,2098588383,-14740915
1652457235,199759,true,2113540631,28,2095862127,-17678504
1652457409,199760,true,2113329298,28,2094186191,-19143107
1652457476,199762,true,2112906695,28,2093558061,-19348634
1652457540,199761,true,2113117986,28,2092930119,-20187867
1652457562,199760,true,2113329298,28,2092720847,-20608451
1652457591,199761,true,2113117986,28,2092511596,-20606390
1652457732,199763,true,2112695426,28,2091047424,-21648002
1652457964,199764,true,2112484177,28,2090211214,-22272963
1652458024,199763,true,2112695426,28,2090002214,-22693212
1652458046,199764,true,2112484177,28,2090002214,-22481963
1652458121,199765,true,2112272950,28,2090211214,-22061736
1652458238,199764,true,2112484177,28,2090420235,-22063942
1652458738,199762,true,2112906695,28,2093558061,-19348634
1652458756,199764,true,2112484177,28,2093767417,-18716760
1652458796,199764,true,2112484177,28,2093976794,-18507383
1652458840,199763,true,2112695426,28,2094186191,-18509235
1652458952,199761,true,2113117986,28,2094395610,-18722376
1652459005,199763,true,2112695426,28,2094395610,-18299816
1652459020,199763,true,2112695426,28,2094395610,-18299816
1652459070,199763,true,2112695426,28,2094186191,-18509235
1652459099,199763,true,2112695426,28,2094186191,-18509235
1652459115,199765,true,2112272950,28,2093976794,-18296156
1652459188,199766,true,2112061744,28,2093558061,-18503683
1652459204,199766,true,2112061744,28,2093558061,-18503683
1652459224,199767,true,2111850559,28,2093348726,-18501833
1652459266,199769,true,2111428252,28,2093139412,-18288840
1652459363,199771,true,2111006030,28,2092093157,-18912873
1652459400,199771,true,2111006030,28,2091883968,-19122062
1652459402,199772,true,2110794950,28,2091883968,-18910982
1652459470,199775,true,2110161838,28,2091256528,-18905310
1652459517,199778,true,2109528916,28,2090629277,-18899639
1652459655,199778,true,2109528916,28,2089166422,-20362494
1652459659,199780,true,2109107074,28,2089166422,-19940652
1652459686,199783,true,2108474468,28,2088748651,-19725817
1652459746,199785,true,2108052837,28,2087704590,-20348247
1652459760,199788,true,2107420547,28,2087495840,-19924707
1652459794,199790,true,2106999126,28,2086869717,-20129409
1652459907,199794,true,2106156537,28,2084367100,-21789437
1652459928,199797,true,2105524817,28,2083950289,-21574528
1652459932,199799,true,2105103775,28,2083741915,-21361860
1652460124,199800,true,2104893285,28,2079994740,-24898545
1652460187,199804,true,2104051539,28,2078955055,-25096484
1652460292,199807,true,2103420449,28,2077084931,-26335518
1652460311,199810,true,2102789549,28,2076669576,-26119973
1652460690,199811,true,2102579291,28,2069621241,-32958050
1652460695,199815,true,2101738470,28,2069621241,-32117229
1652460917,199818,true,2101108075,28,2066725943,-34382132
1652461048,199820,true,2100687916,28,2065486341,-35201575
1652461108,199821,true,2100477868,28,2065692890,-34784978
1652461133,199824,true,2099847851,28,2065692890,-34154961
1652461143,199827,true,2099218022,28,2065692890,-33525132
1652461191,199828,true,2099008122,28,2065692890,-33315232
1652461206,199829,true,2098798242,28,2065692890,-33105352
1652461621,199833,true,2097958932,28,2066725943,-31232989
1652461637,199835,true,2097539403,28,2066725943,-30813460
1652461868,199836,true,2097329670,28,2067759513,-29570157
1652461956,199837,true,2097119959,28,2067966289,-29153670
1652462028,199841,true,2096281320,28,2067966289,-28315031
1652462045,199844,true,2095652562,28,2067966289,-27686273
1652462055,199846,true,2095233494,28,2067966289,-27267205
1652462081,199847,true,2095023991,28,2068173085,-26850906
1652462186,199849,true,2094605050,28,2069414299,-25190751
1652462295,199852,true,2093976794,28,2070449213,-23527581
1652462296,199853,true,2093767417,28,2070449213,-23318204
1652462424,199856,true,2093139412,28,2071484645,-21654767
1652462470,199858,true,2092720847,28,2071691794,-21029053
1652463359,199862,true,2091883968,28,2074594048,-17289920
1652463549,199864,true,2091465654,28,2075216489,-16249165
1652463684,199866,true,2091047424,28,2075631553,-15415871
1652463847,199868,true,2090629277,28,2076046700,-14582577
1652463863,199872,true,2089793234,28,2076046700,-13746534
1652463942,199874,true,2089375338,28,2075631553,-13743785
1652463947,199876,true,2088957526,28,2075631553,-13325973
1652463970,199879,true,2088330964,28,2075424010,-12906954
1652464050,199883,true,2087495840,28,2074594048,-12901792
1652464063,199886,true,2086869717,28,2074386609,-12483108
1652464064,199888,true,2086452405,28,2074386609,-12065796
1652464082,199891,true,2085826595,28,2074179191,-11647404
1652464168,199896,true,2084783994,28,2073142413,-11641581
1652464212,199898,true,2084367100,28,2072727847,-11639253
1652464256,199900,true,2083950289,28,2072313363,-11636926
1652464432,199902,true,2083533562,28,2070863324,-12670238
1652464641,199908,true,2082283879,28,2069000479,-13283400
1652464678,199910,true,2081867485,28,2068793599,-13073886
1652464712,199911,true,2081659319,28,2068379903,-13279416
1652464721,199914,true,2081034946,28,2068379903,-12655043
1652464733,199918,true,2080202740,28,2068173085,-12029655
1652464806,199920,true,2079786762,28,2067552757,-12234005
1652464887,199922,true,2079370867,28,2066725943,-12644924
1652464914,199924,true,2078955055,28,2066312660,-12642395
1652464950,199929,true,2077915889,28,2065899459,-12016430
1652464956,199930,true,2077708118,28,2065692890,-12015228
1652465053,199933,true,2077084931,28,2064247483,-12837448
1652465141,199936,true,2076461930,28,2062184371,-14277559
1652465159,199941,true,2075424010,28,2061771996,-13652014
1652465173,199942,true,2075216489,28,2061565839,-13650650
1652465197,199946,true,2074386609,28,2060947493,-13439116
1652465200,199948,true,2073971794,28,2060947493,-13024301
1652465212,199953,true,2072935119,28,2060741419,-12193700
1652465237,199954,true,2072727847,28,2060123320,-12604527
1652465302,199957,true,2072106153,28,2059093567,-13012586
1652465360,199958,true,2071898963,28,2058064329,-13834634
1652465410,199962,true,2071070410,28,2057241309,-13829101
1652465422,199963,true,2070863324,28,2057035606,-13827718
1652465514,199965,true,2070449213,28,2055801816,-14647397
1652465832,199966,true,2070242189,28,2052310096,-17932093
1652466294,199969,true,2069621241,28,2050874054,-18747187
1652466378,199970,true,2069414299,28,2050463941,-18950358
1652466411,199971,true,2069207379,28,2050258915,-18948464
1652466430,199971,true,2069207379,28,2050258915,-18948464
1652466444,199975,true,2068379903,28,2050053909,-18325994
1652466688,199977,true,2067966289,28,2047800202,-20166087
1652466694,199979,true,2067552757,28,2047800202,-19752555
1652466828,199980,true,2067346023,28,2047595443,-19750580
1652466860,199983,true,2066725943,28,2047800202,-18925741
1652466941,199984,true,2066519291,28,2048824307,-17694984
1652467080,199985,true,2066312660,28,2050258915,-16053745
1652467147,199985,true,2066312660,28,2050668987,-15643673
1652467199,199989,true,2065486341,28,2051079141,-14407200
1652467462,199990,true,2065279813,28,2051489378,-13790435
1652467889,199991,true,2065073306,28,2052104886,-12968420
1652467943,199991,true,2065073306,28,2052310096,-12763210
1652467975,199995,true,2064247483,28,2052515327,-11732156
1652468156,199997,true,2063834696,28,2053952519,-9882177
1652468177,199997,true,2063834696,28,2053952519,-9882177
1652468289,199997,true,2063834696,28,2055596257,-8238439
1652468673,200000,true,2063215669,28,2061565839,-1649830
1652468688,200001,true,2063009368,28,2061771996,-1237372
1652468740,200001,true,2063009368,28,2062184371,-824997
1652468877,200000,true,2063215669,28,2063215669,0
1652469198,200004,true,2062390589,28,2065692890,3302301
1652469241,200005,true,2062184371,28,2066106049,3921678
1652469290,200004,true,2062390589,28,2066519291,4128702
1652469353,200003,true,2062596828,28,2066932616,4335788
1652469375,200006,true,2061978173,28,2067139309,5161136
1652469499,200007,true,2061771996,28,2067759513,5987517
1652469715,200006,true,2061978173,28,2069207379,7229206
1652469758,200005,true,2062184371,28,2069207379,7023008
1652469828,200008,true,2061565839,28,2069414299,7848460
1652470028,200008,true,2061565839,28,2069414299,7848460
1652470372,200007,true,2061771996,28,2069000479,7228483
1652470413,200006,true,2061978173,28,2069000479,7022306
1652470472,200008,true,2061565839,28,2068793599,7227760
1652470553,200008,true,2061565839,28,2068586741,7020902
1652470580,200008,true,2061565839,28,2068586741,7020902
1652470724,200006,true,2061978173,28,2067759513,5781340
1652470960,200009,true,2061359703,28,2066725943,5366240
1652471079,200009,true,2061359703,28,2066312660,4952957
1652471303,200007,true,2061771996,28,2065899459,4127463
1652471563,200006,true,2061978173,28,2064866819,2888646
1652471790,200008,true,2061565839,28,2063421991,1856152
1652471832,200008,true,2061565839,28,2063215669,1649830
1652472094,200008,true,2061565839,28,2061565839,0
1652472139,200007,true,2061771996,28,2061359703,-412293
1652472264,200010,true,2061153588,28,2060947493,-206095
1652472278,200009,true,2061359703,28,2060741419,-618284
1652472329,200009,true,2061359703,28,2060535365,-824338
1652472478,200008,true,2061565839,28,2060123320,-1442519
1652472506,200011,true,2060947493,28,2059917328,-1030165
1652473366,200011,true,2060947493,28,2055596257,-5351236
1652473414,200011,true,2060947493,28,2055596257,-5351236
1652473432,200011,true,2060947493,28,2055390717,-5556776
1652473451,200013,true,2060535365,28,2055390717,-5144648
1652473504,200014,true,2060329332,28,2055390717,-4938615
1652473700,200014,true,2060329332,28,2055596257,-4733075
1652473733,200013,true,2060535365,28,2055596257,-4939108
1652473826,200015,true,2060123320,28,2055801816,-4321504
1652474091,200016,true,2059917328,28,2056418618,-3498710
1652474629,200015,true,2060123320,28,2059505406,-617914
1652474798,200014,true,2060329332,28,2060535365,206033
1652474915,200016,true,2059917328,28,2061153588,1236260
1652474956,200017,true,2059711357,28,2061359703,1648346
1652475005,200016,true,2059917328,28,2061359703,1442375
1652475030,200018,true,2059505406,28,2061359703,1854297
1652475043,200021,true,2058887678,28,2061359703,2472025
1652475116,200022,true,2058681810,28,2061359703,2677893
1652475167,200021,true,2058887678,28,2061359703,2472025
1652475181,200022,true,2058681810,28,2061359703,2677893
1652475225,200025,true,2058064329,28,2061359703,3295374
1652475284,200026,true,2057858543,28,2061153588,3295045
1652475542,200026,true,2057858543,28,2059505406,1646863
1652475591,200027,true,2057652778,28,2059093567,1440789
1652475791,200029,true,2057241309,28,2057241309,0
1652476151,200031,true,2056829923,28,2053541790,-3288133
1652476576,200031,true,2056829923,28,2049029190,-7800733
1652476697,200032,true,2056624260,28,2047800202,-8824058
1652476744,200034,true,2056212997,28,2047595443,-8617554
1652476935,200034,true,2056212997,28,2046776609,-9436388
1652477121,200034,true,2056212997,28,2046367316,-9845681
1652477173,200034,true,2056212997,28,2046367316,-9845681
1652477503,200036,true,2055801816,28,2046162699,-9639117
1652477525,200036,true,2055801816,28,2046162699,-9639117
1652477625,200036,true,2055801816,28,2046367316,-9434500
1652477648,200036,true,2055801816,28,2046367316,-9434500
1652477699,200037,true,2055596257,28,2046571952,-9024305
1652477721,200038,true,2055390717,28,2046776609,-8614108
1652477992,200037,true,2055596257,28,2047800202,-7796055
1652478118,200037,true,2055596257,28,2048619445,-6976812
1652478132,200038,true,2055390717,28,2048619445,-6771272
1652478146,200038,true,2055390717,28,2048619445,-6771272
1652478183,200037,true,2055596257,28,2049029190,-6567067
1652478218,200037,true,2055596257,28,2049234093,-6362164
1652478228,200037,true,2055596257,28,2049234093,-6362164
1652478235,200037,true,2055596257,28,2049234093,-6362164
1652478502,200035,true,2056007396,28,2051489378,-4518018
1652478710,200034,true,2056212997,28,2053131144,-3081853
1652478826,200034,true,2056212997,28,2054157915,-2055082
1652478870,200034,true,2056212997,28,2054568767,-1644230
1652478930,200030,true,2057035606,28,2055390717,-1644889
1652479474,200028,true,2057447033,28,2061565839,4118806
1652479500,200028,true,2057447033,28,2061771996,4324963
1652479515,200028,true,2057447033,28,2061978173,4531140
1652479694,200025,true,2058064329,28,2063834696,5770367
1652479810,200023,true,2058475963,28,2064866819,6390856
1652480067,200023,true,2058475963,28,2067346023,8870060
1652480143,200023,true,2058475963,28,2067966289,9490326
1652480309,200021,true,2058887678,28,2069414299,10526621
1652480449,200019,true,2059299477,28,2070449213,11149736
1652480528,200020,true,2059093567,28,2071070410,11976843
1652480695,200020,true,2059093567,28,2071691794,12598227
1652480907,200017,true,2059711357,28,2072106153,12394796
1652480943,200016,true,2059917328,28,2072313363,12396035
1652481795,200016,true,2059917328,28,2070863324,10945996
1652481804,200015,true,2060123320,28,2070863324,10740004
1652481828,200013,true,2060535365,28,2070656258,10120893
1652481854,200011,true,2060947493,28,2070656258,9708765
1652481950,200013,true,2060535365,28,2070035186,9499821
1652481953,200013,true,2060535365,28,2070035186,9499821
1652482049,200011,true,2060947493,28,2069207379,8259886
1652482732,200011,true,2060947493,28,2064660353,3712860
1652482823,200012,true,2060741419,28,2064247483,3506064
1652483031,200012,true,2060741419,28,2063215669,2474250
1652483041,200010,true,2061153588,28,2063215669,2062081
1652483064,200010,true,2061153588,28,2063009368,1855780
1652483082,200011,true,2060947493,28,2063009368,2061875
1652483109,200012,true,2060741419,28,2062803088,2061669
1652483184,200012,true,2060741419,28,2062184371,1442952
1652483192,200012,true,2060741419,28,2062184371,1442952
1652483211,200014,true,2060329332,28,2061978173,1648841
1652483237,200016,true,2059917328,28,2061771996,1854668
1652483294,200016,true,2059917328,28,2060947493,1030165
1652483314,200017,true,2059711357,28,2060535365,824008
1652483326,200019,true,2059299477,28,2060329332,1029855
1652483378,200021,true,2058887678,28,2059505406,617728
1652483416,200022,true,2058681810,28,2058887678,205868
1652484029,200022,true,2058681810,28,2050258915,-8422895
1652484214,200024,true,2058270136,28,2047800202,-10469934
1652484228,200026,true,2057858543,28,2047595443,-10263100
1652484251,200026,true,2057858543,28,2047390704,-10467839
1652484383,200027,true,2057652778,28,2045548973,-12103805
1652484754,200030,true,2057035606,28,2040237719,-16797887
1652484862,200032,true,2056624260,28,2038402423,-18221837
1652484896,200033,true,2056418618,28,2037791024,-18627594
1652484998,200034,true,2056212997,28,2035957929,-20255068
1652485057,200037,true,2055596257,28,2035143750,-20452507
1652485371,200040,true,2054979701,28,2030874645,-24105056
1652485408,200041,true,2054774224,28,2030468531,-24305693
1652485458,200042,true,2054568767,28,2029859512,-24709255
1652485471,200046,true,2053747145,28,2029656547,-24090598
1652485595,200049,true,2053131144,28,2027628006,-25503138
1652485834,200050,true,2052925851,28,2023981741,-28944110
1652485837,200052,true,2052515327,28,2023981741,-28533586
1652485847,200055,true,2051899696,28,2023779363,-28120333
1652485851,200058,true,2051284249,28,2023577005,-27707244
1652485919,200059,true,2051079141,28,2022565520,-28513621
1652485921,200060,true,2050874054,28,2022565520,-28308534
1652485935,200064,true,2050053909,28,2022363284,-27690625
1652485967,200067,true,2049439016,28,2021756696,-27682320
1652486225,200069,true,2049029190,28,2017313942,-31715248
1652486442,200070,true,2048824307,28,2013887593,-34936714
1652486467,200073,true,2048209783,28,2013283548,-34926235
1652486747,200076,true,2047595443,28,2009462131,-38133312
1652486759,200078,true,2047185985,28,2009462131,-37723854
1652486903,200078,true,2047185985,28,2008859413,-38326572
1652486953,200081,true,2046571952,28,2008658547,-37913405
1652487027,200084,true,2045958103,28,2008658547,-37299556
1652487079,200086,true,2045548973,28,2008658547,-36890426
1652487086,200086,true,2045548973,28,2008658547,-36890426
1652487175,200088,true,2045139925,28,2008859413,-36280512
1652487188,200091,true,2044526505,28,2008859413,-35667092
1652487213,200093,true,2044117661,28,2009060299,-35057362
1652487287,200093,true,2044117661,28,2009462131,-34655530
1652487362,200095,true,2043708899,28,2010266037,-33442862
1652487738,200098,true,2043095909,28,2013887593,-29208316
1652487931,200099,true,2042891620,28,2016305588,-26586032
1652487981,200099,true,2042891620,28,2017112231,-25779389
1652487988,200100,true,2042687351,28,2017112231,-25575120
1652488498,200102,true,2042278875,28,2024791455,-17487420
1652488616,200103,true,2042074668,28,2026209234,-15865434
1652488729,200102,true,2042278875,28,2027628006,-14650869
1652488751,200104,true,2041870481,28,2027830769,-14039712
1652488921,200105,true,2041666314,28,2029250676,-12415638
1652488954,200106,true,2041462168,28,2029656547,-11805621
1652489296,200105,true,2041666314,28,2031280840,-10385474
1652489428,200106,true,2041462168,28,2031890286,-9571882
1652489574,200107,true,2041258042,28,2032703164,-8554878
1652490136,200108,true,2041053937,28,2034329896,-6724041
1652490157,200107,true,2041258042,28,2034329896,-6928146
1652490369,200108,true,2041053937,28,2034533329,-6520608
1652490462,200109,true,2040849852,28,2034736782,-6113070
1652490500,200110,true,2040645787,28,2034736782,-5909005
1652490678,200109,true,2040849852,28,2034533329,-6316523
1652490760,200111,true,2040441743,28,2034329896,-6111847
1652490789,200112,true,2040237719,28,2034329896,-5907823
1652490843,200113,true,2040033716,28,2034126483,-5907233
1652490879,200112,true,2040237719,28,2034126483,-6111236
1652490899,200114,true,2039829733,28,2034126483,-5703250
1652490938,200115,true,2039625770,28,2034126483,-5499287
1652490974,200116,true,2039421828,28,2034126483,-5295345
1652490997,200115,true,2039625770,28,2034329896,-5295874
1652491023,200116,true,2039421828,28,2034329896,-5091932
1652491244,200116,true,2039421828,28,2035957929,-3463899
1652491354,200118,true,2039014005,28,2036772434,-2241571
1652491405,200116,true,2039421828,28,2037179809,-2242019
1652491449,200118,true,2039014005,28,2037587266,-1426739
1652491596,200118,true,2039014005,28,2038810124,-203881
1652491812,200119,true,2038810124,28,2040849852,2039728
1652491987,200118,true,2039014005,28,2042483103,3469098
1652492065,200119,true,2038810124,28,2043300219,4490095
1652492136,200119,true,2038810124,28,2044117661,5307537
1652492159,200121,true,2038402423,28,2044322073,5919650
1652492215,200120,true,2038606263,28,2045139925,6533662
1652492328,200122,true,2038198603,28,2046571952,8373349
1652492753,200122,true,2038198603,28,2051899696,13701093
1652492885,200123,true,2037994804,28,2052515327,14520523
1652493021,200123,true,2037994804,28,2053336457,15341653
1652493674,200124,true,2037791024,28,2056212997,18421973
1652494210,200124,true,2037791024,28,2058064329,20273305
1652494516,200126,true,2037383527,28,2059093567,21710040
1652494549,200126,true,2037383527,28,2059299477,21915950
1652494757,200127,true,2037179809,28,2059093567,21913758
1652494943,200127,true,2037179809,28,2058475963,21296154
1652495429,200129,true,2036772434,28,2057035606,20263172
1652496249,200129,true,2036772434,28,2054568767,17796333
1652496351,200130,true,2036568778,28,2054157915,17589137
1652496569,200130,true,2036568778,28,2053747145,17178367
1652496708,200132,true,2036161525,28,2053131144,16969619
1652496785,200132,true,2036161525,28,2052720579,16559054
1652496922,200132,true,2036161525,28,2052104886,15943361
1652497305,200133,true,2035957929,28,2050463941,14506012
1652497546,200134,true,2035754354,28,2049439016,13684662
1652497758,200135,true,2035550799,28,2048414604,12863805
1652497828,200135,true,2035550799,28,2048209783,12658984
1652498143,200135,true,2035550799,28,2047595443,12044644
1652498271,200136,true,2035347264,28,2047595443,12248179
1652498285,200136,true,2035347264,28,2047595443,12248179
1652498745,200137,true,2035143750,28,2047390704,12246954
1652499064,200137,true,2035143750,28,2047390704,12246954
1652499265,200138,true,2034940256,28,2047390704,12450448
1652499392,200138,true,2034940256,28,2047390704,12450448
1652499423,200138,true,2034940256,28,2047390704,12450448
1652499467,200138,true,2034940256,28,2047185985,12245729
1652499603,200138,true,2034940256,28,2046981287,12041031
1652500255,200138,true,2034940256,28,2044526505,9586249
1652500288,200138,true,2034940256,28,2044526505,9586249
1652500391,200137,true,2035143750,28,2044526505,9382755
1652500765,200138,true,2034940256,28,2044117661,9177405
1652501010,200137,true,2035143750,28,2044322073,9178323
1652501658,200137,true,2035143750,28,2045344439,10200689
1652502234,200136,true,2035347264,28,2046367316,11020052
1652502491,200136,true,2035347264,28,2046367316,11020052
1652502638,200135,true,2035550799,28,2046162699,10611900
1652502662,200135,true,2035550799,28,2046162699,10611900
1652502707,200134,true,2035754354,28,2045958103,10203749
1652502805,200135,true,2035550799,28,2045344439,9793640
1652502834,200134,true,2035754354,28,2045139925,9385571
1652502843,200133,true,2035957929,28,2045139925,9181996
1652502910,200131,true,2036365141,28,2044526505,8161364
1652503282,200132,true,2036161525,28,2041258042,5096517
1652503422,200132,true,2036161525,28,2040033716,3872191
1652503519,200130,true,2036568778,28,2039217906,2649128
1652503637,200128,true,2036976112,28,2037791024,814912
1652503849,200130,true,2036568778,28,2035143750,-1425028
1652504354,200130,true,2036568778,28,2027425264,-9143514
1652504451,200129,true,2036772434,28,2025804053,-10968381
1652504635,200127,true,2037179809,28,2023779363,-13400446
1652504660,200128,true,2036976112,28,2023577005,-13399107
1652504869,200128,true,2036976112,28,2021554541,-15421571
1652505041,200127,true,2037179809,28,2019938024,-17241785
1652505049,200125,true,2037587266,28,2019938024,-17649242
1652505078,200126,true,2037383527,28,2019736051,-17647476
1652505106,200126,true,2037383527,28,2019534097,-17849430
1652505231,200125,true,2037587266,28,2018928358,-18658908
1652505287,200123,true,2037994804,28,2018524633,-19470171
1652505318,200123,true,2037994804,28,2018322801,-19672003
1652505333,200124,true,2037791024,28,2018322801,-19468223
1652505389,200122,true,2038198603,28,2018322801,-19875802
1652505413,200121,true,2038402423,28,2018322801,-20079622
1652505491,200121,true,2038402423,28,2018322801,-20079622
1652505778,200122,true,2038198603,28,2018726486,-19472117
1652505825,200121,true,2038402423,28,2018928358,-19474065
1652506236,200120,true,2038606263,28,2020544066,-18062197
1652506498,200121,true,2038402423,28,2021756696,-16645727
1652506627,200122,true,2038198603,28,2022767777,-15430826
1652506650,200121,true,2038402423,28,2022767777,-15634646
1652506686,200120,true,2038606263,28,2023172350,-15433913
1652507010,200120,true,2038606263,28,2025601493,-13004770
1652507318,200121,true,2038402423,28,2027628006,-10774417
1652507510,200120,true,2038606263,28,2028844887,-9761376
1652507736,200119,true,2038810124,28,2029859512,-8950612
1652507774,200120,true,2038606263,28,2030062498,-8543765
1652507808,200121,true,2038402423,28,2030265505,-8136918
1652508447,200120,true,2038606263,28,2031483969,-7122294
1652509246,200120,true,2038606263,28,2029656547,-8949716
1652509256,200120,true,2038606263,28,2029453601,-9152662
1652509286,200122,true,2038198603,28,2029453601,-8745002
1652509326,200121,true,2038402423,28,2029250676,-9151747
1652509345,200121,true,2038402423,28,2029250676,-9151747
1652509366,200121,true,2038402423,28,2029250676,-9151747
1652509378,200122,true,2038198603,28,2029250676,-8947927
1652509417,200122,true,2038198603,28,2029250676,-8947927
1652509557,200121,true,2038402423,28,2029250676,-9151747
1652509559,200121,true,2038402423,28,2029250676,-9151747
1652510065,200122,true,2038198603,28,2030874645,-7323958
1652510108,200121,true,2038402423,28,2030874645,-7527778
1652510117,200120,true,2038606263,28,2031077733,-7528530
1652510137,200121,true,2038402423,28,2031077733,-7324690
1652510603,200121,true,2038402423,28,2033516367,-4886056
1652510854,200120,true,2038606263,28,2034736782,-3869481
1652511447,200120,true,2038606263,28,2036976112,-1630151
1652512037,200120,true,2038606263,28,2037791024,-815239
1652512221,200121,true,2038402423,28,2037791024,-611399
1652512575,200121,true,2038402423,28,2037791024,-611399
1652513286,200121,true,2038402423,28,2037791024,-611399
1652513716,200122,true,2038198603,28,2037791024,-407579
1652513877,200123,true,2037994804,28,2037791024,-203780
1652513898,200123,true,2037994804,28,2037791024,-203780
1652513914,200123,true,2037994804,28,2037791024,-203780
1652514039,200125,true,2037587266,28,2037383527,-203739
1652514104,200126,true,2037383527,28,2037179809,-203718
1652514342,200126,true,2037383527,28,2036365141,-1018386
1652514374,200127,true,2037179809,28,2036161525,-1018284
1652514578,200129,true,2036772434,28,2035347264,-1425170
1652515429,200130,true,2036568778,28,2032296684,-4272094
1652515694,200130,true,2036568778,28,2031483969,-5084809
1652516011,200131,true,2036365141,28,2031280840,-5084301
1652516179,200133,true,2035957929,28,2031280840,-4677089
1652516199,200134,true,2035754354,28,2031280840,-4473514
1652516219,200135,true,2035550799,28,2031280840,-4269959
1652516388,200136,true,2035347264,28,2031280840,-4066424
1652516911,200138,true,2034940256,28,2031077733,-3862523
1652517045,200140,true,2034533329,28,2031077733,-3455596
1652517068,200140,true,2034533329,28,2031077733,-3455596
1652517098,200141,true,2034329896,28,2031077733,-3252163
1652517115,200142,true,2034126483,28,2031077733,-3048750
1652517699,200142,true,2034126483,28,2033516367,-610116
1652517790,200143,true,2033923091,28,2033923091,0
1652517797,200143,true,2033923091,28,2033923091,0
1652517830,200144,true,2033719719,28,2034126483,406764
1652517836,200144,true,2033719719,28,2034126483,406764
1652518464,200145,true,2033516367,28,2036161525,2645158
1652518609,200145,true,2033516367,28,2036568778,3052411
1652519167,200146,true,2033313036,28,2036976112,3663076
1652519297,200146,true,2033313036,28,2036772434,3459398
1652519311,200146,true,2033313036,28,2036772434,3459398
1652519385,200147,true,2033109725,28,2036772434,3662709
1652519403,200148,true,2032906434,28,2036772434,3866000
1652519624,200147,true,2033109725,28,2037587266,4477541
1652519779,200148,true,2032906434,28,2037791024,4884590
1652519824,200148,true,2032906434,28,2037791024,4884590
1652519836,200149,true,2032703164,28,2037791024,5087860
1652520461,200149,true,2032703164,28,2038198603,5495439
1652521106,200150,true,2032499914,28,2035347264,2847350
1652521220,200150,true,2032499914,28,2034533329,2033415
1652521429,200151,true,2032296684,28,2032093475,-203209
1652521463,200151,true,2032296684,28,2031687117,-609567
1652521595,200153,true,2031890286,28,2030468531,-1421755
1652521624,200154,true,2031687117,28,2030062498,-1624619
1652521673,200155,true,2031483969,28,2029656547,-1827422
1652521979,200156,true,2031280840,28,2026817158,-4463682
1652522026,200158,true,2030874645,28,2026411855,-4462790
1652522178,200158,true,2030874645,28,2024993934,-5880711
1652522816,200159,true,2030671578,28,2021756696,-8914882
1652523030,200160,true,2030468531,28,2020948195,-9520336
1652523129,200162,true,2030062498,28,2020948195,-9114303
1652523171,200162,true,2030062498,28,2020948195,-9114303
1652523277,200163,true,2029859512,28,2020746121,-9113391
1652523309,200163,true,2029859512,28,2020746121,-9113391
1652523445,200164,true,2029656547,28,2020948195,-8708352
1652523473,200164,true,2029656547,28,2021150290,-8506257
1652523546,200164,true,2029656547,28,2021150290,-8506257
1652523602,200164,true,2029656547,28,2021150290,-8506257
1652523635,200166,true,2029250676,28,2021352405,-7898271
1652523700,200166,true,2029250676,28,2021352405,-7898271
1652523807,200165,true,2029453601,28,2021352405,-8101196
1652523831,200164,true,2029656547,28,2021352405,-8304142
1652524669,200166,true,2029250676,28,2021150290,-8100386
1652524693,200165,true,2029453601,28,2021150290,-8303311
1652525173,200164,true,2029656547,28,2021352405,-8304142
1652525277,200163,true,2029859512,28,2021150290,-8709222
1652525551,200165,true,2029453601,28,2021150290,-8303311
1652525563,200164,true,2029656547,28,2021150290,-8506257
1652525640,200163,true,2029859512,28,2021150290,-8709222
1652525662,200162,true,2030062498,28,2021150290,-8912208
1652525717,200165,true,2029453601,28,2020948195,-8505406
1652525772,200164,true,2029656547,28,2020746121,-8910426
1652525805,200164,true,2029656547,28,2020746121,-8910426
1652525824,200163,true,2029859512,28,2020746121,-9113391
1652525846,200166,true,2029250676,28,2020544066,-8706610
1652525985,200166,true,2029250676,28,2020140018,-9110658
1652526001,200166,true,2029250676,28,2019938024,-9312652
1652526018,200165,true,2029453601,28,2019938024,-9515577
1652526043,200168,true,2028844887,28,2019736051,-9108836
1652526062,200168,true,2028844887,28,2019736051,-9108836
1652526632,200169,true,2028642023,28,2015499267,-13142756
1652526682,200168,true,2028844887,28,2014894738,-13950149
1652526744,200171,true,2028236355,28,2014290391,-13945964
1652526769,200172,true,2028033552,28,2013887593,-14145959
1652526792,200174,true,2027628006,28,2013484876,-14143130
1652526824,200175,true,2027425264,28,2012880951,-14544313
1652526950,200179,true,2026614496,28,2010467063,-16147433
1652527031,200180,true,2026411855,28,2009060299,-17351556
1652527298,200183,true,2025804053,28,2002441658,-23362395
1652527656,200184,true,2025601493,28,1995246187,-30355306
1652527716,200188,true,2024791455,28,1994248864,-30542591
1652527720,200188,true,2024791455,28,1994248864,-30542591
1652527774,200192,true,2023981741,28,1993252038,-30729703
1652527926,200193,true,2023779363,28,1990662623,-33116740
1652527955,200196,true,2023172350,28,1990065544,-33106806
1652528070,200197,true,2022970053,28,1988076573,-34893480
1652528646,200201,true,2022161068,28,1979348688,-42812380
1652528932,200202,true,2021958872,28,1977568164,-44390708
1652529042,200206,true,2021150290,28,1977370427,-43779863
1652529191,200208,true,2020746121,28,1976777335,-43968786
1652529394,200212,true,2019938024,28,1975986821,-43951203
1652529410,200213,true,2019736051,28,1975789242,-43946809
1652529490,200217,true,2018928358,28,1975789242,-43139116
1652529715,200218,true,2018726486,28,1975986821,-42739665
1652529903,200221,true,2018120989,28,1976382038,-41738951
1652530302,200223,true,2017717425,28,1977568164,-40149261
1652530363,200227,true,2016910540,28,1977765921,-39144619
1652530377,200228,true,2016708869,28,1977765921,-38942948
1652530509,200231,true,2016103977,28,1977963697,-38140280
1652530521,200234,true,2015499267,28,1978161494,-37337773
1652530733,200237,true,2014894738,28,1978557146,-36337592
1652530791,200238,true,2014693269,28,1978755002,-35938267
1652531032,200242,true,2013887593,28,1978952877,-34934716
1652531154,200244,true,2013484876,28,1979150772,-34334104
1652531173,200248,true,2012679683,28,1979348688,-33330995
1652531278,200249,true,2012478435,28,1979546622,-32931813
1652531324,200252,true,2011874813,28,1979546622,-32328191
1652531506,200253,true,2011673645,28,1980140546,-31533099
1652531513,200257,true,2010869177,28,1980140546,-30728631
1652531633,200257,true,2010869177,28,1980734647,-30134530
1652531824,200260,true,2010266037,28,1981725213,-28540824
1652531870,200260,true,2010266037,28,1981923385,-28342652
1652531955,200264,true,2009462131,28,1982319790,-27142341
1652532268,200264,true,2009462131,28,1983906201,-25555930
1652532361,200267,true,2008859413,28,1984501432,-24357981
1652532474,200268,true,2008658547,28,1985096842,-23561705
1652532874,200271,true,2008056070,28,1987679017,-20377053
1652532930,200272,true,2007855285,28,1988076573,-19778712
1652533008,200275,true,2007253049,28,1988474208,-18778841
1652533039,200275,true,2007253049,28,1988474208,-18778841
1652533049,200279,true,2006450348,28,1988474208,-17976140
1652533089,200280,true,2006249723,28,1988673055,-17576668
1652533152,200283,true,2005647969,28,1988673055,-16974914
1652533156,200285,true,2005246899,28,1988673055,-16573844
1652533390,200289,true,2004445001,28,1988076573,-16368428
1652533402,200289,true,2004445001,28,1988076573,-16368428
1652533419,200293,true,2003643423,28,1988076573,-15566850
1652533437,200294,true,2003443079,28,1987877785,-15565294
1652533658,200299,true,2002441658,28,1986288198,-16153460
1652533760,200300,true,2002241434,28,1985692431,-16549003
1652533832,200303,true,2001640882,28,1985096842,-16544040
1652533855,200305,true,2001240613,28,1984898352,-16342261
1652533948,200310,true,2000240293,28,1983707830,-16532463
1652534027,200312,true,1999840305,28,1982914545,-16925760
1652534270,200315,true,1999240473,28,1980140546,-19099927
1652534379,200318,true,1998640821,28,1978755002,-19885819
1652534729,200324,true,1997442056,28,1974406743,-23035313
1652534741,200325,true,1997242332,28,1974209322,-23033010
1652534745,200329,true,1996443634,28,1974209322,-22234312
1652535069,200331,true,1996044406,28,1971250376,-24794030
1652535232,200335,true,1995246187,28,1969871052,-25375135
1652535285,200336,true,1995046683,28,1969674085,-25372598
1652535328,200340,true,1994248864,28,1969477137,-24771727
1652535416,200342,true,1993850074,28,1968492694,-25357380
1652535419,200346,true,1993052733,28,1968295864,-24756869
1652535516,200347,true,1992853448,28,1967312012,-25541436
1652535529,200351,true,1992056505,28,1967115300,-24941205
1652535672,200353,true,1991658154,28,1966132037,-25526117
1652535883,200357,true,1990861690,28,1965149266,-25712424
1652535900,200358,true,1990662623,28,1964952771,-25709852
1652536084,200362,true,1989866557,28,1964559839,-25306718
1652536096,200363,true,1989667591,28,1964559839,-25107752
1652536142,200367,true,1988871923,28,1964363403,-24508520
1652536185,200369,true,1988474208,28,1964166986,-24307222
1652536221,200373,true,1987679017,28,1964166986,-23512031
1652536453,200374,true,1987480269,28,1963185197,-24295072
1652536916,200378,true,1986685476,28,1960830906,-25854570
1652537007,200380,true,1986288198,28,1960438798,-25849400
1652537072,200385,true,1985295352,28,1960046769,-25248583
1652537173,200386,true,1985096842,28,1959654819,-25442023
1652537201,200390,true,1984303002,28,1959458873,-24844129
1652537428,200392,true,1983906201,28,1958675285,-25230916
1652537733,200397,true,1982914545,28,1957304761,-25609784
1652538449,200398,true,1982716274,28,1955348532,-27367742
1652538547,200402,true,1981923385,28,1955153017,-26770368
1652538680,200404,true,1981527060,28,1955153017,-26374043
1652538697,200409,true,1980536594,28,1955153017,-25383577
1652539207,200410,true,1980338560,28,1955739621,-24598939
1652539358,200414,true,1979546622,28,1956326402,-23220220
1652539403,200416,true,1979150772,28,1956326402,-22824370
1652539439,200420,true,1978359310,28,1956522035,-21837275
1652539520,200421,true,1978161494,28,1957109050,-21052444
1652539582,200424,true,1977568164,28,1957304761,-20263403
1652539689,200426,true,1977172710,28,1957696241,-19476469
1652539840,200430,true,1976382038,28,1958479437,-17902601
1652539966,200430,true,1976382038,28,1959067040,-17314998
1652540046,200433,true,1975789242,28,1959262947,-16526295
1652540113,200435,true,1975394144,28,1959654819,-15739325
1652540489,200439,true,1974604184,28,1961026989,-13577195
1652540552,200439,true,1974604184,28,1961223091,-13381093
1652540688,200442,true,1974011921,28,1961615356,-12396565
1652540727,200443,true,1973814539,28,1961811517,-12003022
1652540825,200446,true,1973222513,28,1962203899,-11018614
1652540885,200447,true,1973025211,28,1962596360,-10428851
1652541023,200449,true,1972630665,28,1963577854,-9052811
1652541105,200450,true,1972433422,28,1963970589,-8462833
1652541170,200452,true,1972038994,28,1964559839,-7479155
1652541230,200451,true,1972236198,28,1964952771,-7283427
1652541308,200452,true,1972038994,28,1965542316,-6496678
1652541374,200453,true,1971841810,28,1965935444,-5906366
1652541585,200453,true,1971841810,28,1967508743,-4333067
1652541901,200452,true,1972038994,28,1969674085,-2364909
1652542147,200453,true,1971841810,28,1971447501,-394309
1652542328,200454,true,1971644645,28,1972630665,986020
1652542374,200454,true,1971644645,28,1973025211,1380566
1652542999,200454,true,1971644645,28,1974209322,2564677
1652543030,200455,true,1971447501,28,1974209322,2761821
1652543050,200455,true,1971447501,28,1974209322,2761821
1652543057,200455,true,1971447501,28,1974209322,2761821
1652543070,200455,true,1971447501,28,1974011921,2564420
1652543084,200456,true,1971250376,28,1974011921,2761545
1652543202,200457,true,1971053270,28,1973222513,2169243
1652543671,200457,true,1971053270,28,1970265046,-788224
1652543794,200456,true,1971250376,28,1969477137,-1773239
1652543872,200458,true,1970856185,28,1968886412,-1969773
1652544144,200459,true,1970659119,28,1967115300,-3543819
1652544380,200460,true,1970462073,28,1965935444,-4526629
1652544690,200460,true,1970462073,28,1964559839,-5902234
1652544722,200461,true,1970265046,28,1964363403,-5901643
1652544728,200462,true,1970068039,28,1964363403,-5704636
1652544850,200463,true,1969871052,28,1963381516,-6489536
1652544897,200463,true,1969871052,28,1963381516,-6489536
1652544925,200464,true,1969674085,28,1963381516,-6292569
1652544944,200466,true,1969280209,28,1963381516,-5898693
1652545008,200465,true,1969477137,28,1963577854,-5899283
1652545105,200464,true,1969674085,28,1963970589,-5703496
1652545142,200465,true,1969477137,28,1964166986,-5310151
1652545160,200467,true,1969083301,28,1964166986,-4916315
1652545209,200466,true,1969280209,28,1964559839,-4720370
1652545288,200466,true,1969280209,28,1965149266,-4130943
1652545349,200467,true,1969083301,28,1965738870,-3344431
1652545460,200468,true,1968886412,28,1966721936,-2164476
1652545657,200468,true,1968886412,28,1968886412,0
1652546039,200467,true,1969083301,28,1973222513,4139212
1652546089,200468,true,1968886412,28,1973814539,4928127
1652546250,200469,true,1968689543,28,1975789242,7099699
1652546554,200468,true,1968886412,28,1980338560,11452148
1652546863,200467,true,1969083301,28,1984501432,15418131
1652546899,200468,true,1968886412,28,1984699882,15813470
1652546974,200469,true,1968689543,28,1985493881,16804338
1652546987,200468,true,1968886412,28,1985493881,16607469
1652547020,200466,true,1969280209,28,1986089589,16809380
1652547082,200466,true,1969280209,28,1987281541,18001332
1652547092,200465,true,1969477137,28,1987281541,17804404
1652547165,200464,true,1969674085,28,1988673055,18998970
1652547345,200461,true,1970265046,28,1992056505,21791459
1652547424,200460,true,1970462073,28,1993451363,22989290
1652547582,200460,true,1970462073,28,1996044406,25582333
1652547636,200458,true,1970856185,28,1996842943,25986758
1652547660,200456,true,1971250376,28,1997042627,25792251
1652547668,200454,true,1971644645,28,1997242332,25597687
1652548160,200455,true,1971447501,28,2002842166,31394665
1652548199,200453,true,1971841810,28,2003242755,31400945
1652548508,200450,true,1972433422,28,2006650993,34217571
1652548529,200448,true,1972827928,28,2006851658,34023730
1652548562,200448,true,1972827928,28,2007052344,34224416
1652548628,200446,true,1973222513,28,2007855285,34632772
1652548846,200443,true,1973814539,28,2009462131,35647592
1652548917,200441,true,1974209322,28,2009261205,35051883
1652549557,200441,true,1974209322,28,2007855285,33645963
1652549801,200438,true,1974801644,28,2008056070,33254426
1652549865,200436,true,1975196624,28,2008056070,32859446
1652549901,200434,true,1975591683,28,2008056070,32464387
1652549936,200434,true,1975591683,28,2008056070,32464387
1652550105,200432,true,1975986821,28,2007654519,31667698
1652550145,200429,true,1976579677,28,2007654519,31074842
1652550245,200426,true,1977172710,28,2007453774,30281064
1652550298,200426,true,1977172710,28,2007253049,30080339
1652550478,200423,true,1977765921,28,2006650993,28885072
1652550634,200421,true,1978161494,28,2006049118,27887624
1652550636,200418,true,1978755002,28,2006049118,27294116
1652550663,200418,true,1978755002,28,2006049118,27294116
1652550708,200416,true,1979150772,28,2006049118,26898346
1652550787,200413,true,1979744577,28,2005848533,26103956
1652551015,200411,true,1980140546,28,2005647969,25507423
1652551173,200410,true,1980338560,28,2005447424,25108864
1652551189,200408,true,1980734647,28,2005447424,24712777
1652551205,200405,true,1981328927,28,2005447424,24118497
1652551334,200402,true,1981923385,28,2005647969,23724584
1652551382,200401,true,1982121578,28,2005647969,23526391
1652551390,200399,true,1982518022,28,2005647969,23129947
1652551447,200395,true,1983311148,28,2006049118,22737970
1652551804,200391,true,1984104591,28,2008457702,24353111
1652551978,200389,true,1984501432,28,2009864044,25362612
1652552137,200387,true,1984898352,28,2011271371,26373019
1652552149,200383,true,1985692431,28,2011472498,25780067
1652552320,200379,true,1986486827,28,2013283548,26796721
1652552471,200377,true,1986884144,28,2015096228,28212084
1652552693,200375,true,1987281541,28,2017313942,30032401
1652552821,200372,true,1987877785,28,2018524633,30646848
1652552836,200368,true,1988673055,28,2018726486,30053431
1652552955,200366,true,1989070810,28,2019736051,30665241
1652552963,200363,true,1989667591,28,2019938024,30270433
1652553014,200360,true,1990264551,28,2020342032,30077481
1652553032,200356,true,1991060776,28,2020544066,29483290
1652553085,200355,true,1991259882,28,2020948195,29688313
1652553176,200352,true,1991857320,28,2021554541,29697221
1652553357,200349,true,1992454937,28,2022363284,29908347
1652553428,200345,true,1993252038,28,2022565520,29313482
1652553433,200344,true,1993451363,28,2022565520,29114157
1652553453,200341,true,1994049459,28,2022565520,28516061
1652553604,200338,true,1994647733,28,2022767777,28120044
1652553666,200335,true,1995246187,28,2022767777,27521590
1652553911,200333,true,1995645257,28,2022767777,27122520
1652554115,200331,true,1996044406,28,2022565520,26521114
1652554155,200329,true,1996443634,28,2022565520,26121886
1652554193,200326,true,1997042627,28,2022363284,25320657
1652554206,200324,true,1997442056,28,2022363284,24921228
1652554229,200322,true,1997841564,28,2022161068,24319504
1652554264,200320,true,1998241153,28,2022161068,23919915
1652554363,200318,true,1998640821,28,2021756696,23115875
1652554797,200317,true,1998840685,28,2019736051,20895366
1652554873,200315,true,1999240473,28,2019534097,20293624
1652554937,200313,true,1999640341,28,2019130251,19489910
1652554960,200311,true,2000040289,28,2018928358,18888069
1652554992,200310,true,2000240293,28,2018726486,18486193
1652555104,200308,true,2000640361,28,2017919197,17278836
1652555213,200306,true,2001040509,28,2017112231,16071722
1652555219,200303,true,2001640882,28,2017112231,15471349
1652555274,200302,true,2001841046,28,2016708869,14867823
1652555510,200301,true,2002041230,28,2015700817,13659587
1652555590,200298,true,2002641902,28,2015297737,12655835
1652555617,200296,true,2003042451,28,2015297737,12255286
1652555821,200294,true,2003443079,28,2014290391,10847312
1652555835,200292,true,2003843788,28,2014290391,10446603
1652555871,200290,true,2004244577,28,2014088982,9844405
1652556045,200287,true,2004845910,28,2013082239,8236329
1652556101,200286,true,2005046395,28,2012880951,7834556
1652556374,200284,true,2005447424,28,2011271371,5823947
1652556436,200282,true,2005848533,28,2011070264,5221731
1652556489,200280,true,2006249723,28,2010668110,4418387
1652556759,200278,true,2006650993,28,2009261205,2610212
1652556776,200276,true,2007052344,28,2009261205,2208861
1652557054,200274,true,2007453774,28,2008256876,803102
1652557064,200271,true,2008056070,28,2008256876,200806
1652557136,200271,true,2008056070,28,2007654519,-401551
1652557151,200270,true,2008256876,28,2007654519,-602357
1652557158,200269,true,2008457702,28,2007453774,-1003928
1652557233,200267,true,2008859413,28,2006650993,-2208420
1652557242,200267,true,2008859413,28,2006650993,-2208420
1652557279,200266,true,2009060299,28,2006249723,-2810576
1652557295,200266,true,2009060299,28,2006049118,-3011181
1652557325,200264,true,2009462131,28,2005848533,-3613598
1652557367,200264,true,2009462131,28,2005447424,-4014707
1652557443,200264,true,2009462131,28,2004645445,-4816686
1652557465,200264,true,2009462131,28,2004445001,-5017130
1652557491,200262,true,2009864044,28,2004044172,-5819872
1652557515,200262,true,2009864044,28,2003843788,-6020256
1652557535,200263,true,2009663078,28,2003643423,-6019655
1652557584,200263,true,2009663078,28,2003242755,-6420323
1652557670,200261,true,2010065030,28,2002441658,-7623372
1652557681,200262,true,2009864044,28,2002241434,-7622610
1652557685,200262,true,2009864044,28,2002241434,-7622610
1652557927,200263,true,2009663078,28,2000040289,-9622789
1652558479,200263,true,2009663078,28,1995445712,-14217366
1652558572,200264,true,2009462131,28,1994647733,-14814398
1652558689,200265,true,2009261205,28,1994049459,-15211746
1652558730,200267,true,2008859413,28,1993850074,-15009339
1652559003,200266,true,2009060299,28,1993650708,-15409591
1652559054,200267,true,2008859413,28,1993850074,-15009339
1652559089,200268,true,2008658547,28,1994049459,-14609088
1652559135,200269,true,2008457702,28,1994248864,-14208838
1652559253,200268,true,2008658547,28,1994647733,-14010814
1652559283,200268,true,2008658547,28,1994647733,-14010814
1652559309,200269,true,2008457702,28,1994847198,-13610504
1652559319,200270,true,2008256876,28,1994847198,-13409678
1652559350,200269,true,2008457702,28,1995046683,-13411019
1652559421,200269,true,2008457702,28,1995445712,-13011990
1652559556,200270,true,2008256876,28,1996443634,-11813242
1652559850,200271,true,2008056070,28,1999040569,-9015501
1652560759,200269,true,2008457702,28,2006049118,-2408584
1652560867,200269,true,2008457702,28,2006450348,-2007354
1652561081,200270,true,2008256876,28,2007052344,-1204532
1652561108,200271,true,2008056070,28,2007052344,-1003726
1652561121,200270,true,2008256876,28,2007052344,-1204532
1652561193,200270,true,2008256876,28,2006851658,-1405218
1652561677,200271,true,2008056070,28,2005046395,-3009675
1652561707,200272,true,2007855285,28,2004845910,-3009375
1652561803,200270,true,2008256876,28,2004445001,-3811875
1652561950,200271,true,2008056070,28,2003643423,-4412647
1652562252,200271,true,2008056070,28,2002241434,-5814636
1652562702,200272,true,2007855285,28,2000040289,-7814996
1652562739,200271,true,2008056070,28,2000040289,-8015781
1652562807,200271,true,2008056070,28,1999640341,-8415729
1652562950,200272,true,2007855285,28,1999040569,-8814716
1652563210,200274,true,2007453774,28,1998440977,-9012797
1652563247,200273,true,2007654519,28,1998241153,-9413366
1652563292,200273,true,2007654519,28,1998241153,-9413366
1652563301,200274,true,2007453774,28,1998241153,-9212621
1652563353,200276,true,2007052344,28,1998241153,-8811191
1652563372,200275,true,2007253049,28,1998041348,-9211701
1652563386,200276,true,2007052344,28,1998041348,-9010996
1652563786,200276,true,2007052344,28,1998041348,-9010996
1652563802,200278,true,2006650993,28,1998041348,-8609645
1652564456,200277,true,2006851658,28,2001440737,-5410921
1652564499,200278,true,2006650993,28,2001640882,-5010111
1652564518,200278,true,2006650993,28,2001841046,-4809947
1652564528,200280,true,2006249723,28,2001841046,-4408677
1652564547,200279,true,2006450348,28,2002041230,-4409118
1652564602,200279,true,2006450348,28,2002641902,-3808446
1652564639,200280,true,2006249723,28,2003042451,-3207272
1652564671,200281,true,2006049118,28,2003443079,-2606039
1652564706,200280,true,2006249723,28,2003843788,-2405935
1652564776,200280,true,2006249723,28,2004845910,-1403813
1652564827,200280,true,2006249723,28,2005647969,-601754
1652564842,200281,true,2006049118,28,2006049118,0
1652564856,200280,true,2006249723,28,2006249723,0
1652564874,200280,true,2006249723,28,2006650993,401270
1652564961,200279,true,2006450348,28,2008457702,2007354
1652565267,200280,true,2006249723,28,2015297737,9048014
1652565299,200278,true,2006650993,28,2015902387,9251394
1652565339,200278,true,2006650993,28,2016708869,10057876
1652565369,200277,true,2006851658,28,2017313942,10462284
1652565414,200277,true,2006851658,28,2018120989,11269331
1652565449,200275,true,2007253049,28,2018928358,11675309
1652565482,200275,true,2007253049,28,2019534097,12281048
1652565494,200274,true,2007453774,28,2019736051,12282277
1652565499,200275,true,2007253049,28,2019938024,12684975
1652565535,200273,true,2007654519,28,2020544066,12889547
1652565771,200273,true,2007654519,28,2023577005,15922486
1652565783,200272,true,2007855285,28,2023779363,15924078
1652565811,200272,true,2007855285,28,2024184139,16328854
1652565864,200271,true,2008056070,28,2024791455,16735385
1652565899,200271,true,2008056070,28,2025196433,17140363
1652566460,200270,true,2008256876,28,2029859512,21602636
1652566487,200271,true,2008056070,28,2030062498,22006428
1652566496,200269,true,2008457702,28,2030062498,21604796
1652566520,200269,true,2008457702,28,2030062498,21604796
1652566876,200267,true,2008859413,28,2029859512,21000099
1652567447,200268,true,2008658547,28,2028236355,19577808
1652567479,200266,true,2009060299,28,2028236355,19176056
1652567692,200266,true,2009060299,28,2027222541,18162242
1652567763,200265,true,2009261205,28,2027019839,17758634
1652567850,200266,true,2009060299,28,2027019839,17959540
1652567929,200264,true,2009462131,28,2026817158,17355027
1652568283,200264,true,2009462131,28,2026209234,16747103
1652568562,200262,true,2009864044,28,2026006633,16142589
1652568591,200263,true,2009663078,28,2026006633,16343555
1652568648,200261,true,2010065030,28,2026209234,16144204
1652568658,200260,true,2010266037,28,2026209234,15943197
1652568764,200257,true,2010869177,28,2026614496,15745319
1652568777,200258,true,2010668110,28,2026817158,16149048
1652568932,200255,true,2011271371,28,2028033552,16762181
1652568971,200254,true,2011472498,28,2028236355,16763857
1652568973,200251,true,2012076000,28,2028439179,16363179
1652568985,200251,true,2012076000,28,2028439179,16363179
1652569002,200248,true,2012679683,28,2028642023,15962340
1652569021,200246,true,2013082239,28,2028844887,15762648
1652569033,200242,true,2013887593,28,2029047772,15160179
1652569295,200242,true,2013887593,28,2032703164,18815571
1652569650,200237,true,2014894738,28,2039421828,24527090
1652569788,200235,true,2015297737,28,2042074668,26776931
1652569819,200232,true,2015902387,28,2042687351,26784964
1652569922,200231,true,2016103977,28,2044322073,28218096
1652569964,200227,true,2016910540,28,2044935431,28024891
1652569994,200225,true,2017313942,28,2045548973,28235031
1652570045,200221,true,2018120989,28,2046367316,28246327
1652570229,200221,true,2018120989,28,2048824307,30703318
1652570478,200217,true,2018928358,28,2051694527,32766169
1652570514,200215,true,2019332164,28,2051899696,32567532
1652570540,200211,true,2020140018,28,2052104886,31964868
1652570553,200210,true,2020342032,28,2052104886,31762854
1652570595,200207,true,2020948195,28,2052310096,31361901
1652571178,200205,true,2021352405,28,2050874054,29521649
1652571197,200202,true,2021958872,28,2050874054,28915182
1652571370,200201,true,2022161068,28,2050258915,28097847
1652571899,200197,true,2022970053,28,2049643960,26673907
1652571916,200195,true,2023374668,28,2049643960,26269292
1652572492,200191,true,2024184139,28,2050463941,26279802
1652572533,200190,true,2024386557,28,2050668987,26282430
1652572579,200187,true,2024993934,28,2050668987,25675053
1652572593,200185,true,2025398953,28,2050874054,25475101
1652572909,200181,true,2026209234,28,2052720579,26511345
1652572955,200180,true,2026411855,28,2052925851,26513996
1652573047,200177,true,2027019839,28,2053131144,26111305
1652573080,200175,true,2027425264,28,2053336457,25911193
1652573347,200172,true,2028033552,28,2053541790,25508238
1652573419,200171,true,2028236355,28,2053336457,25100102
1652573699,200168,true,2028844887,28,2053336457,24491570
1652573761,200167,true,2029047772,28,2053336457,24288685
1652573805,200163,true,2029859512,28,2053336457,23476945
1652573855,200163,true,2029859512,28,2053336457,23476945
1652573893,200160,true,2030468531,28,2053336457,22867926
1652573897,200159,true,2030671578,28,2053336457,22664879
1652573972,200155,true,2031483969,28,2053747145,22263176
1652574033,200154,true,2031687117,28,2053952519,22265402
1652574054,200151,true,2032296684,28,2053952519,21655835
1652574103,200149,true,2032703164,28,2054157915,21454751
1652574113,200144,true,2033719719,28,2054363330,20643611
1652574119,200143,true,2033923091,28,2054363330,20440239
1652574201,200139,true,2034736782,28,2054979701,20242919
1652574206,200137,true,2035143750,28,2055185199,20041449
1652574264,200132,true,2036161525,28,2055596257,19434732
1652574783,200131,true,2036365141,28,2059917328,23552187
1652574870,200127,true,2037179809,28,2060535365,23355556
1652574892,200124,true,2037791024,28,2060741419,22950395
1652574916,200119,true,2038810124,28,2060947493,22137369
1652574973,200118,true,2039014005,28,2061359703,22345698
1652575103,200115,true,2039625770,28,2062184371,22558601
1652575186,200112,true,2040237719,28,2062596828,22359109
1652575190,200107,true,2041258042,28,2062596828,21338786
1652575338,200107,true,2041258042,28,2063421991,22163949
1652575492,200103,true,2042074668,28,2064247483,22172815
1652575577,200101,true,2042483103,28,2064453908,21970805
1652575611,200097,true,2043300219,28,2064660353,21360134
1652575780,200096,true,2043504549,28,2064660353,21155804
1652575946,200094,true,2043913270,28,2064041079,20127809
1652576208,200093,true,2044117661,28,2061771996,17654335
1652576221,200089,true,2044935431,28,2061565839,16630408
1652576294,200088,true,2045139925,28,2060947493,15807568
1652576514,200087,true,2045344439,28,2058887678,13543239
1652576529,200085,true,2045753528,28,2058681810,12928282
1652576544,200082,true,2046367316,28,2058475963,12108647
1652576551,200081,true,2046571952,28,2058475963,11904011
1652576575,200081,true,2046571952,28,2058064329,11492377
1652576903,200081,true,2046571952,28,2054774224,8202272
1652576932,200077,true,2047390704,28,2054363330,6972626
1652576970,200077,true,2047390704,28,2054157915,6767211
1652576975,200077,true,2047390704,28,2053952519,6561815
1652576996,200078,true,2047185985,28,2053747145,6561160
1652577310,200076,true,2047595443,28,2050258915,2663472
1652577368,200076,true,2047595443,28,2049643960,2048517
1652578059,200076,true,2047595443,28,2043913270,-3682173
1652578224,200077,true,2047390704,28,2042687351,-4703353
1652578290,200075,true,2047800202,28,2042074668,-5725534
1652578325,200076,true,2047595443,28,2041870481,-5724962
1652578501,200076,true,2047595443,28,2040849852,-6745591
1652578965,200076,true,2047595443,28,2039217906,-8377537
1652579070,200075,true,2047800202,28,2039014005,-8786197
1652579606,200075,true,2047800202,28,2038402423,-9397779
1652579761,200075,true,2047800202,28,2038198603,-9601599
1652580266,200075,true,2047800202,28,2037587266,-10212936
1652580314,200073,true,2048209783,28,2037791024,-10418759
1652580417,200074,true,2048004982,28,2037791024,-10213958
1652580716,200073,true,2048209783,28,2038198603,-10011180
1652580729,200073,true,2048209783,28,2038198603,-10011180
1652580769,200071,true,2048619445,28,2038198603,-10420842
1652580790,200071,true,2048619445,28,2038198603,-10420842
1652580823,200071,true,2048619445,28,2037994804,-10624641
1652580857,200072,true,2048414604,28,2037994804,-10419800
1652580945,200070,true,2048824307,28,2037791024,-11033283
1652580951,200071,true,2048619445,28,2037791024,-10828421
1652581010,200071,true,2048619445,28,2037383527,-11235918
1652581827,200071,true,2048619445,28,2033313036,-15306409
1652581939,200070,true,2048824307,28,2032703164,-16121143
1652582035,200070,true,2048824307,28,2032296684,-16527623
1652582436,200070,true,2048824307,28,2030062498,-18761809
1652582490,200070,true,2048824307,28,2029656547,-19167760
1652582591,200069,true,2049029190,28,2029047772,-19981418
1652582711,200069,true,2049029190,28,2028844887,-20184303
1652582727,200069,true,2049029190,28,2028844887,-20184303
1652582730,200070,true,2048824307,28,2028844887,-19979420
1652582873,200071,true,2048619445,28,2028439179,-20180266
1652582974,200071,true,2048619445,28,2028236355,-20383090
1652583417,200072,true,2048414604,28,2027425264,-20989340
1652583469,200073,true,2048209783,28,2027425264,-20784519
1652583574,200074,true,2048004982,28,2027222541,-20782441
1652583809,200074,true,2048004982,28,2026817158,-21187824
1652584447,200076,true,2047595443,28,2025601493,-21993950
1652584472,200078,true,2047185985,28,2025398953,-21787032
1652584549,200078,true,2047185985,28,2025398953,-21787032
1652584584,200079,true,2046981287,28,2025398953,-21582334
1652584592,200081,true,2046571952,28,2025398953,-21172999
1652584750,200083,true,2046162699,28,2024993934,-21168765
1652584785,200084,true,2045958103,28,2024791455,-21166648
1652584839,200086,true,2045548973,28,2024588996,-20959977
1652585038,200088,true,2045139925,28,2023577005,-21562920
1652585091,200090,true,2044730958,28,2023172350,-21558608
1652585114,200091,true,2044526505,28,2022970053,-21556452
1652585200,200092,true,2044322073,28,2022161068,-22161005
1652585248,200095,true,2043708899,28,2021756696,-21952203
1652585268,200097,true,2043300219,28,2021756696,-21543523
1652585300,200098,true,2043095909,28,2021352405,-21743504
1652585383,200100,true,2042687351,28,2020544066,-22143285
1652585384,200102,true,2042278875,28,2020544066,-21734809
1652585429,200104,true,2041870481,28,2019938024,-21932457
1652585499,200105,true,2041666314,28,2019130251,-22536063
1652585536,200107,true,2041258042,28,2018726486,-22531556
1652585595,200110,true,2040645787,28,2018120989,-22524798
1652585773,200112,true,2040237719,28,2016103977,-24133742
1652585780,200114,true,2039829733,28,2015902387,-23927346
1652585889,200115,true,2039625770,28,2014693269,-24932501
1652585905,200118,true,2039014005,28,2014491820,-24522185
1652586060,200121,true,2038402423,28,2012679683,-25722740
1652586076,200123,true,2037994804,28,2012478435,-25516369
1652586096,200125,true,2037587266,28,2012277208,-25310058
1652586426,200127,true,2037179809,28,2008658547,-28521262
1652586498,200130,true,2036568778,28,2008056070,-28512708
1652586505,200131,true,2036365141,28,2007855285,-28509856
1652586656,200133,true,2035957929,28,2006851658,-29106271
1652586781,200135,true,2035550799,28,2006049118,-29501681
1652586869,200138,true,2034940256,28,2005647969,-29292287
1652587003,200140,true,2034533329,28,2005046395,-29486934
1652587087,200141,true,2034329896,28,2005046395,-29283501
1652587121,200144,true,2033719719,28,2005046395,-28673324
1652587131,200147,true,2033109725,28,2005046395,-28063330
1652587166,200148,true,2032906434,28,2005046395,-27860039
1652587208,200150,true,2032499914,28,2005046395,-27453519
1652587356,200153,true,2031890286,28,2005046395,-26843891
1652587449,200156,true,2031280840,28,2005246899,-26033941
1652587702,200158,true,2030874645,28,2005647969,-25226676
1652587707,200160,true,2030468531,28,2005647969,-24820562
1652587722,200163,true,2029859512,28,2005647969,-24211543
1652587744,200167,true,2029047772,28,2005647969,-23399803
1652587806,200168,true,2028844887,28,2005848533,-22996354
1652587887,200170,true,2028439179,28,2006249723,-22189456
1652587927,200174,true,2027628006,28,2006450348,-21177658
1652588004,200177,true,2027019839,28,2006650993,-20368846
1652588025,200178,true,2026817158,28,2006650993,-20166165
1652588069,200180,true,2026411855,28,2006851658,-19560197
1652588155,200183,true,2025804053,28,2007253049,-18551004
1652588200,200186,true,2025196433,28,2007453774,-17742659
1652588235,200187,true,2024993934,28,2007654519,-17339415
1652588300,200189,true,2024588996,28,2008056070,-16532926
1652588386,200191,true,2024184139,28,2008256876,-15927263
1652588462,200194,true,2023577005,28,2008658547,-14918458
1652588488,200196,true,2023172350,28,2008859413,-14312937
1652588626,200197,true,2022970053,28,2009462131,-13507922
1652588640,200199,true,2022565520,28,2009462131,-13103389
1652588786,200202,true,2021958872,28,2010065030,-11893842
1652588837,200203,true,2021756696,28,2010266037,-11490659
1652588856,200204,true,2021554541,28,2010266037,-11288504
1652588958,200206,true,2021150290,28,2010668110,-10482180
1652588988,200209,true,2020544066,28,2010869177,-9674889
1652589129,200210,true,2020342032,28,2011271371,-9070661
1652589298,200211,true,2020140018,28,2011874813,-8265205
1652589328,200213,true,2019736051,28,2011874813,-7861238
1652589399,200215,true,2019332164,28,2012076000,-7256164
1652589409,200216,true,2019130251,28,2012277208,-6853043
1652589492,200217,true,2018928358,28,2012478435,-6449923
1652589542,200219,true,2018524633,28,2012478435,-6046198
1652589580,200221,true,2018120989,28,2012478435,-5642554
1652589616,200221,true,2018120989,28,2012478435,-5642554
1652589727,200223,true,2017717425,28,2012277208,-5440217
1652589829,200224,true,2017515674,28,2012076000,-5439674
1652589884,200226,true,2017112231,28,2011874813,-5237418
1652589934,200227,true,2016910540,28,2011874813,-5035727
1652590010,200228,true,2016708869,28,2011673645,-5035224
1652590021,200230,true,2016305588,28,2011673645,-4631943
1652590040,200232,true,2015902387,28,2011472498,-4429889
1652590079,200232,true,2015902387,28,2011472498,-4429889
1652590203,200234,true,2015499267,28,2011070264,-4429003
1652590224,200235,true,2015297737,28,2011070264,-4227473
1652590273,200237,true,2014894738,28,2010869177,-4025561
1652590378,200238,true,2014693269,28,2010668110,-4025159
1652590546,200239,true,2014491820,28,2010266037,-4225783
1652590704,200241,true,2014088982,28,2009864044,-4224938
1652590755,200242,true,2013887593,28,2009663078,-4224515
1652590907,200243,true,2013686224,28,2009261205,-4425019
1652591260,200244,true,2013484876,28,2008859413,-4625463
1652591277,200245,true,2013283548,28,2008859413,-4424135
1652591375,200247,true,2012880951,28,2008658547,-4222404
1652591489,200247,true,2012880951,28,2008658547,-4222404
1652591550,200248,true,2012679683,28,2008859413,-3820270
1652591565,200249,true,2012478435,28,2008859413,-3619022
1652591849,200250,true,2012277208,28,2009060299,-3216909
1652592180,200251,true,2012076000,28,2009261205,-2814795
1652592195,200252,true,2011874813,28,2009261205,-2613608
1652592274,200253,true,2011673645,28,2009462131,-2211514
1652592490,200254,true,2011472498,28,2009663078,-1809420
1652592600,200254,true,2011472498,28,2009864044,-1608454
1652592614,200255,true,2011271371,28,2009864044,-1407327
1652592642,200256,true,2011070264,28,2010065030,-1005234
1652592655,200257,true,2010869177,28,2010065030,-804147
1652592765,200256,true,2011070264,28,2010266037,-804227
1652593182,200257,true,2010869177,28,2011472498,603321
1652593234,200258,true,2010668110,28,2011673645,1005535
1652593316,200258,true,2010668110,28,2011874813,1206703
1652593348,200258,true,2010668110,28,2011874813,1206703
1652593403,200259,true,2010467063,28,2012076000,1608937
1652593479,200259,true,2010467063,28,2012679683,2212620
1652593536,200260,true,2010266037,28,2012880951,2614914
1652593597,200259,true,2010467063,28,2013283548,2816485
1652593635,200260,true,2010266037,28,2013686224,3420187
1652593676,200260,true,2010266037,28,2013887593,3621556
1652593741,200259,true,2010467063,28,2014491820,4024757
1652593776,200258,true,2010668110,28,2014894738,4226628
1652593795,200258,true,2010668110,28,2015096228,4428118
1652593863,200258,true,2010668110,28,2015700817,5032707
1652593936,200258,true,2010668110,28,2016507218,5839108
1652593939,200256,true,2011070264,28,2016507218,5436954
1652593960,200256,true,2011070264,28,2016708869,5638605
1652593962,200255,true,2011271371,28,2016708869,5437498
1652594000,200255,true,2011271371,28,2017112231,5840860
1652594015,200253,true,2011673645,28,2017112231,5438586
1652594030,200253,true,2011673645,28,2017313942,5640297
1652594042,200252,true,2011874813,28,2017515674,5640861
1652594067,200251,true,2012076000,28,2017717425,5641425
1652594093,200249,true,2012478435,28,2017919197,5440762
1652594107,200249,true,2012478435,28,2018120989,5642554
1652594127,200248,true,2012679683,28,2018120989,5441306
1652594154,200247,true,2012880951,28,2018524633,5643682
1652594157,200245,true,2013283548,28,2018524633,5241085
1652594188,200245,true,2013283548,28,2018726486,5442938
1652594231,200244,true,2013484876,28,2019130251,5645375
1652594271,200243,true,2013686224,28,2019534097,5847873
1652594290,200241,true,2014088982,28,2019736051,5647069
1652594580,200240,true,2014290391,28,2022363284,8072893
1652594697,200239,true,2014491820,28,2023172350,8680530
1652595311,200238,true,2014693269,28,2028033552,13340283
1652595320,200237,true,2014894738,28,2028236355,13341617
1652595393,200236,true,2015096228,28,2028439179,13342951
1652595405,200235,true,2015297737,28,2028642023,13344286
1652595542,200234,true,2015499267,28,2029047772,13548505
1652595565,200232,true,2015902387,28,2029047772,13145385
1652595711,200232,true,2015902387,28,2029250676,13348289
1652596036,200231,true,2016103977,28,2029656547,13552570
1652596047,200230,true,2016305588,28,2029656547,13350959
1652596058,200228,true,2016708869,28,2029656547,12947678
1652596462,200227,true,2016910540,28,2029859512,12948972
1652596686,200227,true,2016910540,28,2029859512,12948972
1652596805,200225,true,2017313942,28,2029859512,12545570
1652596925,200224,true,2017515674,28,2029859512,12343838
1652596980,200223,true,2017717425,28,2029859512,12142087
1652596996,200223,true,2017717425,28,2029859512,12142087
1652597109,200222,true,2017919197,28,2029859512,11940315
1652597123,200221,true,2018120989,28,2029859512,11738523
1652597131,200220,true,2018322801,28,2029859512,11536711
1652597157,200220,true,2018322801,28,2029859512,11536711
1652597202,200219,true,2018524633,28,2029656547,11131914
1652597347,200218,true,2018726486,28,2029453601,10727115
1652597390,200217,true,2018928358,28,2029453601,10525243
1652597448,200217,true,2018928358,28,2029250676,10322318
1652597539,200216,true,2019130251,28,2029047772,9917521
1652597644,200215,true,2019332164,28,2028844887,9512723
1652597763,200215,true,2019332164,28,2028642023,9309859
1652597782,200215,true,2019332164,28,2028642023,9309859
1652597961,200214,true,2019534097,28,2028439179,8905082
1652598002,200213,true,2019736051,28,2028236355,8500304
1652598033,200213,true,2019736051,28,2028236355,8500304
1652598044,200212,true,2019938024,28,2028236355,8298331
1652598054,200211,true,2020140018,28,2028236355,8096337
1652598104,200209,true,2020544066,28,2028439179,7895113
1652598250,200208,true,2020746121,28,2029047772,8301651
1652598559,200208,true,2020746121,28,2030468531,9722410
1652598624,200206,true,2021150290,28,2030874645,9724355
1652598985,200205,true,2021352405,28,2033109725,11757320
1652599262,200204,true,2021554541,28,2035143750,13589209
1652599408,200203,true,2021756696,28,2036365141,14608445
1652599780,200202,true,2021958872,28,2039014005,17055133
1652600031,200200,true,2022363284,28,2039829733,17466449
1652600109,200199,true,2022565520,28,2039829733,17264213
1652600182,200198,true,2022767777,28,2040033716,17265939
1652600265,200197,true,2022970053,28,2040033716,17063663
1652600388,200195,true,2023374668,28,2040237719,16863051
1652600434,200193,true,2023779363,28,2040237719,16458356
1652600502,200192,true,2023981741,28,2040237719,16255978
1652600537,200191,true,2024184139,28,2040237719,16053580
1652600612,200189,true,2024588996,28,2040033716,15444720
1652600852,200188,true,2024791455,28,2040033716,15242261
1652600871,200187,true,2024993934,28,2040033716,15039782
1652601010,200185,true,2025398953,28,2039829733,14430780
1652601232,200184,true,2025601493,28,2039625770,14024277
1652601674,200182,true,2026006633,28,2039217906,13211273
1652601714,200181,true,2026209234,28,2039014005,12804771
1652601878,200180,true,2026411855,28,2038810124,12398269
1652601945,200178,true,2026817158,28,2038810124,11992966
1652601952,200177,true,2027019839,28,2038810124,11790285
1652602041,200176,true,2027222541,28,2038606263,11383722
1652602231,200175,true,2027425264,28,2038198603,10773339
1652602430,200174,true,2027628006,28,2037587266,9959260
1652602483,200173,true,2027830769,28,2037587266,9756497
1652602512,200172,true,2028033552,28,2037383527,9349975
1652602603,200171,true,2028236355,28,2036976112,8739757
1652602766,200170,true,2028439179,28,2036161525,7722346
1652602965,200169,true,2028642023,28,2035143750,6501727
1652603009,200168,true,2028844887,28,2034940256,6095369
1652603253,200167,true,2029047772,28,2033719719,4671947
1652603459,200166,true,2029250676,28,2032703164,3452488
1652603471,200165,true,2029453601,28,2032703164,3249563
1652603671,200165,true,2029453601,28,2031687117,2233516
1652604019,200164,true,2029656547,28,2030265505,608958
1652604081,200163,true,2029859512,28,2030062498,202986
1652604133,200162,true,2030062498,28,2030062498,0
1652604214,200162,true,2030062498,28,2029656547,-405951
1652604328,200161,true,2030265505,28,2029453601,-811904
1652604386,200160,true,2030468531,28,2029453601,-1014930
1652604495,200160,true,2030468531,28,2029250676,-1217855
1652604547,200159,true,2030671578,28,2029250676,-1420902
1652604577,200159,true,2030671578,28,2029250676,-1420902
1652604963,200158,true,2030874645,28,2028439179,-2435466
1652605112,200158,true,2030874645,28,2028033552,-2841093
1652605182,200158,true,2030874645,28,2027830769,-3043876
1652605200,200157,true,2031077733,28,2027628006,-3449727
1652605221,200158,true,2030874645,28,2027628006,-3246639
1652605257,200158,true,2030874645,28,2027425264,-3449381
1652605370,200158,true,2030874645,28,2027019839,-3854806
1652605502,200158,true,2030874645,28,2026411855,-4462790
1652605848,200158,true,2030874645,28,2024791455,-6083190
1652606429,200158,true,2030874645,28,2022767777,-8106868
1652606505,200158,true,2030874645,28,2022565520,-8309125
1652606540,200159,true,2030671578,28,2022363284,-8308294
1652606615,200159,true,2030671578,28,2022363284,-8308294
1652606646,200159,true,2030671578,28,2022161068,-8510510
1652606702,200159,true,2030671578,28,2022161068,-8510510
1652606772,200160,true,2030468531,28,2022161068,-8307463
1652607074,200160,true,2030468531,28,2022565520,-7903011
1652607136,200160,true,2030468531,28,2022565520,-7903011
1652607138,200160,true,2030468531,28,2022565520,-7903011
1652607390,200160,true,2030468531,28,2023172350,-7296181
1652607505,200160,true,2030468531,28,2023577005,-6891526
1652607548,200160,true,2030468531,28,2023577005,-6891526
1652607630,200160,true,2030468531,28,2023779363,-6689168
1652607800,200160,true,2030468531,28,2024184139,-6284392
1652607811,200160,true,2030468531,28,2024184139,-6284392
1652607822,200160,true,2030468531,28,2024184139,-6284392
1652607839,200160,true,2030468531,28,2024386557,-6081974
1652607912,200160,true,2030468531,28,2024588996,-5879535
1652607995,200160,true,2030468531,28,2024791455,-5677076
1652608019,200160,true,2030468531,28,2024791455,-5677076
1652608106,200160,true,2030468531,28,2025196433,-5272098
1652608167,200160,true,2030468531,28,2025601493,-4867038
1652608285,200160,true,2030468531,28,2026209234,-4259297
1652608412,200160,true,2030468531,28,2026817158,-3651373
1652608527,200160,true,2030468531,28,2027222541,-3245990
1652608819,200160,true,2030468531,28,2028033552,-2434979
1652609064,200160,true,2030468531,28,2028642023,-1826508
1652609170,200160,true,2030468531,28,2028844887,-1623644
1652609194,200160,true,2030468531,28,2028844887,-1623644
1652609572,200160,true,2030468531,28,2029859512,-609019
1652609634,200160,true,2030468531,28,2030062498,-406033
1652609687,200160,true,2030468531,28,2030062498,-406033
1652609749,200160,true,2030468531,28,2030265505,-203026
1652609969,200160,true,2030468531,28,2030265505,-203026
1652610350,200160,true,2030468531,28,2030265505,-203026
1652610383,200160,true,2030468531,28,2030265505,-203026
1652610410,200160,true,2030468531,28,2030265505,-203026
1652610467,200160,true,2030468531,28,2030265505,-203026
1652610526,200160,true,2030468531,28,2030265505,-203026
1652610558,200160,true,2030468531,28,2030265505,-203026
1652610831,200160,true,2030468531,28,2030265505,-203026
1652610874,200160,true,2030468531,28,2030265505,-203026
1652611011,200159,true,2030671578,28,2030265505,-406073
1652611110,200159,true,2030671578,28,2030265505,-406073
1652611700,200159,true,2030671578,28,2030265505,-406073
1652611722,200159,true,2030671578,28,2030468531,-203047
1652611767,200159,true,2030671578,28,2030468531,-203047
1652611821,200159,true,2030671578,28,2030671578,0
1652611833,200158,true,2030874645,28,2030671578,-203067
1652611854,200157,true,2031077733,28,2030671578,-406155
1652611866,200157,true,2031077733,28,2030874645,-203088
1652612110,200155,true,2031483969,28,2032906434,1422465
1652612154,200155,true,2031483969,28,2033313036,1829067
1652612188,200155,true,2031483969,28,2033719719,2235750
1652612410,200155,true,2031483969,28,2035550799,4066830
1652612502,200154,true,2031687117,28,2036365141,4678024
1652612552,200153,true,2031890286,28,2036772434,4882148
1652612730,200153,true,2031890286,28,2038810124,6919838
1652612827,200153,true,2031890286,28,2039829733,7939447
1652613407,200152,true,2032093475,28,2045958103,13864628
1652613459,200151,true,2032296684,28,2046571952,14275268
1652613966,200151,true,2032296684,28,2048824307,16527623
1652614060,200151,true,2032296684,28,2049234093,16937409
1652614092,200150,true,2032499914,28,2049439016,16939102
1652614106,200150,true,2032499914,28,2049439016,16939102
1652614146,200149,true,2032703164,28,2049643960,16940796
1652614254,200148,true,2032906434,28,2050463941,17557507
1652614301,200147,true,2033109725,28,2050874054,17764329
1652614334,200146,true,2033313036,28,2051079141,17766105
1652614341,200145,true,2033516367,28,2051079141,17562774
1652614346,200145,true,2033516367,28,2051079141,17562774
1652614598,200141,true,2034329896,28,2054774224,20444328
1652614658,200140,true,2034533329,28,2055801816,21268487
1652614922,200139,true,2034736782,28,2059711357,24974575
1652614950,200138,true,2034940256,28,2059917328,24977072
1652615062,200134,true,2035754354,28,2061565839,25811485
1652616040,200133,true,2035957929,28,2075008988,39051059
1652616234,200132,true,2036161525,28,2076877243,40715718
1652616599,200131,true,2036365141,28,2078539326,42174185
1652616688,200127,true,2037179809,28,2079162950,41983141
1652616801,200125,true,2037587266,28,2079578804,41991538
1652617029,200124,true,2037791024,28,2080826863,43035839
1652617124,200122,true,2038198603,28,2081243049,43044446
1652617283,200119,true,2038810124,28,2082075671,43265547
1652617301,200117,true,2039217906,28,2082283879,43065973
1652617319,200115,true,2039625770,28,2082283879,42658109
1652617582,200113,true,2040033716,28,2084367100,44333384
1652617698,200108,true,2041053937,28,2085200972,44147035
1652617745,200106,true,2041462168,28,2085618033,44155865
1652617766,200104,true,2041870481,28,2085618033,43747552
1652617812,200102,true,2042278875,28,2085826595,43547720
1652617898,200099,true,2042891620,28,2085826595,42934975
1652617929,200097,true,2043300219,28,2085618033,42317814
1652618300,200095,true,2043708899,28,2084783994,41075095
1652618399,200094,true,2043913270,28,2084575537,40662267
1652618707,200090,true,2044730958,28,2083741915,39010957
1652618824,200088,true,2045139925,28,2083325229,38185304
1652618874,200087,true,2045344439,28,2083325229,37980790
1652618916,200085,true,2045753528,28,2083325229,37571701
1652618998,200081,true,2046571952,28,2083325229,36753277
1652619344,200079,true,2046981287,28,2082492107,35510820
1652619658,200077,true,2047390704,28,2081867485,34476781
1652619678,200075,true,2047800202,28,2082075671,34275469
1652619734,200071,true,2048619445,28,2082075671,33456226
1652619749,200068,true,2049234093,28,2082075671,32841578
1652619834,200067,true,2049439016,28,2082075671,32636655
1652619982,200065,true,2049848924,28,2082075671,32226747
1652620009,200060,true,2050874054,28,2082075671,31201617
1652620066,200058,true,2051284249,28,2082075671,30791422
1652620145,200057,true,2051489378,28,2081867485,30378107
1652620481,200055,true,2051899696,28,2081243049,29343353
1652620803,200051,true,2052720579,28,2080202740,27482161
1652621010,200049,true,2053131144,28,2079370867,26239723
1652621130,200047,true,2053541790,28,2078955055,25413265
1652621498,200046,true,2053747145,28,2076461930,22714785
1652621539,200042,true,2054568767,28,2076046700,21477933
1652622202,200040,true,2054979701,28,2073349727,18370026
1652623376,200039,true,2055185199,28,2070449213,15264014
1652623429,200038,true,2055390717,28,2070449213,15058496
1652623468,200034,true,2056212997,28,2070449213,14236216
1652623519,200032,true,2056624260,28,2070242189,13617929
1652624055,200032,true,2056624260,28,2068379903,11755643
1652624079,200031,true,2056829923,28,2068379903,11549980
1652624670,200027,true,2057652778,28,2066312660,8659882
1652624742,200025,true,2058064329,28,2066106049,8041720
1652625039,200026,true,2057858543,28,2064453908,6595365
1652625127,200025,true,2058064329,28,2063834696,5770367
1652625800,200021,true,2058887678,28,2061359703,2472025
1652625966,200020,true,2059093567,28,2060741419,1647852
1652626297,200020,true,2059093567,28,2060123320,1029753
1652626772,200019,true,2059299477,28,2059711357,411880
1652626827,200015,true,2060123320,28,2059711357,-411963
1652627195,200014,true,2060329332,28,2060741419,412087
1652627251,200014,true,2060329332,28,2060947493,618161
1652627306,200013,true,2060535365,28,2061359703,824338
1652627504,200009,true,2061359703,28,2063215669,1855966
1652627798,200006,true,2061978173,28,2065692890,3714717
1652627925,200006,true,2061978173,28,2066725943,4747770
1652628234,200005,true,2062184371,28,2068173085,5988714
1652628699,200002,true,2062803088,28,2069621241,6818153
1652628726,199999,true,2063421991,28,2069828203,6406212
1652628730,200000,true,2063215669,28,2069828203,6612534
1652628782,199999,true,2063421991,28,2069621241,6199250
1652628995,199996,true,2064041079,28,2069414299,5373220
1652629023,199994,true,2064453908,28,2069207379,4753471
1652629026,199994,true,2064453908,28,2069207379,4753471
1652629077,199994,true,2064453908,28,2068793599,4339691
1652629601,199992,true,2064866819,28,2063215669,-1651150
1652629867,199990,true,2065279813,28,2060947493,-4332320
1652629921,199990,true,2065279813,28,2060535365,-4744448
1652630159,199989,true,2065486341,28,2058270136,-7216205
1652630388,199988,true,2065692890,28,2056418618,-9274272
1652630593,199986,true,2066106049,28,2055185199,-10920850
1652630623,199986,true,2066106049,28,2054979701,-11126348
1652630739,199985,true,2066312660,28,2054979701,-11332959
1652632072,199983,true,2066725943,28,2058270136,-8455807
1652632315,199981,true,2067139309,28,2059711357,-7427952
1652632444,199981,true,2067139309,28,2060329332,-6809977
1652632522,199980,true,2067346023,28,2060535365,-6810658
1652632645,199977,true,2067966289,28,2061153588,-6812701
1652632658,199975,true,2068379903,28,2061359703,-7020200
1652633003,199975,true,2068379903,28,2063628333,-4751570
1652633012,199974,true,2068586741,28,2063628333,-4958408
1652633026,199972,true,2069000479,28,2063834696,-5165783
1652633036,199970,true,2069414299,28,2063834696,-5579603
1652633836,199969,true,2069621241,28,2072935119,3313878
1652634165,199968,true,2069828203,28,2075839116,6010913
1652634469,199966,true,2070242189,28,2078123681,7881492
1652634523,199965,true,2070449213,28,2078331493,7882280
1652634643,199963,true,2070863324,28,2079162950,8299626
1652634954,199962,true,2071070410,28,2080618801,9548391
1652635568,199960,true,2071484645,28,2082075671,10591026
1652635906,199959,true,2071691794,28,2082700357,11008563
1652635932,199957,true,2072106153,28,2082700357,10594204
1652636020,199957,true,2072106153,28,2082700357,10594204
1652636189,199955,true,2072520595,28,2082908627,10388032
1652636284,199953,true,2072935119,28,2082908627,9973508
1652636292,199953,true,2072935119,28,2082908627,9973508
1652636303,199953,true,2072935119,28,2082908627,9973508
1652636308,199951,true,2073349727,28,2082908627,9558900
1652636345,199950,true,2073557062,28,2082908627,9351565
1652636564,199949,true,2073764418,28,2082283879,8519461
1652636627,199950,true,2073557062,28,2082075671,8518609
1652636840,199950,true,2073557062,28,2081243049,7685987
1652636868,199949,true,2073764418,28,2081243049,7478631
1652636876,199949,true,2073764418,28,2081243049,7478631
1652636881,199949,true,2073764418,28,2081243049,7478631
1652636905,199950,true,2073557062,28,2081034946,7477884
1652636993,199949,true,2073764418,28,2080826863,7062445
1652637122,199949,true,2073764418,28,2080410760,6646342
1652637147,199950,true,2073557062,28,2080202740,6645678
1652637180,199951,true,2073349727,28,2080202740,6853013
1652637190,199951,true,2073349727,28,2079994740,6645013
1652637259,199951,true,2073349727,28,2079578804,6229077
1652637939,199952,true,2073142413,28,2075216489,2074076
1652638098,199953,true,2072935119,28,2074179191,1244072
1652638603,199953,true,2072935119,28,2072313363,-621756
1652638620,199954,true,2072727847,28,2072106153,-621694
1652639319,199955,true,2072520595,28,2071691794,-828801
1652639325,199956,true,2072313363,28,2071691794,-621569
1652639672,199956,true,2072313363,28,2072520595,207232
1652639706,199956,true,2072313363,28,2072727847,414484
1652639735,199957,true,2072106153,28,2072935119,828966
1652639752,199957,true,2072106153,28,2072935119,828966
1652640089,199956,true,2072313363,28,2074594048,2280685
1652640292,199956,true,2072313363,28,2076046700,3733337
1652640666,199956,true,2072313363,28,2079370867,7057504
1652640833,199957,true,2072106153,28,2080618801,8512648
1652641200,199955,true,2072520595,28,2083325229,10804634
1652642004,199955,true,2072520595,28,2086869717,14349122
1652642142,199955,true,2072520595,28,2086869717,14349122
1652642187,199956,true,2072313363,28,2086869717,14556354
1652642384,199955,true,2072520595,28,2086452405,13931810
1652642938,199955,true,2072520595,28,2085826595,13306000
1652642990,199955,true,2072520595,28,2085826595,13306000
1652643541,199956,true,2072313363,28,2084992473,12679110
1652643933,199955,true,2072520595,28,2084367100,11846505
1652643970,199954,true,2072727847,28,2084367100,11639253
1652643983,199954,true,2072727847,28,2084367100,11639253
1652643989,199955,true,2072520595,28,2084367100,11846505
1652644251,199953,true,2072935119,28,2084992473,12057354
1652644332,199953,true,2072935119,28,2085200972,12265853
1652644718,199952,true,2073142413,28,2086035178,12892765
1652644732,199953,true,2072935119,28,2086243781,13308662
1652644761,199951,true,2073349727,28,2086243781,12894054
1652644766,199951,true,2073349727,28,2086243781,12894054
1652644804,199949,true,2073764418,28,2086661051,12896633
1652644881,199949,true,2073764418,28,2087287112,13522694
1652644957,199946,true,2074386609,28,2087913360,13526751
1652645216,199945,true,2074594048,28,2090629277,16035229
1652645244,199944,true,2074801507,28,2090838340,16036833
1652645577,199944,true,2074801507,28,2093976794,19175287
1652645610,199941,true,2075424010,28,2094605050,19181040
1652645649,199939,true,2075839116,28,2095443017,19603901
1652645719,199936,true,2076461930,28,2096910267,20448337
1652646018,199934,true,2076877243,28,2102579291,25702048
1652646276,199931,true,2077500368,28,2107209826,29709458
1652646282,199929,true,2077915889,28,2107420547,29504658
1652646624,199926,true,2078539326,28,2113751985,35212659
1652646632,199923,true,2079162950,28,2113751985,34589035
1652646637,199920,true,2079786762,28,2113963360,34176598
1652646667,199918,true,2080202740,28,2114174756,33972016
1652646997,199916,true,2080618801,28,2117771730,37152929
1652647518,199913,true,2081243049,28,2122011300,40768251
1652648039,199910,true,2081867485,28,2121799120,39931635
1652648399,199907,true,2082492107,28,2121586961,39094854
1652648421,199906,true,2082700357,28,2121586961,38886604
1652648435,199903,true,2083325229,28,2121586961,38261732
1652648657,199901,true,2083741915,28,2122223501,38481586
1652648795,199898,true,2084367100,28,2122860231,38493131
1652648805,199897,true,2084575537,28,2122860231,38284694
1652649035,199894,true,2085200972,28,2123921874,38720902
1652649167,199891,true,2085826595,28,2124559114,38732519
1652649261,199888,true,2086452405,28,2124984047,38531642
1652649344,199886,true,2086869717,28,2125196546,38326829
1652649378,199882,true,2087704590,28,2125409065,37704475
1652649812,199880,true,2088122152,28,2126259356,38137204
1652650234,199877,true,2088748651,28,2126471982,37723331
1652650243,199875,true,2089166422,28,2126471982,37305560
1652651033,199871,true,2090002214,28,2123921874,33919660
1652651057,199868,true,2090629277,28,2123921874,33292597
1652651405,199866,true,2091047424,28,2123497153,32449729
1652651553,199863,true,2091674801,28,2123497153,31822352
1652651598,199858,true,2092720847,28,2123497153,30776306
1652651776,199856,true,2093139412,28,2123497153,30357741
1652651850,199853,true,2093767417,28,2123497153,29729736
1652651981,199851,true,2094186191,28,2123709503,29523312
1652652033,199847,true,2095023991,28,2123709503,28685512
1652652058,199844,true,2095652562,28,2123921874,28269312
1652652121,199842,true,2096071713,28,2124346679,28274966
1652652123,199839,true,2096700597,28,2124346679,27646082
1652652320,199833,true,2097958932,28,2127535431,29576499
1652652594,199831,true,2098378545,28,2131368252,32989707
1652652610,199828,true,2099008122,28,2131581388,32573266
1652652946,199826,true,2099427944,28,2136062189,36634245
1652653181,199821,true,2100477868,28,2139054620,38576752
1652653818,199818,true,2101108075,28,2146339419,45231344
1652654077,199817,true,2101318185,28,2146339419,45021234
1652654264,199815,true,2101738470,28,2145695646,43957176
1652654288,199810,true,2102789549,28,2145481098,42691549
1652654299,199807,true,2103420449,28,2145481098,42060649
1652654322,199806,true,2103630791,28,2145481098,41850307
1652654937,199805,true,2103841154,28,2143765485,39924331
1652655271,199800,true,2104893285,28,2142908193,38014908
1652655280,199798,true,2105314285,28,2142908193,37593908
1652655346,199797,true,2105524817,28,2142479676,36954859
1652655571,199795,true,2105945943,28,2141194638,35248695
1652655580,199791,true,2106788447,28,2141194638,34406191
1652655645,199788,true,2107420547,28,2140766463,33345916
1652655700,199787,true,2107631289,28,2140552408,32921119
1652655714,199786,true,2107842052,28,2140552408,32710356
1652655906,199782,true,2108685316,28,2139482453,30797137
1652656019,199779,true,2109317984,28,2138626873,29308889
1652656321,199778,true,2109528916,28,2136916742,27387826
1652657062,199777,true,2109739869,28,2132860657,23120788
1652657120,199773,true,2110583892,28,2132647392,22063500
1652658129,199770,true,2111217130,28,2131581388,20364258
1652658152,199769,true,2111428252,28,2131794547,20366295
1652658163,199768,true,2111639395,28,2131794547,20155152
1652658176,199763,true,2112695426,28,2131794547,19099121
1652658224,199760,true,2113329298,28,2131794547,18465249
1652658297,199759,true,2113540631,28,2132220927,18680296
1652658343,199758,true,2113751985,28,2132434149,18682164
1652658976,199752,true,2115020553,28,2136916742,21896189
1652659246,199749,true,2115655123,28,2139054620,23399497
1652659256,199747,true,2116078275,28,2139054620,22976345
1652659280,199745,true,2116501512,28,2139268526,22767014
1652659311,199740,true,2117559974,28,2139482453,21922479
1652659343,199737,true,2118195305,28,2139482453,21287148
1652659810,199736,true,2118407125,28,2140766463,22359338
1652660141,199734,true,2118830828,28,2140552408,21721580
1652660218,199729,true,2119890455,28,2140124361,20233906
1652660257,199726,true,2120526486,28,2139696401,19169915
1652660489,199726,true,2120526486,28,2137344146,16817660
1652660539,199726,true,2120526486,28,2136916742,16390256
1652660585,199720,true,2121799120,28,2136489422,14690302
1652661013,199718,true,2122223501,28,2132007726,9784225
1652661241,199718,true,2122223501,28,2130302887,8079386
1652661257,199718,true,2122223501,28,2130089878,7866377
1652661342,199713,true,2123284825,28,2129663924,6379099
1652661522,199712,true,2123497153,28,2128386573,4889420
1652661557,199712,true,2123497153,28,2128173755,4676602
1652661864,199712,true,2123497153,28,2126046752,2549599
1652663288,199707,true,2124559114,28,2121799120,-2759994
1652663321,199706,true,2124771570,28,2121586961,-3184609
1652663360,199706,true,2124771570,28,2121374823,-3396747
1652663370,199706,true,2124771570,28,2121374823,-3396747
1652663578,199702,true,2125621606,28,2120314454,-5307152
1652663858,199701,true,2125834168,28,2118618966,-7215202
1652664028,199701,true,2125834168,28,2117559974,-8274194
1652664103,199701,true,2125834168,28,2117136525,-8697643
1652664298,199698,true,2126471982,28,2115866688,-10605294
1652664401,199697,true,2126684630,28,2115232055,-11452575
1652664446,199697,true,2126684630,28,2115020553,-11664077
1652664674,199698,true,2126471982,28,2113117986,-13353996
1652664794,199695,true,2127109988,28,2111850559,-15259429
1652664811,199695,true,2127109988,28,2111639395,-15470593
1652664828,199695,true,2127109988,28,2111428252,-15681736
1652664920,199697,true,2126684630,28,2110161838,-16522792
1652664958,199695,true,2127109988,28,2109739869,-17370119
1652664984,199695,true,2127109988,28,2109317984,-17792004
1652664997,199695,true,2127109988,28,2109107074,-18002914
1652665022,199697,true,2126684630,28,2108896184,-17788446
1652665041,199695,true,2127109988,28,2108685316,-18424672
1652665252,199696,true,2126897298,28,2106156537,-20740761
1652665452,199697,true,2126684630,28,2104261944,-22422686
1652665785,199700,true,2126046752,28,2101108075,-24938677
1652666008,199700,true,2126046752,28,2098798242,-27248510
1652666115,199701,true,2125834168,28,2097749157,-28085011
1652666238,199702,true,2125621606,28,2096490948,-29130658
1652666290,199705,true,2124984047,28,2096071713,-28912334
1652666341,199705,true,2124984047,28,2095652562,-29331485
1652666369,199706,true,2124771570,28,2095443017,-29328553
1652666482,199707,true,2124559114,28,2094395610,-30163504
1652666497,199710,true,2123921874,28,2094395610,-29526264
1652666559,199710,true,2123921874,28,2093976794,-29945080
1652666563,199711,true,2123709503,28,2093976794,-29732709
1652666614,199713,true,2123284825,28,2093558061,-29726764
1652666714,199715,true,2122860231,28,2092930119,-29930112
1652666750,199716,true,2122647967,28,2092720847,-29927120
1652666940,199718,true,2122223501,28,2092093157,-30130344
1652666963,199719,true,2122011300,28,2091883968,-30127332
1652666974,199722,true,2121374823,28,2091883968,-29490855
1652667102,199723,true,2121162707,28,2091256528,-29906179
1652667200,199725,true,2120738538,28,2090629277,-30109261
1652667721,199727,true,2120314454,28,2086869717,-33444737
1652668097,199730,true,2119678487,28,2084367100,-35311387
1652668327,199731,true,2119466540,28,2082908627,-36557913
1652668515,199733,true,2119042711,28,2082075671,-36967040
1652669070,199735,true,2118618966,28,2081243049,-37375917
1652669111,199737,true,2118195305,28,2081243049,-36952256
1652669139,199738,true,2117983507,28,2081243049,-36740458
1652669179,199740,true,2117559974,28,2081451174,-36108800
1652670323,199742,true,2117136525,28,2080618801,-36517724
1652670432,199745,true,2116501512,28,2080410760,-36090752
1652670457,199746,true,2116289883,28,2080410760,-35879123
1652670486,199747,true,2116078275,28,2080410760,-35667515
1652670568,199750,true,2115443578,28,2080202740,-35240838
1652670599,199753,true,2114809072,28,2079994740,-34814332
1652670701,199754,true,2114597612,28,2079786762,-34810850
1652670714,199756,true,2114174756,28,2079578804,-34595952
1652670824,199759,true,2113540631,28,2079162950,-34377681
1652671177,199762,true,2112906695,28,2078331493,-34575202
1652671312,199766,true,2112061744,28,2077915889,-34145855
1652671372,199768,true,2111639395,28,2077915889,-33723506
1652671389,199771,true,2111006030,28,2077708118,-33297912
1652671441,199775,true,2110161838,28,2077500368,-32661470
1652671480,199778,true,2109528916,28,2077292639,-32236277
1652672046,199781,true,2108896184,28,2074594048,-34302136
1652672469,199784,true,2108263642,28,2072520595,-35743047
1652672741,199787,true,2107631289,28,2071691794,-35939495
1652672777,199791,true,2106788447,28,2071691794,-35096653
1652673976,199793,true,2106367153,28,2070242189,-36124964
1652674108,199796,true,2105735369,28,2070242189,-35493180
1652674814,199800,true,2104893285,28,2069000479,-35892806
1652674825,199803,true,2104261944,28,2069000479,-35261465
1652674858,199806,true,2103630791,28,2069000479,-34630312
1652674926,199809,true,2102999828,28,2068793599,-34206229
1652674991,199811,true,2102579291,28,2068793599,-33785692
1652675053,199814,true,2101948644,28,2068793599,-33155045
1652675153,199817,true,2101318185,28,2068793599,-32524586
1652675179,199820,true,2100687916,28,2069000479,-31687437
1652675347,199822,true,2100267841,28,2069000479,-31267362
1652675649,199825,true,2099637887,28,2069207379,-30430508
1652675749,199827,true,2099218022,28,2069414299,-29803723
1652675935,199830,true,2098588383,28,2069414299,-29174084
1652676029,199832,true,2098168728,28,2069828203,-28340525
1652676088,199835,true,2097539403,28,2069828203,-27711200
1652676986,199838,true,2096910267,28,2071484645,-25425622
1652677433,199840,true,2096490948,28,2071484645,-25006303
1652678185,199843,true,2095862127,28,2071277517,-24584610
1652678542,199845,true,2095443017,28,2071691794,-23751223
1652678616,199848,true,2094814510,28,2071691794,-23122716
1652678681,199851,true,2094186191,28,2071691794,-22494397
1652680038,199854,true,2093558061,28,2074179191,-19378870
1652680110,199857,true,2092930119,28,2074179191,-18750928
1652680372,199860,true,2092302366,28,2074386609,-17915757
1652680382,199863,true,2091674801,28,2074386609,-17288192
1652680388,199866,true,2091047424,28,2074386609,-16660815
1652680412,199869,true,2090420235,28,2074386609,-16033626
1652680492,199872,true,2089793234,28,2074386609,-15406625
1652680827,199875,true,2089166422,28,2073349727,-15816695
1652680873,199877,true,2088748651,28,2073142413,-15606238
1652680886,199880,true,2088122152,28,2072935119,-15187033
1652681100,199884,true,2087287112,28,2071070410,-16216702
1652681127,199887,true,2086661051,28,2070656258,-16004793
1652681135,199889,true,2086243781,28,2070656258,-15587523
1652681165,199892,true,2085618033,28,2070242189,-15375844
1652681169,199896,true,2084783994,28,2070242189,-14541805
1652681178,199900,true,2083950289,28,2070035186,-13915103
1652681192,199902,true,2083533562,28,2069828203,-13705359
1652681334,199906,true,2082700357,28,2067346023,-15354334
1652681340,199910,true,2081867485,28,2067346023,-14521462
1652681444,199914,true,2081034946,28,2065486341,-15548605
1652681558,199915,true,2080826863,28,2063421991,-17404872
1652681836,199920,true,2079786762,28,2058475963,-21310799
1652681878,199924,true,2078955055,28,2057652778,-21302277
1652681958,199928,true,2078123681,28,2055596257,-22527424
1652681969,199930,true,2077708118,28,2055390717,-22317401
1652682114,199934,true,2076877243,28,2051284249,-25592994
1652682386,199939,true,2075839116,28,2044117661,-31721455
1652682430,199943,true,2075008988,28,2043095909,-31913079
1652682456,199945,true,2074594048,28,2042278875,-32315173
1652682828,199950,true,2073557062,28,2032906434,-40650628
1652682836,199955,true,2072520595,28,2032703164,-39817431
1652682855,199959,true,2071691794,28,2032296684,-39395110
1652683058,199961,true,2071277517,28,2028033552,-43243965
1652683791,199966,true,2070242189,28,2018120989,-52121200
1652683931,199970,true,2069414299,28,2017515674,-51898625
1652683953,199974,true,2068586741,28,2017313942,-51272799
1652684040,199975,true,2068379903,28,2016708869,-51671034
1652684071,199981,true,2067139309,28,2016507218,-50632091
1652684084,199986,true,2066106049,28,2016507218,-49598831
1652684108,199989,true,2065486341,28,2016305588,-49180753
1652684313,199991,true,2065073306,28,2014693269,-50380037
1652684619,199996,true,2064041079,28,2013283548,-50757531
1652684683,200001,true,2063009368,28,2012880951,-50128417
1652684690,200004,true,2062390589,28,2012880951,-49509638
1652684824,200006,true,2061978173,28,2012277208,-49700965
1652684855,200011,true,2060947493,28,2012277208,-48670285
1652684900,200016,true,2059917328,28,2011874813,-48042515
1652684911,200020,true,2059093567,28,2011673645,-47419922
1652684923,200022,true,2058681810,28,2011673645,-47008165
1652684967,200027,true,2057652778,28,2011070264,-46582514
1652685092,200032,true,2056624260,28,2010065030,-46559230
1652685221,200036,true,2055801816,28,2008859413,-46942403
1652685597,200038,true,2055390717,28,2005246899,-50143818
1652685776,200044,true,2054157915,28,2003443079,-50714836
1652685877,200048,true,2053336457,28,2002641902,-50694555
1652685919,200052,true,2052515327,28,2002441658,-50073669
1652685926,200054,true,2052104886,28,2002441658,-49663228
1652685973,200059,true,2051079141,28,2002241434,-48837707
1652686006,200064,true,2050053909,28,2002241434,-47812475
1652686188,200066,true,2049643960,28,2001841046,-47802914
1652686678,200069,true,2049029190,28,2001440737,-47588453
1652686742,200074,true,2048004982,28,2001841046,-46163936
1652686754,200077,true,2047390704,28,2001841046,-45549658
1652686756,200080,true,2046776609,28,2001841046,-44935563
1652686794,200081,true,2046571952,28,2002041230,-44530722
1652686839,200086,true,2045548973,28,2002441658,-43107315
1652686858,200089,true,2044935431,28,2002441658,-42493773
1652686879,200092,true,2044322073,28,2002641902,-41680171
1652687009,200093,true,2044117661,28,2003643423,-40474238
1652687263,200098,true,2043095909,28,2005447424,-37648485
1652687548,200101,true,2042483103,28,2008457702,-34025401
1652687556,200103,true,2042074668,28,2008457702,-33616966
1652687609,200105,true,2041666314,28,2009060299,-32606015
1652687627,200109,true,2040849852,28,2009261205,-31588647
1652687639,200113,true,2040033716,28,2009261205,-30772511
1652687670,200115,true,2039625770,28,2009663078,-29962692
1652687707,200116,true,2039421828,28,2009864044,-29557784
1652687812,200120,true,2038606263,28,2010668110,-27938153
1652688031,200124,true,2037791024,28,2011472498,-26318526
1652688944,200126,true,2037383527,28,2013887593,-23495934
1652689004,200127,true,2037179809,28,2013887593,-23292216
1652689048,200131,true,2036365141,28,2013887593,-22477548
1652689136,200135,true,2035550799,28,2014088982,-21461817
1652690168,200136,true,2035347264,28,2017313942,-18033322
1652690243,200137,true,2035143750,28,2017515674,-17628076
1652690443,200141,true,2034329896,28,2018322801,-16007095
1652690508,200144,true,2033719719,28,2018524633,-15195086
1652690625,200144,true,2033719719,28,2018928358,-14791361
1652690630,200145,true,2033516367,28,2018928358,-14588009
1652690683,200149,true,2032703164,28,2019130251,-13572913
1652690689,200152,true,2032093475,28,2019130251,-12963224
1652690894,200153,true,2031890286,28,2019938024,-11952262
1652691096,200154,true,2031687117,28,2020342032,-11345085
1652691377,200157,true,2031077733,28,2020948195,-10129538
1652691447,200160,true,2030468531,28,2020948195,-9520336
1652691717,200161,true,2030265505,28,2021554541,-8710964
1652691749,200162,true,2030062498,28,2021554541,-8507957
1652691778,200166,true,2029250676,28,2021554541,-7696135
1652691810,200168,true,2028844887,28,2021756696,-7088191
1652691935,200169,true,2028642023,28,2021958872,-6683151
1652691957,200170,true,2028439179,28,2021958872,-6480307
1652691991,200174,true,2027628006,28,2021958872,-5669134
1652692022,200177,true,2027019839,28,2021958872,-5060967
1652692093,200178,true,2026817158,28,2021958872,-4858286
1652692152,200179,true,2026614496,28,2021756696,-4857800
1652692299,200183,true,2025804053,28,2021756696,-4047357
1652692325,200186,true,2025196433,28,2021554541,-3641892
1652692329,200187,true,2024993934,28,2021554541,-3439393
1652692411,200189,true,2024588996,28,2021352405,-3236591
1652692502,200193,true,2023779363,28,2021150290,-2629073
1652692656,200196,true,2023172350,28,2020342032,-2830318
1652692690,200197,true,2022970053,28,2020140018,-2830035
1652692695,200199,true,2022565520,28,2020140018,-2425502
1652692706,200204,true,2021554541,28,2020140018,-1414523
1652692871,200208,true,2020746121,28,2018928358,-1817763
1652692967,200209,true,2020544066,28,2018322801,-2221265
1652693003,200210,true,2020342032,28,2018120989,-2221043
1652693007,200215,true,2019332164,28,2017919197,-1412967
1652693025,200218,true,2018726486,28,2017919197,-807289
1652693062,200219,true,2018524633,28,2017515674,-1008959
1652693068,200222,true,2017919197,28,2017515674,-403523
1652693072,200226,true,2017112231,28,2017313942,201711
1652693134,200229,true,2016507218,28,2016708869,201651
1652693604,200229,true,2016507218,28,2011673645,-4833573
1652693759,200231,true,2016103977,28,2010266037,-5837940
1652693999,200235,true,2015297737,28,2008457702,-6840035
1652694012,200238,true,2014693269,28,2008457702,-6235567
1652694162,200237,true,2014894738,28,2007453774,-7440964
1652694320,200239,true,2014491820,28,2006650993,-7840827
1652694360,200242,true,2013887593,28,2006450348,-7437245
1652694369,200244,true,2013484876,28,2006450348,-7034528
1652694390,200244,true,2013484876,28,2006450348,-7034528
1652694493,200245,true,2013283548,28,2006249723,-7033825
1652695220,200248,true,2012679683,28,2008056070,-4623613
1652695223,200250,true,2012277208,28,2008056070,-4221138
1652695272,200249,true,2012478435,28,2008256876,-4221559
1652695287,200250,true,2012277208,28,2008256876,-4020332
1652695464,200251,true,2012076000,28,2008859413,-3216587
1652695576,200253,true,2011673645,28,2009060299,-2613346
1652695643,200252,true,2011874813,28,2009261205,-2613608
1652695671,200252,true,2011874813,28,2009261205,-2613608
1652695692,200253,true,2011673645,28,2009261205,-2412440
1652695782,200254,true,2011472498,28,2009261205,-2211293
1652695787,200254,true,2011472498,28,2009261205,-2211293
1652695805,200254,true,2011472498,28,2009261205,-2211293
1652695806,200255,true,2011271371,28,2009261205,-2010166
1652695817,200257,true,2010869177,28,2009261205,-1607972
1652695834,200257,true,2010869177,28,2009060299,-1808878
1652695875,200258,true,2010668110,28,2008859413,-1808697
1652695958,200257,true,2010869177,28,2008859413,-2009764
1652696031,200258,true,2010668110,28,2008859413,-1808697
1652696047,200258,true,2010668110,28,2009060299,-1607811
1652696092,200258,true,2010668110,28,2009060299,-1607811
1652696119,200257,true,2010869177,28,2009261205,-1607972
1652696134,200258,true,2010668110,28,2009261205,-1406905
1652696144,200258,true,2010668110,28,2009261205,-1406905
1652696217,200257,true,2010869177,28,2009663078,-1206099
1652696277,200255,true,2011271371,28,2010065030,-1206341
1652696320,200255,true,2011271371,28,2010065030,-1206341
1652696338,200255,true,2011271371,28,2010266037,-1005334
1652696357,200254,true,2011472498,28,2010266037,-1206461
1652696381,200251,true,2012076000,28,2010467063,-1608937
1652696424,200251,true,2012076000,28,2010869177,-1206823
1652696448,200251,true,2012076000,28,2010869177,-1206823
1652696451,200250,true,2012277208,28,2010869177,-1408031
1652696540,200246,true,2013082239,28,2011874813,-1207426
1652697159,200246,true,2013082239,28,2018726486,5644247
1652697551,200245,true,2013283548,28,2023374668,10091120
1652697575,200244,true,2013484876,28,2023779363,10294487
1652697606,200240,true,2014290391,28,2024184139,9893748
1652697635,200240,true,2014290391,28,2024993934,10703543
1652697658,200240,true,2014290391,28,2025601493,11311102
1652698249,200238,true,2014693269,28,2032296684,17603415
1652698264,200235,true,2015297737,28,2032296684,16998947
1652698293,200235,true,2015297737,28,2032499914,17202177
1652698329,200235,true,2015297737,28,2032499914,17202177
1652698401,200233,true,2015700817,28,2032906434,17205617
1652698474,200230,true,2016305588,28,2033313036,17007448
1652698603,200230,true,2016305588,28,2034126483,17820895
1652698747,200230,true,2016305588,28,2035143750,18838162
1652699048,200228,true,2016708869,28,2037179809,20470940
1652699346,200225,true,2017313942,28,2039421828,22107886
1652699389,200225,true,2017313942,28,2039625770,22311828
1652699443,200225,true,2017313942,28,2040033716,22719774
1652699565,200223,true,2017717425,28,2040441743,22724318
1652699583,200220,true,2018322801,28,2040645787,22322986
1652699686,200220,true,2018322801,28,2040849852,22527051
1652699722,200220,true,2018322801,28,2041053937,22731136
1652699736,200218,true,2018726486,28,2041053937,22327451
1652699769,200215,true,2019332164,28,2041258042,21925878
1652699797,200215,true,2019332164,28,2041258042,21925878
1652699799,200215,true,2019332164,28,2041258042,21925878
1652699820,200214,true,2019534097,28,2041258042,21723945
1652699821,200211,true,2020140018,28,2041258042,21118024
1652700020,200211,true,2020140018,28,2041258042,21118024
1652700639,200212,true,2019938024,28,2039625770,19687746
1652700690,200211,true,2020140018,28,2039421828,19281810
1652700732,200208,true,2020746121,28,2039421828,18675707
1652701178,200208,true,2020746121,28,2038198603,17452482
1652701602,200209,true,2020544066,28,2037587266,17043200
1652701871,200207,true,2020948195,28,2037994804,17046609
1652701889,200205,true,2021352405,28,2037994804,16642399
1652702158,200205,true,2021352405,28,2038198603,16846198
1652702185,200206,true,2021150290,28,2038198603,17048313
1652702221,200205,true,2021352405,28,2038198603,16846198
1652702294,200202,true,2021958872,28,2038198603,16239731
1652702511,200203,true,2021756696,28,2038198603,16441907
1652702518,200204,true,2021554541,28,2038198603,16644062
1652702557,200202,true,2021958872,28,2038198603,16239731
1652702580,200200,true,2022363284,28,2037994804,15631520
1652702605,200201,true,2022161068,28,2037994804,15833736
1652702647,200202,true,2021958872,28,2037587266,15628394
1652702674,200201,true,2022161068,28,2037383527,15222459
1652702802,200200,true,2022363284,28,2036161525,13798241
1652702843,200201,true,2022161068,28,2035754354,13593286
1652703447,200202,true,2021958872,28,2029453601,7494729
1652703557,200201,true,2022161068,28,2028236355,6075287
1652703627,200200,true,2022363284,28,2027222541,4859257
1652703922,200201,true,2022161068,28,2022767777,606709
1652703953,200203,true,2021756696,28,2022363284,606588
1652703970,200202,true,2021958872,28,2022161068,202196
1652703988,200200,true,2022363284,28,2021958872,-404412
1652704024,200201,true,2022161068,28,2021554541,-606527
1652704041,200203,true,2021756696,28,2021352405,-404291
1652704082,200202,true,2021958872,28,2020948195,-1010677
1652704083,200199,true,2022565520,28,2020948195,-1617325
1652704108,200199,true,2022565520,28,2020746121,-1819399
1652704117,200201,true,2022161068,28,2020746121,-1414947
1652704239,200197,true,2022970053,28,2020746121,-2223932
1652704247,200195,true,2023374668,28,2020746121,-2628547
1652704464,200193,true,2023779363,28,2023172350,-607013
1652704674,200194,true,2023577005,28,2026817158,3240153
1652704719,200189,true,2024588996,28,2027425264,2836268
1652704781,200187,true,2024993934,28,2028439179,3445245
1652704827,200185,true,2025398953,28,2029250676,3851723
1652704852,200186,true,2025196433,28,2029656547,4460114
1652704854,200182,true,2026006633,28,2029656547,3649914
1652704860,200180,true,2026411855,28,2029656547,3244692
1652704910,200178,true,2026817158,28,2030265505,3448347
1652704918,200179,true,2026614496,28,2030265505,3651009
1652705316,200177,true,2027019839,28,2032499914,5480075
1652705376,200175,true,2027425264,28,2032906434,5481170
1652705409,200174,true,2027628006,28,2033109725,5481719
1652705424,200175,true,2027425264,28,2033313036,5887772
1652705460,200174,true,2027628006,28,2033516367,5888361
1652705518,200173,true,2027830769,28,2033923091,6092322
1652705588,200171,true,2028236355,28,2034533329,6296974
1652705748,200173,true,2027830769,28,2035754354,7923585
1652706002,200171,true,2028236355,28,2035957929,7721574
1652706127,200170,true,2028439179,28,2034533329,6094150
1652706206,200169,true,2028642023,28,2033313036,4671013
1652706845,200169,true,2028642023,28,2030062498,1420475
1652706896,200167,true,2029047772,28,2030265505,1217733
1652706933,200165,true,2029453601,28,2030265505,811904
1652707207,200164,true,2029656547,28,2030062498,405951
1652707374,200166,true,2029250676,28,2029453601,202925
1652707424,200164,true,2029656547,28,2029250676,-405871
1652707519,200162,true,2030062498,28,2029047772,-1014726
1652707635,200161,true,2030265505,28,2028642023,-1623482
1652707694,200161,true,2030265505,28,2028439179,-1826326
1652707856,200159,true,2030671578,28,2027628006,-3043572
1652707890,200159,true,2030671578,28,2027425264,-3246314
1652707906,200159,true,2030671578,28,2027425264,-3246314
1652707959,200159,true,2030671578,28,2027222541,-3449037
1652707987,200158,true,2030874645,28,2027019839,-3854806
1652707996,200158,true,2030874645,28,2027019839,-3854806
1652708000,200158,true,2030874645,28,2026817158,-4057487
1652708041,200159,true,2030671578,28,2026411855,-4259723
1652708170,200158,true,2030874645,28,2024588996,-6285649
1652708196,200159,true,2030671578,28,2024184139,-6487439
1652708321,200159,true,2030671578,28,2022363284,-8308294
1652708357,200160,true,2030468531,28,2021958872,-8509659
1652708365,200160,true,2030468531,28,2021756696,-8711835
1652708380,200161,true,2030265505,28,2021756696,-8508809
1652708498,200160,true,2030468531,28,2020746121,-9722410
1652708541,200161,true,2030265505,28,2020342032,-9923473
1652708603,200160,true,2030468531,28,2019938024,-10530507
1652708655,200161,true,2030265505,28,2019534097,-10731408
1652708668,200161,true,2030265505,28,2019534097,-10731408
1652708694,200162,true,2030062498,28,2019332164,-10730334
1652708721,200162,true,2030062498,28,2019130251,-10932247
1652708740,200163,true,2029859512,28,2018928358,-10931154
1652708762,200163,true,2029859512,28,2018726486,-11133026
1652708770,200165,true,2029453601,28,2018726486,-10727115
1652708775,200166,true,2029250676,28,2018524633,-10726043
1652708793,200168,true,2028844887,28,2018322801,-10522086
1652708973,200169,true,2028642023,28,2015700817,-12941206
1652709020,200171,true,2028236355,28,2015096228,-13140127
1652709070,200172,true,2028033552,28,2014491820,-13541732
1652709180,200175,true,2027425264,28,2013283548,-14141716
1652709425,200176,true,2027222541,28,2010869177,-16353364
1652709482,200178,true,2026817158,28,2010266037,-16551121
1652709558,200180,true,2026411855,28,2009663078,-16748777
1652709578,200183,true,2025804053,28,2009462131,-16341922
1652709602,200184,true,2025601493,28,2009060299,-16541194
1652709643,200186,true,2025196433,28,2008658547,-16537886
1652709646,200188,true,2024791455,28,2008658547,-16132908
1652709786,200192,true,2023981741,28,2006450348,-17531393
1652709928,200193,true,2023779363,28,2004645445,-19133918
1652710018,200195,true,2023374668,28,2004044172,-19330496
1652710028,200196,true,2023172350,28,2004044172,-19128178
1652710119,200200,true,2022363284,28,2003443079,-18920205
1652710121,200200,true,2022363284,28,2003443079,-18920205
1652710279,200202,true,2021958872,28,2002241434,-19717438
1652710334,200203,true,2021756696,28,2001841046,-19915650
1652710340,200205,true,2021352405,28,2001841046,-19511359
1652710577,200205,true,2021352405,28,2000640361,-20712044
1652711010,200206,true,2021150290,28,2004645445,-16504845
1652711406,200206,true,2021150290,28,2008256876,-12893414
1652711410,200209,true,2020544066,28,2008256876,-12287190
1652711490,200209,true,2020544066,28,2009462131,-11081935
1652711611,200209,true,2020544066,28,2011472498,-9071568
1652711648,200209,true,2020544066,28,2012076000,-8468066
1652712126,200213,true,2019736051,28,2016507218,-3228833
1652712156,200213,true,2019736051,28,2016507218,-3228833
1652712360,200213,true,2019736051,28,2016507218,-3228833
1652712362,200213,true,2019736051,28,2016507218,-3228833
1652712429,200217,true,2018928358,28,2016305588,-2622770
1652712483,200217,true,2018928358,28,2015902387,-3025971
1652713000,200219,true,2018524633,28,2012679683,-5844950
1652713021,200219,true,2018524633,28,2012478435,-6046198
1652713037,200223,true,2017717425,28,2012277208,-5440217
1652713522,200222,true,2017919197,28,2007855285,-10063912
1652713602,200224,true,2017515674,28,2007453774,-10061900
1652713865,200223,true,2017717425,28,2005848533,-11868892
1652713887,200226,true,2017112231,28,2005647969,-11464262
1652713900,200225,true,2017313942,28,2005647969,-11665973
1652714178,200226,true,2017112231,28,2004845910,-12266321
1652714254,200225,true,2017313942,28,2005046395,-12267547
1652714259,200228,true,2016708869,28,2005046395,-11662474
1652714694,200226,true,2017112231,28,2007052344,-10059887
1652714734,200226,true,2017112231,28,2007052344,-10059887
1652714899,200225,true,2017313942,28,2007654519,-9659423
1652714908,200228,true,2016708869,28,2007654519,-9054350
1652715013,200227,true,2016910540,28,2007855285,-9055255
1652715060,200227,true,2016910540,28,2007855285,-9055255
1652715094,200227,true,2016910540,28,2008056070,-8854470
1652715119,200230,true,2016305588,28,2008056070,-8249518
1652715127,200230,true,2016305588,28,2008056070,-8249518
1652715162,200231,true,2016103977,28,2008056070,-8047907
1652715400,200233,true,2015700817,28,2008056070,-7644747
1652715498,200236,true,2015096228,28,2007654519,-7441709
1652715564,200238,true,2014693269,28,2007253049,-7440220
1652715686,200239,true,2014491820,28,2006650993,-7840827
1652715699,200242,true,2013887593,28,2006650993,-7236600
1652715731,200246,true,2013082239,28,2006450348,-6631891
1652715738,200248,true,2012679683,28,2006249723,-6429960
1652715746,200249,true,2012478435,28,2006249723,-6228712
1652715827,200252,true,2011874813,28,2005647969,-6226844
1652715878,200256,true,2011070264,28,2005246899,-5823365
1652715929,200257,true,2010869177,28,2004645445,-6223732
1652716158,200257,true,2010869177,28,2003042451,-7826726
1652716178,200258,true,2010668110,28,2003042451,-7625659
1652716353,200261,true,2010065030,28,2001640882,-8424148
1652716456,200262,true,2009864044,28,2001040509,-8823535
1652716491,200262,true,2009864044,28,2000840425,-9023619
1652716523,200263,true,2009663078,28,2000840425,-8822653
1652716529,200265,true,2009261205,28,2000840425,-8420780
1652716610,200265,true,2009261205,28,2000840425,-8420780
1652716629,200265,true,2009261205,28,2000640361,-8620844
1652716669,200266,true,2009060299,28,2000440317,-8619982
1652716725,200269,true,2008457702,28,2000440317,-8017385
1652716796,200269,true,2008457702,28,2000440317,-8017385
1652716869,200270,true,2008256876,28,2000240293,-8016583
1652716894,200271,true,2008056070,28,2000240293,-7815777
1652716928,200274,true,2007453774,28,2000240293,-7213481
1652716986,200274,true,2007453774,28,2000640361,-6813413
1652717033,200273,true,2007654519,28,2000840425,-6814094
1652717075,200274,true,2007453774,28,2001040509,-6413265
1652717131,200276,true,2007052344,28,2001240613,-5811731
1652717219,200276,true,2007052344,28,2001240613,-5811731
1652717327,200276,true,2007052344,28,2001440737,-5611607
1652717381,200277,true,2006851658,28,2001440737,-5410921
1652717457,200280,true,2006249723,28,2001440737,-4808986
1652717494,200279,true,2006450348,28,2001440737,-5009611
1652717621,200280,true,2006249723,28,2001640882,-4608841
1652717908,200281,true,2006049118,28,2001640882,-4408236
1652717925,200283,true,2005647969,28,2001640882,-4007087
1652718635,200283,true,2005647969,28,1998241153,-7406816
1652718750,200283,true,2005647969,28,1997641800,-8006169
1652718831,200284,true,2005447424,28,1996842943,-8604481
1652718847,200286,true,2005046395,28,1996842943,-8203452
1652718917,200286,true,2005046395,28,1996443634,-8602761
1652719201,200285,true,2005246899,28,1996044406,-9202493
1652719221,200286,true,2005046395,28,1996044406,-9001989
1652719314,200288,true,2004645445,28,1996244010,-8401435
1652719404,200289,true,2004445001,28,1996244010,-8200991
1652719470,200289,true,2004445001,28,1996244010,-8200991
1652719472,200290,true,2004244577,28,1996244010,-8000567
1652719507,200293,true,2003643423,28,1996044406,-7599017
1652719664,200296,true,2003042451,28,1995046683,-7995768
1652719698,200296,true,2003042451,28,1994647733,-8394718
1652720524,200297,true,2002842166,28,1990662623,-12179543
1652720530,200299,true,2002441658,28,1990662623,-11779035
1652720782,200301,true,2002041230,28,1989468644,-12572586
1652720894,200301,true,2002041230,28,1989070810,-12970420
1652720911,200301,true,2002041230,28,1989070810,-12970420
1652721091,200302,true,2001841046,28,1988474208,-13366838
1652721099,200303,true,2001640882,28,1988474208,-13166674
1652721161,200302,true,2001841046,28,1988474208,-13366838
1652721236,200302,true,2001841046,28,1988474208,-13366838
1652721318,200303,true,2001640882,28,1988673055,-12967827
1652721412,200304,true,2001440737,28,1989269717,-12171020
1652721702,200303,true,2001640882,28,1991459008,-10181874
1652722189,200301,true,2002041230,28,1997242332,-4798898
1652722255,200303,true,2001640882,28,1998241153,-3399729
1652722298,200303,true,2001640882,28,1998840685,-2800197
1652722324,200301,true,2002041230,28,1999240473,-2800757
1652722899,200298,true,2002641902,28,2007052344,4410442
1652724268,200298,true,2002641902,28,2015902387,13260485
1652724316,200298,true,2002641902,28,2016103977,13462075
1652724331,200297,true,2002842166,28,2016305588,13463422
1652724347,200294,true,2003443079,28,2016305588,12862509
1652724898,200293,true,2003643423,28,2019938024,16294601
1652725056,200293,true,2003643423,28,2021150290,17506867
1652725947,200292,true,2003843788,28,2027425264,23581476
1652727084,200289,true,2004445001,28,2031280840,26835839
1652727723,200288,true,2004645445,28,2032703164,28057719
1652728045,200289,true,2004445001,28,2033109725,28664724
1652728375,200289,true,2004445001,28,2033516367,29071366
1652728442,200286,true,2005046395,28,2033516367,28469972
1652728479,200285,true,2005246899,28,2033516367,28269468
1652728511,200286,true,2005046395,28,2033516367,28469972
1652728544,200286,true,2005046395,28,2033516367,28469972
1652728666,200284,true,2005447424,28,2033516367,28068943
1652728744,200282,true,2005848533,28,2033313036,27464503
1652729104,200283,true,2005647969,28,2032906434,27258465
1652729244,200284,true,2005447424,28,2032499914,27052490
1652729247,200281,true,2006049118,28,2032499914,26450796
1652729280,200279,true,2006450348,28,2032499914,26049566
1652729653,200280,true,2006249723,28,2031077733,24828010
1652729679,200280,true,2006249723,28,2030874645,24624922
1652729966,200278,true,2006650993,28,2029047772,22396779
1652730002,200276,true,2007052344,28,2028844887,21792543
1652730150,200277,true,2006851658,28,2027830769,20979111
1652730642,200276,true,2007052344,28,2025398953,18346609
1652730725,200274,true,2007453774,28,2024993934,17540160
1652730729,200272,true,2007855285,28,2024993934,17138649
1652730805,200274,true,2007453774,28,2024386557,16932783
1652730817,200274,true,2007453774,28,2024386557,16932783
1652730920,200273,true,2007654519,28,2023577005,15922486
1652730972,200271,true,2008056070,28,2022970053,14913983
1652732041,200274,true,2007453774,28,2012880951,5427177
1652732066,200275,true,2007253049,28,2012679683,5426634
1652732097,200273,true,2007654519,28,2012478435,4823916
1652732167,200271,true,2008056070,28,2011874813,3818743
1652732235,200274,true,2007453774,28,2011472498,4018724
1652732265,200274,true,2007453774,28,2011271371,3817597
1652732320,200273,true,2007654519,28,2011070264,3415745
1652732445,200270,true,2008256876,28,2010467063,2210187
1652733257,200273,true,2007654519,28,2011472498,3817979
1652733400,200272,true,2007855285,28,2012277208,4421923
1652733430,200270,true,2008256876,28,2012277208,4020332
1652733452,200268,true,2008658547,28,2012478435,3819888
1652733735,200270,true,2008256876,28,2014088982,5832106
1652733992,200269,true,2008457702,28,2015297737,6840035
1652734039,200267,true,2008859413,28,2015700817,6841404
1652734160,200264,true,2009462131,28,2016305588,6843457
1652734662,200265,true,2009261205,28,2019332164,10070959
1652734800,200264,true,2009462131,28,2020140018,10677887
1652734887,200261,true,2010065030,28,2020948195,10883165
1652735025,200258,true,2010668110,28,2021958872,11290762
1652735078,200259,true,2010467063,28,2022363284,11896221
1652735089,200258,true,2010668110,28,2022565520,11897410
1652735117,200255,true,2011271371,28,2022767777,11496406
1652735227,200251,true,2012076000,28,2024184139,12108139
1652735269,200252,true,2011874813,28,2024588996,12714183
1652735309,200251,true,2012076000,28,2025196433,13120433
1652735337,200249,true,2012478435,28,2025601493,13123058
1652735392,200245,true,2013283548,28,2026411855,13128307
1652735630,200246,true,2013082239,28,2029859512,16777273
1652735742,200245,true,2013283548,28,2031280840,17997292
1652735791,200242,true,2013887593,28,2031890286,18002693
1652735951,200238,true,2014693269,28,2033516367,18823098
1652736296,200240,true,2014290391,28,2035550799,21260408
1652736373,200239,true,2014491820,28,2035957929,21466109
1652737072,200236,true,2015096228,28,2038198603,23102375
1652737212,200233,true,2015700817,28,2037791024,22090207
1652737238,200234,true,2015499267,28,2037587266,22087999
1652737373,200234,true,2015499267,28,2037179809,21680542
1652737436,200231,true,2016103977,28,2037179809,21075832
1652737444,200228,true,2016708869,28,2037179809,20470940
1652737858,200229,true,2016507218,28,2037383527,20876309
1652737958,200228,true,2016708869,28,2037587266,20878397
1652738312,200225,true,2017313942,28,2037994804,20680862
1652738394,200221,true,2018120989,28,2038198603,20077614
1652738429,200221,true,2018120989,28,2038198603,20077614
1652738515,200220,true,2018322801,28,2038810124,20487323
1652738557,200216,true,2019130251,28,2039014005,19883754
1652738702,200212,true,2019938024,28,2040033716,20095692
1652738835,200212,true,2019938024,28,2040849852,20911828
1652738898,200211,true,2020140018,28,2041258042,21118024
1652738929,200207,true,2020948195,28,2041258042,20309847
1652739940,200203,true,2021756696,28,2044526505,22769809
1652740003,200204,true,2021554541,28,2044730958,23176417
1652740093,200203,true,2021756696,28,2044935431,23178735
1652740243,200199,true,2022565520,28,2044935431,22369911
1652741183,200195,true,2023374668,28,2042074668,18700000
1652741497,200196,true,2023172350,28,2041258042,18085692
1652741514,200195,true,2023374668,28,2041053937,17679269
1652741519,200191,true,2024184139,28,2041053937,16869798
1652741607,200188,true,2024791455,28,2040645787,15854332
1652741757,200188,true,2024791455,28,2039625770,14834315
1652741917,200186,true,2025196433,28,2038606263,13409830
1652742590,200183,true,2025804053,28,2035754354,9950301
1652743471,200179,true,2026614496,28,2031687117,5072621
1652743503,200180,true,2026411855,28,2031687117,5275262
1652743982,200178,true,2026817158,28,2031280840,4463682
1652744049,200176,true,2027222541,28,2031077733,3855192
1652744055,200172,true,2028033552,28,2031077733,3044181
1652744062,200173,true,2027830769,28,2031077733,3246964
1652744070,200172,true,2028033552,28,2031077733,3044181
1652744143,200170,true,2028439179,28,2030874645,2435466
1652744745,200167,true,2029047772,28,2028439179,-608593
1652744788,200168,true,2028844887,28,2028236355,-608532
1652745529,200167,true,2029047772,28,2024791455,-4256317
1652746051,200167,true,2029047772,28,2022767777,-6279995
1652746121,200164,true,2029656547,28,2022565520,-7091027
1652746340,200165,true,2029453601,28,2022161068,-7292533
1652746493,200165,true,2029453601,28,2022161068,-7292533
1652746635,200165,true,2029453601,28,2022161068,-7292533
1652746645,200163,true,2029859512,28,2022161068,-7698444
1652746684,200164,true,2029656547,28,2022363284,-7293263
1652746750,200163,true,2029859512,28,2022565520,-7293992
1652746764,200163,true,2029859512,28,2022565520,-7293992
1652747018,200162,true,2030062498,28,2024184139,-5878359
1652747092,200163,true,2029859512,28,2024791455,-5068057
1652747327,200163,true,2029859512,28,2026209234,-3650278
1652748031,200163,true,2029859512,28,2031077733,1218221
1652748060,200161,true,2030265505,28,2031280840,1015335
1652748348,200162,true,2030062498,28,2033516367,3453869
1652748355,200162,true,2030062498,28,2033516367,3453869
1652748397,200162,true,2030062498,28,2033923091,3860593
1652748627,200161,true,2030265505,28,2035347264,5081759
1652748669,200161,true,2030265505,28,2035550799,5285294
1652749352,200161,true,2030265505,28,2039217906,8952401
1652749720,200160,true,2030468531,28,2041258042,10789511
1652749930,200159,true,2030671578,28,2041870481,11198903
1652749982,200159,true,2030671578,28,2041870481,11198903
1652750078,200159,true,2030671578,28,2042074668,11403090
1652750101,200158,true,2030874645,28,2042074668,11200023
1652750144,200157,true,2031077733,28,2042074668,10996935
1652750241,200157,true,2031077733,28,2041870481,10792748
1652750737,200157,true,2031077733,28,2039421828,8344095
1652750743,200157,true,2031077733,28,2039421828,8344095
1652750782,200156,true,2031280840,28,2039014005,7733165
1652750842,200156,true,2031280840,28,2038606263,7325423
1652750976,200156,true,2031280840,28,2037791024,6510184
1652751004,200155,true,2031483969,28,2037587266,6103297
1652751063,200154,true,2031687117,28,2037179809,5492692
1652751244,200154,true,2031687117,28,2035754354,4067237
1652751282,200154,true,2031687117,28,2035347264,3660147
1652751306,200153,true,2031890286,28,2035143750,3253464
1652751340,200152,true,2032093475,28,2034940256,2846781
1652751755,200151,true,2032296684,28,2031687117,-609567
1652752139,200151,true,2032296684,28,2029859512,-2437172
1652752401,200150,true,2032499914,28,2029047772,-3452142
1652752459,200148,true,2032906434,28,2028844887,-4061547
1652752477,200147,true,2033109725,28,2028844887,-4264838
1652752499,200147,true,2033109725,28,2028642023,-4467702
1652752542,200146,true,2033313036,28,2028642023,-4671013
1652752688,200145,true,2033516367,28,2028844887,-4671480
1652752817,200144,true,2033719719,28,2028844887,-4874832
1652753452,200144,true,2033719719,28,2030874645,-2845074
1652753497,200143,true,2033923091,28,2031077733,-2845358
1652753551,200141,true,2034329896,28,2031280840,-3049056
1652753569,200141,true,2034329896,28,2031280840,-3049056
1652753580,200141,true,2034329896,28,2031280840,-3049056
1652753584,200140,true,2034533329,28,2031280840,-3252489
1652753605,200138,true,2034940256,28,2031483969,-3456287
1652754109,200138,true,2034940256,28,2034940256,0
1652754117,200138,true,2034940256,28,2034940256,0
1652754138,200137,true,2035143750,28,2035143750,0
1652754388,200136,true,2035347264,28,2036365141,1017877
1652754453,200136,true,2035347264,28,2036365141,1017877
1652754645,200137,true,2035143750,28,2036772434,1628684
1652755136,200136,true,2035347264,28,2037383527,2036263
1652755231,200136,true,2035347264,28,2037383527,2036263
1652755539,200137,true,2035143750,28,2037179809,2036059
1652755705,200137,true,2035143750,28,2036772434,1628684
1652756103,200137,true,2035143750,28,2036161525,1017775
1652756121,200137,true,2035143750,28,2036161525,1017775
1652756186,200138,true,2034940256,28,2036161525,1221269
1652756322,200139,true,2034736782,28,2036365141,1628359
1652756403,200137,true,2035143750,28,2036365141,1221391
1652756646,200137,true,2035143750,28,2036772434,1628684
1652756714,200138,true,2034940256,28,2036976112,2035856
1652756776,200138,true,2034940256,28,2037179809,2239553
1652756792,200137,true,2035143750,28,2037179809,2036059
1652756848,200137,true,2035143750,28,2037383527,2239777
1652756901,200137,true,2035143750,28,2037587266,2443516
1652756902,200137,true,2035143750,28,2037587266,2443516
1652756986,200136,true,2035347264,28,2038198603,2851339
1652757038,200135,true,2035550799,28,2038606263,3055464
1652757116,200135,true,2035550799,28,2039217906,3667107
1652758372,200135,true,2035550799,28,2050258915,14708116
1652758391,200133,true,2035957929,28,2050463941,14506012
1652758416,200133,true,2035957929,28,2050668987,14711058
1652758437,200133,true,2035957929,28,2050874054,14916125
1652758451,200132,true,2036161525,28,2051079141,14917616
1652758468,200131,true,2036365141,28,2051284249,14919108
1652758616,200130,true,2036568778,28,2053336457,16767679
1652758629,200130,true,2036568778,28,2053541790,16973012
1652758876,200129,true,2036772434,28,2056624260,19851826
1652759334,200127,true,2037179809,28,2060947493,23767684
1652759537,200126,true,2037383527,28,2062803088,25419561
1652760036,200125,true,2037587266,28,2067552757,29965491
1652760220,200124,true,2037791024,28,2069621241,31830217
1652760236,200122,true,2038198603,28,2069828203,31629600
1652761066,200120,true,2038606263,28,2070242189,31635926
1652761191,200120,true,2038606263,28,2070242189,31635926
1652761348,200119,true,2038810124,28,2070035186,31225062
1652761445,200117,true,2039217906,28,2070035186,30817280
1652761573,200115,true,2039625770,28,2070035186,30409416
1652761646,200114,true,2039829733,28,2069828203,29998470
1652761885,200113,true,2040033716,28,2069621241,29587525
1652762161,200111,true,2040441743,28,2069207379,28765636
1652762201,200109,true,2040849852,28,2069207379,28357527
1652762237,200107,true,2041258042,28,2069207379,27949337
1652762556,200106,true,2041462168,28,2069828203,28366035
1652762899,200104,true,2041870481,28,2070449213,28578732
1652764248,200101,true,2042483103,28,2073557062,31073959
1652764628,200100,true,2042687351,28,2073557062,30869711
1652764675,200098,true,2043095909,28,2073557062,30461153
1652765055,200096,true,2043504549,28,2072935119,29430570
1652765149,200093,true,2044117661,28,2072727847,28610186
1652765534,200092,true,2044322073,28,2072106153,27784080
1652765966,200090,true,2044730958,28,2071277517,26546559
1652766250,200087,true,2045344439,28,2070863324,25518885
1652766386,200084,true,2045958103,28,2070656258,24698155
1652766515,200083,true,2046162699,28,2070656258,24493559
1652766727,200081,true,2046571952,28,2070863324,24291372
1652766953,200079,true,2046981287,28,2071070410,24089123
1652767085,200076,true,2047595443,28,2071277517,23682074
1652767151,200075,true,2047800202,28,2071277517,23477315
1652767722,200073,true,2048209783,28,2072313363,24103580
1652767748,200071,true,2048619445,28,2072520595,23901150
1652768361,200069,true,2049029190,28,2073349727,24320537
1652768407,200068,true,2049234093,28,2073557062,24322969
1652769035,200066,true,2049643960,28,2073557062,23913102
1652769390,200064,true,2050053909,28,2073349727,23295818
1652769605,200062,true,2050463941,28,2073349727,22885786
1652769868,200061,true,2050668987,28,2073142413,22473426
1652769879,200059,true,2051079141,28,2073142413,22063272
1652770065,200058,true,2051284249,28,2073142413,21858164
1652770088,200056,true,2051694527,28,2073349727,21655200
1652770101,200055,true,2051899696,28,2073349727,21450031
1652770115,200054,true,2052104886,28,2073349727,21244841
1652770134,200052,true,2052515327,28,2073349727,20834400
1652770172,200049,true,2053131144,28,2073557062,20425918
1652770181,200049,true,2053131144,28,2073557062,20425918
1652770216,200047,true,2053541790,28,2073764418,20222628
1652770248,200044,true,2054157915,28,2073971794,19813879
1652770256,200042,true,2054568767,28,2073971794,19403027
1652770370,200041,true,2054774224,28,2074801507,20027283
1652770465,200038,true,2055390717,28,2075631553,20240836
1652770817,200035,true,2056007396,28,2078123681,22116285
1652771246,200032,true,2056624260,28,2081243049,24618789
1652771449,200031,true,2056829923,28,2082700357,25870434
1652771507,200028,true,2057447033,28,2083116917,25669884
1652771680,200026,true,2057858543,28,2083950289,26091746
1652771713,200023,true,2058475963,28,2084158684,25682721
1652771751,200022,true,2058681810,28,2084158684,25476874
1652771771,200019,true,2059299477,28,2084367100,25067623
1652771790,200017,true,2059711357,28,2084367100,24655743
1652771809,200014,true,2060329332,28,2084367100,24037768
1652771941,200014,true,2060329332,28,2084575537,24246205
1652771975,200010,true,2061153588,28,2084367100,23213512
1652772019,200008,true,2061565839,28,2084158684,22592845
1652772085,200006,true,2061978173,28,2083741915,21763742
1652772375,200005,true,2062184371,28,2082075671,19891300
1652772418,200002,true,2062803088,28,2081659319,18856231
1652772489,200000,true,2063215669,28,2081243049,18027380
1652772504,199998,true,2063628333,28,2081243049,17614716
1652772517,199998,true,2063628333,28,2081034946,17406613
1652772639,199995,true,2064247483,28,2080202740,15955257
1652772717,199994,true,2064453908,28,2079578804,15124896
1652773622,199992,true,2064866819,28,2073764418,8897599
1652774306,199991,true,2065073306,28,2072935119,7861813
1652774531,199989,true,2065486341,28,2072727847,7241506
1652774874,199987,true,2065899459,28,2072727847,6828388
1652774895,199985,true,2066312660,28,2072727847,6415187
1652774940,199986,true,2066106049,28,2072935119,6829070
1652774959,199983,true,2066725943,28,2072935119,6209176
1652775281,199981,true,2067139309,28,2073557062,6417753
1652775408,199979,true,2067552757,28,2073764418,6211661
1652775494,199979,true,2067552757,28,2073971794,6419037
1652775504,199976,true,2068173085,28,2073971794,5798709
1652775754,199974,true,2068586741,28,2074594048,6007307
1652775778,199972,true,2069000479,28,2074801507,5801028
1652775786,199972,true,2069000479,28,2074801507,5801028
1652775789,199969,true,2069621241,28,2074801507,5180266
1652775809,199966,true,2070242189,28,2074801507,4559318
1652775856,199964,true,2070656258,28,2075008988,4352730
1652775889,199964,true,2070656258,28,2075216489,4560231
1652775948,199962,true,2071070410,28,2075424010,4353600
1652776025,199959,true,2071691794,28,2075631553,3939759
1652776252,199957,true,2072106153,28,2076669576,4563423
1652776426,199957,true,2072106153,28,2077292639,5186486
1652776601,199954,true,2072727847,28,2078331493,5603646
1652776691,199952,true,2073142413,28,2078955055,5812642
1652776717,199950,true,2073557062,28,2078955055,5397993
1652776773,199950,true,2073557062,28,2079370867,5813805
1652777077,199947,true,2074179191,28,2081659319,7480128
1652777445,199944,true,2074801507,28,2084158684,9357177
1652777590,199943,true,2075008988,28,2084992473,9983485
1652777692,199943,true,2075008988,28,2085409492,10400504
1652777723,199940,true,2075631553,28,2085618033,9986480
1652777732,199938,true,2076046700,28,2085618033,9571333
1652777921,199937,true,2076254304,28,2086661051,10406747
1652777976,199937,true,2076254304,28,2086869717,10615413
1652778004,199935,true,2076669576,28,2087078404,10408828
1652778051,199933,true,2077084931,28,2087078404,9993473
1652778109,199932,true,2077292639,28,2087287112,9994473
1652778221,199933,true,2077084931,28,2087704590,10619659
1652778408,199931,true,2077500368,28,2088122152,10621784
1652778602,199930,true,2077708118,28,2088122152,10414034
1652778619,199930,true,2077708118,28,2088122152,10414034
1652778749,199930,true,2077708118,28,2087913360,10205242
1652778937,199929,true,2077915889,28,2087704590,9788701
1652779073,199927,true,2078331493,28,2087704590,9373097
1652779248,199927,true,2078331493,28,2087495840,9164347
1652779473,199927,true,2078331493,28,2087287112,8955619
1652779638,199926,true,2078539326,28,2087078404,8539078
1652779725,199924,true,2078955055,28,2087078404,8123349
1652779780,199924,true,2078955055,28,2087078404,8123349
1652779994,199924,true,2078955055,28,2087287112,8332057
1652780592,199922,true,2079370867,28,2088122152,8751285
1652780665,199921,true,2079578804,28,2088122152,8543348
1652780771,199920,true,2079786762,28,2088330964,8544202
1652780991,199920,true,2079786762,28,2088539797,8753035
1652781007,199919,true,2079994740,28,2088539797,8545057
1652781159,199918,true,2080202740,28,2088539797,8337057
1652781529,199918,true,2080202740,28,2088748651,8545911
1652781590,199918,true,2080202740,28,2088748651,8545911
1652781696,199917,true,2080410760,28,2088748651,8337891
1652781805,199915,true,2080826863,28,2088748651,7921788
1652782238,199915,true,2080826863,28,2088748651,7921788
1652782573,199915,true,2080826863,28,2088748651,7921788
1652782580,199913,true,2081243049,28,2088748651,7505602
1652782622,199912,true,2081451174,28,2088748651,7297477
1652782649,199912,true,2081451174,28,2088748651,7297477
1652782850,199912,true,2081451174,28,2088539797,7088623
1652782984,199911,true,2081659319,28,2088539797,6880478
1652783037,199909,true,2082075671,28,2088330964,6255293
1652783727,199909,true,2082075671,28,2087704590,5628919
1652783984,199909,true,2082075671,28,2087495840,5420169
1652784028,199908,true,2082283879,28,2087287112,5003233
1652784048,199907,true,2082492107,28,2087287112,4795005
1652785097,199907,true,2082492107,28,2085826595,3334488
1652785111,199907,true,2082492107,28,2085618033,3125926
1652785912,199906,true,2082700357,28,2084783994,2083637
1652787377,199905,true,2082908627,28,2084783994,1875367
1652787430,199905,true,2082908627,28,2084783994,1875367
1652787612,199905,true,2082908627,28,2084575537,1666910
1652787734,199904,true,2083116917,28,2084367100,1250183
1652787825,199904,true,2083116917,28,2084158684,1041767
1652788150,199904,true,2083116917,28,2083533562,416645
1652788952,199904,true,2083116917,28,2082075671,-1041246
1652789177,199903,true,2083325229,28,2081659319,-1665910
1652789375,199903,true,2083325229,28,2081659319,-1665910
1652789762,199903,true,2083325229,28,2081659319,-1665910
1652789888,199904,true,2083116917,28,2081659319,-1457598
1652790132,199903,true,2083325229,28,2082075671,-1249558
1652790156,199903,true,2083325229,28,2082075671,-1249558
1652790203,199903,true,2083325229,28,2082283879,-1041350
1652790257,199904,true,2083116917,28,2082700357,-416560
1652790375,199902,true,2083533562,28,2083533562,0
1652790491,199902,true,2083533562,28,2084575537,1041975
1652790700,199902,true,2083533562,28,2086243781,2710219
1652790769,199902,true,2083533562,28,2086661051,3127489
1652791174,199900,true,2083950289,28,2089793234,5842945
1652791196,199900,true,2083950289,28,2090002214,6051925
1652793243,199899,true,2084158684,28,2097958932,13800248
1652793263,199900,true,2083950289,28,2097958932,14008643
1652793315,199898,true,2084367100,28,2097958932,13591832
1652793429,199897,true,2084575537,28,2097958932,13383395
1652793614,199897,true,2084575537,28,2097749157,13173620
1652793881,199897,true,2084575537,28,2097119959,12544422
1652794103,199895,true,2084992473,28,2096700597,11708124
1652794190,199894,true,2085200972,28,2096700597,11499625
1652794270,199894,true,2085200972,28,2096281320,11080348
1652794379,199894,true,2085200972,28,2095652562,10451590
1652794385,199892,true,2085618033,28,2095652562,10034529
1652794402,199891,true,2085826595,28,2095443017,9616422
1652794535,199891,true,2085826595,28,2095023991,9197396
1652794548,199890,true,2086035178,28,2095023991,8988813
1652794583,199889,true,2086243781,28,2095023991,8780210
1652794593,199888,true,2086452405,28,2095023991,8571586
1652794738,199887,true,2086661051,28,2095023991,8362940
1652794768,199886,true,2086869717,28,2095233494,8363777
1652794818,199884,true,2087287112,28,2095443017,8155905
1652794922,199883,true,2087495840,28,2095862127,8366287
1652794933,199881,true,2087913360,28,2095862127,7948767
1652794949,199880,true,2088122152,28,2095862127,7739975
1652794962,199878,true,2088539797,28,2096071713,7531916
1652795033,199877,true,2088748651,28,2096490948,7742297
1652795093,199875,true,2089166422,28,2096910267,7743845
1652795421,199874,true,2089375338,28,2100057836,10682498
1652795526,199872,true,2089793234,28,2101108075,11314841
1652795626,199871,true,2090002214,28,2101948644,11946430
1652795666,199869,true,2090420235,28,2102369055,11948820
1652795709,199869,true,2090420235,28,2102579291,12159056
1652795777,199867,true,2090838340,28,2102999828,12161488
1652795899,199866,true,2091047424,28,2103841154,12793730
1652795951,199865,true,2091256528,28,2104261944,13005416
1652795970,199864,true,2091465654,28,2104261944,12796290
1652796011,199862,true,2091883968,28,2104472370,12588402
1652796029,199862,true,2091883968,28,2104682817,12798849
1652796052,199861,true,2092093157,28,2104682817,12589660
1652796081,199860,true,2092302366,28,2104893285,12590919
1652796109,199859,true,2092511596,28,2105103775,12592179
1652796129,199859,true,2092511596,28,2105314285,12802689
1652796138,199858,true,2092720847,28,2105524817,12803970
1652796181,199858,true,2092720847,28,2105735369,13014522
1652796192,199857,true,2092930119,28,2105735369,12805250
1652796445,199857,true,2092930119,28,2106156537,13226418
1652796456,199856,true,2093139412,28,2106156537,13017125
1652796488,199856,true,2093139412,28,2106156537,13017125
1652796508,199855,true,2093348726,28,2106156537,12807811
1652796563,199856,true,2093139412,28,2105945943,12806531
1652796621,199855,true,2093348726,28,2105524817,12176091
1652796657,199855,true,2093348726,28,2105314285,11965559
1652796726,199855,true,2093348726,28,2104682817,11334091
1652796819,199856,true,2093139412,28,2103420449,10281037
1652797104,199855,true,2093348726,28,2099427944,6079218
1652797297,199855,true,2093348726,28,2096490948,3142222
1652797797,199855,true,2093348726,28,2090629277,-2719449
1652797840,199856,true,2093139412,28,2090211214,-2928198
1652797895,199855,true,2093348726,28,2089584276,-3764450
1652798198,199856,true,2093139412,28,2085618033,-7521379
1652798253,199857,true,2092930119,28,2084783994,-8146125
1652798382,199858,true,2092720847,28,2082908627,-9812220
1652798502,199858,true,2092720847,28,2081451174,-11269673
1652798534,199859,true,2092511596,28,2081034946,-11476650
1652798624,199860,true,2092302366,28,2079786762,-12515604
1652798688,199862,true,2091883968,28,2078747180,-13136788
1652800375,199863,true,2091674801,28,2056829923,-34844878
1652800608,199865,true,2091256528,28,2056829923,-34426605
1652800648,199866,true,2091047424,28,2056829923,-34217501
1652800667,199868,true,2090629277,28,2056829923,-33799354
1652800717,199869,true,2090420235,28,2056624260,-33795975
1652801158,199871,true,2090002214,28,2055390717,-34611497
1652801176,199872,true,2089793234,28,2055390717,-34402517
1652801246,199874,true,2089375338,28,2055185199,-34190139
1652801622,199875,true,2089166422,28,2053336457,-35829965
1652801682,199878,true,2088539797,28,2053131144,-35408653
1652801696,199879,true,2088330964,28,2053131144,-35199820
1652801703,199881,true,2087913360,28,2053131144,-34782216
1652801713,199881,true,2087913360,28,2053131144,-34782216
1652802036,199883,true,2087495840,28,2053747145,-33748695
1652802683,199884,true,2087287112,28,2055185199,-32101913
1652802920,199886,true,2086869717,28,2056212997,-30656720
1652803240,199886,true,2086869717,28,2058064329,-28805388
1652803460,199888,true,2086452405,28,2059505406,-26946999
1652803605,199889,true,2086243781,28,2059505406,-26738375
1652803623,199891,true,2085826595,28,2059505406,-26321189
1652803628,199891,true,2085826595,28,2059505406,-26321189
1652803824,199893,true,2085409492,28,2059093567,-26315925
1652803856,199894,true,2085200972,28,2059093567,-26107405
1652803934,199896,true,2084783994,28,2058681810,-26102184
1652803947,199896,true,2084783994,28,2058681810,-26102184
1652803957,199898,true,2084367100,28,2058681810,-25685290
1652804073,199900,true,2083950289,28,2058064329,-25885960
1652804443,199902,true,2083533562,28,2056212997,-27320565
1652804503,199902,true,2083533562,28,2055801816,-27731746
1652804534,199904,true,2083116917,28,2055596257,-27520660
1652804538,199906,true,2082700357,28,2055596257,-27104100
1652805244,199909,true,2082075671,28,2048414604,-33661067
1652805266,199909,true,2082075671,28,2048209783,-33865888
1652805297,199911,true,2081659319,28,2047800202,-33859117
1652805766,199912,true,2081451174,28,2045753528,-35697646
1652805970,199915,true,2080826863,28,2045344439,-35482424
1652807201,199914,true,2081034946,28,2052515327,-28519619
1652807243,199916,true,2080618801,28,2052720579,-27898222
1652807446,199917,true,2080410760,28,2053747145,-26663615
1652807484,199920,true,2079786762,28,2053952519,-25834243
1652807645,199919,true,2079994740,28,2054979701,-25015039
1652807659,199921,true,2079578804,28,2054979701,-24599103
1652810423,199923,true,2079162950,28,2060535365,-18627585
1652810512,199926,true,2078539326,28,2060535365,-18003961
1652810527,199925,true,2078747180,28,2060535365,-18211815
1652810530,199927,true,2078331493,28,2060535365,-17796128
1652810549,199929,true,2077915889,28,2060535365,-17380524
1652810637,199933,true,2077084931,28,2060123320,-16961611
1652810659,199933,true,2077084931,28,2060123320,-16961611
1652810778,199935,true,2076669576,28,2059505406,-17164170
1652810909,199937,true,2076254304,28,2058681810,-17572494
1652810951,199941,true,2075424010,28,2058681810,-16742200
1652810963,199940,true,2075631553,28,2058475963,-17155590
1652811061,199942,true,2075216489,28,2058475963,-16740526
1652811109,199943,true,2075008988,28,2058475963,-16533025
1652811169,199947,true,2074179191,28,2058475963,-15703228
1652811233,199946,true,2074386609,28,2058270136,-16116473
1652811246,199948,true,2073971794,28,2058064329,-15907465
1652811258,199950,true,2073557062,28,2058064329,-15492733
1652811327,199954,true,2072727847,28,2057241309,-15486538
1652811432,199955,true,2072520595,28,2056212997,-16307598
1652811443,199957,true,2072106153,28,2056007396,-16098757
1652811468,199959,true,2071691794,28,2055596257,-16095537
1652811558,199964,true,2070656258,28,2054157915,-16498343
1652811574,199966,true,2070242189,28,2053747145,-16495044
1652811641,199969,true,2069621241,28,2052515327,-17105914
1652811700,199972,true,2069000479,28,2051284249,-17716230
1652811762,199978,true,2067759513,28,2049848924,-17910589
1652811771,199981,true,2067139309,28,2049643960,-17495349
1652811826,199984,true,2066519291,28,2048209783,-18309508
1652811834,199987,true,2065899459,28,2048004982,-17894477
1652811852,199994,true,2064453908,28,2047595443,-16858465
1652811930,199997,true,2063834696,28,2045753528,-18081168
1652811965,200001,true,2063009368,28,2044730958,-18278410
1652811989,200004,true,2062390589,28,2044117661,-18272928
1652812374,200010,true,2061153588,28,2034736782,-26416806
1652812456,200013,true,2060535365,28,2032906434,-27628931
1652812498,200017,true,2059711357,28,2032093475,-27617882
1652812549,200020,true,2059093567,28,2031077733,-28015834
1652812777,200027,true,2057652778,28,2026006633,-31646145
1652812809,200030,true,2057035606,28,2025196433,-31839173
1652813815,200032,true,2056624260,28,2018524633,-38099627
1652814255,200034,true,2056212997,28,2020140018,-36072979
1652814263,200041,true,2054774224,28,2020140018,-34634206
1652814282,200044,true,2054157915,28,2020342032,-33815883
1652814312,200046,true,2053747145,28,2020544066,-33203079
1652814325,200048,true,2053336457,28,2020544066,-32792391
1652814350,200054,true,2052104886,28,2020746121,-31358765
1652814417,200056,true,2051694527,28,2021554541,-30139986
1652814458,200058,true,2051284249,28,2021958872,-29325377
1652814489,200059,true,2051079141,28,2022565520,-28513621
1652814595,200064,true,2050053909,28,2024184139,-25869770
1652815312,200065,true,2049848924,28,2034126483,-15722441
1652815456,200067,true,2049439016,28,2036161525,-13277491
1652815662,200068,true,2049234093,28,2039217906,-10016187
1652815867,200073,true,2048209783,28,2042483103,-5726680
1652815890,200073,true,2048209783,28,2042891620,-5318163
1652816034,200074,true,2048004982,28,2045344439,-2660543
1652816135,200075,true,2047800202,28,2046981287,-818915
1652816263,200079,true,2046981287,28,2048619445,1638158
1652816304,200079,true,2046981287,28,2048824307,1843020
1652816359,200080,true,2046776609,28,2049439016,2662407
1652816543,200080,true,2046776609,28,2050463941,3687332
1652816730,200084,true,2045958103,28,2051489378,5531275
1652816749,200084,true,2045958103,28,2051694527,5736424
1652816821,200084,true,2045958103,28,2051899696,5941593
1652816853,200083,true,2046162699,28,2052104886,5942187
1652816860,200087,true,2045344439,28,2052104886,6760447
1652816937,200087,true,2045344439,28,2052104886,6760447
1652817069,200088,true,2045139925,28,2052104886,6964961
1652818991,200087,true,2045344439,28,2045548973,204534
1652819018,200091,true,2044526505,28,2045753528,1227023
1652819124,200089,true,2044935431,28,2045958103,1022672
1652819125,200090,true,2044730958,28,2045958103,1227145
1652819155,200088,true,2045139925,28,2045958103,818178
1652819165,200092,true,2044322073,28,2045958103,1636030
1652819371,200090,true,2044730958,28,2046571952,1840994
1652820170,200090,true,2044730958,28,2049848924,5117966
1652820194,200088,true,2045139925,28,2049848924,4708999
1652820307,200092,true,2044322073,28,2050463941,6141868
1652820317,200090,true,2044730958,28,2050463941,5732983
1652820362,200088,true,2045139925,28,2050874054,5734129
1652821177,200087,true,2045344439,28,2054568767,9224328
1652821220,200090,true,2044730958,28,2054568767,9837809
1652821229,200089,true,2044935431,28,2054568767,9633336
1652822181,200089,true,2044935431,28,2055390717,10455286
1652822641,200088,true,2045139925,28,2054979701,9839776
1652822897,200091,true,2044526505,28,2054774224,10247719
1652823059,200090,true,2044730958,28,2054774224,10043266
1652823091,200090,true,2044730958,28,2054774224,10043266
1652823117,200089,true,2044935431,28,2054979701,10044270
1652823193,200092,true,2044322073,28,2055185199,10863126
1652823219,200090,true,2044730958,28,2055185199,10454241
1652823265,200089,true,2044935431,28,2055390717,10455286
1652823631,200087,true,2045344439,28,2058064329,12719890
1652823746,200089,true,2044935431,28,2058887678,13952247
1652823754,200088,true,2045139925,28,2058887678,13747753
1652823871,200087,true,2045344439,28,2059711357,14366918
1652823897,200084,true,2045958103,28,2059917328,13959225
1652823946,200086,true,2045548973,28,2060535365,14986392
1652824183,200085,true,2045753528,28,2062390589,16637061
1652824384,200083,true,2046162699,28,2064247483,18084784
1652824423,200080,true,2046776609,28,2064660353,17883744
1652824443,200081,true,2046571952,28,2064866819,18294867
1652824500,200079,true,2046981287,28,2065692890,18711603
1652825250,200076,true,2047595443,28,2075839116,28243673
1652825284,200074,true,2048004982,28,2076254304,28249322
1652825321,200075,true,2047800202,28,2076669576,28869374
1652825650,200074,true,2048004982,28,2080202740,32197758
1652825978,200070,true,2048824307,28,2083116917,34292610
1652826089,200068,true,2049234093,28,2084158684,34924591
1652826895,200070,true,2048824307,28,2083741915,34917608
1652826902,200069,true,2049029190,28,2083741915,34712725
1652827162,200066,true,2049643960,28,2082492107,32848147
1652827410,200065,true,2049848924,28,2081034946,31186022
1652827813,200067,true,2049439016,28,2078747180,29308164
1652828184,200066,true,2049643960,28,2077708118,28064158
1652828468,200063,true,2050258915,28,2077084931,26826016
1652828477,200062,true,2050463941,28,2077084931,26620990
1652828499,200063,true,2050258915,28,2077084931,26826016
1652828546,200062,true,2050463941,28,2077084931,26620990
1652828667,200058,true,2051284249,28,2077292639,26008390
1652828697,200056,true,2051694527,28,2077292639,25598112
1652828702,200058,true,2051284249,28,2077292639,26008390
1652828715,200057,true,2051489378,28,2077292639,25803261
1652828737,200053,true,2052310096,28,2077500368,25190272
1652828758,200052,true,2052515327,28,2077500368,24985041
1652829164,200053,true,2052310096,28,2080826863,28516767
1652829804,200052,true,2052515327,28,2085200972,32685645
1652829849,200048,true,2053336457,28,2085409492,32073035
1652829935,200046,true,2053747145,28,2086243781,32496636
1652829948,200046,true,2053747145,28,2086243781,32496636
1652831569,200043,true,2054363330,28,2092511596,38148266
1652832507,200039,true,2055185199,28,2092511596,37326397
1652832521,200037,true,2055596257,28,2092720847,37124590
1652832527,200036,true,2055801816,28,2092720847,36919031
1652832556,200032,true,2056624260,28,2092720847,36096587
1652832657,200027,true,2057652778,28,2093139412,35486634
1652832958,200024,true,2058270136,28,2094605050,36334914
1652833058,200022,true,2058681810,28,2095023991,36342181
1652834017,200019,true,2059299477,28,2099218022,39918545
1652834473,200013,true,2060535365,28,2100477868,39942503
1652834485,200010,true,2061153588,28,2100477868,39324280
1652834860,200008,true,2061565839,28,2100057836,38491997
1652834907,200004,true,2062390589,28,2099847851,37457262
1652835017,199998,true,2063628333,28,2099637887,36009554
1652835053,199995,true,2064247483,28,2099427944,35180461
1652835337,199994,true,2064453908,28,2098168728,33714820
1652835411,199991,true,2065073306,28,2097749157,32675851
1652835782,199985,true,2066312660,28,2096071713,29759053
1652835789,199982,true,2066932616,28,2096071713,29139097
1652835939,199981,true,2067139309,28,2095233494,28094185
1652835979,199977,true,2067966289,28,2095023991,27057702
1652835982,199973,true,2068793599,28,2095023991,26230392
1652836020,199970,true,2069414299,28,2094605050,25190751
1652836067,199969,true,2069621241,28,2094186191,24564950
1652836611,199966,true,2070242189,28,2089584276,19342087
1652836744,199962,true,2071070410,28,2088748651,17678241
1652836799,199960,true,2071484645,28,2088330964,16846319
1652836900,199959,true,2071691794,28,2087913360,16221566
1652836940,199957,true,2072106153,28,2087704590,15598437
1652837167,199953,true,2072935119,28,2086452405,13517286
1652837321,199951,true,2073349727,28,2085618033,12268306
1652837371,199952,true,2073142413,28,2085200972,12058559
1652837383,199951,true,2073349727,28,2085200972,11851245
1652837423,199947,true,2074179191,28,2084783994,10604803
1652837522,199946,true,2074386609,28,2084158684,9772075
1652837712,199946,true,2074386609,28,2082700357,8313748
1652838399,199945,true,2074594048,28,2080202740,5608692
1652838469,199942,true,2075216489,28,2079994740,4778251
1652838558,199941,true,2075424010,28,2079370867,3946857
1652838607,199942,true,2075216489,28,2079162950,3946461
1652838630,199942,true,2075216489,28,2078955055,3738566
1652838686,199939,true,2075839116,28,2078539326,2700210
1652838788,199939,true,2075839116,28,2077708118,1869002
1652838855,199940,true,2075631553,28,2077292639,1661086
1652839051,199940,true,2075631553,28,2075839116,207563
1652839285,199937,true,2076254304,28,2074386609,-1867695
1652839445,199936,true,2076461930,28,2073349727,-3112203
1652839602,199937,true,2076254304,28,2072520595,-3733709
1652839673,199937,true,2076254304,28,2072313363,-3940941
1652839700,199934,true,2076877243,28,2072106153,-4771090
1652840313,199932,true,2077292639,28,2069000479,-8292160
1652840675,199933,true,2077084931,28,2068586741,-8498190
1652841112,199933,true,2077084931,28,2068379903,-8705028
1652841133,199930,true,2077708118,28,2068379903,-9328215
1652841140,199929,true,2077915889,28,2068379903,-9535986
1652841503,199931,true,2077500368,28,2067346023,-10154345
1652842284,199931,true,2077500368,28,2065486341,-12014027
1652842928,199928,true,2078123681,28,2064041079,-14082602
1652843493,199927,true,2078331493,28,2063834696,-14496797
1652843575,199929,true,2077915889,28,2063834696,-14081193
1652843601,199929,true,2077915889,28,2063834696,-14081193
1652843638,199926,true,2078539326,28,2063834696,-14704630
1652843676,199926,true,2078539326,28,2063628333,-14910993
1652843702,199928,true,2078123681,28,2063628333,-14495348
1652843745,199929,true,2077915889,28,2063421991,-14493898
1652843900,199926,true,2078539326,28,2062390589,-16148737
1652844222,199927,true,2078331493,28,2060329332,-18002161
1652844228,199929,true,2077915889,28,2060123320,-17792569
1652844358,199929,true,2077915889,28,2059093567,-18822322
1652844371,199927,true,2078331493,28,2058887678,-19443815
1652845035,199928,true,2078123681,28,2052515327,-25608354
1652845082,199930,true,2077708118,28,2052104886,-25603232
1652845099,199932,true,2077292639,28,2051899696,-25392943
1652845502,199930,true,2077708118,28,2047595443,-30112675
1652846103,199932,true,2077292639,28,2044117661,-33174978
1652846222,199935,true,2076669576,28,2043708899,-32960677
1652846250,199936,true,2076461930,28,2043504549,-32957381
1652846909,199935,true,2076669576,28,2040237719,-36431857
1652848345,199937,true,2076254304,28,2038198603,-38055701
1652849207,199940,true,2075631553,28,2038198603,-37432950
1652849313,199941,true,2075424010,28,2038198603,-37225407
1652849395,199940,true,2075631553,28,2038198603,-37432950
1652849896,199943,true,2075008988,28,2038198603,-36810385
1652849900,199946,true,2074386609,28,2038198603,-36188006
1652850063,199948,true,2073971794,28,2037994804,-35976990
1652850259,199949,true,2073764418,28,2037587266,-36177152
1652850583,199952,true,2073142413,28,2036772434,-36369979
1652851093,199954,true,2072727847,28,2036161525,-36566322
1652851198,199956,true,2072313363,28,2036161525,-36151838
1652851281,199957,true,2072106153,28,2036161525,-35944628
1652851340,199960,true,2071484645,28,2036161525,-35323120
1652851710,199962,true,2071070410,28,2036772434,-34297976
1652852069,199963,true,2070863324,28,2038198603,-32664721
1652852256,199964,true,2070656258,28,2039014005,-31642253
1652852447,199967,true,2070035186,28,2039625770,-30409416
1652852454,199968,true,2069828203,28,2039829733,-29998470
1652852495,199970,true,2069414299,28,2039829733,-29584566
1652852819,199970,true,2069414299,28,2040849852,-28564447
1652852935,199973,true,2068793599,28,2041258042,-27535557
1652853416,199974,true,2068586741,28,2041053937,-27532804
1652853590,199976,true,2068173085,28,2041053937,-27119148
1652853632,199977,true,2067966289,28,2040849852,-27116437
1652853792,199980,true,2067346023,28,2040849852,-26496171
1652853841,199981,true,2067139309,28,2040849852,-26289457
1652853858,199983,true,2066725943,28,2040849852,-25876091
1652854096,199984,true,2066519291,28,2041258042,-25261249
1652854634,199987,true,2065899459,28,2042074668,-23824791
1652854682,199989,true,2065486341,28,2042278875,-23207466
1652854971,199991,true,2065073306,28,2042891620,-22181686
1652855087,199992,true,2064866819,28,2043300219,-21566600
1652855100,199995,true,2064247483,28,2043300219,-20947264
1652855263,199997,true,2063834696,28,2043504549,-20330147
1652855506,199999,true,2063421991,28,2044117661,-19304330
1652855959,200001,true,2063009368,28,2043913270,-19096098
1652855977,200004,true,2062390589,28,2043913270,-18477319
1652856128,200006,true,2061978173,28,2043708899,-18269274
1652856310,200008,true,2061565839,28,2043504549,-18061290
1652856394,200010,true,2061153588,28,2043504549,-17649039
1652856456,200014,true,2060329332,28,2043300219,-17029113
1652856475,200016,true,2059917328,28,2043300219,-16617109
1652856526,200018,true,2059505406,28,2043095909,-16409497
1652856568,200021,true,2058887678,28,2043095909,-15791769
1652856600,200024,true,2058270136,28,2042891620,-15378516
1652856630,200026,true,2057858543,28,2042891620,-14966923
1652856708,200029,true,2057241309,28,2042483103,-14758206
1652856723,200031,true,2056829923,28,2042483103,-14346820
1652856799,200035,true,2056007396,28,2042074668,-13932728
1652856846,200036,true,2055801816,28,2041870481,-13931335
1652857002,200039,true,2055185199,28,2041053937,-14131262
1652857004,200041,true,2054774224,28,2041053937,-13720287
1652857020,200045,true,2053952519,28,2040849852,-13102667
1652857056,200046,true,2053747145,28,2040645787,-13101358
1652857065,200049,true,2053131144,28,2040645787,-12485357
1652857100,200051,true,2052720579,28,2040237719,-12482860
1652857122,200055,true,2051899696,28,2040033716,-11865980
1652857137,200056,true,2051694527,28,2040033716,-11660811
1652857196,200059,true,2051079141,28,2039421828,-11657313
1652857383,200062,true,2050463941,28,2037383527,-13080414
1652857456,200065,true,2049848924,28,2036568778,-13280146
1652857649,200067,true,2049439016,28,2034533329,-14905687
1652858685,200070,true,2048824307,28,2024993934,-23830373
1652858879,200072,true,2048414604,28,2023981741,-24432863
1652859063,200076,true,2047595443,28,2023779363,-23816080
1652859348,200077,true,2047390704,28,2023577005,-23813699
1652859390,200080,true,2046776609,28,2023577005,-23199604
1652859837,200082,true,2046367316,28,2023577005,-22790311
1652859940,200085,true,2045753528,28,2023577005,-22176523
1652859982,200087,true,2045344439,28,2023577005,-21767434
1652860249,200089,true,2044935431,28,2023577005,-21358426
1652860676,200092,true,2044322073,28,2023577005,-20745068
1652860688,200095,true,2043708899,28,2023779363,-19929536
1652860715,200096,true,2043504549,28,2023779363,-19725186
1652860723,200098,true,2043095909,28,2023779363,-19316546
1652860729,200100,true,2042687351,28,2023779363,-18907988
1652860778,200102,true,2042278875,28,2023981741,-18297134
1652860837,200103,true,2042074668,28,2024184139,-17890529
1652860919,200105,true,2041666314,28,2024588996,-17077318
1652860964,200106,true,2041462168,28,2024588996,-16873172
1652861047,200109,true,2040849852,28,2024993934,-15855918
1652861056,200109,true,2040849852,28,2024993934,-15855918
1652861200,200111,true,2040441743,28,2025804053,-14637690
1652861308,200113,true,2040033716,28,2026411855,-13621861
1652861412,200115,true,2039625770,28,2026817158,-12808612
1652861456,200116,true,2039421828,28,2027019839,-12401989
1652861567,200117,true,2039217906,28,2027628006,-11589900
1652861959,200119,true,2038810124,28,2029453601,-9356523
1652861980,200121,true,2038402423,28,2029656547,-8745876
1652862027,200122,true,2038198603,28,2029859512,-8339091
1652862094,200123,true,2037994804,28,2030062498,-7932306
1652862127,200124,true,2037791024,28,2030265505,-7525519
1652862182,200127,true,2037179809,28,2030468531,-6711278
1652862244,200127,true,2037179809,28,2030671578,-6508231
1652862352,200129,true,2036772434,28,2031077733,-5694701
1652862493,200130,true,2036568778,28,2031483969,-5084809
1652862912,200132,true,2036161525,28,2031077733,-5083792
1652863164,200132,true,2036161525,28,2030468531,-5692994
1652863285,200134,true,2035754354,28,2030265505,-5488849
1652864152,200135,true,2035550799,28,2028642023,-6908776
1652864582,200137,true,2035143750,28,2028439179,-6704571
1652864631,200137,true,2035143750,28,2028439179,-6704571
1652865033,200138,true,2034940256,28,2028236355,-6703901
1652865041,200139,true,2034736782,28,2028439179,-6297603
1652865196,200140,true,2034533329,28,2028439179,-6094150
1652865429,200140,true,2034533329,28,2028642023,-5891306
1652865510,200141,true,2034329896,28,2028844887,-5485009
1652865517,200141,true,2034329896,28,2028844887,-5485009
1652865777,200142,true,2034126483,28,2028642023,-5484460
1652865790,200142,true,2034126483,28,2028642023,-5484460
1652866073,200143,true,2033923091,28,2028439179,-5483912
1652867148,200144,true,2033719719,28,2027222541,-6497178
1652867178,200144,true,2033719719,28,2027019839,-6699880
1652867202,200144,true,2033719719,28,2027019839,-6699880
1652867255,200145,true,2033516367,28,2027019839,-6496528
1652867931,200145,true,2033516367,28,2027425264,-6091103
1652868047,200146,true,2033313036,28,2027628006,-5685030
1652868061,200146,true,2033313036,28,2027628006,-5685030
1652868078,200147,true,2033109725,28,2027628006,-5481719
1652868107,200147,true,2033109725,28,2027628006,-5481719
1652868151,200146,true,2033313036,28,2027830769,-5482267
1652868270,200146,true,2033313036,28,2028439179,-4873857
1652868766,200147,true,2033109725,28,2030671578,-2438147
1652868869,200147,true,2033109725,28,2031077733,-2031992
1652868964,200147,true,2033109725,28,2031687117,-1422608
1652868972,200147,true,2033109725,28,2031687117,-1422608
1652869067,200148,true,2032906434,28,2032093475,-812959
1652869619,200148,true,2032906434,28,2034940256,2033822
1652869734,200147,true,2033109725,28,2035550799,2441074
1652869746,200148,true,2032906434,28,2035550799,2644365
1652869808,200149,true,2032703164,28,2035957929,3254765
1652870046,200148,true,2032906434,28,2036976112,4069678
1652870370,200148,true,2032906434,28,2037791024,4884590
1652870557,200148,true,2032906434,28,2038402423,5495989
1652870982,200149,true,2032703164,28,2039014005,6310841
1652871064,200148,true,2032906434,28,2039014005,6107571
1652871503,200148,true,2032906434,28,2039625770,6719336
1652871752,200148,true,2032906434,28,2039625770,6719336
1652871839,200149,true,2032703164,28,2039625770,6922606
1652872398,200149,true,2032703164,28,2037179809,4476645
1652872525,200150,true,2032499914,28,2036568778,4068864
1652872539,200150,true,2032499914,28,2036568778,4068864
1652872688,200151,true,2032296684,28,2035754354,3457670
1652872731,200152,true,2032093475,28,2035550799,3457324
1652872776,200152,true,2032093475,28,2035347264,3253789
1652872810,200153,true,2031890286,28,2035143750,3253464
1652872905,200154,true,2031687117,28,2034736782,3049665
1652873126,200154,true,2031687117,28,2033516367,1829250
1652873281,200154,true,2031687117,28,2032703164,1016047
1652873546,200155,true,2031483969,28,2031280840,-203129
1652873576,200156,true,2031280840,28,2031280840,0
1652874047,200156,true,2031280840,28,2030468531,-812309
1652874138,200157,true,2031077733,28,2030265505,-812228
1652874169,200157,true,2031077733,28,2030265505,-812228
1652874332,200158,true,2030874645,28,2030062498,-812147
1652874450,200158,true,2030874645,28,2029859512,-1015133
1652874545,200158,true,2030874645,28,2029859512,-1015133
1652874717,200159,true,2030671578,28,2029859512,-812066
1652874855,200159,true,2030671578,28,2029859512,-812066
1652875113,200160,true,2030468531,28,2029656547,-811984
1652875926,200160,true,2030468531,28,2029453601,-1014930
1652875945,200160,true,2030468531,28,2029453601,-1014930
1652876078,200160,true,2030468531,28,2029453601,-1014930
1652876081,200160,true,2030468531,28,2029453601,-1014930
1652876200,200161,true,2030265505,28,2029250676,-1014829
1652876491,200161,true,2030265505,28,2028642023,-1623482
1652876757,200161,true,2030265505,28,2028033552,-2231953
1652876792,200161,true,2030265505,28,2028033552,-2231953
1652877673,200161,true,2030265505,28,2026817158,-3448347
1652877768,200161,true,2030265505,28,2026614496,-3651009
1652877999,200161,true,2030265505,28,2026614496,-3651009
1652878077,200161,true,2030265505,28,2026817158,-3448347
1652878096,200161,true,2030265505,28,2026817158,-3448347
1652878137,200161,true,2030265505,28,2026614496,-3651009
1652878153,200161,true,2030265505,28,2026614496,-3651009
1652878182,200162,true,2030062498,28,2026411855,-3650643
1652878259,200162,true,2030062498,28,2026006633,-4055865
1652878283,200162,true,2030062498,28,2025804053,-4258445
1652878351,200163,true,2029859512,28,2025196433,-4663079
1652878423,200164,true,2029656547,28,2024386557,-5269990
1652878443,200165,true,2029453601,28,2024184139,-5269462
1652878527,200165,true,2029453601,28,2023374668,-6078933
1652878567,200166,true,2029250676,28,2022970053,-6280623
1652878619,200167,true,2029047772,28,2022363284,-6684488
1652878646,200168,true,2028844887,28,2021958872,-6886015
1652878666,200169,true,2028642023,28,2021756696,-6885327
1652878683,200170,true,2028439179,28,2021352405,-7086774
1652879108,200172,true,2028033552,28,2014491820,-13541732
1652879127,200173,true,2027830769,28,2014088982,-13741787
1652879165,200174,true,2027628006,28,2013484876,-14143130
1652879186,200175,true,2027425264,28,2013082239,-14343025
1652879287,200178,true,2026817158,28,2011271371,-15545787
1652879746,200179,true,2026614496,28,2003242755,-23371741
1652879911,200181,true,2026209234,28,2000440317,-25768917
1652880225,200182,true,2026006633,28,1997442056,-28564577
1652880314,200185,true,2025398953,28,1996842943,-28556010
1652880330,200186,true,2025196433,28,1996842943,-28353490
1652880332,200187,true,2024993934,28,1996842943,-28150991
1652880366,200189,true,2024588996,28,1996443634,-28145362
1652880470,200192,true,2023981741,28,1995844821,-28136920
1652880498,200193,true,2023779363,28,1995844821,-27934542
1652880650,200194,true,2023577005,28,1995246187,-28330818
1652880800,200196,true,2023172350,28,1994647733,-28524617
1652880898,200199,true,2022565520,28,1994248864,-28316656
1652880969,200200,true,2022363284,28,1994049459,-28313825
1652880979,200201,true,2022161068,28,1994049459,-28111609
1652881245,200202,true,2021958872,28,1993850074,-28108798
1652881288,200205,true,2021352405,28,1993650708,-27701697
1652881299,200207,true,2020948195,28,1993650708,-27297487
1652881312,200208,true,2020746121,28,1993650708,-27095413
1652881322,200209,true,2020544066,28,1993650708,-26893358
1652881330,200212,true,2019938024,28,1993451363,-26486661
1652881344,200214,true,2019534097,28,1993451363,-26082734
1652881381,200215,true,2019332164,28,1993252038,-26080126
1652881417,200217,true,2018928358,28,1993052733,-25875625
1652881657,200220,true,2018322801,28,1991658154,-26664647
1652881762,200221,true,2018120989,28,1991259882,-26861107
1652881846,200223,true,2017717425,28,1991060776,-26656649
1652882095,200224,true,2017515674,28,1990065544,-27450130
1652882346,200227,true,2016910540,28,1989269717,-27640823
1652882436,200229,true,2016507218,28,1989269717,-27237501
1652883333,200230,true,2016305588,28,1988076573,-28229015
1652883361,200231,true,2016103977,28,1988076573,-28027404
1652883391,200234,true,2015499267,28,1988275380,-27223887
1652883688,200235,true,2015297737,28,1988673055,-26624682
1652883976,200236,true,2015096228,28,1989269717,-25826511
1652884596,200238,true,2014693269,28,1990264551,-24428718
1652884619,200241,true,2014088982,28,1990463577,-23625405
1652884640,200242,true,2013887593,28,1990463577,-23424016
1652884836,200243,true,2013686224,28,1990264551,-23421673
1652884846,200245,true,2013283548,28,1990264551,-23018997
1652884868,200248,true,2012679683,28,1990065544,-22614139
1652884931,200250,true,2012277208,28,1989667591,-22609617
1652884998,200253,true,2011673645,28,1989070810,-22602835
1652885082,200256,true,2011070264,28,1988275380,-22794884
1652885158,200260,true,2010266037,28,1987480269,-22785768
1652885171,200262,true,2009864044,28,1987281541,-22582503
1652885308,200265,true,2009261205,28,1985493881,-23767324
1652885378,200268,true,2008658547,28,1984699882,-23958665
1652886655,200272,true,2007855285,28,1970856185,-36999100
1652886659,200274,true,2007453774,28,1970856185,-36597589
1652886683,200277,true,2006851658,28,1970856185,-35995473
1652886692,200280,true,2006249723,28,1970856185,-35393538
1652886711,200284,true,2005447424,28,1970659119,-34788305
1652887041,200286,true,2005046395,28,1970265046,-34781349
1652887114,200290,true,2004244577,28,1970068039,-34176538
1652887126,200293,true,2003643423,28,1970068039,-33575384
1652887146,200297,true,2002842166,28,1969871052,-32971114
1652887186,200300,true,2002241434,28,1969674085,-32567349
1652887239,200304,true,2001440737,28,1969280209,-32160528
1652887255,200307,true,2000840425,28,1969280209,-31560216
1652887282,200311,true,2000040289,28,1969083301,-30956988
1652887284,200314,true,1999440397,28,1969083301,-30357096
1652887287,200317,true,1998840685,28,1968886412,-29954273
1652887344,200321,true,1998041348,28,1968295864,-29745484
1652887409,200326,true,1997042627,28,1967508743,-29533884
1652887581,200328,true,1996643279,28,1965542316,-31100963
1652887855,200332,true,1995844821,28,1962203899,-33640922
1652888126,200336,true,1995046683,28,1958871153,-36175530
1652888143,200340,true,1994248864,28,1958675285,-35573579
1652888279,200343,true,1993650708,28,1957109050,-36541658
1652888289,200347,true,1992853448,28,1956913359,-35940089
1652889216,200349,true,1992454937,28,1952027429,-40427508
1652889294,200354,true,1991459008,28,1952222632,-39236376
1652889372,200356,true,1991060776,28,1952417854,-38642922
1652889957,200360,true,1990264551,28,1953784957,-36479594
1652889992,200363,true,1989667591,28,1953784957,-35882634
1652890023,200367,true,1988871923,28,1953784957,-35086966
1652890037,200370,true,1988275380,28,1953784957,-34490423
1652890083,200375,true,1987281541,28,1953589598,-33691943
1652890296,200378,true,1986685476,28,1952613096,-34072380
1652890324,200382,true,1985891000,28,1952417854,-33473146
1652890347,200385,true,1985295352,28,1952222632,-33072720
1652890365,200390,true,1984303002,28,1952027429,-32275573
1652890471,200394,true,1983509479,28,1951246814,-32262665
1652890495,200398,true,1982716274,28,1951051708,-31664566
1652890526,200401,true,1982121578,28,1950856623,-31264955
1652890527,200405,true,1981328927,28,1950856623,-30472304
1652890599,200408,true,1980734647,28,1950661557,-30073090
1652890615,200412,true,1979942552,28,1950661557,-29280995
1652890624,200414,true,1979546622,28,1950661557,-28885065
1652890627,200419,true,1978557146,28,1950661557,-27895589
1652890958,200421,true,1978161494,28,1950856623,-27304871
1652890963,200425,true,1977370427,28,1950856623,-26513804
1652890996,200427,true,1976975012,28,1950856623,-26118389
1652891311,200432,true,1975986821,28,1950466510,-25520311
1652891462,200434,true,1975591683,28,1950661557,-24930126
1652891663,200437,true,1974999124,28,1950856623,-24142501
1652891701,200438,true,1974801644,28,1951051708,-23749936
1652891903,200442,true,1974011921,28,1953003638,-21008283
1652892011,200443,true,1973814539,28,1954371151,-19443388
1652892044,200445,true,1973419836,28,1954762045,-18657791
1652892088,200446,true,1973222513,28,1955153017,-18069496
1652892146,200449,true,1972630665,28,1955935195,-16695470
1652892232,200450,true,1972433422,28,1957109050,-15324372
1652892550,200453,true,1971841810,28,1959262947,-12578863
1652892588,200454,true,1971644645,28,1959458873,-12185772
1652892634,200457,true,1971053270,28,1959654819,-11398451
1652892656,200458,true,1970856185,28,1959654819,-11201366
1652892696,200459,true,1970659119,28,1960046769,-10612350
1652892815,200459,true,1970659119,28,1961026989,-9632130
1652893545,200462,true,1970068039,28,1967705494,-2362545
1652893609,200463,true,1969871052,28,1967902264,-1968788
1652893660,200463,true,1969871052,28,1967902264,-1968788
1652893728,200463,true,1969871052,28,1967902264,-1968788
1652893752,200466,true,1969280209,28,1967902264,-1377945
1652893826,200468,true,1968886412,28,1967902264,-984148
1652895125,200469,true,1968689543,28,1965149266,-3540277
1652895275,200469,true,1968689543,28,1964559839,-4129704
1652895325,200472,true,1968099054,28,1964559839,-3539215
1652895730,200473,true,1967902264,28,1964559839,-3342425
1652895780,200473,true,1967902264,28,1964756295,-3145969
1652895827,200474,true,1967705494,28,1964756295,-2949199
1652895849,200477,true,1967115300,28,1964756295,-2359005
1652896007,200478,true,1966918608,28,1964952771,-1965837
1652896054,200478,true,1966918608,28,1965149266,-1769342
1652896056,200478,true,1966918608,28,1965149266,-1769342
1652896133,200481,true,1966328651,28,1965149266,-1179385
1652896167,200483,true,1965935444,28,1965149266,-786178
1652896210,200483,true,1965935444,28,1965149266,-786178
1652896241,200484,true,1965738870,28,1965149266,-589604
1652896310,200487,true,1965149266,28,1965149266,0
1652896342,200488,true,1964952771,28,1965149266,196495
1652896385,200488,true,1964952771,28,1964952771,0
1652896477,200488,true,1964952771,28,1964756295,-196476
1652896565,200491,true,1964363403,28,1964559839,196436
1652896675,200492,true,1964166986,28,1964363403,196417
1652896705,200493,true,1963970589,28,1964363403,392814
1652897016,200493,true,1963970589,28,1963381516,-589073
1652897251,200497,true,1963185197,28,1962203899,-981298
1652897290,200498,true,1962988898,28,1961811517,-1177381
1652897357,200498,true,1962988898,28,1961419214,-1569684
1652897550,200499,true,1962792619,28,1960046769,-2745850
1652897734,200503,true,1962007698,28,1958871153,-3136545
1652897763,200504,true,1961811517,28,1958675285,-3136232
1652897788,200505,true,1961615356,28,1958283609,-3331747
1652898125,200506,true,1961419214,28,1956522035,-4897179
1652898193,200509,true,1960830906,28,1956130789,-4700117
1652898292,200511,true,1960438798,28,1955935195,-4503603
1652898328,200511,true,1960438798,28,1955935195,-4503603
1652898449,200512,true,1960242774,28,1955739621,-4503153
1652898580,200515,true,1959654819,28,1955739621,-3915198
1652898623,200516,true,1959458873,28,1955935195,-3523678
1652899185,200516,true,1959458873,28,1957500491,-1958382
1652899859,200516,true,1959458873,28,1960634842,1175969
1652899925,200518,true,1959067040,28,1961026989,1959949
1652900268,200518,true,1959067040,28,1962203899,3136859
1652900278,200518,true,1959067040,28,1962203899,3136859
1652900336,200517,true,1959262947,28,1962400120,3137173
1652900506,200519,true,1958871153,28,1962792619,3921466
1652900580,200518,true,1959067040,28,1962988898,3921858
1652900605,200518,true,1959067040,28,1962988898,3921858
1652900644,200518,true,1959067040,28,1963185197,4118157
1652900670,200519,true,1958871153,28,1963381516,4510363
1652900722,200518,true,1959067040,28,1963970589,4903549
1652900751,200517,true,1959262947,28,1964166986,4904039
1652900873,200516,true,1959458873,28,1965542316,6083443
1652901148,200516,true,1959458873,28,1968886412,9427539
1652901179,200515,true,1959654819,28,1969280209,9625390
1652901199,200514,true,1959850784,28,1969477137,9626353
1652901205,200512,true,1960242774,28,1969477137,9234363
1652901634,200513,true,1960046769,28,1973222513,13175744
1652901723,200512,true,1960242774,28,1974011921,13769147
1652901743,200510,true,1960634842,28,1974209322,13574480
1652901865,200509,true,1960830906,28,1974999124,14168218
1652901961,200510,true,1960634842,28,1975591683,14956841
1652902263,200508,true,1961026989,28,1977172710,16145721
1652902362,200506,true,1961419214,28,1977370427,15951213
1652902618,200504,true,1961811517,28,1976975012,15163495
1652902663,200505,true,1961615356,28,1976579677,14964321
1652902757,200503,true,1962007698,28,1976184420,14176722
1652902863,200502,true,1962203899,28,1975789242,13585343
1652903113,200499,true,1962792619,28,1975591683,12799064
1652903388,200500,true,1962596360,28,1975591683,12995323
1652903860,200499,true,1962792619,28,1976382038,13589419
1652904152,200497,true,1963185197,28,1977370427,14185230
1652904248,200495,true,1963577854,28,1977568164,13990310
1652904287,200496,true,1963381516,28,1977765921,14384405
1652904336,200494,true,1963774212,28,1977765921,13991709
1652904474,200493,true,1963970589,28,1977568164,13597575
1652904631,200492,true,1964166986,28,1976777335,12610349
1652904715,200492,true,1964166986,28,1976184420,12017434
1652905390,200491,true,1964363403,28,1971447501,7084098
1652905423,200490,true,1964559839,28,1971053270,6493431
1652905985,200489,true,1964756295,28,1964952771,196476
1652906060,200489,true,1964756295,28,1964166986,-589309
1652906080,200487,true,1965149266,28,1963970589,-1178677
1652906288,200486,true,1965345781,28,1961811517,-3534264
1652906330,200486,true,1965345781,28,1961419214,-3926567
1652906624,200487,true,1965149266,28,1958871153,-6278113
1652906649,200487,true,1965149266,28,1958675285,-6473981
1652906722,200486,true,1965345781,28,1958087800,-7257981
1652906943,200486,true,1965345781,28,1956522035,-8823746
1652907019,200487,true,1965149266,28,1956130789,-9018477
1652907053,200487,true,1965149266,28,1955935195,-9214071
1652908416,200486,true,1965345781,28,1957696241,-7649540
1652908442,200485,true,1965542316,28,1957892011,-7650305
1652908448,200486,true,1965345781,28,1957892011,-7453770
1652908456,200486,true,1965345781,28,1957892011,-7453770
1652908471,200484,true,1965738870,28,1958087800,-7651070
1652908529,200484,true,1965738870,28,1958283609,-7455261
1652908799,200485,true,1965542316,28,1959654819,-5887497
1652909013,200486,true,1965345781,28,1960242774,-5103007
1652909081,200485,true,1965542316,28,1960438798,-5103518
1652909092,200485,true,1965542316,28,1960438798,-5103518
1652909697,200485,true,1965542316,28,1962596360,-2945956
1652909703,200486,true,1965345781,28,1962596360,-2749421
1652909733,200485,true,1965542316,28,1962596360,-2945956
1652910671,200485,true,1965542316,28,1964559839,-982477
1652910739,200485,true,1965542316,28,1964559839,-982477
1652910765,200485,true,1965542316,28,1964559839,-982477
1652910805,200485,true,1965542316,28,1964363403,-1178913
1652911768,200486,true,1965345781,28,1960242774,-5103007
1652911820,200488,true,1964952771,28,1960046769,-4906002
1652911972,200488,true,1964952771,28,1959458873,-5493898
1652912296,200488,true,1964952771,28,1957892011,-7060760
1652912332,200489,true,1964756295,28,1957696241,-7060054
1652912409,200490,true,1964559839,28,1957500491,-7059348
1652912422,200490,true,1964559839,28,1957500491,-7059348
1652912505,200488,true,1964952771,28,1957500491,-7452280
1652912525,200490,true,1964559839,28,1957500491,-7059348
1652912545,200490,true,1964559839,28,1957500491,-7059348
1652912879,200490,true,1964559839,28,1958871153,-5688686
1652912895,200489,true,1964756295,28,1959067040,-5689255
1652912938,200490,true,1964559839,28,1959067040,-5492799
1652912955,200490,true,1964559839,28,1959067040,-5492799
1652913059,200491,true,1964363403,28,1959067040,-5296363
1652913450,200490,true,1964559839,28,1959262947,-5296892
1652913669,200492,true,1964166986,28,1958871153,-5295833
1652914092,200492,true,1964166986,28,1957892011,-6274975
1652914449,200493,true,1963970589,28,1955739621,-8230968
1652914494,200492,true,1964166986,28,1955348532,-8818454
1652914590,200494,true,1963774212,28,1954566588,-9207624
1652914645,200495,true,1963577854,28,1954175734,-9402120
1652914905,200496,true,1963381516,28,1952417854,-10963662
1652915062,200495,true,1963577854,28,1951441938,-12135916
1652915100,200496,true,1963381516,28,1951246814,-12134702
1652916254,200497,true,1963185197,28,1950271483,-12913714
1652916273,200497,true,1963185197,28,1950271483,-12913714
1652916337,200496,true,1963381516,28,1950076475,-13305041
1652916346,200498,true,1962988898,28,1950076475,-12912423
1652916347,200498,true,1962988898,28,1950076475,-12912423
1652916371,200499,true,1962792619,28,1950076475,-12716144
1652916415,200501,true,1962400120,28,1949491569,-12908551
1652916452,200502,true,1962203899,28,1949101729,-13102170
1652916779,200504,true,1961811517,28,1944624170,-17187347
1652916941,200505,true,1961615356,28,1942097928,-19517428
1652917125,200506,true,1961419214,28,1938993211,-22426003
1652917151,200508,true,1961026989,28,1938605470,-22421519
1652917312,200510,true,1960634842,28,1935506336,-25128506
1652917319,200512,true,1960242774,28,1935312805,-24929969
1652917478,200513,true,1960046769,28,1932218935,-27827834
1652918284,200516,true,1959458873,28,1917973998,-41484875
1652918327,200518,true,1959067040,28,1917782220,-41284820
1652918410,200520,true,1958675285,28,1917207001,-41468284
1652918413,200522,true,1958283609,28,1917207001,-41076608
1652918460,200525,true,1957696241,28,1916823617,-40872624
1652918491,200527,true,1957304761,28,1916631954,-40672807
1652918517,200529,true,1956913359,28,1916631954,-40281405
1652918626,200531,true,1956522035,28,1916248685,-40273350
1652918634,200533,true,1956130789,28,1916248685,-39882104
1652918727,200536,true,1955544067,28,1915865492,-39678575
1652918752,200538,true,1955153017,28,1915865492,-39287525
1652918769,200540,true,1954762045,28,1915673925,-39088120
1652918836,200543,true,1954175734,28,1915482377,-38693357
1652918947,200546,true,1953589598,28,1914716375,-38873223
1652918981,200549,true,1953003638,28,1914716375,-38287263
1652918994,200552,true,1952417854,28,1914716375,-37701479
1652919003,200556,true,1951637082,28,1914716375,-36920707
1652919007,200559,true,1951051708,28,1914716375,-36335333
1652919128,200561,true,1950661557,28,1914907847,-35753710
1652919318,200564,true,1950076475,28,1915290848,-34785627
1652919346,200568,true,1949296640,28,1915290848,-34005792
1652919362,200570,true,1948906839,28,1915482377,-33424462
1652919949,200571,true,1948711967,28,1919508915,-29203052
1652919978,200573,true,1948322284,28,1919700866,-28621418
1652920255,200577,true,1947543149,28,1922197975,-25345174
1652920409,200579,true,1947153699,28,1923543917,-23609782
1652920505,200579,true,1947153699,28,1924313450,-22840249
1652920513,200581,true,1946764327,28,1924505881,-22258446
1652920520,200584,true,1946180414,28,1924505881,-21674533
1652920619,200586,true,1945791237,28,1925853440,-19937797
1652921201,200586,true,1945791237,28,1931832549,-13958688
1652921417,200588,true,1945402137,28,1932798659,-12603478
1652921518,200592,true,1944624170,28,1933185238,-11438932
1652921547,200593,true,1944429727,28,1933378556,-11051171
1652921726,200594,true,1944235304,28,1933958628,-10276676
1652921815,200596,true,1943846515,28,1934345439,-9501076
1652921915,200600,true,1943069171,28,1934732327,-8336844
1652922329,200601,true,1942874883,28,1935119293,-7755590
1652922788,200602,true,1942680615,28,1934345439,-8335176
1652922819,200603,true,1942486367,28,1934345439,-8140928
1652923114,200606,true,1941903737,28,1934538873,-7364864
1652924065,200608,true,1941515415,28,1936087046,-5428369
1652924099,200607,true,1941709566,28,1936087046,-5622520
1652924177,200609,true,1941321283,28,1936087046,-5234237
1652924196,200611,true,1940933077,28,1936087046,-4846031
1652924536,200613,true,1940544948,28,1935893457,-4651491
1652924571,200612,true,1940739003,28,1935893457,-4845546
1652924627,200613,true,1940544948,28,1935699887,-4845061
1652924910,200616,true,1939962901,28,1933958628,-6004273
1652924982,200618,true,1939574967,28,1933378556,-6196411
1652925126,200617,true,1939768924,28,1932412157,-7356767
1652925141,200618,true,1939574967,28,1932218935,-7356032
1652925388,200621,true,1938993211,28,1930287778,-8705433
1652925390,200623,true,1938605470,28,1930287778,-8317692
1652925402,200622,true,1938799331,28,1930094769,-8704562
1652925453,200625,true,1938217807,28,1929515856,-8701951
1652925535,200629,true,1937442714,28,1928551388,-8891326
1652925547,200631,true,1937055284,28,1928358552,-8696732
1652925873,200631,true,1937055284,28,1922966969,-14088315
1652926192,200634,true,1936474283,28,1918549448,-17924835
1652926298,200639,true,1935506336,28,1917015299,-18491037
1652926317,200641,true,1935119293,28,1916823617,-18295676
1652927040,200642,true,1934925801,28,1908599381,-26326420
1652927135,200645,true,1934345439,28,1907836132,-26509307
1652927500,200649,true,1933571894,28,1907454622,-26117272
1652928329,200651,true,1933185238,28,1910890961,-22294277
1652928351,200651,true,1933185238,28,1911082050,-22103188
1652928386,200654,true,1932605398,28,1911846597,-20758801
1652928602,200657,true,1932025733,28,1916440310,-15585423
1652928782,200655,true,1932412157,28,1920276834,-12135323
1652928808,200655,true,1932412157,28,1920660908,-11751249
1652928828,200658,true,1931832549,28,1921237164,-10595385
1652928936,200660,true,1931446241,28,1922966969,-8479272
1652928984,200659,true,1931639385,28,1923736271,-7903114
1652928999,200659,true,1931639385,28,1923928645,-7710740
1652929153,200661,true,1931253115,28,1926238630,-5014485
1652929244,200663,true,1930866923,28,1927587401,-3279522
1652929250,200662,true,1931060009,28,1927780160,-3279849
1652929500,200662,true,1931060009,28,1931446241,386232
1652929537,200665,true,1930480807,28,1932025733,1544926
1652929581,200667,true,1930094769,28,1932798659,2703890
1652929590,200666,true,1930287778,28,1932991939,2704161
1652929795,200664,true,1930673855,28,1938024005,7350150
1652929966,200666,true,1930287778,28,1942292138,12004360
1652929976,200668,true,1929901779,28,1942486367,12584588
1652930031,200667,true,1930094769,28,1943652150,13557381
1652930045,200664,true,1930673855,28,1944040900,13367045
1652930061,200667,true,1930094769,28,1944429727,14334958
1652930078,200668,true,1929901779,28,1944624170,14722391
1652930136,200667,true,1930094769,28,1945791237,15696468
1652930345,200664,true,1930673855,28,1946959003,16285148
1652930925,200667,true,1930094769,28,1949686518,19591749
1652931479,200669,true,1929708808,28,1951246814,21538006
1652931566,200668,true,1929901779,28,1950856623,20954844
1652931660,200664,true,1930673855,28,1950271483,19597628
1652931672,200667,true,1930094769,28,1950271483,20176714
1652931720,200668,true,1929901779,28,1950076475,20174696
1652931976,200667,true,1930094769,28,1949881487,19786718
1652932081,200664,true,1930673855,28,1949881487,19207632
1652932402,200667,true,1930094769,28,1950856623,20761854
1652932832,200668,true,1929901779,28,1952417854,22516075
1652932871,200666,true,1930287778,28,1952613096,22325318
1652933079,200662,true,1931060009,28,1953394259,22334250
1652933210,200663,true,1930866923,28,1953784957,22918034
1652933315,200663,true,1930866923,28,1954371151,23504228
1652933614,200660,true,1931446241,28,1955544067,24097826
1652933661,200656,true,1932218935,28,1955739621,23520686
1652933833,200656,true,1932218935,28,1956326402,24107467
1652934343,200657,true,1932025733,28,1957304761,25279028
1652934633,200653,true,1932798659,28,1957892011,25093352
1652934649,200649,true,1933571894,28,1957892011,24320117
1652934794,200649,true,1933571894,28,1958087800,24515906
1652934812,200649,true,1933571894,28,1958087800,24515906
1652934875,200645,true,1934345439,28,1958087800,23742361
1652935021,200641,true,1935119293,28,1957892011,22772718
1652935509,200641,true,1935119293,28,1956913359,21794066
1652935621,200641,true,1935119293,28,1956522035,21402742
1652935974,200638,true,1935699887,28,1955348532,19648645
1652936057,200634,true,1936474283,28,1955153017,18678734
1652936070,200634,true,1936474283,28,1955153017,18678734
1652936230,200634,true,1936474283,28,1954566588,18092305
1652936549,200631,true,1937055284,28,1953394259,16338975
1652936636,200627,true,1937830222,28,1953198939,15368717
1652937232,200628,true,1937636458,28,1951441938,13805480
1652937372,200627,true,1937830222,28,1951246814,13416592
1652937693,200624,true,1938411629,28,1950661557,12249928
1652938088,200620,true,1939187110,28,1950271483,11084373
1652938374,200621,true,1938993211,28,1950076475,11083264
1652938729,200620,true,1939187110,28,1949881487,10694377
1652938812,200617,true,1939768924,28,1949881487,10112563
1652938843,200614,true,1940350913,28,1949881487,9530574
1652938865,200615,true,1940156898,28,1949881487,9724589
1652938906,200615,true,1940156898,28,1949881487,9724589
1652939644,200613,true,1940544948,28,1946569670,6024722
1652939697,200611,true,1940933077,28,1946375032,5441955
1652939807,200612,true,1940739003,28,1945985816,5246813
1652940025,200612,true,1940739003,28,1945013115,4274112
1652940149,200611,true,1940933077,28,1944429727,3496650
1652940163,200609,true,1941321283,28,1944429727,3108444
1652940271,200610,true,1941127170,28,1944040900,2913730
1652940338,200610,true,1941127170,28,1943846515,2719345
1652940368,200609,true,1941321283,28,1943652150,2330867
1652940411,200607,true,1941709566,28,1943652150,1942584
1652940459,200608,true,1941515415,28,1943652150,2136735
1652940512,200608,true,1941515415,28,1943652150,2136735
1652940553,200606,true,1941903737,28,1943652150,1748413
1652940614,200605,true,1942097928,28,1943652150,1554222
1652941014,200605,true,1942097928,28,1945596677,3498749
1652941072,200605,true,1942097928,28,1945985816,3887888
1652941345,200603,true,1942486367,28,1947932678,5446311
1652941975,200601,true,1942874883,28,1952417854,9542971
1652942050,200601,true,1942874883,28,1953003638,10128755
1652942692,200601,true,1942874883,28,1955935195,13060312
1652943214,200599,true,1943263478,28,1957109050,13845572
1652943390,200597,true,1943652150,28,1957304761,13652611
1652943395,200597,true,1943652150,28,1957304761,13652611
1652943450,200597,true,1943652150,28,1957696241,14044091
1652943782,200593,true,1944429727,28,1959654819,15225092
1652943829,200591,true,1944818633,28,1959850784,15032151
1652944504,200591,true,1944818633,28,1962203899,17385266
1652944697,200590,true,1945013115,28,1962792619,17779504
1652944717,200586,true,1945791237,28,1962988898,17197661
1652944735,200584,true,1946180414,28,1962988898,16808484
1652944956,200584,true,1946180414,28,1963381516,17201102
1652944982,200583,true,1946375032,28,1963381516,17006484
1652945001,200579,true,1947153699,28,1963381516,16227817
1652945023,200577,true,1947543149,28,1963381516,15838367
1652945480,200578,true,1947348415,28,1961223091,13874676
1652945558,200576,true,1947737904,28,1960830906,13093002
1652945722,200572,true,1948517116,28,1959458873,10941757
1652945731,200569,true,1949101729,28,1959262947,10161218
1652945787,200570,true,1948906839,28,1958871153,9964314
1652945815,200569,true,1949101729,28,1958675285,9573556
1652946508,200565,true,1949881487,28,1951441938,1560451
1652946708,200561,true,1950661557,28,1949686518,-975039
1652947092,200563,true,1950271483,28,1947348415,-2923068
1652947154,200561,true,1950661557,28,1947153699,-3507858
1652947240,200559,true,1951051708,28,1946764327,-4287381
1652947580,200555,true,1951832246,28,1945985816,-5846430
1652947747,200557,true,1951441938,28,1945985816,-5456122
1652947787,200557,true,1951441938,28,1945985816,-5456122
1652947878,200558,true,1951246814,28,1945985816,-5260998
1652947934,200555,true,1951832246,28,1945985816,-5846430
1652947987,200556,true,1951637082,28,1945985816,-5651266
1652948032,200556,true,1951637082,28,1945985816,-5651266
1652948098,200557,true,1951441938,28,1946180414,-5261524
1652948841,200553,true,1952222632,28,1947932678,-4289954
1652948873,200554,true,1952027429,28,1948127471,-3899958
1652948967,200554,true,1952027429,28,1948322284,-3705145
1652949252,200555,true,1951832246,28,1948711967,-3120279
1652949269,200551,true,1952613096,28,1948711967,-3901129
1652949394,200553,true,1952222632,28,1948906839,-3315793
1652949431,200552,true,1952417854,28,1948906839,-3511015
1652949455,200553,true,1952222632,28,1948906839,-3315793
1652949510,200552,true,1952417854,28,1948906839,-3511015
1652949842,200555,true,1951832246,28,1948906839,-2925407
1652949989,200555,true,1951832246,28,1948517116,-3315130
1652950148,200556,true,1951637082,28,1948127471,-3509611
1652950210,200554,true,1952027429,28,1948127471,-3899958
1652950384,200556,true,1951637082,28,1947543149,-4093933
1652950399,200556,true,1951637082,28,1947543149,-4093933
1652950426,200557,true,1951441938,28,1947348415,-4093523
1652950810,200557,true,1951441938,28,1944429727,-7012211
1652951098,200559,true,1951051708,28,1942097928,-8953780
1652951317,200559,true,1951051708,28,1940350913,-10700795
1652951374,200560,true,1950856623,28,1940156898,-10699725
1652951532,200559,true,1951051708,28,1939187110,-11864598
1652951568,200562,true,1950466510,28,1938993211,-11473299
1652951716,200562,true,1950466510,28,1938024005,-12442505
1652951717,200563,true,1950271483,28,1938024005,-12247478
1652951774,200562,true,1950466510,28,1937636458,-12830052
1652951919,200565,true,1949881487,28,1936861597,-13019890
1652952073,200566,true,1949686518,28,1935699887,-13986631
1652952273,200567,true,1949491569,28,1934732327,-14759242
1652952380,200567,true,1949491569,28,1934345439,-15146130
1652952548,200570,true,1948906839,28,1933571894,-15334945
1652952605,200570,true,1948906839,28,1933185238,-15721601
1652952694,200572,true,1948517116,28,1932798659,-15718457
1652952709,200572,true,1948517116,28,1932605398,-15911718
1652952744,200576,true,1947737904,28,1932412157,-15325747
1652952849,200577,true,1947543149,28,1931639385,-15903764
1652953281,200579,true,1947153699,28,1927972938,-19180761
1652953335,200579,true,1947153699,28,1927587401,-19566298
1652953813,200583,true,1946375032,28,1922966969,-23408063
1652953913,200584,true,1946180414,28,1922197975,-23982439
1652953940,200586,true,1945791237,28,1922005774,-23785463
1652953994,200586,true,1945791237,28,1921621431,-24169806
1652954010,200589,true,1945207616,28,1921621431,-23586185
1652954475,200590,true,1945013115,28,1920468861,-24544254
1652954536,200592,true,1944624170,28,1920660908,-23963262
1652954628,200592,true,1944624170,28,1920852974,-23771196
1652955049,200594,true,1944235304,28,1922966969,-21268335
1652955160,200594,true,1944235304,28,1923543917,-20691387
1652955559,200596,true,1943846515,28,1926046025,-17800490
1652955712,200596,true,1943846515,28,1927009241,-16837274
1652956273,200598,true,1943457804,28,1928551388,-14906416
1652956393,200598,true,1943457804,28,1928744243,-14713561
1652956426,200600,true,1943069171,28,1928744243,-14324928
1652956463,200600,true,1943069171,28,1928744243,-14324928
1652956800,200603,true,1942486367,28,1927780160,-14706207
1652956849,200603,true,1942486367,28,1927780160,-14706207
1652956856,200605,true,1942097928,28,1927780160,-14317768
1652956863,200605,true,1942097928,28,1927780160,-14317768
1652956897,200607,true,1941709566,28,1927780160,-13929406
1652956927,200606,true,1941903737,28,1927780160,-14123577
1652957116,200606,true,1941903737,28,1928358552,-13545185
1652957149,200606,true,1941903737,28,1928358552,-13545185
1652957166,200609,true,1941321283,28,1928358552,-12962731
1652957222,200608,true,1941515415,28,1928358552,-13156863
1652957685,200608,true,1941515415,28,1929708808,-11806607
1652957730,200608,true,1941515415,28,1929708808,-11806607
1652958001,200610,true,1941127170,28,1931253115,-9874055
1652958028,200609,true,1941321283,28,1931253115,-10068168
1652958802,200610,true,1941127170,28,1934345439,-6781731
1652959263,200610,true,1941127170,28,1934732327,-6394843
1652959282,200612,true,1940739003,28,1934732327,-6006676
1652959286,200612,true,1940739003,28,1934732327,-6006676
1652959339,200612,true,1940739003,28,1934925801,-5813202
1652959374,200612,true,1940739003,28,1935119293,-5619710
1652959453,200614,true,1940350913,28,1935506336,-4844577
1652959471,200614,true,1940350913,28,1935506336,-4844577
1652960427,200614,true,1940350913,28,1941127170,776257
1652960453,200613,true,1940544948,28,1941321283,776335
1652960531,200616,true,1939962901,28,1941903737,1940836
1652960537,200616,true,1939962901,28,1941903737,1940836
1652960561,200615,true,1940156898,28,1942097928,1941030
1652960611,200615,true,1940156898,28,1942680615,2523717
1652960930,200617,true,1939768924,28,1945402137,5633213
1652960946,200617,true,1939768924,28,1945596677,5827753
1652960975,200618,true,1939574967,28,1945985816,6410849
1652961339,200617,true,1939768924,28,1948711967,8943043
1652961355,200619,true,1939381029,28,1948711967,9330938
1652961381,200619,true,1939381029,28,1948906839,9525810
1652961454,200620,true,1939187110,28,1949296640,10109530
1652961519,200619,true,1939381029,28,1949881487,10500458
1652961562,200620,true,1939187110,28,1950076475,10889365
1652961578,200620,true,1939187110,28,1950271483,11084373
1652961762,200620,true,1939187110,28,1951637082,12449972
1652962001,200619,true,1939381029,28,1953589598,14208569
1652962014,200619,true,1939381029,28,1953784957,14403928
1652962273,200619,true,1939381029,28,1955739621,16358592
1652962560,200619,true,1939381029,28,1957304761,17923732
1652962986,200618,true,1939574967,28,1958283609,18708642
1652963006,200618,true,1939574967,28,1958479437,18904470
1652963483,200617,true,1939768924,28,1958283609,18514685
1652963653,200617,true,1939768924,28,1958087800,18318876
1652963686,200616,true,1939962901,28,1957892011,17929110
1652963722,200616,true,1939962901,28,1957892011,17929110
1652963741,200615,true,1940156898,28,1957892011,17735113
1652964072,200615,true,1940156898,28,1956913359,16756461
1652965263,200614,true,1940350913,28,1955348532,14997619
1652965408,200614,true,1940350913,28,1955153017,14802104
1652965782,200614,true,1940350913,28,1954957521,14606608
1652965875,200613,true,1940544948,28,1954957521,14412573
1652965887,200613,true,1940544948,28,1955153017,14608069
1652965899,200613,true,1940544948,28,1955153017,14608069
1652965943,200612,true,1940739003,28,1955153017,14414014
1652965982,200611,true,1940933077,28,1955348532,14415455
1652966004,200610,true,1941127170,28,1955544067,14416897
1652966016,200610,true,1941127170,28,1955544067,14416897
1652966063,200608,true,1941515415,28,1956130789,14615374
1652966258,200606,true,1941903737,28,1958283609,16379872
1652966260,200606,true,1941903737,28,1958283609,16379872
1652966565,200605,true,1942097928,28,1961811517,19713589
1652966590,200604,true,1942292138,28,1962007698,19715560
1652966624,200602,true,1942680615,28,1962400120,19719505
1652966702,200601,true,1942874883,28,1963185197,20310314
1652966703,200600,true,1943069171,28,1963185197,20116026
1652967123,200599,true,1943263478,28,1966918608,23655130
1652967151,200597,true,1943652150,28,1967115300,23463150
1652967168,200596,true,1943846515,28,1967312012,23465497
1652967243,200596,true,1943846515,28,1968295864,24449349
1652967348,200593,true,1944429727,28,1969477137,25047410
1652967418,200591,true,1944818633,28,1970462073,25643440
1652967435,200589,true,1945207616,28,1970659119,25451503
1652967452,200588,true,1945402137,28,1970856185,25454048
1652967656,200585,true,1945985816,28,1974011921,28026105
1652967718,200582,true,1946569670,28,1974999124,28429454
1652967793,200581,true,1946764327,28,1975789242,29024915
1652967801,200579,true,1947153699,28,1975789242,28635543
1652967818,200576,true,1947737904,28,1975986821,28248917
1652967878,200574,true,1948127471,28,1975986821,27859350
1652967901,200573,true,1948322284,28,1975789242,27466958
1652967950,200572,true,1948517116,28,1975789242,27272126
1652967973,200570,true,1948906839,28,1975591683,26684844
1652968029,200568,true,1949296640,28,1975196624,25899984
1652968081,200568,true,1949296640,28,1974604184,25307544
1652968278,200568,true,1949296640,28,1971644645,22348005
1652968514,200566,true,1949686518,28,1968295864,18609346
1652968525,200564,true,1950076475,28,1968099054,18022579
1652968535,200564,true,1950076475,28,1967902264,17825789
1652968550,200564,true,1950076475,28,1967902264,17825789
1652968580,200560,true,1950856623,28,1967508743,16652120
1652968616,200558,true,1951246814,28,1967312012,16065198
1652968636,200557,true,1951441938,28,1967115300,15673362
1652968663,200557,true,1951441938,28,1966918608,15476670
1652968823,200553,true,1952222632,28,1965935444,13712812
1652968906,200550,true,1952808358,28,1965738870,12930512
1652968991,200549,true,1953003638,28,1965542316,12538678
1652969214,200548,true,1953198939,28,1964559839,11360900
1652969817,200544,true,1953980335,28,1962007698,8027363
1652969854,200542,true,1954371151,28,1962400120,8028969
1652969892,200541,true,1954566588,28,1962792619,8226031
1652969963,200540,true,1954762045,28,1963774212,9012167
1652970021,200536,true,1955544067,28,1964559839,9015772
1652970036,200533,true,1956130789,28,1964756295,8625506
1652970182,200532,true,1956326402,28,1967312012,10985610
1652970236,200531,true,1956522035,28,1968295864,11773829
1652970425,200527,true,1957304761,28,1971447501,14142740
1652970440,200524,true,1957892011,28,1971644645,13752634
1652970463,200522,true,1958283609,28,1971841810,13558201
1652970524,200521,true,1958479437,28,1972433422,13953985
1652970626,200517,true,1959262947,28,1973419836,14156889
1652970646,200514,true,1959850784,28,1973617178,13766394
1652971004,200513,true,1960046769,28,1974604184,14557415
1652971479,200512,true,1960242774,28,1975789242,15546468
1652971750,200509,true,1960830906,28,1976184420,15353514
1652971774,200507,true,1961223091,28,1976184420,14961329
1652972214,200505,true,1961615356,28,1974406743,12791387
1652972407,200505,true,1961615356,28,1974011921,12396565
1652972459,200502,true,1962203899,28,1973814539,11610640
1652972496,200499,true,1962792619,28,1973814539,11021920
1652972507,200498,true,1962988898,28,1973814539,10825641
1652972710,200498,true,1962988898,28,1974011921,11023023
1652973050,200494,true,1963774212,28,1974406743,10632531
1652973135,200492,true,1964166986,28,1974604184,10437198
1652973172,200491,true,1964363403,28,1974604184,10240781
1652973586,200489,true,1964756295,28,1977172710,12416415
1652973739,200485,true,1965542316,28,1978557146,13014830
1652973831,200482,true,1966132037,28,1979942552,13810515
1652974104,200481,true,1966328651,28,1984699882,18371231
1652974191,200478,true,1966918608,28,1986288198,19369590
1652974217,200474,true,1967705494,28,1986884144,19178650
1652974301,200471,true,1968295864,28,1988474208,20178344
1652974408,200469,true,1968689543,28,1990463577,21774034
1652974440,200467,true,1969083301,28,1991259882,22176581
1652974453,200462,true,1970068039,28,1991459008,21390969
1652974472,200460,true,1970462073,28,1991857320,21395247
1652974500,200457,true,1971053270,28,1992654182,21600912
1652974511,200454,true,1971644645,28,1992853448,21208803
1652974566,200449,true,1972630665,28,1994448288,21817623
1652974604,200446,true,1973222513,28,1995445712,22223199
1652974786,200444,true,1973617178,28,2000440317,26823139
1652974971,200441,true,1974209322,28,2005447424,31238102
1652975248,200436,true,1975196624,28,2011673645,36477021
1652975327,200433,true,1975789242,28,2013686224,37896982
1652975428,200431,true,1976184420,28,2016103977,39919557
1652975527,200429,true,1976579677,28,2018726486,42146809
1652975542,200423,true,1977765921,28,2018928358,41162437
1652975560,200420,true,1978359310,28,2019332164,40972854
1652975575,200418,true,1978755002,28,2019736051,40981049
1652975583,200415,true,1979348688,28,2019938024,40589336
1652975617,200410,true,1980338560,28,2020544066,40205506
1652975630,200407,true,1980932721,28,2020746121,39813400
1652975641,200405,true,1981328927,28,2020948195,39619268
1652975685,200403,true,1981725213,28,2021352405,39627192
1652975757,200398,true,1982716274,28,2022161068,39444794
1652975769,200395,true,1983311148,28,2022161068,38849920
1652975774,200393,true,1983707830,28,2022363284,38655454
1652976193,200391,true,1984104591,28,2025196433,41091842
1652976222,200386,true,1985096842,28,2025398953,40302111
1652976256,200383,true,1985692431,28,2025398953,39706522
1652976841,200381,true,1986089589,28,2023981741,37892152
1652977345,200380,true,1986288198,28,2021352405,35064207
1652977475,200374,true,1987480269,28,2020746121,33265852
1652977489,200372,true,1987877785,28,2020544066,32666281
1652977799,200369,true,1988474208,28,2020746121,32271913
1652977896,200368,true,1988673055,28,2020746121,32073066
1652978307,200363,true,1989667591,28,2020746121,31078530
1652978315,200361,true,1990065544,28,2020746121,30680577
1652978337,200359,true,1990463577,28,2020746121,30282544
1652978365,200357,true,1990861690,28,2020746121,29884431
1652978439,200354,true,1991459008,28,2020544066,29085058
1652978453,200353,true,1991658154,28,2020544066,28885912
1652978491,200351,true,1992056505,28,2020342032,28285527
1652978973,200350,true,1992255711,28,2018726486,26470775
1652979277,200347,true,1992853448,28,2017919197,25065749
1652979298,200346,true,1993052733,28,2017717425,24664692
1652979387,200344,true,1993451363,28,2017313942,23862579
1652979395,200343,true,1993650708,28,2017313942,23663234
1652979787,200340,true,1994248864,28,2015297737,21048873
1652979976,200339,true,1994448288,28,2014290391,19842103
1652980057,200337,true,1994847198,28,2013887593,19040395
1652980258,200336,true,1995046683,28,2013082239,18035556
1652980285,200334,true,1995445712,28,2012880951,17435239
1652980354,200333,true,1995645257,28,2012880951,17235694
1652980395,200331,true,1996044406,28,2012679683,16635277
1652980413,200330,true,1996244010,28,2012478435,16234425
1652980468,200329,true,1996443634,28,2012277208,15833574
1652980497,200328,true,1996643279,28,2012277208,15633929
1652980605,200327,true,1996842943,28,2011673645,14830702
1652980642,200326,true,1997042627,28,2011472498,14429871
1652980655,200324,true,1997442056,28,2011271371,13829315
1652980893,200324,true,1997442056,28,2009663078,12221022
1652981387,200322,true,1997841564,28,2007052344,9210780
1652981786,200321,true,1998041348,28,2005046395,7005047
1652982475,200319,true,1998440977,28,2003042451,4601474
1652982638,200317,true,1998840685,28,2003042451,4201766
1652982902,200315,true,1999240473,28,2002441658,3201185
1652982916,200312,true,1999840305,28,2002441658,2601353
1652982969,200310,true,2000240293,28,2002441658,2201365
1652982989,200308,true,2000640361,28,2002641902,2001541
1652983017,200304,true,2001440737,28,2002641902,1201165
1652983073,200302,true,2001841046,28,2002842166,1001120
1652983243,200299,true,2002441658,28,2003443079,1001421
1652983389,200298,true,2002641902,28,2004044172,1402270
1652983651,200295,true,2003242755,28,2005046395,1803640
1652983732,200292,true,2003843788,28,2005246899,1403111
1652983746,200290,true,2004244577,28,2005246899,1002322
1652983837,200289,true,2004445001,28,2005447424,1002423
1652983854,200287,true,2004845910,28,2005447424,601514
1652984008,200284,true,2005447424,28,2006249723,802299
1652984059,200283,true,2005647969,28,2006450348,802379
1652984133,200282,true,2005848533,28,2006851658,1003125
1652984148,200279,true,2006450348,28,2006851658,401310
1652984192,200277,true,2006851658,28,2007052344,200686
1652985010,200276,true,2007052344,28,2011070264,4017920
1652985281,200275,true,2007253049,28,2011472498,4219449
1652985869,200273,true,2007654519,28,2011874813,4220294
1652986579,200271,true,2008056070,28,2011271371,3215301
1652986751,200270,true,2008256876,28,2011070264,2813388
1652987365,200270,true,2008256876,28,2010869177,2612301
1652987374,200268,true,2008658547,28,2010869177,2210630
1652987412,200265,true,2009261205,28,2010869177,1607972
1652987437,200264,true,2009462131,28,2010869177,1407046
1652987519,200264,true,2009462131,28,2010668110,1205979
1652988040,200262,true,2009864044,28,2009060299,-803745
1652988117,200260,true,2010266037,28,2008658547,-1607490
1652988374,200259,true,2010467063,28,2007453774,-3013289
1652988468,200259,true,2010467063,28,2007052344,-3414719
1652988498,200257,true,2010869177,28,2006851658,-4017519
1652988563,200255,true,2011271371,28,2006450348,-4821023
1652988575,200254,true,2011472498,28,2006249723,-5222775
1652988584,200254,true,2011472498,28,2006249723,-5222775
1652988870,200253,true,2011673645,28,2003843788,-7829857
1652988958,200251,true,2012076000,28,2003042451,-9033549
1652990928,200251,true,2012076000,28,1995046683,-17029317
1652990973,200251,true,2012076000,28,1995246187,-16829813
1652990980,200249,true,2012478435,28,1995246187,-17232248
1652991660,200248,true,2012679683,28,1996244010,-16435673
1652992037,200248,true,2012679683,28,1996842943,-15836740
1652992143,200249,true,2012478435,28,1997042627,-15435808
1652992524,200249,true,2012478435,28,1997641800,-14836635
1652992574,200249,true,2012478435,28,1997641800,-14836635
1652992684,200249,true,2012478435,28,1997841564,-14636871
1652992755,200250,true,2012277208,28,1998041348,-14235860
1652993168,200250,true,2012277208,28,1998241153,-14036055
1652993307,200251,true,2012076000,28,1998640821,-13435179
1652993352,200251,true,2012076000,28,1998840685,-13235315
1652993485,200253,true,2011673645,28,1999240473,-12433172
1652993677,200252,true,2011874813,28,1999840305,-12034508
1652993916,200253,true,2011673645,28,2001040509,-10633136
1652993921,200255,true,2011271371,28,2001040509,-10230862
1652994000,200256,true,2011070264,28,2001440737,-9629527
1652994019,200256,true,2011070264,28,2001440737,-9629527
1652994229,200256,true,2011070264,28,2002641902,-8428362
1652994640,200258,true,2010668110,28,2004645445,-6022665
1652994692,200259,true,2010467063,28,2004845910,-5621153
1652994719,200259,true,2010467063,28,2005046395,-5420668
1652994820,200260,true,2010266037,28,2005647969,-4618068
1652994870,200262,true,2009864044,28,2006049118,-3814926
1652994891,200263,true,2009663078,28,2006249723,-3413355
1652994925,200263,true,2009663078,28,2006650993,-3012085
1652995006,200263,true,2009663078,28,2007453774,-2209304
1652995012,200264,true,2009462131,28,2007453774,-2008357
1652995061,200266,true,2009060299,28,2007855285,-1205014
1652995660,200266,true,2009060299,28,2012478435,3418136
1652995844,200265,true,2009261205,28,2013686224,4425019
1652995908,200266,true,2009060299,28,2014088982,5028683
1652995979,200267,true,2008859413,28,2014491820,5632407
1652996029,200267,true,2008859413,28,2014693269,5833856
1652996092,200266,true,2009060299,28,2015096228,6035929
1652996146,200267,true,2008859413,28,2014894738,6035325
1652996234,200268,true,2008658547,28,2014894738,6236191
1652996329,200269,true,2008457702,28,2014894738,6437036
1652996341,200268,true,2008658547,28,2014894738,6236191
1652996640,200269,true,2008457702,28,2014894738,6437036
1652996775,200270,true,2008256876,28,2014491820,6234944
1652997132,200271,true,2008056070,28,2012679683,4623613
1652997912,200270,true,2008256876,28,2009261205,1004329
1652998199,200271,true,2008056070,28,2009261205,1205135
1652999436,200273,true,2007654519,28,2006049118,-1605401
1652999540,200273,true,2007654519,28,2005848533,-1805986
1652999600,200273,true,2007654519,28,2005647969,-2006550
1652999722,200273,true,2007654519,28,2005447424,-2207095
1652999844,200275,true,2007253049,28,2005246899,-2006150
1652999952,200276,true,2007052344,28,2004845910,-2206434
1653000006,200275,true,2007253049,28,2004645445,-2607604
1653000183,200276,true,2007052344,28,2004044172,-3008172
1653000929,200278,true,2006650993,28,2001841046,-4809947
1653001210,200278,true,2006650993,28,2001240613,-5410380
1653001230,200278,true,2006650993,28,2001240613,-5410380
1653001328,200278,true,2006650993,28,2001240613,-5410380
1653001779,200279,true,2006450348,28,2002641902,-3808446
1653002885,200279,true,2006450348,28,2007855285,1404937
1653003049,200278,true,2006650993,28,2008457702,1806709
1653003235,200278,true,2006650993,28,2008658547,2007554
1653003292,200279,true,2006450348,28,2008859413,2409065
1653003319,200279,true,2006450348,28,2008859413,2409065
1653003372,200278,true,2006650993,28,2009060299,2409306
1653003775,200277,true,2006851658,28,2010065030,3213372
1653003957,200278,true,2006650993,28,2010668110,4017117
1653004001,200277,true,2006851658,28,2010668110,3816452
1653004114,200276,true,2007052344,28,2011070264,4017920
1653004197,200276,true,2007052344,28,2011472498,4420154
1653004253,200276,true,2007052344,28,2011673645,4621301
1653005047,200275,true,2007253049,28,2015700817,8447768
1653006006,200274,true,2007453774,28,2016507218,9053444
1653006015,200273,true,2007654519,28,2016507218,8852699
1653006028,200274,true,2007453774,28,2016507218,9053444
1653006081,200273,true,2007654519,28,2016305588,8651069
1653006298,200272,true,2007855285,28,2015499267,7643982
1653007020,200272,true,2007855285,28,2012880951,5025666
1653007490,200272,true,2007855285,28,2011472498,3617213
1653007558,200272,true,2007855285,28,2011271371,3416086
1653008003,200272,true,2007855285,28,2010668110,2812825
1653008288,200271,true,2008056070,28,2010668110,2612040
1653008604,200272,true,2007855285,28,2011070264,3214979
1653008715,200271,true,2008056070,28,2011271371,3215301
1653008723,200271,true,2008056070,28,2011271371,3215301
1653008749,200271,true,2008056070,28,2011271371,3215301
1653009168,200271,true,2008056070,28,2010869177,2813107
1653009765,200271,true,2008056070,28,2009864044,1807974
1653009789,200271,true,2008056070,28,2009864044,1807974
1653009850,200271,true,2008056070,28,2010065030,2008960
1653009911,200272,true,2007855285,28,2010065030,2209745
1653010130,200271,true,2008056070,28,2010668110,2612040
1653010288,200271,true,2008056070,28,2010869177,2813107
1653010318,200270,true,2008256876,28,2011070264,2813388
1653010362,200271,true,2008056070,28,2011271371,3215301
1653010381,200269,true,2008457702,28,2011271371,2813669
1653010491,200268,true,2008658547,28,2012277208,3618661
1653010654,200267,true,2008859413,28,2013887593,5028180
1653010754,200268,true,2008658547,28,2015499267,6840720
1653010772,200266,true,2009060299,28,2015902387,6842088
1653010836,200264,true,2009462131,28,2017112231,7650100
1653010906,200262,true,2009864044,28,2018524633,8660589
1653011350,200261,true,2010065030,28,2027830769,17765739
1653011403,200259,true,2010467063,28,2028844887,18377824
1653011420,200257,true,2010869177,28,2029047772,18178595
1653011432,200255,true,2011271371,28,2029250676,17979305
1653011449,200254,true,2011472498,28,2029656547,18184049
1653011581,200253,true,2011673645,28,2031687117,20013472
1653011725,200251,true,2012076000,28,2033719719,21643719
1653012067,200248,true,2012679683,28,2037383527,24703844
1653012156,200248,true,2012679683,28,2038198603,25518920
1653012300,200246,true,2013082239,28,2038402423,25320184
1653012483,200244,true,2013484876,28,2038402423,24917547
1653012686,200242,true,2013887593,28,2036976112,23088519
1653012768,200241,true,2014088982,28,2036161525,22072543
1653012825,200240,true,2014290391,28,2035550799,21260408
1653012871,200239,true,2014491820,28,2035143750,20651930
1653012921,200237,true,2014894738,28,2034533329,19638591
1653013030,200237,true,2014894738,28,2033109725,18214987
1653013130,200235,true,2015297737,28,2031890286,16592549
1653013265,200234,true,2015499267,28,2030265505,14766238
1653013339,200233,true,2015700817,28,2029656547,13955730
1653013549,200233,true,2015700817,28,2027830769,12129952
1653013807,200232,true,2015902387,28,2025398953,9496566
1653014388,200231,true,2016103977,28,2021958872,5854895
1653014486,200229,true,2016507218,28,2021554541,5047323
1653014640,200229,true,2016507218,28,2021352405,4845187
1653014665,200228,true,2016708869,28,2021150290,4441421
1653014797,200227,true,2016910540,28,2021352405,4441865
1653014848,200226,true,2017112231,28,2021352405,4240174
1653014861,200226,true,2017112231,28,2021352405,4240174
1653016721,200225,true,2017313942,28,2026209234,8895292
1653016752,200224,true,2017515674,28,2026209234,8693560
1653017415,200223,true,2017717425,28,2026006633,8289208
1653017687,200223,true,2017717425,28,2026006633,8289208
1653018510,200222,true,2017919197,28,2025804053,7884856
1653018521,200221,true,2018120989,28,2025804053,7683064
1653018954,200220,true,2018322801,28,2025601493,7278692
1653018990,200220,true,2018322801,28,2025601493,7278692
1653019209,200219,true,2018524633,28,2025601493,7076860
1653019297,200219,true,2018524633,28,2025601493,7076860
1653020749,200219,true,2018524633,28,2025398953,6874320
1653021446,200219,true,2018524633,28,2024993934,6469301
1653021514,200218,true,2018726486,28,2024993934,6267448
1653021739,200218,true,2018726486,28,2024993934,6267448
1653021852,200218,true,2018726486,28,2024791455,6064969
1653021927,200218,true,2018726486,28,2024588996,5862510
1653021943,200217,true,2018928358,28,2024588996,5660638
1653021979,200217,true,2018928358,28,2024588996,5660638
1653021987,200216,true,2019130251,28,2024386557,5256306
1653022011,200216,true,2019130251,28,2024386557,5256306
1653022027,200215,true,2019332164,28,2024386557,5054393
1653022378,200216,true,2019130251,28,2022767777,3637526
1653022571,200215,true,2019332164,28,2021756696,2424532
1653022920,200215,true,2019332164,28,2020342032,1009868
1653023184,200214,true,2019534097,28,2019130251,-403846
1653024203,200214,true,2019534097,28,2016708869,-2825228
1653024255,200213,true,2019736051,28,2016708869,-3027182
1653025454,200213,true,2019736051,28,2016708869,-3027182
1653025480,200212,true,2019938024,28,2016708869,-3229155
1653025489,200212,true,2019938024,28,2016910540,-3027484
1653026034,200211,true,2020140018,28,2017112231,-3027787
1653026203,200211,true,2020140018,28,2017313942,-2826076
1653026641,200210,true,2020342032,28,2017919197,-2422835
1653026673,200210,true,2020342032,28,2017919197,-2422835
1653026836,200208,true,2020746121,28,2018120989,-2625132
1653027505,200207,true,2020948195,28,2019130251,-1817944
1653027679,200206,true,2021150290,28,2019332164,-1818126
1653028007,200206,true,2021150290,28,2019534097,-1616193
1653028014,200205,true,2021352405,28,2019534097,-1818308
1653028075,200205,true,2021352405,28,2019534097,-1818308
1653028091,200204,true,2021554541,28,2019534097,-2020444
1653028122,200204,true,2021554541,28,2019332164,-2222377
1653028136,200203,true,2021756696,28,2019332164,-2424532
1653028178,200204,true,2021554541,28,2019332164,-2222377
1653028257,200203,true,2021756696,28,2019130251,-2626445
1653028268,200204,true,2021554541,28,2018928358,-2626183
1653028285,200203,true,2021756696,28,2018928358,-2828338
1653028287,200204,true,2021554541,28,2018928358,-2626183
1653028319,200204,true,2021554541,28,2018726486,-2828055
1653028326,200205,true,2021352405,28,2018726486,-2625919
1653028456,200204,true,2021554541,28,2017717425,-3837116
1653028786,200205,true,2021352405,28,2015499267,-5853138
1653029348,200206,true,2021150290,28,2011472498,-9677792
1653029368,200206,true,2021150290,28,2011472498,-9677792
1653029395,200206,true,2021150290,28,2011271371,-9878919
1653029518,200207,true,2020948195,28,2010266037,-10682158
1653029671,200207,true,2020948195,28,2009060299,-11887896
1653029915,200207,true,2020948195,28,2007253049,-13695146
1653029942,200207,true,2020948195,28,2007253049,-13695146
1653030031,200208,true,2020746121,28,2006851658,-13894463
1653030066,200208,true,2020746121,28,2006851658,-13894463
1653030101,200208,true,2020746121,28,2006851658,-13894463
1653030510,200207,true,2020948195,28,2007253049,-13695146
1653030595,200208,true,2020746121,28,2007453774,-13292347
1653030633,200209,true,2020544066,28,2007453774,-13090292
1653030666,200208,true,2020746121,28,2007453774,-13292347
1653030731,200208,true,2020746121,28,2007654519,-13091602
1653030822,200208,true,2020746121,28,2008056070,-12690051
1653030846,200208,true,2020746121,28,2008056070,-12690051
1653030876,200208,true,2020746121,28,2008256876,-12489245
1653030929,200207,true,2020948195,28,2008457702,-12490493
1653030977,200207,true,2020948195,28,2008658547,-12289648
1653031999,200208,true,2020746121,28,2014290391,-6455730
1653032031,200208,true,2020746121,28,2014491820,-6254301
1653032098,200207,true,2020948195,28,2014894738,-6053457
1653032234,200207,true,2020948195,28,2015700817,-5247378
1653032351,200207,true,2020948195,28,2016305588,-4642607
1653032493,200208,true,2020746121,28,2017112231,-3633890
1653032603,200208,true,2020746121,28,2017717425,-3028696
1653032766,200208,true,2020746121,28,2018322801,-2423320
1653032984,200209,true,2020544066,28,2019130251,-1413815
1653033168,200210,true,2020342032,28,2019938024,-404008
1653034491,200211,true,2020140018,28,2024386557,4246539
1653034571,200212,true,2019938024,28,2024588996,4650972
1653034894,200213,true,2019736051,28,2024588996,4852945
1653034928,200214,true,2019534097,28,2024588996,5054899
1653035287,200214,true,2019534097,28,2024588996,5054899
1653035331,200215,true,2019332164,28,2024588996,5256832
1653035374,200215,true,2019332164,28,2024791455,5459291
1653035400,200216,true,2019130251,28,2024791455,5661204
1653035899,200216,true,2019130251,28,2025804053,6673802
1653035932,200216,true,2019130251,28,2025804053,6673802
1653036074,200216,true,2019130251,28,2026209234,7078983
1653036521,200217,true,2018928358,28,2027019839,8091481
1653036843,200216,true,2019130251,28,2027830769,8700518
1653037126,200217,true,2018928358,28,2028439179,9510821
1653037447,200216,true,2019130251,28,2028439179,9308928
1653037494,200217,true,2018928358,28,2028439179,9510821
1653037744,200216,true,2019130251,28,2028439179,9308928
1653037885,200216,true,2019130251,28,2028439179,9308928
1653037937,200215,true,2019332164,28,2028439179,9107015
1653038154,200216,true,2019130251,28,2028439179,9308928
1653038258,200215,true,2019332164,28,2028236355,8904191
1653038308,200215,true,2019332164,28,2028236355,8904191
1653038369,200214,true,2019534097,28,2028236355,8702258
1653038601,200215,true,2019332164,28,2028033552,8701388
1653038847,200214,true,2019534097,28,2028033552,8499455
1653039020,200213,true,2019736051,28,2027830769,8094718
1653039165,200213,true,2019736051,28,2027830769,8094718
1653039311,200214,true,2019534097,28,2027830769,8296672
1653039343,200213,true,2019736051,28,2027830769,8094718
1653039397,200213,true,2019736051,28,2027830769,8094718
1653039435,200213,true,2019736051,28,2027830769,8094718
1653039546,200213,true,2019736051,28,2027830769,8094718
1653039565,200212,true,2019938024,28,2027830769,7892745
1653039616,200212,true,2019938024,28,2027830769,7892745
1653039666,200212,true,2019938024,28,2027830769,7892745
1653039716,200212,true,2019938024,28,2028033552,8095528
1653040336,200211,true,2020140018,28,2029656547,9516529
1653040531,200211,true,2020140018,28,2030062498,9922480
1653040541,200211,true,2020140018,28,2030062498,9922480
1653040571,200211,true,2020140018,28,2030265505,10125487
1653041601,200210,true,2020342032,28,2034329896,13987864
1653042024,200209,true,2020544066,28,2035347264,14803198
1653042122,200209,true,2020544066,28,2035550799,15006733
1653042128,200209,true,2020544066,28,2035754354,15210288
1653042256,200207,true,2020948195,28,2036161525,15213330
1653042627,200206,true,2021150290,28,2037179809,16029519
1653042693,200206,true,2021150290,28,2037383527,16233237
1653042891,200206,true,2021150290,28,2037791024,16640734
1653043838,200204,true,2021554541,28,2039625770,18071229
1653044162,200203,true,2021756696,28,2039625770,17869074
1653044379,200203,true,2021756696,28,2039625770,17869074
1653044506,200202,true,2021958872,28,2039829733,17870861
1653044528,200200,true,2022363284,28,2039829733,17466449
1653044558,200199,true,2022565520,28,2039829733,17264213
1653044595,200198,true,2022767777,28,2039829733,17061956
1653044624,200198,true,2022767777,28,2039829733,17061956
1653044662,200195,true,2023374668,28,2040033716,16659048
1653044791,200194,true,2023577005,28,2040645787,17068782
1653045018,200193,true,2023779363,28,2042074668,18295305
1653045063,200192,true,2023981741,28,2042278875,18297134
1653045099,200190,true,2024386557,28,2042483103,18096546
1653045120,200188,true,2024791455,28,2042483103,17691648
1653045173,200187,true,2024993934,28,2042891620,17897686
1653045337,200187,true,2024993934,28,2043504549,18510615
1653045395,200185,true,2025398953,28,2043708899,18309946
1653045421,200183,true,2025804053,28,2043708899,17904846
1653045476,200183,true,2025804053,28,2043913270,18109217
1653045955,200182,true,2026006633,28,2045344439,19337806
1653046060,200180,true,2026411855,28,2045548973,19137118
1653046243,200179,true,2026614496,28,2045958103,19343607
1653046263,200178,true,2026817158,28,2045958103,19140945
1653046541,200178,true,2026817158,28,2045958103,19140945
1653046562,200176,true,2027222541,28,2045753528,18530987
1653047233,200174,true,2027628006,28,2044322073,16694067
1653047285,200173,true,2027830769,28,2044322073,16491304
1653047287,200172,true,2028033552,28,2044322073,16288521
1653047444,200170,true,2028439179,28,2044526505,16087326
1653047475,200168,true,2028844887,28,2044730958,15886071
1653047516,200166,true,2029250676,28,2044730958,15480282
1653048566,200165,true,2029453601,28,2051079141,21625540
1653048625,200162,true,2030062498,28,2051284249,21221751
1653048658,200160,true,2030468531,28,2051489378,21020847
1653048783,200158,true,2030874645,28,2052104886,21230241
1653048886,200157,true,2031077733,28,2052515327,21437594
1653049684,200154,true,2031687117,28,2051694527,20007410
1653049801,200152,true,2032093475,28,2051284249,19190774
1653049826,200150,true,2032499914,28,2051079141,18579227
1653049925,200149,true,2032703164,28,2050668987,17965823
1653050105,200147,true,2033109725,28,2049848924,16739199
1653050320,200145,true,2033516367,28,2048824307,15307940
1653050499,200143,true,2033923091,28,2048209783,14286692
1653050653,200142,true,2034126483,28,2047595443,13468960
1653050693,200141,true,2034329896,28,2047390704,13060808
1653050908,200139,true,2034736782,28,2046981287,12244505
1653050937,200137,true,2035143750,28,2046776609,11632859
1653050947,200136,true,2035347264,28,2046776609,11429345
1653050954,200135,true,2035550799,28,2046776609,11225810
1653051030,200135,true,2035550799,28,2045958103,10407304
1653051604,200134,true,2035754354,28,2039829733,4075379
1653052216,200133,true,2035957929,28,2034329896,-1628033
1653052451,200132,true,2036161525,28,2032093475,-4068050
1653052510,200132,true,2036161525,28,2031890286,-4271239
1653052773,200131,true,2036365141,28,2030468531,-5896610
1653052854,200130,true,2036568778,28,2030671578,-5897200
1653052869,200129,true,2036772434,28,2030874645,-5897789
1653052876,200129,true,2036772434,28,2030874645,-5897789
1653052971,200128,true,2036976112,28,2031280840,-5695272
1653052997,200127,true,2037179809,28,2031483969,-5695840
1653053059,200125,true,2037587266,28,2031890286,-5696980
1653053086,200126,true,2037383527,28,2032093475,-5290052
1653053098,200125,true,2037587266,28,2032093475,-5493791
1653053647,200123,true,2037994804,28,2036772434,-1222370
1653053655,200122,true,2038198603,28,2036772434,-1426169
1653053682,200122,true,2038198603,28,2036976112,-1222491
1653053712,200122,true,2038198603,28,2037179809,-1018794
1653053764,200120,true,2038606263,28,2037383527,-1222736
1653053796,200119,true,2038810124,28,2037587266,-1222858
1653053818,200120,true,2038606263,28,2037587266,-1018997
1653054177,200120,true,2038606263,28,2037994804,-611459
1653054226,200119,true,2038810124,28,2038198603,-611521
1653054236,200118,true,2039014005,28,2038198603,-815402
1653054249,200119,true,2038810124,28,2038198603,-611521
1653054283,200119,true,2038810124,28,2038198603,-611521
1653054300,200118,true,2039014005,28,2038402423,-611582
1653054889,200117,true,2039217906,28,2039014005,-203901
1653055292,200117,true,2039217906,28,2037994804,-1223102
1653055627,200117,true,2039217906,28,2037587266,-1630640
1653055653,200116,true,2039421828,28,2037587266,-1834562
1653055669,200115,true,2039625770,28,2037587266,-2038504
1653055694,200115,true,2039625770,28,2037587266,-2038504
1653055781,200116,true,2039421828,28,2037791024,-1630804
1653055957,200115,true,2039625770,28,2037994804,-1630966
1653055973,200114,true,2039829733,28,2037994804,-1834929
1653056322,200114,true,2039829733,28,2036568778,-3260955
1653056416,200115,true,2039625770,28,2036161525,-3464245
1653056424,200114,true,2039829733,28,2036161525,-3668208
1653056440,200113,true,2040033716,28,2035957929,-4075787
1653056454,200114,true,2039829733,28,2035957929,-3871804
1653056510,200116,true,2039421828,28,2035347264,-4074564
1653056705,200115,true,2039625770,28,2033313036,-6312734
1653056771,200114,true,2039829733,28,2032499914,-7329819
1653056774,200116,true,2039421828,28,2032499914,-6921914
1653057497,200118,true,2039014005,28,2021352405,-17661600
1653057548,200118,true,2039014005,28,2020746121,-18267884
1653057562,200118,true,2039014005,28,2020544066,-18469939
1653058149,200119,true,2038810124,28,2012277208,-26532916
1653058184,200122,true,2038198603,28,2011673645,-26524958
1653058259,200123,true,2037994804,28,2010467063,-27527741
1653058299,200122,true,2038198603,28,2010065030,-28133573
1653058325,200125,true,2037587266,28,2009663078,-27924188
1653058383,200129,true,2036772434,28,2008859413,-27913021
1653058436,200129,true,2036772434,28,2008056070,-28716364
1653058466,200130,true,2036568778,28,2007453774,-29115004
1653058523,200133,true,2035957929,28,2006650993,-29306936
1653058543,200137,true,2035143750,28,2006249723,-28894027
1653058634,200138,true,2034940256,28,2004845910,-30094346
1653058673,200138,true,2034940256,28,2004445001,-30495255
1653058784,200142,true,2034126483,28,2002842166,-31284317
1653058893,200146,true,2033313036,28,2001440737,-31872299
1653058956,200147,true,2033109725,28,2000440317,-32669408
1653058999,200148,true,2032906434,28,1999640341,-33266093
1653059037,200152,true,2032093475,28,1998840685,-33252790
1653059059,200156,true,2031280840,28,1998440977,-32839863
1653059098,200159,true,2030671578,28,1997442056,-33229522
1653059106,200160,true,2030468531,28,1997242332,-33226199
1653059110,200165,true,2029453601,28,1997242332,-32211269
1653059143,200170,true,2028439179,28,1996244010,-32195169
1653059239,200173,true,2027830769,28,1993451363,-34379406
1653059338,200175,true,2027425264,28,1990662623,-36762641
1653059355,200180,true,2026411855,28,1990264551,-36147304
1653059390,200186,true,2025196433,28,1989269717,-35926716
1653059539,200189,true,2024588996,28,1985891000,-38697996
1653059660,200190,true,2024386557,28,1983112837,-41273720
1653059962,200195,true,2023374668,28,1976184420,-47190248
1653060054,200201,true,2022161068,28,1974209322,-47951746
1653060174,200204,true,2021554541,28,1972038994,-49515547
1653060402,200205,true,2021352405,28,1968295864,-53056541
1653060441,200211,true,2020140018,28,1967705494,-52434524
1653060466,200216,true,2019130251,28,1967312012,-51818239
1653060733,200218,true,2018726486,28,1964363403,-54363083
1653060971,200220,true,2018322801,28,1963381516,-54941285
1653060995,200225,true,2017313942,28,1963381516,-53932426
1653061265,200230,true,2016305588,28,1963577854,-52727734
1653061693,200233,true,2015700817,28,1962596360,-53104457
1653061764,200234,true,2015499267,28,1962400120,-53099147
1653061791,200239,true,2014491820,28,1962400120,-52091700
1653061846,200245,true,2013283548,28,1962203899,-51079649
1653061855,200248,true,2012679683,28,1962203899,-50475784
1653061867,200250,true,2012277208,28,1962203899,-50073309
1653061873,200256,true,2011070264,28,1962203899,-48866365
1653061928,200263,true,2009663078,28,1961811517,-47851561
1653062020,200266,true,2009060299,28,1961419214,-47641085
1653062090,200268,true,2008658547,28,1961223091,-47435456
1653062351,200274,true,2007453774,28,1959850784,-47602990
1653062685,200281,true,2006049118,28,1957696241,-48352877
1653062820,200284,true,2005447424,28,1956913359,-48534065
1653062822,200285,true,2005246899,28,1956913359,-48333540
1653062877,200291,true,2004044172,28,1956522035,-47522137
1653062953,200298,true,2002641902,28,1955544067,-47097835
1653062974,200303,true,2001640882,28,1955348532,-46292350
1653063020,200304,true,2001440737,28,1954762045,-46678692
1653063235,200310,true,2000240293,28,1951832246,-48408047
1653063571,200318,true,1998640821,28,1947543149,-51097672
1653063996,200322,true,1997841564,28,1943263478,-54578086
1653064021,200323,true,1997641800,28,1943069171,-54572629
1653064035,200330,true,1996244010,28,1942874883,-53369127
1653064077,200338,true,1994647733,28,1942486367,-52161366
1653064118,200342,true,1993850074,28,1942097928,-51752146
1653064352,200343,true,1993650708,28,1939381029,-54269679
1653064566,200348,true,1992654182,28,1937055284,-55598898
1653064624,200355,true,1991259882,28,1936474283,-54785599
1653064705,200359,true,1990463577,28,1935893457,-54570120
1653064806,200360,true,1990264551,28,1935312805,-54951746
1653064840,200365,true,1989269717,28,1935119293,-54150424
1653064979,200373,true,1987679017,28,1934538873,-53140144
1653065094,200378,true,1986685476,28,1933958628,-52726848
1653065282,200380,true,1986288198,28,1932798659,-53489539
1653066095,200384,true,1985493881,28,1931060009,-54433872
1653066892,200392,true,1983906201,28,1930094769,-53811432
1653066921,200397,true,1982914545,28,1930094769,-52819776
1653067008,200399,true,1982518022,28,1930287778,-52230244
1653067015,200404,true,1981527060,28,1930287778,-51239282
1653067250,200412,true,1979942552,28,1930866923,-49075629
1653067552,200417,true,1978952877,28,1931253115,-47699762
1653067616,200419,true,1978557146,28,1931253115,-47304031
1653067862,200424,true,1977568164,28,1931253115,-46315049
1653068003,200432,true,1975986821,28,1931253115,-44733706
1653068069,200437,true,1974999124,28,1931253115,-43746009
1653068085,200439,true,1974604184,28,1931253115,-43351069
1653068094,200444,true,1973617178,28,1931253115,-42364063
1653068103,200451,true,1972236198,28,1931253115,-40983083
1653068122,200455,true,1971447501,28,1931253115,-40194386
1653068168,200457,true,1971053270,28,1931253115,-39800155
1653068303,200462,true,1970068039,28,1931446241,-38621798
1653068479,200469,true,1968689543,28,1931832549,-36856994
1653068497,200474,true,1967705494,28,1931832549,-35872945
1653068686,200476,true,1967312012,28,1932025733,-35286279
1653068758,200481,true,1966328651,28,1932025733,-34302918
1653068815,200489,true,1964756295,28,1932025733,-32730562
1653068897,200493,true,1963970589,28,1932025733,-31944856
1653069028,200495,true,1963577854,28,1932218935,-31358919
1653069289,200500,true,1962596360,28,1932218935,-30377425
1653069349,200507,true,1961223091,28,1932218935,-29004156
1653069381,200511,true,1960438798,28,1932218935,-28219863
1653069919,200513,true,1960046769,28,1933765251,-26281518
1653069974,200517,true,1959262947,28,1933765251,-25497696
1653070047,200524,true,1957892011,28,1933765251,-24126760
1653070876,200529,true,1956913359,28,1932798659,-24114700
1653070927,200531,true,1956522035,28,1932605398,-23916637
1653070969,200535,true,1955739621,28,1932605398,-23134223
1653071621,200541,true,1954566588,28,1929901779,-24664809
1653071989,200546,true,1953589598,28,1928744243,-24845355
1653072293,200548,true,1953198939,28,1928358552,-24840387
1653072347,200552,true,1952417854,28,1928165735,-24252119
1653072462,200557,true,1951441938,28,1928358552,-23083386
1653072503,200561,true,1950661557,28,1928358552,-22303005
1653072518,200562,true,1950466510,28,1928358552,-22107958
1653072649,200566,true,1949686518,28,1928551388,-21135130
1653072766,200570,true,1948906839,28,1928744243,-20162596
1653072847,200574,true,1948127471,28,1929130011,-18997460
1653074878,200574,true,1948127471,28,1938799331,-9328140
1653074939,200577,true,1947543149,28,1938799331,-8743818
1653074984,200581,true,1946764327,28,1938993211,-7771116
1653074989,200584,true,1946180414,28,1938993211,-7187203
1653075006,200584,true,1946180414,28,1938993211,-7187203
1653075588,200586,true,1945791237,28,1939962901,-5828336
1653075667,200590,true,1945013115,28,1940156898,-4856217
1653075680,200593,true,1944429727,28,1940156898,-4272829
1653075699,200592,true,1944624170,28,1940350913,-4273257
1653075702,200594,true,1944235304,28,1940350913,-3884391
1653075731,200597,true,1943652150,28,1940544948,-3107202
1653075736,200599,true,1943263478,28,1940544948,-2718530
1653075754,200598,true,1943457804,28,1940739003,-2718801
1653075779,200599,true,1943263478,28,1940933077,-2330401
1653075904,200601,true,1942874883,28,1942292138,-582745
1653075992,200602,true,1942680615,28,1943263478,582863
1653076130,200601,true,1942874883,28,1944818633,1943750
1653076136,200601,true,1942874883,28,1944818633,1943750
1653076486,200601,true,1942874883,28,1949101729,6226846
1653076563,200602,true,1942680615,28,1950076475,7395860
1653076638,200601,true,1942874883,28,1951051708,8176825
1653076699,200601,true,1942874883,28,1952027429,9152546
1653077055,200601,true,1942874883,28,1956717687,13842804
1653077989,200602,true,1942680615,28,1963970589,21289974
1653077997,200601,true,1942874883,28,1963970589,21095706
1653078853,200601,true,1942874883,28,1965149266,22274383
1653079077,200601,true,1942874883,28,1965345781,22470898
1653079277,200602,true,1942680615,28,1965345781,22665166
1653079454,200600,true,1943069171,28,1965542316,22473145
1653079528,200600,true,1943069171,28,1965542316,22473145
1653079555,200600,true,1943069171,28,1965738870,22669699
1653079560,200601,true,1942874883,28,1965738870,22863987
1653079603,200600,true,1943069171,28,1965542316,22473145
1653079622,200600,true,1943069171,28,1965542316,22473145
1653079682,200600,true,1943069171,28,1965542316,22473145
1653079686,200601,true,1942874883,28,1965542316,22667433
1653079798,200600,true,1943069171,28,1965345781,22276610
1653081184,200600,true,1943069171,28,1962007698,18938527
1653081302,200600,true,1943069171,28,1961811517,18742346
1653081340,200600,true,1943069171,28,1961615356,18546185
1653081796,200599,true,1943263478,28,1961419214,18155736
1653081807,200599,true,1943263478,28,1961419214,18155736
1653081859,200598,true,1943457804,28,1961419214,17961410
1653081932,200599,true,1943263478,28,1961615356,18351878
1653083023,200597,true,1943652150,28,1962988898,19336748
1653083761,200597,true,1943652150,28,1963577854,19925704
1653084154,200596,true,1943846515,28,1963381516,19535001
1653085398,200597,true,1943652150,28,1961615356,17963206
1653085488,200596,true,1943846515,28,1961615356,17768841
1653086732,200596,true,1943846515,28,1961419214,17572699
1653086904,200594,true,1944235304,28,1961615356,17380052
1653087060,200594,true,1944235304,28,1961615356,17380052
1653087215,200592,true,1944624170,28,1961811517,17187347
1653087270,200591,true,1944818633,28,1961811517,16992884
1653087279,200589,true,1945207616,28,1961811517,16603901
1653087293,200589,true,1945207616,28,1961811517,16603901
1653087301,200588,true,1945402137,28,1961811517,16409380
1653087333,200587,true,1945596677,28,1961615356,16018679
1653087483,200585,true,1945985816,28,1961419214,15433398
1653088071,200585,true,1945985816,28,1959850784,13864968
1653088263,200583,true,1946375032,28,1959458873,13083841
1653088288,200583,true,1946375032,28,1959458873,13083841
1653088344,200581,true,1946764327,28,1959458873,12694546
1653088368,200581,true,1946764327,28,1959458873,12694546
1653088375,200578,true,1947348415,28,1959458873,12110458
1653088415,200577,true,1947543149,28,1959654819,12111670
1653088665,200574,true,1948127471,28,1960242774,12115303
1653088944,200573,true,1948322284,28,1961419214,13096930
1653089573,200570,true,1948906839,28,1965542316,16635477
1653089866,200570,true,1948906839,28,1967705494,18798655
1653090125,200567,true,1949491569,28,1969083301,19591732
1653090153,200566,true,1949686518,28,1969083301,19396783
1653090180,200563,true,1950271483,28,1969083301,18811818
1653090279,200563,true,1950271483,28,1969083301,18811818
1653090312,200561,true,1950661557,28,1969083301,18421744
1653090372,200560,true,1950856623,28,1969083301,18226678
1653090445,200558,true,1951246814,28,1969083301,17836487
1653091323,200557,true,1951441938,28,1964952771,13510833
1653091401,200555,true,1951832246,28,1964559839,12727593
1653091957,200555,true,1951832246,28,1961223091,9390845
1653092806,200552,true,1952417854,28,1960438798,8020944
1653092851,200552,true,1952417854,28,1960634842,8216988
1653092932,200549,true,1953003638,28,1960634842,7631204
1653092955,200549,true,1953003638,28,1960634842,7631204
1653093470,200546,true,1953589598,28,1962596360,9006762
1653093574,200545,true,1953784957,28,1962988898,9203941
1653093669,200543,true,1954175734,28,1963185197,9009463
1653093718,200543,true,1954175734,28,1963381516,9205782
1653093969,200540,true,1954762045,28,1963381516,8619471
1653095125,200540,true,1954762045,28,1961419214,6657169
1653095499,200538,true,1955153017,28,1960438798,5285781
1653095575,200538,true,1955153017,28,1960242774,5089757
1653096435,200536,true,1955544067,28,1958675285,3131218
1653096446,200536,true,1955544067,28,1958675285,3131218
1653096478,200534,true,1955935195,28,1958675285,2740090
1653096488,200534,true,1955935195,28,1958675285,2740090
1653096500,200532,true,1956326402,28,1958479437,2153035
1653097151,200534,true,1955935195,28,1951637082,-4298113
1653097215,200533,true,1956130789,28,1951051708,-5079081
1653097686,200532,true,1956326402,28,1946764327,-9562075
1653097725,200530,true,1956717687,28,1946375032,-10342655
1653097745,200532,true,1956326402,28,1946375032,-9951370
1653097754,200530,true,1956717687,28,1946180414,-10537273
1653099141,200528,true,1957109050,28,1945402137,-11706913
1653099332,200527,true,1957304761,28,1945985816,-11318945
1653099783,200529,true,1956913359,28,1946375032,-10538327
1653099801,200527,true,1957304761,28,1946569670,-10735091
1653100031,200525,true,1957696241,28,1946764327,-10931914
1653100102,200524,true,1957892011,28,1946959003,-10933008
1653100138,200526,true,1957500491,28,1946959003,-10541488
1653100155,200524,true,1957892011,28,1947153699,-10738312
1653100195,200522,true,1958283609,28,1947153699,-11129910
1653100478,200521,true,1958479437,28,1948127471,-10351966
1653100540,200523,true,1958087800,28,1948322284,-9765516
1653100629,200521,true,1958479437,28,1948711967,-9767470
1653101450,200519,true,1958871153,28,1952222632,-6648521
1653102638,200518,true,1959067040,28,1954175734,-4891306
1653103124,200521,true,1958479437,28,1954175734,-4303703
1653103843,200519,true,1958871153,28,1954175734,-4695419
1653103879,200517,true,1959262947,28,1954175734,-5087213
1653103925,200516,true,1959458873,28,1954175734,-5283139
1653104159,200519,true,1958871153,28,1954175734,-4695419
1653104960,200518,true,1959067040,28,1953784957,-5282083
1653105070,200516,true,1959458873,28,1953589598,-5869275
1653105102,200516,true,1959458873,28,1953589598,-5869275
1653105128,200519,true,1958871153,28,1953784957,-5086196
1653105145,200519,true,1958871153,28,1953784957,-5086196
1653105147,200517,true,1959262947,28,1953784957,-5477990
1653105441,200516,true,1959458873,28,1954566588,-4892285
1653105449,200519,true,1958871153,28,1954566588,-4304565
1653105525,200519,true,1958871153,28,1954957521,-3913632
1653105628,200517,true,1959262947,28,1955348532,-3914415
1653106299,200516,true,1959458873,28,1958283609,-1175264
1653106979,200519,true,1958871153,28,1961223091,2351938
1653107236,200519,true,1958871153,28,1961419214,2548061
1653107264,200517,true,1959262947,28,1961419214,2156267
1653107280,200516,true,1959458873,28,1961419214,1960341
1653107318,200520,true,1958675285,28,1961419214,2743929
1653107504,200520,true,1958675285,28,1961419214,2743929
1653107543,200518,true,1959067040,28,1961419214,2352174
1653107772,200517,true,1959262947,28,1961419214,2156267
1653107883,200520,true,1958675285,28,1961419214,2743929
1653108045,200521,true,1958479437,28,1961419214,2939777
1653108360,200519,true,1958871153,28,1961419214,2548061
1653108549,200518,true,1959067040,28,1961419214,2352174
1653108668,200521,true,1958479437,28,1961419214,2939777
1653110184,200521,true,1958479437,28,1961419214,2939777
1653110488,200519,true,1958871153,28,1961419214,2548061
1653111037,200518,true,1959067040,28,1961419214,2352174
1653111304,200521,true,1958479437,28,1961419214,2939777
1653112104,200521,true,1958479437,28,1961419214,2939777
1653112273,200519,true,1958871153,28,1961419214,2548061
1653112521,200518,true,1959067040,28,1961419214,2352174
1653112854,200521,true,1958479437,28,1961419214,2939777
1653113055,200521,true,1958479437,28,1961811517,3332080
1653113502,200519,true,1958871153,28,1962203899,3332746
1653114342,200518,true,1959067040,28,1962988898,3921858
1653114374,200521,true,1958479437,28,1962988898,4509461
1653114393,200521,true,1958479437,28,1963185197,4705760
1653114643,200519,true,1958871153,28,1963577854,4706701
1653114826,200518,true,1959067040,28,1963577854,4510814
1653114971,200521,true,1958479437,28,1963774212,5294775
1653115290,200521,true,1958479437,28,1963970589,5491152
1653115951,200518,true,1959067040,28,1964756295,5689255
1653116225,200517,true,1959262947,28,1965149266,5886319
1653116311,200520,true,1958675285,28,1965149266,6473981
1653116488,200520,true,1958675285,28,1965149266,6473981
1653116604,200518,true,1959067040,28,1965149266,6082226
1653116868,200516,true,1959458873,28,1965149266,5690393
1653117091,200519,true,1958871153,28,1965149266,6278113
1653117479,200519,true,1958871153,28,1965149266,6278113
1653117832,200516,true,1959458873,28,1965149266,5690393
1653117937,200515,true,1959654819,28,1965345781,5690962
1653117973,200517,true,1959262947,28,1965542316,6279369
1653118206,200517,true,1959262947,28,1966132037,6869090
1653118542,200515,true,1959654819,28,1966918608,7263789
1653118558,200514,true,1959850784,28,1966918608,7067824
1653118601,200516,true,1959458873,28,1967312012,7853139
1653118614,200516,true,1959458873,28,1967312012,7853139
1653118646,200513,true,1960046769,28,1967508743,7461974
1653118933,200512,true,1960242774,28,1969477137,9234363
1653119260,200515,true,1959654819,28,1971841810,12186991
1653119413,200515,true,1959654819,28,1973025211,13370392
1653119565,200512,true,1960242774,28,1974011921,13769147
1653119672,200510,true,1960634842,28,1974801644,14166802
1653119880,200513,true,1960046769,28,1975789242,15742473
1653120034,200512,true,1960242774,28,1976579677,16336903
1653120197,200510,true,1960634842,28,1977172710,16537868
1653120806,200508,true,1961026989,28,1977963697,16936708
1653121506,200510,true,1960634842,28,1977963697,17328855
1653121640,200510,true,1960634842,28,1977963697,17328855
1653122193,200506,true,1961419214,28,1977963697,16544483
1653122223,200505,true,1961615356,28,1977963697,16348341
1653122267,200507,true,1961223091,28,1978161494,16938403
1653122506,200506,true,1961419214,28,1978161494,16742280
1653122562,200503,true,1962007698,28,1978161494,16153796
1653122659,200503,true,1962007698,28,1978359310,16351612
1653122863,200504,true,1961811517,28,1978359310,16547793
1653123039,200504,true,1961811517,28,1978557146,16745629
1653123711,200501,true,1962400120,28,1978952877,16552757
1653123898,200499,true,1962792619,28,1978952877,16160258
1653124061,200501,true,1962400120,28,1978952877,16552757
1653124101,200501,true,1962400120,28,1978952877,16552757
1653124271,200498,true,1962988898,28,1978359310,15370412
1653125203,200497,true,1963185197,28,1975196624,12011427
1653125228,200498,true,1962988898,28,1974999124,12010226
1653125408,200498,true,1962988898,28,1974406743,11417845
1653125789,200495,true,1963577854,28,1972630665,9052811
1653126044,200494,true,1963774212,28,1971841810,8067598
1653126304,200493,true,1963970589,28,1971644645,7674056
1653126319,200493,true,1963970589,28,1971447501,7476912
1653126379,200490,true,1964559839,28,1971447501,6887662
1653126458,200489,true,1964756295,28,1971250376,6494081
1653126540,200488,true,1964952771,28,1971250376,6297605
1653126568,200487,true,1965149266,28,1971250376,6101110
1653126603,200486,true,1965345781,28,1971250376,5904595
1653126944,200484,true,1965738870,28,1970659119,4920249
1653127101,200484,true,1965738870,28,1970462073,4723203
1653127301,200483,true,1965935444,28,1970265046,4329602
1653127436,200481,true,1966328651,28,1970265046,3936395
1653127465,200480,true,1966525283,28,1970265046,3739763
1653127483,200480,true,1966525283,28,1970265046,3739763
1653127495,200479,true,1966721936,28,1970265046,3543110
1653127530,200478,true,1966918608,28,1970265046,3346438
1653128569,200477,true,1967115300,28,1970265046,3149746
1653128985,200477,true,1967115300,28,1970265046,3149746
1653129028,200476,true,1967312012,28,1970265046,2953034
1653129042,200475,true,1967508743,28,1970265046,2756303
1653129059,200474,true,1967705494,28,1970265046,2559552
1653129300,200474,true,1967705494,28,1970265046,2559552
1653129540,200473,true,1967902264,28,1970265046,2362782
1653129621,200472,true,1968099054,28,1970265046,2165992
1653130236,200471,true,1968295864,28,1970265046,1969182
1653130350,200471,true,1968295864,28,1970265046,1969182
1653131049,200470,true,1968492694,28,1970068039,1575345
1653131074,200469,true,1968689543,28,1970068039,1378496
1653131271,200468,true,1968886412,28,1970068039,1181627
1653131450,200468,true,1968886412,28,1970068039,1181627
1653132402,200468,true,1968886412,28,1969280209,393797
1653132636,200467,true,1969083301,28,1968886412,-196889
1653132683,200466,true,1969280209,28,1968689543,-590666
1653132737,200466,true,1969280209,28,1968689543,-590666
1653132845,200466,true,1969280209,28,1968492694,-787515
1653132871,200465,true,1969477137,28,1968295864,-1181273
1653132890,200465,true,1969477137,28,1968295864,-1181273
1653132906,200465,true,1969477137,28,1968295864,-1181273
1653133122,200466,true,1969280209,28,1967312012,-1968197
1653133129,200465,true,1969477137,28,1967312012,-2165125
1653133260,200465,true,1969477137,28,1966721936,-2755201
1653133625,200466,true,1969280209,28,1964952771,-4327438
1653133987,200466,true,1969280209,28,1963577854,-5702355
1653134036,200465,true,1969477137,28,1963577854,-5899283
1653134332,200465,true,1969477137,28,1962792619,-6684518
1653134525,200465,true,1969477137,28,1962596360,-6880777
1653134591,200466,true,1969280209,28,1962400120,-6880089
1653134632,200465,true,1969477137,28,1962400120,-7077017
1653134639,200465,true,1969477137,28,1962400120,-7077017
1653134642,200465,true,1969477137,28,1962400120,-7077017
1653134650,200465,true,1969477137,28,1962400120,-7077017
1653135050,200464,true,1969674085,28,1963381516,-6292569
1653136335,200464,true,1969674085,28,1966328651,-3345434
1653136664,200464,true,1969674085,28,1966525283,-3148802
1653137678,200464,true,1969674085,28,1966132037,-3542048
1653138037,200463,true,1969871052,28,1965935444,-3935608
1653138047,200463,true,1969871052,28,1965935444,-3935608
1653138366,200463,true,1969871052,28,1965149266,-4721786
1653138425,200464,true,1969674085,28,1965149266,-4524819
1653139352,200463,true,1969871052,28,1963577854,-6293198
1653139370,200463,true,1969871052,28,1963577854,-6293198
1653139521,200463,true,1969871052,28,1963381516,-6489536
1653139534,200464,true,1969674085,28,1963381516,-6292569
1653139856,200463,true,1969871052,28,1962792619,-7078433
1653139887,200463,true,1969871052,28,1962988898,-6882154
1653139976,200463,true,1969871052,28,1962988898,-6882154
1653140182,200464,true,1969674085,28,1963185197,-6488888
1653140220,200463,true,1969871052,28,1963185197,-6685855
1653140243,200464,true,1969674085,28,1963185197,-6488888
1653140270,200464,true,1969674085,28,1963185197,-6488888
1653140294,200464,true,1969674085,28,1963381516,-6292569
1653140749,200463,true,1969871052,28,1964559839,-5311213
1653140911,200463,true,1969871052,28,1965149266,-4721786
1653141094,200463,true,1969871052,28,1965738870,-4132182
1653141243,200464,true,1969674085,28,1966132037,-3542048
1653141558,200462,true,1970068039,28,1966918608,-3149431
1653142047,200463,true,1969871052,28,1968099054,-1771998
1653142784,200463,true,1969871052,28,1968099054,-1771998
1653142947,200463,true,1969871052,28,1968099054,-1771998
1653143002,200463,true,1969871052,28,1968099054,-1771998
1653143063,200463,true,1969871052,28,1968099054,-1771998
1653143107,200463,true,1969871052,28,1967902264,-1968788
1653143124,200464,true,1969674085,28,1967902264,-1771821
1653143991,200465,true,1969477137,28,1965345781,-4131356
1653144100,200466,true,1969280209,28,1964952771,-4327438
1653144159,200466,true,1969280209,28,1964952771,-4327438
1653144188,200467,true,1969083301,28,1964756295,-4327006
1653144199,200467,true,1969083301,28,1964756295,-4327006
1653144229,200468,true,1968886412,28,1964756295,-4130117
1653144244,200468,true,1968886412,28,1964756295,-4130117
1653144259,200469,true,1968689543,28,1964756295,-3933248
1653144277,200469,true,1968689543,28,1964756295,-3933248
1653144432,200469,true,1968689543,28,1965149266,-3540277
1653145449,200469,true,1968689543,28,1970265046,1575503
1653145630,200470,true,1968492694,28,1971447501,2954807
1653145893,200470,true,1968492694,28,1973222513,4729819
1653145940,200470,true,1968492694,28,1973419836,4927142
1653145978,200469,true,1968689543,28,1973617178,4927635
1653146023,200470,true,1968492694,28,1973814539,5321845
1653146479,200472,true,1968099054,28,1972630665,4531611
1653147300,200472,true,1968099054,28,1970265046,2165992
1653147485,200471,true,1968295864,28,1969674085,1378221
1653147606,200472,true,1968099054,28,1969477137,1378083
1653147669,200473,true,1967902264,28,1969280209,1377945
1653148181,200473,true,1967902264,28,1969477137,1574873
1653148394,200473,true,1967902264,28,1970068039,2165775
1653148450,200474,true,1967705494,28,1970265046,2559552
1653148509,200474,true,1967705494,28,1970462073,2756579
1653148743,200473,true,1967902264,28,1971447501,3545237
1653149173,200472,true,1968099054,28,1973419836,5320782
1653149362,200473,true,1967902264,28,1974209322,6307058
1653149579,200473,true,1967902264,28,1974999124,7096860
1653150111,200472,true,1968099054,28,1977765921,9666867
1653150461,200470,true,1968492694,28,1978952877,10460183
1653153732,200471,true,1968295864,28,1980932721,12636857
1653153768,200471,true,1968295864,28,1980932721,12636857
1653154039,200470,true,1968492694,28,1980932721,12440027
1653154576,200468,true,1968886412,28,1980734647,11848235
1653154590,200469,true,1968689543,28,1980734647,12045104
1653155044,200470,true,1968492694,28,1979744577,11251883
1653155324,200468,true,1968886412,28,1979150772,10264360
1653157600,200467,true,1969083301,28,1977370427,8287126
1653158276,200468,true,1968886412,28,1977370427,8484015
1653158926,200468,true,1968886412,28,1977370427,8484015
1653159586,200467,true,1969083301,28,1977370427,8287126
1653159796,200466,true,1969280209,28,1977568164,8287955
1653159904,200466,true,1969280209,28,1977568164,8287955
1653159915,200467,true,1969083301,28,1977568164,8484863
1653160844,200465,true,1969477137,28,1979348688,9871551
1653161072,200464,true,1969674085,28,1979744577,10070492
1653164760,200465,true,1969477137,28,1980734647,11257510
1653165387,200465,true,1969477137,28,1980734647,11257510
1653165399,200463,true,1969871052,28,1980734647,10863595
1653165443,200462,true,1970068039,28,1980734647,10666608
1653165449,200463,true,1969871052,28,1980734647,10863595
1653165546,200464,true,1969674085,28,1980734647,11060562
1653165644,200462,true,1970068039,28,1980536594,10468555
1653165781,200461,true,1970265046,28,1980338560,10073514
1653165830,200461,true,1970265046,28,1980140546,9875500
1653167311,200462,true,1970068039,28,1976579677,6511638
1653167799,200460,true,1970462073,28,1976382038,5919965
1653167959,200459,true,1970659119,28,1976382038,5722919
1653168005,200460,true,1970462073,28,1976382038,5919965
1653169185,200461,true,1970265046,28,1975196624,4931578
1653170116,200459,true,1970659119,28,1974604184,3945065
1653170121,200458,true,1970856185,28,1974604184,3747999
1653170161,200458,true,1970856185,28,1974604184,3747999
1653170191,200460,true,1970462073,28,1974604184,4142111
1653170441,200458,true,1970856185,28,1974209322,3353137
1653170708,200457,true,1971053270,28,1973617178,2563908
1653171545,200457,true,1971053270,28,1971644645,591375
1653172180,200458,true,1970856185,28,1970856185,0
1653175632,200457,true,1971053270,28,1970659119,-394151
1653175668,200455,true,1971447501,28,1970856185,-591316
1653175802,200455,true,1971447501,28,1970856185,-591316
1653177369,200456,true,1971250376,28,1972433422,1183046
1653177531,200455,true,1971447501,28,1972433422,985921
1653179308,200454,true,1971644645,28,1972433422,788777
1653179853,200454,true,1971644645,28,1972433422,788777
1653180288,200455,true,1971447501,28,1972433422,985921
1653181386,200453,true,1971841810,28,1972433422,591612
1653182319,200452,true,1972038994,28,1973617178,1578184
1653183224,200452,true,1972038994,28,1975196624,3157630
1653184080,200453,true,1971841810,28,1975591683,3749873
1653184092,200452,true,1972038994,28,1975591683,3552689
1653184822,200451,true,1972236198,28,1975591683,3355485
1653185880,200450,true,1972433422,28,1975591683,3158261
1653185884,200452,true,1972038994,28,1975591683,3552689
1653186186,200450,true,1972433422,28,1975591683,3158261
1653186864,200449,true,1972630665,28,1975591683,2961018
1653186992,200448,true,1972827928,28,1975591683,2763755
1653187527,200449,true,1972630665,28,1975591683,2961018
1653187654,200448,true,1972827928,28,1975591683,2763755
1653187896,200446,true,1973222513,28,1975591683,2369170
1653188307,200446,true,1973222513,28,1975591683,2369170
1653189347,200447,true,1973025211,28,1975591683,2566472
1653189514,200445,true,1973419836,28,1975394144,1974308
1653190292,200444,true,1973617178,28,1975394144,1776966
1653192027,200444,true,1973617178,28,1975394144,1776966
1653192887,200445,true,1973419836,28,1975196624,1776788
1653193069,200443,true,1973814539,28,1974999124,1184585
1653193111,200442,true,1974011921,28,1974999124,987203
1653193128,200442,true,1974011921,28,1974999124,987203
1653193494,200444,true,1973617178,28,1974209322,592144
1653193723,200443,true,1973814539,28,1973814539,0
1653193893,200441,true,1974209322,28,1973419836,-789486
1653194116,200441,true,1974209322,28,1973222513,-986809
1653194405,200443,true,1973814539,28,1972630665,-1183874
1653194536,200442,true,1974011921,28,1972433422,-1578499
1653195157,200441,true,1974209322,28,1971644645,-2564677
1653195538,200441,true,1974209322,28,1971644645,-2564677
1653195576,200443,true,1973814539,28,1971644645,-2169894
1653195641,200441,true,1974209322,28,1971644645,-2564677
1653196657,200440,true,1974406743,28,1970462073,-3944670
1653199959,200440,true,1974406743,28,1969674085,-4732658
1653201952,200442,true,1974011921,28,1969280209,-4731712
1653202349,200440,true,1974406743,28,1969280209,-5126534
1653202682,200439,true,1974604184,28,1969280209,-5323975
1653203568,200439,true,1974604184,28,1969280209,-5323975
1653203608,200440,true,1974406743,28,1969280209,-5126534
1653203828,200439,true,1974604184,28,1969280209,-5323975
1653203963,200438,true,1974801644,28,1969280209,-5521435
1653204051,200439,true,1974604184,28,1969280209,-5323975
1653204298,200440,true,1974406743,28,1969280209,-5126534
1653204721,200440,true,1974406743,28,1969280209,-5126534
1653205547,200439,true,1974604184,28,1969280209,-5323975
1653206192,200439,true,1974604184,28,1969280209,-5323975
1653206367,200441,true,1974209322,28,1969280209,-4929113
1653208337,200441,true,1974209322,28,1969280209,-4929113
1653208384,200440,true,1974406743,28,1969477137,-4929606
1653208411,200440,true,1974406743,28,1969477137,-4929606
1653208459,200441,true,1974209322,28,1969477137,-4732185
1653208496,200440,true,1974406743,28,1969477137,-4929606
1653208605,200440,true,1974406743,28,1969674085,-4732658
1653209282,200439,true,1974604184,28,1971644645,-2959539
1653209401,200440,true,1974406743,28,1972038994,-2367749
1653209409,200439,true,1974604184,28,1972038994,-2565190
1653209433,200439,true,1974604184,28,1972236198,-2367986
1653209552,200439,true,1974604184,28,1972630665,-1973519
1653209890,200440,true,1974406743,28,1974011921,-394822
1653210004,200439,true,1974604184,28,1974406743,-197441
1653210013,200439,true,1974604184,28,1974406743,-197441
1653210025,200439,true,1974604184,28,1974406743,-197441
1653210041,200440,true,1974406743,28,1974604184,197441
1653210089,200439,true,1974604184,28,1974801644,197460
1653210632,200439,true,1974604184,28,1976777335,2173151
1653210722,200439,true,1974604184,28,1976975012,2370828
1653210757,200440,true,1974406743,28,1977172710,2765967
1653210776,200440,true,1974406743,28,1977172710,2765967
1653210910,200439,true,1974604184,28,1977765921,3161737
1653210983,200439,true,1974604184,28,1978161494,3557310
1653211360,200439,true,1974604184,28,1980338560,5734376
1653211886,200438,true,1974801644,28,1982914545,8112901
1653211917,200438,true,1974801644,28,1982914545,8112901
1653211929,200437,true,1974999124,28,1982914545,7915421
1653211971,200437,true,1974999124,28,1983311148,8312024
1653211980,200437,true,1974999124,28,1983311148,8312024
1653211993,200436,true,1975196624,28,1983311148,8114524
1653212013,200435,true,1975394144,28,1983509479,8115335
1653212058,200434,true,1975591683,28,1984104591,8512908
1653212093,200433,true,1975789242,28,1984501432,8712190
1653212189,200432,true,1975986821,28,1985692431,9705610
1653212206,200431,true,1976184420,28,1985891000,9706580
1653212546,200429,true,1976579677,28,1991459008,14879331
1653212662,200428,true,1976777335,28,1993451363,16674028
1653212724,200427,true,1976975012,28,1994647733,17672721
1653212990,200426,true,1977172710,28,1998640821,21468111
1653213081,200423,true,1977765921,28,2000040289,22274368
1653213358,200422,true,1977963697,28,2004445001,26481304
1653213382,200420,true,1978359310,28,2004845910,26486600
1653213416,200419,true,1978557146,28,2005246899,26689753
1653213432,200417,true,1978952877,28,2005647969,26695092
1653213525,200415,true,1979348688,28,2007253049,27904361
1653213553,200413,true,1979744577,28,2007855285,28110708
1653213564,200412,true,1979942552,28,2008056070,28113518
1653213679,200408,true,1980734647,28,2010467063,29732416
1653213720,200406,true,1981130814,28,2011472498,30341684
1653213739,200404,true,1981527060,28,2011874813,30347753
1653213747,200403,true,1981725213,28,2012076000,30350787
1653213861,200399,true,1982518022,28,2014088982,31570960
1653214048,200396,true,1983112837,28,2016507218,33394381
1653214289,200394,true,1983509479,28,2018928358,35418879
1653215255,200393,true,1983707830,28,2026006633,42298803
1653215430,200389,true,1984501432,28,2026614496,42113064
1653215508,200386,true,1985096842,28,2026614496,41517654
1653216479,200384,true,1985493881,28,2027019839,41525958
1653217660,200383,true,1985692431,28,2027830769,42138338
1653217751,200379,true,1986486827,28,2028033552,41546725
1653217854,200376,true,1987082832,28,2028033552,40950720
1653217953,200374,true,1987480269,28,2028033552,40553283
1653218853,200373,true,1987679017,28,2028033552,40354535
1653218925,200369,true,1988474208,28,2028033552,39559344
1653218931,200366,true,1989070810,28,2028033552,38962742
1653219019,200365,true,1989269717,28,2028033552,38763835
1653219057,200363,true,1989667591,28,2028033552,38365961
1653219084,200360,true,1990264551,28,2027830769,37566218
1653219097,200357,true,1990861690,28,2027830769,36969079
1653219112,200356,true,1991060776,28,2027830769,36769993
1653219123,200355,true,1991259882,28,2027830769,36570887
1653219168,200352,true,1991857320,28,2027628006,35770686
1653219732,200350,true,1992255711,28,2023374668,31118957
1653219762,200349,true,1992454937,28,2023172350,30717413
1653220703,200348,true,1992654182,28,2016507218,23853036
1653220791,200345,true,1993252038,28,2015902387,22650349
1653220990,200343,true,1993650708,28,2015096228,21445520
1653221913,200341,true,1994049459,28,2016708869,22659410
1653221963,200340,true,1994248864,28,2016910540,22661676
1653222024,200337,true,1994847198,28,2016910540,22063342
1653222028,200335,true,1995246187,28,2016910540,21664353
1653222317,200333,true,1995645257,28,2018120989,22475732
1653223196,200332,true,1995844821,28,2021554541,25709720
1653223314,200329,true,1996443634,28,2021958872,25515238
1653225466,200327,true,1996842943,28,2023577005,26734062
1653225794,200325,true,1997242332,28,2023577005,26334673
1653226099,200323,true,1997641800,28,2023577005,25935205
1653226253,200320,true,1998241153,28,2023577005,25335852
1653227483,200318,true,1998640821,28,2023577005,24936184
1653228720,200315,true,1999240473,28,2022161068,22920595
1653228790,200314,true,1999440397,28,2022161068,22720671
1653229013,200311,true,2000040289,28,2021756696,21716407
1653229221,200309,true,2000440317,28,2021352405,20912088
1653229621,200307,true,2000840425,28,2020746121,19905696
1653230386,200305,true,2001240613,28,2019938024,18697411
1653231153,200302,true,2001841046,28,2019534097,17693051
1653231429,200300,true,2002241434,28,2019534097,17292663
1653231526,200298,true,2002641902,28,2019534097,16892195
1653231826,200296,true,2003042451,28,2019332164,16289713
1653232394,200293,true,2003643423,28,2018524633,14881210
1653232482,200292,true,2003843788,28,2018322801,14479013
1653232615,200289,true,2004445001,28,2017919197,13474196
1653232707,200288,true,2004645445,28,2017515674,12870229
1653232809,200286,true,2005046395,28,2016507218,11460823
1653232972,200285,true,2005246899,28,2014693269,9446370
1653233008,200283,true,2005647969,28,2014290391,8642422
1653233025,200282,true,2005848533,28,2014088982,8240449
1653233819,200281,true,2006049118,28,2003643423,-2405695
1653234531,200280,true,2006249723,28,1995844821,-10404902
1653235495,200278,true,2006650993,28,1998640821,-8010172
1653235985,200277,true,2006851658,28,2000440317,-6411341
1653235989,200276,true,2007052344,28,2000440317,-6612027
1653236006,200274,true,2007453774,28,2000440317,-7013457
1653236034,200272,true,2007855285,28,2000440317,-7414968
1653236119,200272,true,2007855285,28,2000640361,-7214924
1653236450,200271,true,2008056070,28,2000440317,-7615753
1653237070,200270,true,2008256876,28,1998440977,-9815899
1653237276,200268,true,2008658547,28,1998241153,-10417394
1653238452,200268,true,2008658547,28,1998840685,-9817862
1653238465,200267,true,2008859413,28,1998840685,-10018728
1653238521,200265,true,2009261205,28,1999040569,-10220636
1653239120,200263,true,2009663078,28,2001640882,-8022196
1653239293,200262,true,2009864044,28,2002641902,-7222142
1653240267,200261,true,2010065030,28,2009261205,-803825
1653241241,200259,true,2010467063,28,2015297737,4830674
1653241278,200256,true,2011070264,28,2015297737,4227473
1653241308,200255,true,2011271371,28,2015499267,4227896
1653241528,200253,true,2011673645,28,2015902387,4228742
1653241809,200252,true,2011874813,28,2016103977,4229164
1653241863,200250,true,2012277208,28,2016103977,3826769
1653241961,200249,true,2012478435,28,2016103977,3625542
1653241998,200247,true,2012880951,28,2016103977,3223026
1653242453,200247,true,2012880951,28,2014290391,1409440
1653242475,200245,true,2013283548,28,2014290391,1006843
1653243536,200245,true,2013283548,28,2008859413,-4424135
1653243830,200243,true,2013686224,28,2008056070,-5630154
1653244417,200243,true,2013686224,28,2006851658,-6834566
1653245213,200241,true,2014088982,28,2007253049,-6835933
1653245736,200241,true,2014088982,28,2007654519,-6434463
1653245999,200239,true,2014491820,28,2007855285,-6636535
1653246135,200239,true,2014491820,28,2008056070,-6435750
1653246186,200237,true,2014894738,28,2008056070,-6838668
1653246301,200238,true,2014693269,28,2008256876,-6436393
1653246475,200237,true,2014894738,28,2008256876,-6637862
1653247059,200237,true,2014894738,28,2008658547,-6236191
1653247714,200236,true,2015096228,28,2009060299,-6035929
1653248559,200236,true,2015096228,28,2009060299,-6035929
1653251486,200237,true,2014894738,28,2009060299,-5834439
1653255623,200237,true,2014894738,28,2009462131,-5432607
1653255869,200236,true,2015096228,28,2009462131,-5634097
1653256488,200237,true,2014894738,28,2009663078,-5231660
1653256614,200237,true,2014894738,28,2009663078,-5231660
1653256799,200238,true,2014693269,28,2009864044,-4829225
1653256834,200237,true,2014894738,28,2010065030,-4829708
1653256881,200237,true,2014894738,28,2010266037,-4628701
1653256963,200237,true,2014894738,28,2010668110,-4226628
1653256977,200238,true,2014693269,28,2010668110,-4025159
1653256985,200236,true,2015096228,28,2010869177,-4227051
1653256993,200236,true,2015096228,28,2010869177,-4227051
1653257654,200237,true,2014894738,28,2016507218,1612480
1653257663,200237,true,2014894738,28,2016507218,1612480
1653257718,200236,true,2015096228,28,2017112231,2016003
1653258088,200236,true,2015096228,28,2020544066,5447838
1653258130,200236,true,2015096228,28,2021150290,6054062
1653258156,200237,true,2014894738,28,2021554541,6659803
1653258388,200235,true,2015297737,28,2026209234,10911497
1653258404,200233,true,2015700817,28,2026411855,10711038
1653258480,200233,true,2015700817,28,2027830769,12129952
1653259057,200234,true,2015499267,28,2034736782,19237515
1653259416,200232,true,2015902387,28,2037994804,22092417
1653260210,200231,true,2016103977,28,2041462168,25358191
1653260257,200231,true,2016103977,28,2041258042,25154065
1653260941,200232,true,2015902387,28,2039829733,23927346
1653260959,200230,true,2016305588,28,2039829733,23524145
1653260960,200229,true,2016507218,28,2039829733,23322515
1653261967,200229,true,2016507218,28,2038810124,22302906
1653262012,200230,true,2016305588,28,2038810124,22504536
1653262019,200228,true,2016708869,28,2039014005,22305136
1653262047,200227,true,2016910540,28,2039014005,22103465
1653263901,200225,true,2017313942,28,2049234093,31920151
1653263905,200226,true,2017112231,28,2049234093,32121862
1653263936,200224,true,2017515674,28,2049234093,31718419
1653263967,200222,true,2017919197,28,2049234093,31314896
1653264034,200220,true,2018322801,28,2049029190,30706389
1653264095,200221,true,2018120989,28,2048824307,30703318
1653264131,200219,true,2018524633,28,2048824307,30299674
1653264506,200218,true,2018726486,28,2046981287,28254801
1653265093,200216,true,2019130251,28,2044730958,25600707
1653265130,200216,true,2019130251,28,2044730958,25600707
1653265167,200214,true,2019534097,28,2044730958,25196861
1653265434,200213,true,2019736051,28,2044526505,24790454
1653265442,200210,true,2020342032,28,2044526505,24184473
1653265503,200211,true,2020140018,28,2044526505,24386487
1653265569,200210,true,2020342032,28,2044322073,23980041
1653265685,200209,true,2020544066,28,2043913270,23369204
1653265794,200207,true,2020948195,28,2043708899,22760704
1653265959,200207,true,2020948195,28,2043708899,22760704
1653266004,200206,true,2021150290,28,2043708899,22558609
1653266017,200206,true,2021150290,28,2043708899,22558609
1653267942,200203,true,2021756696,28,2041666314,19909618
1653271470,200205,true,2021352405,28,2032906434,11554029
1653271513,200204,true,2021554541,28,2032906434,11351893
1653271693,200203,true,2021756696,28,2032703164,10946468
1653271963,200202,true,2021958872,28,2032499914,10541042
1653271986,200203,true,2021756696,28,2032296684,10539988
1653271994,200202,true,2021958872,28,2032296684,10337812
1653272023,200201,true,2022161068,28,2032296684,10135616
1653272078,200200,true,2022363284,28,2032093475,9730191
1653273027,200202,true,2021958872,28,2028642023,6683151
1653273189,200201,true,2022161068,28,2027830769,5669701
1653273309,200200,true,2022363284,28,2027425264,5061980
1653273336,200198,true,2022767777,28,2027425264,4657487
1653273512,200201,true,2022161068,28,2026817158,4656090
1653275361,200199,true,2022565520,28,2025398953,2833433
1653275507,200198,true,2022767777,28,2025601493,2833716
1653276363,200196,true,2023172350,28,2026006633,2834283
1653277059,200197,true,2022970053,28,2026411855,3441802
1653278831,200195,true,2023374668,28,2026411855,3037187
1653278982,200194,true,2023577005,28,2026411855,2834850
1653279046,200190,true,2024386557,28,2026614496,2227939
1653279080,200192,true,2023981741,28,2026614496,2632755
1653279082,200190,true,2024386557,28,2026614496,2227939
1653279122,200189,true,2024588996,28,2026614496,2025500
1653279582,200185,true,2025398953,28,2027222541,1823588
1653279658,200187,true,2024993934,28,2027222541,2228607
1653279691,200185,true,2025398953,28,2027425264,2026311
1653281588,200183,true,2025804053,28,2030265505,4461452
1653282560,200179,true,2026614496,28,2030265505,3651009
1653284956,200181,true,2026209234,28,2030265505,4056271
1653285006,200179,true,2026614496,28,2030468531,3854035
1653285043,200177,true,2027019839,28,2030468531,3448692
1653285076,200173,true,2027830769,28,2030468531,2637762
1653285098,200175,true,2027425264,28,2030468531,3043267
1653285150,200174,true,2027628006,28,2030671578,3043572
1653285262,200172,true,2028033552,28,2030874645,2841093
1653285306,200169,true,2028642023,28,2030874645,2232622
1653285468,200171,true,2028236355,28,2031280840,3044485
1653285475,200170,true,2028439179,28,2031280840,2841661
1653285525,200169,true,2028642023,28,2031483969,2841946
1653285540,200166,true,2029250676,28,2031483969,2233293
1653285571,200167,true,2029047772,28,2031687117,2639345
1653285915,200166,true,2029250676,28,2033109725,3859049
1653286001,200164,true,2029656547,28,2033516367,3859820
1653286135,200161,true,2030265505,28,2034126483,3860978
1653286182,200163,true,2029859512,28,2034329896,4470384
1653286186,200161,true,2030265505,28,2034329896,4064391
1653286406,200159,true,2030671578,28,2035754354,5082776
1653286448,200156,true,2031280840,28,2035957929,4677089
1653286756,200157,true,2031077733,28,2037791024,6713291
1653286814,200155,true,2031483969,28,2038198603,6714634
1653286903,200153,true,2031890286,28,2038606263,6715977
1653286953,200150,true,2032499914,28,2038810124,6310210
1653286996,200151,true,2032296684,28,2039014005,6717321
1653287122,200149,true,2032703164,28,2039625770,6922606
1653287203,200147,true,2033109725,28,2040033716,6923991
1653287629,200144,true,2033719719,28,2041462168,7742449
1653287645,200145,true,2033516367,28,2041462168,7945801
1653287652,200143,true,2033923091,28,2041462168,7539077
1653287768,200141,true,2034329896,28,2041870481,7540585
1653287891,200137,true,2035143750,28,2042278875,7135125
1653288083,200138,true,2034940256,28,2042891620,7951364
1653288086,200137,true,2035143750,28,2042891620,7747870
1653288088,200134,true,2035754354,28,2042891620,7137266
1653288123,200131,true,2036365141,28,2043095909,6730768
1653288131,200132,true,2036161525,28,2043095909,6934384
1653288182,200129,true,2036772434,28,2043504549,6732115
1653289366,200127,true,2037179809,28,2050463941,13284132
1653289559,200124,true,2037791024,28,2051489378,13698354
1653290425,200125,true,2037587266,28,2052720579,15133313
1653290478,200124,true,2037791024,28,2052925851,15134827
1653290482,200121,true,2038402423,28,2052925851,14523428
1653290632,200119,true,2038810124,28,2053131144,14321020
1653290804,200119,true,2038810124,28,2054363330,15553206
1653290869,200117,true,2039217906,28,2054979701,15761795
1653290914,200115,true,2039625770,28,2055185199,15559429
1653290969,200112,true,2040237719,28,2056007396,15769677
1653291008,200112,true,2040237719,28,2056624260,16386541
1653291017,200110,true,2040645787,28,2056624260,15978473
1653291089,200109,true,2040849852,28,2057652778,16802926
1653291110,200107,true,2041258042,28,2057858543,16600501
1653291351,200106,true,2041462168,28,2060741419,19279251
1653291818,200104,true,2041870481,28,2066519291,24648810
1653291881,200103,true,2042074668,28,2067346023,25271355
1653291914,200101,true,2042483103,28,2067759513,25276410
1653292378,200100,true,2042687351,28,2072520595,29833244
1653293025,200099,true,2042891620,28,2072520595,29628975
1653293641,200098,true,2043095909,28,2070863324,27767415
1653293653,200095,true,2043708899,28,2070863324,27154425
1653293702,200095,true,2043708899,28,2070656258,26947359
1653293724,200093,true,2044117661,28,2070656258,26538597
1653293757,200093,true,2044117661,28,2070656258,26538597
1653293784,200092,true,2044322073,28,2070449213,26127140
1653293803,200092,true,2044322073,28,2070449213,26127140
1653293988,200091,true,2044526505,28,2069621241,25094736
1653294413,200090,true,2044730958,28,2067759513,23028555
1653294555,200089,true,2044935431,28,2067139309,22203878
1653294838,200089,true,2044935431,28,2066106049,21170618
1653294908,200088,true,2045139925,28,2065899459,20759534
1653294920,200087,true,2045344439,28,2065692890,20348451
1653294990,200085,true,2045753528,28,2065486341,19732813
1653295202,200085,true,2045753528,28,2064041079,18287551
1653295295,200084,true,2045958103,28,2063628333,17670230
1653295348,200084,true,2045958103,28,2063215669,17257566
1653295429,200083,true,2046162699,28,2062803088,16640389
1653295647,200084,true,2045958103,28,2061771996,15813893
1653295665,200083,true,2046162699,28,2061565839,15403140
1653298567,200082,true,2046367316,28,2056418618,10051302
1653298622,200081,true,2046571952,28,2056624260,10052308
1653298641,200081,true,2046571952,28,2056624260,10052308
1653298672,200080,true,2046776609,28,2056624260,9847651
1653299485,200079,true,2046981287,28,2058681810,11700523
1653299522,200078,true,2047185985,28,2058887678,11701693
1653299590,200077,true,2047390704,28,2059093567,11702863
1653299600,200076,true,2047595443,28,2059093567,11498124
1653300228,200074,true,2048004982,28,2061359703,13354721
1653300717,200072,true,2048414604,28,2062596828,14182224
1653300781,200071,true,2048619445,28,2062803088,14183643
1653300829,200070,true,2048824307,28,2063009368,14185061
1653300885,200068,true,2049234093,28,2063215669,13981576
1653300909,200066,true,2049643960,28,2063215669,13571709
1653301027,200064,true,2050053909,28,2063834696,13780787
1653301433,200062,true,2050463941,28,2065899459,15435518
1653302040,200060,true,2050874054,28,2068173085,17299031
1653302193,200058,true,2051284249,28,2068793599,17509350
1653302998,200056,true,2051694527,28,2071070410,19375883
1653303122,200055,true,2051899696,28,2071070410,19170714
1653303937,200052,true,2052515327,28,2071484645,18969318
1653303993,200050,true,2052925851,28,2071484645,18558794
1653304239,200048,true,2053336457,28,2071484645,18148188
1653304281,200047,true,2053541790,28,2071484645,17942855
1653304312,200044,true,2054157915,28,2071484645,17326730
1653304313,200042,true,2054568767,28,2071484645,16915878
1653304316,200040,true,2054979701,28,2071484645,16504944
1653304323,200039,true,2055185199,28,2071484645,16299446
1653304348,200036,true,2055801816,28,2071691794,15889978
1653304349,200034,true,2056212997,28,2071691794,15478797
1653304560,200032,true,2056624260,28,2072313363,15689103
1653304627,200030,true,2057035606,28,2072520595,15484989
1653305771,200028,true,2057447033,28,2076046700,18599667
1653305803,200026,true,2057858543,28,2076254304,18395761
1653305817,200023,true,2058475963,28,2076254304,17778341
1653305856,200022,true,2058681810,28,2076254304,17572494
1653305875,200020,true,2059093567,28,2076254304,17160737
1653306546,200018,true,2059505406,28,2075631553,16126147
1653306659,200016,true,2059917328,28,2075424010,15506682
1653307467,200015,true,2060123320,28,2072106153,11982833
1653307514,200014,true,2060329332,28,2071898963,11569631
1653307572,200012,true,2060741419,28,2071484645,10743226
1653307602,200010,true,2061153588,28,2071484645,10331057
1653308103,200009,true,2061359703,28,2070863324,9503621
1653308138,200007,true,2061771996,28,2070863324,9091328
1653308192,200006,true,2061978173,28,2070863324,8885151
1653308270,200004,true,2062390589,28,2071070410,8679821
1653308286,200003,true,2062596828,28,2071070410,8473582
1653308718,200000,true,2063215669,28,2073142413,9926744
1653308730,199999,true,2063421991,28,2073142413,9720422
1653308828,199997,true,2063834696,28,2073557062,9722366
1653309037,199996,true,2064041079,28,2074386609,10345530
1653309148,199994,true,2064453908,28,2074594048,10140140
1653309200,199993,true,2064660353,28,2074594048,9933695
1653309226,199991,true,2065073306,28,2074801507,9728201
1653309282,199990,true,2065279813,28,2074801507,9521694
1653309461,199989,true,2065486341,28,2075008988,9522647
1653309554,199987,true,2065899459,28,2075008988,9109529
1653309624,199986,true,2066106049,28,2075008988,8902939
1653310011,199985,true,2066312660,28,2074801507,8488847
1653310589,199984,true,2066519291,28,2071898963,5379672
1653310600,199983,true,2066725943,28,2071898963,5173020
1653310715,199981,true,2067139309,28,2071484645,4345336
1653310840,199980,true,2067346023,28,2070863324,3517301
1653310857,199979,true,2067552757,28,2070863324,3310567
1653310860,199978,true,2067759513,28,2070863324,3103811
1653311029,199977,true,2067966289,28,2069621241,1654952
1653311564,199977,true,2067966289,28,2066725943,-1240346
1653311645,199977,true,2067966289,28,2066519291,-1446998
1653311702,199976,true,2068173085,28,2066312660,-1860425
1653311877,199975,true,2068379903,28,2065692890,-2687013
1653311968,199975,true,2068379903,28,2065486341,-2893562
1653312069,199974,true,2068586741,28,2065279813,-3306928
1653312099,199973,true,2068793599,28,2065279813,-3513786
1653312140,199972,true,2069000479,28,2065279813,-3720666
1653312264,199973,true,2068793599,28,2065073306,-3720293
1653312522,199972,true,2069000479,28,2064660353,-4340126
1653312727,199971,true,2069207379,28,2064866819,-4340560
1653312749,199971,true,2069207379,28,2064866819,-4340560
1653313158,199972,true,2069000479,28,2064866819,-4133660
1653313172,199972,true,2069000479,28,2064866819,-4133660
1653313225,199972,true,2069000479,28,2064660353,-4340126
1653313272,199973,true,2068793599,28,2064247483,-4546116
1653313292,199976,true,2068173085,28,2064041079,-4132006
1653313306,199976,true,2068173085,28,2064041079,-4132006
1653313308,199977,true,2067966289,28,2064041079,-3925210
1653313317,199978,true,2067759513,28,2064041079,-3718434
1653313376,199980,true,2067346023,28,2063628333,-3717690
1653313393,199980,true,2067346023,28,2063628333,-3717690
1653313399,199980,true,2067346023,28,2063628333,-3717690
1653313457,199981,true,2067139309,28,2063421991,-3717318
1653313601,199982,true,2066932616,28,2063009368,-3923248
1653313618,199982,true,2066932616,28,2063009368,-3923248
1653313658,199982,true,2066932616,28,2063009368,-3923248
1653313672,199982,true,2066932616,28,2063009368,-3923248
1653313697,199983,true,2066725943,28,2063009368,-3716575
1653313744,199982,true,2066932616,28,2063009368,-3923248
1653314202,199982,true,2066932616,28,2063421991,-3510625
1653314223,199982,true,2066932616,28,2063421991,-3510625
1653314314,199982,true,2066932616,28,2063421991,-3510625
1653314370,199981,true,2067139309,28,2063215669,-3923640
1653314397,199982,true,2066932616,28,2063215669,-3716947
1653314419,199982,true,2066932616,28,2063215669,-3716947
1653314431,199982,true,2066932616,28,2063009368,-3923248
1653314456,199982,true,2066932616,28,2063009368,-3923248
1653314560,199983,true,2066725943,28,2062390589,-4335354
1653314565,199983,true,2066725943,28,2062184371,-4541572
1653314581,199983,true,2066725943,28,2062184371,-4541572
1653314891,199983,true,2066725943,28,2059917328,-6808615
1653314938,199985,true,2066312660,28,2059505406,-6807254
1653314957,199984,true,2066519291,28,2059299477,-7219814
1653315358,199986,true,2066106049,28,2056418618,-9687431
1653315461,199986,true,2066106049,28,2055390717,-10715332
1653315541,199987,true,2065899459,28,2054568767,-11330692
1653315614,199987,true,2065899459,28,2053541790,-12357669
1653315756,199987,true,2065899459,28,2051899696,-13999763
1653316266,199988,true,2065692890,28,2046981287,-18711603
1653316303,199989,true,2065486341,28,2046776609,-18709732
1653316326,199989,true,2065486341,28,2046776609,-18709732
1653316340,199990,true,2065279813,28,2046776609,-18503204
1653316355,199990,true,2065279813,28,2046776609,-18503204
1653316386,199991,true,2065073306,28,2046776609,-18296697
1653316397,199991,true,2065073306,28,2046981287,-18092019
1653316729,199991,true,2065073306,28,2048619445,-16453861
1653316935,199991,true,2065073306,28,2050258915,-14814391
1653317327,199993,true,2064660353,28,2053336457,-11323896
1653317692,199992,true,2064866819,28,2055185199,-9681620
1653317919,199993,true,2064660353,28,2056418618,-8241735
1653318006,199994,true,2064453908,28,2056829923,-7623985
1653318220,199995,true,2064247483,28,2057447033,-6800450
1653318265,199995,true,2064247483,28,2057652778,-6594705
1653318298,199995,true,2064247483,28,2057652778,-6594705
1653318348,199996,true,2064041079,28,2057652778,-6388301
1653318376,199997,true,2063834696,28,2057652778,-6181918
1653318594,199997,true,2063834696,28,2058064329,-5770367
1653318870,199997,true,2063834696,28,2058681810,-5152886
1653318922,199998,true,2063628333,28,2058681810,-4946523
1653318973,199999,true,2063421991,28,2058887678,-4534313
1653319354,199998,true,2063628333,28,2060535365,-3092968
1653319600,199999,true,2063421991,28,2061565839,-1856152
1653320023,200000,true,2063215669,28,2063421991,206322
1653320322,200001,true,2063009368,28,2064660353,1650985
1653320400,200000,true,2063215669,28,2064866819,1651150
1653320929,200000,true,2063215669,28,2066106049,2890380
1653321664,200001,true,2063009368,28,2066725943,3716575
1653321977,200002,true,2062803088,28,2066932616,4129528
1653322113,200002,true,2062803088,28,2066932616,4129528
1653322145,200002,true,2062803088,28,2067139309,4336221
1653322173,200003,true,2062596828,28,2067139309,4542481
1653323068,200003,true,2062596828,28,2068586741,5989913
1653323590,200002,true,2062803088,28,2069621241,6818153
1653323614,200002,true,2062803088,28,2069621241,6818153
1653323658,200003,true,2062596828,28,2069621241,7024413
1653323731,200003,true,2062596828,28,2069828203,7231375
1653324338,200003,true,2062596828,28,2069207379,6610551
1653324447,200003,true,2062596828,28,2069000479,6403651
1653324600,200004,true,2062390589,28,2068586741,6196152
1653324696,200004,true,2062390589,28,2068379903,5989314
1653324708,200004,true,2062390589,28,2068379903,5989314
1653324759,200004,true,2062390589,28,2068173085,5782496
1653324795,200006,true,2061978173,28,2067966289,5988116
1653324850,200007,true,2061771996,28,2067759513,5987517
1653324945,200007,true,2061771996,28,2067139309,5367313
1653324954,200007,true,2061771996,28,2067139309,5367313
1653324959,200009,true,2061359703,28,2067139309,5779606
1653325289,200010,true,2061153588,28,2064660353,3506765
1653325440,200010,true,2061153588,28,2063628333,2474745
1653325444,200010,true,2061153588,28,2063628333,2474745
1653325498,200011,true,2060947493,28,2063215669,2268176
1653325559,200013,true,2060535365,28,2062596828,2061463
1653325677,200013,true,2060535365,28,2061565839,1030474
1653326079,200014,true,2060329332,28,2058270136,-2059196
1653326262,200015,true,2060123320,28,2056418618,-3704702
1653327770,200017,true,2059711357,28,2047185985,-12525372
1653328068,200017,true,2059711357,28,2046367316,-13344041
1653328183,200018,true,2059505406,28,2046571952,-12933454
1653329402,200018,true,2059505406,28,2048004982,-11500424
1653329472,200020,true,2059093567,28,2048004982,-11088585
1653331992,200020,true,2059093567,28,2049848924,-9244643
1653332007,200020,true,2059093567,28,2049848924,-9244643
1653332156,200020,true,2059093567,28,2049234093,-9859474
1653332190,200022,true,2058681810,28,2049234093,-9447717
1653332312,200023,true,2058475963,28,2048619445,-9856518
1653332314,200024,true,2058270136,28,2048619445,-9650691
1653332397,200025,true,2058064329,28,2047800202,-10264127
1653332477,200028,true,2057447033,28,2046981287,-10465746
1653332622,200030,true,2057035606,28,2045344439,-11691167
1653332640,200030,true,2057035606,28,2045139925,-11895681
1653332664,200032,true,2056624260,28,2044730958,-11893302
1653333149,200035,true,2056007396,28,2037994804,-18012592
1653333195,200037,true,2055596257,28,2037179809,-18416448
1653333317,200037,true,2055596257,28,2035143750,-20452507
1653333337,200039,true,2055185199,28,2034736782,-20448417
1653333352,200042,true,2054568767,28,2034533329,-20035438
1653333383,200045,true,2053952519,28,2033923091,-20029428
1653333390,200044,true,2054157915,28,2033719719,-20438196
1653333409,200046,true,2053747145,28,2033313036,-20434109
1653333804,200050,true,2052925851,28,2022767777,-30158074
1653333824,200053,true,2052310096,28,2022161068,-30149028
1653333966,200053,true,2052310096,28,2018726486,-33583610
1653333988,200055,true,2051899696,28,2018120989,-33778707
1653333998,200060,true,2050874054,28,2017919197,-32954857
1653334000,200063,true,2050258915,28,2017919197,-32339718
1653334025,200064,true,2050053909,28,2017112231,-32941678
1653334532,200066,true,2049643960,28,2006851658,-42792302
1653334940,200072,true,2048414604,28,1999840305,-48574299
1653334992,200075,true,2047800202,28,1999040569,-48759633
1653335022,200076,true,2047595443,28,1998640821,-48954622
1653335108,200079,true,2046981287,28,1997242332,-49738955
1653335197,200085,true,2045753528,28,1996044406,-49709122
1653335590,200089,true,2044935431,28,1993252038,-51683393
1653335660,200090,true,2044730958,28,1992853448,-51877510
1653335853,200093,true,2044117661,28,1991658154,-52459507
1653335949,200099,true,2042891620,28,1991259882,-51631738
1653335959,200103,true,2042074668,28,1991060776,-51013892
1653335961,200104,true,2041870481,28,1991060776,-50809705
1653336004,200107,true,2041258042,28,1990861690,-50396352
1653336109,200112,true,2040237719,28,1990065544,-50172175
1653336141,200116,true,2039421828,28,1989866557,-49555271
1653336515,200117,true,2039217906,28,1987877785,-51340121
1653336969,200118,true,2039014005,28,1986288198,-52725807
1653337089,200124,true,2037791024,28,1986089589,-51701435
1653337113,200127,true,2037179809,28,1986089589,-51090220
1653337153,200127,true,2037179809,28,1986089589,-51090220
1653337189,200128,true,2036976112,28,1986288198,-50687914
1653337199,200133,true,2035957929,28,1986288198,-49669731
1653337361,200136,true,2035347264,28,1986486827,-48860437
1653338625,200137,true,2035143750,28,1991259882,-43883868
1653338638,200138,true,2034940256,28,1991259882,-43680374
1653338719,200143,true,2033923091,28,1991459008,-42464083
1653338885,200146,true,2033313036,28,1992056505,-41256531
1653338894,200146,true,2033313036,28,1992056505,-41256531
1653338926,200148,true,2032906434,28,1992255711,-40650723
1653339310,200153,true,2031890286,28,1993052733,-38837553
1653340030,200156,true,2031280840,28,1994448288,-36832552
1653341549,200157,true,2031077733,28,1995645257,-35432476
1653341722,200159,true,2030671578,28,1995645257,-35026321
1653342050,200164,true,2029656547,28,1995844821,-33811726
1653343198,200167,true,2029047772,28,1995844821,-33202951
1653343277,200168,true,2028844887,28,1995645257,-33199630
1653343328,200170,true,2028439179,28,1995445712,-32993467
1653343335,200175,true,2027425264,28,1995445712,-31979552
1653343351,200180,true,2026411855,28,1995246187,-31165668
1653343375,200180,true,2026411855,28,1995246187,-31165668
1653343396,200182,true,2026006633,28,1995046683,-30959950
1653343405,200188,true,2024791455,28,1995046683,-29744772
1653343494,200193,true,2023779363,28,1994448288,-29331075
1653343532,200194,true,2023577005,28,1994248864,-29328141
1653343541,200196,true,2023172350,28,1994248864,-28923486
1653343778,200201,true,2022161068,28,1992454937,-29706131
1653344558,200207,true,2020948195,28,1986685476,-34262719
1653344653,200208,true,2020746121,28,1985692431,-35053690
1653344688,200210,true,2020342032,28,1985295352,-35046680
1653344772,200216,true,2019130251,28,1984303002,-34827249
1653344831,200223,true,2017717425,28,1983509479,-34207946
1653345144,200225,true,2017313942,28,1980140546,-37173396
1653345158,200227,true,2016910540,28,1979942552,-36967988
1653345230,200233,true,2015700817,28,1979348688,-36352129
1653345319,200240,true,2014290391,28,1978161494,-36128897
1653345418,200243,true,2013686224,28,1977172710,-36513514
1653345442,200245,true,2013283548,28,1976975012,-36308536
1653345500,200252,true,2011874813,28,1976184420,-35690393
1653345532,200259,true,2010467063,28,1975986821,-34480242
1653345539,200262,true,2009864044,28,1975986821,-33877223
1653345542,200264,true,2009462131,28,1975789242,-33672889
1653345549,200270,true,2008256876,28,1975789242,-32467634
1653345586,200277,true,2006851658,28,1975591683,-31259975
1653345984,200279,true,2006450348,28,1972433422,-34016926
1653346011,200281,true,2006049118,28,1972236198,-33812920
1653346182,200288,true,2004645445,28,1970856185,-33789260
1653346479,200294,true,2003443079,28,1969083301,-34359778
1653346488,200296,true,2003042451,28,1969083301,-33959150
1653346528,200298,true,2002641902,28,1969083301,-33558601
1653346579,200304,true,2001440737,28,1968886412,-32554325
1653346586,200310,true,2000240293,28,1968886412,-31353881
1653346868,200312,true,1999840305,28,1968689543,-31150762
1653347098,200314,true,1999440397,28,1969083301,-30357096
1653347787,200319,true,1998440977,28,1971053270,-27387707
1653347847,200325,true,1997242332,28,1971250376,-25991956
1653347885,200327,true,1996842943,28,1971250376,-25592567
1653347896,200329,true,1996443634,28,1971250376,-25193258
1653347923,200335,true,1995246187,28,1971250376,-23995811
1653348274,200341,true,1994049459,28,1970265046,-23784413
1653348850,200342,true,1993850074,28,1968689543,-25160531
1653348925,200344,true,1993451363,28,1968689543,-24761820
1653350503,200349,true,1992454937,28,1968886412,-23568525
1653350760,200355,true,1991259882,28,1969280209,-21979673
1653350800,200356,true,1991060776,28,1969280209,-21780567
1653350849,200358,true,1990662623,28,1969477137,-21185486
1653351091,200362,true,1989866557,28,1970265046,-19601511
1653351362,200368,true,1988673055,28,1971053270,-17619785
1653351395,200370,true,1988275380,28,1971053270,-17222110
1653351476,200371,true,1988076573,28,1971447501,-16629072
1653351487,200375,true,1987281541,28,1971447501,-15834040
1653351997,200379,true,1986486827,28,1974406743,-12080084
1653352042,200381,true,1986089589,28,1974604184,-11485405
1653352571,200382,true,1985891000,28,1977370427,-8520573
1653352617,200386,true,1985096842,28,1977568164,-7528678
1653352771,200389,true,1984501432,28,1977963697,-6537735
1653352857,200390,true,1984303002,28,1978359310,-5943692
1653353854,200391,true,1984104591,28,1980140546,-3964045
1653354293,200394,true,1983509479,28,1980734647,-2774832
1653354681,200396,true,1983112837,28,1980734647,-2378190
1653355289,200398,true,1982716274,28,1980734647,-1981627
1653355910,200398,true,1982716274,28,1980536594,-2179680
1653357400,200401,true,1982121578,28,1979744577,-2377001
1653357986,200403,true,1981725213,28,1979942552,-1782661
1653359220,200404,true,1981527060,28,1981328927,-198133
1653359533,200404,true,1981527060,28,1981527060,0
1653359912,200405,true,1981328927,28,1981725213,396286
1653360677,200407,true,1980932721,28,1981725213,792492
1653360864,200407,true,1980932721,28,1981725213,792492
1653361312,200407,true,1980932721,28,1981725213,792492
1653361734,200407,true,1980932721,28,1981725213,792492
1653361788,200410,true,1980338560,28,1981725213,1386653
1653361859,200410,true,1980338560,28,1981725213,1386653
1653362065,200409,true,1980536594,28,1981725213,1188619
1653362143,200410,true,1980338560,28,1981923385,1584825
1653364000,200412,true,1979942552,28,1982121578,2179026
1653364393,200412,true,1979942552,28,1982319790,2377238
1653367268,200411,true,1980140546,28,1982319790,2179244
1653367315,200411,true,1980140546,28,1982518022,2377476
1653368203,200413,true,1979744577,28,1984501432,4756855
1653370115,200413,true,1979744577,28,1986288198,6543621
1653370366,200412,true,1979942552,28,1986288198,6345646
1653370459,200412,true,1979942552,28,1986288198,6345646
1653370932,200413,true,1979744577,28,1986288198,6543621
1653370948,200413,true,1979744577,28,1986288198,6543621
1653370994,200411,true,1980140546,28,1986288198,6147652
1653371174,200411,true,1980140546,28,1986288198,6147652
1653371176,200412,true,1979942552,28,1986288198,6345646
1653371198,200413,true,1979744577,28,1986089589,6345012
1653371558,200412,true,1979942552,28,1985692431,5749879
1653371728,200411,true,1980140546,28,1985493881,5353335
1653372778,200413,true,1979744577,28,1984104591,4360014
1653372811,200413,true,1979744577,28,1984104591,4360014
1653373114,200413,true,1979744577,28,1983906201,4161624
1653373777,200412,true,1979942552,28,1983707830,3765278
1653374265,200414,true,1979546622,28,1983707830,4161208
1653374286,200415,true,1979348688,28,1983707830,4359142
1653374416,200414,true,1979546622,28,1983509479,3962857
1653374669,200414,true,1979546622,28,1983311148,3764526
1653374672,200416,true,1979150772,28,1983311148,4160376
1653374701,200417,true,1978952877,28,1983311148,4358271
1653374739,200416,true,1979150772,28,1983311148,4160376
1653374765,200416,true,1979150772,28,1983311148,4160376
1653374823,200418,true,1978755002,28,1983112837,4357835
1653375036,200420,true,1978359310,28,1982518022,4158712
1653375221,200419,true,1978557146,28,1981923385,3366239
1653375874,200419,true,1978557146,28,1979942552,1385406
1653376001,200422,true,1977963697,28,1979546622,1582925
1653376109,200423,true,1977765921,28,1979150772,1384851
1653376199,200422,true,1977963697,28,1978952877,989180
1653376590,200422,true,1977963697,28,1978161494,197797
1653376736,200424,true,1977568164,28,1977963697,395533
1653377464,200425,true,1977370427,28,1977963697,593270
1653377498,200424,true,1977568164,28,1978161494,593330
1653377561,200424,true,1977568164,28,1978161494,593330
1653377600,200425,true,1977370427,28,1978161494,791067
1653377682,200426,true,1977172710,28,1978161494,988784
1653377792,200425,true,1977370427,28,1978161494,791067
1653377923,200425,true,1977370427,28,1978161494,791067
1653378016,200426,true,1977172710,28,1978161494,988784
1653378057,200426,true,1977172710,28,1978161494,988784
1653378496,200426,true,1977172710,28,1978359310,1186600
1653378623,200425,true,1977370427,28,1978359310,988883
1653378859,200425,true,1977370427,28,1978557146,1186719
1653379105,200425,true,1977370427,28,1978557146,1186719
1653379267,200425,true,1977370427,28,1978557146,1186719
1653379286,200424,true,1977568164,28,1978557146,988982
1653379526,200424,true,1977568164,28,1978557146,988982
1653379802,200423,true,1977765921,28,1978557146,791225
1653379926,200422,true,1977963697,28,1978557146,593449
1653380321,200422,true,1977963697,28,1978557146,593449
1653380715,200421,true,1978161494,28,1978557146,395652
1653380936,200420,true,1978359310,28,1978557146,197836
1653381145,200420,true,1978359310,28,1978557146,197836
1653381205,200419,true,1978557146,28,1978557146,0
1653381350,200419,true,1978557146,28,1978557146,0
1653381656,200419,true,1978557146,28,1978557146,0
1653381709,200418,true,1978755002,28,1978557146,-197856
1653381836,200418,true,1978755002,28,1978557146,-197856
1653381924,200417,true,1978952877,28,1978557146,-395731
1653382270,200417,true,1978952877,28,1978161494,-791383
1653382311,200417,true,1978952877,28,1977963697,-989180
1653382375,200416,true,1979150772,28,1977765921,-1384851
1653382403,200416,true,1979150772,28,1977765921,-1384851
1653382576,200417,true,1978952877,28,1976579677,-2373200
1653382681,200417,true,1978952877,28,1975986821,-2966056
1653383332,200417,true,1978952877,28,1971053270,-7899607
1653383354,200417,true,1978952877,28,1970856185,-8096692
1653383356,200419,true,1978557146,28,1970856185,-7700961
1653383423,200419,true,1978557146,28,1970068039,-8489107
1653383633,200420,true,1978359310,28,1967508743,-10850567
1653383677,200419,true,1978557146,28,1967115300,-11441846
1653383834,200420,true,1978359310,28,1966328651,-12030659
1653383862,200419,true,1978557146,28,1966132037,-12425109
1653384090,200420,true,1978359310,28,1964952771,-13406539
1653384496,200419,true,1978557146,28,1964756295,-13800851
1653384705,200420,true,1978359310,28,1964952771,-13406539
1653384739,200420,true,1978359310,28,1964952771,-13406539
1653385857,200421,true,1978161494,28,1967312012,-10849482
1653385904,200421,true,1978161494,28,1967312012,-10849482
1653386203,200421,true,1978161494,28,1966918608,-11242886
1653386265,200421,true,1978161494,28,1966918608,-11242886
1653386348,200423,true,1977765921,28,1966721936,-11043985
1653386414,200423,true,1977765921,28,1966721936,-11043985
1653386765,200424,true,1977568164,28,1966525283,-11042881
1653386894,200424,true,1977568164,28,1966328651,-11239513
1653387027,200425,true,1977370427,28,1966328651,-11041776
1653387724,200425,true,1977370427,28,1965935444,-11434983
1653387774,200426,true,1977172710,28,1966132037,-11040673
1653388275,200426,true,1977172710,28,1966328651,-10844059
1653388403,200428,true,1976777335,28,1966328651,-10448684
1653389215,200428,true,1976777335,28,1966328651,-10448684
1653389322,200429,true,1976579677,28,1966525283,-10054394
1653389861,200429,true,1976579677,28,1966721936,-9857741
1653390508,200430,true,1976382038,28,1967902264,-8479774
1653390516,200430,true,1976382038,28,1967902264,-8479774
1653390543,200431,true,1976184420,28,1967902264,-8282156
1653390732,200431,true,1976184420,28,1968295864,-7888556
1653390804,200432,true,1975986821,28,1968492694,-7494127
1653390934,200432,true,1975986821,28,1968689543,-7297278
1653390950,200433,true,1975789242,28,1968689543,-7099699
1653390957,200433,true,1975789242,28,1968886412,-6902830
1653391071,200434,true,1975591683,28,1969280209,-6311474
1653391124,200434,true,1975591683,28,1969477137,-6114546
1653391263,200434,true,1975591683,28,1970068039,-5523644
1653391473,200434,true,1975591683,28,1971053270,-4538413
1653392203,200435,true,1975394144,28,1973419836,-1974308
1653392263,200435,true,1975394144,28,1973419836,-1974308
1653392355,200436,true,1975196624,28,1973617178,-1579446
1653392387,200435,true,1975394144,28,1973814539,-1579605
1653392452,200437,true,1974999124,28,1973814539,-1184585
1653392611,200437,true,1974999124,28,1974209322,-789802
1653392678,200438,true,1974801644,28,1974209322,-592322
1653392727,200438,true,1974801644,28,1974209322,-592322
1653392774,200439,true,1974604184,28,1974209322,-394862
1653392937,200439,true,1974604184,28,1974011921,-592263
1653392946,200440,true,1974406743,28,1973814539,-592204
1653393324,200441,true,1974209322,28,1972433422,-1775900
1653393335,200442,true,1974011921,28,1972433422,-1578499
1653393384,200442,true,1974011921,28,1972038994,-1972927
1653393431,200444,true,1973617178,28,1971841810,-1775368
1653393567,200444,true,1973617178,28,1971053270,-2563908
1653393871,200446,true,1973222513,28,1969477137,-3745376
1653394579,200446,true,1973222513,28,1965935444,-7287069
1653394580,200447,true,1973025211,28,1965935444,-7089767
1653394635,200448,true,1972827928,28,1965738870,-7089058
1653395030,200449,true,1972630665,28,1964559839,-8070826
1653395034,200450,true,1972433422,28,1964559839,-7873583
1653395130,200451,true,1972236198,28,1964363403,-7872795
1653395147,200452,true,1972038994,28,1964363403,-7675591
1653395680,200454,true,1971644645,28,1962596360,-9048285
1653395729,200454,true,1971644645,28,1962400120,-9244525
1653396004,200455,true,1971447501,28,1961419214,-10028287
1653396081,200456,true,1971250376,28,1961223091,-10027285
1653396097,200458,true,1970856185,28,1961026989,-9829196
1653396682,200458,true,1970856185,28,1959654819,-11201366
1653396749,200458,true,1970856185,28,1959654819,-11201366
1653398617,200459,true,1970659119,28,1961026989,-9632130
1653399520,200461,true,1970265046,28,1961026989,-9238057
1653399525,200461,true,1970265046,28,1961026989,-9238057
1653399528,200462,true,1970068039,28,1961026989,-9041050
1653399570,200462,true,1970068039,28,1961026989,-9041050
1653399580,200464,true,1969674085,28,1961026989,-8647096
1653399650,200465,true,1969477137,28,1960830906,-8646231
1653400064,200465,true,1969477137,28,1959654819,-9822318
1653400107,200466,true,1969280209,28,1959458873,-9821336
1653400108,200468,true,1968886412,28,1959458873,-9427539
1653400174,200469,true,1968689543,28,1959067040,-9622503
1653400205,200471,true,1968295864,28,1958675285,-9620579
1653400240,200472,true,1968099054,28,1958479437,-9619617
1653400525,200475,true,1967508743,28,1955348532,-12160211
1653400571,200476,true,1967312012,28,1954762045,-12549967
1653400584,200478,true,1966918608,28,1954566588,-12352020
1653400586,200479,true,1966721936,28,1954566588,-12155348
1653400736,200483,true,1965935444,28,1952417854,-13517590
1653400758,200483,true,1965935444,28,1952027429,-13908015
1653400784,200486,true,1965345781,28,1951637082,-13708699
1653400804,200487,true,1965149266,28,1951246814,-13902452
1653400813,200491,true,1964363403,28,1951246814,-13116589
1653400832,200492,true,1964166986,28,1950856623,-13310363
1653400875,200494,true,1963774212,28,1950076475,-13697737
1653401195,200496,true,1963381516,28,1944429727,-18951789
1653401210,200500,true,1962596360,28,1944040900,-18555460
1653401215,200501,true,1962400120,28,1944040900,-18359220
1653401271,200503,true,1962007698,28,1942874883,-19132815
1653401285,200506,true,1961419214,28,1942680615,-18738599
1653401291,200510,true,1960634842,28,1942486367,-18148475
1653401313,200511,true,1960438798,28,1942097928,-18340870
1653401374,200514,true,1959850784,28,1940739003,-19111781
1653401493,200516,true,1959458873,28,1938217807,-21241066
1653401668,200520,true,1958675285,28,1934732327,-23942958
1653401714,200522,true,1958283609,28,1933765251,-24518358
1653401792,200525,true,1957696241,28,1932218935,-25477306
1653402117,200527,true,1957304761,28,1927009241,-30295520
1653402156,200531,true,1956522035,28,1926431254,-30090781
1653402190,200532,true,1956326402,28,1926046025,-30280377
1653402604,200534,true,1955935195,28,1922197975,-33737220
1653402633,200536,true,1955544067,28,1922005774,-33538293
1653402687,200539,true,1954957521,28,1922197975,-32759546
1653402706,200540,true,1954762045,28,1922197975,-32564070
1653402754,200540,true,1954762045,28,1922197975,-32564070
1653403213,200541,true,1954566588,28,1924505881,-30060707
1653403219,200543,true,1954175734,28,1924505881,-29669853
1653403242,200544,true,1953980335,28,1924698332,-29282003
1653403254,200545,true,1953784957,28,1924698332,-29086625
1653403601,200547,true,1953394259,28,1926816559,-26577700
1653403775,200550,true,1952808358,28,1927780160,-25028198
1653403996,200551,true,1952613096,28,1928937117,-23675979
1653404260,200552,true,1952417854,28,1930287778,-22130076
1653404271,200554,true,1952027429,28,1930287778,-21739651
1653404480,200557,true,1951441938,28,1931060009,-20381929
1653405274,200558,true,1951246814,28,1930287778,-20959036
1653406172,200558,true,1951246814,28,1931253115,-19993699
1653406197,200560,true,1950856623,28,1931446241,-19410382
1653406962,200563,true,1950271483,28,1933378556,-16892927
1653406980,200564,true,1950076475,28,1933378556,-16697919
1653407069,200564,true,1950076475,28,1933765251,-16311224
1653407114,200566,true,1949686518,28,1934152024,-15534494
1653407150,200567,true,1949491569,28,1934345439,-15146130
1653407232,200567,true,1949491569,28,1935119293,-14372276
1653407255,200567,true,1949491569,28,1935506336,-13985233
1653407342,200568,true,1949296640,28,1936667931,-12628709
1653407351,200569,true,1949101729,28,1936861597,-12240132
1653407760,200568,true,1949296640,28,1944818633,-4478007
1653407867,200568,true,1949296640,28,1946764327,-2532313
1653407910,200569,true,1949101729,28,1947543149,-1558580
1653407941,200570,true,1948906839,28,1948127471,-779368
1653408004,200569,true,1949101729,28,1949101729,0
1653408674,200569,true,1949101729,28,1958871153,9769424
1653408708,200570,true,1948906839,28,1959262947,10356108
1653408784,200571,true,1948711967,28,1960438798,11726831
1653408907,200570,true,1948906839,28,1962007698,13100859
1653408924,200570,true,1948906839,28,1962203899,13297060
1653409654,200571,true,1948711967,28,1964952771,16240804
1653409699,200572,true,1948517116,28,1965149266,16632150
1653409799,200571,true,1948711967,28,1965542316,16830349
1653409881,200571,true,1948711967,28,1965738870,17026903
1653409887,200572,true,1948517116,28,1965738870,17221754
1653409922,200573,true,1948322284,28,1965738870,17416586
1653410183,200573,true,1948322284,28,1965738870,17416586
1653410250,200573,true,1948322284,28,1965542316,17220032
1653411059,200575,true,1947932678,28,1962400120,14467442
1653411139,200576,true,1947737904,28,1961811517,14073613
1653411217,200576,true,1947737904,28,1961419214,13681310
1653411790,200576,true,1947737904,28,1957696241,9958337
1653411799,200578,true,1947348415,28,1957500491,10152076
1653411889,200579,true,1947153699,28,1957109050,9955351
1653411931,200579,true,1947153699,28,1956717687,9563988
1653411964,200580,true,1946959003,28,1956522035,9563032
1653412925,200581,true,1946764327,28,1951441938,4677611
1653412932,200583,true,1946375032,28,1951441938,5066906
1653412956,200583,true,1946375032,28,1951246814,4871782
1653412967,200583,true,1946375032,28,1951246814,4871782
1653413722,200586,true,1945791237,28,1944040900,-1750337
1653413916,200588,true,1945402137,28,1942680615,-2721522
1653413970,200588,true,1945402137,28,1942486367,-2915770
1653414052,200588,true,1945402137,28,1942097928,-3304209
1653414079,200591,true,1944818633,28,1942097928,-2720705
1653414354,200592,true,1944624170,28,1941321283,-3302887
1653414382,200591,true,1944818633,28,1941321283,-3497350
1653414925,200592,true,1944624170,28,1941515415,-3108755
1653415008,200594,true,1944235304,28,1942097928,-2137376
1653415163,200594,true,1944235304,28,1943652150,-583154
1653415262,200593,true,1944429727,28,1944624170,194443
1653415451,200592,true,1944624170,28,1946375032,1750862
1653415667,200595,true,1944040900,28,1948517116,4476216
1653415766,200594,true,1944235304,28,1949686518,5451214
1653415874,200594,true,1944235304,28,1950856623,6621319
1653417065,200592,true,1944624170,28,1962203899,17579729
1653417698,200594,true,1944235304,28,1964952771,20717467
1653417835,200594,true,1944235304,28,1964756295,20520991
1653417849,200593,true,1944429727,28,1964756295,20326568
1653417854,200591,true,1944818633,28,1964756295,19937662
1653417878,200594,true,1944235304,28,1964559839,20324535
1653418065,200594,true,1944235304,28,1963577854,19342550
1653418067,200593,true,1944429727,28,1963577854,19148127
1653418094,200591,true,1944818633,28,1963577854,18759221
1653418128,200594,true,1944235304,28,1963185197,18949893
1653418170,200595,true,1944040900,28,1962988898,18947998
1653418542,200595,true,1944040900,28,1959067040,15026140
1653418645,200592,true,1944624170,28,1958087800,13463630
1653418670,200594,true,1944235304,28,1957696241,13460937
1653419257,200594,true,1944235304,28,1951051708,6816404
1653419331,200594,true,1944235304,28,1950271483,6036179
1653420309,200591,true,1944818633,28,1945013115,194482
1653420389,200593,true,1944429727,28,1945207616,777889
1653420394,200593,true,1944429727,28,1945207616,777889
1653420433,200592,true,1944624170,28,1945402137,777967
1653420957,200588,true,1945402137,28,1948322284,2920147
1653420970,200589,true,1945207616,28,1948322284,3114668
1653421042,200589,true,1945207616,28,1948906839,3699223
1653421061,200588,true,1945402137,28,1949101729,3699592
1653421101,200582,true,1946569670,28,1949296640,2726970
1653421162,200584,true,1946180414,28,1949881487,3701073
1653421658,200583,true,1946375032,28,1954566588,8191556
1653422264,200582,true,1946569670,28,1959654819,13085149
1653423305,200576,true,1947737904,28,1962007698,14269794
1653423486,200578,true,1947348415,28,1962007698,14659283
1653423493,200576,true,1947737904,28,1962007698,14269794
1653423693,200575,true,1947932678,28,1962007698,14075020
1653425123,200570,true,1948906839,28,1957304761,8397922
1653425362,200571,true,1948711967,28,1956717687,8005720
1653425579,200569,true,1949101729,28,1956913359,7811630
1653425696,200568,true,1949296640,28,1957109050,7812410
1653425779,200562,true,1950466510,28,1957500491,7033981
1653425990,200563,true,1950271483,28,1958283609,8012126
1653426619,200561,true,1950661557,28,1961615356,10953799
1653426659,200559,true,1951051708,28,1962007698,10955990
1653426712,200554,true,1952027429,28,1962203899,10176470
1653426774,200555,true,1951832246,28,1962596360,10764114
1653426847,200553,true,1952222632,28,1962988898,10766266
1653427253,200551,true,1952613096,28,1965542316,12929220
1653428816,200547,true,1953394259,28,1970068039,16673780
1653429182,200548,true,1953198939,28,1970265046,17066107
1653429279,200546,true,1953589598,28,1970265046,16675448
1653429345,200544,true,1953980335,28,1970462073,16481738
1653429372,200540,true,1954762045,28,1970462073,15700028
1653430273,200539,true,1954957521,28,1974604184,19646663
1653430589,200537,true,1955348532,28,1976184420,20835888
1653433781,200535,true,1955739621,28,1979348688,23609067
1653434310,200531,true,1956522035,28,1979942552,23420517
1653434622,200530,true,1956717687,28,1980338560,23620873
1653435263,200528,true,1957109050,28,1981130814,24021764
1653435424,200526,true,1957500491,28,1981328927,23828436
1653435526,200522,true,1958283609,28,1981328927,23045318
1653435654,200521,true,1958479437,28,1981328927,22849490
1653435973,200519,true,1958871153,28,1981130814,22259661
1653436190,200518,true,1959067040,28,1980932721,21865681
1653437161,200514,true,1959850784,28,1979744577,19893793
1653437523,200513,true,1960046769,28,1979744577,19697808
1653437557,200513,true,1960046769,28,1979744577,19697808
1653437569,200511,true,1960438798,28,1979744577,19305779
1653437642,200508,true,1961026989,28,1979546622,18519633
1653437710,200508,true,1961026989,28,1979546622,18519633
1653438752,200508,true,1961026989,28,1978161494,17134505
1653440496,200509,true,1960830906,28,1977172710,16341804
1653440503,200506,true,1961419214,28,1977172710,15753496
1653440530,200506,true,1961419214,28,1977172710,15753496
1653441164,200506,true,1961419214,28,1976579677,15160463
1653441783,200507,true,1961223091,28,1975789242,14566151
1653442127,200503,true,1962007698,28,1975591683,13583985
1653442143,200504,true,1961811517,28,1975394144,13582627
1653443104,200504,true,1961811517,28,1974604184,12792667
1653443840,200504,true,1961811517,28,1974209322,12397805
1653443849,200501,true,1962400120,28,1974209322,11809202
1653443939,200503,true,1962007698,28,1974209322,12201624
1653443960,200503,true,1962007698,28,1974406743,12399045
1653443985,200503,true,1962007698,28,1974406743,12399045
1653444007,200500,true,1962596360,28,1974406743,11810383
1653444028,200501,true,1962400120,28,1974604184,12204064
1653444041,200500,true,1962596360,28,1974604184,12007824
1653444535,200499,true,1962792619,28,1977568164,14775545
1653445357,200495,true,1963577854,28,1982121578,18543724
1653445441,200496,true,1963381516,28,1982716274,19334758
1653445464,200496,true,1963381516,28,1982914545,19533029
1653445652,200494,true,1963774212,28,1985096842,21322630
1653445706,200489,true,1964756295,28,1985692431,20936136
1653445767,200489,true,1964756295,28,1986288198,21531903
1653445874,200489,true,1964756295,28,1987082832,22326537
1653445904,200486,true,1965345781,28,1987281541,21935760
1653446282,200480,true,1966525283,28,1990264551,23739268
1653446337,200480,true,1966525283,28,1990662623,24137340
1653446406,200479,true,1966721936,28,1991459008,24737072
1653446536,200477,true,1967115300,28,1992853448,25738148
1653446540,200471,true,1968295864,28,1992853448,24557584
1653446931,200468,true,1968886412,28,1997442056,28555644
1653446969,200467,true,1969083301,28,1998041348,28958047
1653447082,200465,true,1969477137,28,1999440397,29963260
1653447107,200458,true,1970856185,28,1999840305,28984120
1653447162,200455,true,1971447501,28,2000640361,29192860
1653447183,200455,true,1971447501,28,2000840425,29392924
1653447385,200453,true,1971841810,28,2002842166,31000356
1653447406,200447,true,1973025211,28,2003042451,30017240
1653447495,200444,true,1973617178,28,2003843788,30226610
1653447608,200444,true,1973617178,28,2004845910,31228732
1653449206,200441,true,1974209322,28,2010869177,36659855
1653450181,200436,true,1975196624,28,2010869177,35672553
1653450306,200434,true,1975591683,28,2011070264,35478581
1653451482,200434,true,1975591683,28,2013082239,37490556
1653451543,200431,true,1976184420,28,2013082239,36897819
1653451624,200427,true,1976975012,28,2013283548,36308536
1653451661,200425,true,1977370427,28,2013283548,35913121
1653451914,200425,true,1977370427,28,2013283548,35913121
1653452985,200423,true,1977765921,28,2011874813,34108892
1653453485,200419,true,1978557146,28,2011271371,32714225
1653453701,200416,true,1979150772,28,2011070264,31919492
1653454074,200416,true,1979150772,28,2010668110,31517338
1653454286,200413,true,1979744577,28,2010266037,30521460
1653454690,200409,true,1980536594,28,2009261205,28724611
1653454861,200407,true,1980932721,28,2008658547,27725826
1653455172,200406,true,1981130814,28,2007855285,26724471
1653456587,200403,true,1981725213,28,2006650993,24925780
1653456718,200399,true,1982518022,28,2006650993,24132971
1653456754,200396,true,1983112837,28,2006650993,23538156
1653456811,200395,true,1983311148,28,2006650993,23339845
1653456888,200392,true,1983906201,28,2006450348,22544147
1653457013,200388,true,1984699882,28,2006049118,21349236
1653457051,200386,true,1985096842,28,2005848533,20751691
1653457182,200386,true,1985096842,28,2004244577,19147735
1653457290,200384,true,1985493881,28,2003042451,17548570
1653457492,200382,true,1985891000,28,2000840425,14949425
1653457527,200380,true,1986288198,28,2000440317,14152119
1653458884,200380,true,1986288198,28,1987877785,1589587
1653458892,200378,true,1986685476,28,1987877785,1192309
1653459012,200377,true,1986884144,28,1987877785,993641
1653459056,200375,true,1987281541,28,1987877785,596244
1653459217,200375,true,1987281541,28,1987679017,397476
1653459407,200374,true,1987480269,28,1987281541,-198728
1653459435,200373,true,1987679017,28,1987281541,-397476
1653459503,200371,true,1988076573,28,1987082832,-993741
1653459846,200372,true,1987877785,28,1985692431,-2185354
1653459875,200370,true,1988275380,28,1985493881,-2781499
1653459916,200369,true,1988474208,28,1985295352,-3178856
1653459939,200366,true,1989070810,28,1985096842,-3973968
1653459975,200368,true,1988673055,28,1984898352,-3774703
1653460904,200366,true,1989070810,28,1979942552,-9128258
1653461167,200365,true,1989269717,28,1979150772,-10118945
1653461372,200363,true,1989667591,28,1978557146,-11110445
1653461506,200365,true,1989269717,28,1978359310,-10910407
1653461591,200364,true,1989468644,28,1978359310,-11109334
1653461602,200363,true,1989667591,28,1978359310,-11308281
1653461721,200361,true,1990065544,28,1978161494,-11904050
1653461807,200363,true,1989667591,28,1978161494,-11506097
1653461817,200362,true,1989866557,28,1978161494,-11705063
1653462042,200361,true,1990065544,28,1978557146,-11508398
1653462948,200359,true,1990463577,28,1980140546,-10323031
1653463149,200361,true,1990065544,28,1980536594,-9528950
1653463165,200360,true,1990264551,28,1980536594,-9727957
1653463872,200359,true,1990463577,28,1980932721,-9530856
1653463926,200358,true,1990662623,28,1980932721,-9729902
1653463954,200360,true,1990264551,28,1980932721,-9331830
1653463976,200360,true,1990264551,28,1980932721,-9331830
1653464241,200359,true,1990463577,28,1980536594,-9926983
1653464354,200359,true,1990463577,28,1980338560,-10125017
1653464401,200361,true,1990065544,28,1980338560,-9726984
1653464732,200360,true,1990264551,28,1979744577,-10519974
1653464935,200360,true,1990264551,28,1979546622,-10717929
1653465012,200359,true,1990463577,28,1979348688,-11114889
1653465631,200361,true,1990065544,28,1978359310,-11706234
1653465701,200361,true,1990065544,28,1978359310,-11706234
1653465730,200360,true,1990264551,28,1978359310,-11905241
1653465758,200359,true,1990463577,28,1978161494,-12302083
1653465974,200363,true,1989667591,28,1976777335,-12890256
1653466051,200363,true,1989667591,28,1976382038,-13285553
1653466435,200362,true,1989866557,28,1974209322,-15657235
1653466469,200361,true,1990065544,28,1974011921,-16053623
1653467469,200364,true,1989468644,28,1969083301,-20385343
1653467964,200364,true,1989468644,28,1969083301,-20385343
1653468177,200364,true,1989468644,28,1969280209,-20188435
1653468201,200363,true,1989667591,28,1969280209,-20387382
1653468329,200366,true,1989070810,28,1969280209,-19790601
1653468508,200365,true,1989269717,28,1969280209,-19989508
1653468565,200365,true,1989269717,28,1969477137,-19792580
1653468592,200364,true,1989468644,28,1969477137,-19991507
1653468606,200366,true,1989070810,28,1969477137,-19593673
1653469779,200366,true,1989070810,28,1971841810,-17229000
1653469810,200365,true,1989269717,28,1972038994,-17230723
1653469903,200364,true,1989468644,28,1972236198,-17232446
1653470070,200367,true,1988871923,28,1972433422,-16438501
1653470097,200366,true,1989070810,28,1972630665,-16440145
1653470146,200366,true,1989070810,28,1972630665,-16440145
1653470207,200365,true,1989269717,28,1972630665,-16639052
1653470221,200368,true,1988673055,28,1972827928,-15845127
1653470316,200369,true,1988474208,28,1972630665,-15843543
1653470338,200369,true,1988474208,28,1972630665,-15843543
1653471100,200368,true,1988673055,28,1970856185,-17816870
1653471584,200371,true,1988076573,28,1969674085,-18402488
1653471630,200372,true,1987877785,28,1969674085,-18203700
1653471656,200373,true,1987679017,28,1969477137,-18201880
1653472031,200373,true,1987679017,28,1968886412,-18792605
1653472193,200376,true,1987082832,28,1968689543,-18393289
1653472313,200377,true,1986884144,28,1968689543,-18194601
1653472339,200378,true,1986685476,28,1968886412,-17799064
1653472404,200378,true,1986685476,28,1968886412,-17799064
1653472438,200381,true,1986089589,28,1968886412,-17203177
1653472476,200382,true,1985891000,28,1968886412,-17004588
1653472539,200384,true,1985493881,28,1969083301,-16410580
1653472727,200384,true,1985493881,28,1969477137,-16016744
1653472872,200387,true,1984898352,28,1969674085,-15224267
1653472915,200388,true,1984699882,28,1969674085,-15025797
1653472929,200390,true,1984303002,28,1969871052,-14431950
1653473002,200390,true,1984303002,28,1969871052,-14431950
1653473197,200394,true,1983509479,28,1970265046,-13244433
1653473514,200395,true,1983311148,28,1970856185,-12454963
1653473536,200397,true,1982914545,28,1970856185,-12058360
1653473657,200397,true,1982914545,28,1971053270,-11861275
1653473784,200401,true,1982121578,28,1971447501,-10674077
1653473822,200402,true,1981923385,28,1971447501,-10475884
1653473852,200404,true,1981527060,28,1971447501,-10079559
1653473860,200404,true,1981527060,28,1971447501,-10079559
1653474219,200408,true,1980734647,28,1972038994,-8695653
1653474250,200410,true,1980338560,28,1971841810,-8496750
1653474478,200412,true,1979942552,28,1971644645,-8297907
1653474823,200412,true,1979942552,28,1971053270,-8889282
1653474998,200415,true,1979348688,28,1970856185,-8492503
1653475261,200417,true,1978952877,28,1970462073,-8490804
1653475659,200419,true,1978557146,28,1969871052,-8686094
1653475704,200420,true,1978359310,28,1969871052,-8488258
1653475752,200423,true,1977765921,28,1969871052,-7894869
1653475808,200424,true,1977568164,28,1969674085,-7894079
1653475840,200426,true,1977172710,28,1969674085,-7498625
1653475844,200427,true,1976975012,28,1969674085,-7300927
1653475962,200430,true,1976382038,28,1969477137,-6904901
1653475984,200431,true,1976184420,28,1969280209,-6904211
1653476535,200433,true,1975789242,28,1968492694,-7296548
1653476800,200434,true,1975591683,28,1968099054,-7492629
1653476967,200437,true,1974999124,28,1967902264,-7096860
1653477089,200438,true,1974801644,28,1967705494,-7096150
1653477100,200440,true,1974406743,28,1967705494,-6701249
1653477126,200440,true,1974406743,28,1967508743,-6898000
1653477146,200442,true,1974011921,28,1967508743,-6503178
1653477215,200444,true,1973617178,28,1967115300,-6501878
1653477260,200444,true,1973617178,28,1966918608,-6698570
1653477281,200445,true,1973419836,28,1966721936,-6697900
1653477364,200448,true,1972827928,28,1966132037,-6695891
1653477536,200449,true,1972630665,28,1964952771,-7677894
1653477865,200450,true,1972433422,28,1962988898,-9444524
1653477943,200450,true,1972433422,28,1962596360,-9837062
1653477958,200453,true,1971841810,28,1962400120,-9441690
1653477999,200454,true,1971644645,28,1962203899,-9440746
1653478031,200455,true,1971447501,28,1961811517,-9635984
1653478209,200456,true,1971250376,28,1960242774,-11007602
1653478275,200458,true,1970856185,28,1959654819,-11201366
1653478610,200460,true,1970462073,28,1956130789,-14331284
1653478688,200461,true,1970265046,28,1955348532,-14916514
1653478713,200462,true,1970068039,28,1955153017,-14915022
1653479732,200464,true,1969674085,28,1948322284,-21351801
1653479774,200466,true,1969280209,28,1948127471,-21152738
1653479994,200467,true,1969083301,28,1947543149,-21540152
1653480025,200468,true,1968886412,28,1947543149,-21343263
1653480032,200470,true,1968492694,28,1947543149,-20949545
1653480167,200471,true,1968295864,28,1947153699,-21142165
1653480241,200473,true,1967902264,28,1946959003,-20943261
1653480258,200474,true,1967705494,28,1946764327,-20941167
1653480473,200477,true,1967115300,28,1945596677,-21518623
1653480777,200479,true,1966721936,28,1944624170,-22097766
1653480925,200480,true,1966525283,28,1944040900,-22484383
1653481991,200481,true,1966328651,28,1941515415,-24813236
1653482145,200484,true,1965738870,28,1941709566,-24029304
1653482211,200486,true,1965345781,28,1941903737,-23442044
1653482341,200487,true,1965149266,28,1942292138,-22857128
1653482398,200488,true,1964952771,28,1942292138,-22660633
1653482880,200490,true,1964559839,28,1943457804,-21102035
1653482965,200492,true,1964166986,28,1943652150,-20514836
1653483124,200493,true,1963970589,28,1944235304,-19735285
1653483183,200494,true,1963774212,28,1944429727,-19344485
1653483644,200496,true,1963381516,28,1946764327,-16617189
1653483728,200497,true,1963185197,28,1947153699,-16031498
1653483774,200498,true,1962988898,28,1947348415,-15640483
1653483960,200499,true,1962792619,28,1948517116,-14275503
1653484307,200500,true,1962596360,28,1949686518,-12909842
1653485563,200502,true,1962203899,28,1952417854,-9786045
1653485565,200503,true,1962007698,28,1952417854,-9589844
1653485620,200503,true,1962007698,28,1952613096,-9394602
1653485661,200504,true,1961811517,28,1952613096,-9198421
1653485672,200504,true,1961811517,28,1952808358,-9003159
1653485696,200505,true,1961615356,28,1952808358,-8806998
1653485741,200505,true,1961615356,28,1953003638,-8611718
1653485796,200505,true,1961615356,28,1953198939,-8416417
1653485805,200506,true,1961419214,28,1953198939,-8220275
1653485824,200506,true,1961419214,28,1953394259,-8024955
1653485848,200506,true,1961419214,28,1953589598,-7829616
1653486144,200504,true,1961811517,28,1957500491,-4311026
1653486157,200505,true,1961615356,28,1957696241,-3919115
1653486186,200505,true,1961615356,28,1958087800,-3527556
1653486200,200505,true,1961615356,28,1958283609,-3331747
1653486327,200504,true,1961811517,28,1959654819,-2156698
1653486489,200504,true,1961811517,28,1961811517,0
1653486538,200505,true,1961615356,28,1962203899,588543
1653486749,200505,true,1961615356,28,1963774212,2158856
1653487342,200505,true,1961615356,28,1968295864,6680508
1653487437,200506,true,1961419214,28,1968886412,7467198
1653488068,200506,true,1961419214,28,1968295864,6876650
1653488110,200506,true,1961419214,28,1968295864,6876650
1653488124,200505,true,1961615356,28,1968295864,6680508
1653488127,200506,true,1961419214,28,1968295864,6876650
1653488191,200505,true,1961615356,28,1968295864,6680508
1653489029,200505,true,1961615356,28,1972630665,11015309
1653489313,200504,true,1961811517,28,1974011921,12200404
1653489644,200504,true,1961811517,28,1975591683,13780166
1653489658,200504,true,1961811517,28,1975591683,13780166
1653489966,200504,true,1961811517,28,1975986821,14175304
1653489978,200503,true,1962007698,28,1975789242,13781544
1653490063,200504,true,1961811517,28,1975591683,13780166
1653490163,200503,true,1962007698,28,1974999124,12991426
1653492906,200504,true,1961811517,28,1966328651,4517134
1653493048,200503,true,1962007698,28,1965935444,3927746
1653493587,200505,true,1961615356,28,1964363403,2748047
1653494515,200505,true,1961615356,28,1961419214,-196142
1653495063,200506,true,1961419214,28,1960634842,-784372
1653495083,200505,true,1961615356,28,1960634842,-980514
1653495381,200507,true,1961223091,28,1960438798,-784293
1653495545,200507,true,1961223091,28,1960242774,-980317
1653495679,200509,true,1960830906,28,1960046769,-784137
1653495874,200508,true,1961026989,28,1959262947,-1764042
1653495988,200510,true,1960634842,28,1958479437,-2155405
1653496162,200510,true,1960634842,28,1957500491,-3134351
1653496603,200513,true,1960046769,28,1954762045,-5284724
1653497369,200512,true,1960242774,28,1949881487,-10361287
1653498554,200514,true,1959850784,28,1947543149,-12307635
1653498726,200515,true,1959654819,28,1947543149,-12111670
1653499014,200517,true,1959262947,28,1947737904,-11525043
1653499080,200517,true,1959262947,28,1947932678,-11330269
1653499161,200518,true,1959067040,28,1947932678,-11134362
1653499182,200519,true,1958871153,28,1947932678,-10938475
1653499843,200521,true,1958479437,28,1949491569,-8987868
1653499869,200520,true,1958675285,28,1949491569,-9183716
1653499955,200522,true,1958283609,28,1949686518,-8597091
1653500030,200522,true,1958283609,28,1949881487,-8402122
1653500103,200524,true,1957892011,28,1950076475,-7815536
1653500226,200523,true,1958087800,28,1950661557,-7426243
1653500227,200525,true,1957696241,28,1950661557,-7034684
1653500234,200525,true,1957696241,28,1950661557,-7034684
1653500303,200526,true,1957500491,28,1951051708,-6448783
1653500577,200525,true,1957696241,28,1952222632,-5473609
1653500672,200527,true,1957304761,28,1952613096,-4691665
1653500783,200527,true,1957304761,28,1953003638,-4301123
1653501443,200528,true,1957109050,28,1955544067,-1564983
1653501629,200527,true,1957304761,28,1956326402,-978359
1653501738,200528,true,1957109050,28,1956913359,-195691
1653501747,200528,true,1957109050,28,1956913359,-195691
1653501984,200528,true,1957109050,28,1959067040,1957990
1653502013,200527,true,1957304761,28,1959262947,1958186
1653502018,200527,true,1957304761,28,1959262947,1958186
1653502031,200527,true,1957304761,28,1959262947,1958186
1653502099,200529,true,1956913359,28,1959262947,2349588
1653502104,200528,true,1957109050,28,1959262947,2153897
1653502111,200528,true,1957109050,28,1959262947,2153897
1653502123,200528,true,1957109050,28,1959067040,1957990
1653502217,200530,true,1956717687,28,1959067040,2349353
1653502222,200528,true,1957109050,28,1959067040,1957990
1653502584,200527,true,1957304761,28,1960634842,3330081
1653502609,200526,true,1957500491,28,1960830906,3330415
1653503238,200527,true,1957304761,28,1964756295,7451534
1653503401,200525,true,1957696241,28,1965738870,8042629
1653503431,200523,true,1958087800,28,1965935444,7847644
1653503496,200523,true,1958087800,28,1966328651,8240851
1653503515,200523,true,1958087800,28,1966525283,8437483
1653503522,200521,true,1958479437,28,1966525283,8045846
1653503721,200519,true,1958871153,28,1966918608,8047455
1653504243,200518,true,1959067040,28,1971053270,11986230
1653504413,200518,true,1959067040,28,1971841810,12774770
1653504543,200516,true,1959458873,28,1972038994,12580121
1653505676,200514,true,1959850784,28,1972236198,12385414
1653505822,200513,true,1960046769,28,1971841810,11795041
1653506481,200513,true,1960046769,28,1971250376,11203607
1653506564,200510,true,1960634842,28,1971250376,10615534
1653507383,200508,true,1961026989,28,1970068039,9041050
1653507395,200507,true,1961223091,28,1970068039,8844948
1653508196,200508,true,1961026989,28,1968099054,7072065
1653508313,200506,true,1961419214,28,1967508743,6089529
1653508371,200504,true,1961811517,28,1967115300,5303783
1653508584,200503,true,1962007698,28,1966132037,4124339
1653508757,200505,true,1961615356,28,1964952771,3337415
1653509027,200504,true,1961811517,28,1962596360,784843
1653510409,200503,true,1962007698,28,1953198939,-8808759
1653511771,200502,true,1962203899,28,1952808358,-9395541
1653511793,200504,true,1961811517,28,1953003638,-8807879
1653512712,200503,true,1962007698,28,1954175734,-7831964
1653514196,200502,true,1962203899,28,1955348532,-6855367
1653514946,200501,true,1962400120,28,1956326402,-6073718
1653514950,200503,true,1962007698,28,1956522035,-5485663
1653516108,200502,true,1962203899,28,1960634842,-1569057
1653516578,200500,true,1962596360,28,1962007698,-588662
1653517105,200499,true,1962792619,28,1962792619,0
1653519663,200501,true,1962400120,28,1963381516,981396
1653519894,200500,true,1962596360,28,1963381516,785156
1653520000,200499,true,1962792619,28,1963381516,588897
1653520082,200498,true,1962988898,28,1963185197,196299
1653520776,200501,true,1962400120,28,1962203899,-196221
1653520792,200499,true,1962792619,28,1962203899,-588720
1653520802,200499,true,1962792619,28,1962203899,-588720
1653520837,200498,true,1962988898,28,1962203899,-784999
1653520853,200502,true,1962203899,28,1962007698,-196201
1653521107,200503,true,1962007698,28,1960438798,-1568900
1653521651,200503,true,1962007698,28,1957304761,-4702937
1653521692,200502,true,1962203899,28,1956913359,-5290540
1653521884,200506,true,1961419214,28,1955935195,-5484019
1653521937,200507,true,1961223091,28,1955544067,-5679024
1653521994,200507,true,1961223091,28,1955153017,-6070074
1653522009,200506,true,1961419214,28,1955153017,-6266197
1653522053,200510,true,1960634842,28,1954762045,-5872797
1653522564,200511,true,1960438798,28,1950271483,-10167315
1653522635,200511,true,1960438798,28,1949686518,-10752280
1653522806,200510,true,1960634842,28,1948906839,-11728003
1653522831,200514,true,1959850784,28,1948711967,-11138817
1653522906,200516,true,1959458873,28,1948322284,-11136589
1653523222,200516,true,1959458873,28,1946764327,-12694546
1653523793,200516,true,1959458873,28,1944040900,-15417973
1653523891,200520,true,1958675285,28,1943846515,-14828770
1653524055,200522,true,1958283609,28,1943846515,-14437094
1653524279,200521,true,1958479437,28,1944040900,-14438537
1653524319,200522,true,1958283609,28,1944040900,-14242709
1653524340,200526,true,1957500491,28,1944235304,-13265187
1653524409,200527,true,1957304761,28,1944429727,-12875034
1653524481,200525,true,1957696241,28,1944624170,-13072071
1653524949,200525,true,1957696241,28,1946764327,-10931914
1653524997,200528,true,1957109050,28,1946959003,-10150047
1653525001,200529,true,1956913359,28,1946959003,-9954356
1653525189,200528,true,1957109050,28,1948127471,-8981579
1653525242,200527,true,1957304761,28,1948517116,-8787645
1653525260,200529,true,1956913359,28,1948711967,-8201392
1653527849,200530,true,1956717687,28,1957304761,587074
1653528168,200528,true,1957109050,28,1957304761,195711
1653528965,200528,true,1957109050,28,1956717687,-391363
1653529066,200530,true,1956717687,28,1956326402,-391285
1653529096,200530,true,1956717687,28,1956130789,-586898
1653529641,200529,true,1956913359,28,1953980335,-2933024
1653529776,200528,true,1957109050,28,1953198939,-3910111
1653529992,200530,true,1956717687,28,1952027429,-4690258
1653530140,200530,true,1956717687,28,1951441938,-5275749
1653532617,200529,true,1956913359,28,1947348415,-9564944
1653533071,200528,true,1957109050,28,1947348415,-9760635
1653533466,200530,true,1956717687,28,1947348415,-9369272
1653533622,200530,true,1956717687,28,1947348415,-9369272
1653534018,200529,true,1956913359,28,1947737904,-9175455
1653534672,200528,true,1957109050,28,1948517116,-8591934
1653534682,200530,true,1956717687,28,1948517116,-8200571
1653534772,200531,true,1956522035,28,1948517116,-8004919
1653534866,200530,true,1956717687,28,1948517116,-8200571
1653534875,200529,true,1956913359,28,1948517116,-8396243
1653534915,200531,true,1956522035,28,1948322284,-8199751
1653534930,200532,true,1956326402,28,1948322284,-8004118
1653535106,200532,true,1956326402,28,1947737904,-8588498
1653535131,200531,true,1956522035,28,1947543149,-8978886
1653535146,200534,true,1955935195,28,1947543149,-8392046
1653535160,200535,true,1955739621,28,1947543149,-8196472
1653535193,200535,true,1955739621,28,1947348415,-8391206
1653537295,200535,true,1955739621,28,1938024005,-17715616
1653537461,200537,true,1955348532,28,1938411629,-16936903
1653537478,200539,true,1954957521,28,1938411629,-16545892
1653538726,200538,true,1955153017,28,1941515415,-13637602
1653539556,200538,true,1955153017,28,1942486367,-12666650
1653540962,200541,true,1954566588,28,1942486367,-12080221
1653540971,200543,true,1954175734,28,1942486367,-11689367
1653540976,200543,true,1954175734,28,1942486367,-11689367
1653541424,200542,true,1954371151,28,1942097928,-12273223
1653542549,200544,true,1953980335,28,1940739003,-13241332
1653542576,200545,true,1953784957,28,1940739003,-13045954
1653542602,200545,true,1953784957,28,1940544948,-13240009
1653542671,200545,true,1953784957,28,1940350913,-13434044
1653542855,200547,true,1953394259,28,1939574967,-13819292
1653542876,200549,true,1953003638,28,1939574967,-13428671
1653543507,200551,true,1952613096,28,1935893457,-16719639
1653543563,200550,true,1952808358,28,1935506336,-17302022
1653543565,200554,true,1952027429,28,1935506336,-16521093
1653543649,200556,true,1951637082,28,1934538873,-17098209
1653543736,200560,true,1950856623,28,1933378556,-17478067
1653543787,200560,true,1950856623,28,1932798659,-18057964
1653543847,200564,true,1950076475,28,1932218935,-17857540
1653543959,200565,true,1949881487,28,1931060009,-18821478
1653543981,200569,true,1949101729,28,1930866923,-18234806
1653544212,200569,true,1949101729,28,1928551388,-20550341
1653544314,200573,true,1948322284,28,1927587401,-20734883
1653545612,200575,true,1947932678,28,1919892836,-28039842
1653545659,200579,true,1947153699,28,1919892836,-27260863
1653545724,200579,true,1947153699,28,1919700866,-27452833
1653545753,200583,true,1946375032,28,1919700866,-26674166
1653545942,200586,true,1945791237,28,1918549448,-27241789
1653545956,200589,true,1945207616,28,1918357612,-26850004
1653546124,200589,true,1945207616,28,1917782220,-27425396
1653546133,200593,true,1944429727,28,1917590461,-26839266
1653546527,200595,true,1944040900,28,1917015299,-27025601
1653546848,200598,true,1943457804,28,1916440310,-27017494
1653546909,200598,true,1943457804,28,1916440310,-27017494
1653546953,200601,true,1942874883,28,1916248685,-26626198
1653547079,200603,true,1942486367,28,1916057079,-26429288
1653547341,200605,true,1942097928,28,1915673925,-26424003
1653547574,200605,true,1942097928,28,1915290848,-26807080
1653547989,200608,true,1941515415,28,1915865492,-25649923
1653548051,200610,true,1941127170,28,1915865492,-25261678
1653548518,200612,true,1940739003,28,1915865492,-24873511
1653548574,200612,true,1940739003,28,1915865492,-24873511
1653549052,200615,true,1940156898,28,1915865492,-24291406
1653549361,200617,true,1939768924,28,1915865492,-23903432
1653549506,200621,true,1938993211,28,1915865492,-23127719
1653550464,200621,true,1938993211,28,1915482377,-23510834
1653550474,200624,true,1938411629,28,1915482377,-22929252
1653550688,200626,true,1938024005,28,1915673925,-22350080
1653550986,200629,true,1937442714,28,1916248685,-21194029
1653551731,200629,true,1937442714,28,1917782220,-19660494
1653552595,200632,true,1936861597,28,1919700866,-17160731
1653552741,200634,true,1936474283,28,1919700866,-16773417
1653552824,200637,true,1935893457,28,1919700866,-16192591
1653552881,200637,true,1935893457,28,1919700866,-16192591
1653552911,200639,true,1935506336,28,1919700866,-15805470
1653552930,200640,true,1935312805,28,1919700866,-15611939
1653552986,200643,true,1934732327,28,1919508915,-15223412
1653553183,200644,true,1934538873,28,1919125071,-15413802
1653553202,200646,true,1934152024,28,1919125071,-15026953
1653553253,200647,true,1933958628,28,1918933177,-15025451
1653553275,200650,true,1933378556,28,1918741303,-14637253
1653553309,200653,true,1932798659,28,1917973998,-14824661
1653553313,200655,true,1932412157,28,1917782220,-14629937
1653553348,200660,true,1931446241,28,1916631954,-14814287
1653553449,200665,true,1930480807,28,1913567947,-16912860
1653553515,200668,true,1929901779,28,1911464285,-18437494
1653553522,200670,true,1929515856,28,1911273158,-18242698
1653553583,200675,true,1928551388,28,1909172018,-19379370
1653553616,200681,true,1927394662,28,1908026916,-19367746
1653553653,200684,true,1926816559,28,1906691831,-20124728
1653553667,200686,true,1926431254,28,1906310550,-20120704
1653553845,200691,true,1925468327,28,1899840423,-25627904
1653553884,200697,true,1924313450,28,1898321234,-25992216
1653553905,200701,true,1923543917,28,1897562096,-25981821
1653553915,200703,true,1923159266,28,1897182640,-25976626
1653553922,200710,true,1921813593,28,1896992941,-24820652
1653554021,200716,true,1920660908,28,1893013634,-27647274
1653554029,200720,true,1919892836,28,1892824352,-27068484
1653554034,200722,true,1919508915,28,1892445844,-27063071
1653554048,200729,true,1918165796,28,1891878224,-26287572
1653554060,200737,true,1916631954,28,1891310774,-25321180
1653554068,200742,true,1915673925,28,1890932568,-24741357
1653554318,200746,true,1914907847,28,1878494127,-36413720
1653554355,200753,true,1913567947,28,1876616666,-36951281
1653554399,200761,true,1912037782,28,1874553626,-37484156
1653554403,200766,true,1911082050,28,1874366189,-36715861
1653554454,200769,true,1910508840,28,1871931218,-38577622
1653554535,200775,true,1909362935,28,1868378103,-40984832
1653554623,200783,true,1907836132,28,1864458821,-43377311
1653554650,200787,true,1907073189,28,1863154222,-43918967
1653554715,200790,true,1906501181,28,1860175708,-46325473
1653554729,200796,true,1905357681,28,1859431823,-45925858
1653554849,200806,true,1903453370,28,1853120805,-50332565
1653554884,200810,true,1902692179,28,1851268703,-51423476
1653554939,200813,true,1902121486,28,1848678870,-53442616
1653554980,200820,true,1900790533,28,1846646543,-54143990
1653555031,200829,true,1899080677,28,1844432007,-54648670
1653555216,200833,true,1898321234,28,1839826916,-58494318
1653555728,200836,true,1897751852,28,1832299444,-65452408
1653555786,200842,true,1896613599,28,1831566707,-65046892
1653555810,200851,true,1894907500,28,1831383569,-63523931
1653555888,200855,true,1894149727,28,1830834263,-63315464
1653555920,200858,true,1893581595,28,1830834263,-62747332
1653555997,200865,true,1892256618,28,1830285123,-61971495
1653556027,200874,true,1890554438,28,1830102113,-60452325
1653556469,200878,true,1889798406,28,1826811056,-62987350
1653556511,200881,true,1889231580,28,1826445749,-62785831
1653556532,200888,true,1887909646,28,1826445749,-61463897
1653556630,200896,true,1886399998,28,1826811056,-59588942
1653556648,200899,true,1885834191,28,1826993737,-58840454
1653556654,200902,true,1885268554,28,1826993737,-58274817
1653556670,200909,true,1883949394,28,1827176437,-56772957
1653556967,200916,true,1882631157,28,1827541890,-55089267
1653557140,200920,true,1881878292,28,1827541890,-54336402
1653557183,200923,true,1881313842,28,1827541890,-53771952
1653557539,200930,true,1879997449,28,1827724645,-52272804
1653557649,200937,true,1878681977,28,1827724645,-50957332
1653558099,200941,true,1877930692,28,1830102113,-47828579
1653558103,200944,true,1877367425,28,1830102113,-47265312
1653558122,200950,true,1876241399,28,1830285123,-45956276
1653558149,200958,true,1874741081,28,1830468151,-44272930
1653558190,200960,true,1874366189,28,1830834263,-43531926
1653558230,200962,true,1873991372,28,1831200449,-42790923
1653558269,200968,true,1872867371,28,1831749864,-41117507
1653558294,200975,true,1871556888,28,1831933039,-39623849
1653558342,200977,true,1871182632,28,1832299444,-38883188
1653558395,200978,true,1870995533,28,1832849188,-38146345
1653558496,200985,true,1869686360,28,1833582438,-36103922
1653558652,200990,true,1868751797,28,1834682863,-34068934
1653558705,200992,true,1868378103,28,1834682863,-33695240
1653558926,200994,true,1868004483,28,1835049817,-32954666
1653559445,201000,true,1866884072,28,1837253089,-29630983
1653559526,201006,true,1865764334,28,1837620558,-28143776
1653559616,201008,true,1865391237,28,1837804320,-27586917
1653559886,201010,true,1865018215,28,1838907278,-26110937
1653560559,201016,true,1863899595,28,1837804320,-26095275
1653560964,201021,true,1862967925,28,1837988100,-24979825
1653560997,201023,true,1862595387,28,1837804320,-24791067
1653561271,201025,true,1862222924,28,1837620558,-24602366
1653561368,201031,true,1861105981,28,1837620558,-23485423
1653561605,201036,true,1860175708,28,1837620558,-22555150
1653561702,201038,true,1859803728,28,1837620558,-22183170
1653561820,201040,true,1859431823,28,1837620558,-21811265
1653561859,201045,true,1858502386,28,1837436814,-21065572
1653561911,201051,true,1857387675,28,1837253089,-20134586
1653561975,201053,true,1857016253,28,1837069382,-19946871
1653562031,201056,true,1856459260,28,1836702023,-19757237
1653562080,201062,true,1855345774,28,1836518371,-18827403
1653562127,201068,true,1854232956,28,1836151123,-18081833
1653562246,201070,true,1853862165,28,1835600387,-18261778
1653562351,201073,true,1853306117,28,1835049817,-18256300
1653562683,201078,true,1852379742,28,1833949173,-18430569
1653562897,201084,true,1851268703,28,1833215777,-18052926
1653562979,201086,true,1850898505,28,1833032473,-17866032
1653563015,201089,true,1850343347,28,1832849188,-17494159
1653563043,201094,true,1849418452,28,1832665922,-16752530
1653563051,201100,true,1848309190,28,1832665922,-15643268
1653563082,201103,true,1847754808,28,1832482673,-15272135
1653563293,201105,true,1847385312,28,1831566707,-15818605
1653563347,201111,true,1846277269,28,1831200449,-15076820
1653563365,201117,true,1845169890,28,1831017347,-14152543
1653563401,201120,true,1844616450,28,1830834263,-13782187
1653563416,201123,true,1844063176,28,1830651198,-13411978
1653563423,201129,true,1842957125,28,1830651198,-12305927
1653563473,201136,true,1841667571,28,1829919121,-11748450
1653563680,201140,true,1840931088,28,1827359154,-13571934
1653563681,201143,true,1840378919,28,1827359154,-13019765
1653563694,201149,true,1839275078,28,1827176437,-12098641
1653563759,201156,true,1837988100,28,1826628393,-11359707
1653563848,201160,true,1837253089,28,1826080515,-11172574
1653563931,201163,true,1836702023,28,1825532800,-11169223
1653563956,201168,true,1835783948,28,1825350265,-10433683
1653564001,201175,true,1834499413,28,1824802769,-9696644
1653564018,201177,true,1834132568,28,1824620307,-9512261
1653564046,201179,true,1833765796,28,1824255438,-9510358
1653564053,201182,true,1833215777,28,1824255438,-8960339
1653564178,201187,true,1832299444,28,1822432185,-9867259
1653564211,201188,true,1832116232,28,1821885565,-10230667
1653564225,201191,true,1831566707,28,1821703395,-9863312
1653564278,201193,true,1831200449,28,1820792816,-10407633
1653564303,201198,true,1830285123,28,1820428712,-9856411
1653564355,201199,true,1830102113,28,1819700723,-10401390
1653564380,201202,true,1829553192,28,1819336837,-10216355
1653564429,201203,true,1829370255,28,1818609284,-10760971
1653564550,201208,true,1828455844,28,1816973354,-11482490
1653564895,201208,true,1828455844,28,1813524555,-14931289
1653565027,201210,true,1828090208,28,1812436821,-15653387
1653565242,201211,true,1827907417,28,1810625380,-17282037
1653565250,201215,true,1827176437,28,1810625380,-16551057
1653565293,201215,true,1827176437,28,1810444336,-16732101
1653565481,201218,true,1826628393,28,1810444336,-16184057
1653565560,201218,true,1826628393,28,1810444336,-16184057
1653565670,201220,true,1826263123,28,1810444336,-15818787
1653566682,201219,true,1826445749,28,1814431498,-12014251
1653567047,201221,true,1826080515,28,1814068666,-12011849
1653567087,201221,true,1826080515,28,1814250073,-11830442
1653567093,201224,true,1825532800,28,1814250073,-11282727
1653567152,201223,true,1825715353,28,1814250073,-11465280
1653567166,201225,true,1825350265,28,1814250073,-11100192
1653567183,201225,true,1825350265,28,1814431498,-10918767
1653567199,201228,true,1824802769,28,1814431498,-10371271
1653567217,201227,true,1824985250,28,1814431498,-10553752
1653567235,201229,true,1824620307,28,1814612941,-10007366
1653567260,201229,true,1824620307,28,1814794403,-9825904
1653567728,201229,true,1824620307,28,1816791675,-7828632
1653567752,201227,true,1824985250,28,1816791675,-8193575
1653567962,201229,true,1824620307,28,1817336767,-7283540
1653568198,201229,true,1824620307,28,1817700253,-6920054
1653568226,201230,true,1824437864,28,1817700253,-6737611
1653568281,201230,true,1824437864,28,1817700253,-6737611
1653568533,201231,true,1824255438,28,1817700253,-6555185
1653568543,201232,true,1824073031,28,1817700253,-6372778
1653568579,201233,true,1823890642,28,1817882023,-6008619
1653568592,201233,true,1823890642,28,1817882023,-6008619
1653568735,201234,true,1823708271,28,1818063811,-5644460
1653568794,201234,true,1823708271,28,1818063811,-5644460
1653568820,201235,true,1823525918,28,1818063811,-5462107
1653568823,201235,true,1823525918,28,1818063811,-5462107
1653568858,201237,true,1823161268,28,1817882023,-5279245
1653568875,201238,true,1822978970,28,1817700253,-5278717
1653568906,201240,true,1822614429,28,1817518501,-5095928
1653568907,201239,true,1822796690,28,1817518501,-5278189
1653568994,201243,true,1822067754,28,1816610014,-5457740
1653569010,201244,true,1821885565,28,1816428371,-5457194
1653569024,201246,true,1821521243,28,1816246747,-5274496
1653569066,201246,true,1821521243,28,1815701981,-5819262
1653569107,201249,true,1820974896,28,1815157380,-5817516
1653569629,201249,true,1820974896,28,1809358449,-11616447
1653569677,201252,true,1820428712,28,1808815750,-11612962
1653569747,201252,true,1820428712,28,1808273214,-12155498
1653569824,201255,true,1819882693,28,1807730841,-12151852
1653570352,201254,true,1820064681,28,1805021412,-15043269
1653570422,201257,true,1819518771,28,1804660462,-14858309
1653570499,201258,true,1819336837,28,1804299584,-15037253
1653570524,201261,true,1818791145,28,1804299584,-14491561
1653570557,201262,true,1818609284,28,1803938779,-14670505
1653570656,201266,true,1817882023,28,1803037080,-14844943
1653570703,201267,true,1817700253,28,1802856794,-14843459
1653570742,201271,true,1816973354,28,1802676526,-14296828
1653570745,201272,true,1816791675,28,1802676526,-14115149
1653570751,201276,true,1816065140,28,1802496277,-13568863
1653570800,201279,true,1815520429,28,1802135832,-13384597
1653570811,201282,true,1814975882,28,1801955636,-13020246
1653570825,201283,true,1814794403,28,1801775458,-13018945
1653570917,201288,true,1813887278,28,1800334686,-13552592
1653570934,201291,true,1813343220,28,1800154671,-13188549
1653570958,201295,true,1812618064,28,1799614733,-13003331
1653570979,201297,true,1812255595,28,1798895067,-13360528
1653570987,201304,true,1810987523,28,1798715195,-12272328
1653570993,201308,true,1810263310,28,1798535342,-11727968
1653571026,201313,true,1809358449,28,1797456598,-11901851
1653571034,201315,true,1808996632,28,1797276870,-11719762
1653571081,201321,true,1807911614,28,1795839696,-12071918
1653571098,201325,true,1807188630,28,1795480582,-11708048
1653571111,201331,true,1806104696,28,1795121539,-10983157
1653571158,201333,true,1805743529,28,1793686088,-12057441
1653571183,201339,true,1804660462,28,1792789514,-11870948
1653571224,201342,true,1804119172,28,1791714217,-12404955
1653571288,201347,true,1803217383,28,1789923488,-13293895
1653571301,201348,true,1803037080,28,1789565557,-13471523
1653571325,201353,true,1802135832,28,1789028794,-13107038
1653571568,201356,true,1801595299,28,1783135024,-18460275
1653571595,201360,true,1800874841,28,1782600190,-18274651
1653571611,201362,true,1800514720,28,1782243724,-18270996
1653571648,201367,true,1799614733,28,1781352869,-18261864
1653571892,201369,true,1799254864,28,1776017085,-23237779
1653571943,201372,true,1798715195,28,1775306856,-23408339
1653572094,201373,true,1798535342,28,1773000572,-25534770
1653572184,201378,true,1797636344,28,1771937144,-25699200
1653572220,201378,true,1797636344,28,1771405669,-26230675
1653572255,201382,true,1796917469,28,1771051441,-25866028
1653572324,201382,true,1796917469,28,1770343197,-26574272
1653572552,201387,true,1796019280,28,1769635237,-26384043
1653572609,201387,true,1796019280,28,1769635237,-26384043
1653572762,201390,true,1795480582,28,1770874353,-24606229
1653572836,201390,true,1795480582,28,1772468778,-23011804
1653572877,201393,true,1794942045,28,1773355189,-21586856
1653572893,201392,true,1795121539,28,1773709878,-21411661
1653572921,201394,true,1794762569,28,1774774370,-19988199
1653572989,201392,true,1795121539,28,1777082962,-18038577
1653573004,201394,true,1794762569,28,1777616140,-17146429
1653573341,201393,true,1794942045,28,1787419473,-7522572
1653573374,201395,true,1794583110,28,1788313362,-6269748
1653573564,201393,true,1794942045,28,1792610253,-2331792
1653573644,201395,true,1794583110,28,1794583110,0
1653573730,201394,true,1794762569,28,1796558139,1795570
1653573916,201395,true,1794583110,28,1799974674,5391564
1653573953,201393,true,1794942045,28,1800514720,5572675
1653573981,201394,true,1794762569,28,1801054928,6292359
1653573996,201392,true,1795121539,28,1801415157,6293618
1653574009,201392,true,1795121539,28,1801595299,6473760
1653574015,201390,true,1795480582,28,1801775458,6294876
1653574211,201389,true,1795660130,28,1806827246,11167116
1653574228,201387,true,1796019280,28,1807188630,11169350
1653574316,201387,true,1796019280,28,1809177532,13158252
1653574357,201385,true,1796378501,28,1810082301,13703800
1653574378,201384,true,1796558139,28,1810625380,14067241
1653574415,201383,true,1796737795,28,1811530874,14793079
1653574422,201384,true,1796558139,28,1811712027,15153888
1653574496,201381,true,1797097161,28,1814068666,16971505
1653574589,201379,true,1797456598,28,1816791675,19335077
1653574624,201378,true,1797636344,28,1817700253,20063909
1653574633,201378,true,1797636344,28,1817882023,20245679
1653574649,201375,true,1798175688,28,1818427442,20251754
1653574666,201374,true,1798355506,28,1818791145,20435639
1653574800,201374,true,1798355506,28,1820974896,22619390
1653574805,201374,true,1798355506,28,1821156993,22801487
1653574846,201371,true,1798895067,28,1821885565,22990498
1653574849,201370,true,1799074956,28,1821885565,22810609
1653574937,201367,true,1799614733,28,1823525918,23911185
1653574972,201368,true,1799434789,28,1824437864,25003075
1653575030,201364,true,1800154671,28,1825532800,25378129
1653575061,201363,true,1800334686,28,1826445749,26111063
1653575239,201360,true,1800874841,28,1831017347,30142506
1653575326,201361,true,1800694771,28,1833032473,32337702
1653575423,201358,true,1801235034,28,1835233322,33998288
1653575454,201358,true,1801235034,28,1835967526,34732492
1653575458,201355,true,1801775458,28,1835967526,34192068
1653575484,201356,true,1801595299,28,1836518371,34923072
1653575587,201353,true,1802135832,28,1838355716,36219884
1653575656,201353,true,1802135832,28,1839459005,37323173
1653576111,201350,true,1802676526,28,1844616450,41939924
1653576233,201351,true,1802496277,28,1845538943,43042666
1653576628,201347,true,1803217383,28,1847385312,44167929
1653577275,201346,true,1803397705,28,1846461897,43064192
1653577281,201343,true,1803938779,28,1846461897,42523118
1653577322,201344,true,1803758403,28,1846461897,42703494
1653577341,201340,true,1804480014,28,1846646543,42166529
1653577370,201338,true,1804840928,28,1846831207,41990279
1653577442,201334,true,1805562973,28,1847570051,42007078
1653577610,201333,true,1805743529,28,1849048624,43305095
1653577728,201329,true,1806465935,28,1850528381,44062446
1653577754,201326,true,1807007929,28,1850898505,43890576
1653577841,201322,true,1807730841,28,1851824140,44093299
1653578168,201321,true,1807911614,28,1854603821,46692207
1653578211,201316,true,1808815750,28,1854974760,46159010
1653578331,201314,true,1809177532,28,1855716862,46539330
1653578430,201310,true,1809901311,28,1856273632,46372321
1653578470,201310,true,1809901311,28,1856273632,46372321
1653578505,201306,true,1810625380,28,1856459260,45833880
1653578854,201303,true,1811168622,28,1858688236,47519614
1653578896,201299,true,1811893198,28,1859059993,47166795
1653578897,201299,true,1811893198,28,1859059993,47166795
1653579019,201296,true,1812436821,28,1859431823,46995002
1653579109,201293,true,1812980606,28,1859617766,46637160
1653579131,201290,true,1813524555,28,1859431823,45907268
1653579427,201290,true,1813524555,28,1857201955,43677400
1653579490,201287,true,1814068666,28,1856459260,42390594
1653579573,201283,true,1814794403,28,1855716862,40922459
1653579618,201280,true,1815338896,28,1855345774,40006878
1653579633,201279,true,1815520429,28,1855160258,39639829
1653579680,201275,true,1816246747,28,1854974760,38728013
1653579686,201271,true,1816973354,28,1854974760,38001406
1653580506,201265,true,1818063811,28,1854232956,36169145
1653580854,201264,true,1818245617,28,1854603821,36358204
1653580968,201260,true,1818973025,28,1855345774,36372749
1653580995,201255,true,1819882693,28,1855531308,35648615
1653581034,201249,true,1820974896,28,1856088023,35113127
1653581147,201246,true,1821521243,28,1857387675,35866432
1653581358,201240,true,1822614429,28,1860175708,37561279
1653581470,201233,true,1823890642,28,1861478221,37587579
1653581476,201225,true,1825350265,28,1861478221,36127956
1653581487,201221,true,1826080515,28,1861664369,35583854
1653581705,201214,true,1827359154,28,1864458821,37099667
1653581839,201207,true,1828638690,28,1866324119,37685429
1653581910,201200,true,1829919121,28,1867257468,37338347
1653581945,201196,true,1830651198,28,1867817701,37166503
1653581950,201188,true,1832116232,28,1867817701,35701469
1653582039,201180,true,1833582438,28,1869499410,35916972
1653582084,201172,true,1835049817,28,1870434346,35384529
1653582134,201168,true,1835783948,28,1871369751,35585803
1653582221,201160,true,1837253089,28,1873429287,36176198
1653582243,201153,true,1838539552,28,1873803992,35264440
1653582260,201145,true,1840010898,28,1874178771,34167873
1653582267,201141,true,1840747013,28,1874366189,33619176
1653582273,201134,true,1842035923,28,1874366189,32330266
1653582349,201127,true,1843325735,28,1875866207,32540472
1653582852,201121,true,1844432007,28,1884137789,39705782
1653582886,201117,true,1845169890,28,1884514635,39344745
1653582971,201111,true,1846277269,28,1885645627,39368358
1653583245,201105,true,1847385312,28,1888098437,40713125
1653583386,201100,true,1848309190,28,1888664923,40355733
1653583587,201097,true,1848863738,28,1889042675,40178937
1653583636,201091,true,1849973333,28,1889042675,39069342
1653584001,201085,true,1851083595,28,1887532121,36448526
1653584152,201081,true,1851824140,28,1886777297,34953157
1653584478,201078,true,1852379742,28,1885457081,33077339
1653584773,201072,true,1853491448,28,1883949394,30457946
1653584870,201067,true,1854418379,28,1883572660,29154281
1653585084,201063,true,1855160258,28,1882631157,27470899
1653585100,201061,true,1855531308,28,1882442912,26911604
1653585119,201057,true,1856273632,28,1882442912,26169280
1653585127,201053,true,1857016253,28,1882442912,25426659
1653585287,201050,true,1857573414,28,1881501973,23928559
1653585774,201049,true,1857759171,28,1878869845,21110674
1653587512,201045,true,1858502386,28,1873803992,15301606
1653588085,201041,true,1859245899,28,1873803992,14558093
1653588367,201038,true,1859803728,28,1873803992,14000264
1653588386,201037,true,1859989709,28,1873803992,13814283
1653588454,201033,true,1860733816,28,1873803992,13070176
1653589569,201030,true,1861292092,28,1869873328,8581236
1653589588,201027,true,1861850535,28,1869873328,8022793
1653589622,201027,true,1861850535,28,1869686360,7835825
1653589777,201024,true,1862409146,28,1869125566,6716420
1653589791,201023,true,1862595387,28,1868938672,6343285
1653590207,201021,true,1862967925,28,1866510752,3542827
1653590327,201020,true,1863154222,28,1865950910,2796688
1653591052,201017,true,1863713224,28,1863154222,-559002
1653591724,201016,true,1863899595,28,1861664369,-2235226
1653591778,201014,true,1864272394,28,1861478221,-2794173
1653591812,201013,true,1864458821,28,1861478221,-2980600
1653591814,201012,true,1864645267,28,1861478221,-3167046
1653591996,201012,true,1864645267,28,1860919889,-3725378
1653591997,201011,true,1864831732,28,1860919889,-3911843
1653592017,201010,true,1865018215,28,1860733816,-4284399
1653592368,201009,true,1865204717,28,1859803728,-5400989
1653592389,201009,true,1865204717,28,1859803728,-5400989
1653592531,201007,true,1865577776,28,1859245899,-6331877
1653592564,201006,true,1865764334,28,1859059993,-6704341
1653592717,201007,true,1865577776,28,1857573414,-8004362
1653592856,201007,true,1865577776,28,1856273632,-9304144
1653593166,201007,true,1865577776,28,1852564980,-13012796
1653593256,201007,true,1865577776,28,1851453830,-14123946
1653593289,201008,true,1865391237,28,1851083595,-14307642
1653593986,201010,true,1865018215,28,1840931088,-24087127
1653594050,201011,true,1864831732,28,1840010898,-24820834
1653594315,201012,true,1864645267,28,1836518371,-28126896
1653594532,201012,true,1864645267,28,1834682863,-29962404
1653594916,201014,true,1864272394,28,1833032473,-31239921
1653594951,201015,true,1864085985,28,1832849188,-31236797
1653595211,201015,true,1864085985,28,1832116232,-31969753
1653595241,201015,true,1864085985,28,1831933039,-32152946
1653595444,201017,true,1863713224,28,1831566707,-32146517
1653595472,201018,true,1863526871,28,1831383569,-32143302
1653595493,201018,true,1863526871,28,1831383569,-32143302
1653595568,201018,true,1863526871,28,1830834263,-32692608
1653595612,201022,true,1862781647,28,1830651198,-32130449
1653595803,201023,true,1862595387,28,1829187336,-33408051
1653595823,201023,true,1862595387,28,1829004436,-33590951
1653596048,201024,true,1862409146,28,1827176437,-35232709
1653596681,201029,true,1861478221,28,1820974896,-40503325
1653596838,201031,true,1861105981,28,1819518771,-41587210
1653596863,201032,true,1860919889,28,1819336837,-41583052
1653596941,201034,true,1860547761,28,1818791145,-41756616
1653596955,201038,true,1859803728,28,1818609284,-41194444
1653596982,201040,true,1859431823,28,1818609284,-40822539
1653597007,201041,true,1859245899,28,1818427442,-40818457
1653597027,201041,true,1859245899,28,1818427442,-40818457
1653597240,201045,true,1858502386,28,1818427442,-40074944
1653597287,201046,true,1858316554,28,1818609284,-39707270
1653597749,201046,true,1858316554,28,1819882693,-38433861
1653598035,201047,true,1858130741,28,1821521243,-36609498
1653599142,201051,true,1857387675,28,1825167748,-32219927
1653599161,201053,true,1857016253,28,1825167748,-31848505
1653599176,201053,true,1857016253,28,1825350265,-31665988
1653599177,201053,true,1857016253,28,1825350265,-31665988
1653599203,201056,true,1856459260,28,1825350265,-31108995
1653599408,201057,true,1856273632,28,1826628393,-29645239
1653599415,201056,true,1856459260,28,1826628393,-29830867
1653599467,201056,true,1856459260,28,1826993737,-29465523
1653600183,201058,true,1856088023,28,1832665922,-23422101
1653600460,201058,true,1856088023,28,1834315981,-21772042
1653600594,201058,true,1856088023,28,1834866331,-21221692
1653600631,201058,true,1856088023,28,1835049817,-21038206
1653600762,201061,true,1855531308,28,1835233322,-20297986
1653600870,201063,true,1855160258,28,1835416846,-19743412
1653601026,201063,true,1855160258,28,1835967526,-19192732
1653601043,201064,true,1854974760,28,1835967526,-19007234
1653601282,201066,true,1854603821,28,1835233322,-19370499
1653601374,201069,true,1854047551,28,1834499413,-19548138
1653601621,201070,true,1853862165,28,1833215777,-20646388
1653601719,201071,true,1853676797,28,1832482673,-21194124
1653601767,201075,true,1852935512,28,1832116232,-20819280
1653602120,201078,true,1852379742,28,1829370255,-23009487
1653602276,201079,true,1852194523,28,1828273017,-23921506
1653602375,201082,true,1851638976,28,1827907417,-23731559
1653602657,201085,true,1851083595,28,1827359154,-23724441
1653602709,201088,true,1850528381,28,1826993737,-23534644
1653602788,201090,true,1850158331,28,1826628393,-23529938
1653602840,201092,true,1849788355,28,1826445749,-23342606
1653602857,201097,true,1848863738,28,1826445749,-22417989
1653602901,201100,true,1848309190,28,1826445749,-21863441
1653602946,201102,true,1847939583,28,1826445749,-21493834
1653602983,201105,true,1847385312,28,1826445749,-20939563
1653603068,201110,true,1846461897,28,1826445749,-20016148
1653603100,201113,true,1845908069,28,1826445749,-19462320
1653603281,201115,true,1845538943,28,1826993737,-18545206
1653603479,201116,true,1845354407,28,1827907417,-17446990
1653603524,201121,true,1844432007,28,1828090208,-16341799
1653603547,201124,true,1843878788,28,1828273017,-15605771
1653603556,201125,true,1843694418,28,1828273017,-15421401
1653603569,201127,true,1843325735,28,1828455844,-14869891
1653604503,201131,true,1842588589,28,1834866331,-7722258
1653604519,201134,true,1842035923,28,1835049817,-6986106
1653604561,201135,true,1841851737,28,1835233322,-6618415
1653604691,201136,true,1841667571,28,1835783948,-5883623
1653604727,201140,true,1840931088,28,1835783948,-5147140
1653604762,201143,true,1840378919,28,1835783948,-4594971
1653604775,201144,true,1840194899,28,1835967526,-4227373
1653604842,201146,true,1839826916,28,1835967526,-3859390
1653604875,201150,true,1839091169,28,1835783948,-3307221
1653605106,201153,true,1838539552,28,1835416846,-3122706
1653605302,201154,true,1838355716,28,1834499413,-3856303
1653605375,201156,true,1837988100,28,1833949173,-4038927
1653605418,201160,true,1837253089,28,1833765796,-3487293
1653605477,201162,true,1836885693,28,1833215777,-3669916
1653605510,201164,true,1836518371,28,1833032473,-3485898
1653605550,201166,true,1836151123,28,1832482673,-3668450
1653605560,201170,true,1835416846,28,1832482673,-2934173
1653605657,201173,true,1834866331,28,1831383569,-3482762
1653605746,201175,true,1834499413,28,1830285123,-4214290
1653606042,201177,true,1834132568,28,1826993737,-7138831
1653606175,201180,true,1833582438,28,1825532800,-8049638
1653606404,201183,true,1833032473,28,1822796690,-10235783
1653606420,201185,true,1832665922,28,1822614429,-10051493
1653606706,201186,true,1832482673,28,1820974896,-11507777
1653606766,201189,true,1831933039,28,1820792816,-11140223
1653606796,201191,true,1831566707,28,1820610755,-10955952
1653606869,201193,true,1831200449,28,1820064681,-11135768
1653606958,201195,true,1830834263,28,1819336837,-11497426
1653607030,201198,true,1830285123,28,1818609284,-11675839
1653607064,201201,true,1829736147,28,1818245617,-11490530
1653607125,201202,true,1829553192,28,1817700253,-11852939
1653607502,201205,true,1829004436,28,1815883552,-13120884
1653608132,201207,true,1828638690,28,1814068666,-14570024
1653608336,201210,true,1828090208,28,1813343220,-14746988
1653608391,201211,true,1827907417,28,1812980606,-14926811
1653608405,201213,true,1827541890,28,1812980606,-14561284
1653608604,201216,true,1826993737,28,1812255595,-14738142
1653608733,201218,true,1826628393,28,1812255595,-14372798
1653608757,201219,true,1826445749,28,1812255595,-14190154
1653608791,201220,true,1826263123,28,1812074388,-14188735
1653608811,201223,true,1825715353,28,1812074388,-13640965
1653608926,201225,true,1825350265,28,1811530874,-13819391
1653609032,201227,true,1824985250,28,1810987523,-13997727
1653609406,201228,true,1824802769,28,1809177532,-15625237
1653609428,201229,true,1824620307,28,1808996632,-15623675
1653609445,201231,true,1824255438,28,1808996632,-15258806
1653609513,201233,true,1823890642,28,1808454041,-15436601
1653609521,201235,true,1823525918,28,1808273214,-15252704
1653609546,201236,true,1823343584,28,1808092405,-15251179
1653609596,201238,true,1822978970,28,1807550086,-15428884
1653609636,201240,true,1822614429,28,1807188630,-15425799
1653609692,201242,true,1822249960,28,1806646582,-15603378
1653610032,201243,true,1822067754,28,1803938779,-18128975
1653610034,201245,true,1821703395,28,1803938779,-17764616
1653610052,201246,true,1821521243,28,1803758403,-17762840
1653610306,201249,true,1820974896,28,1800514720,-20460176
1653610318,201249,true,1820974896,28,1800334686,-20640210
1653610321,201251,true,1820610755,28,1800334686,-20276069
1653610410,201252,true,1820428712,28,1799074956,-21353756
1653610447,201254,true,1820064681,28,1798535342,-21529339
1653610569,201254,true,1820064681,28,1796917469,-23147212
1653610584,201256,true,1819700723,28,1796737795,-22962928
1653610611,201257,true,1819518771,28,1796558139,-22960632
1653610898,201259,true,1819154922,28,1795301051,-23853871
1653610999,201259,true,1819154922,28,1794942045,-24212877
1653611011,201260,true,1818973025,28,1794762569,-24210456
1653611130,201262,true,1818609284,28,1794403670,-24205614
1653611158,201264,true,1818245617,28,1794403670,-23841947
1653611173,201264,true,1818245617,28,1794224248,-24021369
1653611467,201266,true,1817882023,28,1795121539,-22760484
1653612009,201267,true,1817700253,28,1797097161,-20603092
1653612061,201269,true,1817336767,28,1797276870,-20059897
1653612095,201269,true,1817336767,28,1797456598,-19880169
1653612115,201271,true,1816973354,28,1797456598,-19516756
1653612139,201273,true,1816610014,28,1797636344,-18973670
1653612160,201275,true,1816246747,28,1797636344,-18610403
1653612176,201277,true,1815883552,28,1797636344,-18247208
1653612288,201280,true,1815338896,28,1797456598,-17882298
1653612309,201282,true,1814975882,28,1797456598,-17519284
1653612341,201285,true,1814431498,28,1797456598,-16974900
1653612359,201287,true,1814068666,28,1797276870,-16791796
1653612394,201290,true,1813524555,28,1797097161,-16427394
1653612459,201293,true,1812980606,28,1796737795,-16242811
1653612481,201296,true,1812436821,28,1796558139,-15878682
1653612910,201298,true,1812074388,28,1792251785,-19822603
1653612987,201301,true,1811530874,28,1791355928,-20174946
1653613064,201303,true,1811168622,28,1790281490,-20887132
1653613080,201306,true,1810625380,28,1789923488,-20701892
1653613271,201310,true,1809901311,28,1786347397,-23553914
1653613287,201313,true,1809358449,28,1785990181,-23368268
1653613329,201315,true,1808996632,28,1785454491,-23542141
1653613373,201318,true,1808454041,28,1784562031,-23892010
1653613435,201321,true,1807911614,28,1783670018,-24241596
1653613452,201324,true,1807369349,28,1783313337,-24056012
1653613482,201326,true,1807007929,28,1782600190,-24407739
1653613526,201330,true,1806285307,28,1781531005,-24754302
1653613673,201334,true,1805562973,28,1778327293,-27235680
1653613720,201337,true,1805021412,28,1777260670,-27760742
1653613838,201339,true,1804660462,28,1774596911,-30063551
1653613974,201343,true,1803938779,28,1771759968,-32178811
1653614067,201347,true,1803217383,28,1770343197,-32874186
1653614278,201350,true,1802676526,28,1767159605,-35516921
1653614314,201354,true,1801955636,28,1766629563,-35326073
1653614387,201357,true,1801415157,28,1765923088,-35492069
1653614492,201361,true,1800694771,28,1764687436,-36007335
1653614505,201365,true,1799974674,28,1764510985,-35463689
1653614525,201369,true,1799254864,28,1764158135,-35096729
1653614548,201373,true,1798535342,28,1763981737,-34553605
1653614567,201378,true,1797636344,28,1763628994,-34007350
1653614594,201382,true,1796917469,28,1763276321,-33641148
1653615135,201386,true,1796198881,28,1756237654,-39961227
1653615160,201390,true,1795480582,28,1756062048,-39418534
1653615380,201395,true,1794583110,28,1753956143,-40626967
1653615456,201399,true,1793865457,28,1753605404,-40260053
1653615461,201403,true,1793148090,28,1753605404,-39542686
1653615713,201407,true,1792431010,28,1752728864,-39702146
1653615955,201411,true,1791714217,28,1752378371,-39335846
1653616038,201415,true,1790997710,28,1752378371,-38619339
1653616377,201419,true,1790281490,28,1752378371,-37903119
1653616571,201423,true,1789565557,28,1752904137,-36661420
1653616596,201426,true,1789028794,28,1752904137,-36124657
1653616671,201430,true,1788313362,28,1752904137,-35409225
1653616699,201434,true,1787598215,28,1752904137,-34694078
1653616710,201438,true,1786883354,28,1752728864,-34154490
1653616723,201442,true,1786168780,28,1752728864,-33439916
1653616754,201446,true,1785454491,28,1752553609,-32900882
1653616797,201451,true,1784562031,28,1752378371,-32183660
1653616877,201455,true,1783848385,28,1752027948,-31820437
1653616927,201458,true,1783313337,28,1751677595,-31635742
1653617015,201463,true,1782421948,28,1750802019,-31619929
1653617094,201467,true,1781709158,28,1750276883,-31432275
1653617119,201471,true,1780996652,28,1750101873,-30894779
1653617124,201475,true,1780284431,28,1749926880,-30357551
1653617164,201479,true,1779572496,28,1749576948,-29995548
1653617174,201484,true,1778682976,28,1749576948,-29106028
1653617212,201488,true,1777971681,28,1749402007,-28569674
1653617248,201491,true,1777438396,28,1749227085,-28211311
1653617423,201495,true,1776727598,28,1748177916,-28549682
1653617493,201499,true,1776017085,28,1747828332,-28188753
1653617877,201503,true,1775306856,28,1743638783,-31668073
1653617898,201506,true,1774774370,28,1743464437,-31309933
1653617922,201510,true,1774064638,28,1743115796,-30948842
1653617979,201515,true,1773177872,28,1742592966,-30584906
1653618010,201518,true,1772646025,28,1742244500,-30401525
1653618030,201521,true,1772114337,28,1742070293,-30044044
1653618086,201525,true,1771405669,28,1741896103,-29509566
1653618108,201528,true,1770874353,28,1741721931,-29152422
1653618157,201531,true,1770343197,28,1741896103,-28447094
1653618204,201533,true,1769989182,28,1741896103,-28093079
1653618253,201536,true,1769458291,28,1742070293,-27387998
1653618310,201539,true,1768927560,28,1742244500,-26683060
1653618423,201541,true,1768573827,28,1742767226,-25806601
1653618496,201544,true,1768043361,28,1742941502,-25101859
1653618511,201545,true,1767866575,28,1742941502,-24925073
1653618520,201549,true,1767159605,28,1742941502,-24218103
1653618543,201552,true,1766629563,28,1743115796,-23513767
1653618555,201554,true,1766276290,28,1743115796,-23160494
1653618716,201555,true,1766099680,28,1744510777,-21588903
1653618861,201558,true,1765569956,28,1746081465,-19488491
1653618878,201560,true,1765216895,28,1746256073,-18960822
1653619009,201563,true,1764687436,28,1747304089,-17383347
1653619260,201564,true,1764510985,28,1748877292,-15633693
1653619349,201566,true,1764158135,28,1749751905,-14406230
1653619352,201568,true,1763805357,28,1749751905,-14053452
1653619544,201571,true,1763276321,28,1751677595,-11598726
1653619594,201572,true,1763100011,28,1752027948,-11072063
1653619606,201575,true,1762571187,28,1752027948,-10543239
1653619619,201577,true,1762218725,28,1752203151,-10015574
1653619635,201580,true,1761690165,28,1752203151,-9487014
1653620168,201582,true,1761337880,28,1749926880,-11411000
1653620239,201585,true,1760809584,28,1749402007,-11407577
1653620251,201586,true,1760633521,28,1749402007,-11231514
1653620522,201589,true,1760105437,28,1748352733,-11752704
1653620558,201591,true,1759753468,28,1748352733,-11400735
1653620807,201593,true,1759401570,28,1748527569,-10874001
1653621178,201595,true,1759049743,28,1748877292,-10172451
1653621382,201597,true,1758697986,28,1749402007,-9295979
1653621393,201599,true,1758346299,28,1749402007,-8944292
1653621445,201601,true,1757994682,28,1749751905,-8242777
1653621556,201602,true,1757818901,28,1750977099,-6841802
1653621601,201604,true,1757467389,28,1751677595,-5789794
1653621620,201606,true,1757115949,28,1751852763,-5263186
1653621626,201609,true,1756588919,28,1751852763,-4736156
1653622178,201609,true,1756588919,28,1758697986,2109067
1653622233,201612,true,1756062048,28,1759401570,3339522
1653622282,201613,true,1755886459,28,1759929444,4042985
1653622289,201615,true,1755535335,28,1760105437,4570102
1653622332,201614,true,1755710888,28,1760809584,5098696
1653622471,201615,true,1755535335,28,1762394947,6859612
1653622532,201616,true,1755359799,28,1763276321,7916522
1653622676,201617,true,1755184280,28,1764863905,9679625
1653622720,201616,true,1755359799,28,1765393417,10033618
1653622724,201617,true,1755184280,28,1765393417,10209137
1653623156,201618,true,1755008779,28,1768750685,13741906
1653623291,201620,true,1754657830,28,1769458291,14800461
1653623767,201619,true,1754833296,28,1769458291,14624995
1653624241,201619,true,1754833296,28,1768573827,13740531
1653624345,201621,true,1754482382,28,1767866575,13384193
1653624352,201622,true,1754306951,28,1767689806,13382855
1653624390,201621,true,1754482382,28,1767513054,13030672
1653624416,201621,true,1754482382,28,1767336321,12853939
1653624668,201622,true,1754306951,28,1766099680,11792729
1653624692,201623,true,1754131538,28,1765923088,11791550
1653624756,201622,true,1754306951,28,1765746513,11439562
1653624763,201623,true,1754131538,28,1765746513,11614975
1653624836,201624,true,1753956143,28,1765569956,11613813
1653624943,201624,true,1753956143,28,1765040391,11084248
1653624998,201623,true,1754131538,28,1765040391,10908853
1653625164,201622,true,1754306951,28,1764863905,10556954
1653625168,201623,true,1754131538,28,1764863905,10732367
1653625515,201623,true,1754131538,28,1765569956,11438418
1653625760,201621,true,1754482382,28,1766099680,11617298
1653625867,201620,true,1754657830,28,1766276290,11618460
1653625942,201621,true,1754482382,28,1766276290,11793908
1653625986,201621,true,1754482382,28,1766276290,11793908
1653626025,201619,true,1754833296,28,1766276290,11442994
1653626132,201618,true,1755008779,28,1766099680,11090901
1653626228,201620,true,1754657830,28,1765923088,11265258
1653626459,201620,true,1754657830,28,1764863905,10206075
1653626501,201618,true,1755008779,28,1764687436,9678657
1653626513,201618,true,1755008779,28,1764687436,9678657
1653626555,201619,true,1754833296,28,1764334551,9501255
1653626802,201620,true,1754657830,28,1762747444,8089614
1653626825,201618,true,1755008779,28,1762571187,7562408
1653626829,201617,true,1755184280,28,1762571187,7386907
1653627049,201619,true,1754833296,28,1760281447,5448151
1653627463,201620,true,1754657830,28,1755184280,526450
1653627823,201619,true,1754833296,28,1750451911,-4381385
1653627881,201619,true,1754833296,28,1749751905,-5081391
1653628025,201621,true,1754482382,28,1748352733,-6129649
1653628114,201622,true,1754306951,28,1747828332,-6478619
1653628147,201622,true,1754306951,28,1747653567,-6653384
1653628171,201621,true,1754482382,28,1747478819,-7003563
1653628223,201622,true,1754306951,28,1747304089,-7002862
1653628335,201623,true,1754131538,28,1747129376,-7002162
1653628589,201621,true,1754482382,28,1746954680,-7527702
1653628951,201621,true,1754482382,28,1747653567,-6828815
1653628975,201621,true,1754482382,28,1747653567,-6828815
1653629280,201621,true,1754482382,28,1747828332,-6654050
1653629566,201620,true,1754657830,28,1748527569,-6130261
1653629781,201619,true,1754833296,28,1749227085,-5606211
1653629813,201619,true,1754833296,28,1749227085,-5606211
1653629851,201619,true,1754833296,28,1749402007,-5431289
1653629872,201617,true,1755184280,28,1749402007,-5782273
1653629898,201617,true,1755184280,28,1749227085,-5957195
1653629921,201617,true,1755184280,28,1749227085,-5957195
1653629936,201618,true,1755008779,28,1749052179,-5956600
1653629992,201617,true,1755184280,28,1748702421,-6481859
1653629993,201618,true,1755008779,28,1748702421,-6306358
1653630003,201619,true,1754833296,28,1748527569,-6305727
1653630174,201621,true,1754482382,28,1746256073,-8226309
1653630359,201620,true,1754657830,28,1743115796,-11542034
1653630396,201621,true,1754482382,28,1742418724,-12063658
1653630419,201622,true,1754306951,28,1742070293,-12236658
1653630483,201624,true,1753956143,28,1741025416,-12930727
1653630519,201623,true,1754131538,28,1740677264,-13454274
1653631020,201622,true,1754306951,28,1735636864,-18670087
1653631089,201624,true,1753956143,28,1735116277,-18839866
1653631143,201626,true,1753605404,28,1734422404,-19183000
1653631175,201627,true,1753430061,28,1734075571,-19354490
1653631316,201627,true,1753430061,28,1732862204,-20567857
1653631466,201629,true,1753079428,28,1731303407,-21776021
1653631643,201632,true,1752553609,28,1729573056,-22980553
1653631691,201633,true,1752378371,28,1729054287,-23324084
1653631749,201633,true,1752378371,28,1728881399,-23496972
1653631858,201635,true,1752027948,28,1728708528,-23319420
1653631913,201638,true,1751502445,28,1728708528,-22793917
1653631922,201638,true,1751502445,28,1728708528,-22793917
1653631960,201637,true,1751677595,28,1729054287,-22623308
1653632141,201638,true,1751502445,28,1731649685,-19852760
1653632187,201640,true,1751152197,28,1732342449,-18809748
1653632201,201639,true,1751327312,28,1732515683,-18811629
1653632253,201639,true,1751327312,28,1732862204,-18465108
1653632443,201641,true,1750977099,28,1733035490,-17941609
1653632488,201644,true,1750451911,28,1733035490,-17416421
1653632652,201644,true,1750451911,28,1733035490,-17416421
1653632671,201643,true,1750626956,28,1733035490,-17591466
1653632696,201646,true,1750101873,28,1733035490,-17066383
1653632808,201648,true,1749751905,28,1733208793,-16543112
1653632967,201647,true,1749926880,28,1733902181,-16024699
1653633061,201645,true,1750276883,28,1734248979,-16027904
1653633114,201647,true,1749926880,28,1734422404,-15504476
1653633207,201649,true,1749576948,28,1734942782,-14634166
1653633245,201648,true,1749751905,28,1735289788,-14462117
1653633271,201646,true,1750101873,28,1735463317,-14638556
1653633306,201647,true,1749926880,28,1735984008,-13942872
1653633314,201649,true,1749576948,28,1735984008,-13592940
1653633335,201648,true,1749751905,28,1736331223,-13420682
1653633683,201646,true,1750101873,28,1742244500,-7857373
1653633778,201647,true,1749926880,28,1743290108,-6636772
1653634018,201649,true,1749576948,28,1744859697,-4717251
1653634335,201648,true,1749751905,28,1749926880,174975
1653634479,201646,true,1750101873,28,1752378371,2276498
1653634639,201647,true,1749926880,28,1754657830,4730950
1653634686,201649,true,1749576948,28,1755359799,5782851
1653634694,201648,true,1749751905,28,1755535335,5783430
1653634705,201646,true,1750101873,28,1755710888,5609015
1653634858,201647,true,1749926880,28,1758346299,8419419
1653635305,201648,true,1749751905,28,1763276321,13524416
1653635438,201649,true,1749576948,28,1764158135,14581187
1653635508,201648,true,1749751905,28,1764510985,14759080
1653635540,201648,true,1749751905,28,1764687436,14935531
1653635604,201650,true,1749402007,28,1765216895,15814888
1653635789,201650,true,1749402007,28,1766452918,17050911
1653635846,201649,true,1749576948,28,1766982906,17405958
1653635869,201648,true,1749751905,28,1767159605,17407700
1653635883,201649,true,1749576948,28,1767336321,17759373
1653636084,201648,true,1749751905,28,1769104452,19352547
1653636229,201646,true,1750101873,28,1770520231,20418358
1653636245,201646,true,1750101873,28,1770697284,20595411
1653636309,201647,true,1749926880,28,1771405669,21478789
1653636345,201645,true,1750276883,28,1771759968,21483085
1653636390,201643,true,1750626956,28,1772291549,21664593
1653636452,201642,true,1750802019,28,1773177872,22375853
1653636456,201642,true,1750802019,28,1773177872,22375853
1653636756,201640,true,1751152197,28,1776549943,25397746
1653636813,201638,true,1751502445,28,1777260670,25758225
1653636820,201636,true,1751852763,28,1777260670,25407907
1653636850,201637,true,1751677595,28,1777616140,25938545
1653636957,201635,true,1752027948,28,1778505126,26477178
1653637130,201633,true,1752378371,28,1779928428,27550057
1653637250,201632,true,1752553609,28,1780818570,28264961
1653637271,201634,true,1752203151,28,1780996652,28793501
1653637355,201632,true,1752553609,28,1781531005,28977396
1653637470,201631,true,1752728864,28,1782243724,29514860
1653637635,201630,true,1752904137,28,1782956728,30052591
1653637665,201632,true,1752553609,28,1782956728,30403119
1653637681,201630,true,1752904137,28,1782956728,30052591
1653637921,201629,true,1753079428,28,1781887329,28807901
1653638243,201628,true,1753254736,28,1780106421,26851685
1653638311,201629,true,1753079428,28,1779216635,26137207
1653638335,201628,true,1753254736,28,1779038731,25783995
1653638417,201626,true,1753605404,28,1777971681,24366277
1653638593,201626,true,1753605404,28,1775484387,21878983
1653638633,201627,true,1753430061,28,1774951848,21521787
1653638641,201625,true,1753780765,28,1774774370,20993605
1653638703,201624,true,1753956143,28,1773887249,19931106
1653638822,201625,true,1753780765,28,1771937144,18156379
1653638872,201625,true,1753780765,28,1771051441,17270676
1653638929,201623,true,1754131538,28,1770343197,16211659
1653638944,201622,true,1754306951,28,1770166181,15859230
1653638982,201621,true,1754482382,28,1769812200,15329818
1653639042,201620,true,1754657830,28,1769458291,14800461
1653639116,201617,true,1755184280,28,1769104452,13920172
1653639184,201616,true,1755359799,28,1768750685,13390886
1653639222,201616,true,1755359799,28,1768573827,13214028
1653639236,201616,true,1755359799,28,1768573827,13214028
1653639247,201613,true,1755886459,28,1768573827,12687368
1653639400,201611,true,1756237654,28,1768573827,12336173
1653639449,201611,true,1756237654,28,1768573827,12336173
1653639487,201610,true,1756413278,28,1768750685,12337407
1653639877,201607,true,1756940255,28,1770697284,13757029
1653640230,201605,true,1757291660,28,1772646025,15354365
1653640306,201604,true,1757467389,28,1773177872,15710483
1653640789,201603,true,1757643136,28,1778149478,20506342
1653641472,201600,true,1758170482,28,1778327293,20156811
1653641492,201598,true,1758522134,28,1778327293,19805159
1653641505,201597,true,1758697986,28,1778327293,19629307
1653641563,201596,true,1758873856,28,1777971681,19097825
1653641868,201593,true,1759401570,28,1776549943,17148373
1653641958,201590,true,1759929444,28,1776017085,16087641
1653642027,201589,true,1760105437,28,1775661935,15556498
1653642098,201587,true,1760457475,28,1775306856,14849381
1653642133,201584,true,1760985665,28,1774951848,13966183
1653642395,201582,true,1761337880,28,1773355189,12017309
1653642440,201581,true,1761514014,28,1773000572,11486558
1653642555,201578,true,1762042521,28,1772291549,10249028
1653643185,201576,true,1762394947,28,1768043361,5648414
1653643338,201574,true,1762747444,28,1767336321,4588877
1653643430,201573,true,1762923719,28,1766982906,4059187
1653643476,201571,true,1763276321,28,1766982906,3706585
1653643582,201569,true,1763628994,28,1766629563,3000569
1653643592,201567,true,1763981737,28,1766629563,2647826
1653643924,201566,true,1764158135,28,1766452918,2294783
1653644293,201563,true,1764687436,28,1767159605,2472169
1653644337,201561,true,1765040391,28,1767336321,2295930
1653644350,201559,true,1765393417,28,1767336321,1942904
1653644525,201557,true,1765746513,28,1767866575,2120062
1653644736,201554,true,1766276290,28,1768750685,2474395
1653645151,201551,true,1766806226,28,1770343197,3536971
1653645233,201551,true,1766806226,28,1770697284,3891058
1653645303,201551,true,1766806226,28,1771051441,4245215
1653645346,201548,true,1767336321,28,1771405669,4069348
1653645379,201545,true,1767866575,28,1771582809,3716234
1653646710,201543,true,1768220166,28,1778505126,10284960
1653646802,201542,true,1768396988,28,1778860845,10463857
1653647031,201539,true,1768927560,28,1779750453,10822893
1653647114,201536,true,1769458291,28,1780106421,10648130
1653647219,201534,true,1769812200,28,1779928428,10116228
1653647452,201532,true,1770166181,28,1779750453,9584272
1653647569,201530,true,1770520231,28,1779394556,8874325
1653647584,201527,true,1771051441,28,1779394556,8343115
1653647623,201525,true,1771405669,28,1779216635,7810966
1653647776,201525,true,1771405669,28,1778682976,7277307
1653648056,201523,true,1771759968,28,1776905271,5145303
1653648293,201521,true,1772114337,28,1775484387,3370050
1653648497,201520,true,1772291549,28,1773532525,1240976
1653648887,201520,true,1772291549,28,1769635237,-2656312
1653649001,201520,true,1772291549,28,1768573827,-3717722
1653649078,201519,true,1772468778,28,1767866575,-4602203
1653649236,201519,true,1772468778,28,1766452918,-6015860
1653649250,201520,true,1772291549,28,1766276290,-6015259
1653649252,201519,true,1772468778,28,1766276290,-6192488
1653649666,201519,true,1772468778,28,1763452649,-9016129
1653649936,201519,true,1772468778,28,1762394947,-10073831
1653649967,201520,true,1772291549,28,1762218725,-10072824
1653650017,201519,true,1772468778,28,1762042521,-10426257
1653650109,201518,true,1772646025,28,1762042521,-10603504
1653650203,201518,true,1772646025,28,1762218725,-10427300
1653650661,201520,true,1772291549,28,1763276321,-9015228
1653650674,201520,true,1772291549,28,1763452649,-8838900
1653650705,201519,true,1772468778,28,1763452649,-9016129
1653650754,201519,true,1772468778,28,1763805357,-8663421
1653650799,201519,true,1772468778,28,1763981737,-8487041
1653650845,201519,true,1772468778,28,1764334551,-8134227
1653650988,201518,true,1772646025,28,1765569956,-7076069
1653651006,201517,true,1772823289,28,1765746513,-7076776
1653651239,201518,true,1772646025,28,1768396988,-4249037
1653651697,201517,true,1772823289,28,1773532525,709236
1653651871,201517,true,1772823289,28,1775306856,2483567
1653651934,201517,true,1772823289,28,1775839501,3016212
1653651951,201517,true,1772823289,28,1775839501,3016212
1653651997,201517,true,1772823289,28,1776194687,3371398
1653652053,201517,true,1772823289,28,1776372306,3549017
1653652134,201518,true,1772646025,28,1776905271,4259246
1653652306,201519,true,1772468778,28,1777616140,5147362
1653652350,201519,true,1772468778,28,1777793902,5325124
1653652779,201520,true,1772291549,28,1778149478,5857929
1653652782,201521,true,1772114337,28,1778149478,6035141
1653652846,201522,true,1771937144,28,1777793902,5856758
1653652931,201522,true,1771937144,28,1777260670,5323526
1653653695,201524,true,1771582809,28,1771405669,-177140
1653653902,201524,true,1771582809,28,1770520231,-1062578
1653653945,201525,true,1771405669,28,1770343197,-1062472
1653653955,201525,true,1771405669,28,1770343197,-1062472
1653654020,201526,true,1771228546,28,1770343197,-885349
1653654071,201525,true,1771405669,28,1770520231,-885438
1653654095,201526,true,1771228546,28,1770520231,-708315
1653654131,201525,true,1771405669,28,1770697284,-708385
1653654253,201525,true,1771405669,28,1771582809,177140
1653654267,201523,true,1771759968,28,1771759968,0
1653654635,201522,true,1771937144,28,1775129343,3192199
1653654678,201522,true,1771937144,28,1775839501,3902357
1653654697,201521,true,1772114337,28,1776017085,3902748
1653654729,201519,true,1772468778,28,1776549943,4081165
1653654816,201516,true,1773000572,28,1777793902,4793330
1653654887,201516,true,1773000572,28,1778860845,5860273
1653654952,201515,true,1773177872,28,1779928428,6750556
1653654967,201512,true,1773709878,28,1780106421,6396543
1653655008,201509,true,1774242044,28,1780818570,6576526
1653655271,201506,true,1774774370,28,1786347397,11573027
1653655301,201506,true,1774774370,28,1786883354,12108984
1653655400,201503,true,1775306856,28,1789386618,14079762
1653655639,201499,true,1776017085,28,1795480582,19463497
1653655804,201497,true,1776372306,28,1799434789,23062483
1653656075,201497,true,1776372306,28,1804119172,27746866
1653656105,201494,true,1776905271,28,1804480014,27574743
1653656151,201490,true,1777616140,28,1805021412,27405272
1653656213,201489,true,1777793902,28,1805924104,28130202
1653656284,201489,true,1777793902,28,1806646582,28852680
1653656893,201488,true,1777971681,28,1811168622,33196941
1653657014,201484,true,1778682976,28,1811349739,32666763
1653657334,201483,true,1778860845,28,1810444336,31583491
1653657818,201484,true,1778682976,28,1808092405,29409429
1653657838,201482,true,1779038731,28,1807911614,28872883
1653657850,201479,true,1779572496,28,1807730841,28158345
1653657966,201478,true,1779750453,28,1806827246,27076793
1653657994,201479,true,1779572496,28,1806646582,27074086
1653658262,201478,true,1779750453,28,1805021412,25270959
1653658303,201475,true,1780284431,28,1804840928,24556497
1653658486,201473,true,1780640506,28,1804299584,23659078
1653658507,201473,true,1780640506,28,1804299584,23659078
1653658822,201472,true,1780818570,28,1803397705,22579135
1653658885,201468,true,1781531005,28,1803217383,21686378
1653658888,201467,true,1781709158,28,1803217383,21508225
1653659097,201466,true,1781887329,28,1803397705,21510376
1653659102,201464,true,1782243724,28,1803217383,20973659
1653659236,201460,true,1782956728,28,1803217383,20260655
1653659579,201459,true,1783135024,28,1803037080,19902056
1653659641,201459,true,1783135024,28,1803037080,19902056
1653659646,201456,true,1783670018,28,1803037080,19367062
1653659694,201453,true,1784205172,28,1803397705,19192533
1653659721,201450,true,1784740488,28,1803578045,18837557
1653659815,201449,true,1784918962,28,1804299584,19380622
1653660059,201447,true,1785275963,28,1806285307,21009344
1653660397,201444,true,1785811600,28,1808092405,22280805
1653660421,201441,true,1786347397,28,1808092405,21745008
1653660457,201441,true,1786347397,28,1808273214,21925817
1653660474,201438,true,1786883354,28,1808273214,21389860
1653660477,201436,true,1787240749,28,1808273214,21032465
1653660499,201434,true,1787598215,28,1808273214,20674999
1653660956,201435,true,1787419473,28,1807911614,20492141
1653660968,201432,true,1787955753,28,1807730841,19775088
1653661086,201430,true,1788313362,28,1807550086,19236724
1653661152,201429,true,1788492193,28,1807369349,18877156
1653661297,201430,true,1788313362,28,1806827246,18513884
1653661518,201428,true,1788671042,28,1805562973,16891931
1653661829,201426,true,1789028794,28,1803217383,14188589
1653661915,201425,true,1789207697,28,1802676526,13468829
1653661931,201426,true,1789028794,28,1802496277,13467483
1653661933,201425,true,1789207697,28,1802496277,13288580
1653662038,201423,true,1789565557,28,1801235034,11669477
1653662096,201422,true,1789744513,28,1800514720,10770207
1653662203,201424,true,1789386618,28,1798895067,9508449
1653662432,201423,true,1789565557,28,1796198881,6633324
1653662610,201421,true,1789923488,28,1794583110,4659622
1653662638,201419,true,1790281490,28,1794224248,3942758
1653662673,201421,true,1789923488,28,1793865457,3941969
1653662777,201420,true,1790102480,28,1792431010,2328530
1653662784,201418,true,1790460518,28,1792431010,1970492
1653662797,201416,true,1790818628,28,1792251785,1433157
1653662823,201418,true,1790460518,28,1791893388,1432870
1653662909,201417,true,1790639564,28,1790460518,-179046
1653662925,201416,true,1790818628,28,1790281490,-537138
1653663158,201415,true,1790997710,28,1786526031,-4471679
1653663169,201416,true,1790818628,28,1786347397,-4471231
1653663430,201416,true,1790818628,28,1781887329,-8931299
1653663638,201414,true,1791176810,28,1777971681,-13205129
1653663721,201413,true,1791355928,28,1776549943,-14805985
1653663731,201415,true,1790997710,28,1776372306,-14625404
1653663744,201416,true,1790818628,28,1776194687,-14623941
1653663775,201414,true,1791176810,28,1775661935,-15514875
1653663825,201414,true,1791176810,28,1774951848,-16224962
1653663895,201417,true,1790639564,28,1773709878,-16929686
1653664235,201417,true,1790639564,28,1768750685,-21888879
1653664272,201417,true,1790639564,28,1768220166,-22419398
1653664571,201417,true,1790639564,28,1764510985,-26128579
1653664595,201420,true,1790102480,28,1764334551,-25767929
1653664607,201420,true,1790102480,28,1764334551,-25767929
1653664636,201420,true,1790102480,28,1764158135,-25944345
1653664653,201420,true,1790102480,28,1764158135,-25944345
1653664845,201422,true,1789744513,28,1764334551,-25409962
1653665472,201423,true,1789565557,28,1764863905,-24701652
1653665749,201423,true,1789565557,28,1766276290,-23289267
1653665985,201422,true,1789744513,28,1767866575,-21877938
1653666953,201423,true,1789565557,28,1770520231,-19045326
1653667020,201424,true,1789386618,28,1770520231,-18866387
1653667066,201424,true,1789386618,28,1770343197,-19043421
1653667094,201423,true,1789565557,28,1770343197,-19222360
1653667128,201425,true,1789207697,28,1770166181,-19041516
1653667138,201426,true,1789028794,28,1770166181,-18862613
1653667489,201426,true,1789028794,28,1768927560,-20101234
1653667531,201425,true,1789207697,28,1768750685,-20457012
1653667543,201426,true,1789028794,28,1768750685,-20278109
1653667583,201427,true,1788849909,28,1768396988,-20452921
1653667716,201428,true,1788671042,28,1767336321,-21334721
1653667845,201428,true,1788671042,28,1766099680,-22571362
1653667867,201429,true,1788492193,28,1766099680,-22392513
1653667894,201431,true,1788134548,28,1765923088,-22211460
1653667920,201432,true,1787955753,28,1765746513,-22209240
1653668151,201430,true,1788313362,28,1765393417,-22919945
1653668172,201433,true,1787776975,28,1765216895,-22560080
1653668175,201435,true,1787419473,28,1765216895,-22202578
1653668184,201436,true,1787240749,28,1765216895,-22023854
1653668515,201436,true,1787240749,28,1763805357,-23435392
1653668559,201438,true,1786883354,28,1763628994,-23254360
1653668569,201440,true,1786526031,28,1763452649,-23073382
1653668591,201443,true,1785990181,28,1763276321,-22713860
1653668602,201443,true,1785990181,28,1763276321,-22713860
1653668638,201446,true,1785454491,28,1762923719,-22530772
1653668830,201448,true,1785097453,28,1761337880,-23759573
1653668938,201451,true,1784562031,28,1760809584,-23752447
1653668947,201452,true,1784383593,28,1760633521,-23750072
1653669005,201456,true,1783670018,28,1760281447,-23388571
1653669483,201459,true,1783135024,28,1757467389,-25667635
1653669905,201463,true,1782421948,28,1754833296,-27588652
1653669971,201465,true,1782065517,28,1754306951,-27758566
1653670372,201469,true,1781352869,28,1752027948,-29324921
1653670398,201472,true,1780818570,28,1752027948,-28790622
1653670403,201476,true,1780106421,28,1752027948,-28078473
1653671099,201478,true,1779750453,28,1748527569,-31222884
1653671181,201482,true,1779038731,28,1748352733,-30685998
1653671359,201485,true,1778505126,28,1748003115,-30502011
1653671433,201488,true,1777971681,28,1747828332,-30143349
1653671838,201490,true,1777616140,28,1747828332,-29787808
1653671855,201494,true,1776905271,28,1747828332,-29076939
1653671861,201496,true,1776549943,28,1747828332,-28721611
1653671873,201500,true,1775839501,28,1747828332,-28011169
1653671887,201502,true,1775484387,28,1747653567,-27830820
1653672025,201506,true,1774774370,28,1746430699,-28343671
1653672109,201508,true,1774419469,28,1745732301,-28687168
1653672176,201512,true,1773709878,28,1745034183,-28675695
1653672180,201515,true,1773177872,28,1745034183,-28143689
1653672304,201520,true,1772291549,28,1743987529,-28304020
1653672366,201523,true,1771759968,28,1743638783,-28121185
1653672399,201527,true,1771051441,28,1743464437,-27587004
1653672422,201529,true,1770697284,28,1743464437,-27232847
1653672643,201533,true,1769989182,28,1742941502,-27047680
1653672847,201536,true,1769458291,28,1742418724,-27039567
1653672857,201540,true,1768750685,28,1742418724,-26331961
1653673052,201543,true,1768220166,28,1741199519,-27020647
1653673391,201547,true,1767513054,28,1738415966,-29097088
1653673517,201550,true,1766982906,28,1737199562,-29783344
1653673637,201554,true,1766276290,28,1736157607,-30118683
1653673860,201558,true,1765569956,28,1735463317,-30106639
1653674143,201563,true,1764687436,28,1735810427,-28877009
1653674197,201566,true,1764158135,28,1735636864,-28521271
1653674477,201570,true,1763452649,28,1734075571,-29377078
1653675449,201574,true,1762747444,28,1730957198,-31790246
1653675514,201579,true,1761866334,28,1730611059,-31255275
1653675534,201583,true,1761161764,28,1730611059,-30550705
1653675649,201587,true,1760457475,28,1729918988,-30538487
1653675797,201591,true,1759753468,28,1728708528,-31044940
1653676097,201596,true,1758873856,28,1726808090,-32065766
1653676249,201599,true,1758346299,28,1726290151,-32056148
1653676314,201603,true,1757643136,28,1725944944,-31698192
1653676530,201608,true,1756764578,28,1725082231,-31682347
1653676555,201611,true,1756237654,28,1724909740,-31327914
1653676558,201615,true,1755535335,28,1724909740,-30625595
1653676610,201619,true,1754833296,28,1724737266,-30096030
1653676884,201623,true,1754131538,28,1724392370,-29739168
1653676958,201626,true,1753605404,28,1724047544,-29557860
1653676972,201630,true,1752904137,28,1724047544,-28856593
1653677019,201633,true,1752378371,28,1723875156,-28503215
1653677313,201637,true,1751677595,28,1722152229,-29525366
1653677554,201640,true,1751152197,28,1721635686,-29516511
1653677720,201644,true,1750451911,28,1721463540,-28988371
1653677741,201646,true,1750101873,28,1721463540,-28638333
1653677847,201650,true,1749402007,28,1721463540,-27938467
1653678085,201653,true,1748877292,28,1721463540,-27413752
1653678093,201656,true,1748352733,28,1721463540,-26889193
1653678149,201658,true,1748003115,28,1721635686,-26367429
1653678228,201662,true,1747304089,28,1721807850,-25496239
1653678333,201664,true,1746954680,28,1721980031,-24974649
1653678582,201666,true,1746605342,28,1721980031,-24625311
1653678696,201668,true,1746256073,28,1721807850,-24448223
1653679116,201671,true,1745732301,28,1723185778,-22546523
1653679280,201674,true,1745208686,28,1723702786,-21505900
1653679899,201675,true,1745034183,28,1724909740,-20124443
1653680109,201677,true,1744685228,28,1725082231,-19602997
1653680355,201680,true,1744161927,28,1725254739,-18907188
1653680474,201682,true,1743813147,28,1725599807,-18213340
1653680680,201683,true,1743638783,28,1726117539,-17521244
1653680994,201684,true,1743464437,28,1727326184,-16138253
1653681011,201686,true,1743115796,28,1727326184,-15789612
1653681201,201687,true,1742941502,28,1729918988,-13022514
1653681215,201687,true,1742941502,28,1730091979,-12849523
1653681247,201686,true,1743115796,28,1730611059,-12504737
1653681282,201688,true,1742767226,28,1731130294,-11636932
1653681302,201688,true,1742767226,28,1731476538,-11290688
1653681433,201687,true,1742941502,28,1734248979,-8692523
1653681461,201686,true,1743115796,28,1734942782,-8173014
1653681484,201689,true,1742592966,28,1735289788,-7303178
1653681538,201690,true,1742418724,28,1736331223,-6087501
1653681565,201689,true,1742592966,28,1736852174,-5740792
1653681606,201689,true,1742592966,28,1737547019,-5045947
1653681641,201692,true,1742070293,28,1738068335,-4001958
1653681861,201694,true,1741721931,28,1741025416,-696515
1653681894,201693,true,1741896103,28,1741547776,-348327
1653681904,201693,true,1741896103,28,1741721931,-174172
1653681956,201695,true,1741547776,28,1742767226,1219450
1653682005,201696,true,1741373639,28,1743638783,2265144
1653682085,201694,true,1741721931,28,1745034183,3312252
1653682093,201694,true,1741721931,28,1745208686,3486755
1653682177,201696,true,1741373639,28,1746780002,5406363
1653682220,201696,true,1741373639,28,1747653567,6279928
1653682228,201695,true,1741547776,28,1747828332,6280556
1653682393,201692,true,1742070293,28,1750977099,8906806
1653682427,201694,true,1741721931,28,1751502445,9780514
1653682449,201694,true,1741721931,28,1751852763,10130832
1653682973,201694,true,1741721931,28,1757643136,15921205
1653683065,201692,true,1742070293,28,1757994682,15924389
1653683104,201696,true,1741373639,28,1758170482,16796843
1653683791,201696,true,1741373639,28,1759577511,18203872
1653683921,201695,true,1741547776,28,1759577511,18029735
1653684061,201694,true,1741721931,28,1759225648,17503717
1653684108,201697,true,1741199519,28,1759049743,17850224
1653684786,201697,true,1741199519,28,1759049743,17850224
1653684791,201696,true,1741373639,28,1759049743,17676104
1653684823,201695,true,1741547776,28,1759049743,17501967
1653684926,201697,true,1741199519,28,1758873856,17674337
1653684959,201697,true,1741199519,28,1758697986,17498467
1653685082,201697,true,1741199519,28,1757994682,16795163
1653685150,201695,true,1741547776,28,1757643136,16095360
1653685161,201698,true,1741025416,28,1757643136,16617720
1653685489,201698,true,1741025416,28,1755359799,14334383
1653686018,201697,true,1741199519,28,1752203151,11003632
1653686255,201696,true,1741373639,28,1750977099,9603460
1653687275,201698,true,1741025416,28,1748352733,7327317
1653687402,201699,true,1740851331,28,1748177916,7326585
1653688026,201698,true,1741025416,28,1747653567,6628151
1653688068,201697,true,1741199519,28,1747653567,6454048
1653688200,201698,true,1741025416,28,1747478819,6453403
1653688588,201699,true,1740851331,28,1747129376,6278045
1653688626,201698,true,1741025416,28,1746954680,5929264
1653688658,201697,true,1741199519,28,1746780002,5580483
1653688792,201700,true,1740677264,28,1745732301,5055037
1653688807,201701,true,1740503213,28,1745732301,5229088
1653688840,201701,true,1740503213,28,1745383207,4879994
1653688847,201700,true,1740677264,28,1745383207,4705943
1653688919,201702,true,1740329180,28,1744685228,4356048
1653688996,201703,true,1740155165,28,1743987529,3832364
1653689116,201702,true,1740329180,28,1742941502,2612322
1653689250,201700,true,1740677264,28,1742070293,1393029
1653689307,201703,true,1740155165,28,1741896103,1740938
1653689362,201702,true,1740329180,28,1741721931,1392751
1653689484,201701,true,1740503213,28,1740851331,348118
1653689544,201699,true,1740851331,28,1740503213,-348118
1653689595,201702,true,1740329180,28,1740329180,0
1653689673,201703,true,1740155165,28,1739807186,-347979
1653689849,201702,true,1740329180,28,1739111437,-1217743
1653690245,201699,true,1740851331,28,1737894546,-2956785
1653690451,201702,true,1740329180,28,1737720774,-2608406
1653690553,201702,true,1740329180,28,1738068335,-2260845
1653690647,201700,true,1740677264,28,1738763667,-1913597
1653690762,201697,true,1741199519,28,1739807186,-1392333
1653690962,201699,true,1740851331,28,1741199519,348188
1653691078,201699,true,1740851331,28,1741896103,1044772
1653691697,201697,true,1741199519,28,1745208686,4009167
1653692080,201694,true,1741721931,28,1746430699,4708768
1653692254,201696,true,1741373639,28,1746954680,5581041
1653692448,201695,true,1741547776,28,1747129376,5581600
1653692513,201694,true,1741721931,28,1746954680,5232749
1653692530,201691,true,1742244500,28,1746954680,4710180
1653692540,201691,true,1742244500,28,1746954680,4710180
1653692794,201691,true,1742244500,28,1746430699,4186199
1653692906,201689,true,1742592966,28,1746256073,3663107
1653693028,201686,true,1743115796,28,1745906874,2791078
1653693073,201686,true,1743115796,28,1745732301,2616505
1653693129,201687,true,1742941502,28,1745383207,2441705
1653693144,201685,true,1743290108,28,1745208686,1918578
1653693421,201684,true,1743464437,28,1743464437,0
1653693504,201685,true,1743290108,28,1742767226,-522882
1653693532,201685,true,1743290108,28,1742418724,-871384
1653693599,201684,true,1743464437,28,1741721931,-1742506
1653693835,201683,true,1743638783,28,1739111437,-4527346
1653693880,201683,true,1743638783,28,1738589808,-5048975
1653693918,201683,true,1743638783,28,1738242142,-5396641
1653693926,201682,true,1743813147,28,1738068335,-5744812
1653693997,201681,true,1743987529,28,1737199562,-6787967
1653694269,201682,true,1743813147,28,1733555453,-10257694
1653694589,201683,true,1743638783,28,1729746013,-13892770
1653694831,201682,true,1743813147,28,1726635426,-17177721
1653694988,201682,true,1743813147,28,1724737266,-19075881
1653695183,201683,true,1743638783,28,1723185778,-20453005
1653696014,201684,true,1743464437,28,1720086989,-23377448
1653696346,201683,true,1743638783,28,1720086989,-23551794
1653696392,201683,true,1743638783,28,1720086989,-23551794
1653696628,201684,true,1743464437,28,1721119299,-22345138
1653696898,201684,true,1743464437,28,1723013477,-20450960
1653696915,201683,true,1743638783,28,1723013477,-20625306
1653697041,201682,true,1743813147,28,1724219948,-19593199
1653697274,201682,true,1743813147,28,1726117539,-17695608
1653697290,201682,true,1743813147,28,1726290151,-17522996
1653697468,201681,true,1743987529,28,1727671666,-16315863
1653697544,201681,true,1743987529,28,1728362839,-15624690
1653697744,201681,true,1743987529,28,1729918988,-14068541
1653697835,201682,true,1743813147,28,1730611059,-13202088
1653697976,201682,true,1743813147,28,1731476538,-12336609
1653698060,201684,true,1743464437,28,1732169232,-11295205
1653698252,201684,true,1743464437,28,1733208793,-10255644
1653698308,201686,true,1743115796,28,1733382114,-9733682
1653698470,201687,true,1742941502,28,1734075571,-8865931
1653698492,201689,true,1742592966,28,1734075571,-8517395
1653698519,201690,true,1742418724,28,1734248979,-8169745
1653698771,201691,true,1742244500,28,1735289788,-6954712
1653698861,201691,true,1742244500,28,1735463317,-6781183
1653698920,201693,true,1741896103,28,1735636864,-6259239
1653699062,201693,true,1741896103,28,1735984008,-5912095
1653699181,201693,true,1741896103,28,1736157607,-5738496
1653699211,201694,true,1741721931,28,1736157607,-5564324
1653699643,201695,true,1741547776,28,1737894546,-3653230
1653699969,201696,true,1741373639,28,1739459277,-1914362
1653700493,201697,true,1741199519,28,1742070293,870774
1653701141,201697,true,1741199519,28,1743987529,2788010
1653701276,201698,true,1741025416,28,1743987529,2962113
1653701292,201699,true,1740851331,28,1744161927,3310596
1653701336,201700,true,1740677264,28,1743987529,3310265
1653702151,201702,true,1740329180,28,1741025416,696236
1653702183,201704,true,1739981167,28,1740851331,870164
1653702223,201704,true,1739981167,28,1740677264,696097
1653702804,201706,true,1739633223,28,1736678506,-2954717
1653702945,201707,true,1739459277,28,1735636864,-3822413
1653703041,201709,true,1739111437,28,1734942782,-4168655
1653703053,201710,true,1738937543,28,1734942782,-3994761
1653704197,201712,true,1738589808,28,1731130294,-7459514
1653704244,201713,true,1738415966,28,1730957198,-7458768
1653704366,201715,true,1738068335,28,1730957198,-7111137
1653704447,201716,true,1737894546,28,1730784120,-7110426
1653705325,201717,true,1737720774,28,1732342449,-5378325
1653705376,201718,true,1737547019,28,1732342449,-5204570
1653705400,201720,true,1737199562,28,1732342449,-4857113
1653705403,201720,true,1737199562,28,1732342449,-4857113
1653705411,201721,true,1737025859,28,1732342449,-4683410
1653705442,201723,true,1736678506,28,1732342449,-4336057
1653705473,201724,true,1736504856,28,1732342449,-4162407
1653705527,201725,true,1736331223,28,1732169232,-4161991
1653705556,201726,true,1736157607,28,1732169232,-3988375
1653706136,201728,true,1735810427,28,1730957198,-4853229
1653707039,201729,true,1735636864,28,1727326184,-8310680
1653707594,201730,true,1735463317,28,1726462780,-9000537
1653707678,201730,true,1735463317,28,1726462780,-9000537
1653707753,201732,true,1735116277,28,1726980770,-8135507
1653707785,201733,true,1734942782,28,1727153468,-7789314
1653707855,201732,true,1735116277,28,1727671666,-7444611
1653707912,201732,true,1735116277,28,1728190020,-6926257
1653707970,201733,true,1734942782,28,1728535675,-6407107
1653708038,201734,true,1734769305,28,1729400116,-5369189
1653708057,201732,true,1735116277,28,1729573056,-5543221
1653708061,201730,true,1735463317,28,1729573056,-5890261
1653708124,201731,true,1735289788,28,1730091979,-5197809
1653708149,201732,true,1735116277,28,1730264989,-4851288
1653708225,201730,true,1735463317,28,1730957198,-4506119
1653708252,201728,true,1735810427,28,1731130294,-4680133
1653708406,201729,true,1735636864,28,1732688935,-2947929
1653708439,201730,true,1735463317,28,1733035490,-2427827
1653708547,201728,true,1735810427,28,1734075571,-1734856
1653708630,201726,true,1736157607,28,1734942782,-1214825
1653708643,201727,true,1735984008,28,1734942782,-1041226
1653708671,201729,true,1735636864,28,1735289788,-347076
1653708728,201726,true,1736157607,28,1735810427,-347180
1653708737,201724,true,1736504856,28,1735984008,-520848
1653708982,201726,true,1736157607,28,1738589808,2432201
1653709107,201728,true,1735810427,28,1739981167,4170740
1653709194,201725,true,1736331223,28,1741373639,5042416
1653709202,201723,true,1736678506,28,1741373639,4695133
1653709251,201724,true,1736504856,28,1742070293,5565437
1653709370,201727,true,1735984008,28,1743464437,7480429
1653709438,201725,true,1736331223,28,1744336344,8005121
1653709733,201722,true,1736852174,28,1747129376,10277202
1653709825,201723,true,1736678506,28,1747653567,10975061
1653710035,201725,true,1736331223,28,1749227085,12895862
1653710250,201723,true,1736678506,28,1750626956,13948450
1653710791,201720,true,1737199562,28,1754482382,17282820
1653711888,201721,true,1737025859,28,1757818901,20793042
1653713687,201723,true,1736678506,28,1757818901,21140395
1653713758,201720,true,1737199562,28,1757994682,20795120
1653713797,201717,true,1737720774,28,1757994682,20273908
1653713913,201718,true,1737547019,28,1758170482,20623463
1653714616,201719,true,1737373282,28,1759049743,21676461
1653714637,201717,true,1737720774,28,1759049743,21328969
1653715744,201714,true,1738242142,28,1759401570,21159428
1653716037,201714,true,1738242142,28,1759401570,21159428
1653716053,201714,true,1738242142,28,1759401570,21159428
1653716118,201712,true,1738589808,28,1759225648,20635840
1653716388,201708,true,1739285348,28,1760809584,21524236
1653717018,201706,true,1739633223,28,1766982906,27349683
1653717295,201705,true,1739807186,28,1769458291,29651105
1653717314,201702,true,1740329180,28,1769635237,29306057
1653717390,201698,true,1741025416,28,1770343197,29317781
1653717529,201696,true,1741373639,28,1771405669,30032030
1653717541,201695,true,1741547776,28,1771582809,30035033
1653717565,201692,true,1742070293,28,1771759968,29689675
1653717613,201687,true,1742941502,28,1772114337,29172835
1653717670,201686,true,1743115796,28,1772468778,29352982
1653717704,201685,true,1743290108,28,1772646025,29355917
1653717797,201682,true,1743813147,28,1773177872,29364725
1653718176,201677,true,1744685228,28,1774064638,29379410
1653718288,201676,true,1744859697,28,1773709878,28850181
1653718765,201675,true,1745034183,28,1771759968,26725785
1653718821,201672,true,1745557745,28,1771405669,25847924
1653718872,201668,true,1746256073,28,1771228546,24972473
1653719182,201667,true,1746430699,28,1770166181,23735482
1653719279,201667,true,1746430699,28,1769812200,23381501
1653719530,201664,true,1746954680,28,1769458291,22503611
1653720237,201661,true,1747478819,28,1768750685,21271866
1653721480,201661,true,1747478819,28,1768396988,20918169
1653721686,201660,true,1747653567,28,1768396988,20743421
1653721722,201658,true,1748003115,28,1768396988,20393873
1653721794,201654,true,1748702421,28,1768396988,19694567
1653721907,201654,true,1748702421,28,1768396988,19694567
1653722545,201653,true,1748877292,28,1767866575,18989283
1653722593,201651,true,1749227085,28,1767866575,18639490
1653722772,201648,true,1749751905,28,1767513054,17761149
1653723191,201647,true,1749926880,28,1766629563,16702683
1653723352,201647,true,1749926880,28,1765746513,15819633
1653723356,201645,true,1750276883,28,1765746513,15469630
1653723485,201643,true,1750626956,28,1765040391,14413435
1653723539,201643,true,1750626956,28,1764687436,14060480
1653723881,201643,true,1750626956,28,1763100011,12473055
1653724132,201641,true,1750977099,28,1761866334,10889235
1653724429,201639,true,1751327312,28,1760457475,9130163
1653724532,201639,true,1751327312,28,1760105437,8778125
1653724952,201639,true,1751327312,28,1759225648,7898336
1653725026,201637,true,1751677595,28,1759401570,7723975
1653725237,201635,true,1752027948,28,1760281447,8253499
1653725301,201635,true,1752027948,28,1760633521,8605573
1653725553,201635,true,1752027948,28,1761866334,9838386
1653725684,201633,true,1752378371,28,1762571187,10192816
1653726352,201630,true,1752904137,28,1765569956,12665819
1653726475,201629,true,1753079428,28,1765923088,12843660
1653726516,201629,true,1753079428,28,1765923088,12843660
1653726631,201627,true,1753430061,28,1766099680,12669619
1653726668,201624,true,1753956143,28,1766099680,12143537
1653726703,201623,true,1754131538,28,1766099680,11968142
1653726768,201623,true,1754131538,28,1765923088,11791550
1653727310,201622,true,1754306951,28,1761866334,7559383
1653727449,201619,true,1754833296,28,1760809584,5976288
1653727510,201618,true,1755008779,28,1760633521,5624742
1653728403,201618,true,1755008779,28,1756588919,1580140
1653729227,201616,true,1755359799,28,1758346299,2986500
1653729312,201614,true,1755710888,28,1758346299,2635411
1653729358,201613,true,1755886459,28,1758346299,2459840
1653729382,201613,true,1755886459,28,1758346299,2459840
1653730549,201612,true,1756062048,28,1758346299,2284251
1653731104,201609,true,1756588919,28,1758346299,1757380
1653731161,201607,true,1756940255,28,1758170482,1230227
1653731214,201607,true,1756940255,28,1758170482,1230227
1653731224,201605,true,1757291660,28,1758170482,878822
1653731402,201603,true,1757643136,28,1757818901,175765
1653731563,201601,true,1757994682,28,1757643136,-351546
1653731659,201601,true,1757994682,28,1757467389,-527293
1653731959,201599,true,1758346299,28,1757115949,-1230350
1653732055,201597,true,1758697986,28,1756940255,-1757731
1653732907,201595,true,1759049743,28,1756062048,-2987695
1653732921,201595,true,1759049743,28,1756062048,-2987695
1653733097,201595,true,1759049743,28,1755886459,-3163284
1653733103,201594,true,1759225648,28,1755886459,-3339189
1653733546,201592,true,1759577511,28,1755710888,-3866623
1653733818,201592,true,1759577511,28,1755710888,-3866623
1653734053,201593,true,1759401570,28,1755710888,-3690682
1653734112,201591,true,1759753468,28,1755710888,-4042580
1653734369,201590,true,1759929444,28,1755886459,-4042985
1653734473,201589,true,1760105437,28,1755886459,-4218978
1653734675,201589,true,1760105437,28,1755886459,-4218978
1653734747,201588,true,1760281447,28,1756062048,-4219399
1653734763,201587,true,1760457475,28,1756062048,-4395427
1653734897,201587,true,1760457475,28,1756062048,-4395427
1653735356,201587,true,1760457475,28,1756413278,-4044197
1653735425,201586,true,1760633521,28,1756413278,-4220243
1653735874,201585,true,1760809584,28,1756413278,-4396306
1653736164,201584,true,1760985665,28,1756413278,-4572387
1653736246,201584,true,1760985665,28,1756764578,-4221087
1653736343,201583,true,1761161764,28,1757291660,-3870104
1653736420,201582,true,1761337880,28,1757643136,-3694744
1653736515,201580,true,1761690165,28,1758170482,-3519683
1653736526,201581,true,1761514014,28,1758170482,-3343532
1653736843,201579,true,1761866334,28,1760105437,-1760897
1653737032,201578,true,1762042521,28,1761161764,-880757
1653737054,201576,true,1762394947,28,1761337880,-1057067
1653737068,201577,true,1762218725,28,1761514014,-704711
1653737103,201576,true,1762394947,28,1761866334,-528613
1653737356,201573,true,1762923719,28,1765040391,2116672
1653738205,201572,true,1763100011,28,1774596911,11496900
1653738457,201572,true,1763100011,28,1776372306,13272295
1653738533,201571,true,1763276321,28,1776727598,13451277
1653738652,201569,true,1763628994,28,1777438396,13809402
1653738751,201567,true,1763981737,28,1778149478,14167741
1653738769,201568,true,1763805357,28,1778149478,14344121
1653738824,201567,true,1763981737,28,1778505126,14523389
1653739231,201565,true,1764334551,28,1777793902,13459351
1653739675,201564,true,1764510985,28,1776727598,12216613
1653740089,201565,true,1764334551,28,1775839501,11504950
1653740711,201564,true,1764510985,28,1774419469,9908484
1653740749,201562,true,1764863905,28,1774242044,9378139
1653740837,201561,true,1765040391,28,1774242044,9201653
1653740840,201562,true,1764863905,28,1774242044,9378139
1653741354,201561,true,1765040391,28,1775306856,10266465
1653741441,201561,true,1765040391,28,1775484387,10443996
1653741903,201560,true,1765216895,28,1776549943,11333048
1653742128,201561,true,1765040391,28,1777260670,12220279
1653742212,201561,true,1765040391,28,1777438396,12398005
1653742249,201560,true,1765216895,28,1777616140,12399245
1653742432,201559,true,1765393417,28,1778505126,13111709
1653742622,201560,true,1765216895,28,1779750453,14533558
1653743358,201559,true,1765393417,28,1782421948,17028531
1653743547,201558,true,1765569956,28,1783135024,17565068
1653743697,201557,true,1765746513,28,1783848385,18101872
1653743846,201557,true,1765746513,28,1784383593,18637080
1653743888,201556,true,1765923088,28,1784562031,18638943
1653743915,201555,true,1766099680,28,1784740488,18640808
1653744316,201553,true,1766452918,28,1786883354,20430436
1653744692,201552,true,1766629563,28,1788134548,21504985
1653744816,201551,true,1766806226,28,1788313362,21507136
1653745458,201551,true,1766806226,28,1788849909,22043683
1653746427,201549,true,1767159605,28,1787062043,19902438
1653747042,201549,true,1767159605,28,1786704684,19545079
1653747153,201548,true,1767336321,28,1786704684,19368363
1653749263,201547,true,1767513054,28,1783135024,15621970
1653749303,201546,true,1767689806,28,1783135024,15445218
1653749343,201546,true,1767689806,28,1783135024,15445218
1653749522,201545,true,1767866575,28,1783135024,15268449
1653749736,201544,true,1768043361,28,1782956728,14913367
1653750235,201543,true,1768220166,28,1782600190,14380024
1653751003,201543,true,1768220166,28,1780996652,12776486
1653751433,201542,true,1768396988,28,1780640506,12243518
1653751693,201542,true,1768396988,28,1780818570,12421582
1653751720,201539,true,1768927560,28,1780818570,11891010
1653751854,201539,true,1768927560,28,1781174752,12247192
1653751943,201537,true,1769281363,28,1781531005,12249642
1653752051,201535,true,1769635237,28,1782600190,12964953
1653752135,201532,true,1770166181,28,1783491669,13325488
1653752349,201531,true,1770343197,28,1785990181,15646984
1653752407,201529,true,1770697284,28,1786704684,16007400
1653752471,201527,true,1771051441,28,1787598215,16546774
1653752572,201524,true,1771582809,28,1788849909,17267100
1653752634,201523,true,1771759968,28,1789744513,17984545
1653752781,201521,true,1772114337,28,1791355928,19241591
1653752933,201519,true,1772468778,28,1792968793,20500015
1653752939,201517,true,1772823289,28,1792968793,20145504
1653753020,201516,true,1773000572,28,1793686088,20685516
1653753615,201515,true,1773177872,28,1798535342,25357470
1653754070,201513,true,1773532525,28,1797995889,24463364
1653754202,201511,true,1773887249,28,1797276870,23389621
1653754589,201510,true,1774064638,28,1795480582,21415944
1653754645,201509,true,1774242044,28,1795301051,21059007
1653755027,201507,true,1774596911,28,1793506737,18909826
1653755266,201505,true,1774951848,28,1792431010,17479162
1653755319,201503,true,1775306856,28,1792251785,16944929
1653755568,201502,true,1775484387,28,1791714217,16229830
1653756567,201500,true,1775839501,28,1791535063,15695562
1653756593,201498,true,1776194687,28,1791355928,15161241
1653756594,201497,true,1776372306,28,1791355928,14983622
1653756614,201495,true,1776727598,28,1791355928,14628330
1653756634,201495,true,1776727598,28,1791176810,14449212
1653756677,201493,true,1777082962,28,1790997710,13914748
1653756719,201492,true,1777260670,28,1790818628,13557958
1653756783,201491,true,1777438396,28,1790460518,13022122
1653756820,201491,true,1777438396,28,1790102480,12664084
1653756838,201489,true,1777793902,28,1789923488,12129586
1653756869,201488,true,1777971681,28,1789744513,11772832
1653756912,201487,true,1778149478,28,1789386618,11237140
1653756925,201487,true,1778149478,28,1789207697,11058219
1653756965,201486,true,1778327293,28,1788671042,10343749
1653756972,201485,true,1778505126,28,1788671042,10165916
1653757005,201485,true,1778505126,28,1788134548,9629422
1653757013,201485,true,1778505126,28,1788134548,9629422
1653757025,201485,true,1778505126,28,1787776975,9271849
1653757075,201484,true,1778682976,28,1787062043,8379067
1653757090,201484,true,1778682976,28,1786704684,8021708
1653757105,201484,true,1778682976,28,1786526031,7843055
1653757117,201484,true,1778682976,28,1786347397,7664421
1653757119,201484,true,1778682976,28,1786168780,7485804
1653757124,201483,true,1778860845,28,1786168780,7307935
1653757136,201484,true,1778682976,28,1785990181,7307205
1653757147,201483,true,1778860845,28,1785811600,6950755
1653757180,201482,true,1779038731,28,1785275963,6237232
1653757441,201481,true,1779216635,28,1781887329,2670694
1653758150,201482,true,1779038731,28,1769635237,-9403494
1653758183,201482,true,1779038731,28,1769104452,-9934279
1653758222,201480,true,1779394556,28,1768573827,-10820729
1653758292,201480,true,1779394556,28,1767159605,-12234951
1653758354,201481,true,1779216635,28,1766099680,-13116955
1653758445,201481,true,1779216635,28,1765040391,-14176244
1653758480,201479,true,1779572496,28,1764863905,-14708591
1653758789,201478,true,1779750453,28,1764158135,-15592318
1653758929,201480,true,1779394556,28,1764863905,-14530651
1653759062,201480,true,1779394556,28,1764863905,-14530651
1653759726,201479,true,1779572496,28,1766806226,-12766270
1653759958,201478,true,1779750453,28,1767689806,-12060647
1653760594,201479,true,1779572496,28,1769458291,-10114205
1653760799,201479,true,1779572496,28,1769812200,-9760296
1653760895,201478,true,1779750453,28,1770166181,-9584272
1653761656,201477,true,1779928428,28,1772291549,-7636879
1653761796,201480,true,1779394556,28,1772646025,-6748531
1653762692,201480,true,1779394556,28,1776017085,-3377471
1653762983,201479,true,1779572496,28,1776905271,-2667225
1653763060,201477,true,1779928428,28,1777260670,-2667758
1653764372,201480,true,1779394556,28,1780462460,1067904
1653765667,201479,true,1779572496,28,1782065517,2493021
1653765739,201478,true,1779750453,28,1782065517,2315064
1653765816,201477,true,1779928428,28,1782243724,2315296
1653766168,201479,true,1779572496,28,1782421948,2849452
1653766226,201478,true,1779750453,28,1782421948,2671495
1653766795,201476,true,1780106421,28,1782421948,2315527
1653767224,201475,true,1780284431,28,1782421948,2137517
1653767373,201477,true,1779928428,28,1782956728,3028300
1653767448,201476,true,1780106421,28,1783135024,3028603
1653767508,201474,true,1780462460,28,1783313337,2850877
1653768012,201473,true,1780640506,28,1785454491,4813985
1653768749,201474,true,1780462460,28,1788492193,8029733
1653769155,201474,true,1780462460,28,1789923488,9461028
1653770125,201472,true,1780818570,28,1789923488,9104918
1653770178,201470,true,1781174752,28,1789923488,8748736
1653770927,201472,true,1780818570,28,1789565557,8746987
1653771185,201472,true,1780818570,28,1789386618,8568048
1653771260,201471,true,1780996652,28,1789207697,8211045
1653771641,201470,true,1781174752,28,1788492193,7317441
1653771652,201472,true,1780818570,28,1788492193,7673623
1653771725,201471,true,1780996652,28,1788492193,7495541
1653771901,201470,true,1781174752,28,1788492193,7317441
1653772001,201469,true,1781352869,28,1788492193,7139324
1653773259,201471,true,1780996652,28,1790102480,9105828
1653773721,201471,true,1780996652,28,1790460518,9463866
1653774661,201470,true,1781174752,28,1789923488,8748736
1653774985,201469,true,1781352869,28,1789565557,8212688
1653775027,201471,true,1780996652,28,1789565557,8568905
1653775038,201471,true,1780996652,28,1789565557,8568905
1653775178,201470,true,1781174752,28,1789386618,8211866
1653775208,201469,true,1781352869,28,1789386618,8033749
1653775282,201470,true,1781174752,28,1789207697,8032945
1653776653,201471,true,1780996652,28,1784026770,3030118
1653777829,201470,true,1781174752,28,1782600190,1425438
1653779409,201469,true,1781352869,28,1782600190,1247321
1653779485,201470,true,1781174752,28,1782956728,1781976
1653779844,201471,true,1780996652,28,1784205172,3208520
1653779990,201469,true,1781352869,28,1784740488,3387619
1653780499,201467,true,1781709158,28,1786526031,4816873
1653780922,201468,true,1781531005,28,1788313362,6782357
1653781030,201469,true,1781352869,28,1788849909,7497040
1653781250,201468,true,1781531005,28,1789744513,8213508
1653781516,201466,true,1781887329,28,1790639564,8752235
1653781884,201468,true,1781531005,28,1792251785,10720780
1653781902,201468,true,1781531005,28,1792251785,10720780
1653782393,201468,true,1781531005,28,1794044843,12513838
1653782495,201466,true,1781887329,28,1794403670,12516341
1653782503,201469,true,1781352869,28,1794403670,13050801
1653782524,201469,true,1781352869,28,1794403670,13050801
1653782774,201470,true,1781174752,28,1795121539,13946787
1653783321,201468,true,1781531005,28,1795480582,13949577
1653783729,201470,true,1781174752,28,1794224248,13049496
1653784919,201471,true,1780996652,28,1791535063,10538411
1653785251,201471,true,1780996652,28,1791176810,10180158
1653785282,201469,true,1781352869,28,1791176810,9823941
1653785300,201471,true,1780996652,28,1791176810,10180158
1653785644,201472,true,1780818570,28,1791176810,10358240
1653785686,201472,true,1780818570,28,1791176810,10358240
1653785751,201470,true,1781174752,28,1791176810,10002058
1653786069,201471,true,1780996652,28,1790997710,10001058
1653786149,201472,true,1780818570,28,1790818628,10000058
1653786152,201472,true,1780818570,28,1790818628,10000058
1653786369,201470,true,1781174752,28,1790460518,9285766
1653786869,201472,true,1780818570,28,1789744513,8925943
1653787066,201473,true,1780640506,28,1789386618,8746112
1653787176,201473,true,1780640506,28,1789207697,8567191
1653787257,201471,true,1780996652,28,1789207697,8211045
1653787692,201471,true,1780996652,28,1788492193,7495541
1653787751,201472,true,1780818570,28,1788313362,7494792
1653787756,201472,true,1780818570,28,1788313362,7494792
1653787776,201469,true,1781352869,28,1788313362,6960493
1653787802,201469,true,1781352869,28,1788313362,6960493
1653787825,201470,true,1781174752,28,1788134548,6959796
1653787853,201470,true,1781174752,28,1788134548,6959796
1653787874,201467,true,1781709158,28,1788134548,6425390
1653787914,201468,true,1781531005,28,1787955753,6424748
1653787933,201468,true,1781531005,28,1787776975,6245970
1653788001,201467,true,1781709158,28,1787598215,5889057
1653788116,201464,true,1782243724,28,1787240749,4997025
1653788187,201464,true,1782243724,28,1786883354,4639630
1653788381,201464,true,1782243724,28,1785990181,3746457
1653788438,201463,true,1782421948,28,1785811600,3389652
1653788526,201460,true,1782956728,28,1785454491,2497763
1653788585,201460,true,1782956728,28,1785275963,2319235
1653788655,201460,true,1782956728,28,1784740488,1783760
1653788692,201459,true,1783135024,28,1784562031,1427007
1653789285,201456,true,1783670018,28,1780996652,-2673366
1653789818,201456,true,1783670018,28,1778327293,-5342725
1653789867,201456,true,1783670018,28,1778149478,-5520540
1653789957,201456,true,1783670018,28,1777971681,-5698337
1653790277,201454,true,1784026770,28,1776905271,-7121499
1653790297,201454,true,1784026770,28,1776727598,-7299172
1653790377,201454,true,1784026770,28,1776194687,-7832083
1653790930,201455,true,1783848385,28,1773000572,-10847813
1653792440,201453,true,1784205172,28,1766982906,-17222266
1653793339,201452,true,1784383593,28,1766982906,-17400687
1653793923,201453,true,1784205172,28,1766982906,-17222266
1653794081,201454,true,1784026770,28,1766982906,-17043864
1653794193,201453,true,1784205172,28,1767159605,-17045567
1653794919,201453,true,1784205172,28,1767159605,-17045567
1653795556,201454,true,1784026770,28,1767336321,-16690449
1653795659,201454,true,1784026770,28,1767336321,-16690449
1653795739,201453,true,1784205172,28,1767513054,-16692118
1653796251,201453,true,1784205172,28,1767866575,-16338597
1653796371,201454,true,1784026770,28,1768043361,-15983409
1653796399,201455,true,1783848385,28,1768043361,-15805024
1653796439,201454,true,1784026770,28,1768043361,-15983409
1653796454,201454,true,1784026770,28,1768043361,-15983409
1653796549,201455,true,1783848385,28,1768220166,-15628219
1653796646,201456,true,1783670018,28,1768396988,-15273030
1653796652,201455,true,1783848385,28,1768396988,-15451397
1653796662,201456,true,1783670018,28,1768396988,-15273030
1653796840,201457,true,1783491669,28,1768750685,-14740984
1653797637,201458,true,1783313337,28,1770343197,-12970140
1653798718,201457,true,1783491669,28,1771228546,-12263123
1653799294,201458,true,1783313337,28,1771228546,-12084791
1653799502,201459,true,1783135024,28,1771228546,-11906478
1653799531,201460,true,1782956728,28,1771228546,-11728182
1653799550,201460,true,1782956728,28,1771405669,-11551059
1653799661,201460,true,1782956728,28,1771405669,-11551059
1653799752,201462,true,1782600190,28,1771405669,-11194521
1653799890,201463,true,1782421948,28,1771405669,-11016279
1653799967,201463,true,1782421948,28,1771405669,-11016279
1653800076,201464,true,1782243724,28,1771405669,-10838055
1653800196,201465,true,1782065517,28,1771405669,-10659848
1653801005,201467,true,1781709158,28,1771759968,-9949190
1653801411,201467,true,1781709158,28,1771937144,-9772014
1653801983,201467,true,1781709158,28,1772646025,-9063133
1653802067,201469,true,1781352869,28,1772823289,-8529580
1653802138,201470,true,1781174752,28,1772823289,-8351463
1653802873,201469,true,1781352869,28,1774774370,-6578499
1653803035,201470,true,1781174752,28,1775129343,-6045409
1653803200,201471,true,1780996652,28,1775484387,-5512265
1653803219,201472,true,1780818570,28,1775484387,-5334183
1653803565,201472,true,1780818570,28,1776017085,-4801485
1653803788,201472,true,1780818570,28,1776372306,-4446264
1653803967,201474,true,1780462460,28,1776372306,-4090154
1653803975,201475,true,1780284431,28,1776549943,-3734488
1653804019,201475,true,1780284431,28,1776549943,-3734488
1653804041,201475,true,1780284431,28,1776549943,-3734488
1653804105,201476,true,1780106421,28,1776727598,-3378823
1653804324,201476,true,1780106421,28,1777438396,-2668025
1653805995,201476,true,1780106421,28,1782600190,2493769
1653806111,201476,true,1780106421,28,1782600190,2493769
1653806603,201476,true,1780106421,28,1782421948,2315527
1653806613,201476,true,1780106421,28,1782421948,2315527
1653806757,201476,true,1780106421,28,1782421948,2315527
1653806853,201476,true,1780106421,28,1782421948,2315527
1653806881,201476,true,1780106421,28,1782421948,2315527
1653806968,201477,true,1779928428,28,1782421948,2493520
1653807582,201477,true,1779928428,28,1782065517,2137089
1653808510,201478,true,1779750453,28,1781887329,2136876
1653809436,201478,true,1779750453,28,1781887329,2136876
1653809455,201478,true,1779750453,28,1781887329,2136876
1653810479,201479,true,1779572496,28,1781887329,2314833
1653810731,201480,true,1779394556,28,1781887329,2492773
1653811317,201480,true,1779394556,28,1781887329,2492773
1653811731,201481,true,1779216635,28,1781531005,2314370
1653812136,201482,true,1779038731,28,1780996652,1957921
1653812177,201483,true,1778860845,28,1780996652,2135807
1653812234,201484,true,1778682976,28,1780996652,2313676
1653812246,201484,true,1778682976,28,1780996652,2313676
1653812340,201485,true,1778505126,28,1780996652,2491526
1653812477,201485,true,1778505126,28,1781174752,2669626
1653812543,201485,true,1778505126,28,1781352869,2847743
1653812721,201486,true,1778327293,28,1781709158,3381865
1653812814,201486,true,1778327293,28,1781887329,3560036
1653812851,201486,true,1778327293,28,1781887329,3560036
1653812967,201486,true,1778327293,28,1782243724,3916431
1653813010,201486,true,1778327293,28,1782421948,4094655
1653813049,201487,true,1778149478,28,1782421948,4272470
1653813050,201487,true,1778149478,28,1782421948,4272470
1653814078,201486,true,1778327293,28,1787598215,9270922
1653814152,201487,true,1778149478,28,1787955753,9806275
1653814261,201487,true,1778149478,28,1788313362,10163884
1653814323,201487,true,1778149478,28,1788492193,10342715
1653814380,201486,true,1778327293,28,1788492193,10164900
1653814415,201486,true,1778327293,28,1788492193,10164900
1653814574,201487,true,1778149478,28,1788671042,10521564
1653815164,201487,true,1778149478,28,1788492193,10342715
1653815207,201486,true,1778327293,28,1788313362,9986069
1653815211,201487,true,1778149478,28,1788313362,10163884
1653815219,201487,true,1778149478,28,1788313362,10163884
1653815229,201487,true,1778149478,28,1788313362,10163884
1653815252,201486,true,1778327293,28,1788313362,9986069
1653815344,201487,true,1778149478,28,1788134548,9985070
1653815376,201487,true,1778149478,28,1788134548,9985070
1653815471,201487,true,1778149478,28,1787776975,9627497
1653815523,201486,true,1778327293,28,1787598215,9270922
1653815529,201486,true,1778327293,28,1787598215,9270922
1653815629,201487,true,1778149478,28,1787419473,9269995
1653815643,201486,true,1778327293,28,1787240749,8913456
1653815724,201486,true,1778327293,28,1787062043,8734750
1653815759,201486,true,1778327293,28,1786883354,8556061
1653815979,201486,true,1778327293,28,1786168780,7841487
1653816045,201486,true,1778327293,28,1785811600,7484307
1653816145,201485,true,1778505126,28,1785454491,6949365
1653816152,201485,true,1778505126,28,1785275963,6770837
1653816202,201486,true,1778327293,28,1785097453,6770160
1653816365,201485,true,1778505126,28,1784383593,5878467
1653816813,201485,true,1778505126,28,1782421948,3916822
1653816816,201485,true,1778505126,28,1782421948,3916822
1653816822,201485,true,1778505126,28,1782421948,3916822
1653816834,201485,true,1778505126,28,1782243724,3738598
1653816848,201484,true,1778682976,28,1782243724,3560748
1653816986,201483,true,1778860845,28,1781531005,2670160
1653817149,201483,true,1778860845,28,1780818570,1957725
1653817290,201482,true,1779038731,28,1780462460,1423729
1653817436,201481,true,1779216635,28,1779928428,711793
1653817738,201481,true,1779216635,28,1779216635,0
1653817994,201481,true,1779216635,28,1778682976,-533659
1653818356,201480,true,1779394556,28,1778505126,-889430
1653818791,201479,true,1779572496,28,1778327293,-1245203
1653818811,201479,true,1779572496,28,1778505126,-1067370
1653818917,201478,true,1779750453,28,1778505126,-1245327
1653818955,201478,true,1779750453,28,1778682976,-1067477
1653818991,201476,true,1780106421,28,1778682976,-1423445
1653819056,201476,true,1780106421,28,1779038731,-1067690
1653819087,201475,true,1780284431,28,1779038731,-1245700
1653819311,201474,true,1780462460,28,1780106421,-356039
1653819445,201473,true,1780640506,28,1780996652,356146
1653819465,201472,true,1780818570,28,1781174752,356182
1653819479,201472,true,1780818570,28,1781174752,356182
1653819507,201470,true,1781174752,28,1781352869,178117
1653819723,201469,true,1781352869,28,1783135024,1782155
1653819784,201468,true,1781531005,28,1783670018,2139013
1653820346,201467,true,1781709158,28,1788134548,6425390
1653820594,201466,true,1781887329,28,1790102480,8215151
1653820833,201464,true,1782243724,28,1791535063,9291339
1653820884,201464,true,1782243724,28,1791893388,9649664
1653820900,201463,true,1782421948,28,1791893388,9471440
1653821009,201462,true,1782600190,28,1792251785,9651595
1653821120,201460,true,1782956728,28,1792610253,9653525
1653821134,201459,true,1783135024,28,1792610253,9475229
1653821713,201459,true,1783135024,28,1792789514,9654490
1653821775,201458,true,1783313337,28,1792789514,9476177
1653821879,201456,true,1783670018,28,1792789514,9119496
1653822871,201455,true,1783848385,28,1792789514,8941129
1653823959,201455,true,1783848385,28,1792789514,8941129
1653824072,201454,true,1784026770,28,1792789514,8762744
1653824169,201452,true,1784383593,28,1792789514,8405921
1653824176,201451,true,1784562031,28,1792789514,8227483
1653824391,201451,true,1784562031,28,1792789514,8227483
1653824481,201450,true,1784740488,28,1792789514,8049026
1653824618,201449,true,1784918962,28,1792789514,7870552
1653824702,201448,true,1785097453,28,1792968793,7871340
1653825029,201447,true,1785275963,28,1793686088,8410125
1653825544,201446,true,1785454491,28,1794942045,9487554
1653825996,201444,true,1785811600,28,1796019280,10207680
1653826195,201444,true,1785811600,28,1797995889,12184289
1653826220,201443,true,1785990181,28,1798355506,12365325
1653826228,201441,true,1786347397,28,1798535342,12187945
1653826313,201438,true,1786883354,28,1799614733,12731379
1653826762,201437,true,1787062043,28,1804299584,17237541
1653826863,201436,true,1787240749,28,1805382435,18141686
1653826894,201435,true,1787419473,28,1805743529,18324056
1653827251,201431,true,1788134548,28,1808996632,20862084
1653827402,201431,true,1788134548,28,1810263310,22128762
1653827444,201430,true,1788313362,28,1810625380,22312018
1653827619,201429,true,1788492193,28,1812255595,23763402
1653827925,201425,true,1789207697,28,1814068666,24860969
1653828417,201424,true,1789386618,28,1813524555,24137937
1653828728,201424,true,1789386618,28,1813161904,23775286
1653829336,201422,true,1789744513,28,1812980606,23236093
1653829514,201419,true,1790281490,28,1812980606,22699116
1653829540,201418,true,1790460518,28,1812980606,22520088
1653829584,201418,true,1790460518,28,1812980606,22520088
1653829833,201416,true,1790818628,28,1813887278,23068650
1653829886,201412,true,1791535063,28,1814068666,22533603
1653829956,201411,true,1791714217,28,1814250073,22535856
1653829967,201410,true,1791893388,28,1814250073,22356685
1653829983,201408,true,1792251785,28,1814250073,21998288
1653830492,201405,true,1792789514,28,1814612941,21823427
1653830973,201404,true,1792968793,28,1815157380,22188587
1653831995,201403,true,1793148090,28,1814431498,21283408
1653832490,201402,true,1793327405,28,1814431498,21104093
1653832532,201399,true,1793865457,28,1814431498,20566041
1653832557,201398,true,1794044843,28,1814431498,20386655
1653832643,201398,true,1794044843,28,1814431498,20386655
1653832669,201396,true,1794403670,28,1814431498,20027828
1653832785,201393,true,1794942045,28,1814250073,19308028
1653832931,201393,true,1794942045,28,1814068666,19126621
1653833372,201393,true,1794942045,28,1813161904,18219859
1653833388,201392,true,1795121539,28,1813161904,18040365
1653834213,201389,true,1795660130,28,1810082301,14422171
1653834755,201389,true,1795660130,28,1808634887,12974757
1653836182,201389,true,1795660130,28,1807369349,11709219
1653836410,201388,true,1795839696,28,1807188630,11348934
1653836449,201386,true,1796198881,28,1807188630,10989749
1653836484,201385,true,1796378501,28,1807007929,10629428
1653836513,201386,true,1796198881,28,1807007929,10809048
1653836578,201385,true,1796378501,28,1806827246,10448745
1653836626,201383,true,1796737795,28,1806646582,9908787
1653837165,201383,true,1796737795,28,1803578045,6840250
1653837215,201383,true,1796737795,28,1803397705,6659910
1653838678,201383,true,1796737795,28,1797097161,359366
1653839034,201381,true,1797097161,28,1797097161,0
1653839081,201381,true,1797097161,28,1797097161,0
1653841121,201381,true,1797097161,28,1797097161,0
1653841262,201380,true,1797276870,28,1797456598,179728
1653841273,201378,true,1797636344,28,1797456598,-179746
1653841282,201378,true,1797636344,28,1797456598,-179746
1653842214,201377,true,1797816107,28,1800334686,2518579
1653842433,201377,true,1797816107,28,1801054928,3238821
1653845088,201375,true,1798175688,28,1802856794,4681106
1653845261,201375,true,1798175688,28,1802856794,4681106
1653845765,201374,true,1798355506,28,1802856794,4501288
1653846732,201373,true,1798535342,28,1802676526,4141184
1653846767,201371,true,1798895067,28,1802676526,3781459
1653847428,201371,true,1798895067,28,1801415157,2520090
1653849019,201370,true,1799074956,28,1799074956,0
1653850103,201369,true,1799254864,28,1799074956,-179908
1653850863,201367,true,1799614733,28,1798535342,-1079391
1653850933,201367,true,1799614733,28,1798355506,-1259227
1653850953,201366,true,1799794694,28,1798355506,-1439188
1653851022,201365,true,1799974674,28,1798175688,-1798986
1653851052,201363,true,1800334686,28,1798175688,-2158998
1653851296,201364,true,1800154671,28,1797636344,-2518327
1653851560,201363,true,1800334686,28,1796558139,-3776547
1653851827,201362,true,1800514720,28,1795301051,-5213669
1653851983,201360,true,1800874841,28,1794583110,-6291731
1653853133,201361,true,1800694771,28,1789923488,-10771283
1653854635,201361,true,1800694771,28,1789207697,-11487074
1653856177,201360,true,1800874841,28,1790281490,-10593351
1653857062,201358,true,1801235034,28,1790281490,-10953544
1653857789,201359,true,1801054928,28,1790281490,-10773438
1653858766,201358,true,1801235034,28,1790281490,-10953544
1653858858,201358,true,1801235034,28,1790281490,-10953544
1653859761,201356,true,1801595299,28,1790818628,-10776671
1653859881,201357,true,1801415157,28,1790997710,-10417447
1653859933,201357,true,1801415157,28,1790997710,-10417447
1653860094,201357,true,1801415157,28,1791176810,-10238347
1653860110,201355,true,1801775458,28,1791176810,-10598648
1653860253,201356,true,1801595299,28,1791714217,-9881082
1653860266,201356,true,1801595299,28,1791714217,-9881082
1653860419,201355,true,1801775458,28,1792431010,-9344448
1653862486,201354,true,1801955636,28,1799074956,-2880680
1653862662,201355,true,1801775458,28,1799254864,-2520594
1653862673,201354,true,1801955636,28,1799254864,-2700772
1653862818,201354,true,1801955636,28,1799434789,-2520847
1653862868,201352,true,1802316045,28,1799614733,-2701312
1653863653,201352,true,1802316045,28,1804299584,1983539
1653863675,201351,true,1802496277,28,1804480014,1983737
1653863774,201351,true,1802496277,28,1805021412,2525135
1653863849,201349,true,1802856794,28,1805562973,2706179
1653863911,201348,true,1803037080,28,1806104696,3067616
1653864042,201347,true,1803217383,28,1807369349,4151966
1653864536,201346,true,1803397705,28,1812074388,8676683
1653864710,201344,true,1803758403,28,1813343220,9584817
1653864875,201343,true,1803938779,28,1813887278,9948499
1653864954,201342,true,1804119172,28,1814068666,9949494
1653865078,201341,true,1804299584,28,1814250073,9950489
1653866792,201340,true,1804480014,28,1812618064,8138050
1653867895,201339,true,1804660462,28,1812436821,7776359
1653869255,201338,true,1804840928,28,1812436821,7595893
1653869329,201337,true,1805021412,28,1812436821,7415409
1653869374,201336,true,1805201915,28,1812436821,7234906
1653869611,201336,true,1805201915,28,1811712027,6510112
1653870499,201336,true,1805201915,28,1809177532,3975617
1653870647,201335,true,1805382435,28,1808815750,3433315
1653871379,201334,true,1805562973,28,1807550086,1987113
1653873585,201334,true,1805562973,28,1807369349,1806376
1653873604,201334,true,1805562973,28,1807550086,1987113
1653873754,201334,true,1805562973,28,1807550086,1987113
1653873778,201335,true,1805382435,28,1807550086,2167651
1653874046,201335,true,1805382435,28,1808092405,2709970
1653874146,201336,true,1805201915,28,1808273214,3071299
1653874173,201335,true,1805382435,28,1808273214,2890779
1653874205,201336,true,1805201915,28,1808454041,3252126
1653874227,201335,true,1805382435,28,1808454041,3071606
1653874269,201336,true,1805201915,28,1808634887,3432972
1653874343,201335,true,1805382435,28,1808996632,3614197
1653874507,201335,true,1805382435,28,1809901311,4518876
1653874575,201335,true,1805382435,28,1810263310,4880875
1653874627,201335,true,1805382435,28,1810444336,5061901
1653874687,201334,true,1805562973,28,1810987523,5424550
1653874776,201334,true,1805562973,28,1812074388,6511415
1653875009,201332,true,1805924104,28,1814794403,8870299
1653875020,201332,true,1805924104,28,1814975882,9051778
1653875058,201331,true,1806104696,28,1815520429,9415733
1653875183,201331,true,1806104696,28,1817336767,11232071
1653875508,201329,true,1806465935,28,1822067754,15601819
1653875515,201329,true,1806465935,28,1822249960,15784025
1653875626,201328,true,1806646582,28,1823890642,17244060
1653875643,201327,true,1806827246,28,1824073031,17245785
1653875651,201325,true,1807188630,28,1824255438,17066808
1653875952,201324,true,1807369349,28,1828821554,21452205
1653875963,201323,true,1807550086,28,1829004436,21454350
1653876001,201323,true,1807550086,28,1829553192,22003106
1653876028,201320,true,1808092405,28,1829919121,21826716
1653876086,201319,true,1808273214,28,1830834263,22561049
1653876232,201317,true,1808634887,28,1833215777,24580890
1653876293,201316,true,1808815750,28,1834315981,25500231
1653876301,201314,true,1809177532,28,1834499413,25321881
1653876318,201312,true,1809539385,28,1834866331,25326946
1653876415,201308,true,1810263310,28,1837253089,26989779
1653876674,201306,true,1810625380,28,1842404348,31778968
1653876701,201303,true,1811168622,28,1842957125,31788503
1653876974,201301,true,1811530874,28,1847939583,36408709
1653876997,201297,true,1812255595,28,1848309190,36053595
1653877273,201294,true,1812799326,28,1853676797,40877471
1653877367,201291,true,1813343220,28,1855531308,42188088
1653877653,201289,true,1813705907,28,1860919889,47213982
1653878020,201284,true,1814612941,28,1867070761,52457820
1653878088,201281,true,1815157380,28,1868191283,53033903
1653878166,201277,true,1815883552,28,1868938672,53055120
1653878172,201274,true,1816428371,28,1868938672,52510301
1653878208,201269,true,1817336767,28,1869125566,51788799
1653878948,201265,true,1818063811,28,1873803992,55740181
1653879227,201261,true,1818791145,28,1875116048,56324903
1653879290,201258,true,1819336837,28,1875491090,56154253
1653879331,201254,true,1820064681,28,1875678639,55613958
1653879351,201250,true,1820792816,28,1875678639,54885823
1653879700,201246,true,1821521243,28,1876616666,55095423
1653879791,201244,true,1821885565,28,1876804328,54918763
1653880370,201239,true,1822796690,28,1877179707,54383017
1653880437,201235,true,1823525918,28,1877179707,53653789
1653881374,201232,true,1824073031,28,1874553626,50480595
1653881611,201230,true,1824437864,28,1873991372,49553508
1653881706,201226,true,1825167748,28,1873803992,48636244
1653882014,201222,true,1825897925,28,1873054657,47156732
1653882181,201218,true,1826628393,28,1872680103,46051710
1653882405,201216,true,1826993737,28,1873054657,46060920
1653882730,201211,true,1827907417,28,1874366189,46458772
1653883218,201206,true,1828821554,28,1876241399,47419845
1653883960,201203,true,1829370255,28,1878869845,49499590
1653885074,201200,true,1829919121,28,1879057732,49138611
1653885101,201195,true,1830834263,28,1879057732,48223469
1653885164,201190,true,1831749864,28,1878869845,47119981
1653885206,201186,true,1832482673,28,1878869845,46387172
1653885265,201184,true,1832849188,28,1878869845,46020657
1653886106,201179,true,1833765796,28,1876053793,42287997
1653886302,201174,true,1834682863,28,1875491090,40808227
1653886516,201170,true,1835416846,28,1874928555,39511709
1653886749,201168,true,1835783948,28,1874366189,38582241
1653887435,201163,true,1836702023,28,1873616630,36914607
1653887551,201158,true,1837620558,28,1873616630,35996072
1653887684,201154,true,1838355716,28,1873616630,35260914
1653887755,201151,true,1838907278,28,1873616630,34709352
1653888060,201146,true,1839826916,28,1873616630,33789714
1653888087,201142,true,1840562957,28,1873616630,33053673
1653888356,201138,true,1841299292,28,1873616630,32317338
1653888917,201135,true,1841851737,28,1873616630,31764893
1653888937,201130,true,1842772848,28,1873803992,31031144
1653888995,201126,true,1843510067,28,1873803992,30293925
1653889020,201122,true,1844247582,28,1873803992,29556410
1653889052,201119,true,1844800912,28,1873803992,29003080
1653889114,201115,true,1845538943,28,1873991372,28452429
1653889175,201111,true,1846277269,28,1874178771,27901502
1653889209,201107,true,1847015891,28,1874366189,27350298
1653889221,201104,true,1847570051,28,1874366189,26796138
1653889244,201099,true,1848494021,28,1874553626,26059605
1653889371,201094,true,1849418452,28,1875491090,26072638
1653889551,201091,true,1849973333,28,1876992008,27018675
1653889616,201088,true,1850528381,28,1877555162,27026781
1653889823,201084,true,1851268703,28,1879057732,27789029
1653890088,201079,true,1852194523,28,1881125729,28931206
1653890120,201077,true,1852564980,28,1881313842,28748862
1653890238,201074,true,1853120805,28,1882254687,29133882
1653890286,201070,true,1853862165,28,1882819420,28957255
1653890399,201065,true,1854789281,28,1883761018,28971737
1653890445,201062,true,1855345774,28,1884326202,28980428
1653890918,201059,true,1855902433,28,1889231580,33329147
1653891223,201055,true,1856644906,28,1890554438,33909532
1653891287,201049,true,1857759171,28,1890932568,33173397
1653891403,201047,true,1858130741,28,1891499905,33369164
1653891449,201044,true,1858688236,28,1891689055,33000819
1653891944,201038,true,1859803728,28,1896992941,37189213
1653891976,201032,true,1860919889,28,1897372358,36452469
1653892126,201029,true,1861478221,28,1898511066,37032845
1653892145,201025,true,1862222924,28,1898700918,36477994
1653892161,201018,true,1863526871,28,1899270585,35743714
1653892168,201012,true,1864645267,28,1899460512,34815245
1653892184,201007,true,1865577776,28,1899460512,33882736
1653892523,201006,true,1865764334,28,1901360827,35596493
1653892550,201000,true,1866884072,28,1901550963,34666891
1653893050,200993,true,1868191283,28,1905548216,37356933
1653893857,200988,true,1869125566,28,1907263896,38138330
1653894337,200987,true,1869312478,28,1907836132,38523654
1653894384,200981,true,1870434346,28,1907836132,37401786
1653894489,200975,true,1871556888,28,1907645368,36088480
1653894521,200970,true,1872492853,28,1907645368,35152515
1653894786,200969,true,1872680103,28,1907073189,34393086
1653895269,200964,true,1873616630,28,1906119938,32503308
1653896106,200958,true,1874741081,28,1904405287,29664206
1653897141,200953,true,1875678639,28,1904214866,28536227
1653897151,200953,true,1875678639,28,1904405287,28726648
1653898472,200947,true,1876804328,28,1905357681,28553353
1653898884,200942,true,1877742917,28,1905548216,27805299
1653901572,200938,true,1878494127,28,1904595728,26101601
1653902102,200938,true,1878494127,28,1904595728,26101601
1653902155,200933,true,1879433562,28,1904595728,25162166
1653902306,200928,true,1880373467,28,1904595728,24222261
1653903461,200925,true,1880937635,28,1904214866,23277231
1653905369,200925,true,1880937635,28,1903834080,22896445
1653905385,200920,true,1881878292,28,1903834080,21955788
1653905403,200915,true,1882819420,28,1903834080,21014660
1653905446,200912,true,1883384322,28,1903834080,20449758
1653905941,200913,true,1883196002,28,1902501929,19305927
1653907091,200908,true,1884137789,28,1897751852,13614063
1653907829,200903,true,1885080046,28,1896044729,10964683
1653908000,200901,true,1885457081,28,1895855143,10398062
1653908762,200902,true,1885268554,28,1895665577,10397023
1653908849,200898,true,1886022775,28,1895665577,9642802
1653908878,200894,true,1886777297,28,1895665577,8888280
1653908938,200891,true,1887343387,28,1895476029,8132642
1653910048,200893,true,1886965975,28,1895476029,8510054
1653910158,200891,true,1887343387,28,1895665577,8322190
1653913004,200887,true,1888098437,28,1900030407,11931970
1653913153,200884,true,1888664923,28,1900030407,11365484
1653913171,200886,true,1888287247,28,1900220410,11933163
1653913308,200884,true,1888664923,28,1900790533,12125610
1653913332,200880,true,1889420503,28,1900790533,11370030
1653913392,200877,true,1889987386,28,1900790533,10803147
1653913398,200879,true,1889609445,28,1900790533,11181088
1653913418,200878,true,1889798406,28,1900790533,10992127
1653913440,200875,true,1890365402,28,1900790533,10425131
1653913447,200872,true,1890932568,28,1900790533,9857965
1653913450,200875,true,1890365402,28,1900790533,10425131
1653913705,200875,true,1890365402,28,1899460512,9095110
1653913711,200872,true,1890932568,28,1899460512,8527944
1653913734,200870,true,1891310774,28,1899270585,7959811
1653913746,200872,true,1890932568,28,1899080677,8148109
1653913780,200874,true,1890554438,28,1898890788,8336350
1653913802,200871,true,1891121662,28,1898511066,7389404
1653913866,200868,true,1891689055,28,1897941627,6252572
1653913930,200871,true,1891121662,28,1897372358,6250696
1653914015,200873,true,1890743494,28,1896234333,5490839
1653914082,200870,true,1891310774,28,1895476029,4165255
1653914404,200868,true,1891689055,28,1891499905,-189150
1653914406,200871,true,1891121662,28,1891499905,378243
1653915099,200872,true,1890932568,28,1882819420,-8113148
1653915123,200869,true,1891499905,28,1882631157,-8868748
1653915191,200866,true,1892067411,28,1881878292,-10189119
1653915246,200869,true,1891499905,28,1881313842,-10186063
1653915253,200870,true,1891310774,28,1881313842,-9996932
1653916400,200867,true,1891878224,28,1883761018,-8117206
1653916430,200865,true,1892256618,28,1883949394,-8307224
1653916766,200868,true,1891689055,28,1884514635,-7174420
1653916773,200869,true,1891499905,28,1884514635,-6985270
1653918661,200867,true,1891878224,28,1879809468,-12068756
1653918681,200865,true,1892256618,28,1879997449,-12259169
1653918736,200868,true,1891689055,28,1879997449,-11691606
1653918850,200868,true,1891689055,28,1880373467,-11315588
1653919511,200865,true,1892256618,28,1882442912,-9813706
1653919527,200863,true,1892635088,28,1882442912,-10192176
1653919545,200866,true,1892067411,28,1882631157,-9436254
1653919557,200866,true,1892067411,28,1882631157,-9436254
1653919656,200861,true,1893013634,28,1883384322,-9629312
1653919762,200859,true,1893392256,28,1884137789,-9254467
1653919865,200861,true,1893013634,28,1885834191,-7179443
1653919868,200861,true,1893013634,28,1885834191,-7179443
1653920072,200855,true,1894149727,28,1889798406,-4351321
1653920112,200851,true,1894907500,28,1890554438,-4353062
1653920154,200853,true,1894528575,28,1891310774,-3217801
1653920174,200853,true,1894528575,28,1891689055,-2839520
1653920600,200848,true,1895476029,28,1898890788,3414759
1653921537,200844,true,1896234333,28,1912037782,15803449
1653921550,200846,true,1895855143,28,1912228986,16373843
1653921622,200847,true,1895665577,28,1912420208,16754631
1653921676,200841,true,1896803261,28,1912420208,15616947
1653921706,200838,true,1897372358,28,1912228986,14856628
1653921741,200841,true,1896803261,28,1912037782,15234521
1653921746,200842,true,1896613599,28,1912037782,15424183
1653921893,200838,true,1897372358,28,1910890961,13518603
1653922138,200836,true,1897751852,28,1909362935,11611083
1653922151,200839,true,1897182640,28,1909172018,11989378
1653922267,200840,true,1896992941,28,1908408540,11415599
1653923198,200836,true,1897751852,28,1901360827,3608975
1653924293,200834,true,1898131421,28,1899840423,1709002
1653924583,200836,true,1897751852,28,1900410432,2658580
1653924648,200837,true,1897562096,28,1900600473,3038377
1653924729,200834,true,1898131421,28,1900790533,2659112
1653924759,200831,true,1898700918,28,1900790533,2089615
1653925491,200834,true,1898131421,28,1903072737,4941316
1653925525,200835,true,1897941627,28,1903072737,5131110
1653925580,200832,true,1898511066,28,1903263044,4751978
1653925591,200829,true,1899080677,28,1903263044,4182367
1653926160,200832,true,1898511066,28,1904976666,6465600
1653927727,200834,true,1898131421,28,1907645368,9513947
1653927766,200831,true,1898700918,28,1907836132,9135214
1653927772,200829,true,1899080677,28,1907836132,8755455
1653927774,200831,true,1898700918,28,1907836132,9135214
1653928250,200833,true,1898321234,28,1909362935,11041701
1653929205,200830,true,1898890788,28,1913567947,14677159
1653929213,200830,true,1898890788,28,1913567947,14677159
1653929783,200829,true,1899080677,28,1917782220,18701543
1653929850,200831,true,1898700918,28,1918165796,19464878
1653929863,200827,true,1899460512,28,1918165796,18705284
1653929932,200827,true,1899460512,28,1918357612,18897100
1653929944,200827,true,1899460512,28,1918549448,19088936
1653930206,200829,true,1899080677,28,1918933177,19852500
1653930425,200825,true,1899840423,28,1919125071,19284648
1653930962,200825,true,1899840423,28,1919700866,19860443
1653930977,200824,true,1900030407,28,1919700866,19670459
1653931019,200826,true,1899650458,28,1919892836,20242378
1653931048,200822,true,1900410432,28,1919892836,19482404
1653931760,200820,true,1900790533,28,1923543917,22753384
1653931853,200819,true,1900980612,28,1924313450,23332838
1653932385,200821,true,1900600473,28,1928358552,27758079
1653932662,200817,true,1901360827,28,1930673855,29313028
1653933297,200815,true,1901741119,28,1931832549,30091430
1653933356,200814,true,1901931293,28,1931832549,29901256
1653933688,200816,true,1901550963,28,1931446241,29895278
1653934186,200813,true,1902121486,28,1931060009,28938523
1653934239,200810,true,1902692179,28,1930866923,28174744
1653934697,200810,true,1902692179,28,1930287778,27595599
1653934888,200811,true,1902501929,28,1929901779,27399850
1653935044,200808,true,1903072737,28,1929515856,26443119
1653935552,200806,true,1903453370,28,1928165735,24712365
1653935580,200805,true,1903643716,28,1928165735,24522019
1653935618,200806,true,1903453370,28,1927972938,24519568
1653935658,200803,true,1904024463,28,1927780160,23755697
1653935716,200801,true,1904405287,28,1927587401,23182114
1653935776,200799,true,1904786188,28,1927394662,22608474
1653935793,200801,true,1904405287,28,1927394662,22989375
1653935832,200797,true,1905167164,28,1927201942,22034778
1653935879,200795,true,1905548216,28,1927009241,21461025
1653936969,200794,true,1905738771,28,1923928645,18189874
1653937075,200796,true,1905357681,28,1923736271,18378590
1653937208,200793,true,1905929345,28,1923543917,17614572
1653937282,200791,true,1906310550,28,1923351582,17041032
1653937303,200790,true,1906501181,28,1923351582,16850401
1653937599,200792,true,1906119938,28,1923159266,17039328
1653937890,200789,true,1906691831,28,1922966969,16275138
1653939377,200787,true,1907073189,28,1924121038,17047849
1653939654,200786,true,1907263896,28,1924313450,17049554
1653939710,200787,true,1907073189,28,1924313450,17240261
1653940089,200785,true,1907454622,28,1924698332,17243710
1653940145,200782,true,1908026916,28,1924698332,16671416
1653940189,200781,true,1908217719,28,1924698332,16480613
1653940215,200781,true,1908217719,28,1924505881,16288162
1653940271,200779,true,1908599381,28,1924313450,15714069
1653940284,200777,true,1908981120,28,1924313450,15332330
1653940316,200776,true,1909172018,28,1924313450,15141432
1653940324,200775,true,1909362935,28,1924313450,14950515
1653940365,200773,true,1909744827,28,1924121038,14376211
1653941301,200771,true,1910126795,28,1919508915,9382120
1653941387,200770,true,1910317808,28,1919125071,8807263
1653941399,200768,true,1910699891,28,1919125071,8425180
1653941483,200766,true,1911082050,28,1918933177,7851127
1653941515,200763,true,1911655432,28,1918933177,7277745
1653941750,200761,true,1912037782,28,1918741303,6703521
1653941874,200760,true,1912228986,28,1918741303,6512317
1653942272,200757,true,1912802712,28,1921045060,8242348
1653942328,200754,true,1913376610,28,1922005774,8629164
1653942429,200751,true,1913950680,28,1923351582,9400902
1653942462,200750,true,1914142075,28,1923928645,9786570
1653942529,200746,true,1914907847,28,1924890802,9982955
1653942584,200743,true,1915482377,28,1925853440,10371063
1653942658,200740,true,1916057079,28,1927201942,11144863
1653943174,200740,true,1916057079,28,1934152024,18094945
1653943226,200735,true,1917015299,28,1934925801,17910502
1653943460,200732,true,1917590461,28,1937055284,19464823
1653943520,200729,true,1918165796,28,1937636458,19470662
1653943822,200728,true,1918357612,28,1940156898,21799286
1653944313,200724,true,1919125071,28,1941709566,22584495
1653944326,200721,true,1919700866,28,1941709566,22008700
1653944397,200718,true,1920276834,28,1941903737,21626903
1653944403,200718,true,1920276834,28,1941903737,21626903
1653944799,200714,true,1921045060,28,1943457804,22412744
1653944811,200711,true,1921621431,28,1943652150,22030719
1653945073,200708,true,1922197975,28,1945596677,23398702
1653945185,200708,true,1922197975,28,1946569670,24371695
1653945200,200705,true,1922774692,28,1946569670,23794978
1653945205,200703,true,1923159266,28,1946764327,23605061
1653945434,200700,true,1923736271,28,1949296640,25560369
1653945509,200699,true,1923928645,28,1950466510,26537865
1653945519,200695,true,1924698332,28,1950661557,25963225
1653945536,200693,true,1925083291,28,1950856623,25773332
1653945589,200689,true,1925853440,28,1951832246,25978806
1653945601,200687,true,1926238630,28,1952027429,25788799
1653945645,200683,true,1927009241,28,1953003638,25994397
1653945705,200680,true,1927587401,28,1954371151,26783750
1653945718,200675,true,1928551388,28,1954762045,26210657
1653945755,200673,true,1928937117,28,1955739621,26802504
1653945828,200668,true,1929901779,28,1957696241,27794462
1653945853,200664,true,1930673855,28,1958283609,27609754
1653945963,200659,true,1931639385,28,1961026989,29387604
1653946515,200657,true,1932025733,28,1972630665,40604932
1653946599,200652,true,1932991939,28,1974209322,41217383
1653946607,200648,true,1933765251,28,1974406743,40641492
1653946613,200644,true,1934538873,28,1974604184,40065311
1653946630,200642,true,1934925801,28,1974801644,39875843
1653946668,200637,true,1935893457,28,1975196624,39303167
1653946751,200635,true,1936280655,28,1976382038,40101383
1653946782,200630,true,1937248989,28,1976777335,39528346
1653946908,200628,true,1937636458,28,1978359310,40722852
1653947660,200624,true,1938411629,28,1980734647,42323018
1653947753,200621,true,1938993211,28,1980338560,41345349
1653947779,200617,true,1939768924,28,1980140546,40371622
1653947847,200615,true,1940156898,28,1979942552,39785654
1653947848,200611,true,1940933077,28,1979942552,39009475
1653948081,200607,true,1941709566,28,1980338560,38628994
1653948287,200603,true,1942486367,28,1980734647,38248280
1653948492,200602,true,1942680615,28,1981328927,38648312
